01;Álava;001;Alegría-Dulantzi;1329;696;633
01;Álava;002;Amurrio;9753;4854;4899
01;Álava;049;Añana;188;97;91
01;Álava;003;Aramaio;1373;723;650
01;Álava;006;Armiñón;153;78;75
01;Álava;037;Arraia-Maeztu;712;380;332
01;Álava;008;Arrazua-Ubarrundia;756;397;359
01;Álava;004;Artziniega;1338;673;665
01;Álava;009;Asparrena;1561;768;793
01;Álava;010;Ayala/Aiara;2031;1015;1016
01;Álava;011;Baños de Ebro/Mañueta;333;183;150
01;Álava;013;Barrundia;590;329;261
01;Álava;014;Berantevilla;422;219;203
01;Álava;016;Bernedo;544;315;229
01;Álava;017;Campezo/Kanpezu;1062;559;503
01;Álava;021;Elburgo/Burgelu;269;147;122
01;Álava;022;Elciego;905;462;443
01;Álava;023;Elvillar/Bilar;356;191;165
01;Álava;056;Harana/Valle de Arana;353;196;157
01;Álava;901;Iruña Oka/Iruña de Oca;1674;882;792
01;Álava;027;Iruraiz-Gauna;416;229;187
01;Álava;019;Kripan;190;99;91
01;Álava;020;Kuartango;372;209;163
01;Álava;028;Labastida/Bastida;1195;633;562
01;Álava;030;Lagrán;197;103;94
01;Álava;031;Laguardia;1409;728;681
01;Álava;032;Lanciego/Lantziego;642;340;302
01;Álava;902;Lantarón;924;529;395
01;Álava;033;Lapuebla de Labarca;872;443;429
01;Álava;058;Legutiano;1333;705;628
01;Álava;034;Leza;196;107;89
01;Álava;036;Llodio;19632;9825;9807
01;Álava;039;Moreda de Álava;292;157;135
01;Álava;041;Navaridas;215;121;94
01;Álava;042;Okondo;831;425;406
01;Álava;043;Oyón/Oion;2286;1148;1138
01;Álava;044;Peñacerrada-Urizaharra;258;140;118
01;Álava;046;Erriberagoitia/Ribera Alta;515;306;209
01;Álava;047;Ribera Baja/Erribera Beitia;493;270;223
01;Álava;051;Salvatierra/Agurain;3933;1969;1964
01;Álava;052;Samaniego;306;152;154
01;Álava;053;San Millán/Donemiliaga;681;371;310
01;Álava;054;Urkabustaiz;840;465;375
01;Álava;055;Valdegovía/Gaubea;925;500;425
01;Álava;057;Villabuena de Álava/Eskuernaga;336;170;166
01;Álava;059;Vitoria-Gasteiz;217154;106705;110449
01;Álava;060;Yécora/Lekora;257;123;134
01;Álava;061;Zalduondo;141;74;67
01;Álava;062;Zambrana;370;196;174
01;Álava;018;Zigoitia;1198;670;528
01;Álava;063;Zuia;1637;824;813
02;Albacete;001;Abengibre;996;493;503
02;Albacete;002;Alatoz;684;356;328
02;Albacete;003;Albacete;147527;72139;75388
02;Albacete;004;Albatana;870;440;430
02;Albacete;005;Alborea;813;424;389
02;Albacete;006;Alcadozo;775;396;379
02;Albacete;007;Alcalá del Júcar;1525;781;744
02;Albacete;008;Alcaraz;1751;839;912
02;Albacete;009;Almansa;23612;11655;11957
02;Albacete;010;Alpera;2334;1201;1133
02;Albacete;011;Ayna;1007;506;501
02;Albacete;012;Balazote;2254;1137;1117
02;Albacete;014;Ballestero (El);573;290;283
02;Albacete;013;Balsa de Ves;283;154;129
02;Albacete;015;Barrax;1952;981;971
02;Albacete;016;Bienservida;907;458;449
02;Albacete;017;Bogarra;1347;710;637
02;Albacete;018;Bonete;1222;616;606
02;Albacete;019;Bonillo (El);3278;1659;1619
02;Albacete;020;Carcelén;664;353;311
02;Albacete;021;Casas de Juan Núñez;1267;658;609
02;Albacete;022;Casas de Lázaro;439;238;201
02;Albacete;023;Casas de Ves;909;476;433
02;Albacete;024;Casas-Ibáñez;4097;2068;2029
02;Albacete;025;Caudete;8909;4433;4476
02;Albacete;026;Cenizate;1070;556;514
02;Albacete;029;Chinchilla de Monte-Aragón;3227;1672;1555
02;Albacete;027;Corral-Rubio;481;244;237
02;Albacete;028;Cotillas;216;108;108
02;Albacete;030;Elche de la Sierra;3936;1958;1978
02;Albacete;032;Fuensanta;377;198;179
02;Albacete;033;Fuente-Álamo;2483;1267;1216
02;Albacete;034;Fuentealbilla;1803;919;884
02;Albacete;031;Férez;803;396;407
02;Albacete;035;Gineta (La);2064;1012;1052
02;Albacete;036;Golosalvo;114;54;60
02;Albacete;037;Hellín;26205;12986;13219
02;Albacete;038;Herrera (La);402;206;196
02;Albacete;039;Higueruela;1326;668;658
02;Albacete;040;Hoya-Gonzalo;762;387;375
02;Albacete;041;Jorquera;580;307;273
02;Albacete;042;Letur;1370;672;698
02;Albacete;043;Lezuza;1793;935;858
02;Albacete;044;Liétor;1676;861;815
02;Albacete;045;Madrigueras;4536;2286;2250
02;Albacete;046;Mahora;1366;673;693
02;Albacete;047;Masegoso;166;97;69
02;Albacete;048;Minaya;1789;904;885
02;Albacete;049;Molinicos;1373;705;668
02;Albacete;050;Montalvos;149;76;73
02;Albacete;051;Montealegre del Castillo;2144;1076;1068
02;Albacete;052;Motilleja;511;252;259
02;Albacete;053;Munera;4064;2051;2013
02;Albacete;054;Navas de Jorquera;540;281;259
02;Albacete;055;Nerpio;1785;950;835
02;Albacete;056;Ontur;2431;1202;1229
02;Albacete;057;Ossa de Montiel;2791;1385;1406
02;Albacete;058;Paterna del Madera;558;292;266
02;Albacete;060;Peñas de San Pedro;1224;644;580
02;Albacete;059;Peñascosa;413;215;198
02;Albacete;062;Povedilla;719;372;347
02;Albacete;901;Pozo Cañada;"";"";""
02;Albacete;064;Pozo-Lorente;549;270;279
02;Albacete;063;Pozohondo;1847;958;889
02;Albacete;065;Pozuelo;714;372;342
02;Albacete;061;Pétrola;915;472;443
02;Albacete;066;Recueja (La);346;175;171
02;Albacete;067;Riópar;1473;757;716
02;Albacete;068;Robledo;430;226;204
02;Albacete;069;Roda (La);13627;6826;6801
02;Albacete;070;Salobre;618;315;303
02;Albacete;071;San Pedro;1336;677;659
02;Albacete;072;Socovos;2035;1044;991
02;Albacete;073;Tarazona de la Mancha;6012;2986;3026
02;Albacete;074;Tobarra;7469;3746;3723
02;Albacete;075;Valdeganga;1981;992;989
02;Albacete;076;Vianos;504;245;259
02;Albacete;077;Villa de Ves;69;35;34
02;Albacete;078;Villalgordo del Júcar;1306;646;660
02;Albacete;079;Villamalea;3476;1782;1694
02;Albacete;080;Villapalacios;844;420;424
02;Albacete;081;Villarrobledo;22197;10836;11361
02;Albacete;082;Villatoya;197;103;94
02;Albacete;083;Villavaliente;288;152;136
02;Albacete;084;Villaverde de Guadalimar;543;287;256
02;Albacete;085;Viveros;559;302;257
02;Albacete;086;Yeste;4444;2258;2186
03;Alicante/Alacant;001;Adsubia;558;288;270
03;Alicante/Alacant;002;Agost;4053;2018;2035
03;Alicante/Alacant;003;Agres;649;339;310
03;Alicante/Alacant;004;Aigües;579;296;283
03;Alicante/Alacant;005;Albatera;8661;4376;4285
03;Alicante/Alacant;006;Alcalalí;941;490;451
03;Alicante/Alacant;007;Alcocer de Planes;123;52;71
03;Alicante/Alacant;008;Alcoleja;271;131;140
03;Alicante/Alacant;009;Alcoy/Alcoi;60476;29135;31341
03;Alicante/Alacant;010;Alfafara;388;187;201
03;Alicante/Alacant;011;Alfàs del Pi (L');13226;6423;6803
03;Alicante/Alacant;012;Algorfa;1220;617;603
03;Alicante/Alacant;013;Algueña;1459;717;742
03;Alicante/Alacant;014;Alicante/Alacant;272432;130607;141825
03;Alicante/Alacant;015;Almoradí;13606;6834;6772
03;Alicante/Alacant;016;Almudaina;111;58;53
03;Alicante/Alacant;017;Alqueria d'Asnar (L');416;210;206
03;Alicante/Alacant;018;Altea;14711;7214;7497
03;Alicante/Alacant;019;Aspe;16492;8251;8241
03;Alicante/Alacant;020;Balones;181;86;95
03;Alicante/Alacant;021;Banyeres de Mariola;6848;3398;3450
03;Alicante/Alacant;022;Benasau;195;97;98
03;Alicante/Alacant;023;Beneixama;1796;895;901
03;Alicante/Alacant;024;Benejúzar;5067;2518;2549
03;Alicante/Alacant;025;Benferri;1026;525;501
03;Alicante/Alacant;026;Beniarbeig;1205;586;619
03;Alicante/Alacant;027;Beniardá;209;98;111
03;Alicante/Alacant;028;Beniarrés;1414;712;702
03;Alicante/Alacant;030;Benidoleig;817;400;417
03;Alicante/Alacant;031;Benidorm;52845;25981;26864
03;Alicante/Alacant;032;Benifallim;147;68;79
03;Alicante/Alacant;033;Benifato;138;70;68
03;Alicante/Alacant;029;Benigembla;389;198;191
03;Alicante/Alacant;034;Benijófar;1655;807;848
03;Alicante/Alacant;035;Benilloba;920;466;454
03;Alicante/Alacant;036;Benillup;94;48;46
03;Alicante/Alacant;037;Benimantell;419;198;221
03;Alicante/Alacant;038;Benimarfull;406;187;219
03;Alicante/Alacant;039;Benimassot;185;96;89
03;Alicante/Alacant;040;Benimeli;329;163;166
03;Alicante/Alacant;041;Benissa;9687;4809;4878
03;Alicante/Alacant;042;Benitachell/Poble Nou de Benitatxell (el);2131;1076;1055
03;Alicante/Alacant;043;Biar;3537;1717;1820
03;Alicante/Alacant;044;Bigastro;4829;2434;2395
03;Alicante/Alacant;045;Bolulla;316;156;160
03;Alicante/Alacant;046;Busot;1615;819;796
03;Alicante/Alacant;048;Callosa d'En Sarrià;6365;3174;3191
03;Alicante/Alacant;049;Callosa de Segura;15291;7668;7623
03;Alicante/Alacant;047;Calp;15605;7838;7767
03;Alicante/Alacant;050;Campello (El);17564;8681;8883
03;Alicante/Alacant;051;Campo de Mirra/Camp de Mirra (el);386;186;200
03;Alicante/Alacant;053;Castalla;7631;3780;3851
03;Alicante/Alacant;054;Castell de Castells;465;230;235
03;Alicante/Alacant;055;Catral;4979;2468;2511
03;Alicante/Alacant;052;Cañada;1121;534;587
03;Alicante/Alacant;056;Cocentaina;10572;5180;5392
03;Alicante/Alacant;057;Confrides;309;178;131
03;Alicante/Alacant;058;Cox;5806;2944;2862
03;Alicante/Alacant;059;Crevillent;24408;12267;12141
03;Alicante/Alacant;061;Daya Nueva;1139;591;548
03;Alicante/Alacant;062;Daya Vieja;163;81;82
03;Alicante/Alacant;064;Dolores;6239;3178;3061
03;Alicante/Alacant;063;Dénia;29585;14464;15121
03;Alicante/Alacant;065;Elche/Elx;193174;95470;97704
03;Alicante/Alacant;066;Elda;51228;24961;26267
03;Alicante/Alacant;067;Facheca;123;62;61
03;Alicante/Alacant;068;Famorca;65;31;34
03;Alicante/Alacant;069;Finestrat;1954;977;977
03;Alicante/Alacant;070;Formentera del Segura;2111;1031;1080
03;Alicante/Alacant;072;Gaianes;291;130;161
03;Alicante/Alacant;071;Gata de Gorgos;5003;2493;2510
03;Alicante/Alacant;073;Gorga;257;133;124
03;Alicante/Alacant;074;Granja de Rocamora;1962;982;980
03;Alicante/Alacant;075;Guadalest;176;89;87
03;Alicante/Alacant;076;Guardamar del Segura;8845;4394;4451
03;Alicante/Alacant;077;Hondón de las Nieves;1604;787;817
03;Alicante/Alacant;078;Hondón de los Frailes;553;277;276
03;Alicante/Alacant;079;Ibi;21180;10496;10684
03;Alicante/Alacant;080;Jacarilla;1540;773;767
03;Alicante/Alacant;081;Jalón/Xaló;2001;984;1017
03;Alicante/Alacant;083;Jijona/Xixona;7436;3485;3951
03;Alicante/Alacant;082;Jávea/Xàbia;21996;10874;11122
03;Alicante/Alacant;085;Llíber;524;264;260
03;Alicante/Alacant;084;Lorcha/Orxa (L');778;393;385
03;Alicante/Alacant;086;Millena;144;70;74
03;Alicante/Alacant;088;Monforte del Cid;5178;2665;2513
03;Alicante/Alacant;903;Montesinos (Los);2526;1284;1242
03;Alicante/Alacant;089;Monóvar/Monòver;11909;5836;6073
03;Alicante/Alacant;091;Murla;322;138;184
03;Alicante/Alacant;092;Muro de Alcoy;7194;3547;3647
03;Alicante/Alacant;090;Mutxamel;14087;7033;7054
03;Alicante/Alacant;093;Novelda;23665;11679;11986
03;Alicante/Alacant;094;Nucia (la);7839;3894;3945
03;Alicante/Alacant;095;Ondara;5246;2631;2615
03;Alicante/Alacant;096;Onil;6777;3387;3390
03;Alicante/Alacant;097;Orba;1586;764;822
03;Alicante/Alacant;099;Orihuela;51649;25577;26072
03;Alicante/Alacant;098;Orxeta;429;216;213
03;Alicante/Alacant;100;Parcent;826;408;418
03;Alicante/Alacant;101;Pedreguer;5941;2889;3052
03;Alicante/Alacant;102;Pego;10186;5188;4998
03;Alicante/Alacant;103;Penàguila;366;173;193
03;Alicante/Alacant;104;Petrer;28223;14089;14134
03;Alicante/Alacant;902;Pilar de la Horadada;10723;5711;5012
03;Alicante/Alacant;105;Pinoso;6064;3011;3053
03;Alicante/Alacant;106;Planes;813;400;413
03;Alicante/Alacant;901;Poblets (Els);1485;724;761
03;Alicante/Alacant;107;Polop;2024;978;1046
03;Alicante/Alacant;060;Quatretondeta;182;91;91
03;Alicante/Alacant;109;Rafal;3123;1542;1581
03;Alicante/Alacant;111;Redován;5398;2769;2629
03;Alicante/Alacant;112;Relleu;806;400;406
03;Alicante/Alacant;113;Rojales;7099;3484;3615
03;Alicante/Alacant;114;Romana (La);1992;1006;986
03;Alicante/Alacant;110;Ràfol d'Almúnia (El);386;193;193
03;Alicante/Alacant;115;Sagra;398;194;204
03;Alicante/Alacant;116;Salinas;1188;603;585
03;Alicante/Alacant;118;San Fulgencio;3384;1688;1696
03;Alicante/Alacant;904;San Isidro;1249;650;599
03;Alicante/Alacant;120;San Miguel de Salinas;3691;1886;1805
03;Alicante/Alacant;122;San Vicente del Raspeig/Sant Vicent del Raspeig;37484;18595;18889
03;Alicante/Alacant;117;Sanet y Negrals;537;245;292
03;Alicante/Alacant;119;Sant Joan d'Alacant;16910;8287;8623
03;Alicante/Alacant;121;Santa Pola;18253;9047;9206
03;Alicante/Alacant;123;Sax;8602;4317;4285
03;Alicante/Alacant;124;Sella;590;297;293
03;Alicante/Alacant;125;Senija;472;246;226
03;Alicante/Alacant;128;Teulada;8901;4442;4459
03;Alicante/Alacant;129;Tibi;1176;610;566
03;Alicante/Alacant;130;Tollos;43;27;16
03;Alicante/Alacant;131;Tormos;292;141;151
03;Alicante/Alacant;132;Torremanzanas/Torre de les Maçanes (la);724;362;362
03;Alicante/Alacant;133;Torrevieja;42278;20906;21372
03;Alicante/Alacant;127;Tárbena;702;350;352
03;Alicante/Alacant;134;Vall d'Alcalà (La);179;90;89
03;Alicante/Alacant;135;Vall de Ebo;342;170;172
03;Alicante/Alacant;136;Vall de Gallinera;596;312;284
03;Alicante/Alacant;137;Vall de Laguar (La);916;438;478
03;Alicante/Alacant;138;Verger (El);3610;1732;1878
03;Alicante/Alacant;139;Villajoyosa/Vila Joiosa (La);23340;11485;11855
03;Alicante/Alacant;140;Villena;31700;15657;16043
04;Almería;001;Abla;1519;746;773
04;Almería;002;Abrucena;1460;716;744
04;Almería;003;Adra;21286;10668;10618
04;Almería;004;Albánchez;605;303;302
04;Almería;005;Alboloduy;811;384;427
04;Almería;006;Albox;9671;4845;4826
04;Almería;007;Alcolea;856;431;425
04;Almería;008;Alcóntar;610;315;295
04;Almería;009;Alcudia de Monteagud;194;92;102
04;Almería;010;Alhabia;670;323;347
04;Almería;011;Alhama de Almería;3124;1562;1562
04;Almería;012;Alicún;241;116;125
04;Almería;013;Almería;169027;82029;86998
04;Almería;014;Almócita;185;94;91
04;Almería;015;Alsodux;105;53;52
04;Almería;016;Antas;2677;1321;1356
04;Almería;017;Arboleas;1540;781;759
04;Almería;018;Armuña de Almanzora;324;159;165
04;Almería;019;Bacares;284;148;136
04;Almería;020;Bayárcal;334;178;156
04;Almería;021;Bayarque;234;109;125
04;Almería;022;Bédar;566;298;268
04;Almería;023;Beires;144;71;73
04;Almería;024;Benahadux;2775;1329;1446
04;Almería;026;Benitagla;86;46;40
04;Almería;027;Benizalón;324;169;155
04;Almería;028;Bentarique;321;168;153
04;Almería;029;Berja;13317;6395;6922
04;Almería;030;Canjáyar;1694;858;836
04;Almería;031;Cantoria;3206;1611;1595
04;Almería;032;Carboneras;6360;3258;3102
04;Almería;033;Castro de Filabres;181;88;93
04;Almería;036;Chercos;296;152;144
04;Almería;037;Chirivel;1824;911;913
04;Almería;034;Cóbdar;252;127;125
04;Almería;035;Cuevas del Almanzora;9584;4796;4788
04;Almería;038;Dalías;3663;1806;1857
04;Almería;039;Darrical;"";"";""
04;Almería;902;Ejido (El);51485;27090;24395
04;Almería;041;Enix;284;154;130
04;Almería;043;Felix;575;289;286
04;Almería;044;Fines;1727;879;848
04;Almería;045;Fiñana;2594;1269;1325
04;Almería;046;Fondón;926;474;452
04;Almería;047;Gádor;2574;1291;1283
04;Almería;048;Gallardos (Los);1700;855;845
04;Almería;049;Garrucha;5156;2623;2533
04;Almería;050;Gérgal;1067;532;535
04;Almería;051;Huécija;531;270;261
04;Almería;052;Huércal de Almería;6395;3232;3163
04;Almería;053;Huércal-Overa;13870;6831;7039
04;Almería;054;Illar;468;225;243
04;Almería;055;Instinción;544;266;278
04;Almería;056;Laroya;105;54;51
04;Almería;057;Láujar de Andarax;1855;905;950
04;Almería;058;Líjar;496;243;253
04;Almería;059;Lubrín;1771;850;921
04;Almería;060;Lucainena de las Torres;595;300;295
04;Almería;061;Lúcar;792;391;401
04;Almería;062;Macael;5861;2973;2888
04;Almería;063;María;1685;876;809
04;Almería;064;Mojácar;4615;2279;2336
04;Almería;903;Mojonera (La);6582;3538;3044
04;Almería;065;Nacimiento;528;263;265
04;Almería;066;Níjar;16083;8449;7634
04;Almería;067;Ohanes;784;394;390
04;Almería;068;Olula de Castro;189;99;90
04;Almería;069;Olula del Río;6008;2993;3015
04;Almería;070;Oria;2138;1084;1054
04;Almería;071;Padules;491;250;241
04;Almería;072;Partaloa;377;186;191
04;Almería;073;Paterna del Río;383;200;183
04;Almería;074;Pechina;2689;1355;1334
04;Almería;075;Pulpí;5375;2636;2739
04;Almería;076;Purchena;1623;790;833
04;Almería;077;Rágol;398;175;223
04;Almería;078;Rioja;1186;585;601
04;Almería;079;Roquetas de Mar;42333;21766;20567
04;Almería;080;Santa Cruz de Marchena;215;95;120
04;Almería;081;Santa Fe de Mondújar;414;201;213
04;Almería;082;Senés;335;170;165
04;Almería;083;Serón;2673;1298;1375
04;Almería;084;Sierro;484;238;246
04;Almería;085;Somontín;492;242;250
04;Almería;086;Sorbas;2735;1378;1357
04;Almería;087;Suflí;249;131;118
04;Almería;088;Tabernas;3241;1630;1611
04;Almería;089;Taberno;1002;495;507
04;Almería;090;Tahal;392;209;183
04;Almería;091;Terque;421;218;203
04;Almería;092;Tíjola;3796;1855;1941
04;Almería;901;Tres Villas (Las);605;320;285
04;Almería;093;Turre;2233;1095;1138
04;Almería;094;Turrillas;247;125;122
04;Almería;095;Uleila del Campo;976;497;479
04;Almería;096;Urrácal;332;159;173
04;Almería;097;Velefique;313;159;154
04;Almería;098;Vélez-Blanco;2144;1100;1044
04;Almería;099;Vélez-Rubio;6502;3114;3388
04;Almería;100;Vera;6926;3478;3448
04;Almería;101;Viator;3493;1700;1793
04;Almería;102;Vícar;15356;8092;7264
04;Almería;103;Zurgena;2079;1011;1068
05;Ávila;001;Adanero;370;211;159
05;Ávila;002;Adrada (La);2016;1032;984
05;Ávila;005;Albornos;260;146;114
05;Ávila;007;Aldeanueva de Santa Cruz;187;97;90
05;Ávila;008;Aldeaseca;345;177;168
05;Ávila;010;Aldehuela (La);286;141;145
05;Ávila;012;Amavida;194;99;95
05;Ávila;013;Arenal (El);1075;522;553
05;Ávila;014;Arenas de San Pedro;6494;3192;3302
05;Ávila;015;Arevalillo;133;65;68
05;Ávila;016;Arévalo;7451;3603;3848
05;Ávila;017;Aveinte;138;73;65
05;Ávila;018;Avellaneda;37;18;19
05;Ávila;019;Ávila;47682;22915;24767
05;Ávila;021;Barco de Ávila (El);2649;1309;1340
05;Ávila;022;Barraco (El);2019;1024;995
05;Ávila;023;Barromán;256;144;112
05;Ávila;024;Becedas;424;224;200
05;Ávila;025;Becedillas;173;91;82
05;Ávila;026;Bercial de Zapardiel;322;153;169
05;Ávila;027;Berlanas (Las);341;180;161
05;Ávila;029;Bernuy-Zapardiel;242;136;106
05;Ávila;030;Berrocalejo de Aragona;47;26;21
05;Ávila;033;Blascomillán;293;141;152
05;Ávila;034;Blasconuño de Matacabras;18;10;8
05;Ávila;035;Blascosancho;149;74;75
05;Ávila;036;Bohodón (El);205;103;102
05;Ávila;037;Bohoyo;458;230;228
05;Ávila;038;Bonilla de la Sierra;198;108;90
05;Ávila;039;Brabos;70;39;31
05;Ávila;040;Bularros;120;66;54
05;Ávila;041;Burgohondo;1206;621;585
05;Ávila;042;Cabezas de Alambre;233;122;111
05;Ávila;043;Cabezas del Pozo;167;89;78
05;Ávila;044;Cabezas del Villar;492;255;237
05;Ávila;045;Cabizuela;158;80;78
05;Ávila;046;Canales;66;35;31
05;Ávila;047;Candeleda;5137;2641;2496
05;Ávila;048;Cantiveros;196;100;96
05;Ávila;049;Cardeñosa;576;303;273
05;Ávila;051;Carrera (La);294;139;155
05;Ávila;052;Casas del Puerto de Villatoro;104;56;48
05;Ávila;053;Casasola;170;89;81
05;Ávila;054;Casavieja;1605;830;775
05;Ávila;055;Casillas;851;438;413
05;Ávila;056;Castellanos de Zapardiel;143;80;63
05;Ávila;057;Cebreros;3317;1662;1655
05;Ávila;058;Cepeda la Mora;151;80;71
05;Ávila;067;Chamartín;117;66;51
05;Ávila;059;Cillán;151;80;71
05;Ávila;060;Cisla;200;99;101
05;Ávila;061;Colilla (La);208;106;102
05;Ávila;062;Collado de Contreras;271;148;123
05;Ávila;063;Collado del Mirón;86;45;41
05;Ávila;064;Constanzana;187;100;87
05;Ávila;065;Crespos;744;384;360
05;Ávila;066;Cuevas del Valle;663;358;305
05;Ávila;903;Diego del Carpio;309;164;145
05;Ávila;069;Donjimeno;142;76;66
05;Ávila;070;Donvidas;69;34;35
05;Ávila;072;Espinosa de los Caballeros;107;60;47
05;Ávila;073;Flores de Ávila;438;227;211
05;Ávila;074;Fontíveros;1023;521;502
05;Ávila;075;Fresnedilla;100;43;57
05;Ávila;076;Fresno (El);494;246;248
05;Ávila;077;Fuente el Saúz;327;172;155
05;Ávila;078;Fuentes de Año;206;110;96
05;Ávila;079;Gallegos de Altamiros;99;53;46
05;Ávila;080;Gallegos de Sobrinos;108;52;56
05;Ávila;081;Garganta del Villar;78;44;34
05;Ávila;082;Gavilanes;745;421;324
05;Ávila;083;Gemuño;225;106;119
05;Ávila;085;Gil García;66;32;34
05;Ávila;084;Gilbuena;141;79;62
05;Ávila;086;Gimialcón;119;64;55
05;Ávila;087;Gotarrendura;180;66;114
05;Ávila;088;Grandes y San Martín;50;25;25
05;Ávila;089;Guisando;660;352;308
05;Ávila;090;Gutierre-Muñoz;134;64;70
05;Ávila;092;Hernansancho;233;120;113
05;Ávila;093;Herradón de Pinares;516;263;253
05;Ávila;094;Herreros de Suso;238;117;121
05;Ávila;095;Higuera de las Dueñas;328;185;143
05;Ávila;096;Hija de Dios (La);112;63;49
05;Ávila;097;Horcajada (La);810;391;419
05;Ávila;099;Horcajo de las Torres;805;435;370
05;Ávila;100;Hornillo (El);421;215;206
05;Ávila;102;Hoyo de Pinares (El);2381;1215;1166
05;Ávila;101;Hoyocasero;387;200;187
05;Ávila;103;Hoyorredondo;123;64;59
05;Ávila;106;Hoyos de Miguel Muñoz;55;27;28
05;Ávila;104;Hoyos del Collado;51;31;20
05;Ávila;105;Hoyos del Espino;425;235;190
05;Ávila;107;Hurtumpascual;119;66;53
05;Ávila;108;Junciana;106;55;51
05;Ávila;109;Langa;591;304;287
05;Ávila;110;Lanzahíta;935;485;450
05;Ávila;113;Llanos de Tormes (Los);136;71;65
05;Ávila;112;Losar del Barco (El);145;74;71
05;Ávila;114;Madrigal de las Altas Torres;2010;1028;982
05;Ávila;115;Maello;666;330;336
05;Ávila;116;Malpartida de Corneja;214;107;107
05;Ávila;117;Mamblas;285;158;127
05;Ávila;118;Mancera de Arriba;151;76;75
05;Ávila;119;Manjabálago;72;38;34
05;Ávila;120;Marlín;48;26;22
05;Ávila;121;Martiherrero;202;108;94
05;Ávila;122;Martínez;245;130;115
05;Ávila;123;Mediana de Voltoya;109;60;49
05;Ávila;124;Medinilla;226;113;113
05;Ávila;125;Mengamuñoz;75;33;42
05;Ávila;126;Mesegar de Corneja;122;65;57
05;Ávila;127;Mijares;1009;519;490
05;Ávila;128;Mingorría;549;271;278
05;Ávila;129;Mirón (El);259;151;108
05;Ávila;130;Mironcillo;135;74;61
05;Ávila;131;Mirueña de los Infanzones;191;96;95
05;Ávila;132;Mombeltrán;1175;623;552
05;Ávila;133;Monsalupe;108;51;57
05;Ávila;134;Moraleja de Matacabras;81;37;44
05;Ávila;135;Muñana;586;303;283
05;Ávila;136;Muñico;150;78;72
05;Ávila;138;Muñogalindo;451;246;205
05;Ávila;139;Muñogrande;109;57;52
05;Ávila;140;Muñomer del Peco;134;72;62
05;Ávila;141;Muñopepe;106;59;47
05;Ávila;142;Muñosancho;166;75;91
05;Ávila;143;Muñotello;128;67;61
05;Ávila;144;Narrillos del Álamo;166;88;78
05;Ávila;145;Narrillos del Rebollar;78;39;39
05;Ávila;149;Narros de Saldueña;187;103;84
05;Ávila;147;Narros del Castillo;246;134;112
05;Ávila;148;Narros del Puerto;42;25;17
05;Ávila;152;Nava de Arévalo;996;518;478
05;Ávila;153;Nava del Barco;185;95;90
05;Ávila;151;Navacepedilla de Corneja;147;80;67
05;Ávila;154;Navadijos;63;36;27
05;Ávila;155;Navaescurial;88;50;38
05;Ávila;156;Navahondilla;133;80;53
05;Ávila;157;Navalacruz;315;156;159
05;Ávila;158;Navalmoral;614;313;301
05;Ávila;159;Navalonguilla;451;229;222
05;Ávila;160;Navalosa;510;267;243
05;Ávila;161;Navalperal de Pinares;873;422;451
05;Ávila;162;Navalperal de Tormes;142;78;64
05;Ávila;163;Navaluenga;2009;1017;992
05;Ávila;164;Navaquesera;64;24;40
05;Ávila;165;Navarredonda de Gredos;500;257;243
05;Ávila;166;Navarredondilla;328;160;168
05;Ávila;167;Navarrevisca;402;207;195
05;Ávila;168;Navas del Marqués (Las);4252;2132;2120
05;Ávila;169;Navatalgordo;346;177;169
05;Ávila;170;Navatejares;106;48;58
05;Ávila;171;Neila de San Miguel;125;65;60
05;Ávila;172;Niharra;200;103;97
05;Ávila;173;Ojos-Albos;60;29;31
05;Ávila;174;Orbita;107;52;55
05;Ávila;175;Oso (El);225;126;99
05;Ávila;176;Padiernos;233;120;113
05;Ávila;177;Pajares de Adaja;199;99;100
05;Ávila;178;Palacios de Goda;518;258;260
05;Ávila;179;Papatrigo;338;175;163
05;Ávila;180;Parral (El);132;70;62
05;Ávila;181;Pascualcobo;54;31;23
05;Ávila;182;Pedro Bernardo;1309;676;633
05;Ávila;183;Pedro-Rodríguez;219;103;116
05;Ávila;184;Peguerinos;311;163;148
05;Ávila;185;Peñalba de Ávila;119;68;51
05;Ávila;186;Piedrahíta;2168;1055;1113
05;Ávila;187;Piedralaves;2105;1061;1044
05;Ávila;188;Poveda;87;50;37
05;Ávila;189;Poyales del Hoyo;709;356;353
05;Ávila;190;Pozanco;51;29;22
05;Ávila;191;Pradosegar;178;94;84
05;Ávila;192;Puerto Castilla;147;84;63
05;Ávila;193;Rasueros;357;187;170
05;Ávila;194;Riocabado;206;113;93
05;Ávila;195;Riofrío;331;179;152
05;Ávila;196;Rivilla de Barajas;90;47;43
05;Ávila;197;Salobral;129;64;65
05;Ávila;198;Salvadiós;128;65;63
05;Ávila;199;San Bartolomé de Béjar;81;37;44
05;Ávila;200;San Bartolomé de Corneja;116;61;55
05;Ávila;201;San Bartolomé de Pinares;747;394;353
05;Ávila;206;San Esteban de los Patos;44;24;20
05;Ávila;208;San Esteban de Zapardiel;69;35;34
05;Ávila;207;San Esteban del Valle;896;460;436
05;Ávila;209;San García de Ingelmos;173;93;80
05;Ávila;901;San Juan de Gredos;406;212;194
05;Ávila;210;San Juan de la Encinilla;138;64;74
05;Ávila;211;San Juan de la Nava;695;364;331
05;Ávila;212;San Juan del Molinillo;343;191;152
05;Ávila;213;San Juan del Olmo;176;98;78
05;Ávila;214;San Lorenzo de Tormes;63;33;30
05;Ávila;215;San Martín de la Vega del Alberche;304;170;134
05;Ávila;216;San Martín del Pimpollar;334;181;153
05;Ávila;217;San Miguel de Corneja;116;54;62
05;Ávila;218;San Miguel de Serrezuela;216;115;101
05;Ávila;219;San Pascual;57;35;22
05;Ávila;220;San Pedro del Arroyo;486;251;235
05;Ávila;231;San Vicente de Arévalo;227;114;113
05;Ávila;204;Sanchidrián;780;396;384
05;Ávila;205;Sanchorreja;137;73;64
05;Ávila;222;Santa Cruz de Pinares;217;122;95
05;Ávila;221;Santa Cruz del Valle;663;340;323
05;Ávila;226;Santa María de los Caballeros;156;80;76
05;Ávila;224;Santa María del Arroyo;136;70;66
05;Ávila;225;Santa María del Berrocal;579;270;309
05;Ávila;902;Santa María del Cubillo;399;227;172
05;Ávila;227;Santa María del Tiétar;381;202;179
05;Ávila;228;Santiago del Collado;286;178;108
05;Ávila;904;Santiago del Tormes;280;142;138
05;Ávila;229;Santo Domingo de las Posadas;91;43;48
05;Ávila;230;Santo Tomé de Zabarcos;120;65;55
05;Ávila;232;Serrada (La);144;74;70
05;Ávila;233;Serranillos;433;224;209
05;Ávila;234;Sigeres;77;37;40
05;Ávila;235;Sinlabajos;246;124;122
05;Ávila;236;Solana de Ávila;215;115;100
05;Ávila;237;Solana de Rioalmar;296;158;138
05;Ávila;238;Solosancho;1070;558;512
05;Ávila;239;Sotalbo;260;133;127
05;Ávila;240;Sotillo de la Adrada;3508;1737;1771
05;Ávila;241;Tiemblo (El);3736;1876;1860
05;Ávila;242;Tiñosillos;787;413;374
05;Ávila;243;Tolbaños;134;66;68
05;Ávila;244;Tormellas;113;56;57
05;Ávila;245;Tornadizos de Ávila;352;172;180
05;Ávila;247;Torre (La);439;242;197
05;Ávila;246;Tórtoles;127;66;61
05;Ávila;249;Umbrías;174;91;83
05;Ávila;251;Vadillo de la Sierra;159;85;74
05;Ávila;252;Valdecasa;116;63;53
05;Ávila;253;Vega de Santa María;141;76;65
05;Ávila;254;Velayos;265;127;138
05;Ávila;256;Villaflor;169;88;81
05;Ávila;257;Villafranca de la Sierra;224;119;105
05;Ávila;905;Villanueva de Ávila;490;249;241
05;Ávila;258;Villanueva de Gómez;149;72;77
05;Ávila;259;Villanueva del Aceral;205;92;113
05;Ávila;260;Villanueva del Campillo;209;106;103
05;Ávila;261;Villar de Corneja;80;40;40
05;Ávila;262;Villarejo del Valle;512;264;248
05;Ávila;263;Villatoro;240;139;101
05;Ávila;264;Viñegra de Moraña;95;51;44
05;Ávila;265;Vita;123;75;48
05;Ávila;266;Zapardiel de la Cañada;197;98;99
05;Ávila;267;Zapardiel de la Ribera;140;71;69
06;Badajoz;001;Acedera;995;523;472
06;Badajoz;002;Aceuchal;5240;2595;2645
06;Badajoz;003;Ahillones;1211;595;616
06;Badajoz;004;Alange;2063;1055;1008
06;Badajoz;005;Albuera (La);1789;910;879
06;Badajoz;006;Alburquerque;5660;2843;2817
06;Badajoz;007;Alconchel;2153;1058;1095
06;Badajoz;008;Alconera;734;362;372
06;Badajoz;009;Aljucén;245;136;109
06;Badajoz;010;Almendral;1499;742;757
06;Badajoz;011;Almendralejo;27554;13482;14072
06;Badajoz;012;Arroyo de San Serván;3994;2062;1932
06;Badajoz;013;Atalaya;372;173;199
06;Badajoz;014;Azuaga;8924;4502;4422
06;Badajoz;015;Badajoz;136613;66335;70278
06;Badajoz;016;Barcarrota;3706;1898;1808
06;Badajoz;017;Baterno;404;211;193
06;Badajoz;018;Benquerencia de la Serena;1075;550;525
06;Badajoz;019;Berlanga;2721;1326;1395
06;Badajoz;020;Bienvenida;2375;1231;1144
06;Badajoz;021;Bodonal de la Sierra;1264;653;611
06;Badajoz;022;Burguillos del Cerro;3340;1618;1722
06;Badajoz;023;Cabeza del Buey;6071;2984;3087
06;Badajoz;024;Cabeza la Vaca;1655;816;839
06;Badajoz;025;Calamonte;6008;3005;3003
06;Badajoz;026;Calera de León;1111;560;551
06;Badajoz;027;Calzadilla de los Barros;848;415;433
06;Badajoz;028;Campanario;5765;2809;2956
06;Badajoz;029;Campillo de Llerena;1776;869;907
06;Badajoz;030;Capilla;226;109;117
06;Badajoz;031;Carmonita;672;346;326
06;Badajoz;032;Carrascalejo (El);56;33;23
06;Badajoz;033;Casas de Don Pedro;1780;871;909
06;Badajoz;034;Casas de Reina;251;118;133
06;Badajoz;035;Castilblanco;1418;699;719
06;Badajoz;036;Castuera;7354;3633;3721
06;Badajoz;042;Cheles;1349;669;680
06;Badajoz;037;Codosera (La);2375;1242;1133
06;Badajoz;038;Cordobilla de Lácara;1030;520;510
06;Badajoz;039;Coronada (La);2468;1230;1238
06;Badajoz;040;Corte de Peleas;1307;653;654
06;Badajoz;041;Cristina;572;300;272
06;Badajoz;043;Don Álvaro;670;327;343
06;Badajoz;044;Don Benito;31367;15488;15879
06;Badajoz;045;Entrín Bajo;676;333;343
06;Badajoz;046;Esparragalejo;1519;738;781
06;Badajoz;047;Esparragosa de la Serena;1136;562;574
06;Badajoz;048;Esparragosa de Lares;1201;581;620
06;Badajoz;049;Feria;1441;705;736
06;Badajoz;050;Fregenal de la Sierra;5360;2570;2790
06;Badajoz;051;Fuenlabrada de los Montes;2082;1032;1050
06;Badajoz;052;Fuente de Cantos;5039;2541;2498
06;Badajoz;053;Fuente del Arco;840;427;413
06;Badajoz;054;Fuente del Maestre;6860;3398;3462
06;Badajoz;055;Fuentes de León;2748;1352;1396
06;Badajoz;056;Garbayuela;593;314;279
06;Badajoz;057;Garlitos;791;397;394
06;Badajoz;058;Garrovilla (La);2638;1353;1285
06;Badajoz;059;Granja de Torrehermosa;2625;1301;1324
06;Badajoz;060;Guareña;7375;3701;3674
06;Badajoz;061;Haba (La);1465;741;724
06;Badajoz;062;Helechosa de los Montes;770;423;347
06;Badajoz;063;Herrera del Duque;3946;2003;1943
06;Badajoz;064;Higuera de la Serena;1252;633;619
06;Badajoz;065;Higuera de Llerena;475;233;242
06;Badajoz;066;Higuera de Vargas;2246;1119;1127
06;Badajoz;067;Higuera la Real;2696;1347;1349
06;Badajoz;068;Hinojosa del Valle;610;310;300
06;Badajoz;069;Hornachos;3815;1975;1840
06;Badajoz;070;Jerez de los Caballeros;9609;4807;4802
06;Badajoz;071;Lapa (La);337;171;166
06;Badajoz;073;Llera;974;497;477
06;Badajoz;074;Llerena;5670;2741;2929
06;Badajoz;072;Lobón;2737;1396;1341
06;Badajoz;075;Magacela;731;380;351
06;Badajoz;076;Maguilla;1168;576;592
06;Badajoz;077;Malcocinado;552;295;257
06;Badajoz;078;Malpartida de la Serena;794;405;389
06;Badajoz;079;Manchita;776;387;389
06;Badajoz;080;Medellín;2440;1229;1211
06;Badajoz;081;Medina de las Torres;1533;758;775
06;Badajoz;082;Mengabril;456;232;224
06;Badajoz;083;Mérida;50387;24604;25783
06;Badajoz;084;Mirandilla;1420;723;697
06;Badajoz;085;Monesterio;5057;2531;2526
06;Badajoz;086;Montemolín;1724;892;832
06;Badajoz;087;Monterrubio de la Serena;3131;1536;1595
06;Badajoz;088;Montijo;15332;7556;7776
06;Badajoz;089;Morera (La);785;387;398
06;Badajoz;090;Nava de Santiago (La);1202;601;601
06;Badajoz;091;Navalvillar de Pela;4957;2506;2451
06;Badajoz;092;Nogales;796;393;403
06;Badajoz;093;Oliva de la Frontera;5949;2956;2993
06;Badajoz;094;Oliva de Mérida;2009;995;1014
06;Badajoz;095;Olivenza;10585;5227;5358
06;Badajoz;096;Orellana de la Sierra;393;200;193
06;Badajoz;097;Orellana la Vieja;3522;1764;1758
06;Badajoz;098;Palomas;717;382;335
06;Badajoz;099;Parra (La);1390;718;672
06;Badajoz;100;Peñalsordo;1592;757;835
06;Badajoz;101;Peraleda del Zaucejo;677;346;331
06;Badajoz;102;Puebla de Alcocer;1492;725;767
06;Badajoz;103;Puebla de la Calzada;5526;2741;2785
06;Badajoz;104;Puebla de la Reina;897;457;440
06;Badajoz;107;Puebla de Obando;2036;1039;997
06;Badajoz;108;Puebla de Sancho Pérez;2914;1470;1444
06;Badajoz;105;Puebla del Maestre;960;471;489
06;Badajoz;106;Puebla del Prior;583;292;291
06;Badajoz;902;Pueblonuevo del Guadiana;"";"";""
06;Badajoz;109;Quintana de la Serena;5128;2587;2541
06;Badajoz;110;Reina;232;122;110
06;Badajoz;111;Rena;680;340;340
06;Badajoz;112;Retamal de Llerena;573;294;279
06;Badajoz;113;Ribera del Fresno;3431;1675;1756
06;Badajoz;114;Risco;220;108;112
06;Badajoz;115;Roca de la Sierra (La);1644;815;829
06;Badajoz;116;Salvaleón;2220;1111;1109
06;Badajoz;117;Salvatierra de los Barros;1974;973;1001
06;Badajoz;119;San Pedro de Mérida;811;412;399
06;Badajoz;123;San Vicente de Alcántara;5930;2924;3006
06;Badajoz;118;Sancti-Spíritus;308;145;163
06;Badajoz;120;Santa Amalia;4356;2176;2180
06;Badajoz;121;Santa Marta;4100;2013;2087
06;Badajoz;122;Santos de Maimona (Los);7938;3954;3984
06;Badajoz;124;Segura de León;2307;1146;1161
06;Badajoz;125;Siruela;2483;1227;1256
06;Badajoz;126;Solana de los Barros;2839;1421;1418
06;Badajoz;127;Talarrubias;3731;1842;1889
06;Badajoz;128;Talavera la Real;5307;2685;2622
06;Badajoz;129;Táliga;767;391;376
06;Badajoz;130;Tamurejo;282;140;142
06;Badajoz;131;Torre de Miguel Sesmero;1274;629;645
06;Badajoz;132;Torremayor;1089;523;566
06;Badajoz;133;Torremejía;2030;1029;1001
06;Badajoz;134;Trasierra;706;375;331
06;Badajoz;135;Trujillanos;1348;702;646
06;Badajoz;136;Usagre;2101;1060;1041
06;Badajoz;137;Valdecaballeros;1465;740;725
06;Badajoz;901;Valdelacalzada;2591;1342;1249
06;Badajoz;138;Valdetorres;1378;698;680
06;Badajoz;139;Valencia de las Torres;874;442;432
06;Badajoz;140;Valencia del Mombuey;832;403;429
06;Badajoz;141;Valencia del Ventoso;2417;1180;1237
06;Badajoz;146;Valle de la Serena;1612;792;820
06;Badajoz;147;Valle de Matamoros;519;256;263
06;Badajoz;148;Valle de Santa Ana;1271;644;627
06;Badajoz;142;Valverde de Burguillos;385;196;189
06;Badajoz;143;Valverde de Leganés;3751;1890;1861
06;Badajoz;144;Valverde de Llerena;847;402;445
06;Badajoz;145;Valverde de Mérida;1144;572;572
06;Badajoz;149;Villafranca de los Barros;12482;6173;6309
06;Badajoz;150;Villagarcía de la Torre;1022;517;505
06;Badajoz;151;Villagonzalo;1471;714;757
06;Badajoz;152;Villalba de los Barros;1757;900;857
06;Badajoz;153;Villanueva de la Serena;23717;11704;12013
06;Badajoz;154;Villanueva del Fresno;3522;1756;1766
06;Badajoz;156;Villar de Rena;1726;908;818
06;Badajoz;155;Villar del Rey;2323;1190;1133
06;Badajoz;157;Villarta de los Montes;696;342;354
06;Badajoz;158;Zafra;15059;7243;7816
06;Badajoz;159;Zahínos;3096;1551;1545
06;Badajoz;160;Zalamea de la Serena;4636;2273;2363
06;Badajoz;162;Zarza (La);3623;1826;1797
06;Badajoz;161;Zarza-Capilla;531;280;251
07;Balears (Illes);002;Alaior;7229;3584;3645
07;Balears (Illes);001;Alaró;3834;1834;2000
07;Balears (Illes);003;Alcúdia;11435;5754;5681
07;Balears (Illes);004;Algaida;3661;1835;1826
07;Balears (Illes);005;Andratx;8477;4249;4228
07;Balears (Illes);901;Ariany;774;389;385
07;Balears (Illes);006;Artà;6065;3025;3040
07;Balears (Illes);007;Banyalbufar;504;268;236
07;Balears (Illes);008;Binissalem;5097;2459;2638
07;Balears (Illes);009;Búger;938;473;465
07;Balears (Illes);010;Bunyola;4530;2236;2294
07;Balears (Illes);011;Calvià;35376;17699;17677
07;Balears (Illes);012;Campanet;2333;1150;1183
07;Balears (Illes);013;Campos;7040;3542;3498
07;Balears (Illes);014;Capdepera;7380;3692;3688
07;Balears (Illes);064;Castell (Es);6260;3160;3100
07;Balears (Illes);015;Ciutadella de Menorca;22341;11153;11188
07;Balears (Illes);016;Consell;2254;1124;1130
07;Balears (Illes);017;Costitx;876;419;457
07;Balears (Illes);018;Deyá;644;321;323
07;Balears (Illes);026;Eivissa;32700;16320;16380
07;Balears (Illes);019;Escorca;308;169;139
07;Balears (Illes);020;Esporles;3875;1923;1952
07;Balears (Illes);021;Estellencs;343;176;167
07;Balears (Illes);022;Felanitx;14900;7443;7457
07;Balears (Illes);023;Ferreries;3981;2086;1895
07;Balears (Illes);024;Formentera;5999;3055;2944
07;Balears (Illes);025;Fornalutx;590;296;294
07;Balears (Illes);027;Inca;21974;10870;11104
07;Balears (Illes);028;Lloret de Vistalegre;877;436;441
07;Balears (Illes);029;Lloseta;4523;2235;2288
07;Balears (Illes);030;Llubí;1883;936;947
07;Balears (Illes);031;Llucmajor;22811;11349;11462
07;Balears (Illes);032;Maó;22725;11098;11627
07;Balears (Illes);033;Manacor;30154;14950;15204
07;Balears (Illes);034;Mancor de la Vall;932;453;479
07;Balears (Illes);035;Maria de la Salut;1800;889;911
07;Balears (Illes);036;Marratxí;19451;9810;9641
07;Balears (Illes);037;Mercadal (Es);2896;1478;1418
07;Balears (Illes);902;Migjorn Gran (Es);1136;587;549
07;Balears (Illes);038;Montuïri;2250;1117;1133
07;Balears (Illes);039;Muro;6174;3070;3104
07;Balears (Illes);040;Palma de Mallorca;326993;158965;168028
07;Balears (Illes);041;Petra;2566;1243;1323
07;Balears (Illes);044;Pobla (Sa);10188;5242;4946
07;Balears (Illes);042;Pollença;13976;6973;7003
07;Balears (Illes);043;Porreres;4261;2150;2111
07;Balears (Illes);045;Puigpunyent;1223;610;613
07;Balears (Illes);059;Salines (Ses);3370;1723;1647
07;Balears (Illes);046;Sant Antoni de Portmany;15339;7780;7559
07;Balears (Illes);049;Sant Joan;1683;836;847
07;Balears (Illes);050;Sant Joan de Labritja;4063;2043;2020
07;Balears (Illes);048;Sant Josep de sa Talaia;13729;7014;6715
07;Balears (Illes);051;Sant Llorenç des Cardassar;5854;2923;2931
07;Balears (Illes);052;Sant Lluís;4257;2127;2130
07;Balears (Illes);053;Santa Eugènia;1143;564;579
07;Balears (Illes);054;Santa Eulalia del Río;21122;10772;10350
07;Balears (Illes);055;Santa Margalida;7493;3720;3773
07;Balears (Illes);056;Santa María del Camí;4672;2318;2354
07;Balears (Illes);057;Santanyí;8467;4267;4200
07;Balears (Illes);058;Selva;2909;1422;1487
07;Balears (Illes);047;Sencelles;2057;1051;1006
07;Balears (Illes);060;Sineu;2675;1300;1375
07;Balears (Illes);061;Sóller;11464;5693;5771
07;Balears (Illes);062;Son Servera;9009;4566;4443
07;Balears (Illes);063;Valldemossa;1651;799;852
07;Balears (Illes);065;Vilafranca de Bonany;2326;1145;1181
08;Barcelona;001;Abrera;7728;3972;3756
08;Barcelona;002;Aguilar de Segarra;213;106;107
08;Barcelona;014;Aiguafreda;2162;1061;1101
08;Barcelona;003;Alella;8176;4045;4131
08;Barcelona;004;Alpens;266;143;123
08;Barcelona;005;Ametlla del Vallès (L');5294;2601;2693
08;Barcelona;006;Arenys de Mar;12345;5948;6397
08;Barcelona;007;Arenys de Munt;6037;2992;3045
08;Barcelona;008;Argençola;195;103;92
08;Barcelona;009;Argentona;9213;4592;4621
08;Barcelona;010;Artés;4293;2128;2165
08;Barcelona;011;Avià;1816;922;894
08;Barcelona;012;Avinyó;1995;979;1016
08;Barcelona;013;Avinyonet del Penedès;1187;622;565
08;Barcelona;015;Badalona;209635;103531;106104
08;Barcelona;904;Badia del Vallès;15885;8028;7857
08;Barcelona;016;Bagà;2083;1005;1078
08;Barcelona;017;Balenyà;3127;1559;1568
08;Barcelona;018;Balsareny;3256;1608;1648
08;Barcelona;252;Barberà del Vallès;26342;13196;13146
08;Barcelona;019;Barcelona;1503451;702576;800875
08;Barcelona;020;Begues;3838;1946;1892
08;Barcelona;021;Bellprat;87;47;40
08;Barcelona;022;Berga;14173;6910;7263
08;Barcelona;023;Bigues i Riells;5006;2618;2388
08;Barcelona;024;Borredà;483;239;244
08;Barcelona;025;Bruc (El);977;519;458
08;Barcelona;026;Brull (El);191;104;87
08;Barcelona;027;Cabanyes (Les);516;273;243
08;Barcelona;029;Cabrera de Mar;3628;1856;1772
08;Barcelona;028;Cabrera d'Igualada;442;248;194
08;Barcelona;030;Cabrils;4352;2119;2233
08;Barcelona;031;Calaf;3052;1502;1550
08;Barcelona;034;Calders;710;367;343
08;Barcelona;033;Caldes de Montbui;12445;6157;6288
08;Barcelona;032;Caldes d'Estrac;1937;942;995
08;Barcelona;035;Calella;12503;6016;6487
08;Barcelona;037;Calldetenes;1920;980;940
08;Barcelona;038;Callús;1347;669;678
08;Barcelona;036;Calonge de Segarra;192;101;91
08;Barcelona;039;Campins;279;139;140
08;Barcelona;040;Canet de Mar;9852;4839;5013
08;Barcelona;041;Canovelles;13165;6609;6556
08;Barcelona;042;Cànoves i Samalús;1750;905;845
08;Barcelona;043;Canyelles;1684;893;791
08;Barcelona;044;Capellades;4928;2415;2513
08;Barcelona;045;Capolat;64;38;26
08;Barcelona;046;Cardedeu;11676;5802;5874
08;Barcelona;047;Cardona;5677;2753;2924
08;Barcelona;048;Carme;684;351;333
08;Barcelona;049;Casserres;1648;789;859
08;Barcelona;057;Castell de l'Areny;49;30;19
08;Barcelona;052;Castellar de n'Hug;186;93;93
08;Barcelona;050;Castellar del Riu;108;61;47
08;Barcelona;051;Castellar del Vallès;16863;8429;8434
08;Barcelona;053;Castellbell i el Vilar;2694;1338;1356
08;Barcelona;054;Castellbisbal;7269;3729;3540
08;Barcelona;055;Castellcir;356;197;159
08;Barcelona;056;Castelldefels;43307;21624;21683
08;Barcelona;058;Castellet i la Gornal;1348;680;668
08;Barcelona;060;Castellfollit de Riubregós;234;117;117
08;Barcelona;059;Castellfollit del Boix;366;178;188
08;Barcelona;061;Castellgalí;901;462;439
08;Barcelona;062;Castellnou de Bages;474;247;227
08;Barcelona;063;Castellolí;432;222;210
08;Barcelona;064;Castellterçol;2004;982;1022
08;Barcelona;065;Castellví de la Marca;1459;738;721
08;Barcelona;066;Castellví de Rosanes;1055;544;511
08;Barcelona;067;Centelles;5739;2836;2903
08;Barcelona;268;Cercs;1458;721;737
08;Barcelona;266;Cerdanyola del Vallès;52166;26168;25998
08;Barcelona;068;Cervelló;5617;2797;2820
08;Barcelona;069;Collbató;1882;1015;867
08;Barcelona;070;Collsuspina;250;132;118
08;Barcelona;071;Copons;271;129;142
08;Barcelona;072;Corbera de Llobregat;8708;4428;4280
08;Barcelona;073;Cornellà de Llobregat;80329;39415;40914
08;Barcelona;074;Cubelles;5918;3020;2898
08;Barcelona;075;Dosrius;2675;1371;1304
08;Barcelona;076;Esparreguera;16280;8225;8055
08;Barcelona;077;Esplugues de Llobregat;46304;22823;23481
08;Barcelona;078;Espunyola (L');286;145;141
08;Barcelona;079;Estany (L');395;186;209
08;Barcelona;134;Figaró-Montmany;777;409;368
08;Barcelona;080;Fígols;53;29;24
08;Barcelona;082;Fogars de la Selva;650;336;314
08;Barcelona;081;Fogars de Montclús;323;175;148
08;Barcelona;083;Folgueroles;1513;761;752
08;Barcelona;084;Fonollosa;907;463;444
08;Barcelona;085;Font-rubí;1219;629;590
08;Barcelona;086;Franqueses del Vallès (Les);11706;5852;5854
08;Barcelona;090;Gaià;163;86;77
08;Barcelona;087;Gallifa;160;85;75
08;Barcelona;088;Garriga (La);11274;5446;5828
08;Barcelona;089;Gavà;39214;19560;19654
08;Barcelona;091;Gelida;4270;2135;2135
08;Barcelona;092;Gironella;4913;2382;2531
08;Barcelona;093;Gisclareny;30;16;14
08;Barcelona;094;Granada (La);1333;640;693
08;Barcelona;095;Granera;66;43;23
08;Barcelona;096;Granollers;51925;25335;26590
08;Barcelona;097;Gualba;748;392;356
08;Barcelona;099;Guardiola de Berguedà;1002;502;500
08;Barcelona;100;Gurb;1874;951;923
08;Barcelona;101;Hospitalet de Llobregat (L');247986;121347;126639
08;Barcelona;162;Hostalets de Pierola (Els);1212;625;587
08;Barcelona;102;Igualada;32526;15774;16752
08;Barcelona;103;Jorba;577;280;297
08;Barcelona;104;Llacuna (La);833;432;401
08;Barcelona;105;Llagosta (La);11770;5867;5903
08;Barcelona;107;Lliçà d'Amunt;8995;4661;4334
08;Barcelona;108;Lliçà de Vall;4954;2536;2418
08;Barcelona;106;Llinars del Vallès;6710;3395;3315
08;Barcelona;109;Lluçà;282;156;126
08;Barcelona;110;Malgrat de Mar;13277;6601;6676
08;Barcelona;111;Malla;258;121;137
08;Barcelona;112;Manlleu;17360;8614;8746
08;Barcelona;113;Manresa;63688;30553;33135
08;Barcelona;242;Marganell;239;107;132
08;Barcelona;114;Martorell;19969;10016;9953
08;Barcelona;115;Martorelles;4891;2466;2425
08;Barcelona;116;Masies de Roda (Les);644;319;325
08;Barcelona;117;Masies de Voltregà (Les);2644;1288;1356
08;Barcelona;118;Masnou (El);21076;10197;10879
08;Barcelona;119;Masquefa;4143;2100;2043
08;Barcelona;120;Matadepera;6533;3296;3237
08;Barcelona;121;Mataró;104095;51054;53041
08;Barcelona;122;Mediona;1346;693;653
08;Barcelona;138;Moià;3922;1919;2003
08;Barcelona;123;Molins de Rei;19366;9520;9846
08;Barcelona;124;Mollet del Vallès;45324;22663;22661
08;Barcelona;128;Monistrol de Calders;598;292;306
08;Barcelona;127;Monistrol de Montserrat;2498;1265;1233
08;Barcelona;125;Montcada i Reixac;27348;13459;13889
08;Barcelona;130;Montclar;117;60;57
08;Barcelona;131;Montesquiu;849;417;432
08;Barcelona;126;Montgat;8089;3984;4105
08;Barcelona;132;Montmajor;488;250;238
08;Barcelona;133;Montmaneu;205;112;93
08;Barcelona;135;Montmeló;8332;4162;4170
08;Barcelona;136;Montornès del Vallès;12195;6112;6083
08;Barcelona;137;Montseny;305;158;147
08;Barcelona;129;Muntanyola;274;148;126
08;Barcelona;139;Mura;225;120;105
08;Barcelona;140;Navarcles;5285;2626;2659
08;Barcelona;141;Navàs;5813;2865;2948
08;Barcelona;142;Nou de Berguedà (La);152;81;71
08;Barcelona;143;Òdena;2686;1338;1348
08;Barcelona;145;Olèrdola;2121;1087;1034
08;Barcelona;146;Olesa de Bonesvalls;876;464;412
08;Barcelona;147;Olesa de Montserrat;16750;8438;8312
08;Barcelona;148;Olivella;1165;625;540
08;Barcelona;149;Olost;1185;578;607
08;Barcelona;144;Olvan;922;449;473
08;Barcelona;150;Orís;230;116;114
08;Barcelona;151;Oristà;663;324;339
08;Barcelona;152;Orpí;146;75;71
08;Barcelona;153;Òrrius;441;231;210
08;Barcelona;154;Pacs del Penedès;652;325;327
08;Barcelona;155;Palafolls;4940;2464;2476
08;Barcelona;156;Palau-solità i Plegamans;10760;5493;5267
08;Barcelona;157;Pallejà;7128;3587;3541
08;Barcelona;905;Palma de Cervelló (La);2519;1276;1243
08;Barcelona;158;Papiol (El);3434;1703;1731
08;Barcelona;159;Parets del Vallès;14008;7062;6946
08;Barcelona;160;Perafita;344;174;170
08;Barcelona;161;Piera;8031;4089;3942
08;Barcelona;163;Pineda de Mar;19209;9570;9639
08;Barcelona;164;Pla del Penedès (El);915;452;463
08;Barcelona;165;Pobla de Claramunt (La);1657;840;817
08;Barcelona;166;Pobla de Lillet (La);1488;735;753
08;Barcelona;167;Polinyà;4412;2268;2144
08;Barcelona;182;Pont de Vilomara i Rocafort (El);2578;1317;1261
08;Barcelona;168;Pontons;349;189;160
08;Barcelona;169;Prat de Llobregat (El);62773;31399;31374
08;Barcelona;171;Prats de Lluçanès;2737;1347;1390
08;Barcelona;170;Prats de Rei (Els);551;273;278
08;Barcelona;230;Premià de Dalt;8454;4223;4231
08;Barcelona;172;Premià de Mar;25882;12877;13005
08;Barcelona;174;Puigdàlber;337;157;180
08;Barcelona;175;Puig-reig;4397;2135;2262
08;Barcelona;176;Pujalt;181;92;89
08;Barcelona;177;Quar (La);64;33;31
08;Barcelona;178;Rajadell;372;195;177
08;Barcelona;179;Rellinars;343;178;165
08;Barcelona;180;Ripollet;29358;14676;14682
08;Barcelona;181;Roca del Vallès (La);7136;3583;3553
08;Barcelona;183;Roda de Ter;5137;2472;2665
08;Barcelona;184;Rubí;57030;28584;28446
08;Barcelona;185;Rubió;122;65;57
08;Barcelona;901;Rupit i Pruit;356;182;174
08;Barcelona;187;Sabadell;184859;89881;94978
08;Barcelona;188;Sagàs;161;85;76
08;Barcelona;190;Saldes;337;189;148
08;Barcelona;191;Sallent;7261;3508;3753
08;Barcelona;194;Sant Adrià de Besòs;32823;16176;16647
08;Barcelona;195;Sant Agustí de Lluçanès;111;60;51
08;Barcelona;196;Sant Andreu de la Barca;18854;9602;9252
08;Barcelona;197;Sant Andreu de Llavaneres;6767;3374;3393
08;Barcelona;198;Sant Antoni de Vilamajor;3063;1528;1535
08;Barcelona;199;Sant Bartomeu del Grau;1213;647;566
08;Barcelona;200;Sant Boi de Llobregat;79050;39317;39733
08;Barcelona;201;Sant Boi de Lluçanès;552;273;279
08;Barcelona;203;Sant Cebrià de Vallalta;1625;870;755
08;Barcelona;202;Sant Celoni;12840;6382;6458
08;Barcelona;204;Sant Climent de Llobregat;2866;1429;1437
08;Barcelona;205;Sant Cugat del Vallès;50168;24717;25451
08;Barcelona;206;Sant Cugat Sesgarrigues;728;383;345
08;Barcelona;207;Sant Esteve de Palautordera;1363;688;675
08;Barcelona;208;Sant Esteve Sesrovires;4849;2577;2272
08;Barcelona;210;Sant Feliu de Codines;4179;2070;2109
08;Barcelona;211;Sant Feliu de Llobregat;36953;18256;18697
08;Barcelona;212;Sant Feliu Sasserra;656;323;333
08;Barcelona;209;Sant Fost de Campsentelles;6034;3077;2957
08;Barcelona;213;Sant Fruitós de Bages;5453;2724;2729
08;Barcelona;215;Sant Hipòlit de Voltregà;2981;1466;1515
08;Barcelona;193;Sant Iscle de Vallalta;786;417;369
08;Barcelona;216;Sant Jaume de Frontanyà;30;16;14
08;Barcelona;218;Sant Joan de Vilatorrada;8917;4472;4445
08;Barcelona;217;Sant Joan Despí;27470;13571;13899
08;Barcelona;903;Sant Julià de Cerdanyola;213;111;102
08;Barcelona;220;Sant Julià de Vilatorta;2203;1083;1120
08;Barcelona;221;Sant Just Desvern;13883;6683;7200
08;Barcelona;222;Sant Llorenç d'Hortons;1502;757;745
08;Barcelona;223;Sant Llorenç Savall;2027;987;1040
08;Barcelona;225;Sant Martí d'Albars;129;63;66
08;Barcelona;224;Sant Martí de Centelles;706;363;343
08;Barcelona;226;Sant Martí de Tous;968;484;484
08;Barcelona;227;Sant Martí Sarroca;2457;1240;1217
08;Barcelona;228;Sant Martí Sesgueioles;355;176;179
08;Barcelona;229;Sant Mateu de Bages;506;259;247
08;Barcelona;231;Sant Pere de Ribes;21057;10652;10405
08;Barcelona;232;Sant Pere de Riudebitlles;2098;1032;1066
08;Barcelona;233;Sant Pere de Torelló;2202;1073;1129
08;Barcelona;234;Sant Pere de Vilamajor;2326;1202;1124
08;Barcelona;189;Sant Pere Sallavinera;158;79;79
08;Barcelona;235;Sant Pol de Mar;3413;1753;1660
08;Barcelona;236;Sant Quintí de Mediona;1632;804;828
08;Barcelona;237;Sant Quirze de Besora;1986;972;1014
08;Barcelona;238;Sant Quirze del Vallès;11994;5990;6004
08;Barcelona;239;Sant Quirze Safaja;333;181;152
08;Barcelona;240;Sant Sadurní d'Anoia;9387;4662;4725
08;Barcelona;241;Sant Sadurní d'Osormort;76;43;33
08;Barcelona;098;Sant Salvador de Guardiola;1891;958;933
08;Barcelona;262;Sant Vicenç de Castellet;7323;3525;3798
08;Barcelona;264;Sant Vicenç de Montalt;2920;1503;1417
08;Barcelona;265;Sant Vicenç de Torelló;1748;834;914
08;Barcelona;263;Sant Vicenç dels Horts;24065;12091;11974
08;Barcelona;243;Santa Cecilia de Voltregà;201;115;86
08;Barcelona;244;Santa Coloma de Cervelló;4116;2057;2059
08;Barcelona;245;Santa Coloma de Gramenet;120802;60100;60702
08;Barcelona;246;Santa Eugènia de Berga;1955;996;959
08;Barcelona;247;Santa Eulàlia de Riuprimer;862;445;417
08;Barcelona;248;Santa Eulàlia de Ronçana;4365;2192;2173
08;Barcelona;249;Santa Fe del Penedès;284;135;149
08;Barcelona;250;Santa Margarida de Montbui;9181;4559;4622
08;Barcelona;251;Santa Margarida i els Monjos;4544;2315;2229
08;Barcelona;253;Santa Maria de Besora;177;87;90
08;Barcelona;254;Santa Maria de Corcó;2039;1027;1012
08;Barcelona;256;Santa Maria de Martorelles;716;345;371
08;Barcelona;255;Santa Maria de Merlès;172;85;87
08;Barcelona;257;Santa Maria de Miralles;89;45;44
08;Barcelona;259;Santa Maria de Palautordera;6047;3059;2988
08;Barcelona;258;Santa Maria d'Oló;990;503;487
08;Barcelona;260;Santa Perpètua de Mogoda;18670;9423;9247
08;Barcelona;261;Santa Susanna;1779;894;885
08;Barcelona;192;Santpedor;5242;2569;2673
08;Barcelona;267;Sentmenat;5469;2725;2744
08;Barcelona;269;Seva;2444;1247;1197
08;Barcelona;270;Sitges;18546;4541;14005
08;Barcelona;271;Sobremunt;86;41;45
08;Barcelona;272;Sora;182;100;82
08;Barcelona;273;Subirats;2432;1236;1196
08;Barcelona;274;Súria;6193;3038;3155
08;Barcelona;276;Tagamanent;197;109;88
08;Barcelona;277;Talamanca;82;47;35
08;Barcelona;278;Taradell;4877;2410;2467
08;Barcelona;275;Tavèrnoles;269;131;138
08;Barcelona;280;Tavertet;135;75;60
08;Barcelona;281;Teià;5065;2562;2503
08;Barcelona;279;Terrassa;168695;82369;86326
08;Barcelona;282;Tiana;5565;2759;2806
08;Barcelona;283;Tona;5842;2893;2949
08;Barcelona;284;Tordera;9506;4816;4690
08;Barcelona;285;Torelló;12077;5879;6198
08;Barcelona;286;Torre de Claramunt (La);2198;1147;1051
08;Barcelona;287;Torrelavit;1177;595;582
08;Barcelona;288;Torrelles de Foix;1702;901;801
08;Barcelona;289;Torrelles de Llobregat;3377;1709;1668
08;Barcelona;290;Ullastrell;1079;554;525
08;Barcelona;291;Vacarisses;2349;1236;1113
08;Barcelona;292;Vallbona d'Anoia;1065;545;520
08;Barcelona;293;Vallcebre;271;147;124
08;Barcelona;294;Vallgorguina;1252;649;603
08;Barcelona;295;Vallirana;8914;4517;4397
08;Barcelona;296;Vallromanes;1209;628;581
08;Barcelona;297;Veciana;148;82;66
08;Barcelona;298;Vic;31090;14964;16126
08;Barcelona;299;Vilada;534;276;258
08;Barcelona;301;Viladecans;55575;28028;27547
08;Barcelona;300;Viladecavalls;5509;2776;2733
08;Barcelona;305;Vilafranca del Penedès;29273;14350;14923
08;Barcelona;306;Vilalba Sasserra;446;237;209
08;Barcelona;303;Vilanova de Sau;317;149;168
08;Barcelona;302;Vilanova del Camí;10111;5076;5035
08;Barcelona;902;Vilanova del Vallès;2224;1125;1099
08;Barcelona;307;Vilanova i la Geltrú;51409;25262;26147
08;Barcelona;214;Vilassar de Dalt;7417;3678;3739
08;Barcelona;219;Vilassar de Mar;16572;8181;8391
08;Barcelona;304;Vilobí del Penedès;874;448;426
08;Barcelona;308;Viver i Serrateix;193;98;95
09;Burgos;001;Abajas;30;15;15
09;Burgos;003;Adrada de Haza;285;155;130
09;Burgos;006;Aguas Cándidas;92;53;39
09;Burgos;007;Aguilar de Bureba;91;50;41
09;Burgos;009;Albillos;157;89;68
09;Burgos;010;Alcocero de Mola;56;34;22
09;Burgos;011;Alfoz de Bricia;143;70;73
09;Burgos;907;Alfoz de Quintanadueñas;635;339;296
09;Burgos;012;Alfoz de Santa Gadea;177;93;84
09;Burgos;013;Altable;61;38;23
09;Burgos;014;Altos (Los);235;139;96
09;Burgos;016;Ameyugo;64;34;30
09;Burgos;017;Anguix;152;77;75
09;Burgos;018;Aranda de Duero;29695;14802;14893
09;Burgos;019;Arandilla;197;114;83
09;Burgos;020;Arauzo de Miel;399;218;181
09;Burgos;021;Arauzo de Salce;75;42;33
09;Burgos;022;Arauzo de Torre;111;60;51
09;Burgos;023;Arcos;250;140;110
09;Burgos;024;Arenillas de Riopisuerga;230;123;107
09;Burgos;025;Arija;228;108;120
09;Burgos;026;Arlanzón;420;226;194
09;Burgos;027;Arraya de Oca;54;27;27
09;Burgos;029;Atapuerca;204;102;102
09;Burgos;030;Ausines (Los);132;73;59
09;Burgos;032;Avellanosa de Muñó;166;87;79
09;Burgos;033;Bahabón de Esgueva;141;81;60
09;Burgos;034;Balbases (Los);376;197;179
09;Burgos;035;Baños de Valdearados;490;269;221
09;Burgos;036;Bañuelos de Bureba;46;28;18
09;Burgos;037;Barbadillo de Herreros;154;87;67
09;Burgos;038;Barbadillo del Mercado;172;97;75
09;Burgos;039;Barbadillo del Pez;114;61;53
09;Burgos;041;Barrio de Muñó;37;22;15
09;Burgos;043;Barrios de Bureba (Los);280;150;130
09;Burgos;044;Barrios de Colina;80;44;36
09;Burgos;045;Basconcillos del Tozo;381;203;178
09;Burgos;046;Bascuñana;69;39;30
09;Burgos;047;Belbimbre;75;41;34
09;Burgos;048;Belorado;2094;1060;1034
09;Burgos;050;Berberana;87;43;44
09;Burgos;051;Berlangas de Roa;267;138;129
09;Burgos;052;Berzosa de Bureba;53;31;22
09;Burgos;054;Bozoó;112;61;51
09;Burgos;055;Brazacorta;102;57;45
09;Burgos;056;Briviesca;6128;3040;3088
09;Burgos;057;Bugedo;99;72;27
09;Burgos;058;Buniel;178;96;82
09;Burgos;059;Burgos;162802;78560;84242
09;Burgos;060;Busto de Bureba;237;126;111
09;Burgos;061;Cabañes de Esgueva;274;144;130
09;Burgos;062;Cabezón de la Sierra;72;32;40
09;Burgos;063;Cabia;241;130;111
09;Burgos;064;Caleruega;416;222;194
09;Burgos;065;Campillo de Aranda;194;104;90
09;Burgos;066;Campolara;103;57;46
09;Burgos;067;Canicosa de la Sierra;644;332;312
09;Burgos;068;Cantabrana;53;29;24
09;Burgos;070;Carazo;48;28;20
09;Burgos;071;Carcedo de Bureba;51;27;24
09;Burgos;072;Carcedo de Burgos;154;90;64
09;Burgos;073;Cardeñadijo;506;263;243
09;Burgos;074;Cardeñajimeno;419;228;191
09;Burgos;075;Cardeñuela Riopico;99;53;46
09;Burgos;076;Carrias;53;35;18
09;Burgos;077;Cascajares de Bureba;62;36;26
09;Burgos;078;Cascajares de la Sierra;27;11;16
09;Burgos;079;Castellanos de Castro;68;38;30
09;Burgos;083;Castil de Peones;34;16;18
09;Burgos;082;Castildelgado;79;38;41
09;Burgos;084;Castrillo de la Reina;297;181;116
09;Burgos;085;Castrillo de la Vega;583;312;271
09;Burgos;088;Castrillo de Riopisuerga;92;47;45
09;Burgos;086;Castrillo del Val;388;220;168
09;Burgos;090;Castrillo Matajudíos;80;39;41
09;Burgos;091;Castrojeriz;1024;526;498
09;Burgos;093;Cayuela;116;67;49
09;Burgos;094;Cebrecos;79;47;32
09;Burgos;095;Celada del Camino;100;46;54
09;Burgos;098;Cerezo de Río Tirón;774;409;365
09;Burgos;100;Cerratón de Juarros;81;44;37
09;Burgos;101;Ciadoncha;131;76;55
09;Burgos;102;Cillaperlata;73;38;35
09;Burgos;103;Cilleruelo de Abajo;333;186;147
09;Burgos;104;Cilleruelo de Arriba;87;48;39
09;Burgos;105;Ciruelos de Cervera;171;90;81
09;Burgos;108;Cogollos;241;129;112
09;Burgos;109;Condado de Treviño;952;530;422
09;Burgos;110;Contreras;121;76;45
09;Burgos;112;Coruña del Conde;175;96;79
09;Burgos;113;Covarrubias;619;324;295
09;Burgos;114;Cubillo del Campo;75;41;34
09;Burgos;115;Cubo de Bureba;117;59;58
09;Burgos;117;Cueva de Roa (La);116;65;51
09;Burgos;119;Cuevas de San Clemente;62;30;32
09;Burgos;120;Encío;64;32;32
09;Burgos;122;Espinosa de Cervera;115;69;46
09;Burgos;124;Espinosa de los Monteros;2236;1143;1093
09;Burgos;123;Espinosa del Camino;46;24;22
09;Burgos;125;Estépar;850;457;393
09;Burgos;127;Fontioso;86;46;40
09;Burgos;128;Frandovínez;95;52;43
09;Burgos;129;Fresneda de la Sierra Tirón;102;56;46
09;Burgos;130;Fresneña;118;63;55
09;Burgos;131;Fresnillo de las Dueñas;307;158;149
09;Burgos;132;Fresno de Río Tirón;265;153;112
09;Burgos;133;Fresno de Rodilla;50;27;23
09;Burgos;134;Frías;296;158;138
09;Burgos;135;Fuentebureba;82;40;42
09;Burgos;136;Fuentecén;271;148;123
09;Burgos;137;Fuentelcésped;183;87;96
09;Burgos;138;Fuentelisendo;121;63;58
09;Burgos;139;Fuentemolinos;121;69;52
09;Burgos;140;Fuentenebro;203;108;95
09;Burgos;141;Fuentespina;597;318;279
09;Burgos;143;Galbarros;32;22;10
09;Burgos;144;Gallega (La);98;56;42
09;Burgos;148;Grijalba;137;67;70
09;Burgos;149;Grisaleña;49;32;17
09;Burgos;151;Gumiel de Izán;629;336;293
09;Burgos;152;Gumiel de Mercado;387;209;178
09;Burgos;154;Hacinas;209;116;93
09;Burgos;155;Haza;41;21;20
09;Burgos;159;Hontanas;72;40;32
09;Burgos;160;Hontangas;151;87;64
09;Burgos;162;Hontoria de la Cantera;131;64;67
09;Burgos;164;Hontoria de Valdearados;224;140;84
09;Burgos;163;Hontoria del Pinar;911;492;419
09;Burgos;166;Hormazas (Las);149;82;67
09;Burgos;167;Hornillos del Camino;77;43;34
09;Burgos;168;Horra (La);454;240;214
09;Burgos;169;Hortigüela;130;84;46
09;Burgos;170;Hoyales de Roa;308;151;157
09;Burgos;172;Huérmeces;152;86;66
09;Burgos;173;Huerta de Arriba;192;99;93
09;Burgos;174;Huerta de Rey;1175;614;561
09;Burgos;175;Humada;236;138;98
09;Burgos;176;Hurones;60;39;21
09;Burgos;177;Ibeas de Juarros;979;537;442
09;Burgos;178;Ibrillos;100;58;42
09;Burgos;179;Iglesiarrubia;62;34;28
09;Burgos;180;Iglesias;197;109;88
09;Burgos;181;Isar;434;204;230
09;Burgos;182;Itero del Castillo;127;68;59
09;Burgos;183;Jaramillo de la Fuente;38;22;16
09;Burgos;184;Jaramillo Quemado;23;16;7
09;Burgos;189;Junta de Traslaloma;196;103;93
09;Burgos;190;Junta de Villalba de Losa;95;47;48
09;Burgos;191;Jurisdicción de Lara;78;45;33
09;Burgos;192;Jurisdicción de San Zadornil;97;46;51
09;Burgos;194;Lerma;2527;1258;1269
09;Burgos;195;Llano de Bureba;56;34;22
09;Burgos;196;Madrigal del Monte;199;109;90
09;Burgos;197;Madrigalejo del Monte;164;91;73
09;Burgos;198;Mahamud;169;84;85
09;Burgos;199;Mambrilla de Castrejón;156;80;76
09;Burgos;200;Mambrillas de Lara;83;44;39
09;Burgos;201;Mamolar;72;37;35
09;Burgos;202;Manciles;50;27;23
09;Burgos;206;Mazuela;89;46;43
09;Burgos;208;Mecerreyes;310;161;149
09;Burgos;209;Medina de Pomar;5026;2518;2508
09;Burgos;211;Melgar de Fernamental;2026;1040;986
09;Burgos;213;Merindad de Cuesta-Urria;513;289;224
09;Burgos;214;Merindad de Montija;965;518;447
09;Burgos;906;Merindad de Río Ubierna;1282;656;626
09;Burgos;215;Merindad de Sotoscueva;606;327;279
09;Burgos;216;Merindad de Valdeporres;572;292;280
09;Burgos;217;Merindad de Valdivielso;560;292;268
09;Burgos;218;Milagros;466;252;214
09;Burgos;219;Miranda de Ebro;35547;17590;17957
09;Burgos;220;Miraveche;119;67;52
09;Burgos;221;Modúbar de la Emparedada;248;137;111
09;Burgos;223;Monasterio de la Sierra;40;23;17
09;Burgos;224;Monasterio de Rodilla;229;127;102
09;Burgos;225;Moncalvillo;129;76;53
09;Burgos;226;Monterrubio de la Demanda;89;50;39
09;Burgos;227;Montorio;178;91;87
09;Burgos;228;Moradillo de Roa;225;120;105
09;Burgos;229;Nava de Roa;272;143;129
09;Burgos;230;Navas de Bureba;52;26;26
09;Burgos;231;Nebreda;109;68;41
09;Burgos;232;Neila;238;116;122
09;Burgos;235;Olmedillo de Roa;216;115;101
09;Burgos;236;Olmillos de Muñó;46;25;21
09;Burgos;238;Oña;1673;838;835
09;Burgos;239;Oquillas;80;44;36
09;Burgos;241;Orbaneja Riopico;155;90;65
09;Burgos;242;Padilla de Abajo;103;60;43
09;Burgos;243;Padilla de Arriba;131;68;63
09;Burgos;244;Padrones de Bureba;75;41;34
09;Burgos;246;Palacios de la Sierra;880;454;426
09;Burgos;247;Palacios de Riopisuerga;34;18;16
09;Burgos;248;Palazuelos de la Sierra;70;35;35
09;Burgos;249;Palazuelos de Muñó;67;37;30
09;Burgos;250;Pampliega;428;216;212
09;Burgos;251;Pancorbo;499;261;238
09;Burgos;253;Pardilla;123;67;56
09;Burgos;255;Partido de la Sierra en Tobalina;82;49;33
09;Burgos;256;Pedrosa de Duero;578;299;279
09;Burgos;259;Pedrosa de Río Úrbel;280;156;124
09;Burgos;257;Pedrosa del Páramo;118;64;54
09;Burgos;258;Pedrosa del Príncipe;293;154;139
09;Burgos;261;Peñaranda de Duero;602;322;280
09;Burgos;262;Peral de Arlanza;251;129;122
09;Burgos;265;Piérnigas;46;29;17
09;Burgos;266;Pineda de la Sierra;120;66;54
09;Burgos;267;Pineda Trasmonte;189;100;89
09;Burgos;268;Pinilla de los Barruecos;141;74;67
09;Burgos;269;Pinilla de los Moros;51;33;18
09;Burgos;270;Pinilla Trasmonte;226;127;99
09;Burgos;272;Poza de la Sal;377;187;190
09;Burgos;273;Prádanos de Bureba;71;38;33
09;Burgos;274;Pradoluengo;1733;846;887
09;Burgos;275;Presencio;281;149;132
09;Burgos;276;Puebla de Arganzón (La);361;198;163
09;Burgos;277;Puentedura;133;74;59
09;Burgos;279;Quemada;254;142;112
09;Burgos;281;Quintana del Pidio;200;107;93
09;Burgos;280;Quintanabureba;35;19;16
09;Burgos;283;Quintanaélez;102;50;52
09;Burgos;287;Quintanaortuño;137;70;67
09;Burgos;288;Quintanapalla;115;61;54
09;Burgos;289;Quintanar de la Sierra;2128;1093;1035
09;Burgos;292;Quintanavides;84;39;45
09;Burgos;294;Quintanilla de la Mata;166;90;76
09;Burgos;901;Quintanilla del Agua y Tordueles;586;304;282
09;Burgos;295;Quintanilla del Coco;119;61;58
09;Burgos;298;Quintanilla San García;109;51;58
09;Burgos;301;Quintanilla Vivar;435;218;217
09;Burgos;297;Quintanillas (Las);348;185;163
09;Burgos;302;Rabanera del Pinar;138;72;66
09;Burgos;303;Rábanos;90;55;35
09;Burgos;304;Rabé de las Calzadas;173;93;80
09;Burgos;306;Rebolledo de la Torre;172;97;75
09;Burgos;307;Redecilla del Camino;146;87;59
09;Burgos;308;Redecilla del Campo;90;46;44
09;Burgos;309;Regumiel de la Sierra;505;254;251
09;Burgos;310;Reinoso;26;18;8
09;Burgos;311;Retuerta;76;43;33
09;Burgos;314;Revilla del Campo;131;66;65
09;Burgos;316;Revilla Vallejera;171;96;75
09;Burgos;312;Revilla y Ahedo (La);122;65;57
09;Burgos;315;Revillarruz;152;79;73
09;Burgos;317;Rezmondo;21;10;11
09;Burgos;318;Riocavado de la Sierra;75;41;34
09;Burgos;321;Roa;2266;1156;1110
09;Burgos;323;Rojas;101;56;45
09;Burgos;325;Royuela de Río Franco;341;190;151
09;Burgos;326;Rubena;158;82;76
09;Burgos;327;Rublacedo de Abajo;41;21;20
09;Burgos;328;Rucandio;115;57;58
09;Burgos;329;Salas de Bureba;164;92;72
09;Burgos;330;Salas de los Infantes;2063;1033;1030
09;Burgos;332;Saldaña de Burgos;121;67;54
09;Burgos;334;Salinillas de Bureba;68;37;31
09;Burgos;335;San Adrián de Juarros;49;27;22
09;Burgos;337;San Juan del Monte;175;92;83
09;Burgos;338;San Mamés de Burgos;189;106;83
09;Burgos;339;San Martín de Rubiales;267;139;128
09;Burgos;340;San Millán de Lara;87;53;34
09;Burgos;360;San Vicente del Valle;41;26;15
09;Burgos;343;Santa Cecilia;136;74;62
09;Burgos;345;Santa Cruz de la Salceda;201;112;89
09;Burgos;346;Santa Cruz del Valle Urbión;130;76;54
09;Burgos;347;Santa Gadea del Cid;183;98;85
09;Burgos;348;Santa Inés;207;113;94
09;Burgos;350;Santa María del Campo;732;377;355
09;Burgos;351;Santa María del Invierno;59;37;22
09;Burgos;352;Santa María del Mercadillo;191;111;80
09;Burgos;353;Santa María Rivarredonda;127;71;56
09;Burgos;354;Santa Olalla de Bureba;40;16;24
09;Burgos;355;Santibáñez de Esgueva;163;80;83
09;Burgos;356;Santibáñez del Val;60;37;23
09;Burgos;358;Santo Domingo de Silos;311;196;115
09;Burgos;361;Sargentes de la Lora;172;95;77
09;Burgos;362;Sarracín;194;110;84
09;Burgos;363;Sasamón;1538;826;712
09;Burgos;365;Sequera de Haza (La);63;36;27
09;Burgos;366;Solarana;115;66;49
09;Burgos;368;Sordillos;41;25;16
09;Burgos;369;Sotillo de la Ribera;619;340;279
09;Burgos;372;Sotragero;151;80;71
09;Burgos;373;Sotresgudo;753;407;346
09;Burgos;374;Susinos del Páramo;110;51;59
09;Burgos;375;Tamarón;52;32;20
09;Burgos;377;Tardajos;662;355;307
09;Burgos;378;Tejada;49;29;20
09;Burgos;380;Terradillos de Esgueva;129;64;65
09;Burgos;381;Tinieblas de la Sierra;50;21;29
09;Burgos;382;Tobar;52;29;23
09;Burgos;384;Tordómar;412;231;181
09;Burgos;386;Torrecilla del Monte;74;42;32
09;Burgos;387;Torregalindo;143;82;61
09;Burgos;388;Torrelara;29;15;14
09;Burgos;389;Torrepadre;133;74;59
09;Burgos;390;Torresandino;829;445;384
09;Burgos;391;Tórtoles de Esgueva;539;302;237
09;Burgos;392;Tosantos;74;38;36
09;Burgos;394;Trespaderne;1072;556;516
09;Burgos;395;Tubilla del Agua;197;124;73
09;Burgos;396;Tubilla del Lago;202;107;95
09;Burgos;398;Úrbel del Castillo;95;56;39
09;Burgos;400;Vadocondes;450;233;217
09;Burgos;403;Valdeande;151;87;64
09;Burgos;405;Valdezate;202;107;95
09;Burgos;406;Valdorros;120;65;55
09;Burgos;408;Vallarta de Bureba;72;40;32
09;Burgos;904;Valle de las Navas;650;359;291
09;Burgos;908;Valle de Losa;683;393;290
09;Burgos;409;Valle de Manzanedo;128;67;61
09;Burgos;410;Valle de Mena;3339;1717;1622
09;Burgos;411;Valle de Oca;219;110;109
09;Burgos;902;Valle de Santibáñez;646;330;316
09;Burgos;905;Valle de Sedano;549;295;254
09;Burgos;412;Valle de Tobalina;1098;577;521
09;Burgos;413;Valle de Valdebezana;778;416;362
09;Burgos;414;Valle de Valdelaguna;245;132;113
09;Burgos;415;Valle de Valdelucio;370;200;170
09;Burgos;416;Valle de Zamanzas;76;45;31
09;Burgos;417;Vallejera;60;34;26
09;Burgos;418;Valles de Palenzuela;107;55;52
09;Burgos;419;Valluércanes;123;66;57
09;Burgos;407;Valmala;33;16;17
09;Burgos;422;Vid de Bureba (La);45;22;23
09;Burgos;421;Vid y Barrios (La);345;194;151
09;Burgos;423;Vileña;40;25;15
09;Burgos;427;Villadiego;2045;1109;936
09;Burgos;428;Villaescusa de Roa;183;105;78
09;Burgos;429;Villaescusa la Sombría;58;35;23
09;Burgos;430;Villaespasa;31;16;15
09;Burgos;431;Villafranca Montes de Oca;212;108;104
09;Burgos;432;Villafruela;302;173;129
09;Burgos;433;Villagalijo;74;48;26
09;Burgos;434;Villagonzalo Pedernales;727;365;362
09;Burgos;437;Villahoz;415;211;204
09;Burgos;438;Villalba de Duero;575;303;272
09;Burgos;439;Villalbilla de Burgos;684;370;314
09;Burgos;440;Villalbilla de Gumiel;134;76;58
09;Burgos;441;Villaldemiro;87;45;42
09;Burgos;442;Villalmanzo;500;269;231
09;Burgos;443;Villamayor de los Montes;256;122;134
09;Burgos;444;Villamayor de Treviño;116;66;50
09;Burgos;445;Villambistia;78;46;32
09;Burgos;446;Villamedianilla;28;13;15
09;Burgos;447;Villamiel de la Sierra;40;23;17
09;Burgos;448;Villangómez;333;179;154
09;Burgos;449;Villanueva de Argaño;123;66;57
09;Burgos;450;Villanueva de Carazo;27;16;11
09;Burgos;451;Villanueva de Gumiel;310;160;150
09;Burgos;454;Villanueva de Teba;71;40;31
09;Burgos;455;Villaquirán de la Puebla;68;38;30
09;Burgos;456;Villaquirán de los Infantes;200;98;102
09;Burgos;903;Villarcayo de Merindad de Castilla la Vieja;3809;1915;1894
09;Burgos;458;Villariezo;185;99;86
09;Burgos;460;Villasandino;262;132;130
09;Burgos;463;Villasur de Herreros;304;167;137
09;Burgos;464;Villatuelda;74;39;35
09;Burgos;466;Villaverde del Monte;205;111;94
09;Burgos;467;Villaverde-Mogina;123;75;48
09;Burgos;471;Villayerno Morquillas;138;70;68
09;Burgos;472;Villazopeque;93;54;39
09;Burgos;473;Villegas;131;74;57
09;Burgos;476;Villoruebo;55;35;20
09;Burgos;424;Viloria de Rioja;72;40;32
09;Burgos;425;Vilviestre del Pinar;791;407;384
09;Burgos;478;Vizcaínos;66;34;32
09;Burgos;480;Zael;147;76;71
09;Burgos;482;Zarzosa de Río Pisuerga;60;36;24
09;Burgos;483;Zazuar;255;133;122
09;Burgos;485;Zuñeda;87;45;42
10;Cáceres;001;Abadía;271;152;119
10;Cáceres;002;Abertura;512;274;238
10;Cáceres;003;Acebo;785;417;368
10;Cáceres;004;Acehúche;938;472;466
10;Cáceres;005;Aceituna;727;370;357
10;Cáceres;006;Ahigal;1684;869;815
10;Cáceres;903;Alagón del Río;"";"";""
10;Cáceres;007;Albalá del Caudillo;858;421;437
10;Cáceres;008;Alcántara;1772;908;864
10;Cáceres;009;Alcollarín;352;166;186
10;Cáceres;010;Alcuéscar;3176;1655;1521
10;Cáceres;012;Aldea del Cano;777;380;397
10;Cáceres;013;Aldea del Obispo (La);415;220;195
10;Cáceres;011;Aldeacentenera;991;503;488
10;Cáceres;014;Aldeanueva de la Vera;2501;1242;1259
10;Cáceres;015;Aldeanueva del Camino;906;467;439
10;Cáceres;016;Aldehuela de Jerte;386;219;167
10;Cáceres;017;Alía;1408;701;707
10;Cáceres;018;Aliseda;2309;1150;1159
10;Cáceres;019;Almaraz;1447;754;693
10;Cáceres;020;Almoharín;2398;1209;1189
10;Cáceres;021;Arroyo de la Luz;6569;3286;3283
10;Cáceres;023;Arroyomolinos;1062;537;525
10;Cáceres;022;Arroyomolinos de la Vera;604;300;304
10;Cáceres;024;Baños de Montemayor;618;313;305
10;Cáceres;025;Barrado;543;277;266
10;Cáceres;026;Belvís de Monroy;622;320;302
10;Cáceres;027;Benquerencia;104;62;42
10;Cáceres;028;Berrocalejo;123;54;69
10;Cáceres;029;Berzocana;644;329;315
10;Cáceres;030;Bohonal de Ibor;620;319;301
10;Cáceres;031;Botija;180;79;101
10;Cáceres;032;Brozas;2359;1179;1180
10;Cáceres;033;Cabañas del Castillo;564;290;274
10;Cáceres;034;Cabezabellosa;535;270;265
10;Cáceres;035;Cabezuela del Valle;2524;1313;1211
10;Cáceres;036;Cabrero;450;236;214
10;Cáceres;037;Cáceres;78614;37864;40750
10;Cáceres;038;Cachorrilla;109;50;59
10;Cáceres;039;Cadalso;583;302;281
10;Cáceres;040;Calzadilla;604;307;297
10;Cáceres;041;Caminomorisco;1263;667;596
10;Cáceres;042;Campillo de Deleitosa;144;70;74
10;Cáceres;043;Campo Lugar;1384;706;678
10;Cáceres;044;Cañamero;2189;1122;1067
10;Cáceres;045;Cañaveral;1490;733;757
10;Cáceres;046;Carbajo;283;150;133
10;Cáceres;047;Carcaboso;1116;643;473
10;Cáceres;048;Carrascalejo;432;218;214
10;Cáceres;049;Casar de Cáceres;4706;2361;2345
10;Cáceres;050;Casar de Palomero;1353;679;674
10;Cáceres;051;Casares de las Hurdes;753;374;379
10;Cáceres;052;Casas de Don Antonio;258;130;128
10;Cáceres;053;Casas de Don Gómez;352;184;168
10;Cáceres;056;Casas de Millán;818;426;392
10;Cáceres;057;Casas de Miravete;163;87;76
10;Cáceres;054;Casas del Castañar;725;360;365
10;Cáceres;055;Casas del Monte;909;473;436
10;Cáceres;058;Casatejada;1305;654;651
10;Cáceres;059;Casillas de Coria;547;254;293
10;Cáceres;060;Castañar de Ibor;1372;701;671
10;Cáceres;061;Ceclavín;2149;1134;1015
10;Cáceres;062;Cedillo;541;284;257
10;Cáceres;063;Cerezo;233;109;124
10;Cáceres;064;Cilleros;2164;1089;1075
10;Cáceres;065;Collado;237;128;109
10;Cáceres;066;Conquista de la Sierra;183;87;96
10;Cáceres;067;Coria;11811;5934;5877
10;Cáceres;068;Cuacos de Yuste;933;498;435
10;Cáceres;069;Cumbre (La);1167;579;588
10;Cáceres;070;Deleitosa;948;472;476
10;Cáceres;071;Descargamaría;268;138;130
10;Cáceres;072;Eljas;1239;632;607
10;Cáceres;073;Escurial;947;474;473
10;Cáceres;075;Fresnedoso de Ibor;417;208;209
10;Cáceres;076;Galisteo;1993;1006;987
10;Cáceres;077;Garciaz;1064;542;522
10;Cáceres;078;Garganta (La);489;273;216
10;Cáceres;079;Garganta la Olla;1044;550;494
10;Cáceres;080;Gargantilla;498;265;233
10;Cáceres;081;Gargüera;198;101;97
10;Cáceres;082;Garrovillas de Alconétar;2738;1343;1395
10;Cáceres;083;Garvín;121;70;51
10;Cáceres;084;Gata;1950;979;971
10;Cáceres;085;Gordo (El);368;183;185
10;Cáceres;086;Granja (La);424;237;187
10;Cáceres;087;Guadalupe;2387;1178;1209
10;Cáceres;088;Guijo de Coria;297;157;140
10;Cáceres;089;Guijo de Galisteo;1829;932;897
10;Cáceres;090;Guijo de Granadilla;753;370;383
10;Cáceres;091;Guijo de Santa Bárbara;506;253;253
10;Cáceres;092;Herguijuela;442;217;225
10;Cáceres;093;Hernán-Pérez;511;264;247
10;Cáceres;094;Herrera de Alcántara;340;170;170
10;Cáceres;095;Herreruela;477;251;226
10;Cáceres;096;Hervás;3934;1917;2017
10;Cáceres;097;Higuera;114;62;52
10;Cáceres;098;Hinojal;436;207;229
10;Cáceres;099;Holguera;847;422;425
10;Cáceres;100;Hoyos;1001;512;489
10;Cáceres;101;Huélaga;210;108;102
10;Cáceres;102;Ibahernando;817;401;416
10;Cáceres;103;Jaraicejo;812;404;408
10;Cáceres;104;Jaraíz de la Vera;6604;3353;3251
10;Cáceres;105;Jarandilla de la Vera;3228;1620;1608
10;Cáceres;106;Jarilla;198;104;94
10;Cáceres;107;Jerte;1377;719;658
10;Cáceres;108;Ladrillar;335;183;152
10;Cáceres;109;Logrosán;2593;1320;1273
10;Cáceres;110;Losar de la Vera;3007;1514;1493
10;Cáceres;111;Madrigal de la Vera;1686;888;798
10;Cáceres;112;Madrigalejo;2357;1170;1187
10;Cáceres;113;Madroñera;3122;1562;1560
10;Cáceres;114;Majadas;1257;691;566
10;Cáceres;115;Malpartida de Cáceres;4361;2189;2172
10;Cáceres;116;Malpartida de Plasencia;4191;2043;2148
10;Cáceres;117;Marchagaz;328;164;164
10;Cáceres;118;Mata de Alcántara;393;201;192
10;Cáceres;119;Membrío;861;409;452
10;Cáceres;120;Mesas de Ibor;207;108;99
10;Cáceres;121;Miajadas;9629;4817;4812
10;Cáceres;122;Millanes;200;113;87
10;Cáceres;123;Mirabel;861;422;439
10;Cáceres;124;Mohedas de Granadilla;1125;568;557
10;Cáceres;125;Monroy;1080;569;511
10;Cáceres;126;Montánchez;2233;1102;1131
10;Cáceres;127;Montehermoso;5211;2639;2572
10;Cáceres;128;Moraleja;8161;4040;4121
10;Cáceres;129;Morcillo;496;245;251
10;Cáceres;130;Navaconcejo;2176;1103;1073
10;Cáceres;131;Navalmoral de la Mata;14934;7474;7460
10;Cáceres;132;Navalvillar de Ibor;532;276;256
10;Cáceres;133;Navas del Madroño;1575;793;782
10;Cáceres;134;Navezuelas;737;389;348
10;Cáceres;135;Nuñomoral;1888;995;893
10;Cáceres;136;Oliva de Plasencia;312;161;151
10;Cáceres;137;Palomero;559;282;277
10;Cáceres;138;Pasarón de la Vera;719;359;360
10;Cáceres;139;Pedroso de Acim;147;78;69
10;Cáceres;140;Peraleda de la Mata;1382;690;692
10;Cáceres;141;Peraleda de San Román;428;206;222
10;Cáceres;142;Perales del Puerto;1006;495;511
10;Cáceres;143;Pescueza;213;98;115
10;Cáceres;144;Pesga (La);1283;733;550
10;Cáceres;145;Piedras Albas;218;105;113
10;Cáceres;146;Pinofranqueado;1738;944;794
10;Cáceres;147;Piornal;1545;766;779
10;Cáceres;148;Plasencia;36465;17841;18624
10;Cáceres;149;Plasenzuela;580;273;307
10;Cáceres;150;Portaje;411;201;210
10;Cáceres;151;Portezuelo;328;159;169
10;Cáceres;152;Pozuelo de Zarzón;640;309;331
10;Cáceres;153;Puerto de Santa Cruz;440;212;228
10;Cáceres;154;Rebollar;251;129;122
10;Cáceres;155;Riolobos;1545;821;724
10;Cáceres;156;Robledillo de Gata;175;93;82
10;Cáceres;157;Robledillo de la Vera;335;164;171
10;Cáceres;158;Robledillo de Trujillo;537;273;264
10;Cáceres;159;Robledollano;443;240;203
10;Cáceres;160;Romangordo;190;88;102
10;Cáceres;901;Rosalejo;1917;1082;835
10;Cáceres;161;Ruanes;109;57;52
10;Cáceres;162;Salorino;811;400;411
10;Cáceres;163;Salvatierra de Santiago;426;217;209
10;Cáceres;164;San Martín de Trevejo;1023;504;519
10;Cáceres;165;Santa Ana;383;192;191
10;Cáceres;166;Santa Cruz de la Sierra;403;207;196
10;Cáceres;167;Santa Cruz de Paniagua;488;261;227
10;Cáceres;168;Santa Marta de Magasca;376;189;187
10;Cáceres;169;Santiago de Alcántara;783;393;390
10;Cáceres;170;Santiago del Campo;325;162;163
10;Cáceres;171;Santibáñez el Alto;652;344;308
10;Cáceres;172;Santibáñez el Bajo;1134;589;545
10;Cáceres;173;Saucedilla;630;320;310
10;Cáceres;174;Segura de Toro;209;111;98
10;Cáceres;175;Serradilla;1974;1002;972
10;Cáceres;176;Serrejón;525;274;251
10;Cáceres;177;Sierra de Fuentes;1690;869;821
10;Cáceres;178;Talaván;1033;514;519
10;Cáceres;179;Talaveruela de la Vera;457;213;244
10;Cáceres;180;Talayuela;9528;5646;3882
10;Cáceres;181;Tejeda de Tiétar;1238;662;576
10;Cáceres;182;Toril;224;143;81
10;Cáceres;183;Tornavacas;1341;712;629
10;Cáceres;184;Torno (El);967;495;472
10;Cáceres;187;Torre de Don Miguel;666;334;332
10;Cáceres;188;Torre de Santa María;758;377;381
10;Cáceres;185;Torrecilla de los Ángeles;834;432;402
10;Cáceres;186;Torrecillas de la Tiesa;1295;656;639
10;Cáceres;190;Torrejón el Rubio;717;370;347
10;Cáceres;189;Torrejoncillo;3633;1775;1858
10;Cáceres;191;Torremenga;585;326;259
10;Cáceres;192;Torremocha;1446;698;748
10;Cáceres;193;Torreorgaz;1615;816;799
10;Cáceres;194;Torrequemada;615;293;322
10;Cáceres;195;Trujillo;9070;4366;4704
10;Cáceres;196;Valdastillas;414;206;208
10;Cáceres;197;Valdecañas de Tajo;270;138;132
10;Cáceres;198;Valdefuentes;1576;785;791
10;Cáceres;199;Valdehúncar;206;101;105
10;Cáceres;200;Valdelacasa de Tajo;561;264;297
10;Cáceres;201;Valdemorales;322;155;167
10;Cáceres;202;Valdeobispo;831;405;426
10;Cáceres;203;Valencia de Alcántara;6331;3101;3230
10;Cáceres;204;Valverde de la Vera;564;292;272
10;Cáceres;205;Valverde del Fresno;2690;1368;1322
10;Cáceres;902;Vegaviana;"";"";""
10;Cáceres;206;Viandar de la Vera;331;157;174
10;Cáceres;207;Villa del Campo;656;321;335
10;Cáceres;208;Villa del Rey;183;97;86
10;Cáceres;209;Villamesías;384;190;194
10;Cáceres;210;Villamiel;846;483;363
10;Cáceres;211;Villanueva de la Sierra;615;294;321
10;Cáceres;212;Villanueva de la Vera;2032;1022;1010
10;Cáceres;214;Villar de Plasencia;275;136;139
10;Cáceres;213;Villar del Pedroso;820;411;409
10;Cáceres;215;Villasbuenas de Gata;521;269;252
10;Cáceres;216;Zarza de Granadilla;1822;941;881
10;Cáceres;217;Zarza de Montánchez;640;318;322
10;Cáceres;218;Zarza la Mayor;1688;836;852
10;Cáceres;219;Zorita;1615;803;812
11;Cádiz;001;Alcalá de los Gazules;5575;2897;2678
11;Cádiz;002;Alcalá del Valle;5274;2994;2280
11;Cádiz;003;Algar;1803;973;830
11;Cádiz;004;Algeciras;103106;50684;52422
11;Cádiz;005;Algodonales;5680;2926;2754
11;Cádiz;006;Arcos de la Frontera;27948;14021;13927
11;Cádiz;007;Barbate;22011;11002;11009
11;Cádiz;008;Barrios (Los);16511;8343;8168
11;Cádiz;901;Benalup-Casas Viejas;6286;3201;3085
11;Cádiz;009;Benaocaz;632;317;315
11;Cádiz;010;Bornos;8029;3981;4048
11;Cádiz;011;Bosque (El);1847;948;899
11;Cádiz;013;Castellar de la Frontera;2483;1272;1211
11;Cádiz;015;Chiclana de la Frontera;57585;29238;28347
11;Cádiz;016;Chipiona;16200;8177;8023
11;Cádiz;014;Conil de la Frontera;17470;8885;8585
11;Cádiz;012;Cádiz;142449;68437;74012
11;Cádiz;017;Espera;3975;2074;1901
11;Cádiz;018;Gastor (El);1978;1041;937
11;Cádiz;019;Grazalema;2249;1171;1078
11;Cádiz;020;Jerez de la Frontera;182660;89164;93496
11;Cádiz;021;Jimena de la Frontera;9127;4664;4463
11;Cádiz;022;Línea de la Concepción (La);59828;29282;30546
11;Cádiz;023;Medina-Sidonia;10844;5620;5224
11;Cádiz;024;Olvera;8818;4426;4392
11;Cádiz;025;Paterna de Rivera;5180;2690;2490
11;Cádiz;026;Prado del Rey;5814;2916;2898
11;Cádiz;028;Puerto Real;34447;17342;17105
11;Cádiz;029;Puerto Serrano;6743;3441;3302
11;Cádiz;027;Puerto de Santa María (El);75097;37406;37691
11;Cádiz;030;Rota;25198;12733;12465
11;Cádiz;031;San Fernando;87179;43112;44067
11;Cádiz;902;San José del Valle;4285;2137;2148
11;Cádiz;033;San Roque;22719;11398;11321
11;Cádiz;032;Sanlúcar de Barrameda;61648;30873;30775
11;Cádiz;034;Setenil de las Bodegas;3099;1579;1520
11;Cádiz;035;Tarifa;15344;7753;7591
11;Cádiz;036;Torre Alháquime;959;485;474
11;Cádiz;037;Trebujena;6919;3581;3338
11;Cádiz;038;Ubrique;17960;8933;9027
11;Cádiz;039;Vejer de la Frontera;12731;6447;6284
11;Cádiz;040;Villaluenga del Rosario;447;239;208
11;Cádiz;041;Villamartín;12105;6068;6037
11;Cádiz;042;Zahara;1560;813;747
12;Castellón/Castelló;003;Albocàsser;1368;659;709
12;Castellón/Castelló;004;Alcalà de Xivert;5150;2568;2582
12;Castellón/Castelló;005;Alcora (L');8935;4549;4386
12;Castellón/Castelló;006;Alcudia de Veo;172;82;90
12;Castellón/Castelló;007;Alfondeguilla;910;445;465
12;Castellón/Castelló;008;Algimia de Almonacid;287;163;124
12;Castellón/Castelló;009;Almazora/Almassora;16609;8228;8381
12;Castellón/Castelló;010;Almedíjar;274;132;142
12;Castellón/Castelló;011;Almenara;5001;2468;2533
12;Castellón/Castelló;901;Alquerías del Niño Perdido;3556;1729;1827
12;Castellón/Castelló;012;Altura;3144;1582;1562
12;Castellón/Castelló;013;Arañuel;160;83;77
12;Castellón/Castelló;014;Ares del Maestre;268;132;136
12;Castellón/Castelló;015;Argelita;121;62;59
12;Castellón/Castelló;016;Artana;1828;904;924
12;Castellón/Castelló;001;Atzeneta del Maestrat;1465;741;724
12;Castellón/Castelló;017;Ayódar;256;140;116
12;Castellón/Castelló;018;Azuébar;347;171;176
12;Castellón/Castelló;002;Aín;156;77;79
12;Castellón/Castelló;020;Barracas;160;87;73
12;Castellón/Castelló;022;Bejís;383;211;172
12;Castellón/Castelló;024;Benafer;150;81;69
12;Castellón/Castelló;025;Benafigos;209;112;97
12;Castellón/Castelló;026;Benasal;1390;671;719
12;Castellón/Castelló;027;Benicarló;19540;9681;9859
12;Castellón/Castelló;028;Benicasim/Benicàssim;11288;5702;5586
12;Castellón/Castelló;029;Benlloch;833;426;407
12;Castellón/Castelló;021;Betxí;5339;2721;2618
12;Castellón/Castelló;031;Borriol;3405;1723;1682
12;Castellón/Castelló;032;Borriana/Burriana;26323;12825;13498
12;Castellón/Castelló;033;Cabanes;2390;1182;1208
12;Castellón/Castelló;036;Canet lo Roig;914;436;478
12;Castellón/Castelló;037;Castell de Cabres;22;10;12
12;Castellón/Castelló;038;Castellfort;234;121;113
12;Castellón/Castelló;039;Castellnovo;1031;486;545
12;Castellón/Castelló;040;Castellón de la Plana/Castelló de la Plana;139712;68112;71600
12;Castellón/Castelló;041;Castillo de Villamalefa;123;61;62
12;Castellón/Castelló;042;Catí;878;455;423
12;Castellón/Castelló;043;Caudiel;699;348;351
12;Castellón/Castelló;044;Cervera del Maestre;711;337;374
12;Castellón/Castelló;052;Chert/Xert;913;445;468
12;Castellón/Castelló;053;Chilches/Xilxes;2228;1137;1091
12;Castellón/Castelló;055;Chodos/Xodos;156;86;70
12;Castellón/Castelló;056;Chóvar;390;197;193
12;Castellón/Castelló;045;Cinctorres;533;247;286
12;Castellón/Castelló;046;Cirat;272;143;129
12;Castellón/Castelló;048;Cortes de Arenoso;429;228;201
12;Castellón/Castelló;049;Costur;467;234;233
12;Castellón/Castelló;050;Coves de Vinromà (les);1836;931;905
12;Castellón/Castelló;051;Culla;794;406;388
12;Castellón/Castelló;034;Càlig;1742;849;893
12;Castellón/Castelló;057;Eslida;768;363;405
12;Castellón/Castelló;058;Espadilla;75;35;40
12;Castellón/Castelló;059;Fanzara;265;124;141
12;Castellón/Castelló;060;Figueroles;563;282;281
12;Castellón/Castelló;061;Forcall;570;271;299
12;Castellón/Castelló;063;Fuente la Reina;28;13;15
12;Castellón/Castelló;064;Fuentes de Ayódar;97;54;43
12;Castellón/Castelló;065;Gaibiel;203;109;94
12;Castellón/Castelló;066;Gatova;"";"";""
12;Castellón/Castelló;067;Geldo;690;346;344
12;Castellón/Castelló;068;Herbés;107;55;52
12;Castellón/Castelló;069;Higueras;37;22;15
12;Castellón/Castelló;070;Jana (La);817;415;402
12;Castellón/Castelló;071;Jérica;1561;797;764
12;Castellón/Castelló;074;Llosa (La);932;471;461
12;Castellón/Castelló;072;Lucena del Cid;1581;792;789
12;Castellón/Castelló;073;Ludiente;228;118;110
12;Castellón/Castelló;075;Mata de Morella (La);189;95;94
12;Castellón/Castelló;076;Matet;145;73;72
12;Castellón/Castelló;077;Moncofa;3797;1930;1867
12;Castellón/Castelló;079;Montanejos;425;212;213
12;Castellón/Castelló;078;Montán;350;181;169
12;Castellón/Castelló;080;Morella;2719;1309;1410
12;Castellón/Castelló;081;Navajas;536;276;260
12;Castellón/Castelló;082;Nules;11444;5705;5739
12;Castellón/Castelló;083;Olocau del Rey;148;80;68
12;Castellón/Castelló;084;Onda;19110;9657;9453
12;Castellón/Castelló;085;Oropesa del Mar/Orpesa;3392;1740;1652
12;Castellón/Castelló;087;Palanques;24;14;10
12;Castellón/Castelló;088;Pavías;57;35;22
12;Castellón/Castelló;089;Peníscola/Peñíscola;4258;2142;2116
12;Castellón/Castelló;090;Pina de Montalgrao;168;89;79
12;Castellón/Castelló;094;Pobla Tornesa (La);540;269;271
12;Castellón/Castelló;093;Pobla de Benifassà (La);232;113;119
12;Castellón/Castelló;091;Portell de Morella;268;128;140
12;Castellón/Castelló;092;Puebla de Arenoso;171;86;85
12;Castellón/Castelló;095;Ribesalbes;1283;640;643
12;Castellón/Castelló;096;Rossell;1111;570;541
12;Castellón/Castelló;097;Sacañet;94;53;41
12;Castellón/Castelló;098;Salzadella (La);808;397;411
12;Castellón/Castelló;101;San Rafael del Río;455;237;218
12;Castellón/Castelló;902;Sant Joan de Moró;1741;887;854
12;Castellón/Castelló;099;Sant Jordi/San Jorge;572;278;294
12;Castellón/Castelló;100;Sant Mateu;1797;896;901
12;Castellón/Castelló;102;Santa Magdalena de Pulpis;712;366;346
12;Castellón/Castelló;103;Sarratella;92;50;42
12;Castellón/Castelló;104;Segorbe;7768;3780;3988
12;Castellón/Castelló;105;Sierra Engarcerán;1072;565;507
12;Castellón/Castelló;106;Soneja;1383;699;684
12;Castellón/Castelló;107;Sot de Ferrer;425;217;208
12;Castellón/Castelló;108;Sueras/Suera;549;270;279
12;Castellón/Castelló;109;Tales;775;375;400
12;Castellón/Castelló;110;Teresa;359;182;177
12;Castellón/Castelló;112;Todolella;147;84;63
12;Castellón/Castelló;113;Toga;107;55;52
12;Castellón/Castelló;115;Toro (El);345;186;159
12;Castellón/Castelló;116;Torralba del Pinar;69;33;36
12;Castellón/Castelló;120;Torre d'en Doménech (La);234;117;117
12;Castellón/Castelló;119;Torre d'En Besora (La);212;107;105
12;Castellón/Castelló;117;Torreblanca;4610;2291;2319
12;Castellón/Castelló;118;Torrechiva;73;46;27
12;Castellón/Castelló;114;Torás;254;131;123
12;Castellón/Castelló;121;Traiguera;1594;824;770
12;Castellón/Castelló;111;Tírig;556;279;277
12;Castellón/Castelló;122;Useras/Useres (Les);1012;515;497
12;Castellón/Castelló;124;Vall d'Alba;1933;972;961
12;Castellón/Castelló;126;Vall d'Uixó (La);28972;14370;14602
12;Castellón/Castelló;125;Vall de Almonacid;289;149;140
12;Castellón/Castelló;123;Vallat;49;24;25
12;Castellón/Castelló;127;Vallibona;93;55;38
12;Castellón/Castelló;128;Vilafamés;1453;775;678
12;Castellón/Castelló;132;Vilanova d'Alcolea;649;329;320
12;Castellón/Castelló;134;Vilar de Canes;188;93;95
12;Castellón/Castelló;129;Villafranca del Cid;2654;1288;1366
12;Castellón/Castelló;130;Villahermosa del Río;458;255;203
12;Castellón/Castelló;131;Villamalur;148;84;64
12;Castellón/Castelló;133;Villanueva de Viver;80;40;40
12;Castellón/Castelló;135;Vila-real;40933;20370;20563
12;Castellón/Castelló;136;Villavieja;3376;1683;1693
12;Castellón/Castelló;137;Villores;66;33;33
12;Castellón/Castelló;138;Vinaròs;22268;10850;11418
12;Castellón/Castelló;139;Vistabella del Maestrazgo;467;234;233
12;Castellón/Castelló;140;Viver;1265;650;615
12;Castellón/Castelló;141;Zorita del Maestrazgo;135;67;68
12;Castellón/Castelló;142;Zucaina;214;120;94
13;Ciudad Real;001;Abenójar;1810;904;906
13;Ciudad Real;002;Agudo;2132;1078;1054
13;Ciudad Real;003;Alamillo;696;348;348
13;Ciudad Real;004;Albaladejo;1697;864;833
13;Ciudad Real;005;Alcázar de San Juan;26104;12741;13363
13;Ciudad Real;006;Alcoba;764;398;366
13;Ciudad Real;007;Alcolea de Calatrava;1655;826;829
13;Ciudad Real;008;Alcubillas;707;338;369
13;Ciudad Real;009;Aldea del Rey;2202;1081;1121
13;Ciudad Real;010;Alhambra;1278;649;629
13;Ciudad Real;011;Almadén;7313;3501;3812
13;Ciudad Real;012;Almadenejos;606;324;282
13;Ciudad Real;013;Almagro;8255;4003;4252
13;Ciudad Real;014;Almedina;749;378;371
13;Ciudad Real;015;Almodóvar del Campo;7511;3695;3816
13;Ciudad Real;016;Almuradiel;1023;474;549
13;Ciudad Real;017;Anchuras;458;252;206
13;Ciudad Real;903;Arenales de San Gregorio;"";"";""
13;Ciudad Real;018;Arenas de San Juan;1088;544;544
13;Ciudad Real;019;Argamasilla de Alba;6681;3303;3378
13;Ciudad Real;020;Argamasilla de Calatrava;5536;2806;2730
13;Ciudad Real;021;Arroba de los Montes;649;333;316
13;Ciudad Real;022;Ballesteros de Calatrava;572;272;300
13;Ciudad Real;023;Bolaños de Calatrava;10619;5300;5319
13;Ciudad Real;024;Brazatortas;1250;623;627
13;Ciudad Real;025;Cabezarados;392;204;188
13;Ciudad Real;026;Cabezarrubias del Puerto;667;341;326
13;Ciudad Real;027;Calzada de Calatrava;4754;2335;2419
13;Ciudad Real;028;Campo de Criptana;13762;6750;7012
13;Ciudad Real;029;Cañada de Calatrava;82;43;39
13;Ciudad Real;030;Caracuel de Calatrava;177;97;80
13;Ciudad Real;031;Carrión de Calatrava;2629;1297;1332
13;Ciudad Real;032;Carrizosa;1706;853;853
13;Ciudad Real;033;Castellar de Santiago;2242;1099;1143
13;Ciudad Real;038;Chillón;2347;1129;1218
13;Ciudad Real;034;Ciudad Real;61138;28872;32266
13;Ciudad Real;035;Corral de Calatrava;1301;664;637
13;Ciudad Real;036;Cortijos (Los);1094;535;559
13;Ciudad Real;037;Cózar;1320;641;679
13;Ciudad Real;039;Daimiel;17202;8453;8749
13;Ciudad Real;040;Fernán Caballero;1058;506;552
13;Ciudad Real;041;Fontanarejo;373;200;173
13;Ciudad Real;042;Fuencaliente;1325;699;626
13;Ciudad Real;043;Fuenllana;327;152;175
13;Ciudad Real;044;Fuente el Fresno;3460;1714;1746
13;Ciudad Real;045;Granátula de Calatrava;1005;483;522
13;Ciudad Real;046;Guadalmez;1091;551;540
13;Ciudad Real;047;Herencia;7041;3520;3521
13;Ciudad Real;048;Hinojosas de Calatrava;771;378;393
13;Ciudad Real;049;Horcajo de los Montes;1100;547;553
13;Ciudad Real;050;Labores (Las);706;348;358
13;Ciudad Real;904;Llanos del Caudillo;"";"";""
13;Ciudad Real;051;Luciana;448;229;219
13;Ciudad Real;052;Malagón;8059;3969;4090
13;Ciudad Real;053;Manzanares;18222;8917;9305
13;Ciudad Real;054;Membrilla;6600;3294;3306
13;Ciudad Real;055;Mestanza;941;458;483
13;Ciudad Real;056;Miguelturra;9617;4830;4787
13;Ciudad Real;057;Montiel;1721;865;856
13;Ciudad Real;058;Moral de Calatrava;5202;2543;2659
13;Ciudad Real;059;Navalpino;318;156;162
13;Ciudad Real;060;Navas de Estena;427;229;198
13;Ciudad Real;061;Pedro Muñoz;7192;3592;3600
13;Ciudad Real;062;Picón;649;345;304
13;Ciudad Real;063;Piedrabuena;5036;2567;2469
13;Ciudad Real;064;Poblete;803;405;398
13;Ciudad Real;065;Porzuna;3984;2019;1965
13;Ciudad Real;066;Pozuelo de Calatrava;2522;1246;1276
13;Ciudad Real;067;Pozuelos de Calatrava (Los);566;286;280
13;Ciudad Real;068;Puebla de Don Rodrigo;1327;700;627
13;Ciudad Real;069;Puebla del Príncipe;1094;552;542
13;Ciudad Real;070;Puerto Lápice;1041;524;517
13;Ciudad Real;071;Puertollano;50367;24494;25873
13;Ciudad Real;072;Retuerta del Bullaque;1049;543;506
13;Ciudad Real;901;Robledo (El);1131;596;535
13;Ciudad Real;902;Ruidera;610;321;289
13;Ciudad Real;073;Saceruela;754;405;349
13;Ciudad Real;074;San Carlos del Valle;1251;626;625
13;Ciudad Real;075;San Lorenzo de Calatrava;313;162;151
13;Ciudad Real;076;Santa Cruz de los Cáñamos;661;333;328
13;Ciudad Real;077;Santa Cruz de Mudela;4843;2367;2476
13;Ciudad Real;078;Socuéllamos;11228;5508;5720
13;Ciudad Real;080;Solana del Pino;556;280;276
13;Ciudad Real;079;Solana (La);14960;7491;7469
13;Ciudad Real;081;Terrinches;978;474;504
13;Ciudad Real;082;Tomelloso;29255;14349;14906
13;Ciudad Real;083;Torralba de Calatrava;2934;1448;1486
13;Ciudad Real;084;Torre de Juan Abad;1438;693;745
13;Ciudad Real;085;Torrenueva;3264;1655;1609
13;Ciudad Real;086;Valdemanco del Esteras;318;157;161
13;Ciudad Real;087;Valdepeñas;26370;12698;13672
13;Ciudad Real;088;Valenzuela de Calatrava;819;400;419
13;Ciudad Real;089;Villahermosa;2719;1296;1423
13;Ciudad Real;090;Villamanrique;1695;832;863
13;Ciudad Real;091;Villamayor de Calatrava;649;323;326
13;Ciudad Real;092;Villanueva de la Fuente;2748;1353;1395
13;Ciudad Real;093;Villanueva de los Infantes;5801;2781;3020
13;Ciudad Real;094;Villanueva de San Carlos;470;226;244
13;Ciudad Real;095;Villar del Pozo;95;48;47
13;Ciudad Real;096;Villarrubia de los Ojos;9608;4786;4822
13;Ciudad Real;097;Villarta de San Juan;2915;1471;1444
13;Ciudad Real;098;Viso del Marqués;3094;1540;1554
14;Córdoba;001;Adamuz;4453;2275;2178
14;Córdoba;002;Aguilar de la Frontera;13416;6633;6783
14;Córdoba;003;Alcaracejos;1474;737;737
14;Córdoba;004;Almedinilla;2555;1262;1293
14;Córdoba;005;Almodóvar del Río;7144;3543;3601
14;Córdoba;006;Añora;1631;802;829
14;Córdoba;007;Baena;19712;9750;9962
14;Córdoba;008;Belalcázar;3835;1861;1974
14;Córdoba;009;Belmez;3992;1905;2087
14;Córdoba;010;Benamejí;4763;2398;2365
14;Córdoba;011;Blázquez (Los);726;370;356
14;Córdoba;012;Bujalance;8156;4000;4156
14;Córdoba;013;Cabra;20744;10108;10636
14;Córdoba;015;Carcabuey;2888;1447;1441
14;Córdoba;016;Cardeña;1912;974;938
14;Córdoba;017;Carlota (La);10336;5185;5151
14;Córdoba;018;Carpio (El);4509;2193;2316
14;Córdoba;019;Castro del Río;8023;3924;4099
14;Córdoba;014;Cañete de las Torres;3385;1692;1693
14;Córdoba;020;Conquista;508;260;248
14;Córdoba;021;Córdoba;311708;150243;161465
14;Córdoba;023;Dos Torres;2602;1283;1319
14;Córdoba;022;Doña Mencía;4955;2467;2488
14;Córdoba;024;Encinas Reales;2395;1166;1229
14;Córdoba;025;Espejo;3998;1982;2016
14;Córdoba;026;Espiel;2415;1202;1213
14;Córdoba;027;Fernán-Núñez;9491;4740;4751
14;Córdoba;029;Fuente Obejuna;6032;3082;2950
14;Córdoba;030;Fuente Palmera;9849;4973;4876
14;Córdoba;028;Fuente la Lancha;416;206;210
14;Córdoba;031;Fuente-Tójar;848;394;454
14;Córdoba;032;Granjuela (La);517;273;244
14;Córdoba;033;Guadalcázar;1156;593;563
14;Córdoba;034;Guijo (El);412;205;207
14;Córdoba;035;Hinojosa del Duque;7992;3861;4131
14;Córdoba;036;Hornachuelos;4937;2467;2470
14;Córdoba;037;Iznájar;5200;2621;2579
14;Córdoba;038;Lucena;35837;17811;18026
14;Córdoba;039;Luque;3364;1668;1696
14;Córdoba;040;Montalbán de Córdoba;4573;2294;2279
14;Córdoba;041;Montemayor;3825;1918;1907
14;Córdoba;042;Montilla;22910;11292;11618
14;Córdoba;043;Montoro;9481;4648;4833
14;Córdoba;044;Monturque;1938;972;966
14;Córdoba;045;Moriles;3795;1888;1907
14;Córdoba;046;Nueva Carteya;5690;2864;2826
14;Córdoba;047;Obejo;1505;759;746
14;Córdoba;048;Palenciana;1569;787;782
14;Córdoba;049;Palma del Río;19243;9584;9659
14;Córdoba;050;Pedro Abad;2904;1456;1448
14;Córdoba;051;Pedroche;1840;912;928
14;Córdoba;052;Peñarroya-Pueblonuevo;13352;6372;6980
14;Córdoba;053;Posadas;7167;3571;3596
14;Córdoba;054;Pozoblanco;16218;7828;8390
14;Córdoba;055;Priego de Córdoba;22208;10884;11324
14;Córdoba;056;Puente Genil;27825;13662;14163
14;Córdoba;057;Rambla (La);7266;3621;3645
14;Córdoba;058;Rute;10083;4983;5100
14;Córdoba;059;San Sebastián de los Ballesteros;843;432;411
14;Córdoba;061;Santa Eufemia;1153;584;569
14;Córdoba;060;Santaella;5875;2955;2920
14;Córdoba;062;Torrecampo;1417;698;719
14;Córdoba;063;Valenzuela;1463;711;752
14;Córdoba;064;Valsequillo;466;224;242
14;Córdoba;065;Victoria (La);1786;886;900
14;Córdoba;066;Villa del Río;7181;3632;3549
14;Córdoba;067;Villafranca de Córdoba;3686;1901;1785
14;Córdoba;068;Villaharta;640;319;321
14;Córdoba;069;Villanueva de Córdoba;9957;4852;5105
14;Córdoba;070;Villanueva del Duque;1825;852;973
14;Córdoba;071;Villanueva del Rey;1268;648;620
14;Córdoba;072;Villaralto;1533;743;790
14;Córdoba;073;Villaviciosa de Córdoba;3877;1995;1882
14;Córdoba;074;Viso (El);3124;1504;1620
14;Córdoba;075;Zuheros;904;450;454
15;Coruña (A);001;Abegondo;5480;2739;2741
15;Coruña (A);002;Ames;15318;7448;7870
15;Coruña (A);003;Aranga;2444;1222;1222
15;Coruña (A);004;Ares;4662;2307;2355
15;Coruña (A);005;Arteixo;21679;10880;10799
15;Coruña (A);006;Arzúa;6896;3375;3521
15;Coruña (A);007;Baña (A);5429;2603;2826
15;Coruña (A);008;Bergondo;5941;2885;3056
15;Coruña (A);009;Betanzos;12315;5835;6480
15;Coruña (A);010;Boimorto;2666;1339;1327
15;Coruña (A);011;Boiro;17915;8689;9226
15;Coruña (A);012;Boqueixón;4245;2090;2155
15;Coruña (A);013;Brión;6275;3014;3261
15;Coruña (A);014;Cabana de Bergantiños;5785;2867;2918
15;Coruña (A);015;Cabanas;3271;1591;1680
15;Coruña (A);016;Camariñas;7063;3475;3588
15;Coruña (A);017;Cambre;17074;8408;8666
15;Coruña (A);018;Capela (A);1601;783;818
15;Coruña (A);019;Carballo;27980;13624;14356
15;Coruña (A);901;Cariño;5110;2499;2611
15;Coruña (A);020;Carnota;5864;2816;3048
15;Coruña (A);021;Carral;5290;2571;2719
15;Coruña (A);022;Cedeira;7553;3704;3849
15;Coruña (A);023;Cee;7352;3537;3815
15;Coruña (A);024;Cerceda;5513;2692;2821
15;Coruña (A);025;Cerdido;1692;807;885
15;Coruña (A);026;Cesuras;2703;1349;1354
15;Coruña (A);027;Coirós;1549;761;788
15;Coruña (A);028;Corcubión;1929;932;997
15;Coruña (A);029;Coristanco;8218;4049;4169
15;Coruña (A);030;A Coruña;243402;113783;129619
15;Coruña (A);031;Culleredo;19867;9766;10101
15;Coruña (A);032;Curtis;4444;2176;2268
15;Coruña (A);033;Dodro;3296;1609;1687
15;Coruña (A);034;Dumbría;4611;2224;2387
15;Coruña (A);035;Fene;14875;7337;7538
15;Coruña (A);036;Ferrol;81991;38268;43723
15;Coruña (A);037;Fisterra;5295;2659;2636
15;Coruña (A);038;Frades;3096;1551;1545
15;Coruña (A);039;Irixoa;1758;869;889
15;Coruña (A);041;Laracha (A);10669;5213;5456
15;Coruña (A);040;Laxe;3541;1743;1798
15;Coruña (A);042;Lousame;4219;2022;2197
15;Coruña (A);043;Malpica de Bergantiños;7325;3592;3733
15;Coruña (A);045;Mazaricos;6349;3053;3296
15;Coruña (A);044;Mañón;1987;968;1019
15;Coruña (A);046;Melide;8430;4160;4270
15;Coruña (A);047;Mesía;3483;1730;1753
15;Coruña (A);048;Miño;4888;2308;2580
15;Coruña (A);049;Moeche;1569;756;813
15;Coruña (A);050;Monfero;2758;1413;1345
15;Coruña (A);051;Mugardos;6056;2932;3124
15;Coruña (A);053;Muros;10670;5118;5552
15;Coruña (A);052;Muxía;6422;3126;3296
15;Coruña (A);054;Narón;31108;15086;16022
15;Coruña (A);055;Neda;6192;2992;3200
15;Coruña (A);056;Negreira;6594;3153;3441
15;Coruña (A);057;Noia;14420;6899;7521
15;Coruña (A);058;Oleiros;25166;12219;12947
15;Coruña (A);059;Ordes;11946;5820;6126
15;Coruña (A);060;Oroso;4904;2419;2485
15;Coruña (A);061;Ortigueira;8603;4103;4500
15;Coruña (A);062;Outes;8739;4170;4569
15;Coruña (A);063;Oza dos Ríos;3221;1558;1663
15;Coruña (A);064;Paderne;2755;1321;1434
15;Coruña (A);065;Padrón;9548;4592;4956
15;Coruña (A);066;Pino (O);4990;2493;2497
15;Coruña (A);067;Pobra do Caramiñal (A);10066;4822;5244
15;Coruña (A);068;Ponteceso;7370;3688;3682
15;Coruña (A);069;Pontedeume;8857;4275;4582
15;Coruña (A);070;Pontes de García Rodríguez (As);12457;6295;6162
15;Coruña (A);071;Porto do Son;10376;5088;5288
15;Coruña (A);072;Rianxo;12147;5949;6198
15;Coruña (A);073;Ribeira;26451;13019;13432
15;Coruña (A);074;Rois;5238;2498;2740
15;Coruña (A);075;Sada;10621;5226;5395
15;Coruña (A);076;San Sadurniño;3487;1698;1789
15;Coruña (A);077;Santa Comba;10960;5400;5560
15;Coruña (A);078;Santiago de Compostela;93745;43955;49790
15;Coruña (A);079;Santiso;2319;1192;1127
15;Coruña (A);080;Sobrado;2541;1310;1231
15;Coruña (A);081;Somozas (As);1486;739;747
15;Coruña (A);082;Teo;14071;6876;7195
15;Coruña (A);083;Toques;1640;852;788
15;Coruña (A);084;Tordoia;5106;2431;2675
15;Coruña (A);085;Touro;4948;2430;2518
15;Coruña (A);086;Trazo;3864;1905;1959
15;Coruña (A);088;Val do Dubra;5079;2478;2601
15;Coruña (A);087;Valdoviño;6765;3328;3437
15;Coruña (A);089;Vedra;5088;2431;2657
15;Coruña (A);091;Vilarmaior;1429;729;700
15;Coruña (A);090;Vilasantar;1707;873;834
15;Coruña (A);092;Vimianzo;8937;4370;4567
15;Coruña (A);093;Zas;6226;2994;3232
16;Cuenca;001;Abia de la Obispalía;85;46;39
16;Cuenca;002;Acebrón (El);275;138;137
16;Cuenca;003;Alarcón;205;99;106
16;Cuenca;004;Albaladejo del Cuende;415;219;196
16;Cuenca;005;Albalate de las Nogueras;387;211;176
16;Cuenca;006;Albendea;186;93;93
16;Cuenca;007;Alberca de Záncara (La);1774;881;893
16;Cuenca;008;Alcalá de la Vega;172;95;77
16;Cuenca;009;Alcantud;127;68;59
16;Cuenca;011;Alcohujate;50;28;22
16;Cuenca;012;Alconchel de la Estrella;235;120;115
16;Cuenca;010;Alcázar del Rey;254;125;129
16;Cuenca;013;Algarra;34;18;16
16;Cuenca;014;Aliaguilla;859;452;407
16;Cuenca;015;Almarcha (La);631;318;313
16;Cuenca;016;Almendros;349;177;172
16;Cuenca;017;Almodóvar del Pinar;532;271;261
16;Cuenca;018;Almonacid del Marquesado;572;296;276
16;Cuenca;019;Altarejos;326;166;160
16;Cuenca;020;Arandilla del Arroyo;48;24;24
16;Cuenca;905;Arcas del Villar;636;315;321
16;Cuenca;022;Arcos de la Sierra;126;67;59
16;Cuenca;024;Arguisuelas;202;105;97
16;Cuenca;025;Arrancacepas;38;19;19
16;Cuenca;026;Atalaya del Cañavate;147;74;73
16;Cuenca;027;Barajas de Melo;741;361;380
16;Cuenca;029;Barchín del Hoyo;133;75;58
16;Cuenca;030;Bascuñana de San Pedro;43;24;19
16;Cuenca;031;Beamud;104;59;45
16;Cuenca;032;Belinchón;365;184;181
16;Cuenca;033;Belmonte;2474;1169;1305
16;Cuenca;034;Belmontejo;298;145;153
16;Cuenca;035;Beteta;412;203;209
16;Cuenca;036;Boniches;211;111;100
16;Cuenca;038;Buciegas;85;41;44
16;Cuenca;039;Buenache de Alarcón;614;317;297
16;Cuenca;040;Buenache de la Sierra;104;65;39
16;Cuenca;041;Buendía;530;259;271
16;Cuenca;042;Campillo de Altobuey;1675;829;846
16;Cuenca;043;Campillos-Paravientos;146;78;68
16;Cuenca;044;Campillos-Sierra;101;55;46
16;Cuenca;901;Campos del Paraíso;1147;536;611
16;Cuenca;045;Canalejas del Arroyo;321;169;152
16;Cuenca;055;Carboneras de Guadazaón;1026;539;487
16;Cuenca;056;Cardenete;694;357;337
16;Cuenca;057;Carrascosa;105;64;41
16;Cuenca;058;Carrascosa de Haro;154;78;76
16;Cuenca;060;Casas de Benítez;1067;507;560
16;Cuenca;061;Casas de Fernando Alonso;1365;669;696
16;Cuenca;062;Casas de Garcimolina;34;17;17
16;Cuenca;063;Casas de Guijarro;150;76;74
16;Cuenca;064;Casas de Haro;890;447;443
16;Cuenca;065;Casas de los Pinos;511;253;258
16;Cuenca;066;Casasimarro;3057;1556;1501
16;Cuenca;067;Castejón;235;114;121
16;Cuenca;068;Castillejo de Iniesta;192;105;87
16;Cuenca;070;Castillejo-Sierra;55;26;29
16;Cuenca;072;Castillo de Garcimuñoz;221;115;106
16;Cuenca;071;Castillo-Albaráñez;32;17;15
16;Cuenca;047;Cañada Juncosa;382;204;178
16;Cuenca;046;Cañada del Hoyo;360;189;171
16;Cuenca;048;Cañamares;586;310;276
16;Cuenca;049;Cañavate (El);258;124;134
16;Cuenca;050;Cañaveras;384;192;192
16;Cuenca;051;Cañaveruelas;239;121;118
16;Cuenca;052;Cañete;828;403;425
16;Cuenca;053;Cañizares;628;329;299
16;Cuenca;073;Cervera del Llano;340;171;169
16;Cuenca;023;Chillarón de Cuenca;360;190;170
16;Cuenca;081;Chumillas;42;28;14
16;Cuenca;074;Cierva (La);57;29;28
16;Cuenca;078;Cuenca;45100;21631;23469
16;Cuenca;079;Cueva del Hierro;46;27;19
16;Cuenca;082;Enguídanos;574;291;283
16;Cuenca;083;Fresneda de Altarejos;91;51;40
16;Cuenca;084;Fresneda de la Sierra;73;36;37
16;Cuenca;085;Frontera (La);215;109;106
16;Cuenca;086;Fuente de Pedro Naharro;1215;607;608
16;Cuenca;087;Fuentelespino de Haro;321;174;147
16;Cuenca;088;Fuentelespino de Moya;152;79;73
16;Cuenca;904;Fuentenava de Jábaga;343;179;164
16;Cuenca;089;Fuentes;505;262;243
16;Cuenca;091;Fuertescusa;114;63;51
16;Cuenca;092;Gabaldón;192;112;80
16;Cuenca;093;Garaballa;149;80;69
16;Cuenca;094;Gascueña;161;78;83
16;Cuenca;095;Graja de Campalbo;142;79;63
16;Cuenca;096;Graja de Iniesta;342;185;157
16;Cuenca;097;Henarejos;280;135;145
16;Cuenca;098;Herrumblar (El);781;402;379
16;Cuenca;099;Hinojosa (La);338;165;173
16;Cuenca;100;Hinojosos (Los);1090;538;552
16;Cuenca;101;Hito (El);235;117;118
16;Cuenca;102;Honrubia;1623;804;819
16;Cuenca;103;Hontanaya;468;231;237
16;Cuenca;104;Hontecillas;92;44;48
16;Cuenca;106;Horcajo de Santiago;3980;1988;1992
16;Cuenca;108;Huelves;69;27;42
16;Cuenca;110;Huerta de la Obispalía;153;85;68
16;Cuenca;111;Huerta del Marquesado;227;131;96
16;Cuenca;112;Huete;2219;1129;1090
16;Cuenca;107;Huélamo;149;79;70
16;Cuenca;109;Huérguina;149;75;74
16;Cuenca;113;Iniesta;3814;1887;1927
16;Cuenca;115;Laguna del Marquesado;79;44;35
16;Cuenca;116;Lagunaseca;123;59;64
16;Cuenca;117;Landete;1573;770;803
16;Cuenca;118;Ledaña;1940;962;978
16;Cuenca;119;Leganiel;234;118;116
16;Cuenca;121;Majadas (Las);371;179;192
16;Cuenca;122;Mariana;314;151;163
16;Cuenca;123;Masegosa;124;67;57
16;Cuenca;124;Mesas (Las);2501;1284;1217
16;Cuenca;125;Minglanilla;2295;1168;1127
16;Cuenca;126;Mira;1077;548;529
16;Cuenca;128;Monreal del Llano;84;43;41
16;Cuenca;129;Montalbanejo;199;91;108
16;Cuenca;130;Montalbo;771;399;372
16;Cuenca;131;Monteagudo de las Salinas;135;81;54
16;Cuenca;132;Mota de Altarejos;58;36;22
16;Cuenca;133;Mota del Cuervo;5445;2693;2752
16;Cuenca;134;Motilla del Palancar;5149;2591;2558
16;Cuenca;135;Moya;296;158;138
16;Cuenca;137;Narboneta;123;59;64
16;Cuenca;139;Olivares de Júcar;560;289;271
16;Cuenca;140;Olmeda de la Cuesta;47;28;19
16;Cuenca;141;Olmeda del Rey;254;123;131
16;Cuenca;142;Olmedilla de Alarcón;177;89;88
16;Cuenca;143;Olmedilla de Eliz;31;17;14
16;Cuenca;145;Osa de la Vega;658;322;336
16;Cuenca;147;Pajaroncillo;100;48;52
16;Cuenca;146;Pajarón;144;78;66
16;Cuenca;148;Palomares del Campo;1103;539;564
16;Cuenca;149;Palomera;175;86;89
16;Cuenca;150;Paracuellos;156;71;85
16;Cuenca;151;Paredes;77;41;36
16;Cuenca;152;Parra de las Vegas (La);64;35;29
16;Cuenca;153;Pedernoso (El);1337;671;666
16;Cuenca;154;Pedroñeras (Las);6429;3280;3149
16;Cuenca;155;Peral (El);736;377;359
16;Cuenca;156;Peraleja (La);172;84;88
16;Cuenca;157;Pesquera (La);275;141;134
16;Cuenca;158;Picazo (El);714;350;364
16;Cuenca;159;Pinarejo;410;209;201
16;Cuenca;160;Pineda de Gigüela;156;84;72
16;Cuenca;161;Piqueras del Castillo;81;45;36
16;Cuenca;162;Portalrubio de Guadamejud;91;44;47
16;Cuenca;163;Portilla;90;46;44
16;Cuenca;165;Poyatos;123;71;52
16;Cuenca;166;Pozoamargo;315;153;162
16;Cuenca;908;Pozorrubielos de la Mancha;308;160;148
16;Cuenca;167;Pozorrubio;511;239;272
16;Cuenca;169;Pozuelo (El);93;48;45
16;Cuenca;170;Priego;1026;527;499
16;Cuenca;171;Provencio (El);2587;1298;1289
16;Cuenca;172;Puebla de Almenara;549;286;263
16;Cuenca;173;Puebla de Don Francisco;368;180;188
16;Cuenca;174;Puebla del Salvador;294;158;136
16;Cuenca;175;Quintanar del Rey;6158;3135;3023
16;Cuenca;176;Rada de Haro;71;34;37
16;Cuenca;177;Reíllo;148;75;73
16;Cuenca;181;Rozalén del Monte;121;56;65
16;Cuenca;185;Saceda-Trasierra;99;53;46
16;Cuenca;186;Saelices;696;346;350
16;Cuenca;187;Salinas del Manzano;118;67;51
16;Cuenca;188;Salmeroncillos;182;92;90
16;Cuenca;189;Salvacañete;347;190;157
16;Cuenca;190;San Clemente;6286;3112;3174
16;Cuenca;191;San Lorenzo de la Parrilla;1470;739;731
16;Cuenca;192;San Martín de Boniches;111;56;55
16;Cuenca;193;San Pedro Palmiches;105;54;51
16;Cuenca;194;Santa Cruz de Moya;417;212;205
16;Cuenca;196;Santa María de los Llanos;893;458;435
16;Cuenca;195;Santa María del Campo Rus;778;392;386
16;Cuenca;197;Santa María del Val;119;64;55
16;Cuenca;198;Sisante;1801;903;898
16;Cuenca;199;Solera de Gabaldón;51;26;25
16;Cuenca;909;Sotorribas;1119;555;564
16;Cuenca;202;Talayuelas;1176;608;568
16;Cuenca;203;Tarancón;11335;5577;5758
16;Cuenca;205;Tejadillos;174;90;84
16;Cuenca;206;Tinajas;361;195;166
16;Cuenca;209;Torralba;188;95;93
16;Cuenca;211;Torrejoncillo del Rey;709;334;375
16;Cuenca;212;Torrubia del Campo;364;170;194
16;Cuenca;213;Torrubia del Castillo;44;22;22
16;Cuenca;215;Tragacete;386;211;175
16;Cuenca;216;Tresjuncos;496;249;247
16;Cuenca;217;Tribaldos;135;63;72
16;Cuenca;204;Tébar;411;222;189
16;Cuenca;218;Uclés;300;141;159
16;Cuenca;219;Uña;147;75;72
16;Cuenca;906;Valdecolmenas (Los);127;68;59
16;Cuenca;224;Valdemeca;114;61;53
16;Cuenca;225;Valdemorillo de la Sierra;99;54;45
16;Cuenca;227;Valdemoro-Sierra;189;102;87
16;Cuenca;228;Valdeolivas;305;160;145
16;Cuenca;902;Valdetórtola;143;79;64
16;Cuenca;903;Valeras (Las);1386;687;699
16;Cuenca;231;Valhermoso de la Fuente;60;29;31
16;Cuenca;234;Valsalobre;52;26;26
16;Cuenca;236;Valverde de Júcar;1365;682;683
16;Cuenca;237;Valverdejo;152;79;73
16;Cuenca;238;Vara de Rey;707;350;357
16;Cuenca;239;Vega del Codorno;239;124;115
16;Cuenca;240;Vellisca;179;88;91
16;Cuenca;242;Villaconejos de Trabaque;531;269;262
16;Cuenca;243;Villaescusa de Haro;623;317;306
16;Cuenca;244;Villagarcía del Llano;966;476;490
16;Cuenca;245;Villalba de la Sierra;561;292;269
16;Cuenca;246;Villalba del Rey;707;360;347
16;Cuenca;247;Villalgordo del Marquesado;132;67;65
16;Cuenca;248;Villalpardo;1104;573;531
16;Cuenca;249;Villamayor de Santiago;2721;1351;1370
16;Cuenca;250;Villanueva de Guadamejud;130;62;68
16;Cuenca;251;Villanueva de la Jara;2450;1240;1210
16;Cuenca;253;Villar de Cañas;441;214;227
16;Cuenca;254;Villar de Domingo García;272;138;134
16;Cuenca;263;Villar de Olalla;880;456;424
16;Cuenca;255;Villar de la Encina;241;119;122
16;Cuenca;258;Villar del Humo;475;252;223
16;Cuenca;259;Villar del Infantado;50;29;21
16;Cuenca;910;Villar y Velasco;125;69;56
16;Cuenca;264;Villarejo de Fuentes;813;393;420
16;Cuenca;265;Villarejo de la Peñuela;32;15;17
16;Cuenca;266;Villarejo-Periesteban;538;273;265
16;Cuenca;269;Villares del Saz;729;366;363
16;Cuenca;270;Villarrubio;266;141;125
16;Cuenca;271;Villarta;781;414;367
16;Cuenca;272;Villas de la Ventosa;386;204;182
16;Cuenca;273;Villaverde y Pasaconsol;435;211;224
16;Cuenca;275;Vindel;24;16;8
16;Cuenca;274;Víllora;245;122;123
16;Cuenca;276;Yémeda;30;13;17
16;Cuenca;277;Zafra de Záncara;215;110;105
16;Cuenca;278;Zafrilla;137;63;74
16;Cuenca;279;Zarza de Tajo;268;123;145
16;Cuenca;280;Zarzuela;297;147;150
17;Girona;001;Agullana;624;322;302
17;Girona;002;Aiguaviva;471;236;235
17;Girona;003;Albanyà;137;73;64
17;Girona;004;Albons;564;293;271
17;Girona;006;Alp;1127;582;545
17;Girona;007;Amer;2246;1114;1132
17;Girona;008;Anglès;4943;2471;2472
17;Girona;009;Arbúcies;4939;2481;2458
17;Girona;010;Argelaguer;368;200;168
17;Girona;011;Armentera (L');742;372;370
17;Girona;012;Avinyonet de Puigventós;507;253;254
17;Girona;015;Banyoles;14985;7358;7627
17;Girona;016;Bàscara;803;413;390
17;Girona;013;Begur;3288;1650;1638
17;Girona;018;Bellcaire d'Empordà;516;265;251
17;Girona;019;Besalú;1983;965;1018
17;Girona;020;Bescanó;3159;1592;1567
17;Girona;021;Beuda;128;71;57
17;Girona;022;Bisbal d'Empordà (La);8182;4001;4181
17;Girona;234;Biure;218;110;108
17;Girona;023;Blanes;29615;14871;14744
17;Girona;029;Boadella d'Empordà;225;113;112
17;Girona;024;Bolvir;264;134;130
17;Girona;025;Bordils;1416;706;710
17;Girona;026;Borrassà;518;257;261
17;Girona;027;Breda;3325;1706;1619
17;Girona;028;Brunyola;395;200;195
17;Girona;031;Cabanelles;230;132;98
17;Girona;030;Cabanes;777;393;384
17;Girona;032;Cadaqués;2280;1123;1157
17;Girona;033;Caldes de Malavella;3867;1945;1922
17;Girona;034;Calonge;6663;3334;3329
17;Girona;035;Camós;631;323;308
17;Girona;036;Campdevànol;3349;1638;1711
17;Girona;037;Campelles;117;61;56
17;Girona;038;Campllong;311;160;151
17;Girona;039;Camprodon;2350;1161;1189
17;Girona;040;Canet d'Adri;522;266;256
17;Girona;041;Cantallops;264;135;129
17;Girona;042;Capmany;407;202;205
17;Girona;044;Cassà de la Selva;7583;3764;3819
17;Girona;046;Castellfollit de la Roca;968;471;497
17;Girona;047;Castelló d'Empúries;5816;2960;2856
17;Girona;048;Castell-Platja d'Aro;6185;3116;3069
17;Girona;189;Cellera de Ter (La);2028;1002;1026
17;Girona;049;Celrà;2640;1279;1361
17;Girona;050;Cervià de Ter;624;311;313
17;Girona;051;Cistella;223;111;112
17;Girona;054;Colera;581;293;288
17;Girona;055;Colomers;204;102;102
17;Girona;057;Corçà;1122;571;551
17;Girona;056;Cornellà del Terri;1889;946;943
17;Girona;058;Crespià;194;94;100
17;Girona;901;Cruïlles, Monells i Sant Sadurní de l'Heura;1100;540;560
17;Girona;060;Darnius;515;272;243
17;Girona;061;Das;155;84;71
17;Girona;062;Escala (L');5926;2956;2970
17;Girona;063;Espinelves;188;95;93
17;Girona;064;Espolla;372;190;182
17;Girona;065;Esponellà;398;201;197
17;Girona;005;Far d'Empordà (El);386;200;186
17;Girona;066;Figueres;33823;16408;17415
17;Girona;067;Flaçà;844;423;421
17;Girona;068;Foixà;317;155;162
17;Girona;069;Fontanals de Cerdanya;400;204;196
17;Girona;070;Fontanilles;124;68;56
17;Girona;071;Fontcoberta;1077;542;535
17;Girona;902;Forallac;1650;805;845
17;Girona;073;Fornells de la Selva;1410;686;724
17;Girona;074;Fortià;507;249;258
17;Girona;075;Garrigàs;316;169;147
17;Girona;076;Garrigoles;151;83;68
17;Girona;077;Garriguella;687;349;338
17;Girona;078;Ger;356;183;173
17;Girona;079;Girona;72682;34944;37738
17;Girona;080;Gombrèn;237;112;125
17;Girona;081;Gualta;284;141;143
17;Girona;082;Guils de Cerdanya;331;163;168
17;Girona;083;Hostalric;2894;1424;1470
17;Girona;084;Isòvol;198;107;91
17;Girona;085;Jafre;332;170;162
17;Girona;086;Jonquera (La);2510;1249;1261
17;Girona;087;Juià;260;124;136
17;Girona;088;Lladó;504;257;247
17;Girona;089;Llagostera;5624;2847;2777
17;Girona;090;Llambilles;450;224;226
17;Girona;091;Llanars;475;245;230
17;Girona;092;Llançà;3982;1975;2007
17;Girona;093;Llers;922;466;456
17;Girona;094;Llívia;961;505;456
17;Girona;095;Lloret de Mar;19041;9511;9530
17;Girona;096;Llosses (Les);275;144;131
17;Girona;102;Maçanet de Cabrenys;650;343;307
17;Girona;103;Maçanet de la Selva;3672;1880;1792
17;Girona;097;Madremanya;188;80;108
17;Girona;098;Maià de Montcal;314;159;155
17;Girona;100;Masarac;239;118;121
17;Girona;101;Massanes;506;263;243
17;Girona;099;Meranges;80;47;33
17;Girona;105;Mieres;334;171;163
17;Girona;106;Mollet de Peralada;184;100;84
17;Girona;107;Molló;343;176;167
17;Girona;109;Montagut i Oix;781;405;376
17;Girona;110;Mont-ras;1599;850;749
17;Girona;111;Navata;670;332;338
17;Girona;112;Ogassa;239;141;98
17;Girona;114;Olot;27814;13412;14402
17;Girona;115;Ordis;291;154;137
17;Girona;116;Osor;468;253;215
17;Girona;117;Palafrugell;17816;8935;8881
17;Girona;118;Palamós;14740;7268;7472
17;Girona;119;Palau de Santa Eulàlia;89;51;38
17;Girona;121;Palau-sator;292;152;140
17;Girona;120;Palau-saverdera;914;464;450
17;Girona;122;Palmerola;"";"";""
17;Girona;123;Palol de Revardit;370;192;178
17;Girona;124;Pals;1842;944;898
17;Girona;125;Pardines;139;69;70
17;Girona;126;Parlavà;330;174;156
17;Girona;128;Pau;420;207;213
17;Girona;129;Pedret i Marzà;125;62;63
17;Girona;130;Pera (La);370;188;182
17;Girona;132;Peralada;1242;632;610
17;Girona;133;Planes d'Hostoles (Les);1735;857;878
17;Girona;134;Planoles;277;151;126
17;Girona;135;Pont de Molins;450;242;208
17;Girona;136;Pontós;215;120;95
17;Girona;137;Porqueres;3511;1726;1785
17;Girona;140;Port de la Selva (El);848;427;421
17;Girona;138;Portbou;283;176;107
17;Girona;139;Preses (Les);1341;658;683
17;Girona;141;Puigcerdà;6699;3396;3303
17;Girona;142;Quart;2275;1165;1110
17;Girona;043;Queralbs;197;110;87
17;Girona;143;Rabós;148;71;77
17;Girona;144;Regencós;292;167;125
17;Girona;145;Ribes de Freser;2118;1031;1087
17;Girona;146;Riells i Viabrea;1862;972;890
17;Girona;147;Ripoll;10818;5238;5580
17;Girona;148;Riudarenes;1258;655;603
17;Girona;149;Riudaura;405;206;199
17;Girona;150;Riudellots de la Selva;1509;770;739
17;Girona;151;Riumors;192;98;94
17;Girona;152;Roses;12408;6209;6199
17;Girona;153;Rupià;192;106;86
17;Girona;154;Sales de Llierca;81;46;35
17;Girona;155;Salt;21822;10829;10993
17;Girona;157;Sant Andreu Salou;145;71;74
17;Girona;183;Sant Aniol de Finestres;269;146;123
17;Girona;158;Sant Climent Sescebes;415;212;203
17;Girona;159;Sant Feliu de Buixalleu;717;388;329
17;Girona;160;Sant Feliu de Guíxols;18067;8869;9198
17;Girona;161;Sant Feliu de Pallerols;1140;555;585
17;Girona;162;Sant Ferriol;209;117;92
17;Girona;163;Sant Gregori;2288;1194;1094
17;Girona;164;Sant Hilari Sacalm;4932;2483;2449
17;Girona;165;Sant Jaume de Llierca;711;351;360
17;Girona;167;Sant Joan de les Abadesses;3706;1822;1884
17;Girona;168;Sant Joan de Mollet;352;171;181
17;Girona;185;Sant Joan les Fonts;2775;1372;1403
17;Girona;166;Sant Jordi Desvalls;597;306;291
17;Girona;169;Sant Julià de Ramis;1986;1006;980
17;Girona;903;Sant Julià del Llor i Bonmatí;938;473;465
17;Girona;171;Sant Llorenç de la Muga;152;74;78
17;Girona;172;Sant Martí de Llémena;463;237;226
17;Girona;173;Sant Martí Vell;164;84;80
17;Girona;174;Sant Miquel de Campmajor;218;123;95
17;Girona;175;Sant Miquel de Fluvià;603;308;295
17;Girona;176;Sant Mori;154;76;78
17;Girona;177;Sant Pau de Segúries;650;329;321
17;Girona;178;Sant Pere Pescador;1377;749;628
17;Girona;180;Santa Coloma de Farners;8695;4427;4268
17;Girona;181;Santa Cristina d'Aro;2730;1430;1300
17;Girona;182;Santa Llogaia d'Àlguema;298;157;141
17;Girona;184;Santa Pau;1501;770;731
17;Girona;186;Sarrià de Ter;3347;1648;1699
17;Girona;187;Saus, Camallera i Llampaies;702;343;359
17;Girona;188;Selva de Mar (La);191;97;94
17;Girona;190;Serinyà;822;432;390
17;Girona;191;Serra de Daró;180;91;89
17;Girona;192;Setcases;160;83;77
17;Girona;193;Sils;2896;1468;1428
17;Girona;052;Siurana;155;74;81
17;Girona;194;Susqueda;92;52;40
17;Girona;195;Tallada d'Empordà (La);330;171;159
17;Girona;196;Terrades;185;88;97
17;Girona;197;Torrent;167;82;85
17;Girona;198;Torroella de Fluvià;309;174;135
17;Girona;199;Torroella de Montgrí;8265;4201;4064
17;Girona;200;Tortellà;697;350;347
17;Girona;201;Toses;139;83;56
17;Girona;202;Tossa de Mar;4115;2041;2074
17;Girona;204;Ullà;788;409;379
17;Girona;205;Ullastret;245;129;116
17;Girona;203;Ultramort;193;107;86
17;Girona;206;Urús;179;94;85
17;Girona;014;Vajol (La);97;51;46
17;Girona;208;Vall de Bianya (La);1131;564;567
17;Girona;207;Vall d'en Bas (La);2536;1295;1241
17;Girona;170;Vallfogona de Ripollès;224;115;109
17;Girona;209;Vall-llobrega;358;147;211
17;Girona;210;Ventalló;606;317;289
17;Girona;211;Verges;1126;556;570
17;Girona;212;Vidrà;164;80;84
17;Girona;213;Vidreres;4489;2269;2220
17;Girona;214;Vilabertran;797;400;397
17;Girona;215;Vilablareix;1658;826;832
17;Girona;217;Viladamat;404;212;192
17;Girona;216;Viladasens;187;96;91
17;Girona;218;Vilademuls;744;373;371
17;Girona;220;Viladrau;856;429;427
17;Girona;221;Vilafant;3834;1909;1925
17;Girona;223;Vilajuïga;924;462;462
17;Girona;224;Vilallonga de Ter;427;230;197
17;Girona;225;Vilamacolum;255;128;127
17;Girona;226;Vilamalla;699;366;333
17;Girona;227;Vilamaniscle;120;63;57
17;Girona;228;Vilanant;297;157;140
17;Girona;230;Vila-sacra;363;181;182
17;Girona;222;Vilaür;115;67;48
17;Girona;233;Vilobí d'Onyar;2182;1148;1034
17;Girona;232;Vilopriu;172;88;84
18;Granada;001;Agrón;415;214;201
18;Granada;002;Alamedilla;947;480;467
18;Granada;003;Albolote;12916;6497;6419
18;Granada;004;Albondón;1060;520;540
18;Granada;005;Albuñán;478;239;239
18;Granada;006;Albuñol;5547;2777;2770
18;Granada;007;Albuñuelas;1249;642;607
18;Granada;010;Aldeire;786;397;389
18;Granada;011;Alfacar;4333;2206;2127
18;Granada;012;Algarinejo;5265;2699;2566
18;Granada;013;Alhama de Granada;5934;2965;2969
18;Granada;014;Alhendín;4223;2124;2099
18;Granada;015;Alicún de Ortega;719;380;339
18;Granada;016;Almegíjar;420;213;207
18;Granada;017;Almuñécar;21170;10444;10726
18;Granada;904;Alpujarra de la Sierra;1221;619;602
18;Granada;018;Alquife;930;465;465
18;Granada;020;Arenas del Rey;2043;1068;975
18;Granada;021;Armilla;13706;6765;6941
18;Granada;022;Atarfe;11220;5552;5668
18;Granada;023;Baza;21336;10465;10871
18;Granada;024;Beas de Granada;990;517;473
18;Granada;025;Beas de Guadix;384;203;181
18;Granada;027;Benalúa;3327;1667;1660
18;Granada;028;Benalúa de las Villas;1473;727;746
18;Granada;029;Benamaurel;2420;1220;1200
18;Granada;030;Bérchules;814;430;384
18;Granada;032;Bubión;372;180;192
18;Granada;033;Busquístar;370;202;168
18;Granada;034;Cacín;836;419;417
18;Granada;035;Cádiar;1650;852;798
18;Granada;036;Cájar;3243;1543;1700
18;Granada;114;Calahorra (La);931;454;477
18;Granada;037;Calicasas;599;303;296
18;Granada;038;Campotéjar;1447;731;716
18;Granada;039;Caniles;5116;2498;2618
18;Granada;040;Cáñar;325;155;170
18;Granada;042;Capileira;560;272;288
18;Granada;043;Carataunas;190;98;92
18;Granada;044;Cástaras;310;166;144
18;Granada;045;Castilléjar;1859;916;943
18;Granada;046;Castril;3093;1578;1515
18;Granada;047;Cenes de la Vega;5043;2584;2459
18;Granada;059;Chauchina;4138;2049;2089
18;Granada;061;Chimeneas;1537;770;767
18;Granada;062;Churriana de la Vega;6669;3293;3376
18;Granada;048;Cijuela;1522;748;774
18;Granada;049;Cogollos de Guadix;774;402;372
18;Granada;050;Cogollos de la Vega;2020;1028;992
18;Granada;051;Colomera;1664;847;817
18;Granada;053;Cortes de Baza;2886;1482;1404
18;Granada;054;Cortes y Graena;1023;524;499
18;Granada;912;Cuevas del Campo;2232;1105;1127
18;Granada;056;Cúllar;5078;2533;2545
18;Granada;057;Cúllar Vega;3171;1585;1586
18;Granada;063;Darro;1526;758;768
18;Granada;064;Dehesas de Guadix;679;342;337
18;Granada;066;Deifontes;2424;1212;1212
18;Granada;067;Diezma;941;491;450
18;Granada;068;Dílar;1510;742;768
18;Granada;069;Dólar;629;305;324
18;Granada;070;Dúdar;292;155;137
18;Granada;071;Dúrcal;5667;2792;2875
18;Granada;072;Escúzar;849;421;428
18;Granada;074;Ferreira;365;177;188
18;Granada;076;Fonelas;1256;625;631
18;Granada;078;Freila;1034;526;508
18;Granada;079;Fuente Vaqueros;4038;1993;2045
18;Granada;905;Gabias (Las);8338;4205;4133
18;Granada;082;Galera;1360;678;682
18;Granada;083;Gobernador;387;195;192
18;Granada;084;Gójar;3502;1805;1697
18;Granada;085;Gor;1167;581;586
18;Granada;086;Gorafe;575;279;296
18;Granada;087;Granada;244767;114078;130689
18;Granada;088;Guadahortuna;2285;1180;1105
18;Granada;089;Guadix;20246;10001;10245
18;Granada;906;Guajares (Los);1327;682;645
18;Granada;093;Gualchos;2969;1497;1472
18;Granada;094;Güejar Sierra;2769;1416;1353
18;Granada;095;Güevéjar;1507;753;754
18;Granada;096;Huélago;617;322;295
18;Granada;097;Huéneja;1246;612;634
18;Granada;098;Huéscar;8024;3962;4062
18;Granada;099;Huétor de Santillán;1665;871;794
18;Granada;100;Huétor Tájar;8313;4138;4175
18;Granada;101;Huétor Vega;8575;4311;4264
18;Granada;102;Illora;10672;5361;5311
18;Granada;103;Itrabo;1029;505;524
18;Granada;105;Iznalloz;7094;3594;3500
18;Granada;107;Jayena;1355;689;666
18;Granada;108;Jerez del Marquesado;1163;584;579
18;Granada;109;Jete;756;358;398
18;Granada;111;Jun;1724;873;851
18;Granada;112;Juviles;183;91;92
18;Granada;115;Láchar;2477;1241;1236
18;Granada;116;Lanjarón;3870;1900;1970
18;Granada;117;Lanteira;643;323;320
18;Granada;119;Lecrín;2322;1147;1175
18;Granada;120;Lentegí;340;158;182
18;Granada;121;Lobras;176;86;90
18;Granada;122;Loja;20143;9969;10174
18;Granada;123;Lugros;397;201;196
18;Granada;124;Lújar;562;298;264
18;Granada;126;Malahá (La);1587;802;785
18;Granada;127;Maracena;14331;7139;7192
18;Granada;128;Marchal;422;198;224
18;Granada;132;Moclín;4544;2235;2309
18;Granada;133;Molvízar;2769;1352;1417
18;Granada;134;Monachil;5067;2572;2495
18;Granada;135;Montefrío;7028;3514;3514
18;Granada;136;Montejícar;2861;1439;1422
18;Granada;137;Montillana;1393;704;689
18;Granada;138;Moraleda de Zafayona;2809;1440;1369
18;Granada;909;Morelábor;968;496;472
18;Granada;140;Motril;50398;24879;25519
18;Granada;141;Murtas;834;427;407
18;Granada;903;Nevada;1431;715;716
18;Granada;143;Nigüelas;1115;564;551
18;Granada;144;Nívar;651;334;317
18;Granada;145;Ogíjares;8502;4286;4216
18;Granada;146;Orce;1460;726;734
18;Granada;147;Órgiva;5123;2580;2543
18;Granada;148;Otívar;1090;545;545
18;Granada;149;Otura;4058;2045;2013
18;Granada;150;Padul;6777;3407;3370
18;Granada;151;Pampaneira;345;178;167
18;Granada;152;Pedro Martínez;1427;714;713
18;Granada;153;Peligros;7380;3653;3727
18;Granada;154;Peza (La);1464;767;697
18;Granada;910;Pinar (El);1210;611;599
18;Granada;157;Pinos Genil;1159;603;556
18;Granada;158;Pinos Puente;13524;6833;6691
18;Granada;159;Píñar;1376;712;664
18;Granada;161;Polícar;265;141;124
18;Granada;162;Polopos;1264;655;609
18;Granada;163;Pórtugos;437;211;226
18;Granada;164;Puebla de Don Fadrique;2550;1271;1279
18;Granada;165;Pulianas;3835;1955;1880
18;Granada;167;Purullena;2022;990;1032
18;Granada;168;Quéntar;1108;553;555
18;Granada;170;Rubite;400;211;189
18;Granada;171;Salar;2793;1377;1416
18;Granada;173;Salobreña;10255;5090;5165
18;Granada;174;Santa Cruz del Comercio;550;287;263
18;Granada;175;Santa Fe;12740;6291;6449
18;Granada;176;Soportújar;276;149;127
18;Granada;177;Sorvilán;665;340;325
18;Granada;901;Taha (La);831;417;414
18;Granada;178;Torre-Cardela;1206;603;603
18;Granada;179;Torvizcón;955;482;473
18;Granada;180;Trevélez;779;413;366
18;Granada;181;Turón;377;213;164
18;Granada;182;Ugíjar;2499;1229;1270
18;Granada;907;Valle del Zalabí;2392;1180;1212
18;Granada;902;Valle (El);1326;641;685
18;Granada;183;Válor;1001;506;495
18;Granada;911;Vegas del Genil;2791;1403;1388
18;Granada;184;Vélez de Benaudalla;2569;1262;1307
18;Granada;185;Ventas de Huelma;665;328;337
18;Granada;908;Villamena;1009;474;535
18;Granada;187;Villanueva de las Torres;938;490;448
18;Granada;188;Villanueva Mesía;1933;954;979
18;Granada;189;Víznar;742;393;349
18;Granada;192;Zafarraya;2194;1139;1055
18;Granada;913;Zagra;1195;594;601
18;Granada;193;Zubia (La);12826;6305;6521
18;Granada;194;Zújar;2831;1439;1392
19;Guadalajara;001;Abánades;119;66;53
19;Guadalajara;002;Ablanque;154;76;78
19;Guadalajara;003;Adobes;42;21;21
19;Guadalajara;004;Alaminos;83;39;44
19;Guadalajara;005;Alarilla;120;66;54
19;Guadalajara;006;Albalate de Zorita;936;504;432
19;Guadalajara;007;Albares;483;236;247
19;Guadalajara;008;Albendiego;46;26;20
19;Guadalajara;009;Alcocer;310;153;157
19;Guadalajara;010;Alcolea de las Peñas;30;15;15
19;Guadalajara;011;Alcolea del Pinar;421;207;214
19;Guadalajara;013;Alcoroches;196;108;88
19;Guadalajara;015;Aldeanueva de Guadalajara;105;45;60
19;Guadalajara;016;Algar de Mesa;80;43;37
19;Guadalajara;017;Algora;122;68;54
19;Guadalajara;018;Alhóndiga;232;129;103
19;Guadalajara;019;Alique;35;12;23
19;Guadalajara;020;Almadrones;100;64;36
19;Guadalajara;021;Almoguera;961;498;463
19;Guadalajara;022;Almonacid de Zorita;921;446;475
19;Guadalajara;023;Alocén;157;74;83
19;Guadalajara;024;Alovera;1576;805;771
19;Guadalajara;027;Alustante;253;137;116
19;Guadalajara;031;Angón;47;26;21
19;Guadalajara;032;Anguita;289;151;138
19;Guadalajara;033;Anquela del Ducado;93;49;44
19;Guadalajara;034;Anquela del Pedregal;25;15;10
19;Guadalajara;036;Aranzueque;384;189;195
19;Guadalajara;037;Arbancón;214;114;100
19;Guadalajara;038;Arbeteta;50;24;26
19;Guadalajara;039;Argecilla;111;66;45
19;Guadalajara;040;Armallones;60;33;27
19;Guadalajara;041;Armuña de Tajuña;110;61;49
19;Guadalajara;042;Arroyo de las Fraguas;43;21;22
19;Guadalajara;043;Atanzón;105;61;44
19;Guadalajara;044;Atienza;470;244;226
19;Guadalajara;045;Auñón;263;139;124
19;Guadalajara;046;Azuqueca de Henares;18592;9425;9167
19;Guadalajara;047;Baides;82;42;40
19;Guadalajara;048;Baños de Tajo;31;20;11
19;Guadalajara;049;Bañuelos;30;17;13
19;Guadalajara;050;Barriopedro;32;13;19
19;Guadalajara;051;Berninches;113;66;47
19;Guadalajara;052;Bodera (La);58;32;26
19;Guadalajara;053;Brihuega;2891;1493;1398
19;Guadalajara;054;Budia;286;157;129
19;Guadalajara;055;Bujalaro;80;42;38
19;Guadalajara;057;Bustares;100;56;44
19;Guadalajara;058;Cabanillas del Campo;2214;1130;1084
19;Guadalajara;059;Campillo de Dueñas;138;80;58
19;Guadalajara;060;Campillo de Ranas;144;75;69
19;Guadalajara;061;Campisábalos;72;33;39
19;Guadalajara;064;Canredondo;103;52;51
19;Guadalajara;065;Cantalojas;163;86;77
19;Guadalajara;066;Cañizar;110;52;58
19;Guadalajara;067;Cardoso de la Sierra (El);93;60;33
19;Guadalajara;070;Casa de Uceda;109;57;52
19;Guadalajara;071;Casar (El);2796;1460;1336
19;Guadalajara;073;Casas de San Galindo;40;23;17
19;Guadalajara;074;Caspueñas;85;51;34
19;Guadalajara;075;Castejón de Henares;115;62;53
19;Guadalajara;076;Castellar de la Muela;54;25;29
19;Guadalajara;078;Castilforte;47;27;20
19;Guadalajara;079;Castilnuevo;12;6;6
19;Guadalajara;080;Cendejas de Enmedio;128;64;64
19;Guadalajara;081;Cendejas de la Torre;100;56;44
19;Guadalajara;082;Centenera;72;39;33
19;Guadalajara;103;Checa;414;224;190
19;Guadalajara;104;Chequilla;16;8;8
19;Guadalajara;106;Chillarón del Rey;127;67;60
19;Guadalajara;105;Chiloeches;1060;549;511
19;Guadalajara;086;Cifuentes;2222;1115;1107
19;Guadalajara;087;Cincovillas;37;20;17
19;Guadalajara;088;Ciruelas;101;57;44
19;Guadalajara;089;Ciruelos del Pinar;57;31;26
19;Guadalajara;090;Cobeta;119;64;55
19;Guadalajara;091;Cogollor;59;31;28
19;Guadalajara;092;Cogolludo;583;325;258
19;Guadalajara;095;Condemios de Abajo;29;17;12
19;Guadalajara;096;Condemios de Arriba;170;80;90
19;Guadalajara;097;Congostrina;43;19;24
19;Guadalajara;098;Copernal;28;17;11
19;Guadalajara;099;Corduente;462;253;209
19;Guadalajara;102;Cubillo de Uceda (El);131;62;69
19;Guadalajara;107;Driebes;364;190;174
19;Guadalajara;108;Durón;114;55;59
19;Guadalajara;109;Embid;68;37;31
19;Guadalajara;110;Escamilla;129;54;75
19;Guadalajara;111;Escariche;193;101;92
19;Guadalajara;112;Escopete;60;19;41
19;Guadalajara;113;Espinosa de Henares;568;281;287
19;Guadalajara;114;Esplegares;63;37;26
19;Guadalajara;115;Establés;46;25;21
19;Guadalajara;116;Estriégana;26;16;10
19;Guadalajara;117;Fontanar;932;484;448
19;Guadalajara;118;Fuembellida;16;9;7
19;Guadalajara;119;Fuencemillán;114;58;56
19;Guadalajara;120;Fuentelahiguera de Albatages;165;81;84
19;Guadalajara;121;Fuentelencina;180;101;79
19;Guadalajara;122;Fuentelsaz;137;66;71
19;Guadalajara;123;Fuentelviejo;81;42;39
19;Guadalajara;124;Fuentenovilla;225;123;102
19;Guadalajara;125;Gajanejos;85;46;39
19;Guadalajara;126;Galápagos;285;144;141
19;Guadalajara;127;Galve de Sorbe;157;76;81
19;Guadalajara;129;Gascueña de Bornova;46;24;22
19;Guadalajara;130;Guadalajara;69959;34356;35603
19;Guadalajara;132;Henche;87;47;40
19;Guadalajara;133;Heras de Ayuso;122;62;60
19;Guadalajara;134;Herrería;37;16;21
19;Guadalajara;135;Hiendelaencina;136;71;65
19;Guadalajara;136;Hijes;26;14;12
19;Guadalajara;138;Hita;282;158;124
19;Guadalajara;139;Hombrados;49;27;22
19;Guadalajara;142;Hontoba;186;90;96
19;Guadalajara;143;Horche;1407;712;695
19;Guadalajara;145;Hortezuela de Océn;79;41;38
19;Guadalajara;146;Huerce (La);45;25;20
19;Guadalajara;147;Huérmeces del Cerro;62;39;23
19;Guadalajara;148;Huertahernando;70;43;27
19;Guadalajara;150;Hueva;139;68;71
19;Guadalajara;151;Humanes;1188;610;578
19;Guadalajara;152;Illana;684;358;326
19;Guadalajara;153;Iniéstola;18;11;7
19;Guadalajara;154;Inviernas (Las);100;55;45
19;Guadalajara;155;Irueste;68;37;31
19;Guadalajara;156;Jadraque;1253;627;626
19;Guadalajara;157;Jirueque;88;48;40
19;Guadalajara;159;Ledanca;133;72;61
19;Guadalajara;160;Loranca de Tajuña;335;190;145
19;Guadalajara;161;Lupiana;275;149;126
19;Guadalajara;162;Luzaga;124;60;64
19;Guadalajara;163;Luzón;85;42;43
19;Guadalajara;165;Majaelrayo;57;32;25
19;Guadalajara;166;Málaga del Fresno;209;112;97
19;Guadalajara;167;Malaguilla;147;86;61
19;Guadalajara;168;Mandayona;447;213;234
19;Guadalajara;169;Mantiel;75;40;35
19;Guadalajara;170;Maranchón;227;124;103
19;Guadalajara;171;Marchamalo;"";"";""
19;Guadalajara;172;Masegoso de Tajuña;96;49;47
19;Guadalajara;173;Matarrubia;55;34;21
19;Guadalajara;174;Matillas;205;103;102
19;Guadalajara;175;Mazarete;77;37;40
19;Guadalajara;176;Mazuecos;372;191;181
19;Guadalajara;177;Medranda;135;67;68
19;Guadalajara;178;Megina;81;41;40
19;Guadalajara;179;Membrillera;100;44;56
19;Guadalajara;181;Miedes de Atienza;99;50;49
19;Guadalajara;182;Mierla (La);25;13;12
19;Guadalajara;184;Millana;114;58;56
19;Guadalajara;183;Milmarcos;120;62;58
19;Guadalajara;185;Miñosa (La);51;28;23
19;Guadalajara;186;Mirabueno;120;63;57
19;Guadalajara;187;Miralrío;83;48;35
19;Guadalajara;188;Mochales;117;55;62
19;Guadalajara;189;Mohernando;130;70;60
19;Guadalajara;190;Molina de Aragón;3330;1706;1624
19;Guadalajara;191;Monasterio;19;8;11
19;Guadalajara;192;Mondéjar;2083;1038;1045
19;Guadalajara;193;Montarrón;59;33;26
19;Guadalajara;194;Moratilla de los Meleros;100;53;47
19;Guadalajara;195;Morenilla;54;33;21
19;Guadalajara;196;Muduex;116;59;57
19;Guadalajara;197;Navas de Jadraque (Las);25;16;9
19;Guadalajara;198;Negredo;24;10;14
19;Guadalajara;199;Ocentejo;50;22;28
19;Guadalajara;200;Olivar (El);122;58;64
19;Guadalajara;201;Olmeda de Cobeta;75;29;46
19;Guadalajara;202;Olmeda de Jadraque (La);31;14;17
19;Guadalajara;203;Ordial (El);49;20;29
19;Guadalajara;204;Orea;290;155;135
19;Guadalajara;208;Pálmaces de Jadraque;64;34;30
19;Guadalajara;209;Pardos;64;32;32
19;Guadalajara;210;Paredes de Sigüenza;57;30;27
19;Guadalajara;211;Pareja;486;245;241
19;Guadalajara;212;Pastrana;1124;564;560
19;Guadalajara;213;Pedregal (El);110;61;49
19;Guadalajara;214;Peñalén;137;76;61
19;Guadalajara;215;Peñalver;248;139;109
19;Guadalajara;216;Peralejos de las Truchas;179;93;86
19;Guadalajara;217;Peralveche;132;70;62
19;Guadalajara;218;Pinilla de Jadraque;89;45;44
19;Guadalajara;219;Pinilla de Molina;25;16;9
19;Guadalajara;220;Pioz;366;195;171
19;Guadalajara;221;Piqueras;68;39;29
19;Guadalajara;222;Pobo de Dueñas (El);176;96;80
19;Guadalajara;223;Poveda de la Sierra;205;107;98
19;Guadalajara;224;Pozo de Almoguera;191;102;89
19;Guadalajara;225;Pozo de Guadalajara;371;197;174
19;Guadalajara;226;Prádena de Atienza;37;22;15
19;Guadalajara;227;Prados Redondos;84;50;34
19;Guadalajara;228;Puebla de Beleña;45;27;18
19;Guadalajara;229;Puebla de Valles;69;39;30
19;Guadalajara;230;Quer;88;42;46
19;Guadalajara;231;Rebollosa de Jadraque;35;20;15
19;Guadalajara;232;Recuenco (El);116;59;57
19;Guadalajara;233;Renera;67;35;32
19;Guadalajara;234;Retiendas;51;26;25
19;Guadalajara;235;Riba de Saelices;173;96;77
19;Guadalajara;237;Rillo de Gallo;61;35;26
19;Guadalajara;238;Riofrío del Llano;71;42;29
19;Guadalajara;239;Robledillo de Mohernando;164;83;81
19;Guadalajara;240;Robledo de Corpes;106;51;55
19;Guadalajara;241;Romanillos de Atienza;78;46;32
19;Guadalajara;242;Romanones;147;83;64
19;Guadalajara;243;Rueda de la Sierra;65;34;31
19;Guadalajara;244;Sacecorbo;139;82;57
19;Guadalajara;245;Sacedón;1668;849;819
19;Guadalajara;246;Saelices de la Sal;70;37;33
19;Guadalajara;247;Salmerón;276;145;131
19;Guadalajara;248;San Andrés del Congosto;86;45;41
19;Guadalajara;249;San Andrés del Rey;40;16;24
19;Guadalajara;250;Santiuste;25;15;10
19;Guadalajara;251;Saúca;76;38;38
19;Guadalajara;252;Sayatón;170;91;79
19;Guadalajara;254;Selas;58;26;32
19;Guadalajara;901;Semillas;39;19;20
19;Guadalajara;255;Setiles;163;89;74
19;Guadalajara;256;Sienes;83;48;35
19;Guadalajara;257;Sigüenza;4643;2327;2316
19;Guadalajara;258;Solanillos del Extremo;129;66;63
19;Guadalajara;259;Somolinos;40;19;21
19;Guadalajara;260;Sotillo (El);47;27;20
19;Guadalajara;261;Sotodosos;64;30;34
19;Guadalajara;262;Tamajón;234;112;122
19;Guadalajara;263;Taragudo;29;17;12
19;Guadalajara;264;Taravilla;75;40;35
19;Guadalajara;265;Tartanedo;209;103;106
19;Guadalajara;266;Tendilla;351;183;168
19;Guadalajara;267;Terzaga;35;22;13
19;Guadalajara;268;Tierzo;45;24;21
19;Guadalajara;269;Toba (La);115;66;49
19;Guadalajara;271;Tordellego;75;36;39
19;Guadalajara;270;Tordelrábano;14;7;7
19;Guadalajara;272;Tordesilos;135;71;64
19;Guadalajara;274;Torija;405;197;208
19;Guadalajara;279;Torre del Burgo;67;38;29
19;Guadalajara;277;Torrecuadrada de Molina;16;11;5
19;Guadalajara;278;Torrecuadradilla;67;42;25
19;Guadalajara;280;Torrejón del Rey;1060;546;514
19;Guadalajara;281;Torremocha de Jadraque;18;13;5
19;Guadalajara;282;Torremocha del Campo;310;167;143
19;Guadalajara;283;Torremocha del Pinar;70;33;37
19;Guadalajara;284;Torremochuela;13;7;6
19;Guadalajara;285;Torrubia;44;24;20
19;Guadalajara;286;Tórtola de Henares;416;216;200
19;Guadalajara;287;Tortuera;231;120;111
19;Guadalajara;288;Tortuero;41;24;17
19;Guadalajara;289;Traíd;61;29;32
19;Guadalajara;290;Trijueque;492;257;235
19;Guadalajara;291;Trillo;1447;741;706
19;Guadalajara;293;Uceda;863;430;433
19;Guadalajara;294;Ujados;33;17;16
19;Guadalajara;296;Utande;61;39;22
19;Guadalajara;297;Valdarachas;28;11;17
19;Guadalajara;298;Valdearenas;64;32;32
19;Guadalajara;299;Valdeavellano;95;51;44
19;Guadalajara;300;Valdeaveruelo;254;135;119
19;Guadalajara;301;Valdeconcha;57;31;26
19;Guadalajara;302;Valdegrudas;63;35;28
19;Guadalajara;303;Valdelcubo;70;42;28
19;Guadalajara;304;Valdenuño Fernández;136;70;66
19;Guadalajara;305;Valdepeñas de la Sierra;235;125;110
19;Guadalajara;306;Valderrebollo;43;23;20
19;Guadalajara;307;Valdesotos;41;16;25
19;Guadalajara;308;Valfermoso de Tajuña;103;54;49
19;Guadalajara;309;Valhermoso;47;27;20
19;Guadalajara;310;Valtablado del Río;14;9;5
19;Guadalajara;311;Valverde de los Arroyos;100;53;47
19;Guadalajara;314;Viana de Jadraque;58;35;23
19;Guadalajara;317;Villanueva de Alcorón;290;161;129
19;Guadalajara;318;Villanueva de Argecilla;40;21;19
19;Guadalajara;319;Villanueva de la Torre;452;231;221
19;Guadalajara;321;Villares de Jadraque;55;27;28
19;Guadalajara;322;Villaseca de Henares;72;36;36
19;Guadalajara;323;Villaseca de Uceda;64;33;31
19;Guadalajara;324;Villel de Mesa;255;133;122
19;Guadalajara;325;Viñuelas;127;75;52
19;Guadalajara;326;Yebes;173;122;51
19;Guadalajara;327;Yebra;532;271;261
19;Guadalajara;329;Yélamos de Abajo;118;57;61
19;Guadalajara;330;Yélamos de Arriba;168;85;83
19;Guadalajara;331;Yunquera de Henares;2005;1016;989
19;Guadalajara;332;Yunta (La);173;84;89
19;Guadalajara;333;Zaorejas;250;144;106
19;Guadalajara;334;Zarzuela de Jadraque;29;14;15
19;Guadalajara;335;Zorita de los Canes;107;61;46
20;Guipúzcoa;001;Abaltzisketa;262;157;105
20;Guipúzcoa;002;Aduna;310;165;145
20;Guipúzcoa;016;Aia;1663;928;735
20;Guipúzcoa;003;Aizarnazabal;546;293;253
20;Guipúzcoa;004;Albiztur;289;159;130
20;Guipúzcoa;005;Alegia;1614;832;782
20;Guipúzcoa;006;Alkiza;261;149;112
20;Guipúzcoa;906;Altzaga;97;50;47
20;Guipúzcoa;007;Altzo;338;178;160
20;Guipúzcoa;008;Amezketa;995;523;472
20;Guipúzcoa;009;Andoain;14249;7139;7110
20;Guipúzcoa;010;Anoeta;1718;887;831
20;Guipúzcoa;011;Antzuola;1900;970;930
20;Guipúzcoa;012;Arama;168;85;83
20;Guipúzcoa;013;Aretxabaleta;6096;3109;2987
20;Guipúzcoa;055;Arrasate/Mondragón;23984;11986;11998
20;Guipúzcoa;014;Asteasu;1179;631;548
20;Guipúzcoa;903;Astigarraga;3355;1669;1686
20;Guipúzcoa;015;Ataun;1553;806;747
20;Guipúzcoa;017;Azkoitia;10212;5081;5131
20;Guipúzcoa;018;Azpeitia;13560;6803;6757
20;Guipúzcoa;904;Baliarrain;85;43;42
20;Guipúzcoa;019;Beasain;12171;6096;6075
20;Guipúzcoa;020;Beizama;161;92;69
20;Guipúzcoa;021;Belauntza;322;174;148
20;Guipúzcoa;022;Berastegi;972;529;443
20;Guipúzcoa;074;Bergara;15141;7531;7610
20;Guipúzcoa;023;Berrobi;551;296;255
20;Guipúzcoa;024;Bidegoyan;420;235;185
20;Guipúzcoa;029;Deba;5090;2573;2517
20;Guipúzcoa;069;Donostia/San Sebastián;179208;84274;94934
20;Guipúzcoa;030;Eibar;29339;14404;14935
20;Guipúzcoa;031;Elduain;192;100;92
20;Guipúzcoa;033;Elgeta;973;494;479
20;Guipúzcoa;032;Elgoibar;10750;5373;5377
20;Guipúzcoa;067;Errenteria;39189;19324;19865
20;Guipúzcoa;066;Errezil;631;336;295
20;Guipúzcoa;034;Eskoriatza;3914;2019;1895
20;Guipúzcoa;035;Ezkio-Itsaso;537;285;252
20;Guipúzcoa;038;Gabiria;434;240;194
20;Guipúzcoa;037;Gaintza;133;83;50
20;Guipúzcoa;907;Gaztelu;149;84;65
20;Guipúzcoa;039;Getaria;2430;1223;1207
20;Guipúzcoa;040;Hernani;18682;9308;9374
20;Guipúzcoa;041;Hernialde;287;146;141
20;Guipúzcoa;036;Hondarribia;14674;7316;7358
20;Guipúzcoa;042;Ibarra;4334;2261;2073
20;Guipúzcoa;043;Idiazabal;2040;1035;1005
20;Guipúzcoa;044;Ikaztegieta;382;198;184
20;Guipúzcoa;045;Irún;55497;27072;28425
20;Guipúzcoa;046;Irura;746;385;361
20;Guipúzcoa;047;Itsasondo;609;304;305
20;Guipúzcoa;048;Larraul;144;84;60
20;Guipúzcoa;902;Lasarte-Oria;17630;8788;8842
20;Guipúzcoa;049;Lazkao;4873;2502;2371
20;Guipúzcoa;050;Leaburu;356;189;167
20;Guipúzcoa;051;Legazpi;9064;4649;4415
20;Guipúzcoa;052;Legorreta;1422;722;700
20;Guipúzcoa;068;Leintz-Gatzaga;262;146;116
20;Guipúzcoa;053;Lezo;5829;2915;2914
20;Guipúzcoa;054;Lizartza;600;317;283
20;Guipúzcoa;901;Mendaro;1343;690;653
20;Guipúzcoa;057;Mutiloa;167;86;81
20;Guipúzcoa;056;Mutriku;4799;2392;2407
20;Guipúzcoa;063;Oiartzun;9055;4557;4498
20;Guipúzcoa;058;Olaberria;977;506;471
20;Guipúzcoa;076;Ordizia;9087;4437;4650
20;Guipúzcoa;905;Orendain;152;90;62
20;Guipúzcoa;060;Orexa;79;43;36
20;Guipúzcoa;061;Orio;4307;2177;2130
20;Guipúzcoa;062;Ormaiztegi;1176;596;580
20;Guipúzcoa;059;Oñati;10668;5356;5312
20;Guipúzcoa;064;Pasaia;17056;8297;8759
20;Guipúzcoa;070;Segura;1263;623;640
20;Guipúzcoa;065;Soraluze/Placencia de las Armas;4315;2142;2173
20;Guipúzcoa;071;Tolosa;18113;8721;9392
20;Guipúzcoa;072;Urnieta;5376;2742;2634
20;Guipúzcoa;077;Urretxu;6381;3194;3187
20;Guipúzcoa;073;Usurbil;5282;2714;2568
20;Guipúzcoa;075;Villabona;5443;2764;2679
20;Guipúzcoa;078;Zaldibia;1526;792;734
20;Guipúzcoa;079;Zarautz;20187;9970;10217
20;Guipúzcoa;025;Zegama;1307;669;638
20;Guipúzcoa;026;Zerain;242;123;119
20;Guipúzcoa;027;Zestoa;3182;1646;1536
20;Guipúzcoa;028;Zizurkil;2763;1398;1365
20;Guipúzcoa;081;Zumaia;8331;4157;4174
20;Guipúzcoa;080;Zumarraga;10126;5071;5055
21;Huelva;001;Alájar;794;400;394
21;Huelva;002;Aljaraque;10298;5152;5146
21;Huelva;003;Almendro (El);874;450;424
21;Huelva;004;Almonaster la Real;2011;983;1028
21;Huelva;005;Almonte;17202;8631;8571
21;Huelva;006;Alosno;4843;2329;2514
21;Huelva;007;Aracena;6672;3274;3398
21;Huelva;008;Aroche;3517;1745;1772
21;Huelva;009;Arroyomolinos de León;1174;599;575
21;Huelva;010;Ayamonte;16980;8320;8660
21;Huelva;011;Beas;4165;2083;2082
21;Huelva;012;Berrocal;412;206;206
21;Huelva;013;Bollullos Par del Condado;12727;6330;6397
21;Huelva;014;Bonares;5063;2568;2495
21;Huelva;015;Cabezas Rubias;969;500;469
21;Huelva;016;Cala;1457;725;732
21;Huelva;017;Calañas;4873;2401;2472
21;Huelva;018;Campillo (El);2424;1164;1260
21;Huelva;019;Campofrío;861;437;424
21;Huelva;020;Cañaveral de León;515;248;267
21;Huelva;021;Cartaya;12094;6052;6042
21;Huelva;022;Castaño del Robledo;207;107;100
21;Huelva;023;Cerro de Andévalo (El);2760;1339;1421
21;Huelva;030;Chucena;1980;1007;973
21;Huelva;024;Corteconcepción;703;352;351
21;Huelva;025;Cortegana;5132;2554;2578
21;Huelva;026;Cortelazor;327;164;163
21;Huelva;027;Cumbres de Enmedio;63;31;32
21;Huelva;028;Cumbres de San Bartolomé;572;286;286
21;Huelva;029;Cumbres Mayores;2135;1048;1087
21;Huelva;031;Encinasola;1845;913;932
21;Huelva;032;Escacena del Campo;2202;1089;1113
21;Huelva;033;Fuenteheridos;645;329;316
21;Huelva;034;Galaroza;1600;769;831
21;Huelva;035;Gibraleón;10908;5531;5377
21;Huelva;036;Granada de Río-Tinto (La);223;115;108
21;Huelva;037;Granado (El);681;368;313
21;Huelva;038;Higuera de la Sierra;1260;633;627
21;Huelva;039;Hinojales;436;221;215
21;Huelva;040;Hinojos;3548;1802;1746
21;Huelva;041;Huelva;140583;67881;72702
21;Huelva;042;Isla Cristina;18070;9065;9005
21;Huelva;043;Jabugo;2591;1299;1292
21;Huelva;044;Lepe;18995;9734;9261
21;Huelva;045;Linares de la Sierra;309;150;159
21;Huelva;046;Lucena del Puerto;2243;1160;1083
21;Huelva;047;Manzanilla;2507;1238;1269
21;Huelva;048;Marines (Los);326;159;167
21;Huelva;049;Minas de Riotinto;5027;2377;2650
21;Huelva;050;Moguer;14030;7132;6898
21;Huelva;051;Nava (La);326;168;158
21;Huelva;052;Nerva;6475;3137;3338
21;Huelva;053;Niebla;3924;1987;1937
21;Huelva;054;Palma del Condado (La);9709;4806;4903
21;Huelva;055;Palos de la Frontera;7060;3576;3484
21;Huelva;056;Paterna del Campo;3914;1994;1920
21;Huelva;057;Paymogo;1235;603;632
21;Huelva;058;Puebla de Guzmán;3242;1640;1602
21;Huelva;059;Puerto Moral;251;124;127
21;Huelva;060;Punta Umbría;11864;6046;5818
21;Huelva;061;Rociana del Condado;6353;3246;3107
21;Huelva;062;Rosal de la Frontera;1869;893;976
21;Huelva;063;San Bartolomé de la Torre;2897;1474;1423
21;Huelva;064;San Juan del Puerto;5882;2937;2945
21;Huelva;066;San Silvestre de Guzmán;653;322;331
21;Huelva;065;Sanlúcar de Guadiana;397;194;203
21;Huelva;067;Santa Ana la Real;514;244;270
21;Huelva;068;Santa Bárbara de Casa;1368;690;678
21;Huelva;069;Santa Olalla del Cala;2297;1147;1150
21;Huelva;070;Trigueros;7225;3607;3618
21;Huelva;071;Valdelarco;273;131;142
21;Huelva;072;Valverde del Camino;12510;6081;6429
21;Huelva;073;Villablanca;2030;1056;974
21;Huelva;074;Villalba del Alcor;3589;1792;1797
21;Huelva;075;Villanueva de las Cruces;430;200;230
21;Huelva;076;Villanueva de los Castillejos;2707;1330;1377
21;Huelva;077;Villarrasa;2071;1056;1015
21;Huelva;078;Zalamea la Real;3497;1717;1780
21;Huelva;079;Zufre;1112;579;533
22;Huesca;001;Abiego;290;147;143
22;Huesca;002;Abizanda;142;74;68
22;Huesca;003;Adahuesca;157;82;75
22;Huesca;004;Agüero;166;85;81
22;Huesca;907;Aínsa-Sobrarbe;1579;813;766
22;Huesca;006;Aisa;369;201;168
22;Huesca;007;Albalate de Cinca;1105;557;548
22;Huesca;008;Albalatillo;261;129;132
22;Huesca;009;Albelda;954;488;466
22;Huesca;011;Albero Alto;99;53;46
22;Huesca;012;Albero Bajo;111;61;50
22;Huesca;013;Alberuela de Tubo;388;193;195
22;Huesca;014;Alcalá de Gurrea;332;162;170
22;Huesca;015;Alcalá del Obispo;348;179;169
22;Huesca;016;Alcampell;947;472;475
22;Huesca;017;Alcolea de Cinca;1235;626;609
22;Huesca;018;Alcubierre;467;249;218
22;Huesca;019;Alerre;188;100;88
22;Huesca;020;Alfántega;119;63;56
22;Huesca;021;Almudévar;2346;1204;1142
22;Huesca;022;Almunia de San Juan;701;354;347
22;Huesca;023;Almuniente;627;324;303
22;Huesca;024;Alquézar;304;157;147
22;Huesca;025;Altorricón;1448;756;692
22;Huesca;027;Angüés;434;236;198
22;Huesca;028;Ansó;528;264;264
22;Huesca;029;Antillón;168;83;85
22;Huesca;032;Aragüés del Puerto;135;81;54
22;Huesca;035;Arén;392;201;191
22;Huesca;036;Argavieso;128;74;54
22;Huesca;037;Arguis;58;32;26
22;Huesca;039;Ayerbe;1111;573;538
22;Huesca;040;Azanuy-Alins;198;93;105
22;Huesca;041;Azara;224;111;113
22;Huesca;042;Azlor;160;82;78
22;Huesca;043;Baélls;153;87;66
22;Huesca;044;Bailo;313;183;130
22;Huesca;045;Baldellou;150;79;71
22;Huesca;046;Ballobar;1071;535;536
22;Huesca;047;Banastás;182;96;86
22;Huesca;048;Barbastro;14503;7059;7444
22;Huesca;049;Barbués;118;61;57
22;Huesca;050;Barbuñales;113;58;55
22;Huesca;051;Bárcabo;109;60;49
22;Huesca;052;Belver de Cinca;1398;730;668
22;Huesca;053;Benabarre;1173;611;562
22;Huesca;054;Benasque;1419;755;664
22;Huesca;055;Berbegal;474;240;234
22;Huesca;057;Bielsa;457;234;223
22;Huesca;058;Bierge;225;129;96
22;Huesca;059;Biescas;1269;669;600
22;Huesca;060;Binaced;1596;811;785
22;Huesca;061;Binéfar;8199;4109;4090
22;Huesca;062;Bisaurri;216;123;93
22;Huesca;063;Biscarrués;232;124;108
22;Huesca;064;Blecua y Torres;186;99;87
22;Huesca;066;Boltaña;850;439;411
22;Huesca;067;Bonansa;76;40;36
22;Huesca;068;Borau;75;39;36
22;Huesca;069;Broto;520;268;252
22;Huesca;072;Caldearenas;270;150;120
22;Huesca;074;Campo;355;168;187
22;Huesca;075;Camporrélls;247;129;118
22;Huesca;076;Canal de Berdún;437;238;199
22;Huesca;077;Candasnos;558;290;268
22;Huesca;078;Canfranc;526;290;236
22;Huesca;079;Capdesaso;180;82;98
22;Huesca;080;Capella;401;208;193
22;Huesca;081;Casbas de Huesca;308;164;144
22;Huesca;083;Castejón de Monegros;717;360;357
22;Huesca;084;Castejón de Sos;546;283;263
22;Huesca;082;Castejón del Puente;408;215;193
22;Huesca;085;Castelflorite;147;75;72
22;Huesca;086;Castiello de Jaca;166;83;83
22;Huesca;087;Castigaleu;110;61;49
22;Huesca;088;Castillazuelo;233;110;123
22;Huesca;089;Castillonroy;423;206;217
22;Huesca;094;Chalamera;164;92;72
22;Huesca;095;Chía;113;62;51
22;Huesca;096;Chimillas;176;96;80
22;Huesca;090;Colungo;122;65;57
22;Huesca;099;Esplús;771;365;406
22;Huesca;102;Estada;193;99;94
22;Huesca;103;Estadilla;920;466;454
22;Huesca;105;Estopiñán del Castillo;182;95;87
22;Huesca;106;Fago;40;25;15
22;Huesca;107;Fanlo;129;77;52
22;Huesca;109;Fiscal;241;134;107
22;Huesca;110;Fonz;1123;572;551
22;Huesca;111;Foradada del Toscar;244;117;127
22;Huesca;112;Fraga;11928;5959;5969
22;Huesca;113;Fueva (La);626;331;295
22;Huesca;114;Gistaín;173;101;72
22;Huesca;115;Grado (El);568;297;271
22;Huesca;116;Grañén;2006;1018;988
22;Huesca;117;Graus;3255;1644;1611
22;Huesca;119;Gurrea de Gállego;1839;939;900
22;Huesca;122;Hoz de Jaca;77;34;43
22;Huesca;908;Hoz y Costean;267;142;125
22;Huesca;124;Huerto;265;149;116
22;Huesca;125;Huesca;45627;21970;23657
22;Huesca;126;Ibieca;101;50;51
22;Huesca;127;Igriés;193;96;97
22;Huesca;128;Ilche;277;145;132
22;Huesca;129;Isábena;255;130;125
22;Huesca;130;Jaca;11374;5630;5744
22;Huesca;131;Jasa;127;71;56
22;Huesca;133;Labuerda;168;88;80
22;Huesca;135;Laluenga;270;138;132
22;Huesca;136;Lalueza;1262;676;586
22;Huesca;137;Lanaja;1574;819;755
22;Huesca;139;Laperdiguera;102;49;53
22;Huesca;141;Lascellas-Ponzano;162;83;79
22;Huesca;142;Lascuarre;176;94;82
22;Huesca;143;Laspaúles;289;157;132
22;Huesca;144;Laspuña;272;146;126
22;Huesca;149;Loarre;400;212;188
22;Huesca;150;Loporzano;507;263;244
22;Huesca;151;Loscorrales;125;67;58
22;Huesca;905;Lupiñén-Ortilla;363;194;169
22;Huesca;155;Monesma y Cajigar;104;53;51
22;Huesca;156;Monflorite-Lascasas;193;106;87
22;Huesca;157;Montanuy;308;174;134
22;Huesca;158;Monzón;14577;7323;7254
22;Huesca;160;Naval;300;152;148
22;Huesca;162;Novales;189;95;94
22;Huesca;163;Nueno;215;121;94
22;Huesca;164;Olvena;58;26;32
22;Huesca;165;Ontiñena;651;331;320
22;Huesca;167;Osso de Cinca;746;411;335
22;Huesca;168;Palo;26;14;12
22;Huesca;170;Panticosa;668;338;330
22;Huesca;172;Peñalba;812;409;403
22;Huesca;173;Peñas de Riglos (Las);281;157;124
22;Huesca;174;Peralta de Alcofea;726;361;365
22;Huesca;175;Peralta de Calasanz;282;149;133
22;Huesca;176;Peraltilla;175;95;80
22;Huesca;177;Perarrúa;128;63;65
22;Huesca;178;Pertusa;154;80;74
22;Huesca;181;Piracés;100;64;36
22;Huesca;182;Plan;323;176;147
22;Huesca;184;Poleñino;269;136;133
22;Huesca;186;Pozán de Vero;265;127;138
22;Huesca;187;Puebla de Castro (La);320;168;152
22;Huesca;188;Puente de Montañana;130;63;67
22;Huesca;902;Puente la Reina de Jaca;239;124;115
22;Huesca;189;Puértolas;213;120;93
22;Huesca;190;Pueyo de Araguás (El);161;97;64
22;Huesca;193;Pueyo de Santa Cruz;347;173;174
22;Huesca;195;Quicena;147;78;69
22;Huesca;197;Robres;682;354;328
22;Huesca;199;Sabiñánigo;8545;4313;4232
22;Huesca;200;Sahún;301;162;139
22;Huesca;201;Salas Altas;383;195;188
22;Huesca;202;Salas Bajas;171;76;95
22;Huesca;203;Salillas;125;66;59
22;Huesca;204;Sallent de Gállego;1027;539;488
22;Huesca;205;San Esteban de Litera;607;302;305
22;Huesca;207;San Juan de Plan;156;86;70
22;Huesca;903;San Miguel del Cinca;910;471;439
22;Huesca;206;Sangarrén;278;138;140
22;Huesca;208;Santa Cilia;204;109;95
22;Huesca;209;Santa Cruz de la Serós;152;87;65
22;Huesca;906;Santa María de Dulcis;210;107;103
22;Huesca;212;Santaliestra y San Quílez;96;55;41
22;Huesca;213;Sariñena;4026;2001;2025
22;Huesca;214;Secastilla;161;71;90
22;Huesca;215;Seira;214;108;106
22;Huesca;217;Sena;591;310;281
22;Huesca;218;Senés de Alcubierre;59;31;28
22;Huesca;220;Sesa;262;132;130
22;Huesca;221;Sesué;130;68;62
22;Huesca;222;Siétamo;375;211;164
22;Huesca;223;Sopeira;104;50;54
22;Huesca;904;Sotonera (La);1108;589;519
22;Huesca;225;Tamarite de Litera;3777;1893;1884
22;Huesca;226;Tardienta;1062;547;515
22;Huesca;227;Tella-Sin;271;140;131
22;Huesca;228;Tierz;186;92;94
22;Huesca;229;Tolva;203;108;95
22;Huesca;230;Torla;324;170;154
22;Huesca;232;Torralba de Aragón;129;61;68
22;Huesca;233;Torre la Ribera;116;63;53
22;Huesca;234;Torrente de Cinca;1093;545;548
22;Huesca;235;Torres de Alcanadre;139;81;58
22;Huesca;236;Torres de Barbués;371;184;187
22;Huesca;239;Tramaced;106;64;42
22;Huesca;242;Valfarta;97;55;42
22;Huesca;243;Valle de Bardají;56;29;27
22;Huesca;901;Valle de Hecho;959;497;462
22;Huesca;244;Valle de Lierp;59;31;28
22;Huesca;245;Velilla de Cinca;478;237;241
22;Huesca;909;Vencillón;475;242;233
22;Huesca;246;Veracruz;111;58;53
22;Huesca;247;Viacamp y Litera;29;20;9
22;Huesca;248;Vicién;120;64;56
22;Huesca;249;Villanova;132;68;64
22;Huesca;250;Villanúa;339;170;169
22;Huesca;251;Villanueva de Sigena;512;254;258
22;Huesca;252;Yebra de Basa;168;97;71
22;Huesca;253;Yésero;77;41;36
22;Huesca;254;Zaidín;1682;843;839
23;Jaén;001;Albanchez de Mágina;1502;764;738
23;Jaén;002;Alcalá la Real;21521;10620;10901
23;Jaén;003;Alcaudete;11404;5638;5766
23;Jaén;004;Aldeaquemada;627;327;300
23;Jaén;005;Andújar;38254;18938;19316
23;Jaén;006;Arjona;5695;2874;2821
23;Jaén;007;Arjonilla;3941;1963;1978
23;Jaén;008;Arquillos;1936;961;975
23;Jaén;905;Arroyo del Ojanco;"";"";""
23;Jaén;009;Baeza;15841;7764;8077
23;Jaén;010;Bailén;17481;8913;8568
23;Jaén;011;Baños de la Encina;2783;1411;1372
23;Jaén;012;Beas de Segura;8135;4156;3979
23;Jaén;902;Bedmar y Garcíez;3239;1629;1610
23;Jaén;014;Begíjar;3171;1586;1585
23;Jaén;015;Bélmez de la Moraleda;2055;1050;1005
23;Jaén;016;Benatae;581;310;271
23;Jaén;017;Cabra del Santo Cristo;2275;1170;1105
23;Jaén;018;Cambil;3183;1664;1519
23;Jaén;019;Campillo de Arenas;2221;1137;1084
23;Jaén;020;Canena;2139;1037;1102
23;Jaén;021;Carboneros;681;337;344
23;Jaén;901;Cárcheles;1570;777;793
23;Jaén;024;Carolina (La);15121;7460;7661
23;Jaén;025;Castellar;3696;1874;1822
23;Jaén;026;Castillo de Locubín;5277;2585;2692
23;Jaén;027;Cazalilla;840;424;416
23;Jaén;028;Cazorla;8643;4191;4452
23;Jaén;029;Chiclana de Segura;1390;693;697
23;Jaén;030;Chilluévar;1781;881;900
23;Jaén;031;Escañuela;951;471;480
23;Jaén;032;Espelúy;791;389;402
23;Jaén;033;Frailes;1894;969;925
23;Jaén;034;Fuensanta de Martos;3372;1683;1689
23;Jaén;035;Fuerte del Rey;1156;569;587
23;Jaén;037;Génave;708;369;339
23;Jaén;038;Guardia de Jaén (La);2106;1097;1009
23;Jaén;039;Guarromán;2831;1402;1429
23;Jaén;041;Higuera de Calatrava;706;365;341
23;Jaén;042;Hinojares;508;247;261
23;Jaén;043;Hornos;744;361;383
23;Jaén;044;Huelma;6047;3082;2965
23;Jaén;045;Huesa;2735;1368;1367
23;Jaén;046;Ibros;3056;1533;1523
23;Jaén;047;Iruela (La);1988;1005;983
23;Jaén;048;Iznatoraf;1220;606;614
23;Jaén;049;Jabalquinto;2552;1272;1280
23;Jaén;050;Jaén;109247;52727;56520
23;Jaén;051;Jamilena;3327;1692;1635
23;Jaén;052;Jimena;1585;766;819
23;Jaén;053;Jódar;12051;5954;6097
23;Jaén;040;Lahiguera;1937;954;983
23;Jaén;054;Larva;518;266;252
23;Jaén;055;Linares;58722;28686;30036
23;Jaén;056;Lopera;3982;1959;2023
23;Jaén;057;Lupión;1084;514;570
23;Jaén;058;Mancha Real;9067;4643;4424
23;Jaén;059;Marmolejo;7687;3864;3823
23;Jaén;060;Martos;22637;10929;11708
23;Jaén;061;Mengíbar;8535;4291;4244
23;Jaén;062;Montizón;2017;1032;985
23;Jaén;063;Navas de San Juan;5251;2603;2648
23;Jaén;064;Noalejo;2298;1153;1145
23;Jaén;065;Orcera;2259;1134;1125
23;Jaén;066;Peal de Becerro;5379;2670;2709
23;Jaén;067;Pegalajar;3126;1611;1515
23;Jaén;069;Porcuna;6969;3480;3489
23;Jaén;070;Pozo Alcón;5859;2947;2912
23;Jaén;071;Puente de Génave;2048;1036;1012
23;Jaén;072;Puerta de Segura (La);2730;1365;1365
23;Jaén;073;Quesada;6158;3016;3142
23;Jaén;074;Rus;3793;1903;1890
23;Jaén;075;Sabiote;4199;2104;2095
23;Jaén;076;Santa Elena;1020;544;476
23;Jaén;077;Santiago de Calatrava;927;465;462
23;Jaén;904;Santiago-Pontones;4520;2303;2217
23;Jaén;079;Santisteban del Puerto;5042;2558;2484
23;Jaén;080;Santo Tomé;2362;1182;1180
23;Jaén;081;Segura de la Sierra;2211;1106;1105
23;Jaén;082;Siles;2728;1368;1360
23;Jaén;084;Sorihuela del Guadalimar;1238;634;604
23;Jaén;086;Torre del Campo;12866;6457;6409
23;Jaén;085;Torreblascopedro;3001;1490;1511
23;Jaén;087;Torredonjimeno;13839;6806;7033
23;Jaén;088;Torreperogil;7491;3692;3799
23;Jaén;090;Torres;1859;965;894
23;Jaén;091;Torres de Albánchez;1026;513;513
23;Jaén;092;Úbeda;32739;15972;16767
23;Jaén;093;Valdepeñas de Jaén;4520;2281;2239
23;Jaén;094;Vilches;5089;2531;2558
23;Jaén;095;Villacarrillo;11154;5545;5609
23;Jaén;096;Villanueva de la Reina;3322;1658;1664
23;Jaén;097;Villanueva del Arzobispo;8644;4324;4320
23;Jaén;098;Villardompardo;1261;622;639
23;Jaén;099;Villares (Los);4878;2448;2430
23;Jaén;101;Villarrodrigo;573;283;290
23;Jaén;903;Villatorres;4539;2295;2244
24;León;001;Acebedo;287;156;131
24;León;002;Algadefe;382;196;186
24;León;003;Alija del Infantado;1006;503;503
24;León;004;Almanza;776;411;365
24;León;005;Antigua (La);638;336;302
24;León;006;Ardón;697;364;333
24;León;007;Arganza;974;480;494
24;León;008;Astorga;12387;5863;6524
24;León;009;Balboa;484;258;226
24;León;010;Bañeza (La);10311;5003;5308
24;León;011;Barjas;403;217;186
24;León;012;Barrios de Luna (Los);347;172;175
24;León;014;Bembibre;11050;5483;5567
24;León;015;Benavides;3057;1552;1505
24;León;016;Benuza;738;381;357
24;León;017;Bercianos del Páramo;869;431;438
24;León;018;Bercianos del Real Camino;222;112;110
24;León;019;Berlanga del Bierzo;442;210;232
24;León;020;Boca de Huérgano;606;334;272
24;León;021;Boñar;2621;1284;1337
24;León;022;Borrenes;530;270;260
24;León;023;Brazuelo;356;178;178
24;León;024;Burgo Ranero (El);969;509;460
24;León;025;Burón;405;215;190
24;León;026;Bustillo del Páramo;1921;960;961
24;León;027;Cabañas Raras;1300;663;637
24;León;028;Cabreros del Río;616;318;298
24;León;029;Cabrillanes;1128;558;570
24;León;030;Cacabelos;4849;2444;2405
24;León;031;Calzada del Coto;317;176;141
24;León;032;Campazas;169;87;82
24;León;033;Campo de Villavidel;350;182;168
24;León;034;Camponaraya;3188;1552;1636
24;León;036;Candín;454;247;207
24;León;037;Cármenes;432;220;212
24;León;038;Carracedelo;3550;1735;1815
24;León;039;Carrizo;2789;1387;1402
24;León;040;Carrocera;643;318;325
24;León;041;Carucedo;665;326;339
24;León;042;Castilfalé;102;52;50
24;León;043;Castrillo de Cabrera;198;99;99
24;León;044;Castrillo de la Valduerna;246;105;141
24;León;046;Castrocalbón;1406;711;695
24;León;047;Castrocontrigo;1193;591;602
24;León;049;Castropodame;1879;952;927
24;León;050;Castrotierra de Valmadrigal;153;77;76
24;León;051;Cea;764;402;362
24;León;052;Cebanico;260;140;120
24;León;053;Cebrones del Río;729;368;361
24;León;065;Chozas de Abajo;2170;1104;1066
24;León;054;Cimanes de la Vega;704;345;359
24;León;055;Cimanes del Tejar;1045;518;527
24;León;056;Cistierna;4409;2149;2260
24;León;057;Congosto;1765;847;918
24;León;058;Corbillos de los Oteros;309;156;153
24;León;059;Corullón;1237;617;620
24;León;060;Crémenes;1188;570;618
24;León;061;Cuadros;1654;779;875
24;León;062;Cubillas de los Oteros;227;115;112
24;León;063;Cubillas de Rueda;634;325;309
24;León;064;Cubillos del Sil;1514;792;722
24;León;066;Destriana;873;420;453
24;León;067;Encinedo;1067;543;524
24;León;068;Ercina (La);726;358;368
24;León;069;Escobar de Campos;77;46;31
24;León;070;Fabero;5997;2993;3004
24;León;071;Folgoso de la Ribera;1390;679;711
24;León;073;Fresno de la Vega;715;358;357
24;León;074;Fuentes de Carbajal;144;72;72
24;León;076;Garrafe de Torío;1221;618;603
24;León;077;Gordaliza del Pino;368;184;184
24;León;078;Gordoncillo;634;306;328
24;León;079;Gradefes;1379;663;716
24;León;080;Grajal de Campos;303;132;171
24;León;081;Gusendos de los Oteros;234;117;117
24;León;082;Hospital de Órbigo;1147;567;580
24;León;083;Igüeña;2041;1064;977
24;León;084;Izagre;275;137;138
24;León;086;Joarilla de las Matas;448;233;215
24;León;087;Laguna Dalga;943;472;471
24;León;088;Laguna de Negrillos;1576;798;778
24;León;089;León;139809;65340;74469
24;León;092;Llamas de la Ribera;1272;644;628
24;León;090;Lucillo;541;270;271
24;León;091;Luyego;1007;477;530
24;León;093;Magaz de Cepeda;543;259;284
24;León;094;Mansilla de las Mulas;1773;891;882
24;León;095;Mansilla Mayor;421;211;210
24;León;096;Maraña;180;93;87
24;León;097;Matadeón de los Oteros;313;163;150
24;León;098;Matallana de Torío;1732;864;868
24;León;099;Matanza;302;153;149
24;León;100;Molinaseca;771;396;375
24;León;101;Murias de Paredes;684;317;367
24;León;102;Noceda del Bierzo;945;470;475
24;León;103;Oencia;577;314;263
24;León;104;Omañas (Las);454;228;226
24;León;105;Onzonilla;1421;710;711
24;León;106;Oseja de Sajambre;348;192;156
24;León;107;Pajares de los Oteros;382;197;185
24;León;108;Palacios de la Valduerna;549;259;290
24;León;109;Palacios del Sil;1521;766;755
24;León;110;Páramo del Sil;1868;952;916
24;León;112;Peranzanes;344;187;157
24;León;113;Pobladura de Pelayo García;587;303;284
24;León;114;Pola de Gordón (La);5193;2510;2683
24;León;115;Ponferrada;61965;30196;31769
24;León;116;Posada de Valdeón;484;257;227
24;León;117;Pozuelo del Páramo;666;343;323
24;León;118;Prado de la Guzpeña;173;93;80
24;León;119;Priaranza del Bierzo;1002;510;492
24;León;120;Prioro;475;245;230
24;León;121;Puebla de Lillo;704;376;328
24;León;122;Puente de Domingo Flórez;1951;1023;928
24;León;123;Quintana del Castillo;1156;607;549
24;León;124;Quintana del Marco;551;278;273
24;León;125;Quintana y Congosto;826;418;408
24;León;127;Regueras de Arriba;412;212;200
24;León;129;Reyero;162;88;74
24;León;130;Riaño;570;320;250
24;León;131;Riego de la Vega;1146;557;589
24;León;132;Riello;1064;547;517
24;León;133;Rioseco de Tapia;591;316;275
24;León;134;Robla (La);5135;2566;2569
24;León;136;Roperuelos del Páramo;827;411;416
24;León;137;Sabero;1938;958;980
24;León;139;Sahagún;3223;1547;1676
24;León;141;San Adrián del Valle;162;76;86
24;León;142;San Andrés del Rabanedo;23687;11530;12157
24;León;144;San Cristóbal de la Polantera;1136;576;560
24;León;145;San Emiliano;957;492;465
24;León;146;San Esteban de Nogales;365;165;200
24;León;148;San Justo de la Vega;2293;1163;1130
24;León;149;San Millán de los Caballeros;192;97;95
24;León;150;San Pedro Bercianos;392;198;194
24;León;143;Sancedo;587;296;291
24;León;151;Santa Colomba de Curueño;667;321;346
24;León;152;Santa Colomba de Somoza;475;237;238
24;León;153;Santa Cristina de Valmadrigal;376;196;180
24;León;154;Santa Elena de Jamuz;1420;722;698
24;León;155;Santa María de la Isla;717;376;341
24;León;158;Santa María de Ordás;461;232;229
24;León;156;Santa María del Monte de Cea;391;188;203
24;León;157;Santa María del Páramo;3163;1544;1619
24;León;159;Santa Marina del Rey;2635;1304;1331
24;León;160;Santas Martas;1051;551;500
24;León;161;Santiago Millas;359;183;176
24;León;162;Santovenia de la Valdoncina;1643;803;840
24;León;163;Sariegos;2300;1155;1145
24;León;164;Sena de Luna;509;252;257
24;León;165;Sobrado;564;288;276
24;León;166;Soto de la Vega;2005;1016;989
24;León;167;Soto y Amío;1093;532;561
24;León;168;Toral de los Guzmanes;701;361;340
24;León;169;Toreno;4341;2230;2111
24;León;170;Torre del Bierzo;3240;1624;1616
24;León;171;Trabadelo;583;303;280
24;León;172;Truchas;802;400;402
24;León;173;Turcia;1380;685;695
24;León;174;Urdiales del Páramo;730;376;354
24;León;185;Val de San Lorenzo;790;383;407
24;León;175;Valdefresno;1671;850;821
24;León;176;Valdefuentes del Páramo;448;233;215
24;León;177;Valdelugueros;465;255;210
24;León;178;Valdemora;127;60;67
24;León;179;Valdepiélago;426;218;208
24;León;180;Valdepolo;1616;838;778
24;León;181;Valderas;2223;1134;1089
24;León;182;Valderrey;658;320;338
24;León;183;Valderrueda;1341;667;674
24;León;184;Valdesamario;295;147;148
24;León;187;Valdevimbre;1237;626;611
24;León;188;Valencia de Don Juan;3980;1983;1997
24;León;191;Vallecillo;175;91;84
24;León;189;Valverde de la Virgen;4297;2165;2132
24;León;190;Valverde-Enrique;228;110;118
24;León;193;Vecilla (La);459;238;221
24;León;196;Vega de Espinareda;3019;1520;1499
24;León;197;Vega de Infanzones;878;431;447
24;León;198;Vega de Valcarce;906;463;443
24;León;194;Vegacervera;386;197;189
24;León;199;Vegaquemada;551;261;290
24;León;201;Vegas del Condado;1399;722;677
24;León;202;Villablino;14702;7423;7279
24;León;203;Villabraz;160;85;75
24;León;205;Villadangos del Páramo;1023;512;511
24;León;206;Villadecanes;2358;1190;1168
24;León;207;Villademor de la Vega;484;261;223
24;León;209;Villafranca del Bierzo;3941;1952;1989
24;León;210;Villagatón;877;454;423
24;León;211;Villamandos;449;210;239
24;León;901;Villamanín;1329;654;675
24;León;212;Villamañán;1428;714;714
24;León;213;Villamartín de Don Sancho;208;109;99
24;León;214;Villamejil;1020;510;510
24;León;215;Villamol;249;124;125
24;León;216;Villamontán de la Valduerna;1135;571;564
24;León;217;Villamoratiel de las Matas;188;108;80
24;León;218;Villanueva de las Manzanas;644;311;333
24;León;219;Villaobispo de Otero;730;371;359
24;León;902;Villaornate y Castro;576;309;267
24;León;221;Villaquejida;1101;578;523
24;León;222;Villaquilambre;7718;3874;3844
24;León;223;Villarejo de Órbigo;3579;1742;1837
24;León;224;Villares de Órbigo;1002;509;493
24;León;225;Villasabariego;1237;621;616
24;León;226;Villaselán;332;180;152
24;León;227;Villaturiel;1807;936;871
24;León;228;Villazala;1060;546;514
24;León;229;Villazanzo de Valderaduey;715;386;329
24;León;230;Zotes del Páramo;677;354;323
25;Lleida;001;Abella de la Conca;186;100;86
25;Lleida;002;Àger;542;289;253
25;Lleida;003;Agramunt;4933;2501;2432
25;Lleida;038;Aitona;2193;1095;1098
25;Lleida;004;Alamús (Els);672;337;335
25;Lleida;005;Alàs i Cerc;417;228;189
25;Lleida;006;Albagés (L');499;261;238
25;Lleida;007;Albatàrrec;1096;547;549
25;Lleida;008;Albesa;1497;740;757
25;Lleida;009;Albi (L');773;399;374
25;Lleida;010;Alcanó;263;134;129
25;Lleida;011;Alcarràs;4814;2408;2406
25;Lleida;012;Alcoletge;1718;874;844
25;Lleida;013;Alfarràs;2924;1434;1490
25;Lleida;014;Alfés;330;173;157
25;Lleida;015;Algerri;520;252;268
25;Lleida;016;Alguaire;2798;1423;1375
25;Lleida;017;Alins;284;144;140
25;Lleida;019;Almacelles;5515;2795;2720
25;Lleida;020;Almatret;488;245;243
25;Lleida;021;Almenar;3457;1774;1683
25;Lleida;022;Alòs de Balaguer;180;104;76
25;Lleida;023;Alpicat;3813;1895;1918
25;Lleida;024;Alt Àneu;399;220;179
25;Lleida;027;Anglesola;1283;656;627
25;Lleida;029;Arbeca;2388;1220;1168
25;Lleida;031;Arres;66;34;32
25;Lleida;032;Arsèguel;109;54;55
25;Lleida;033;Artesa de Lleida;1297;663;634
25;Lleida;034;Artesa de Segre;3171;1626;1545
25;Lleida;036;Aspa;264;131;133
25;Lleida;037;Avellanes i Santa Linya (Les);488;260;228
25;Lleida;039;Baix Pallars;352;203;149
25;Lleida;040;Balaguer;13172;6457;6715
25;Lleida;041;Barbens;742;383;359
25;Lleida;042;Baronia de Rialb (La);253;132;121
25;Lleida;044;Bassella;318;161;157
25;Lleida;045;Bausen;67;39;28
25;Lleida;046;Belianes;556;268;288
25;Lleida;170;Bellaguarda;365;183;182
25;Lleida;047;Bellcaire d'Urgell;1319;627;692
25;Lleida;048;Bell-lloc d'Urgell;2113;1045;1068
25;Lleida;049;Bellmunt d'Urgell;230;115;115
25;Lleida;050;Bellpuig;3984;1979;2005
25;Lleida;051;Bellver de Cerdanya;1548;817;731
25;Lleida;052;Bellvís;2165;1055;1110
25;Lleida;053;Benavent de Segrià;868;454;414
25;Lleida;055;Biosca;253;129;124
25;Lleida;057;Bòrdes (Es);215;110;105
25;Lleida;058;Borges Blanques (Les);5181;2568;2613
25;Lleida;059;Bossòst;847;430;417
25;Lleida;056;Bovera;405;207;198
25;Lleida;060;Cabanabona;100;51;49
25;Lleida;061;Cabó;120;68;52
25;Lleida;062;Camarasa;875;446;429
25;Lleida;063;Canejan;103;53;50
25;Lleida;904;Castell de Mur;146;77;69
25;Lleida;064;Castellar de la Ribera;153;69;84
25;Lleida;067;Castelldans;944;472;472
25;Lleida;068;Castellnou de Seana;713;369;344
25;Lleida;069;Castelló de Farfanya;588;298;290
25;Lleida;070;Castellserà;1119;544;575
25;Lleida;071;Cava;56;34;22
25;Lleida;072;Cervera;7330;3618;3712
25;Lleida;073;Cervià de les Garrigues;859;450;409
25;Lleida;074;Ciutadilla;217;110;107
25;Lleida;075;Clariana de Cardener;142;74;68
25;Lleida;076;Cogul (El);223;114;109
25;Lleida;077;Coll de Nargó;617;331;286
25;Lleida;163;Coma i la Pedra (La);231;143;88
25;Lleida;161;Conca de Dalt;426;224;202
25;Lleida;078;Corbins;1037;527;510
25;Lleida;079;Cubells;381;195;186
25;Lleida;081;Espluga Calba (L');435;224;211
25;Lleida;082;Espot;293;158;135
25;Lleida;088;Estamariu;127;67;60
25;Lleida;085;Estaràs;187;104;83
25;Lleida;086;Esterri d'Àneu;638;311;327
25;Lleida;087;Esterri de Cardós;72;38;34
25;Lleida;089;Farrera;84;46;38
25;Lleida;908;Fígols i Alinyà;300;165;135
25;Lleida;092;Floresta (La);170;90;80
25;Lleida;093;Fondarella;678;345;333
25;Lleida;094;Foradada;191;113;78
25;Lleida;096;Fuliola (La);1247;629;618
25;Lleida;097;Fulleda;113;60;53
25;Lleida;098;Gavet de la Conca;313;153;160
25;Lleida;912;Gimenells i el Pla de la Font;1118;585;533
25;Lleida;099;Golmés;1311;632;679
25;Lleida;100;Gósol;218;122;96
25;Lleida;101;Granadella (La);822;425;397
25;Lleida;102;Granja d'Escarp (La);1121;600;521
25;Lleida;103;Granyanella;134;67;67
25;Lleida;105;Granyena de les Garrigues;169;87;82
25;Lleida;104;Granyena de Segarra;160;82;78
25;Lleida;109;Guimerà;386;192;194
25;Lleida;903;Guingueta d'Àneu (La);295;151;144
25;Lleida;110;Guissona;3164;1617;1547
25;Lleida;111;Guixers;155;92;63
25;Lleida;115;Isona i Conca Dellà;1229;648;581
25;Lleida;112;Ivars de Noguera;336;173;163
25;Lleida;113;Ivars d'Urgell;1729;888;841
25;Lleida;114;Ivorra;156;80;76
25;Lleida;910;Josa i Tuixén;168;90;78
25;Lleida;118;Juncosa;612;348;264
25;Lleida;119;Juneda;2995;1517;1478
25;Lleida;121;Les;692;348;344
25;Lleida;122;Linyola;2397;1189;1208
25;Lleida;123;Lladorre;220;112;108
25;Lleida;124;Lladurs;249;131;118
25;Lleida;125;Llardecans;627;324;303
25;Lleida;126;Llavorsí;289;145;144
25;Lleida;120;Lleida;112207;54637;57570
25;Lleida;127;Lles de Cerdanya;304;169;135
25;Lleida;128;Llimiana;132;72;60
25;Lleida;129;Llobera;240;124;116
25;Lleida;133;Maials;1004;500;504
25;Lleida;130;Maldà;286;147;139
25;Lleida;131;Massalcoreig;646;314;332
25;Lleida;132;Massoteres;173;90;83
25;Lleida;134;Menàrguens;821;422;399
25;Lleida;135;Miralcamp;1251;600;651
25;Lleida;137;Mollerussa;9481;4706;4775
25;Lleida;136;Molsosa (La);134;69;65
25;Lleida;139;Montellà i Martinet;502;255;247
25;Lleida;140;Montferrer i Castellbò;736;404;332
25;Lleida;138;Montgai;794;403;391
25;Lleida;142;Montoliu de Lleida;488;241;247
25;Lleida;141;Montoliu de Segarra;189;102;87
25;Lleida;143;Montornès de Segarra;102;46;56
25;Lleida;145;Nalec;106;50;56
25;Lleida;025;Naut Aran;1463;772;691
25;Lleida;146;Navès;273;133;140
25;Lleida;148;Odèn;278;157;121
25;Lleida;149;Oliana;1869;948;921
25;Lleida;150;Oliola;219;120;99
25;Lleida;151;Olius;523;264;259
25;Lleida;152;Oluges (Les);191;99;92
25;Lleida;153;Omellons (Els);266;135;131
25;Lleida;154;Omells de na Gaia (Els);160;87;73
25;Lleida;155;Organyà;991;510;481
25;Lleida;156;Os de Balaguer;747;389;358
25;Lleida;157;Ossó de Sió;214;109;105
25;Lleida;158;Palau d'Anglesola (El);1655;830;825
25;Lleida;164;Penelles;541;297;244
25;Lleida;165;Peramola;386;205;181
25;Lleida;166;Pinell de Solsonès;219;117;102
25;Lleida;167;Pinós;314;171;143
25;Lleida;911;Plans de Sió (Els);616;321;295
25;Lleida;168;Poal (El);612;329;283
25;Lleida;169;Pobla de Cérvoles (La);216;121;95
25;Lleida;171;Pobla de Segur (La);2912;1404;1508
25;Lleida;030;Pont de Bar (El);155;86;69
25;Lleida;173;Pont de Suert (El);2183;1098;1085
25;Lleida;172;Ponts;2393;1202;1191
25;Lleida;174;Portella (La);584;317;267
25;Lleida;175;Prats i Sansor;195;106;89
25;Lleida;176;Preixana;430;217;213
25;Lleida;177;Preixens;520;252;268
25;Lleida;179;Prullans;207;108;99
25;Lleida;180;Puiggròs;261;137;124
25;Lleida;181;Puigverd d'Agramunt;253;143;110
25;Lleida;182;Puigverd de Lleida;1041;510;531
25;Lleida;183;Rialp;533;279;254
25;Lleida;905;Ribera d'Ondara;516;269;247
25;Lleida;185;Ribera d'Urgellet;748;390;358
25;Lleida;186;Riner;278;142;136
25;Lleida;913;Riu de Cerdanya;76;38;38
25;Lleida;189;Rosselló;1796;877;919
25;Lleida;190;Salàs de Pallars;334;171;163
25;Lleida;191;Sanaüja;453;223;230
25;Lleida;196;Sant Esteve de la Sarga;119;72;47
25;Lleida;192;Sant Guim de Freixenet;1055;507;548
25;Lleida;197;Sant Guim de la Plana;194;102;92
25;Lleida;193;Sant Llorenç de Morunys;892;453;439
25;Lleida;902;Sant Martí de Riucorb;718;364;354
25;Lleida;194;Sant Ramon;554;270;284
25;Lleida;201;Sarroca de Bellera;144;80;64
25;Lleida;200;Sarroca de Lleida;486;249;237
25;Lleida;202;Senterada;115;60;55
25;Lleida;035;Sentiu de Sió (La);492;237;255
25;Lleida;204;Seròs;1760;930;830
25;Lleida;203;Seu d'Urgell (La);10733;5243;5490
25;Lleida;205;Sidamon;501;248;253
25;Lleida;206;Soleràs (El);424;216;208
25;Lleida;207;Solsona;7211;3614;3597
25;Lleida;208;Soriguera;299;153;146
25;Lleida;209;Sort;1755;878;877
25;Lleida;210;Soses;1531;792;739
25;Lleida;211;Sudanell;715;384;331
25;Lleida;212;Sunyer;301;149;152
25;Lleida;215;Talarn;362;185;177
25;Lleida;216;Talavera;291;153;138
25;Lleida;217;Tàrrega;12259;5918;6341
25;Lleida;218;Tarrés;104;56;48
25;Lleida;219;Tarroja de Segarra;179;90;89
25;Lleida;220;Térmens;1403;711;692
25;Lleida;221;Tírvia;121;65;56
25;Lleida;222;Tiurana;23;16;7
25;Lleida;223;Torà;1168;588;580
25;Lleida;224;Torms (Els);196;105;91
25;Lleida;225;Tornabous;829;419;410
25;Lleida;227;Torre de Cabdella (La);655;326;329
25;Lleida;226;Torrebesses;325;159;166
25;Lleida;228;Torrefarrera;1666;851;815
25;Lleida;907;Torrefeta i Florejacs;667;336;331
25;Lleida;230;Torregrossa;2251;1112;1139
25;Lleida;231;Torrelameu;577;316;261
25;Lleida;232;Torres de Segre;1811;922;889
25;Lleida;233;Torre-serona;317;157;160
25;Lleida;234;Tremp;5379;2648;2731
25;Lleida;043;Vall de Boí (La);839;471;368
25;Lleida;901;Vall de Cardós;318;166;152
25;Lleida;238;Vallbona de les Monges;265;131;134
25;Lleida;240;Vallfogona de Balaguer;1471;743;728
25;Lleida;906;Valls d'Aguilar (Les);296;158;138
25;Lleida;239;Valls de Valira (Les);751;408;343
25;Lleida;909;Vansa i Fórnols (La);172;87;85
25;Lleida;242;Verdú;1015;485;530
25;Lleida;243;Vielha e Mijaran;4017;2006;2011
25;Lleida;244;Vilagrassa;434;232;202
25;Lleida;245;Vilaller;611;322;289
25;Lleida;247;Vilamòs;149;76;73
25;Lleida;248;Vilanova de Bellpuig;1159;573;586
25;Lleida;254;Vilanova de la Barca;907;446;461
25;Lleida;249;Vilanova de l'Aguda;270;138;132
25;Lleida;250;Vilanova de Meià;479;249;230
25;Lleida;251;Vilanova de Segrià;762;390;372
25;Lleida;252;Vila-sana;523;259;264
25;Lleida;253;Vilosell (El);195;87;108
25;Lleida;255;Vinaixa;619;301;318
26;Rioja (La);001;Ábalos;280;157;123
26;Rioja (La);002;Agoncillo;892;467;425
26;Rioja (La);003;Aguilar del Río Alhama;707;363;344
26;Rioja (La);004;Ajamil de Cameros;63;41;22
26;Rioja (La);005;Albelda de Iregua;2181;1101;1080
26;Rioja (La);006;Alberite;2005;998;1007
26;Rioja (La);007;Alcanadre;808;416;392
26;Rioja (La);008;Aldeanueva de Ebro;2486;1284;1202
26;Rioja (La);009;Alesanco;490;251;239
26;Rioja (La);010;Alesón;142;71;71
26;Rioja (La);011;Alfaro;9124;4580;4544
26;Rioja (La);012;Almarza de Cameros;41;26;15
26;Rioja (La);013;Anguciana;293;150;143
26;Rioja (La);014;Anguiano;604;333;271
26;Rioja (La);015;Arenzana de Abajo;312;163;149
26;Rioja (La);016;Arenzana de Arriba;40;22;18
26;Rioja (La);017;Arnedillo;450;216;234
26;Rioja (La);018;Arnedo;12796;6387;6409
26;Rioja (La);019;Arrúbal;481;252;229
26;Rioja (La);020;Ausejo;711;386;325
26;Rioja (La);021;Autol;3368;1718;1650
26;Rioja (La);022;Azofra;347;188;159
26;Rioja (La);023;Badarán;722;387;335
26;Rioja (La);024;Bañares;383;192;191
26;Rioja (La);026;Baños de Río Tobía;1808;919;889
26;Rioja (La);025;Baños de Rioja;115;67;48
26;Rioja (La);027;Berceo;224;136;88
26;Rioja (La);028;Bergasa;132;74;58
26;Rioja (La);029;Bergasillas Bajera;30;17;13
26;Rioja (La);030;Bezares;31;19;12
26;Rioja (La);031;Bobadilla;164;94;70
26;Rioja (La);032;Brieva de Cameros;70;41;29
26;Rioja (La);033;Briñas;200;99;101
26;Rioja (La);034;Briones;818;436;382
26;Rioja (La);035;Cabezón de Cameros;32;22;10
26;Rioja (La);036;Calahorra;19057;9260;9797
26;Rioja (La);037;Camprovín;220;118;102
26;Rioja (La);038;Canales de la Sierra;84;45;39
26;Rioja (La);039;Canillas de Río Tuerto;67;32;35
26;Rioja (La);040;Cañas;113;52;61
26;Rioja (La);041;Cárdenas;263;129;134
26;Rioja (La);042;Casalarreina;889;446;443
26;Rioja (La);043;Castañares de Rioja;489;248;241
26;Rioja (La);044;Castroviejo;61;31;30
26;Rioja (La);045;Cellorigo;21;11;10
26;Rioja (La);046;Cenicero;2076;1045;1031
26;Rioja (La);047;Cervera del Río Alhama;3038;1572;1466
26;Rioja (La);048;Cidamón;45;24;21
26;Rioja (La);049;Cihuri;161;84;77
26;Rioja (La);050;Cirueña;123;72;51
26;Rioja (La);051;Clavijo;208;110;98
26;Rioja (La);052;Cordovín;218;112;106
26;Rioja (La);053;Corera;251;120;131
26;Rioja (La);054;Cornago;580;315;265
26;Rioja (La);055;Corporales;63;32;31
26;Rioja (La);056;Cuzcurrita de Río Tirón;477;258;219
26;Rioja (La);057;Daroca de Rioja;52;32;20
26;Rioja (La);058;Enciso;174;107;67
26;Rioja (La);059;Entrena;1132;585;547
26;Rioja (La);060;Estollo;147;82;65
26;Rioja (La);061;Ezcaray;1833;966;867
26;Rioja (La);062;Foncea;128;68;60
26;Rioja (La);063;Fonzaleche;172;104;68
26;Rioja (La);064;Fuenmayor;2210;1118;1092
26;Rioja (La);065;Galbárruli;70;39;31
26;Rioja (La);066;Galilea;290;151;139
26;Rioja (La);067;Gallinero de Cameros;27;18;9
26;Rioja (La);068;Gimileo;94;44;50
26;Rioja (La);069;Grañón;420;220;200
26;Rioja (La);070;Grávalos;276;140;136
26;Rioja (La);071;Haro;9150;4515;4635
26;Rioja (La);072;Herce;342;177;165
26;Rioja (La);073;Herramélluri;164;88;76
26;Rioja (La);074;Hervías;197;102;95
26;Rioja (La);075;Hormilla;481;249;232
26;Rioja (La);076;Hormilleja;178;91;87
26;Rioja (La);077;Hornillos de Cameros;22;11;11
26;Rioja (La);078;Hornos de Moncalvillo;96;45;51
26;Rioja (La);079;Huércanos;877;448;429
26;Rioja (La);080;Igea;774;418;356
26;Rioja (La);081;Jalón de Cameros;37;20;17
26;Rioja (La);082;Laguna de Cameros;178;98;80
26;Rioja (La);083;Lagunilla del Jubera;349;186;163
26;Rioja (La);084;Lardero;3421;1719;1702
26;Rioja (La);086;Ledesma de la Cogolla;20;14;6
26;Rioja (La);087;Leiva;302;149;153
26;Rioja (La);088;Leza de Río Leza;31;21;10
26;Rioja (La);089;Logroño;127093;61092;66001
26;Rioja (La);091;Lumbreras;158;97;61
26;Rioja (La);092;Manjarrés;142;81;61
26;Rioja (La);093;Mansilla de la Sierra;49;33;16
26;Rioja (La);094;Manzanares de Rioja;121;66;55
26;Rioja (La);095;Matute;163;78;85
26;Rioja (La);096;Medrano;212;113;99
26;Rioja (La);098;Munilla;120;61;59
26;Rioja (La);099;Murillo de Río Leza;1471;747;724
26;Rioja (La);100;Muro de Aguas;70;41;29
26;Rioja (La);101;Muro en Cameros;40;25;15
26;Rioja (La);102;Nájera;7063;3519;3544
26;Rioja (La);103;Nalda;825;434;391
26;Rioja (La);104;Navajún;19;12;7
26;Rioja (La);105;Navarrete;2048;1055;993
26;Rioja (La);106;Nestares;73;39;34
26;Rioja (La);107;Nieva de Cameros;113;59;54
26;Rioja (La);109;Ochánduri;100;50;50
26;Rioja (La);108;Ocón;327;186;141
26;Rioja (La);110;Ojacastro;240;142;98
26;Rioja (La);111;Ollauri;307;171;136
26;Rioja (La);112;Ortigosa de Cameros;327;171;156
26;Rioja (La);113;Pazuengos;49;31;18
26;Rioja (La);114;Pedroso;113;63;50
26;Rioja (La);115;Pinillos;32;18;14
26;Rioja (La);117;Pradejón;2964;1555;1409
26;Rioja (La);118;Pradillo;92;51;41
26;Rioja (La);119;Préjano;229;111;118
26;Rioja (La);120;Quel;1882;984;898
26;Rioja (La);121;Rabanera;45;32;13
26;Rioja (La);122;Rasillo de Cameros (El);110;59;51
26;Rioja (La);123;Redal (El);215;109;106
26;Rioja (La);124;Ribafrecha;985;540;445
26;Rioja (La);125;Rincón de Soto;2562;1366;1196
26;Rioja (La);126;Robres del Castillo;16;10;6
26;Rioja (La);127;Rodezno;327;178;149
26;Rioja (La);128;Sajazarra;143;73;70
26;Rioja (La);129;San Asensio;1217;630;587
26;Rioja (La);130;San Millán de la Cogolla;276;171;105
26;Rioja (La);131;San Millán de Yécora;56;34;22
26;Rioja (La);132;San Román de Cameros;160;87;73
26;Rioja (La);139;San Torcuato;99;55;44
26;Rioja (La);142;San Vicente de la Sonsierra;1083;553;530
26;Rioja (La);134;Santa Coloma;143;89;54
26;Rioja (La);135;Santa Engracia del Jubera;208;123;85
26;Rioja (La);136;Santa Eulalia Bajera;102;58;44
26;Rioja (La);138;Santo Domingo de la Calzada;5676;2846;2830
26;Rioja (La);140;Santurde de Rioja;292;146;146
26;Rioja (La);141;Santurdejo;190;106;84
26;Rioja (La);143;Sojuela;82;48;34
26;Rioja (La);144;Sorzano;221;114;107
26;Rioja (La);145;Sotés;225;132;93
26;Rioja (La);146;Soto en Cameros;169;92;77
26;Rioja (La);147;Terroba;32;17;15
26;Rioja (La);148;Tirgo;268;137;131
26;Rioja (La);149;Tobía;59;35;24
26;Rioja (La);150;Tormantos;220;118;102
26;Rioja (La);153;Torre en Cameros;14;11;3
26;Rioja (La);151;Torrecilla en Cameros;558;300;258
26;Rioja (La);152;Torrecilla sobre Alesanco;79;40;39
26;Rioja (La);154;Torremontalbo;16;10;6
26;Rioja (La);155;Treviana;268;143;125
26;Rioja (La);157;Tricio;347;166;181
26;Rioja (La);158;Tudelilla;440;221;219
26;Rioja (La);160;Uruñuela;742;383;359
26;Rioja (La);161;Valdemadera;15;10;5
26;Rioja (La);162;Valgañón;166;92;74
26;Rioja (La);163;Ventosa;127;69;58
26;Rioja (La);164;Ventrosa;88;39;49
26;Rioja (La);165;Viguera;373;219;154
26;Rioja (La);166;Villalba de Rioja;149;88;61
26;Rioja (La);167;Villalobar de Rioja;124;75;49
26;Rioja (La);168;Villamediana de Iregua;2128;1106;1022
26;Rioja (La);169;Villanueva de Cameros;122;64;58
26;Rioja (La);170;Villar de Arnedo (El);636;306;330
26;Rioja (La);171;Villar de Torre;314;164;150
26;Rioja (La);172;Villarejo;50;31;19
26;Rioja (La);173;Villarroya;9;4;5
26;Rioja (La);174;Villarta-Quintana;216;108;108
26;Rioja (La);175;Villavelayo;73;42;31
26;Rioja (La);176;Villaverde de Rioja;103;58;45
26;Rioja (La);177;Villoslada de Cameros;393;231;162
26;Rioja (La);178;Viniegra de Abajo;122;65;57
26;Rioja (La);179;Viniegra de Arriba;54;34;20
26;Rioja (La);180;Zarratón;265;140;125
26;Rioja (La);181;Zarzosa;17;12;5
26;Rioja (La);183;Zorraquín;49;30;19
27;Lugo;001;Abadín;3531;1663;1868
27;Lugo;002;Alfoz;2485;1198;1287
27;Lugo;003;Antas de Ulla;2800;1326;1474
27;Lugo;004;Baleira;1956;1007;949
27;Lugo;901;Baralla;3414;1746;1668
27;Lugo;005;Barreiros;3493;1682;1811
27;Lugo;006;Becerreá;3779;1914;1865
27;Lugo;007;Begonte;3873;1924;1949
27;Lugo;008;Bóveda;2087;1009;1078
27;Lugo;902;Burela;7939;3932;4007
27;Lugo;009;Carballedo;3295;1645;1650
27;Lugo;010;Castro de Rei;5952;2967;2985
27;Lugo;011;Castroverde;3575;1829;1746
27;Lugo;012;Cervantes;2276;1240;1036
27;Lugo;013;Cervo;5092;2555;2537
27;Lugo;016;Chantada;9871;4860;5011
27;Lugo;014;Corgo (O);4325;2182;2143
27;Lugo;015;Cospeito;5971;2932;3039
27;Lugo;017;Folgoso do Courel;1628;823;805
27;Lugo;018;Fonsagrada (A);5682;2978;2704
27;Lugo;019;Foz;9527;4531;4996
27;Lugo;020;Friol;4873;2429;2444
27;Lugo;022;Guitiriz;6451;3196;3255
27;Lugo;023;Guntín;3599;1804;1795
27;Lugo;024;Incio (O);2605;1274;1331
27;Lugo;026;Láncara;3342;1725;1617
27;Lugo;027;Lourenzá;2884;1389;1495
27;Lugo;028;Lugo;87480;41179;46301
27;Lugo;029;Meira;1849;901;948
27;Lugo;030;Mondoñedo;5139;2379;2760
27;Lugo;031;Monforte de Lemos;20007;9584;10423
27;Lugo;032;Monterroso;4265;2111;2154
27;Lugo;033;Muras;1184;576;608
27;Lugo;034;Navia de Suarna;2042;1084;958
27;Lugo;035;Negueira de Muñiz;271;142;129
27;Lugo;037;Nogais (As);1624;835;789
27;Lugo;038;Ourol;1612;784;828
27;Lugo;039;Outeiro de Rei;4134;2086;2048
27;Lugo;040;Palas de Rei;4333;2113;2220
27;Lugo;041;Pantón;3604;1718;1886
27;Lugo;042;Paradela;2728;1347;1381
27;Lugo;043;Páramo (O);1919;980;939
27;Lugo;044;Pastoriza (A);4143;2073;2070
27;Lugo;045;Pedrafita do Cebreiro;1650;885;765
27;Lugo;047;Pobra do Brollón (A);2675;1300;1375
27;Lugo;046;Pol;2205;1081;1124
27;Lugo;048;Pontenova (A);3426;1674;1752
27;Lugo;049;Portomarín;2138;1045;1093
27;Lugo;050;Quiroga;4458;2170;2288
27;Lugo;056;Rábade;1574;788;786
27;Lugo;051;Ribadeo;8953;4187;4766
27;Lugo;052;Ribas de Sil;1496;718;778
27;Lugo;053;Ribeira de Piquín;914;448;466
27;Lugo;054;Riotorto;1980;977;1003
27;Lugo;055;Samos;2177;1135;1042
27;Lugo;057;Sarria;12972;6340;6632
27;Lugo;058;Saviñao (O);5163;2502;2661
27;Lugo;059;Sober;3185;1539;1646
27;Lugo;060;Taboada;4249;2059;2190
27;Lugo;061;Trabada;1746;840;906
27;Lugo;062;Triacastela;939;456;483
27;Lugo;063;Valadouro (O);2487;1234;1253
27;Lugo;064;Vicedo (O);2423;1195;1228
27;Lugo;065;Vilalba;15658;7683;7975
27;Lugo;066;Viveiro;15425;7463;7962
27;Lugo;021;Xermade;2797;1371;1426
27;Lugo;025;Xove;3605;1795;1810
28;Madrid;001;Acebeda (La);47;26;21
28;Madrid;002;Ajalvir;1936;1005;931
28;Madrid;003;Alameda del Valle;186;104;82
28;Madrid;004;Álamo (El);4429;2528;1901
28;Madrid;005;Alcalá de Henares;164463;81942;82521
28;Madrid;006;Alcobendas;87924;43375;44549
28;Madrid;007;Alcorcón;142048;70208;71840
28;Madrid;008;Aldea del Fresno;1396;726;670
28;Madrid;009;Algete;14033;7106;6927
28;Madrid;010;Alpedrete;6337;3188;3149
28;Madrid;011;Ambite;301;148;153
28;Madrid;012;Anchuelo;576;316;260
28;Madrid;013;Aranjuez;39326;18989;20337
28;Madrid;014;Arganda del Rey;30231;14970;15261
28;Madrid;015;Arroyomolinos;3101;1578;1523
28;Madrid;016;Atazar (El);89;48;41
28;Madrid;017;Batres;787;406;381
28;Madrid;018;Becerril de la Sierra;3055;1582;1473
28;Madrid;019;Belmonte de Tajo;1139;575;564
28;Madrid;021;Berrueco (El);309;169;140
28;Madrid;020;Berzosa del Lozoya;100;48;52
28;Madrid;022;Boadilla del Monte;19300;9745;9555
28;Madrid;023;Boalo (El);2845;1454;1391
28;Madrid;024;Braojos;154;84;70
28;Madrid;025;Brea de Tajo;464;238;226
28;Madrid;026;Brunete;4931;2444;2487
28;Madrid;027;Buitrago del Lozoya;1419;699;720
28;Madrid;028;Bustarviejo;1390;716;674
28;Madrid;029;Cabanillas de la Sierra;448;234;214
28;Madrid;030;Cabrera (La);1591;807;784
28;Madrid;031;Cadalso de los Vidrios;2223;1132;1091
28;Madrid;032;Camarma de Esteruelas;2313;1164;1149
28;Madrid;033;Campo Real;2644;1339;1305
28;Madrid;034;Canencia;444;231;213
28;Madrid;035;Carabaña;1149;566;583
28;Madrid;036;Casarrubuelos;668;358;310
28;Madrid;037;Cenicientos;1850;913;937
28;Madrid;038;Cercedilla;5488;2717;2771
28;Madrid;039;Cervera de Buitrago;90;54;36
28;Madrid;051;Chapinería;1304;667;637
28;Madrid;052;Chinchón;3991;1992;1999
28;Madrid;040;Ciempozuelos;13231;6724;6507
28;Madrid;041;Cobeña;2624;1344;1280
28;Madrid;046;Collado Mediano;4341;2188;2153
28;Madrid;047;Collado Villalba;40872;20393;20479
28;Madrid;043;Colmenar de Oreja;5424;2653;2771
28;Madrid;042;Colmenar del Arroyo;862;402;460
28;Madrid;045;Colmenar Viejo;31445;15630;15815
28;Madrid;044;Colmenarejo;4014;2023;1991
28;Madrid;048;Corpa;356;181;175
28;Madrid;049;Coslada;76538;37985;38553
28;Madrid;050;Cubas de la Sagra;1563;770;793
28;Madrid;053;Daganzo de Arriba;3483;1779;1704
28;Madrid;054;Escorial (El);10053;5002;5051
28;Madrid;055;Estremera;1004;518;486
28;Madrid;056;Fresnedillas de la Oliva;697;347;350
28;Madrid;057;Fresno de Torote;538;299;239
28;Madrid;058;Fuenlabrada;171173;86315;84858
28;Madrid;059;Fuente el Saz de Jarama;3720;1939;1781
28;Madrid;060;Fuentidueña de Tajo;1447;702;745
28;Madrid;061;Galapagar;20534;10379;10155
28;Madrid;062;Garganta de los Montes;326;167;159
28;Madrid;063;Gargantilla del Lozoya y Pinilla de Buitrago;232;142;90
28;Madrid;064;Gascones;100;54;46
28;Madrid;065;Getafe;145371;72184;73187
28;Madrid;066;Griñón;4009;2048;1961
28;Madrid;067;Guadalix de la Sierra;2844;1476;1368
28;Madrid;068;Guadarrama;8805;4333;4472
28;Madrid;069;Hiruela (La);65;32;33
28;Madrid;070;Horcajo de la Sierra-Aoslos;139;74;65
28;Madrid;071;Horcajuelo de la Sierra;93;44;49
28;Madrid;072;Hoyo de Manzanares;5362;2728;2634
28;Madrid;073;Humanes de Madrid;9039;4642;4397
28;Madrid;074;Leganés;173163;86270;86893
28;Madrid;075;Loeches;2910;1440;1470
28;Madrid;076;Lozoya;442;227;215
28;Madrid;901;Lozoyuela-Navas-Sieteiglesias;641;346;295
28;Madrid;078;Madarcos;26;14;12
28;Madrid;079;Madrid;2879052;1344682;1534370
28;Madrid;080;Majadahonda;43955;21332;22623
28;Madrid;082;Manzanares el Real;3453;1791;1662
28;Madrid;083;Meco;5667;2919;2748
28;Madrid;084;Mejorada del Campo;15500;7789;7711
28;Madrid;085;Miraflores de la Sierra;3606;1804;1802
28;Madrid;086;Molar (El);3628;1923;1705
28;Madrid;087;Molinos (Los);3165;1537;1628
28;Madrid;088;Montejo de la Sierra;291;142;149
28;Madrid;089;Moraleja de Enmedio;2878;1446;1432
28;Madrid;090;Moralzarzal;4449;2263;2186
28;Madrid;091;Morata de Tajuña;5420;2670;2750
28;Madrid;092;Móstoles;195351;96829;98522
28;Madrid;093;Navacerrada;1824;903;921
28;Madrid;094;Navalafuente;496;267;229
28;Madrid;095;Navalagamella;1040;529;511
28;Madrid;096;Navalcarnero;12913;6516;6397
28;Madrid;097;Navarredonda y San Mamés;106;58;48
28;Madrid;099;Navas del Rey;1583;830;753
28;Madrid;100;Nuevo Baztán;2624;1363;1261
28;Madrid;101;Olmeda de las Fuentes;151;84;67
28;Madrid;102;Orusco de Tajuña;665;347;318
28;Madrid;104;Paracuellos de Jarama;5757;2960;2797
28;Madrid;106;Parla;72975;36550;36425
28;Madrid;107;Patones;370;188;182
28;Madrid;108;Pedrezuela;1322;694;628
28;Madrid;109;Pelayos de la Presa;1328;660;668
28;Madrid;110;Perales de Tajuña;2054;1004;1050
28;Madrid;111;Pezuela de las Torres;584;316;268
28;Madrid;112;Pinilla del Valle;159;89;70
28;Madrid;113;Pinto;27204;13619;13585
28;Madrid;114;Piñuécar-Gandullas;152;71;81
28;Madrid;115;Pozuelo de Alarcón;64778;31659;33119
28;Madrid;116;Pozuelo del Rey;215;114;101
28;Madrid;117;Prádena del Rincón;99;51;48
28;Madrid;118;Puebla de la Sierra;77;44;33
28;Madrid;902;Puentes Viejas;415;228;187
28;Madrid;119;Quijorna;1001;542;459
28;Madrid;120;Rascafría;1621;852;769
28;Madrid;121;Redueña;158;77;81
28;Madrid;122;Ribatejada;359;193;166
28;Madrid;123;Rivas-Vaciamadrid;27422;13742;13680
28;Madrid;124;Robledillo de la Jara;78;40;38
28;Madrid;125;Robledo de Chavela;2180;1085;1095
28;Madrid;126;Robregordo;86;41;45
28;Madrid;127;Rozas de Madrid (Las);51650;25301;26349
28;Madrid;128;Rozas de Puerto Real;294;155;139
28;Madrid;129;San Agustín del Guadalix;5673;2862;2811
28;Madrid;130;San Fernando de Henares;32144;16141;16003
28;Madrid;131;San Lorenzo de El Escorial;11350;5480;5870
28;Madrid;132;San Martín de la Vega;10060;5139;4921
28;Madrid;133;San Martín de Valdeiglesias;6034;2980;3054
28;Madrid;134;San Sebastián de los Reyes;58215;29039;29176
28;Madrid;135;Santa María de la Alameda;747;408;339
28;Madrid;136;Santorcaz;550;289;261
28;Madrid;137;Santos de la Humosa (Los);895;455;440
28;Madrid;138;Serna del Monte (La);100;53;47
28;Madrid;140;Serranillos del Valle;936;485;451
28;Madrid;141;Sevilla la Nueva;3243;1702;1541
28;Madrid;143;Somosierra;95;51;44
28;Madrid;144;Soto del Real;4870;2483;2387
28;Madrid;145;Talamanca de Jarama;1408;696;712
28;Madrid;146;Tielmes;1923;978;945
28;Madrid;147;Titulcia;961;483;478
28;Madrid;148;Torrejón de Ardoz;92262;43535;48727
28;Madrid;149;Torrejón de la Calzada;3873;1938;1935
28;Madrid;150;Torrejón de Velasco;1774;933;841
28;Madrid;151;Torrelaguna;2729;1318;1411
28;Madrid;152;Torrelodones;12342;6088;6254
28;Madrid;153;Torremocha de Jarama;341;167;174
28;Madrid;154;Torres de la Alameda;4131;2084;2047
28;Madrid;903;Tres Cantos;33121;16431;16690
28;Madrid;155;Valdaracete;640;313;327
28;Madrid;156;Valdeavero;575;304;271
28;Madrid;157;Valdelaguna;527;279;248
28;Madrid;158;Valdemanco;530;283;247
28;Madrid;159;Valdemaqueda;549;273;276
28;Madrid;160;Valdemorillo;5257;2698;2559
28;Madrid;161;Valdemoro;25572;12823;12749
28;Madrid;162;Valdeolmos-Alalpardo;1725;907;818
28;Madrid;163;Valdepiélagos;314;164;150
28;Madrid;164;Valdetorres de Jarama;1872;967;905
28;Madrid;165;Valdilecha;1847;938;909
28;Madrid;166;Valverde de Alcalá;271;142;129
28;Madrid;167;Velilla de San Antonio;5935;3042;2893
28;Madrid;168;Vellón (El);1101;572;529
28;Madrid;169;Venturada;734;382;352
28;Madrid;171;Villa del Prado;3778;1920;1858
28;Madrid;170;Villaconejos;2867;1456;1411
28;Madrid;172;Villalbilla;3838;2020;1818
28;Madrid;173;Villamanrique de Tajo;606;298;308
28;Madrid;174;Villamanta;1503;758;745
28;Madrid;175;Villamantilla;332;176;156
28;Madrid;176;Villanueva de la Cañada;9966;4933;5033
28;Madrid;178;Villanueva de Perales;471;259;212
28;Madrid;177;Villanueva del Pardillo;4042;2056;1986
28;Madrid;179;Villar del Olmo;1290;656;634
28;Madrid;180;Villarejo de Salvanés;5581;2777;2804
28;Madrid;181;Villaviciosa de Odón;18465;9189;9276
28;Madrid;182;Villavieja del Lozoya;172;81;91
28;Madrid;183;Zarzalejo;1028;530;498
29;Málaga;001;Alameda;4947;2446;2501
29;Málaga;002;Alcaucín;1499;751;748
29;Málaga;003;Alfarnate;1431;730;701
29;Málaga;004;Alfarnatejo;408;216;192
29;Málaga;005;Algarrobo;4861;2412;2449
29;Málaga;006;Algatocín;947;478;469
29;Málaga;007;Alhaurín de la Torre;20192;10040;10152
29;Málaga;008;Alhaurín el Grande;16870;8438;8432
29;Málaga;009;Almáchar;1956;991;965
29;Málaga;010;Almargen;2145;449;1696
29;Málaga;011;Almogía;4119;2103;2016
29;Málaga;012;Álora;12565;6282;6283
29;Málaga;013;Alozaina;2127;1111;1016
29;Málaga;014;Alpandeire;301;152;149
29;Málaga;015;Antequera;40433;19771;20662
29;Málaga;016;Árchez;338;170;168
29;Málaga;017;Archidona;8203;4077;4126
29;Málaga;018;Ardales;2958;1459;1499
29;Málaga;019;Arenas;1199;644;555
29;Málaga;020;Arriate;3436;1647;1789
29;Málaga;021;Atajate;169;92;77
29;Málaga;022;Benadalid;260;136;124
29;Málaga;023;Benahavís;1867;928;939
29;Málaga;024;Benalauría;504;265;239
29;Málaga;025;Benalmádena;30059;14770;15289
29;Málaga;026;Benamargosa;1552;787;765
29;Málaga;027;Benamocarra;2790;1396;1394
29;Málaga;028;Benaoján;1648;815;833
29;Málaga;029;Benarrabá;653;342;311
29;Málaga;030;Borge (El);1033;527;506
29;Málaga;031;Burgo (El);1992;1026;966
29;Málaga;032;Campillos;7633;3836;3797
29;Málaga;033;Canillas de Aceituno;2257;1126;1131
29;Málaga;034;Canillas de Albaida;680;361;319
29;Málaga;035;Cañete la Real;2215;1144;1071
29;Málaga;036;Carratraca;838;410;428
29;Málaga;037;Cartajima;219;117;102
29;Málaga;038;Cártama;13004;6549;6455
29;Málaga;039;Casabermeja;2958;1541;1417
29;Málaga;040;Casarabonela;2559;1295;1264
29;Málaga;041;Casares;3224;1687;1537
29;Málaga;042;Coín;17627;8802;8825
29;Málaga;043;Colmenar;3172;1553;1619
29;Málaga;044;Comares;1407;720;687
29;Málaga;045;Cómpeta;2703;1364;1339
29;Málaga;046;Cortes de la Frontera;3565;1775;1790
29;Málaga;047;Cuevas Bajas;1438;695;743
29;Málaga;049;Cuevas de San Marcos;4017;1972;2045
29;Málaga;048;Cuevas del Becerro;1933;977;956
29;Málaga;050;Cútar;609;308;301
29;Málaga;051;Estepona;40552;20123;20429
29;Málaga;052;Faraján;273;140;133
29;Málaga;053;Frigiliana;2157;1062;1095
29;Málaga;054;Fuengirola;46392;22762;23630
29;Málaga;055;Fuente de Piedra;1940;935;1005
29;Málaga;056;Gaucín;1688;869;819
29;Málaga;057;Genalguacil;571;300;271
29;Málaga;058;Guaro;1901;960;941
29;Málaga;059;Humilladero;2513;1276;1237
29;Málaga;060;Igualeja;912;452;460
29;Málaga;061;Istán;1322;659;663
29;Málaga;062;Iznate;751;382;369
29;Málaga;063;Jimera de Líbar;419;195;224
29;Málaga;064;Jubrique;848;419;429
29;Málaga;065;Júzcar;223;121;102
29;Málaga;066;Macharaviaya;346;184;162
29;Málaga;067;Málaga;530553;252293;278260
29;Málaga;068;Manilva;5509;2818;2691
29;Málaga;069;Marbella;101144;49852;51292
29;Málaga;070;Mijas;39302;19661;19641
29;Málaga;071;Moclinejo;1076;542;534
29;Málaga;072;Mollina;3345;1632;1713
29;Málaga;073;Monda;1671;833;838
29;Málaga;074;Montejaque;1020;496;524
29;Málaga;075;Nerja;15725;7763;7962
29;Málaga;076;Ojén;1994;1053;941
29;Málaga;077;Parauta;223;115;108
29;Málaga;079;Periana;3408;1757;1651
29;Málaga;080;Pizarra;6586;3201;3385
29;Málaga;081;Pujerra;310;173;137
29;Málaga;082;Rincón de la Victoria;21721;10842;10879
29;Málaga;083;Riogordo;2692;1372;1320
29;Málaga;084;Ronda;33806;16554;17252
29;Málaga;085;Salares;213;106;107
29;Málaga;086;Sayalonga;1143;593;550
29;Málaga;087;Sedella;484;262;222
29;Málaga;088;Sierra de Yeguas;3218;1588;1630
29;Málaga;089;Teba;4394;2233;2161
29;Málaga;090;Tolox;2488;1287;1201
29;Málaga;901;Torremolinos;39068;19238;19830
29;Málaga;091;Torrox;11919;5907;6012
29;Málaga;092;Totalán;615;312;303
29;Málaga;093;Valle de Abdalajís;3035;1481;1554
29;Málaga;094;Vélez-Málaga;54796;27219;27577
29;Málaga;095;Villanueva de Algaidas;4159;2061;2098
29;Málaga;098;Villanueva de Tapia;1606;823;783
29;Málaga;096;Villanueva del Rosario;3339;1635;1704
29;Málaga;097;Villanueva del Trabuco;4753;2406;2347
29;Málaga;099;Viñuela;1185;593;592
29;Málaga;100;Yunquera;3256;1691;1565
30;Murcia;001;Abanilla;6153;3068;3085
30;Murcia;002;Abarán;12177;6046;6131
30;Murcia;003;Águilas;26773;13322;13451
30;Murcia;004;Albudeite;1376;684;692
30;Murcia;005;Alcantarilla;32982;16224;16758
30;Murcia;902;Alcázares (Los);6877;3446;3431
30;Murcia;006;Aledo;1005;511;494
30;Murcia;007;Alguazas;7021;3490;3531
30;Murcia;008;Alhama de Murcia;15640;7823;7817
30;Murcia;009;Archena;14398;7160;7238
30;Murcia;010;Beniel;7974;3965;4009
30;Murcia;011;Blanca;5706;2831;2875
30;Murcia;012;Bullas;10677;5349;5328
30;Murcia;013;Calasparra;8934;4493;4441
30;Murcia;014;Campos del Río;2005;978;1027
30;Murcia;015;Caravaca de la Cruz;22269;11048;11221
30;Murcia;016;Cartagena;177709;87825;89884
30;Murcia;017;Cehegín;14077;7068;7009
30;Murcia;018;Ceutí;7153;3617;3536
30;Murcia;019;Cieza;31725;15580;16145
30;Murcia;020;Fortuna;6652;3395;3257
30;Murcia;021;Fuente Álamo de Murcia;9606;4862;4744
30;Murcia;022;Jumilla;20573;10226;10347
30;Murcia;023;Librilla;3873;1897;1976
30;Murcia;024;Lorca;70689;35040;35649
30;Murcia;025;Lorquí;5527;2755;2772
30;Murcia;026;Mazarrón;17478;8941;8537
30;Murcia;027;Molina de Segura;43097;21403;21694
30;Murcia;028;Moratalla;8574;4357;4217
30;Murcia;029;Mula;13632;6783;6849
30;Murcia;030;Murcia;353504;171986;181518
30;Murcia;031;Ojós;589;292;297
30;Murcia;032;Pliego;3401;1742;1659
30;Murcia;033;Puerto Lumbreras;10658;5220;5438
30;Murcia;034;Ricote;1579;769;810
30;Murcia;035;San Javier;18267;9242;9025
30;Murcia;036;San Pedro del Pinatar;15008;7409;7599
30;Murcia;901;Santomera;10594;5310;5284
30;Murcia;037;Torre-Pacheco;21937;12030;9907
30;Murcia;038;Torres de Cotillas (Las);15617;7821;7796
30;Murcia;039;Totana;21973;11056;10917
30;Murcia;040;Ulea;956;476;480
30;Murcia;041;Unión (La);14386;7171;7215
30;Murcia;042;Villanueva del Río Segura;1555;746;809
30;Murcia;043;Yecla;28772;14431;14341
31;Navarra;001;Abáigar;99;53;46
31;Navarra;002;Abárzuza;514;257;257
31;Navarra;003;Abaurregaina/Abaurrea Alta;171;102;69
31;Navarra;004;Abaurrepea/Abaurrea Baja;47;33;14
31;Navarra;005;Aberin;361;189;172
31;Navarra;006;Ablitas;2311;1180;1131
31;Navarra;007;Adiós;128;63;65
31;Navarra;008;Aguilar de Codés;106;60;46
31;Navarra;009;Aibar/Oibar;930;481;449
31;Navarra;011;Allín;850;446;404
31;Navarra;012;Allo;1066;535;531
31;Navarra;010;Altsasu/Alsasua;7011;3535;3476
31;Navarra;013;Améscoa Baja;826;436;390
31;Navarra;014;Ancín/Antzin;274;141;133
31;Navarra;015;Andosilla;2490;1238;1252
31;Navarra;016;Ansoáin/Antsoain;6479;3307;3172
31;Navarra;017;Anue;433;255;178
31;Navarra;018;Añorbe;407;224;183
31;Navarra;019;Aoiz/Agoitz;1838;920;918
31;Navarra;020;Araitz;613;358;255
31;Navarra;025;Arakil;879;468;411
31;Navarra;021;Aranarache/Aranaratxe;94;46;48
31;Navarra;023;Aranguren;3485;1833;1652
31;Navarra;024;Arano;143;76;67
31;Navarra;022;Arantza;679;375;304
31;Navarra;026;Aras;226;121;105
31;Navarra;027;Arbizu;927;488;439
31;Navarra;028;Arce/Artzi;302;167;135
31;Navarra;029;Arcos (Los);1339;663;676
31;Navarra;030;Arellano;205;112;93
31;Navarra;031;Areso;307;157;150
31;Navarra;032;Arguedas;2264;1137;1127
31;Navarra;033;Aria;68;41;27
31;Navarra;034;Aribe;63;32;31
31;Navarra;035;Armañanzas;94;50;44
31;Navarra;036;Arróniz;1188;628;560
31;Navarra;037;Arruazu;101;54;47
31;Navarra;038;Artajona;1689;889;800
31;Navarra;039;Artazu;80;45;35
31;Navarra;040;Atez;214;129;85
31;Navarra;058;Auritz/Burguete;334;147;187
31;Navarra;041;Ayegui/Aiegi;933;478;455
31;Navarra;042;Azagra;3524;1749;1775
31;Navarra;043;Azuelo;55;25;30
31;Navarra;044;Bakaiku;363;204;159
31;Navarra;901;Barañain;20541;10097;10444
31;Navarra;045;Barásoain;459;230;229
31;Navarra;046;Barbarin;107;47;60
31;Navarra;047;Bargota;381;188;193
31;Navarra;048;Barillas;189;92;97
31;Navarra;049;Basaburua;697;402;295
31;Navarra;050;Baztan;7741;3935;3806
31;Navarra;137;Beintza-Labaien;296;159;137
31;Navarra;051;Beire;320;157;163
31;Navarra;052;Belascoáin;102;52;50
31;Navarra;250;Bera;3511;1788;1723
31;Navarra;053;Berbinzana;720;362;358
31;Navarra;905;Beriáin;2503;1239;1264
31;Navarra;902;Berrioplano;1171;578;593
31;Navarra;903;Berriozar;5445;2801;2644
31;Navarra;054;Bertizarana;719;366;353
31;Navarra;055;Betelu;346;188;158
31;Navarra;253;Bidaurreta;104;65;39
31;Navarra;056;Biurrun-Olcoz;179;95;84
31;Navarra;057;Buñuel;2397;1168;1229
31;Navarra;059;Burgui/Burgi;239;133;106
31;Navarra;060;Burlada/Burlata;16647;8217;8430
31;Navarra;061;Busto (El);102;55;47
31;Navarra;062;Cabanillas;1461;750;711
31;Navarra;063;Cabredo;128;67;61
31;Navarra;064;Cadreita;1869;915;954
31;Navarra;065;Caparroso;2313;1136;1177
31;Navarra;066;Cárcar;1259;611;648
31;Navarra;067;Carcastillo;2621;1314;1307
31;Navarra;068;Cascante;3616;1788;1828
31;Navarra;069;Cáseda;1061;520;541
31;Navarra;070;Castejón;3149;1571;1578
31;Navarra;071;Castillonuevo;25;15;10
31;Navarra;072;Cintruénigo;5589;2764;2825
31;Navarra;074;Cirauqui/Zirauki;458;254;204
31;Navarra;075;Ciriza;65;25;40
31;Navarra;076;Cizur;1198;604;594
31;Navarra;077;Corella;6686;3342;3344
31;Navarra;078;Cortes;3268;1672;1596
31;Navarra;079;Desojo;144;83;61
31;Navarra;080;Dicastillo;681;361;320
31;Navarra;081;Donamaria;379;191;188
31;Navarra;221;Doneztebe/Santesteban;1368;677;691
31;Navarra;083;Echarri;51;27;24
31;Navarra;086;Egüés;2127;1077;1050
31;Navarra;087;Elgorriaga;268;141;127
31;Navarra;089;Enériz/Eneritz;188;95;93
31;Navarra;090;Eratsun;179;110;69
31;Navarra;091;Ergoiena;481;271;210
31;Navarra;092;Erro;790;433;357
31;Navarra;094;Eslava;178;87;91
31;Navarra;095;Esparza de Salazar/Espartza Zaraitzu;121;65;56
31;Navarra;096;Espronceda;178;103;75
31;Navarra;097;Estella/Lizarra;12607;6050;6557
31;Navarra;098;Esteribar;1709;910;799
31;Navarra;099;Etayo;99;53;46
31;Navarra;082;Etxalar;791;417;374
31;Navarra;084;Etxarri-Aranatz;2337;1202;1135
31;Navarra;085;Etxauri;413;217;196
31;Navarra;100;Eulate;381;203;178
31;Navarra;101;Ezcabarte;1198;640;558
31;Navarra;093;Ezcároz/Ezkaroze;363;192;171
31;Navarra;102;Ezkurra;245;151;94
31;Navarra;103;Ezprogui;64;32;32
31;Navarra;104;Falces;2604;1285;1319
31;Navarra;105;Fitero;2034;1017;1017
31;Navarra;106;Fontellas;709;361;348
31;Navarra;107;Funes;2175;1122;1053
31;Navarra;108;Fustiñana;2290;1155;1135
31;Navarra;109;Galar;1102;578;524
31;Navarra;110;Gallipienzo;159;88;71
31;Navarra;111;Gallués/Galoze;123;79;44
31;Navarra;112;Garaioa;134;72;62
31;Navarra;113;Garde;200;108;92
31;Navarra;114;Garínoain;331;174;157
31;Navarra;115;Garralda;213;109;104
31;Navarra;116;Genevilla;125;67;58
31;Navarra;117;Goizueta;906;480;426
31;Navarra;118;Goñi;166;95;71
31;Navarra;119;Güesa/Gorza;78;45;33
31;Navarra;120;Guesálaz/Gesalatz;458;265;193
31;Navarra;121;Guirguillano;72;40;32
31;Navarra;256;Hiriberri/Villanueva de Aezkoa;154;86;68
31;Navarra;122;Huarte/Uharte;2809;1422;1387
31;Navarra;124;Ibargoiti;231;129;102
31;Navarra;259;Igantzi;593;303;290
31;Navarra;125;Igúzquiza;362;182;180
31;Navarra;126;Imotz;407;228;179
31;Navarra;127;Irañeta;169;89;80
31;Navarra;904;Irurtzun;2019;1039;980
31;Navarra;128;Isaba/Izaba;533;268;265
31;Navarra;129;Ituren;465;236;229
31;Navarra;130;Iturmendi;376;192;184
31;Navarra;131;Iza/Itza;667;348;319
31;Navarra;132;Izagaondoa;168;101;67
31;Navarra;133;Izalzu/Itzaltzu;51;30;21
31;Navarra;134;Jaurrieta;262;138;124
31;Navarra;135;Javier;130;57;73
31;Navarra;136;Juslapeña;473;262;211
31;Navarra;138;Lakuntza;984;502;482
31;Navarra;139;Lana;218;127;91
31;Navarra;140;Lantz;120;76;44
31;Navarra;141;Lapoblación;187;105;82
31;Navarra;142;Larraga;1878;996;882
31;Navarra;143;Larraona;156;80;76
31;Navarra;144;Larraun;1083;601;482
31;Navarra;145;Lazagurría;236;126;110
31;Navarra;146;Leache;51;31;20
31;Navarra;147;Legarda;78;47;31
31;Navarra;148;Legaria;123;62;61
31;Navarra;149;Leitza;3003;1571;1432
31;Navarra;908;Lekunberri;834;430;404
31;Navarra;150;Leoz/Leotz;263;164;99
31;Navarra;151;Lerga;85;45;40
31;Navarra;152;Lerín;1918;954;964
31;Navarra;153;Lesaka;2737;1439;1298
31;Navarra;154;Lezáun;283;164;119
31;Navarra;155;Liédena;320;150;170
31;Navarra;156;Lizoáin-Arriasgoiti;237;137;100
31;Navarra;157;Lodosa;4589;2326;2263
31;Navarra;158;Lónguida/Longida;298;159;139
31;Navarra;159;Lumbier;1414;763;651
31;Navarra;160;Luquin;131;72;59
31;Navarra;248;Luzaide/Valcarlos;469;232;237
31;Navarra;161;Mañeru;354;180;174
31;Navarra;162;Marañón;75;41;34
31;Navarra;163;Marcilla;2517;1301;1216
31;Navarra;164;Mélida;822;428;394
31;Navarra;165;Mendavia;3563;1771;1792
31;Navarra;166;Mendaza;372;180;192
31;Navarra;167;Mendigorría;884;455;429
31;Navarra;168;Metauten;291;158;133
31;Navarra;169;Milagro;2586;1260;1326
31;Navarra;170;Mirafuentes;52;28;24
31;Navarra;171;Miranda de Arga;996;505;491
31;Navarra;172;Monreal;294;164;130
31;Navarra;173;Monteagudo;1175;594;581
31;Navarra;174;Morentin;137;67;70
31;Navarra;175;Mues;112;62;50
31;Navarra;176;Murchante;3053;1509;1544
31;Navarra;177;Murieta;272;151;121
31;Navarra;178;Murillo el Cuende;672;361;311
31;Navarra;179;Murillo el Fruto;755;375;380
31;Navarra;180;Muruzábal;239;125;114
31;Navarra;181;Navascués;223;137;86
31;Navarra;182;Nazar;58;32;26
31;Navarra;088;Noáin (Valle de Elorz)/Noain (Elortzibar);3869;1931;1938
31;Navarra;183;Obanos;785;376;409
31;Navarra;185;Ochagavía/Otsagabia;680;349;331
31;Navarra;184;Oco;83;48;35
31;Navarra;186;Odieta;327;180;147
31;Navarra;187;Oitz;149;89;60
31;Navarra;188;Olaibar;169;92;77
31;Navarra;189;Olazti/Olazagutía;1659;853;806
31;Navarra;190;Olejua;55;26;29
31;Navarra;191;Olite/Erriberri;3101;1551;1550
31;Navarra;194;Ollo;336;192;144
31;Navarra;192;Olóriz/Oloritz;179;103;76
31;Navarra;193;Cendea de Olza/Oltza Zendea;1328;677;651
31;Navarra;195;Orbaitzeta;240;132;108
31;Navarra;196;Orbara;59;30;29
31;Navarra;906;Orcoyen;1280;660;620
31;Navarra;197;Orísoain;103;61;42
31;Navarra;198;Oronz/Orontze;60;33;27
31;Navarra;199;Oroz-Betelu/Orotz-Betelu;228;123;105
31;Navarra;211;Orreaga/Roncesvalles;31;16;15
31;Navarra;200;Oteiza;908;475;433
31;Navarra;201;Pamplona/Iruña;180483;86232;94251
31;Navarra;202;Peralta/Azkoien;4694;2340;2354
31;Navarra;203;Petilla de Aragón;48;24;24
31;Navarra;204;Piedramillera;70;40;30
31;Navarra;205;Pitillas;577;291;286
31;Navarra;206;Puente la Reina/Gares;2254;1122;1132
31;Navarra;207;Pueyo;324;170;154
31;Navarra;208;Ribaforada;3179;1626;1553
31;Navarra;209;Romanzado;167;99;68
31;Navarra;210;Roncal/Erronkari;368;181;187
31;Navarra;212;Sada;246;133;113
31;Navarra;213;Saldías;153;83;70
31;Navarra;214;Salinas de Oro/Jaitz;107;62;45
31;Navarra;215;San Adrián;5392;2624;2768
31;Navarra;217;San Martín de Unx;483;260;223
31;Navarra;216;Sangüesa/Zangoza;4634;2388;2246
31;Navarra;219;Sansol;123;59;64
31;Navarra;220;Santacara;1039;529;510
31;Navarra;222;Sarriés/Sartze;79;47;32
31;Navarra;223;Sartaguda;1364;695;669
31;Navarra;224;Sesma;1381;667;714
31;Navarra;225;Sorlada;49;25;24
31;Navarra;226;Sunbilla;677;348;329
31;Navarra;227;Tafalla;10214;5032;5182
31;Navarra;228;Tiebas-Muruarte de Reta;576;303;273
31;Navarra;229;Tirapu;65;36;29
31;Navarra;230;Torralba del Río;159;88;71
31;Navarra;231;Torres del Río;185;87;98
31;Navarra;232;Tudela;27602;13414;14188
31;Navarra;233;Tulebras;103;34;69
31;Navarra;234;Ucar;120;68;52
31;Navarra;123;Uharte-Arakil;769;411;358
31;Navarra;235;Ujué;242;125;117
31;Navarra;236;Ultzama;1630;826;804
31;Navarra;237;Unciti;228;138;90
31;Navarra;238;Unzué;137;82;55
31;Navarra;239;Urdazubi/Urdax;402;192;210
31;Navarra;240;Urdiain;647;331;316
31;Navarra;241;Urraul Alto;169;98;71
31;Navarra;242;Urraul Bajo;273;128;145
31;Navarra;244;Urrotz;213;120;93
31;Navarra;243;Urroz;360;187;173
31;Navarra;245;Urzainqui/Urzainki;110;59;51
31;Navarra;246;Uterga;136;66;70
31;Navarra;247;Uztárroz/Uztarroze;278;138;140
31;Navarra;249;Valtierra;2422;1176;1246
31;Navarra;251;Viana;3488;1791;1697
31;Navarra;252;Vidángoz/Bidankoze;114;60;54
31;Navarra;254;Villafranca;2530;1237;1293
31;Navarra;255;Villamayor de Monjardín;130;70;60
31;Navarra;257;Villatuerta;817;426;391
31;Navarra;258;Villava/Atarrabia;9142;4521;4621
31;Navarra;260;Valle de Yerri/Deierri;1229;668;561
31;Navarra;261;Yesa;239;136;103
31;Navarra;262;Zabalza/Zabaltza;155;73;82
31;Navarra;073;Ziordia;382;176;206
31;Navarra;907;Zizur Mayor/Zizur Nagusia;10077;5026;5051
31;Navarra;263;Zubieta;314;181;133
31;Navarra;264;Zugarramurdi;237;125;112
31;Navarra;265;Zúñiga;118;70;48
32;Ourense;001;Allariz;5151;2470;2681
32;Ourense;002;Amoeiro;2260;1098;1162
32;Ourense;003;Arnoia (A);1215;561;654
32;Ourense;004;Avión;2959;1276;1683
32;Ourense;005;Baltar;1304;653;651
32;Ourense;006;Bande;2660;1254;1406
32;Ourense;007;Baños de Molgas;2235;1110;1125
32;Ourense;008;Barbadás;5929;2852;3077
32;Ourense;009;Barco de Valdeorras (O);12596;6290;6306
32;Ourense;010;Beade;585;286;299
32;Ourense;011;Beariz;1674;770;904
32;Ourense;012;Blancos (Os);1354;670;684
32;Ourense;013;Boborás;3485;1596;1889
32;Ourense;014;Bola (A);1599;752;847
32;Ourense;015;Bolo (O);1509;742;767
32;Ourense;016;Calvos de Randín;1292;648;644
32;Ourense;018;Carballeda de Avia;1715;815;900
32;Ourense;017;Carballeda de Valdeorras;2354;1185;1169
32;Ourense;019;Carballiño (O);12363;5831;6532
32;Ourense;020;Cartelle;3981;1918;2063
32;Ourense;022;Castrelo de Miño;2108;1007;1101
32;Ourense;021;Castrelo do Val;1312;643;669
32;Ourense;023;Castro Caldelas;1935;972;963
32;Ourense;024;Celanova;5959;2816;3143
32;Ourense;025;Cenlle;1713;799;914
32;Ourense;029;Chandrexa de Queixa;928;506;422
32;Ourense;026;Coles;3063;1512;1551
32;Ourense;027;Cortegada;1444;702;742
32;Ourense;028;Cualedro;2469;1231;1238
32;Ourense;030;Entrimo;1478;662;816
32;Ourense;031;Esgos;1350;647;703
32;Ourense;033;Gomesende;1211;557;654
32;Ourense;034;Gudiña (A);1778;886;892
32;Ourense;035;Irixo (O);2216;1025;1191
32;Ourense;038;Larouco;626;297;329
32;Ourense;039;Laza;2059;1031;1028
32;Ourense;040;Leiro;2053;973;1080
32;Ourense;041;Lobeira;1261;613;648
32;Ourense;042;Lobios;2718;1296;1422
32;Ourense;043;Maceda;3399;1646;1753
32;Ourense;044;Manzaneda;1308;674;634
32;Ourense;045;Maside;3345;1572;1773
32;Ourense;046;Melón;1618;721;897
32;Ourense;047;Merca (A);2444;1167;1277
32;Ourense;048;Mezquita (A);1553;780;773
32;Ourense;049;Montederramo;1313;679;634
32;Ourense;050;Monterrei;3461;1720;1741
32;Ourense;051;Muíños;2083;997;1086
32;Ourense;052;Nogueira de Ramuín;2651;1245;1406
32;Ourense;053;Oímbra;2044;1024;1020
32;Ourense;054;Ourense;109120;51215;57905
32;Ourense;055;Paderne de Allariz;1712;815;897
32;Ourense;056;Padrenda;2707;1297;1410
32;Ourense;057;Parada de Sil;894;424;470
32;Ourense;058;Pereiro de Aguiar (O);4847;2358;2489
32;Ourense;059;Peroxa (A);2619;1241;1378
32;Ourense;060;Petín;1156;553;603
32;Ourense;061;Piñor;1627;801;826
32;Ourense;063;Pobra de Trives (A);2977;1475;1502
32;Ourense;064;Pontedeva;723;334;389
32;Ourense;062;Porqueira;1178;558;620
32;Ourense;065;Punxín;965;459;506
32;Ourense;066;Quintela de Leirado;981;460;521
32;Ourense;067;Rairiz de Veiga;1932;942;990
32;Ourense;068;Ramirás;2085;964;1121
32;Ourense;069;Ribadavia;5556;2676;2880
32;Ourense;071;Riós;2328;1166;1162
32;Ourense;072;Rúa (A);4951;2429;2522
32;Ourense;073;Rubiá;1857;915;942
32;Ourense;074;San Amaro;1561;752;809
32;Ourense;075;San Cibrao das Viñas;3553;1717;1836
32;Ourense;076;San Cristovo de Cea;3244;1564;1680
32;Ourense;070;San Xoán de Río;1063;507;556
32;Ourense;077;Sandiás;1727;803;924
32;Ourense;078;Sarreaus;1944;962;982
32;Ourense;079;Taboadela;1716;860;856
32;Ourense;080;Teixeira (A);611;287;324
32;Ourense;081;Toén;2599;1314;1285
32;Ourense;082;Trasmiras;1916;948;968
32;Ourense;083;Veiga (A);1445;716;729
32;Ourense;084;Verea;1515;729;786
32;Ourense;085;Verín;12765;6231;6534
32;Ourense;086;Viana do Bolo;4202;2076;2126
32;Ourense;087;Vilamarín;2271;1119;1152
32;Ourense;088;Vilamartín de Valdeorras;2527;1237;1290
32;Ourense;089;Vilar de Barrio;2091;1041;1050
32;Ourense;090;Vilar de Santos;1028;501;527
32;Ourense;091;Vilardevós;2980;1497;1483
32;Ourense;092;Vilariño de Conso;849;467;382
32;Ourense;032;Xinzo de Limia;9511;4718;4793
32;Ourense;036;Xunqueira de Ambía;2073;1017;1056
32;Ourense;037;Xunqueira de Espadanedo;1094;522;572
33;Asturias;001;Allande;2519;1297;1222
33;Asturias;002;Aller;15775;7765;8010
33;Asturias;003;Amieva;927;492;435
33;Asturias;004;Avilés;84519;40664;43855
33;Asturias;005;Belmonte de Miranda;2389;1223;1166
33;Asturias;006;Bimenes;2212;1047;1165
33;Asturias;007;Boal;2608;1282;1326
33;Asturias;008;Cabrales;2367;1209;1158
33;Asturias;009;Cabranes;1277;634;643
33;Asturias;010;Candamo;2629;1258;1371
33;Asturias;012;Cangas de Onís;6287;3062;3225
33;Asturias;011;Cangas del Narcea;17593;8915;8678
33;Asturias;013;Caravia;589;301;288
33;Asturias;014;Carreño;10610;5147;5463
33;Asturias;015;Caso;2070;1082;988
33;Asturias;016;Castrillón;22515;10928;11587
33;Asturias;017;Castropol;4417;2095;2322
33;Asturias;018;Coaña;3765;1833;1932
33;Asturias;019;Colunga;4571;2239;2332
33;Asturias;020;Corvera de Asturias;16295;8004;8291
33;Asturias;021;Cudillero;6172;3014;3158
33;Asturias;022;Degaña;1564;827;737
33;Asturias;023;Franco (El);4170;2042;2128
33;Asturias;024;Gijón;267980;127095;140885
33;Asturias;025;Gozón;11337;5527;5810
33;Asturias;026;Grado;11805;5685;6120
33;Asturias;027;Grandas de Salime;1376;704;672
33;Asturias;028;Ibias;2224;1204;1020
33;Asturias;029;Illano;646;340;306
33;Asturias;030;Illas;1182;624;558
33;Asturias;031;Langreo;49771;23808;25963
33;Asturias;032;Laviana;14893;7231;7662
33;Asturias;033;Lena;14030;6824;7206
33;Asturias;035;Llanera;11798;5788;6010
33;Asturias;036;Llanes;13212;6331;6881
33;Asturias;037;Mieres;50578;24245;26333
33;Asturias;038;Morcín;3074;1505;1569
33;Asturias;039;Muros de Nalón;2372;1112;1260
33;Asturias;040;Nava;5684;2782;2902
33;Asturias;041;Navia;9154;4394;4760
33;Asturias;042;Noreña;4274;2043;2231
33;Asturias;043;Onís;903;452;451
33;Asturias;044;Oviedo;200453;93306;107147
33;Asturias;045;Parres;5627;2741;2886
33;Asturias;046;Peñamellera Alta;742;367;375
33;Asturias;047;Peñamellera Baja;1632;808;824
33;Asturias;048;Pesoz;268;133;135
33;Asturias;049;Piloña;8976;4344;4632
33;Asturias;050;Ponga;774;459;315
33;Asturias;051;Pravia;9515;4594;4921
33;Asturias;052;Proaza;947;486;461
33;Asturias;053;Quirós;1703;894;809
33;Asturias;054;Regueras (Las);2221;1102;1119
33;Asturias;055;Ribadedeva;1905;924;981
33;Asturias;056;Ribadesella;6291;2983;3308
33;Asturias;057;Ribera de Arriba;2034;998;1036
33;Asturias;058;Riosa;2605;1325;1280
33;Asturias;059;Salas;7154;3486;3668
33;Asturias;061;San Martín de Oscos;535;275;260
33;Asturias;060;San Martín del Rey Aurelio;21414;10282;11132
33;Asturias;063;San Tirso de Abres;667;325;342
33;Asturias;062;Santa Eulalia de Oscos;586;294;292
33;Asturias;064;Santo Adriano;344;178;166
33;Asturias;065;Sariego;1409;695;714
33;Asturias;066;Siero;47270;22869;24401
33;Asturias;067;Sobrescobio;814;422;392
33;Asturias;068;Somiedo;1638;871;767
33;Asturias;069;Soto del Barco;4433;2096;2337
33;Asturias;070;Tapia de Casariego;4394;2091;2303
33;Asturias;071;Taramundi;932;450;482
33;Asturias;072;Teverga;2325;1215;1110
33;Asturias;073;Tineo;13200;6648;6552
33;Asturias;034;Valdés;15556;7615;7941
33;Asturias;074;Vegadeo;4825;2285;2540
33;Asturias;075;Villanueva de Oscos;416;213;203
33;Asturias;076;Villaviciosa;14348;7042;7306
33;Asturias;077;Villayón;2000;1031;969
33;Asturias;078;Yernes y Tameza;228;111;117
34;Palencia;001;Abarca de Campos;49;25;24
34;Palencia;003;Abia de las Torres;216;110;106
34;Palencia;004;Aguilar de Campoo;7734;3799;3935
34;Palencia;005;Alar del Rey;1319;620;699
34;Palencia;006;Alba de Cerrato;105;50;55
34;Palencia;009;Amayuelas de Arriba;45;27;18
34;Palencia;010;Ampudia;692;357;335
34;Palencia;011;Amusco;577;314;263
34;Palencia;012;Antigüedad;439;237;202
34;Palencia;015;Arconada;71;37;34
34;Palencia;017;Astudillo;1310;671;639
34;Palencia;018;Autilla del Pino;248;133;115
34;Palencia;019;Autillo de Campos;186;84;102
34;Palencia;020;Ayuela;82;51;31
34;Palencia;022;Baltanás;1572;809;763
34;Palencia;024;Baquerín de Campos;38;23;15
34;Palencia;025;Bárcena de Campos;65;29;36
34;Palencia;027;Barruelo de Santullán;1901;893;1008
34;Palencia;028;Báscones de Ojeda;217;109;108
34;Palencia;029;Becerril de Campos;1138;556;582
34;Palencia;031;Belmonte de Campos;49;24;25
34;Palencia;032;Berzosilla;74;33;41
34;Palencia;033;Boada de Campos;24;13;11
34;Palencia;035;Boadilla de Rioseco;191;98;93
34;Palencia;034;Boadilla del Camino;195;103;92
34;Palencia;036;Brañosera;295;154;141
34;Palencia;037;Buenavista de Valdavia;446;223;223
34;Palencia;038;Bustillo de la Vega;377;201;176
34;Palencia;039;Bustillo del Páramo de Carrión;101;54;47
34;Palencia;041;Calahorra de Boedo;140;69;71
34;Palencia;042;Calzada de los Molinos;389;207;182
34;Palencia;045;Capillas;122;58;64
34;Palencia;046;Cardeñosa de Volpejera;56;30;26
34;Palencia;047;Carrión de los Condes;2466;1163;1303
34;Palencia;048;Castil de Vela;111;54;57
34;Palencia;049;Castrejón de la Peña;638;335;303
34;Palencia;050;Castrillo de Don Juan;350;196;154
34;Palencia;051;Castrillo de Onielo;183;87;96
34;Palencia;052;Castrillo de Villavega;300;155;145
34;Palencia;053;Castromocho;273;140;133
34;Palencia;055;Cervatos de la Cueza;401;207;194
34;Palencia;056;Cervera de Pisuerga;2747;1380;1367
34;Palencia;057;Cevico de la Torre;722;352;370
34;Palencia;058;Cevico Navero;297;152;145
34;Palencia;059;Cisneros;633;302;331
34;Palencia;060;Cobos de Cerrato;260;126;134
34;Palencia;061;Collazos de Boedo;165;92;73
34;Palencia;062;Congosto de Valdavia;282;162;120
34;Palencia;063;Cordovilla la Real;122;70;52
34;Palencia;066;Cubillas de Cerrato;98;50;48
34;Palencia;067;Dehesa de Montejo;237;134;103
34;Palencia;068;Dehesa de Romanos;47;27;20
34;Palencia;069;Dueñas;2966;1516;1450
34;Palencia;070;Espinosa de Cerrato;274;144;130
34;Palencia;071;Espinosa de Villagonzalo;275;140;135
34;Palencia;072;Frechilla;278;133;145
34;Palencia;073;Fresno del Río;201;102;99
34;Palencia;074;Frómista;999;495;504
34;Palencia;076;Fuentes de Nava;831;417;414
34;Palencia;077;Fuentes de Valdepero;240;132;108
34;Palencia;079;Grijota;812;403;409
34;Palencia;080;Guardo;8718;4405;4313
34;Palencia;081;Guaza de Campos;83;40;43
34;Palencia;082;Hérmedes de Cerrato;138;68;70
34;Palencia;083;Herrera de Pisuerga;2707;1340;1367
34;Palencia;084;Herrera de Valdecañas;206;101;105
34;Palencia;086;Hontoria de Cerrato;124;63;61
34;Palencia;087;Hornillos de Cerrato;138;66;72
34;Palencia;088;Husillos;230;124;106
34;Palencia;089;Itero de la Vega;250;126;124
34;Palencia;091;Lagartos;172;91;81
34;Palencia;092;Lantadilla;529;253;276
34;Palencia;094;Ledigos;108;56;52
34;Palencia;903;Loma de Ucieza;334;174;160
34;Palencia;096;Lomas;58;27;31
34;Palencia;098;Magaz de Pisuerga;724;375;349
34;Palencia;099;Manquillos;77;41;36
34;Palencia;100;Mantinos;206;102;104
34;Palencia;101;Marcilla de Campos;77;34;43
34;Palencia;102;Mazariegos;289;157;132
34;Palencia;103;Mazuecos de Valdeginate;141;71;70
34;Palencia;104;Melgar de Yuso;401;220;181
34;Palencia;106;Meneses de Campos;155;80;75
34;Palencia;107;Micieces de Ojeda;112;59;53
34;Palencia;108;Monzón de Campos;763;399;364
34;Palencia;109;Moratinos;92;48;44
34;Palencia;110;Mudá;130;66;64
34;Palencia;112;Nogal de las Huertas;71;40;31
34;Palencia;113;Olea de Boedo;46;22;24
34;Palencia;114;Olmos de Ojeda;356;198;158
34;Palencia;116;Osornillo;104;57;47
34;Palencia;901;Osorno la Mayor;1735;930;805
34;Palencia;120;Palencia;80332;38376;41956
34;Palencia;121;Palenzuela;327;173;154
34;Palencia;122;Páramo de Boedo;118;61;57
34;Palencia;123;Paredes de Nava;2476;1220;1256
34;Palencia;124;Payo de Ojeda;97;57;40
34;Palencia;125;Pedraza de Campos;139;71;68
34;Palencia;126;Pedrosa de la Vega;390;205;185
34;Palencia;127;Perales;122;65;57
34;Palencia;904;Pernía (La);481;266;215
34;Palencia;129;Pino del Río;276;163;113
34;Palencia;130;Piña de Campos;305;164;141
34;Palencia;131;Población de Arroyo;93;50;43
34;Palencia;132;Población de Campos;205;111;94
34;Palencia;133;Población de Cerrato;124;64;60
34;Palencia;134;Polentinos;96;52;44
34;Palencia;135;Pomar de Valdivia;539;272;267
34;Palencia;136;Poza de la Vega;275;151;124
34;Palencia;137;Pozo de Urama;46;24;22
34;Palencia;139;Prádanos de Ojeda;256;134;122
34;Palencia;140;Puebla de Valdavia (La);163;82;81
34;Palencia;141;Quintana del Puente;266;136;130
34;Palencia;143;Quintanilla de Onsoña;249;142;107
34;Palencia;146;Reinoso de Cerrato;83;49;34
34;Palencia;147;Renedo de la Vega;266;153;113
34;Palencia;149;Requena de Campos;62;32;30
34;Palencia;151;Respenda de la Peña;285;151;134
34;Palencia;152;Revenga de Campos;190;93;97
34;Palencia;154;Revilla de Collazos;87;48;39
34;Palencia;155;Ribas de Campos;204;108;96
34;Palencia;156;Riberos de la Cueza;95;54;41
34;Palencia;157;Saldaña;3180;1600;1580
34;Palencia;158;Salinas de Pisuerga;290;156;134
34;Palencia;159;San Cebrián de Campos;556;320;236
34;Palencia;160;San Cebrián de Mudá;209;102;107
34;Palencia;161;San Cristóbal de Boedo;49;29;20
34;Palencia;163;San Mamés de Campos;114;47;67
34;Palencia;165;San Román de la Cuba;126;63;63
34;Palencia;167;Santa Cecilia del Alcor;167;91;76
34;Palencia;168;Santa Cruz de Boedo;67;36;31
34;Palencia;169;Santervás de la Vega;570;310;260
34;Palencia;170;Santibáñez de Ecla;103;44;59
34;Palencia;171;Santibáñez de la Peña;1567;789;778
34;Palencia;174;Santoyo;295;144;151
34;Palencia;175;Serna (La);126;74;52
34;Palencia;177;Soto de Cerrato;232;117;115
34;Palencia;176;Sotobañado y Priorato;189;101;88
34;Palencia;178;Tabanera de Cerrato;173;88;85
34;Palencia;179;Tabanera de Valdavia;59;24;35
34;Palencia;180;Támara de Campos;106;54;52
34;Palencia;181;Tariego de Cerrato;560;296;264
34;Palencia;182;Torquemada;1219;619;600
34;Palencia;184;Torremormojón;105;58;47
34;Palencia;185;Triollo;98;52;46
34;Palencia;186;Valbuena de Pisuerga;76;43;33
34;Palencia;189;Valdeolmillos;91;47;44
34;Palencia;190;Valderrábano;80;48;32
34;Palencia;192;Valde-Ucieza;126;72;54
34;Palencia;196;Valle de Cerrato;135;75;60
34;Palencia;902;Valle del Retortillo;224;110;114
34;Palencia;199;Velilla del Río Carrión;1855;946;909
34;Palencia;023;Venta de Baños;6303;3076;3227
34;Palencia;201;Vertavillo;243;132;111
34;Palencia;093;Vid de Ojeda (La);137;79;58
34;Palencia;202;Villabasta de Valdavia;41;18;23
34;Palencia;204;Villacidaler;79;37;42
34;Palencia;205;Villaconancio;90;52;38
34;Palencia;206;Villada;1320;645;675
34;Palencia;208;Villaeles de Valdavia;87;48;39
34;Palencia;210;Villahán;143;77;66
34;Palencia;211;Villaherreros;283;133;150
34;Palencia;213;Villalaco;86;36;50
34;Palencia;214;Villalba de Guardo;246;132;114
34;Palencia;215;Villalcázar de Sirga;245;113;132
34;Palencia;216;Villalcón;93;45;48
34;Palencia;217;Villalobón;302;159;143
34;Palencia;218;Villaluenga de la Vega;663;371;292
34;Palencia;220;Villamartín de Campos;169;89;80
34;Palencia;221;Villamediana;246;126;120
34;Palencia;222;Villameriel;159;86;73
34;Palencia;223;Villamoronta;342;184;158
34;Palencia;224;Villamuera de la Cueza;68;41;27
34;Palencia;225;Villamuriel de Cerrato;4649;2383;2266
34;Palencia;227;Villanueva del Rebollar;107;54;53
34;Palencia;228;Villanuño de Valdavia;125;71;54
34;Palencia;229;Villaprovedo;101;61;40
34;Palencia;230;Villarmentero de Campos;15;10;5
34;Palencia;231;Villarrabé;294;144;150
34;Palencia;232;Villarramiel;1102;557;545
34;Palencia;233;Villasarracino;283;150;133
34;Palencia;234;Villasila de Valdavia;114;63;51
34;Palencia;236;Villaturde;264;126;138
34;Palencia;237;Villaumbrales;885;460;425
34;Palencia;238;Villaviudas;461;221;240
34;Palencia;240;Villerías de Campos;127;71;56
34;Palencia;241;Villodre;48;28;20
34;Palencia;242;Villodrigo;132;67;65
34;Palencia;243;Villoldo;490;260;230
34;Palencia;245;Villota del Páramo;458;266;192
34;Palencia;246;Villovieco;126;64;62
35;Palmas (Las);001;Agaete;5789;2963;2826
35;Palmas (Las);002;Agüimes;19933;10160;9773
35;Palmas (Las);003;Antigua;4240;2337;1903
35;Palmas (Las);004;Arrecife;42231;21488;20743
35;Palmas (Las);005;Artenara;1368;714;654
35;Palmas (Las);006;Arucas;31175;15619;15556
35;Palmas (Las);007;Betancuria;636;331;305
35;Palmas (Las);008;Firgas;6747;3390;3357
35;Palmas (Las);009;Gáldar;22220;11143;11077
35;Palmas (Las);010;Haría;4022;2069;1953
35;Palmas (Las);011;Ingenio;24004;12147;11857
35;Palmas (Las);016;Las Palmas de Gran Canaria;354757;173266;181491
35;Palmas (Las);012;Mogán;12256;6430;5826
35;Palmas (Las);013;Moya;8701;4418;4283
35;Palmas (Las);014;Oliva (La);9547;5132;4415
35;Palmas (Las);015;Pájara;10132;5677;4455
35;Palmas (Las);017;Puerto del Rosario;20218;10593;9625
35;Palmas (Las);018;San Bartolomé;11576;6057;5519
35;Palmas (Las);019;San Bartolomé de Tirajana;38729;20035;18694
35;Palmas (Las);020;San Nicolás de Tolentino;8073;4081;3992
35;Palmas (Las);021;Santa Brígida;17706;8819;8887
35;Palmas (Las);022;Santa Lucía de Tirajana;43543;22164;21379
35;Palmas (Las);023;Santa María de Guía de Gran Canaria;13897;6933;6964
35;Palmas (Las);024;Teguise;11534;5934;5600
35;Palmas (Las);025;Tejeda;2487;1263;1224
35;Palmas (Las);026;Telde;86037;43117;42920
35;Palmas (Las);027;Teror;11654;5880;5774
35;Palmas (Las);028;Tías;12684;6550;6134
35;Palmas (Las);029;Tinajo;4149;2144;2005
35;Palmas (Las);030;Tuineje;9130;4845;4285
35;Palmas (Las);032;Valleseco;4129;2118;2011
35;Palmas (Las);031;Valsequillo de Gran Canaria;7905;4065;3840
35;Palmas (Las);033;Vega de San Mateo;7281;3762;3519
35;Palmas (Las);034;Yaiza;4179;2302;1877
36;Pontevedra;020;Agolada;4457;2176;2281
36;Pontevedra;001;Arbo;4459;2178;2281
36;Pontevedra;003;Baiona;10659;5214;5445
36;Pontevedra;002;Barro;3533;1686;1847
36;Pontevedra;004;Bueu;12517;6129;6388
36;Pontevedra;005;Caldas de Reis;9405;4510;4895
36;Pontevedra;006;Cambados;13067;6342;6725
36;Pontevedra;007;Campo Lameiro;2374;1115;1259
36;Pontevedra;008;Cangas;23413;11549;11864
36;Pontevedra;009;Cañiza (A);7176;3359;3817
36;Pontevedra;010;Catoira;3528;1714;1814
36;Pontevedra;011;Cerdedo;2592;1128;1464
36;Pontevedra;012;Cotobade;4963;2271;2692
36;Pontevedra;013;Covelo;4112;1908;2204
36;Pontevedra;014;Crecente;3062;1393;1669
36;Pontevedra;015;Cuntis;5637;2596;3041
36;Pontevedra;016;Dozón;2230;1069;1161
36;Pontevedra;017;Estrada (A);22331;10492;11839
36;Pontevedra;018;Forcarei;4892;2284;2608
36;Pontevedra;019;Fornelos de Montes;2343;1063;1280
36;Pontevedra;021;Gondomar;11327;5549;5778
36;Pontevedra;022;Grove (O);11049;5474;5575
36;Pontevedra;023;Guarda (A);9919;4819;5100
36;Pontevedra;901;Illa de Arousa (A);4850;2392;2458
36;Pontevedra;024;Lalín;20196;9755;10441
36;Pontevedra;025;Lama (A);2985;1356;1629
36;Pontevedra;026;Marín;25421;12570;12851
36;Pontevedra;027;Meaño;5419;2587;2832
36;Pontevedra;028;Meis;5001;2325;2676
36;Pontevedra;029;Moaña;17751;8603;9148
36;Pontevedra;030;Mondariz;5915;2770;3145
36;Pontevedra;031;Mondariz-Balneario;634;305;329
36;Pontevedra;032;Moraña;4402;2093;2309
36;Pontevedra;033;Mos;13729;6683;7046
36;Pontevedra;034;Neves (As);5027;2374;2653
36;Pontevedra;035;Nigrán;15647;7644;8003
36;Pontevedra;036;Oia;2956;1468;1488
36;Pontevedra;037;Pazos de Borbén;3202;1488;1714
36;Pontevedra;041;Poio;13843;6705;7138
36;Pontevedra;043;Ponte Caldelas;6547;3081;3466
36;Pontevedra;042;Ponteareas;17938;8609;9329
36;Pontevedra;044;Pontecesures;2981;1491;1490
36;Pontevedra;038;Pontevedra;74139;35052;39087
36;Pontevedra;039;Porriño (O);15823;7613;8210
36;Pontevedra;040;Portas;3215;1507;1708
36;Pontevedra;045;Redondela;28943;14036;14907
36;Pontevedra;046;Ribadumia;4214;2059;2155
36;Pontevedra;047;Rodeiro;4396;2257;2139
36;Pontevedra;048;Rosal (O);5807;2792;3015
36;Pontevedra;049;Salceda de Caselas;6019;2942;3077
36;Pontevedra;050;Salvaterra de Miño;8453;4043;4410
36;Pontevedra;051;Sanxenxo;16022;7875;8147
36;Pontevedra;052;Silleda;9297;4454;4843
36;Pontevedra;053;Soutomaior;5330;2575;2755
36;Pontevedra;054;Tomiño;10705;5235;5470
36;Pontevedra;055;Tui;15827;7549;8278
36;Pontevedra;056;Valga;6288;3060;3228
36;Pontevedra;057;Vigo;283670;134490;149180
36;Pontevedra;059;Vila de Cruces;7219;3528;3691
36;Pontevedra;058;Vilaboa;5761;2832;2929
36;Pontevedra;060;Vilagarcía de Arousa;33909;16356;17553
36;Pontevedra;061;Vilanova de Arousa;10277;4985;5292
37;Salamanca;001;Abusejo;269;131;138
37;Salamanca;002;Agallas;194;98;96
37;Salamanca;003;Ahigal de los Aceiteros;206;106;100
37;Salamanca;004;Ahigal de Villarino;47;24;23
37;Salamanca;005;Alameda de Gardón (La);171;80;91
37;Salamanca;006;Alamedilla (La);215;111;104
37;Salamanca;007;Alaraz;668;346;322
37;Salamanca;008;Alba de Tormes;4567;2250;2317
37;Salamanca;009;Alba de Yeltes;296;142;154
37;Salamanca;010;Alberca (La);1108;575;533
37;Salamanca;011;Alberguería de Argañán (La);206;105;101
37;Salamanca;012;Alconada;227;111;116
37;Salamanca;015;Aldea del Obispo;410;212;198
37;Salamanca;013;Aldeacipreste;238;129;109
37;Salamanca;014;Aldeadávila de la Ribera;1907;969;938
37;Salamanca;016;Aldealengua;565;291;274
37;Salamanca;017;Aldeanueva de Figueroa;348;180;168
37;Salamanca;018;Aldeanueva de la Sierra;107;51;56
37;Salamanca;019;Aldearrodrigo;216;108;108
37;Salamanca;020;Aldearrubia;536;291;245
37;Salamanca;021;Aldeaseca de Alba;138;67;71
37;Salamanca;022;Aldeaseca de la Frontera;369;183;186
37;Salamanca;023;Aldeatejada;625;308;317
37;Salamanca;024;Aldeavieja de Tormes;140;70;70
37;Salamanca;025;Aldehuela de la Bóveda;387;190;197
37;Salamanca;026;Aldehuela de Yeltes;333;170;163
37;Salamanca;027;Almenara de Tormes;247;124;123
37;Salamanca;028;Almendra;193;97;96
37;Salamanca;029;Anaya de Alba;330;182;148
37;Salamanca;030;Añover de Tormes;109;59;50
37;Salamanca;031;Arabayona de Mógica;537;289;248
37;Salamanca;032;Arapiles;525;264;261
37;Salamanca;033;Arcediano;113;57;56
37;Salamanca;034;Arco (El);103;55;48
37;Salamanca;035;Armenteros;377;183;194
37;Salamanca;037;Atalaya (La);156;84;72
37;Salamanca;038;Babilafuente;1008;529;479
37;Salamanca;039;Bañobárez;453;230;223
37;Salamanca;040;Barbadillo;567;269;298
37;Salamanca;041;Barbalos;115;62;53
37;Salamanca;042;Barceo;73;39;34
37;Salamanca;044;Barruecopardo;593;300;293
37;Salamanca;045;Bastida (La);41;22;19
37;Salamanca;046;Béjar;16025;7615;8410
37;Salamanca;047;Beleña;172;86;86
37;Salamanca;049;Bermellar;222;108;114
37;Salamanca;050;Berrocal de Huebra;128;62;66
37;Salamanca;051;Berrocal de Salvatierra;145;69;76
37;Salamanca;052;Boada;447;228;219
37;Salamanca;054;Bodón (El);337;172;165
37;Salamanca;055;Bogajo;212;112;100
37;Salamanca;056;Bouza (La);67;32;35
37;Salamanca;057;Bóveda del Río Almar;315;168;147
37;Salamanca;058;Brincones;113;55;58
37;Salamanca;059;Buenamadre;174;91;83
37;Salamanca;060;Buenavista;89;48;41
37;Salamanca;061;Cabaco (El);293;145;148
37;Salamanca;063;Cabeza de Béjar (La);113;57;56
37;Salamanca;065;Cabeza del Caballo;490;254;236
37;Salamanca;062;Cabezabellosa de la Calzada;143;73;70
37;Salamanca;067;Cabrerizos;1775;891;884
37;Salamanca;068;Cabrillas;550;258;292
37;Salamanca;069;Calvarrasa de Abajo;1005;501;504
37;Salamanca;070;Calvarrasa de Arriba;681;355;326
37;Salamanca;071;Calzada de Béjar (La);104;54;50
37;Salamanca;072;Calzada de Don Diego;261;134;127
37;Salamanca;073;Calzada de Valdunciel;652;322;330
37;Salamanca;074;Campillo de Azaba;266;133;133
37;Salamanca;077;Campo de Peñaranda (El);408;208;200
37;Salamanca;078;Candelario;1121;547;574
37;Salamanca;079;Canillas de Abajo;125;71;54
37;Salamanca;080;Cantagallo;295;142;153
37;Salamanca;081;Cantalapiedra;1355;668;687
37;Salamanca;082;Cantalpino;1179;637;542
37;Salamanca;083;Cantaracillo;276;142;134
37;Salamanca;085;Carbajosa de la Sagrada;1530;771;759
37;Salamanca;086;Carpio de Azaba;112;58;54
37;Salamanca;087;Carrascal de Barregas;453;235;218
37;Salamanca;088;Carrascal del Obispo;259;125;134
37;Salamanca;089;Casafranca;85;39;46
37;Salamanca;090;Casas del Conde (Las);86;40;46
37;Salamanca;091;Casillas de Flores;275;127;148
37;Salamanca;092;Castellanos de Moriscos;363;173;190
37;Salamanca;185;Castellanos de Villiquera;595;312;283
37;Salamanca;096;Castillejo de Martín Viejo;405;211;194
37;Salamanca;097;Castraz;65;39;26
37;Salamanca;098;Cepeda;535;256;279
37;Salamanca;099;Cereceda de la Sierra;108;54;54
37;Salamanca;100;Cerezal de Peñahorcada;137;74;63
37;Salamanca;101;Cerralbo;296;156;140
37;Salamanca;102;Cerro (El);570;298;272
37;Salamanca;103;Cespedosa de Tormes;667;350;317
37;Salamanca;114;Chagarcía Medianero;150;80;70
37;Salamanca;104;Cilleros de la Bastida;45;21;24
37;Salamanca;106;Cipérez;448;221;227
37;Salamanca;107;Ciudad Rodrigo;14502;6952;7550
37;Salamanca;108;Coca de Alba;160;71;89
37;Salamanca;109;Colmenar de Montemayor;280;157;123
37;Salamanca;110;Cordovilla;150;85;65
37;Salamanca;112;Cristóbal;237;123;114
37;Salamanca;113;Cubo de Don Sancho (El);591;315;276
37;Salamanca;115;Dios le Guarde;168;95;73
37;Salamanca;116;Doñinos de Ledesma;108;57;51
37;Salamanca;117;Doñinos de Salamanca;720;376;344
37;Salamanca;118;Ejeme;200;109;91
37;Salamanca;120;Encina de San Silvestre;129;65;64
37;Salamanca;119;Encina (La);214;115;99
37;Salamanca;121;Encinas de Abajo;683;357;326
37;Salamanca;122;Encinas de Arriba;293;140;153
37;Salamanca;123;Encinasola de los Comendadores;301;153;148
37;Salamanca;124;Endrinal;307;169;138
37;Salamanca;125;Escurial de la Sierra;299;152;147
37;Salamanca;126;Espadaña;51;27;24
37;Salamanca;127;Espeja;289;149;140
37;Salamanca;128;Espino de la Orbada;383;194;189
37;Salamanca;129;Florida de Liébana;254;137;117
37;Salamanca;130;Forfoleda;251;124;127
37;Salamanca;131;Frades de la Sierra;285;148;137
37;Salamanca;132;Fregeneda (La);555;267;288
37;Salamanca;133;Fresnedoso;124;54;70
37;Salamanca;134;Fresno Alhándiga;330;177;153
37;Salamanca;135;Fuente de San Esteban (La);1572;797;775
37;Salamanca;136;Fuenteguinaldo;964;488;476
37;Salamanca;137;Fuenteliante;154;70;84
37;Salamanca;138;Fuenterroble de Salvatierra;279;140;139
37;Salamanca;139;Fuentes de Béjar;305;128;177
37;Salamanca;140;Fuentes de Oñoro;1453;702;751
37;Salamanca;141;Gajates;265;132;133
37;Salamanca;142;Galindo y Perahuy;345;186;159
37;Salamanca;143;Galinduste;648;320;328
37;Salamanca;144;Galisancho;590;330;260
37;Salamanca;145;Gallegos de Argañán;417;216;201
37;Salamanca;146;Gallegos de Solmirón;206;99;107
37;Salamanca;147;Garcibuey;295;166;129
37;Salamanca;148;Garcihernández;606;324;282
37;Salamanca;149;Garcirrey;112;56;56
37;Salamanca;150;Gejuelo del Barro;52;28;24
37;Salamanca;151;Golpejas;227;112;115
37;Salamanca;152;Gomecello;536;275;261
37;Salamanca;154;Guadramiro;230;134;96
37;Salamanca;155;Guijo de Ávila;116;63;53
37;Salamanca;156;Guijuelo;5092;2528;2564
37;Salamanca;157;Herguijuela de Ciudad Rodrigo;153;80;73
37;Salamanca;158;Herguijuela de la Sierra;333;166;167
37;Salamanca;159;Herguijuela del Campo;126;57;69
37;Salamanca;160;Hinojosa de Duero;856;426;430
37;Salamanca;161;Horcajo de Montemayor;210;105;105
37;Salamanca;162;Horcajo Medianero;381;186;195
37;Salamanca;163;Hoya (La);24;18;6
37;Salamanca;164;Huerta;276;145;131
37;Salamanca;165;Iruelos;67;28;39
37;Salamanca;166;Ituero de Azaba;300;162;138
37;Salamanca;167;Juzbado;194;101;93
37;Salamanca;168;Lagunilla;638;339;299
37;Salamanca;169;Larrodrigo;313;165;148
37;Salamanca;170;Ledesma;1942;945;997
37;Salamanca;171;Ledrada;611;310;301
37;Salamanca;172;Linares de Riofrío;1062;537;525
37;Salamanca;173;Lumbrales;2268;1131;1137
37;Salamanca;175;Machacón;535;274;261
37;Salamanca;174;Macotera;1709;863;846
37;Salamanca;176;Madroñal;184;100;84
37;Salamanca;177;Maíllo (El);453;229;224
37;Salamanca;178;Malpartida;181;101;80
37;Salamanca;179;Mancera de Abajo;368;186;182
37;Salamanca;180;Manzano (El);98;53;45
37;Salamanca;181;Martiago;382;201;181
37;Salamanca;183;Martín de Yeltes;574;294;280
37;Salamanca;182;Martinamor;82;44;38
37;Salamanca;184;Masueco;538;267;271
37;Salamanca;186;Mata de Ledesma (La);150;74;76
37;Salamanca;187;Matilla de los Caños del Río;712;371;341
37;Salamanca;188;Maya (La);263;143;120
37;Salamanca;189;Membribe de la Sierra;94;51;43
37;Salamanca;190;Mieza;363;185;178
37;Salamanca;191;Milano (El);188;101;87
37;Salamanca;192;Miranda de Azán;314;147;167
37;Salamanca;193;Miranda del Castañar;740;394;346
37;Salamanca;194;Mogarraz;365;172;193
37;Salamanca;195;Molinillo;107;50;57
37;Salamanca;196;Monforte de la Sierra;126;72;54
37;Salamanca;197;Monleón;135;78;57
37;Salamanca;198;Monleras;272;137;135
37;Salamanca;199;Monsagro;235;133;102
37;Salamanca;200;Montejo;251;138;113
37;Salamanca;201;Montemayor del Río;382;204;178
37;Salamanca;202;Monterrubio de Armuña;442;228;214
37;Salamanca;203;Monterrubio de la Sierra;164;88;76
37;Salamanca;204;Morasverdes;441;220;221
37;Salamanca;205;Morille;185;101;84
37;Salamanca;206;Moríñigo;143;73;70
37;Salamanca;207;Moriscos;138;68;70
37;Salamanca;208;Moronta;135;73;62
37;Salamanca;209;Mozárbez;388;199;189
37;Salamanca;211;Narros de Matalayegua;309;166;143
37;Salamanca;213;Nava de Béjar;124;64;60
37;Salamanca;214;Nava de Francia;151;79;72
37;Salamanca;215;Nava de Sotrobal;226;119;107
37;Salamanca;212;Navacarros;124;67;57
37;Salamanca;216;Navales;404;228;176
37;Salamanca;217;Navalmoral de Béjar;77;35;42
37;Salamanca;218;Navamorales;185;102;83
37;Salamanca;219;Navarredonda de la Rinconada;267;129;138
37;Salamanca;221;Navasfrías;720;355;365
37;Salamanca;222;Negrilla de Palencia;131;61;70
37;Salamanca;223;Olmedo de Camaces;182;88;94
37;Salamanca;224;Orbada (La);284;150;134
37;Salamanca;225;Pajares de la Laguna;146;73;73
37;Salamanca;226;Palacios del Arzobispo;241;123;118
37;Salamanca;228;Palaciosrubios;562;301;261
37;Salamanca;229;Palencia de Negrilla;203;102;101
37;Salamanca;230;Parada de Arriba;250;136;114
37;Salamanca;231;Parada de Rubiales;353;185;168
37;Salamanca;232;Paradinas de San Juan;650;347;303
37;Salamanca;233;Pastores;58;31;27
37;Salamanca;234;Payo (El);505;241;264
37;Salamanca;235;Pedraza de Alba;294;154;140
37;Salamanca;236;Pedrosillo de Alba;274;137;137
37;Salamanca;237;Pedrosillo de los Aires;446;239;207
37;Salamanca;238;Pedrosillo el Ralo;154;79;75
37;Salamanca;239;Pedroso de la Armuña (El);320;157;163
37;Salamanca;240;Pelabravo;785;405;380
37;Salamanca;241;Pelarrodríguez;203;116;87
37;Salamanca;242;Pelayos;76;39;37
37;Salamanca;243;Peña (La);163;74;89
37;Salamanca;244;Peñacaballera;215;100;115
37;Salamanca;245;Peñaparda;533;259;274
37;Salamanca;246;Peñaranda de Bracamonte;6282;3065;3217
37;Salamanca;247;Peñarandilla;282;141;141
37;Salamanca;248;Peralejos de Abajo;200;94;106
37;Salamanca;249;Peralejos de Arriba;73;41;32
37;Salamanca;250;Pereña de la Ribera;571;284;287
37;Salamanca;251;Peromingo;166;79;87
37;Salamanca;252;Pinedas;195;102;93
37;Salamanca;253;Pino de Tormes (El);180;90;90
37;Salamanca;254;Pitiegua;270;136;134
37;Salamanca;255;Pizarral;102;52;50
37;Salamanca;256;Poveda de las Cintas;350;191;159
37;Salamanca;257;Pozos de Hinojo;82;44;38
37;Salamanca;258;Puebla de Azaba;290;149;141
37;Salamanca;259;Puebla de San Medel;72;38;34
37;Salamanca;260;Puebla de Yeltes;251;135;116
37;Salamanca;261;Puente del Congosto;350;174;176
37;Salamanca;262;Puertas;105;57;48
37;Salamanca;263;Puerto de Béjar;500;234;266
37;Salamanca;264;Puerto Seguro;115;58;57
37;Salamanca;265;Rágama;313;165;148
37;Salamanca;266;Redonda (La);119;56;63
37;Salamanca;267;Retortillo;247;115;132
37;Salamanca;268;Rinconada de la Sierra (La);168;84;84
37;Salamanca;269;Robleda;580;310;270
37;Salamanca;270;Robliza de Cojos;213;111;102
37;Salamanca;271;Rollán;624;316;308
37;Salamanca;272;Saelices el Chico;185;99;86
37;Salamanca;273;Sagrada (La);188;95;93
37;Salamanca;303;Sahugo (El);279;147;132
37;Salamanca;274;Salamanca;158720;74483;84237
37;Salamanca;275;Saldeana;186;100;86
37;Salamanca;276;Salmoral;342;168;174
37;Salamanca;277;Salvatierra de Tormes;62;28;34
37;Salamanca;278;San Cristóbal de la Cuesta;353;184;169
37;Salamanca;284;San Esteban de la Sierra;453;230;223
37;Salamanca;285;San Felices de los Gallegos;642;318;324
37;Salamanca;286;San Martín del Castañar;287;150;137
37;Salamanca;287;San Miguel de Valero;438;232;206
37;Salamanca;036;San Miguel del Robledo;103;48;55
37;Salamanca;288;San Morales;222;122;100
37;Salamanca;289;San Muñoz;368;186;182
37;Salamanca;291;San Pedro de Rozados;354;176;178
37;Salamanca;290;San Pedro del Valle;130;62;68
37;Salamanca;292;San Pelayo de Guareña;105;54;51
37;Salamanca;280;Sanchón de la Ribera;123;66;57
37;Salamanca;281;Sanchón de la Sagrada;55;30;25
37;Salamanca;282;Sanchotello;324;166;158
37;Salamanca;279;Sancti-Spíritus;1184;615;569
37;Salamanca;283;Sando;181;97;84
37;Salamanca;293;Santa María de Sando;188;98;90
37;Salamanca;294;Santa Marta de Tormes;10166;5081;5085
37;Salamanca;296;Santiago de la Puebla;558;285;273
37;Salamanca;297;Santibáñez de Béjar;683;341;342
37;Salamanca;298;Santibáñez de la Sierra;254;140;114
37;Salamanca;299;Santiz;280;142;138
37;Salamanca;300;Santos (Los);739;377;362
37;Salamanca;301;Sardón de los Frailes;105;55;50
37;Salamanca;302;Saucelle;441;218;223
37;Salamanca;304;Sepulcro-Hilario;301;155;146
37;Salamanca;305;Sequeros;272;118;154
37;Salamanca;306;Serradilla del Arroyo;440;221;219
37;Salamanca;307;Serradilla del Llano;265;133;132
37;Salamanca;309;Sierpe (La);53;31;22
37;Salamanca;310;Sieteiglesias de Tormes;188;92;96
37;Salamanca;311;Sobradillo;359;171;188
37;Salamanca;312;Sorihuela;383;188;195
37;Salamanca;313;Sotoserrano;739;384;355
37;Salamanca;314;Tabera de Abajo;111;58;53
37;Salamanca;315;Tala (La);140;73;67
37;Salamanca;316;Tamames;1010;514;496
37;Salamanca;317;Tarazona de Guareña;431;230;201
37;Salamanca;318;Tardáguila;265;141;124
37;Salamanca;319;Tejado (El);179;87;92
37;Salamanca;320;Tejeda y Segoyuela;124;63;61
37;Salamanca;321;Tenebrón;230;117;113
37;Salamanca;322;Terradillos;3037;1546;1491
37;Salamanca;323;Topas;707;356;351
37;Salamanca;324;Tordillos;580;298;282
37;Salamanca;325;Tornadizo (El);144;75;69
37;Salamanca;327;Torresmenudas;242;115;127
37;Salamanca;328;Trabanca;252;128;124
37;Salamanca;329;Tremedal de Tormes;47;24;23
37;Salamanca;330;Valdecarros;462;236;226
37;Salamanca;331;Valdefuentes de Sangusín;323;162;161
37;Salamanca;332;Valdehijaderos;119;65;54
37;Salamanca;333;Valdelacasa;360;194;166
37;Salamanca;334;Valdelageve;131;71;60
37;Salamanca;335;Valdelosa;480;227;253
37;Salamanca;336;Valdemierque;76;38;38
37;Salamanca;337;Valderrodrigo;184;89;95
37;Salamanca;338;Valdunciel;122;58;64
37;Salamanca;339;Valero;453;222;231
37;Salamanca;343;Vallejera de Riofrío;54;26;28
37;Salamanca;340;Valsalabroso;249;134;115
37;Salamanca;341;Valverde de Valdelacasa;79;39;40
37;Salamanca;342;Valverdón;272;142;130
37;Salamanca;344;Vecinos;299;148;151
37;Salamanca;345;Vega de Tirados;226;116;110
37;Salamanca;346;Veguillas (Las);303;150;153
37;Salamanca;347;Vellés (La);457;229;228
37;Salamanca;348;Ventosa del Río Almar;167;81;86
37;Salamanca;349;Vídola (La);187;95;92
37;Salamanca;351;Villaflores;468;231;237
37;Salamanca;352;Villagonzalo de Tormes;240;125;115
37;Salamanca;353;Villalba de los Llanos;194;107;87
37;Salamanca;354;Villamayor;2765;1446;1319
37;Salamanca;355;Villanueva del Conde;257;135;122
37;Salamanca;356;Villar de Argañán;120;60;60
37;Salamanca;357;Villar de Ciervo;409;211;198
37;Salamanca;358;Villar de Gallimazo;215;105;110
37;Salamanca;359;Villar de la Yegua;307;143;164
37;Salamanca;360;Villar de Peralonso;349;162;187
37;Salamanca;361;Villar de Samaniego;144;78;66
37;Salamanca;362;Villares de la Reina;2722;1382;1340
37;Salamanca;363;Villares de Yeltes;173;79;94
37;Salamanca;364;Villarino de los Aires;1082;532;550
37;Salamanca;365;Villarmayor;235;125;110
37;Salamanca;366;Villarmuerto;62;35;27
37;Salamanca;367;Villasbuenas;321;164;157
37;Salamanca;368;Villasdardo;25;11;14
37;Salamanca;369;Villaseco de los Gamitos;213;109;104
37;Salamanca;370;Villaseco de los Reyes;460;237;223
37;Salamanca;371;Villasrubias;375;202;173
37;Salamanca;372;Villaverde de Guareña;200;98;102
37;Salamanca;373;Villavieja de Yeltes;1114;555;559
37;Salamanca;374;Villoria;1417;709;708
37;Salamanca;375;Villoruela;1022;508;514
37;Salamanca;350;Vilvestre;633;307;326
37;Salamanca;376;Vitigudino;3132;1544;1588
37;Salamanca;377;Yecla de Yeltes;363;177;186
37;Salamanca;378;Zamarra;162;85;77
37;Salamanca;379;Zamayón;211;120;91
37;Salamanca;380;Zarapicos;67;37;30
37;Salamanca;381;Zarza de Pumareda (La);199;111;88
37;Salamanca;382;Zorita de la Frontera;283;156;127
38;Santa Cruz de Tenerife;001;Adeje;13605;6833;6772
38;Santa Cruz de Tenerife;002;Agulo;1100;547;553
38;Santa Cruz de Tenerife;003;Alajeró;1267;670;597
38;Santa Cruz de Tenerife;004;Arafo;4669;2254;2415
38;Santa Cruz de Tenerife;005;Arico;5115;2620;2495
38;Santa Cruz de Tenerife;006;Arona;29792;14994;14798
38;Santa Cruz de Tenerife;007;Barlovento;2403;1203;1200
38;Santa Cruz de Tenerife;008;Breña Alta;5866;2895;2971
38;Santa Cruz de Tenerife;009;Breña Baja;3737;1850;1887
38;Santa Cruz de Tenerife;010;Buenavista del Norte;5469;2782;2687
38;Santa Cruz de Tenerife;011;Candelaria;13356;6645;6711
38;Santa Cruz de Tenerife;012;Fasnia;2496;1279;1217
38;Santa Cruz de Tenerife;013;Frontera;4493;2273;2220
38;Santa Cruz de Tenerife;014;Fuencaliente de la Palma;1767;902;865
38;Santa Cruz de Tenerife;015;Garachico;5499;2695;2804
38;Santa Cruz de Tenerife;016;Garafía;2020;1020;1000
38;Santa Cruz de Tenerife;017;Granadilla de Abona;19253;9632;9621
38;Santa Cruz de Tenerife;018;Guancha (La);5244;2609;2635
38;Santa Cruz de Tenerife;019;Guía de Isora;13761;6790;6971
38;Santa Cruz de Tenerife;020;Güímar;14306;7021;7285
38;Santa Cruz de Tenerife;021;Hermigua;2106;1077;1029
38;Santa Cruz de Tenerife;022;Icod de los Vinos;22079;10833;11246
38;Santa Cruz de Tenerife;024;Llanos de Aridane (Los);17910;8829;9081
38;Santa Cruz de Tenerife;025;Matanza de Acentejo (La);6940;3528;3412
38;Santa Cruz de Tenerife;026;Orotava (La);35775;17707;18068
38;Santa Cruz de Tenerife;027;Paso (El);7268;3693;3575
38;Santa Cruz de Tenerife;901;Pinar de el Hierro (El);"";"";""
38;Santa Cruz de Tenerife;028;Puerto de la Cruz;24050;11713;12337
38;Santa Cruz de Tenerife;029;Puntagorda;1785;879;906
38;Santa Cruz de Tenerife;030;Puntallana;2205;1083;1122
38;Santa Cruz de Tenerife;031;Realejos (Los);33575;16613;16962
38;Santa Cruz de Tenerife;032;Rosario (El);11544;5780;5764
38;Santa Cruz de Tenerife;033;San Andrés y Sauces;5339;2696;2643
38;Santa Cruz de Tenerife;023;San Cristóbal de La Laguna;127945;62703;65242
38;Santa Cruz de Tenerife;034;San Juan de la Rambla;4645;2297;2348
38;Santa Cruz de Tenerife;035;San Miguel de Abona;6645;3347;3298
38;Santa Cruz de Tenerife;036;San Sebastián de la Gomera;6274;3162;3112
38;Santa Cruz de Tenerife;037;Santa Cruz de la Palma;18337;8967;9370
38;Santa Cruz de Tenerife;038;Santa Cruz de Tenerife;213050;102571;110479
38;Santa Cruz de Tenerife;039;Santa Úrsula;10186;5099;5087
38;Santa Cruz de Tenerife;040;Santiago del Teide;8454;4305;4149
38;Santa Cruz de Tenerife;041;Sauzal (El);7474;3731;3743
38;Santa Cruz de Tenerife;042;Silos (Los);5230;2589;2641
38;Santa Cruz de Tenerife;043;Tacoronte;20349;10203;10146
38;Santa Cruz de Tenerife;044;Tanque (El);3242;1623;1619
38;Santa Cruz de Tenerife;045;Tazacorte;6500;3244;3256
38;Santa Cruz de Tenerife;046;Tegueste;8853;4395;4458
38;Santa Cruz de Tenerife;047;Tijarafe;2637;1341;1296
38;Santa Cruz de Tenerife;049;Valle Gran Rey;3713;1896;1817
38;Santa Cruz de Tenerife;050;Vallehermoso;2693;1355;1338
38;Santa Cruz de Tenerife;048;Valverde;3589;1772;1817
38;Santa Cruz de Tenerife;051;Victoria de Acentejo (La);8122;4044;4078
38;Santa Cruz de Tenerife;052;Vilaflor;1643;832;811
38;Santa Cruz de Tenerife;053;Villa de Mazo;4645;2340;2305
39;Cantabria;001;Alfoz de Lloredo;2608;1332;1276
39;Cantabria;002;Ampuero;3497;1768;1729
39;Cantabria;003;Anievas;398;202;196
39;Cantabria;004;Arenas de Iguña;2045;1022;1023
39;Cantabria;005;Argoños;811;411;400
39;Cantabria;006;Arnuero;1787;899;888
39;Cantabria;007;Arredondo;639;352;287
39;Cantabria;008;Astillero (El);13263;6389;6874
39;Cantabria;009;Bárcena de Cicero;2252;1129;1123
39;Cantabria;010;Bárcena de Pie de Concha;941;457;484
39;Cantabria;011;Bareyo;1714;875;839
39;Cantabria;012;Cabezón de la Sal;6988;3450;3538
39;Cantabria;013;Cabezón de Liébana;702;387;315
39;Cantabria;014;Cabuérniga;1110;560;550
39;Cantabria;015;Camaleño;1101;577;524
39;Cantabria;016;Camargo;22535;11037;11498
39;Cantabria;027;Campoo de Enmedio;3897;1973;1924
39;Cantabria;017;Campoo de Yuso;730;362;368
39;Cantabria;018;Cartes;3243;1619;1624
39;Cantabria;019;Castañeda;1481;732;749
39;Cantabria;020;Castro-Urdiales;16795;8388;8407
39;Cantabria;021;Cieza;690;336;354
39;Cantabria;022;Cillorigo de Liébana;1111;597;514
39;Cantabria;023;Colindres;6420;3249;3171
39;Cantabria;024;Comillas;2360;1115;1245
39;Cantabria;025;Corrales de Buelna (Los);10657;5330;5327
39;Cantabria;026;Corvera de Toranzo;2102;1054;1048
39;Cantabria;028;Entrambasaguas;2476;1238;1238
39;Cantabria;029;Escalante;750;388;362
39;Cantabria;030;Guriezo;1717;896;821
39;Cantabria;031;Hazas de Cesto;1261;637;624
39;Cantabria;032;Hermandad de Campoo de Suso;1863;1003;860
39;Cantabria;033;Herrerías;798;435;363
39;Cantabria;034;Lamasón;402;225;177
39;Cantabria;035;Laredo;13155;6379;6776
39;Cantabria;036;Liendo;843;440;403
39;Cantabria;037;Liérganes;2268;1112;1156
39;Cantabria;038;Limpias;1311;660;651
39;Cantabria;039;Luena;985;519;466
39;Cantabria;040;Marina de Cudeyo;4597;2288;2309
39;Cantabria;041;Mazcuerras;1870;992;878
39;Cantabria;042;Medio Cudeyo;6093;2986;3107
39;Cantabria;043;Meruelo;1081;541;540
39;Cantabria;044;Miengo;3363;1668;1695
39;Cantabria;045;Miera;543;272;271
39;Cantabria;046;Molledo;1955;941;1014
39;Cantabria;047;Noja;1981;993;988
39;Cantabria;048;Penagos;1635;813;822
39;Cantabria;049;Peñarrubia;284;140;144
39;Cantabria;050;Pesaguero;405;217;188
39;Cantabria;051;Pesquera;95;48;47
39;Cantabria;052;Piélagos;11181;5534;5647
39;Cantabria;053;Polaciones;292;175;117
39;Cantabria;054;Polanco;3586;1743;1843
39;Cantabria;055;Potes;1564;767;797
39;Cantabria;056;Puente Viesgo;2378;1182;1196
39;Cantabria;057;Ramales de la Victoria;2253;1166;1087
39;Cantabria;058;Rasines;960;493;467
39;Cantabria;059;Reinosa;11518;5575;5943
39;Cantabria;060;Reocín;6867;3417;3450
39;Cantabria;061;Ribamontán al Mar;3525;1796;1729
39;Cantabria;062;Ribamontán al Monte;1985;1014;971
39;Cantabria;063;Rionansa;1471;815;656
39;Cantabria;064;Riotuerto;1520;727;793
39;Cantabria;065;Rozas de Valdearroyo (Las);322;174;148
39;Cantabria;066;Ruente;966;515;451
39;Cantabria;067;Ruesga;1246;639;607
39;Cantabria;068;Ruiloba;701;355;346
39;Cantabria;069;San Felices de Buelna;2176;1047;1129
39;Cantabria;070;San Miguel de Aguayo;160;85;75
39;Cantabria;071;San Pedro del Romeral;657;339;318
39;Cantabria;072;San Roque de Riomiera;536;303;233
39;Cantabria;080;San Vicente de la Barquera;4392;2243;2149
39;Cantabria;073;Santa Cruz de Bezana;7617;3770;3847
39;Cantabria;074;Santa María de Cayón;6324;3170;3154
39;Cantabria;075;Santander;184165;86385;97780
39;Cantabria;076;Santillana del Mar;3865;1901;1964
39;Cantabria;077;Santiurde de Reinosa;334;180;154
39;Cantabria;078;Santiurde de Toranzo;1651;833;818
39;Cantabria;079;Santoña;11657;5948;5709
39;Cantabria;081;Saro;530;267;263
39;Cantabria;082;Selaya;2004;1019;985
39;Cantabria;083;Soba;1699;893;806
39;Cantabria;084;Solórzano;1003;513;490
39;Cantabria;085;Suances;6331;3124;3207
39;Cantabria;086;Tojos (Los);397;217;180
39;Cantabria;087;Torrelavega;57070;27483;29587
39;Cantabria;088;Tresviso;60;35;25
39;Cantabria;089;Tudanca;264;159;105
39;Cantabria;090;Udías;841;424;417
39;Cantabria;095;Val de San Vicente;2556;1304;1252
39;Cantabria;091;Valdáliga;2570;1320;1250
39;Cantabria;092;Valdeolea;1517;775;742
39;Cantabria;093;Valdeprado del Río;297;154;143
39;Cantabria;094;Valderredible;1236;650;586
39;Cantabria;096;Vega de Liébana;1016;550;466
39;Cantabria;097;Vega de Pas;1011;523;488
39;Cantabria;098;Villacarriedo;1764;919;845
39;Cantabria;099;Villaescusa;3113;1517;1596
39;Cantabria;100;Villafufre;1121;582;539
39;Cantabria;101;Villaverde de Trucíos;371;192;179
39;Cantabria;102;Voto;2230;1151;1079
40;Segovia;001;Abades;860;432;428
40;Segovia;002;Adrada de Pirón;57;33;24
40;Segovia;003;Adrados;219;112;107
40;Segovia;004;Aguilafuente;802;386;416
40;Segovia;005;Alconada de Maderuelo;55;32;23
40;Segovia;012;Aldea Real;401;214;187
40;Segovia;006;Aldealcorvo;32;16;16
40;Segovia;007;Aldealengua de Pedraza;94;52;42
40;Segovia;008;Aldealengua de Santa María;88;46;42
40;Segovia;009;Aldeanueva de la Serrezuela;51;31;20
40;Segovia;010;Aldeanueva del Codonal;219;114;105
40;Segovia;013;Aldeasoña;111;51;60
40;Segovia;014;Aldehorno;84;43;41
40;Segovia;015;Aldehuela del Codonal;54;26;28
40;Segovia;016;Aldeonte;91;45;46
40;Segovia;017;Anaya;135;69;66
40;Segovia;018;Añe;118;64;54
40;Segovia;019;Arahuetes;43;24;19
40;Segovia;020;Arcones;250;136;114
40;Segovia;021;Arevalillo de Cega;45;23;22
40;Segovia;022;Armuña;269;148;121
40;Segovia;024;Ayllón;1192;603;589
40;Segovia;025;Barbolla;225;121;104
40;Segovia;026;Basardilla;100;49;51
40;Segovia;028;Bercial;133;63;70
40;Segovia;029;Bercimuel;89;41;48
40;Segovia;030;Bernardos;739;372;367
40;Segovia;031;Bernuy de Porreros;325;169;156
40;Segovia;032;Boceguillas;549;278;271
40;Segovia;033;Brieva;70;44;26
40;Segovia;034;Caballar;101;48;53
40;Segovia;035;Cabañas de Polendos;119;61;58
40;Segovia;036;Cabezuela;746;395;351
40;Segovia;037;Calabazas de Fuentidueña;78;38;40
40;Segovia;039;Campo de San Pedro;399;226;173
40;Segovia;040;Cantalejo;3424;1743;1681
40;Segovia;041;Cantimpalos;1285;656;629
40;Segovia;043;Carbonero el Mayor;2331;1184;1147
40;Segovia;044;Carrascal del Río;212;113;99
40;Segovia;045;Casla;151;78;73
40;Segovia;046;Castillejo de Mesleón;121;59;62
40;Segovia;047;Castro de Fuentidueña;92;50;42
40;Segovia;048;Castrojimeno;47;28;19
40;Segovia;049;Castroserna de Abajo;63;36;27
40;Segovia;051;Castroserracín;67;38;29
40;Segovia;052;Cedillo de la Torre;129;63;66
40;Segovia;053;Cerezo de Abajo;176;83;93
40;Segovia;054;Cerezo de Arriba;204;104;100
40;Segovia;065;Chañe;729;390;339
40;Segovia;055;Cilleruelo de San Mamés;52;24;28
40;Segovia;056;Cobos de Fuentidueña;69;29;40
40;Segovia;057;Coca;2002;986;1016
40;Segovia;058;Codorniz;486;234;252
40;Segovia;059;Collado Hermoso;151;69;82
40;Segovia;060;Condado de Castilnovo;131;71;60
40;Segovia;061;Corral de Ayllón;110;57;53
40;Segovia;902;Cozuelos de Fuentidueña;196;100;96
40;Segovia;062;Cubillo;57;35;22
40;Segovia;063;Cuéllar;9059;4612;4447
40;Segovia;905;Cuevas de Provanco;221;116;105
40;Segovia;068;Domingo García;45;22;23
40;Segovia;069;Donhierro;106;59;47
40;Segovia;070;Duruelo;135;71;64
40;Segovia;071;Encinas;72;34;38
40;Segovia;072;Encinillas;76;41;35
40;Segovia;073;Escalona del Prado;593;315;278
40;Segovia;074;Escarabajosa de Cabezas;379;199;180
40;Segovia;075;Escobar de Polendos;225;117;108
40;Segovia;076;Espinar (El);6087;3114;2973
40;Segovia;077;Espirdo;217;122;95
40;Segovia;078;Fresneda de Cuéllar;245;130;115
40;Segovia;079;Fresno de Cantespino;235;124;111
40;Segovia;080;Fresno de la Fuente;74;38;36
40;Segovia;081;Frumales;216;111;105
40;Segovia;082;Fuente de Santa Cruz;197;99;98
40;Segovia;083;Fuente el Olmo de Fuentidueña;152;76;76
40;Segovia;084;Fuente el Olmo de Íscar;111;60;51
40;Segovia;086;Fuentepelayo;974;492;482
40;Segovia;087;Fuentepiñel;192;96;96
40;Segovia;088;Fuenterrebollo;450;229;221
40;Segovia;089;Fuentesaúco de Fuentidueña;329;176;153
40;Segovia;091;Fuentesoto;170;91;79
40;Segovia;092;Fuentidueña;181;89;92
40;Segovia;093;Gallegos;111;57;54
40;Segovia;094;Garcillán;348;188;160
40;Segovia;095;Gomezserracín;662;338;324
40;Segovia;097;Grajera;98;53;45
40;Segovia;099;Honrubia de la Cuesta;78;33;45
40;Segovia;100;Hontalbilla;442;228;214
40;Segovia;101;Hontanares de Eresma;159;88;71
40;Segovia;103;Huertos (Los);162;76;86
40;Segovia;104;Ituero y Lama;93;54;39
40;Segovia;105;Juarros de Riomoros;71;38;33
40;Segovia;106;Juarros de Voltoya;305;158;147
40;Segovia;107;Labajos;161;91;70
40;Segovia;108;Laguna de Contreras;176;95;81
40;Segovia;109;Languilla;128;76;52
40;Segovia;110;Lastras de Cuéllar;570;308;262
40;Segovia;111;Lastras del Pozo;76;39;37
40;Segovia;112;Lastrilla (La);1567;778;789
40;Segovia;113;Losa (La);387;206;181
40;Segovia;115;Maderuelo;156;78;78
40;Segovia;903;Marazoleja;154;88;66
40;Segovia;118;Marazuela;85;44;41
40;Segovia;119;Martín Miguel;209;103;106
40;Segovia;120;Martín Muñoz de la Dehesa;190;102;88
40;Segovia;121;Martín Muñoz de las Posadas;508;251;257
40;Segovia;122;Marugán;288;149;139
40;Segovia;124;Mata de Cuéllar;330;184;146
40;Segovia;123;Matabuena;217;112;105
40;Segovia;125;Matilla (La);122;64;58
40;Segovia;126;Melque de Cercos;126;58;68
40;Segovia;127;Membibre de la Hoz;76;39;37
40;Segovia;128;Migueláñez;180;87;93
40;Segovia;129;Montejo de Arévalo;301;163;138
40;Segovia;130;Montejo de la Vega de la Serrezuela;194;103;91
40;Segovia;131;Monterrubio;67;35;32
40;Segovia;132;Moral de Hornuez;113;62;51
40;Segovia;134;Mozoncillo;1030;532;498
40;Segovia;135;Muñopedro;399;204;195
40;Segovia;136;Muñoveros;209;111;98
40;Segovia;138;Nava de la Asunción;2662;1357;1305
40;Segovia;139;Navafría;378;202;176
40;Segovia;140;Navalilla;161;77;84
40;Segovia;141;Navalmanzano;1146;594;552
40;Segovia;142;Navares de Ayuso;86;43;43
40;Segovia;143;Navares de Enmedio;164;89;75
40;Segovia;144;Navares de las Cuevas;23;12;11
40;Segovia;145;Navas de Oro;1462;740;722
40;Segovia;904;Navas de Riofrío;285;137;148
40;Segovia;146;Navas de San Antonio;285;149;136
40;Segovia;148;Nieva;374;196;178
40;Segovia;149;Olombrada;821;437;384
40;Segovia;150;Orejana;118;64;54
40;Segovia;151;Ortigosa de Pestaño;90;47;43
40;Segovia;901;Ortigosa del Monte;342;172;170
40;Segovia;152;Otero de Herreros;828;399;429
40;Segovia;154;Pajarejos;48;22;26
40;Segovia;155;Palazuelos de Eresma;2942;1492;1450
40;Segovia;156;Pedraza;464;244;220
40;Segovia;157;Pelayos del Arroyo;49;24;25
40;Segovia;158;Perosillo;33;21;12
40;Segovia;159;Pinarejos;199;113;86
40;Segovia;160;Pinarnegrillo;197;102;95
40;Segovia;161;Pradales;73;38;35
40;Segovia;162;Prádena;582;314;268
40;Segovia;163;Puebla de Pedraza;100;50;50
40;Segovia;164;Rapariegos;268;136;132
40;Segovia;165;Rebollo;138;75;63
40;Segovia;166;Remondo;365;172;193
40;Segovia;168;Riaguas de San Bartolomé;98;51;47
40;Segovia;170;Riaza;1686;899;787
40;Segovia;171;Ribota;34;21;13
40;Segovia;172;Riofrío de Riaza;51;27;24
40;Segovia;173;Roda de Eresma;112;55;57
40;Segovia;174;Sacramenia;581;300;281
40;Segovia;176;Samboal;603;309;294
40;Segovia;177;San Cristóbal de Cuéllar;235;116;119
40;Segovia;178;San Cristóbal de la Vega;165;81;84
40;Segovia;906;San Cristóbal de Segovia;"";"";""
40;Segovia;181;San Ildefonso;5156;2507;2649
40;Segovia;182;San Martín y Mudrián;291;150;141
40;Segovia;183;San Miguel de Bernuy;175;88;87
40;Segovia;184;San Pedro de Gaíllos;349;172;177
40;Segovia;179;Sanchonuño;742;365;377
40;Segovia;180;Sangarcía;457;237;220
40;Segovia;185;Santa María la Real de Nieva;1460;737;723
40;Segovia;186;Santa Marta del Cerro;52;27;25
40;Segovia;188;Santiuste de Pedraza;102;55;47
40;Segovia;189;Santiuste de San Juan Bautista;779;397;382
40;Segovia;190;Santo Domingo de Pirón;67;32;35
40;Segovia;191;Santo Tomé del Puerto;327;173;154
40;Segovia;192;Sauquillo de Cabezas;248;137;111
40;Segovia;193;Sebúlcor;280;150;130
40;Segovia;194;Segovia;54175;26032;28143
40;Segovia;195;Sepúlveda;1330;685;645
40;Segovia;196;Sequera de Fresno;53;27;26
40;Segovia;198;Sotillo;44;20;24
40;Segovia;199;Sotosalbos;114;63;51
40;Segovia;200;Tabanera la Luenga;72;39;33
40;Segovia;201;Tolocirio;67;30;37
40;Segovia;206;Torre Val de San Pedro;189;103;86
40;Segovia;202;Torreadrada;136;67;69
40;Segovia;203;Torrecaballeros;487;252;235
40;Segovia;204;Torrecilla del Pinar;323;158;165
40;Segovia;205;Torreiglesias;388;201;187
40;Segovia;207;Trescasas;298;153;145
40;Segovia;208;Turégano;1113;556;557
40;Segovia;210;Urueñas;120;66;54
40;Segovia;211;Valdeprados;63;30;33
40;Segovia;212;Valdevacas de Montejo;36;22;14
40;Segovia;213;Valdevacas y Guijar;142;75;67
40;Segovia;218;Valle de Tabladillo;167;85;82
40;Segovia;219;Vallelado;851;431;420
40;Segovia;220;Valleruela de Pedraza;77;42;35
40;Segovia;221;Valleruela de Sepúlveda;77;36;41
40;Segovia;214;Valseca;299;156;143
40;Segovia;215;Valtiendas;199;111;88
40;Segovia;216;Valverde del Majano;505;260;245
40;Segovia;222;Veganzones;290;145;145
40;Segovia;223;Vegas de Matute;246;139;107
40;Segovia;224;Ventosilla y Tejadilla;28;19;9
40;Segovia;225;Villacastín;1537;773;764
40;Segovia;228;Villaverde de Íscar;732;373;359
40;Segovia;229;Villaverde de Montejo;68;35;33
40;Segovia;230;Villeguillo;180;96;84
40;Segovia;231;Yanguas de Eresma;188;93;95
40;Segovia;233;Zarzuela del Monte;534;268;266
40;Segovia;234;Zarzuela del Pinar;607;320;287
41;Sevilla;001;Aguadulce;1953;983;970
41;Sevilla;002;Alanís;2038;1022;1016
41;Sevilla;003;Albaida del Aljarafe;1819;920;899
41;Sevilla;004;Alcalá de Guadaira;56743;28164;28579
41;Sevilla;005;Alcalá del Río;9265;4696;4569
41;Sevilla;006;Alcolea del Río;3350;1639;1711
41;Sevilla;007;Algaba (La);12785;6443;6342
41;Sevilla;008;Algámitas;1382;721;661
41;Sevilla;009;Almadén de la Plata;1728;867;861
41;Sevilla;010;Almensilla;2884;1474;1410
41;Sevilla;011;Arahal;18431;9124;9307
41;Sevilla;012;Aznalcázar;3490;1762;1728
41;Sevilla;013;Aznalcóllar;5804;2959;2845
41;Sevilla;014;Badolatosa;3124;1621;1503
41;Sevilla;015;Benacazón;5033;2552;2481
41;Sevilla;016;Bollullos de la Mitación;5012;2521;2491
41;Sevilla;017;Bormujos;8223;4117;4106
41;Sevilla;018;Brenes;10597;5317;5280
41;Sevilla;019;Burguillos;3498;1753;1745
41;Sevilla;020;Cabezas de San Juan (Las);15660;8082;7578
41;Sevilla;021;Camas;25499;12416;13083
41;Sevilla;022;Campana (La);5212;2632;2580
41;Sevilla;023;Cantillana;8959;4520;4439
41;Sevilla;901;Cañada Rosal;3036;1499;1537
41;Sevilla;024;Carmona;25403;12813;12590
41;Sevilla;025;Carrión de los Céspedes;2306;1097;1209
41;Sevilla;026;Casariche;5145;2600;2545
41;Sevilla;027;Castilblanco de los Arroyos;4403;2204;2199
41;Sevilla;028;Castilleja de Guzmán;1195;611;584
41;Sevilla;029;Castilleja de la Cuesta;15981;7843;8138
41;Sevilla;030;Castilleja del Campo;622;306;316
41;Sevilla;031;Castillo de las Guardas (El);1607;812;795
41;Sevilla;032;Cazalla de la Sierra;5198;2606;2592
41;Sevilla;033;Constantina;7246;3565;3681
41;Sevilla;034;Coria del Río;23751;11899;11852
41;Sevilla;035;Coripe;1560;790;770
41;Sevilla;036;Coronil (El);5114;2598;2516
41;Sevilla;037;Corrales (Los);4133;2107;2026
41;Sevilla;903;Cuervo de Sevilla (El);7717;3905;3812
41;Sevilla;038;Dos Hermanas;94591;46899;47692
41;Sevilla;039;Écija;37565;18496;19069
41;Sevilla;040;Espartinas;4749;2427;2322
41;Sevilla;041;Estepa;11654;5747;5907
41;Sevilla;042;Fuentes de Andalucía;7468;3697;3771
41;Sevilla;043;Garrobo (El);780;385;395
41;Sevilla;044;Gelves;5644;2783;2861
41;Sevilla;045;Gerena;5450;2733;2717
41;Sevilla;046;Gilena;3849;1956;1893
41;Sevilla;047;Gines;9303;4595;4708
41;Sevilla;048;Guadalcanal;3015;1493;1522
41;Sevilla;049;Guillena;8286;4204;4082
41;Sevilla;050;Herrera;6005;2961;3044
41;Sevilla;051;Huévar del Aljarafe;2278;1175;1103
41;Sevilla;052;Lantejuela (La);3569;1843;1726
41;Sevilla;053;Lebrija;24023;12141;11882
41;Sevilla;054;Lora de Estepa;765;385;380
41;Sevilla;055;Lora del Río;18878;9315;9563
41;Sevilla;056;Luisiana (La);4339;2208;2131
41;Sevilla;057;Madroño (El);368;186;182
41;Sevilla;058;Mairena del Alcor;16408;8159;8249
41;Sevilla;059;Mairena del Aljarafe;33005;16563;16442
41;Sevilla;060;Marchena;18132;8919;9213
41;Sevilla;061;Marinaleda;2623;1293;1330
41;Sevilla;062;Martín de la Jara;2774;1459;1315
41;Sevilla;063;Molares (Los);2672;1339;1333
41;Sevilla;064;Montellano;6943;3507;3436
41;Sevilla;065;Morón de la Frontera;28207;14011;14196
41;Sevilla;066;Navas de la Concepción (Las);1905;945;960
41;Sevilla;067;Olivares;7697;3897;3800
41;Sevilla;068;Osuna;17306;8548;8758
41;Sevilla;069;Palacios y Villafranca (Los);32452;16413;16039
41;Sevilla;070;Palomares del Río;3651;1857;1794
41;Sevilla;071;Paradas;6972;3487;3485
41;Sevilla;072;Pedrera;5011;2492;2519
41;Sevilla;073;Pedroso (El);2406;1183;1223
41;Sevilla;074;Peñaflor;3864;1954;1910
41;Sevilla;075;Pilas;11221;5543;5678
41;Sevilla;076;Pruna;3297;1683;1614
41;Sevilla;077;Puebla de Cazalla (La);10750;5399;5351
41;Sevilla;078;Puebla de los Infantes (La);3469;1750;1719
41;Sevilla;079;Puebla del Río (La);10660;5312;5348
41;Sevilla;080;Real de la Jara (El);1742;846;896
41;Sevilla;081;Rinconada (La);27673;13978;13695
41;Sevilla;082;Roda de Andalucía (La);4194;2074;2120
41;Sevilla;083;Ronquillo (El);1437;719;718
41;Sevilla;084;Rubio (El);3702;1855;1847
41;Sevilla;085;Salteras;2986;1482;1504
41;Sevilla;086;San Juan de Aznalfarache;20563;9934;10629
41;Sevilla;088;San Nicolás del Puerto;692;351;341
41;Sevilla;087;Sanlúcar la Mayor;10796;5360;5436
41;Sevilla;089;Santiponce;6905;3462;3443
41;Sevilla;090;Saucejo (El);4221;2105;2116
41;Sevilla;091;Sevilla;701927;335437;366490
41;Sevilla;092;Tocina;8828;4378;4450
41;Sevilla;093;Tomares;17414;8578;8836
41;Sevilla;094;Umbrete;4830;2428;2402
41;Sevilla;095;Utrera;46052;23051;23001
41;Sevilla;096;Valencina de la Concepción;6410;3213;3197
41;Sevilla;902;Villafranco del Guadalquivir;6076;3052;3024
41;Sevilla;097;Villamanrique de la Condesa;3791;1868;1923
41;Sevilla;100;Villanueva de San Juan;1565;771;794
41;Sevilla;098;Villanueva del Ariscal;4585;2232;2353
41;Sevilla;099;Villanueva del Río y Minas;5549;2675;2874
41;Sevilla;101;Villaverde del Río;6598;3361;3237
41;Sevilla;102;Viso del Alcor (El);16036;8112;7924
42;Soria;001;Abejar;363;193;170
42;Soria;003;Adradas;103;56;47
42;Soria;004;Ágreda;3333;1638;1695
42;Soria;006;Alconaba;178;100;78
42;Soria;007;Alcubilla de Avellaneda;231;116;115
42;Soria;008;Alcubilla de las Peñas;106;55;51
42;Soria;009;Aldealafuente;157;79;78
42;Soria;010;Aldealices;30;15;15
42;Soria;011;Aldealpozo;31;14;17
42;Soria;012;Aldealseñor;49;30;19
42;Soria;013;Aldehuela de Periáñez;26;17;9
42;Soria;014;Aldehuelas (Las);119;66;53
42;Soria;015;Alentisque;43;19;24
42;Soria;016;Aliud;43;20;23
42;Soria;017;Almajano;177;89;88
42;Soria;018;Almaluez;308;163;145
42;Soria;019;Almarza;615;342;273
42;Soria;020;Almazán;5871;2915;2956
42;Soria;021;Almazul;171;87;84
42;Soria;022;Almenar de Soria;386;203;183
42;Soria;023;Alpanseque;107;55;52
42;Soria;024;Arancón;111;61;50
42;Soria;025;Arcos de Jalón;1915;962;953
42;Soria;026;Arenillas;43;24;19
42;Soria;027;Arévalo de la Sierra;107;59;48
42;Soria;028;Ausejo de la Sierra;54;26;28
42;Soria;029;Baraona;238;131;107
42;Soria;030;Barca;141;80;61
42;Soria;031;Barcones;46;25;21
42;Soria;032;Bayubas de Abajo;284;152;132
42;Soria;033;Bayubas de Arriba;85;42;43
42;Soria;034;Beratón;34;27;7
42;Soria;035;Berlanga de Duero;1151;590;561
42;Soria;036;Blacos;64;38;26
42;Soria;037;Bliecos;53;31;22
42;Soria;038;Borjabad;63;34;29
42;Soria;039;Borobia;383;187;196
42;Soria;041;Buberos;48;23;25
42;Soria;042;Buitrago;49;24;25
42;Soria;043;Burgo de Osma-Ciudad de Osma;5042;2487;2555
42;Soria;044;Cabrejas del Campo;87;49;38
42;Soria;045;Cabrejas del Pinar;477;256;221
42;Soria;046;Calatañazor;73;42;31
42;Soria;048;Caltojar;129;69;60
42;Soria;049;Candilichera;239;120;119
42;Soria;050;Cañamaque;42;25;17
42;Soria;051;Carabantes;38;18;20
42;Soria;052;Caracena;24;17;7
42;Soria;053;Carrascosa de Abajo;40;21;19
42;Soria;054;Carrascosa de la Sierra;14;7;7
42;Soria;055;Casarejos;265;131;134
42;Soria;056;Castilfrío de la Sierra;31;20;11
42;Soria;058;Castillejo de Robledo;197;103;94
42;Soria;057;Castilruiz;330;165;165
42;Soria;059;Centenera de Andaluz;29;10;19
42;Soria;060;Cerbón;51;29;22
42;Soria;061;Cidones;347;190;157
42;Soria;062;Cigudosa;79;46;33
42;Soria;063;Cihuela;105;49;56
42;Soria;064;Ciria;104;46;58
42;Soria;065;Cirujales del Río;41;22;19
42;Soria;068;Coscurita;145;83;62
42;Soria;069;Covaleda;2059;1044;1015
42;Soria;070;Cubilla;80;41;39
42;Soria;071;Cubo de la Solana;257;140;117
42;Soria;073;Cueva de Ágreda;102;53;49
42;Soria;075;Dévanos;135;72;63
42;Soria;076;Deza;389;195;194
42;Soria;078;Duruelo de la Sierra;1465;736;729
42;Soria;079;Escobosa de Almazán;41;23;18
42;Soria;080;Espeja de San Marcelino;258;142;116
42;Soria;081;Espejón;228;114;114
42;Soria;082;Estepa de San Juan;14;7;7
42;Soria;083;Frechilla de Almazán;50;26;24
42;Soria;084;Fresno de Caracena;54;30;24
42;Soria;085;Fuentearmegil;353;188;165
42;Soria;086;Fuentecambrón;77;41;36
42;Soria;087;Fuentecantos;54;27;27
42;Soria;088;Fuentelmonge;143;71;72
42;Soria;089;Fuentelsaz de Soria;59;23;36
42;Soria;090;Fuentepinilla;155;87;68
42;Soria;092;Fuentes de Magaña;98;46;52
42;Soria;093;Fuentestrún;73;41;32
42;Soria;094;Garray;384;204;180
42;Soria;095;Golmayo;641;370;271
42;Soria;096;Gómara;509;257;252
42;Soria;097;Gormaz;22;9;13
42;Soria;098;Herrera de Soria;26;17;9
42;Soria;100;Hinojosa del Campo;53;33;20
42;Soria;103;Langa de Duero;929;500;429
42;Soria;105;Liceras;66;34;32
42;Soria;106;Losilla (La);20;12;8
42;Soria;107;Magaña;103;54;49
42;Soria;108;Maján;18;9;9
42;Soria;110;Matalebreras;124;61;63
42;Soria;111;Matamala de Almazán;405;207;198
42;Soria;113;Medinaceli;729;366;363
42;Soria;115;Miño de Medinaceli;121;58;63
42;Soria;116;Miño de San Esteban;99;58;41
42;Soria;117;Molinos de Duero;188;100;88
42;Soria;118;Momblona;41;23;18
42;Soria;119;Monteagudo de las Vicarías;313;153;160
42;Soria;120;Montejo de Tiermes;239;137;102
42;Soria;121;Montenegro de Cameros;114;61;53
42;Soria;123;Morón de Almazán;280;132;148
42;Soria;124;Muriel de la Fuente;74;44;30
42;Soria;125;Muriel Viejo;73;36;37
42;Soria;127;Nafría de Ucero;89;45;44
42;Soria;128;Narros;54;27;27
42;Soria;129;Navaleno;957;477;480
42;Soria;130;Nepas;85;52;33
42;Soria;131;Nolay;91;47;44
42;Soria;132;Noviercas;245;116;129
42;Soria;134;Ólvega;3283;1699;1584
42;Soria;135;Oncala;103;59;44
42;Soria;139;Pinilla del Campo;26;15;11
42;Soria;140;Portillo de Soria;23;12;11
42;Soria;141;Póveda de Soria (La);119;64;55
42;Soria;142;Pozalmuro;97;47;50
42;Soria;144;Quintana Redonda;561;297;264
42;Soria;145;Quintanas de Gormaz;199;103;96
42;Soria;148;Quiñonería;15;5;10
42;Soria;149;Rábanos (Los);411;239;172
42;Soria;151;Rebollar;51;28;23
42;Soria;152;Recuerda;110;55;55
42;Soria;153;Rello;44;20;24
42;Soria;154;Renieblas;120;65;55
42;Soria;155;Retortillo de Soria;243;130;113
42;Soria;156;Reznos;48;26;22
42;Soria;157;Riba de Escalote (La);30;18;12
42;Soria;158;Rioseco de Soria;151;76;75
42;Soria;159;Rollamienta;48;27;21
42;Soria;160;Royo (El);353;174;179
42;Soria;161;Salduero;190;101;89
42;Soria;162;San Esteban de Gormaz;3367;1725;1642
42;Soria;163;San Felices;84;41;43
42;Soria;164;San Leonardo de Yagüe;2093;1068;1025
42;Soria;165;San Pedro Manrique;484;257;227
42;Soria;166;Santa Cruz de Yanguas;55;33;22
42;Soria;167;Santa María de Huerta;455;237;218
42;Soria;168;Santa María de las Hoyas;209;112;97
42;Soria;171;Serón de Nágima;272;143;129
42;Soria;172;Soliedra;45;28;17
42;Soria;173;Soria;34045;16214;17831
42;Soria;174;Sotillo del Rincón;218;111;107
42;Soria;175;Suellacabras;41;24;17
42;Soria;176;Tajahuerce;48;23;25
42;Soria;177;Tajueco;124;65;59
42;Soria;178;Talveila;205;107;98
42;Soria;181;Tardelcuende;652;323;329
42;Soria;182;Taroda;82;42;40
42;Soria;183;Tejado;214;108;106
42;Soria;184;Torlengua;113;57;56
42;Soria;185;Torreblacos;38;19;19
42;Soria;187;Torrubia de Soria;95;54;41
42;Soria;188;Trévago;78;33;45
42;Soria;189;Ucero;117;59;58
42;Soria;190;Vadillo;152;80;72
42;Soria;191;Valdeavellano de Tera;256;129;127
42;Soria;192;Valdegeña;49;28;21
42;Soria;193;Valdelagua del Cerro;28;14;14
42;Soria;194;Valdemaluque;298;149;149
42;Soria;195;Valdenebro;150;79;71
42;Soria;196;Valdeprado;15;7;8
42;Soria;197;Valderrodilla;131;66;65
42;Soria;198;Valtajeros;29;15;14
42;Soria;200;Velamazán;148;83;65
42;Soria;201;Velilla de la Sierra;22;10;12
42;Soria;202;Velilla de los Ajos;45;28;17
42;Soria;204;Viana de Duero;78;47;31
42;Soria;205;Villaciervos;100;60;40
42;Soria;206;Villanueva de Gormaz;19;12;7
42;Soria;207;Villar del Ala;56;25;31
42;Soria;208;Villar del Campo;36;19;17
42;Soria;209;Villar del Río;178;93;85
42;Soria;211;Villares de Soria (Los);119;58;61
42;Soria;212;Villasayas;102;61;41
42;Soria;213;Villaseca de Arciel;44;25;19
42;Soria;215;Vinuesa;1077;570;507
42;Soria;216;Vizmanos;45;31;14
42;Soria;217;Vozmediano;50;26;24
42;Soria;218;Yanguas;121;58;63
42;Soria;219;Yelo;64;32;32
43;Tarragona;001;Aiguamúrcia;643;329;314
43;Tarragona;002;Albinyana;1296;667;629
43;Tarragona;003;Albiol (L');159;83;76
43;Tarragona;004;Alcanar;7801;3862;3939
43;Tarragona;005;Alcover;3692;1873;1819
43;Tarragona;904;Aldea (L');3526;1787;1739
43;Tarragona;006;Aldover;784;370;414
43;Tarragona;007;Aleixar (L');699;351;348
43;Tarragona;008;Alfara de Carles;382;201;181
43;Tarragona;009;Alforja;1230;639;591
43;Tarragona;010;Alió;364;185;179
43;Tarragona;011;Almoster;767;387;380
43;Tarragona;012;Altafulla;2955;1512;1443
43;Tarragona;013;Ametlla de Mar (L');4777;2398;2379
43;Tarragona;906;Ampolla (L');1756;865;891
43;Tarragona;014;Amposta;16162;7982;8180
43;Tarragona;016;Arboç (L');3485;1807;1678
43;Tarragona;015;Arbolí;131;66;65
43;Tarragona;017;Argentera (L');146;82;64
43;Tarragona;018;Arnes;518;268;250
43;Tarragona;019;Ascó;1709;864;845
43;Tarragona;020;Banyeres del Penedès;1647;858;789
43;Tarragona;021;Barberà de la Conca;405;205;200
43;Tarragona;022;Batea;1970;1000;970
43;Tarragona;023;Bellmunt del Priorat;314;156;158
43;Tarragona;024;Bellvei;1293;685;608
43;Tarragona;025;Benifallet;904;449;455
43;Tarragona;026;Benissanet;1017;524;493
43;Tarragona;027;Bisbal de Falset (La);242;119;123
43;Tarragona;028;Bisbal del Penedès (La);1812;954;858
43;Tarragona;029;Blancafort;387;197;190
43;Tarragona;030;Bonastre;317;158;159
43;Tarragona;031;Borges del Camp (Les);1521;766;755
43;Tarragona;032;Bot;850;430;420
43;Tarragona;033;Botarell;572;282;290
43;Tarragona;034;Bràfim;571;282;289
43;Tarragona;035;Cabacés;340;181;159
43;Tarragona;036;Cabra del Camp;560;303;257
43;Tarragona;037;Calafell;11106;5609;5497
43;Tarragona;903;Camarles;2914;1448;1466
43;Tarragona;038;Cambrils;19087;9469;9618
43;Tarragona;039;Capafonts;115;62;53
43;Tarragona;040;Capçanes;404;185;219
43;Tarragona;041;Caseres;323;161;162
43;Tarragona;042;Castellvell del Camp;1074;547;527
43;Tarragona;043;Catllar (El);2120;1121;999
43;Tarragona;045;Colldejou;196;108;88
43;Tarragona;046;Conesa;112;59;53
43;Tarragona;047;Constantí;5100;2640;2460
43;Tarragona;048;Corbera d'Ebre;1062;546;516
43;Tarragona;049;Cornudella de Montsant;846;430;416
43;Tarragona;050;Creixell;1664;841;823
43;Tarragona;051;Cunit;5542;2860;2682
43;Tarragona;901;Deltebre;10169;5088;5081
43;Tarragona;053;Duesaigües;201;122;79
43;Tarragona;054;Espluga de Francolí (L');3650;1809;1841
43;Tarragona;055;Falset;2469;1241;1228
43;Tarragona;056;Fatarella (La);1252;625;627
43;Tarragona;057;Febró (La);62;37;25
43;Tarragona;058;Figuera (La);118;58;60
43;Tarragona;059;Figuerola del Camp;267;133;134
43;Tarragona;060;Flix;4296;2155;2141
43;Tarragona;061;Forès;67;33;34
43;Tarragona;062;Freginals;352;175;177
43;Tarragona;063;Galera (La);731;364;367
43;Tarragona;064;Gandesa;2588;1298;1290
43;Tarragona;065;Garcia;536;271;265
43;Tarragona;066;Garidells (Els);171;81;90
43;Tarragona;067;Ginestar;835;423;412
43;Tarragona;068;Godall;728;370;358
43;Tarragona;069;Gratallops;230;120;110
43;Tarragona;070;Guiamets (Els);304;150;154
43;Tarragona;071;Horta de Sant Joan;1231;658;573
43;Tarragona;072;Lloar (El);125;64;61
43;Tarragona;073;Llorac;121;59;62
43;Tarragona;074;Llorenç del Penedès;1513;731;782
43;Tarragona;076;Marçà;602;292;310
43;Tarragona;075;Margalef;129;69;60
43;Tarragona;077;Mas de Barberans;701;360;341
43;Tarragona;078;Masdenverge;924;471;453
43;Tarragona;079;Masllorenç;420;206;214
43;Tarragona;080;Masó (La);269;126;143
43;Tarragona;081;Maspujols;450;232;218
43;Tarragona;082;Masroig (El);511;249;262
43;Tarragona;083;Milà (El);153;73;80
43;Tarragona;084;Miravet;795;413;382
43;Tarragona;085;Molar (El);282;149;133
43;Tarragona;086;Montblanc;5920;2936;2984
43;Tarragona;088;Montbrió del Camp;1438;719;719
43;Tarragona;089;Montferri;162;86;76
43;Tarragona;090;Montmell (El);498;274;224
43;Tarragona;091;Mont-ral;149;81;68
43;Tarragona;092;Mont-roig del Camp;6412;3288;3124
43;Tarragona;093;Móra d'Ebre;4836;2410;2426
43;Tarragona;094;Móra la Nova;2714;1346;1368
43;Tarragona;095;Morell (El);2338;1179;1159
43;Tarragona;096;Morera de Montsant (La);172;95;77
43;Tarragona;097;Nou de Gaià (La);372;183;189
43;Tarragona;098;Nulles;345;162;183
43;Tarragona;100;Pallaresos (Els);2400;1244;1156
43;Tarragona;099;Palma d'Ebre (La);418;198;220
43;Tarragona;101;Passanant;182;109;73
43;Tarragona;102;Paüls;643;328;315
43;Tarragona;103;Perafort;594;301;293
43;Tarragona;104;Perelló (El);2134;1098;1036
43;Tarragona;105;Piles (Les);174;97;77
43;Tarragona;106;Pinell de Brai (El);1085;551;534
43;Tarragona;107;Pira;395;194;201
43;Tarragona;108;Pla de Santa Maria (El);1615;823;792
43;Tarragona;109;Pobla de Mafumet (La);1047;524;523
43;Tarragona;110;Pobla de Massaluca (La);451;232;219
43;Tarragona;111;Pobla de Montornès (La);1256;674;582
43;Tarragona;112;Poboleda;332;167;165
43;Tarragona;113;Pont d'Armentera (El);578;297;281
43;Tarragona;141;Pontils;151;77;74
43;Tarragona;114;Porrera;460;245;215
43;Tarragona;115;Pradell de la Teixeta;211;110;101
43;Tarragona;116;Prades;522;264;258
43;Tarragona;117;Prat de Comte;183;87;96
43;Tarragona;118;Pratdip;515;255;260
43;Tarragona;119;Puigpelat;591;301;290
43;Tarragona;120;Querol;286;160;126
43;Tarragona;121;Rasquera;799;406;393
43;Tarragona;122;Renau;66;32;34
43;Tarragona;123;Reus;88912;43431;45481
43;Tarragona;124;Riba (La);763;396;367
43;Tarragona;125;Riba-roja d'Ebre;1377;712;665
43;Tarragona;126;Riera de Gaià (La);955;474;481
43;Tarragona;127;Riudecanyes;664;334;330
43;Tarragona;128;Riudecols;1010;519;491
43;Tarragona;129;Riudoms;5153;2580;2573
43;Tarragona;130;Rocafort de Queralt;273;149;124
43;Tarragona;131;Roda de Barà;3150;1714;1436
43;Tarragona;132;Rodonyà;397;203;194
43;Tarragona;133;Roquetes;6289;3136;3153
43;Tarragona;134;Rourell (El);255;134;121
43;Tarragona;135;Salomó;377;192;185
43;Tarragona;905;Salou;12267;6188;6079
43;Tarragona;136;Sant Carles de la Ràpita;11106;5503;5603
43;Tarragona;137;Sant Jaume dels Domenys;1346;701;645
43;Tarragona;902;Sant Jaume d'Enveja;3331;1690;1641
43;Tarragona;138;Santa Bàrbara;3240;1614;1626
43;Tarragona;139;Santa Coloma de Queralt;2579;1243;1336
43;Tarragona;140;Santa Oliva;2064;1053;1011
43;Tarragona;142;Sarral;1421;744;677
43;Tarragona;143;Savallà del Comtat;79;38;41
43;Tarragona;144;Secuita (La);1121;562;559
43;Tarragona;145;Selva del Camp (La);4034;2023;2011
43;Tarragona;146;Senan;37;23;14
43;Tarragona;044;Sénia (La);5029;2545;2484
43;Tarragona;147;Solivella;625;298;327
43;Tarragona;148;Tarragona;113016;55253;57763
43;Tarragona;149;Tivenys;928;459;469
43;Tarragona;150;Tivissa;1767;873;894
43;Tarragona;151;Torre de Fontaubella (La);123;59;64
43;Tarragona;152;Torre de l'Espanyol (La);665;349;316
43;Tarragona;153;Torredembarra;10090;4985;5105
43;Tarragona;154;Torroja del Priorat;136;80;56
43;Tarragona;155;Tortosa;29669;14392;15277
43;Tarragona;156;Ulldecona;5284;2614;2670
43;Tarragona;157;Ulldemolins;492;253;239
43;Tarragona;158;Vallclara;108;56;52
43;Tarragona;159;Vallfogona de Riucorb;135;74;61
43;Tarragona;160;Vallmoll;1107;572;535
43;Tarragona;161;Valls;20265;9929;10336
43;Tarragona;162;Vandellòs i l'Hospitalet de l'Infant;4348;2180;2168
43;Tarragona;163;Vendrell (El);21097;10555;10542
43;Tarragona;164;Vespella de Gaià;179;100;79
43;Tarragona;165;Vilabella;795;398;397
43;Tarragona;175;Vilalba dels Arcs;770;409;361
43;Tarragona;166;Vilallonga del Camp;1215;612;603
43;Tarragona;168;Vilanova de Prades;150;78;72
43;Tarragona;167;Vilanova d'Escornalbou;474;244;230
43;Tarragona;169;Vilaplana;518;264;254
43;Tarragona;170;Vila-rodona;1030;557;473
43;Tarragona;171;Vila-seca;12756;6426;6330
43;Tarragona;172;Vilaverd;347;174;173
43;Tarragona;173;Vilella Alta (La);130;67;63
43;Tarragona;174;Vilella Baixa (La);172;92;80
43;Tarragona;176;Vimbodí i Poblet;1017;533;484
43;Tarragona;177;Vinebre;437;215;222
43;Tarragona;178;Vinyols i els Arcs;1154;595;559
43;Tarragona;052;Xerta;1206;596;610
44;Teruel;001;Ababuj;86;49;37
44;Teruel;002;Abejuela;63;40;23
44;Teruel;003;Aguatón;26;10;16
44;Teruel;004;Aguaviva;611;300;311
44;Teruel;005;Aguilar del Alfambra;86;40;46
44;Teruel;006;Alacón;475;245;230
44;Teruel;007;Alba;275;144;131
44;Teruel;008;Albalate del Arzobispo;2335;1148;1187
44;Teruel;009;Albarracín;1049;544;505
44;Teruel;010;Albentosa;266;132;134
44;Teruel;011;Alcaine;54;30;24
44;Teruel;012;Alcalá de la Selva;465;245;220
44;Teruel;013;Alcañiz;12961;6404;6557
44;Teruel;014;Alcorisa;3185;1600;1585
44;Teruel;016;Alfambra;662;339;323
44;Teruel;017;Aliaga;421;224;197
44;Teruel;021;Allepuz;147;76;71
44;Teruel;022;Alloza;796;386;410
44;Teruel;023;Allueva;13;8;5
44;Teruel;018;Almohaja;30;19;11
44;Teruel;019;Alobras;96;52;44
44;Teruel;020;Alpeñés;29;18;11
44;Teruel;024;Anadón;17;9;8
44;Teruel;025;Andorra;8072;4171;3901
44;Teruel;026;Arcos de las Salinas;154;75;79
44;Teruel;027;Arens de Lledó;247;116;131
44;Teruel;028;Argente;266;138;128
44;Teruel;029;Ariño;901;444;457
44;Teruel;031;Azaila;180;99;81
44;Teruel;032;Bádenas;24;12;12
44;Teruel;033;Báguena;524;265;259
44;Teruel;034;Bañón;183;99;84
44;Teruel;035;Barrachina;161;84;77
44;Teruel;036;Bea;44;27;17
44;Teruel;037;Beceite;643;326;317
44;Teruel;039;Bello;399;185;214
44;Teruel;038;Belmonte de San José;149;80;69
44;Teruel;040;Berge;223;115;108
44;Teruel;041;Bezas;71;37;34
44;Teruel;042;Blancas;192;100;92
44;Teruel;043;Blesa;156;94;62
44;Teruel;044;Bordón;143;77;66
44;Teruel;045;Bronchales;457;241;216
44;Teruel;046;Bueña;104;58;46
44;Teruel;047;Burbáguena;330;151;179
44;Teruel;048;Cabra de Mora;118;68;50
44;Teruel;049;Calaceite;1223;621;602
44;Teruel;050;Calamocha;4055;2012;2043
44;Teruel;051;Calanda;3487;1751;1736
44;Teruel;052;Calomarde;86;42;44
44;Teruel;053;Camañas;141;81;60
44;Teruel;054;Camarena de la Sierra;181;103;78
44;Teruel;055;Camarillas;131;71;60
44;Teruel;056;Caminreal;822;407;415
44;Teruel;059;Cantavieja;743;390;353
44;Teruel;060;Cañada de Benatanduz;63;40;23
44;Teruel;061;Cañada de Verich (La);108;61;47
44;Teruel;062;Cañada Vellida;61;40;21
44;Teruel;063;Cañizar del Olivar;126;65;61
44;Teruel;064;Cascante del Río;123;75;48
44;Teruel;065;Castejón de Tornos;106;52;54
44;Teruel;066;Castel de Cabra;176;92;84
44;Teruel;070;Castellar (El);100;54;46
44;Teruel;071;Castellote;739;380;359
44;Teruel;067;Castelnou;101;53;48
44;Teruel;068;Castelserás;862;456;406
44;Teruel;074;Cedrillas;526;272;254
44;Teruel;075;Celadas;435;233;202
44;Teruel;076;Cella;2913;1497;1416
44;Teruel;077;Cerollera (La);92;49;43
44;Teruel;080;Codoñera (La);347;179;168
44;Teruel;082;Corbalán;72;43;29
44;Teruel;084;Cortes de Aragón;122;61;61
44;Teruel;085;Cosa;105;57;48
44;Teruel;086;Cretas;619;316;303
44;Teruel;087;Crivillén;131;69;62
44;Teruel;088;Cuba (La);61;29;32
44;Teruel;089;Cubla;53;26;27
44;Teruel;090;Cucalón;77;43;34
44;Teruel;092;Cuervo (El);127;64;63
44;Teruel;093;Cuevas de Almudén;103;56;47
44;Teruel;094;Cuevas Labradas;164;87;77
44;Teruel;096;Ejulve;238;120;118
44;Teruel;097;Escorihuela;235;117;118
44;Teruel;099;Escucha;1121;596;525
44;Teruel;100;Estercuel;353;182;171
44;Teruel;101;Ferreruela de Huerva;86;45;41
44;Teruel;102;Fonfría;33;19;14
44;Teruel;103;Formiche Alto;199;106;93
44;Teruel;105;Fórnoles;107;50;57
44;Teruel;106;Fortanete;197;102;95
44;Teruel;107;Foz-Calanda;240;132;108
44;Teruel;108;Fresneda (La);438;224;214
44;Teruel;109;Frías de Albarracín;168;89;79
44;Teruel;110;Fuenferrada;48;26;22
44;Teruel;111;Fuentes Calientes;137;78;59
44;Teruel;112;Fuentes Claras;656;323;333
44;Teruel;113;Fuentes de Rubielos;94;50;44
44;Teruel;114;Fuentespalda;363;183;180
44;Teruel;115;Galve;144;76;68
44;Teruel;116;Gargallo;123;68;55
44;Teruel;117;Gea de Albarracín;461;237;224
44;Teruel;118;Ginebrosa (La);252;140;112
44;Teruel;119;Griegos;140;82;58
44;Teruel;120;Guadalaviar;292;148;144
44;Teruel;121;Gúdar;80;46;34
44;Teruel;122;Híjar;1929;969;960
44;Teruel;123;Hinojosa de Jarque;180;94;86
44;Teruel;124;Hoz de la Vieja (La);139;73;66
44;Teruel;125;Huesa del Común;139;81;58
44;Teruel;126;Iglesuela del Cid (La);499;259;240
44;Teruel;127;Jabaloyas;92;48;44
44;Teruel;128;Jarque de la Val;100;55;45
44;Teruel;129;Jatiel;71;36;35
44;Teruel;130;Jorcas;47;31;16
44;Teruel;131;Josa;41;23;18
44;Teruel;132;Lagueruela;70;37;33
44;Teruel;133;Lanzuela;30;19;11
44;Teruel;135;Libros;160;83;77
44;Teruel;136;Lidón;81;38;43
44;Teruel;137;Linares de Mora;302;168;134
44;Teruel;141;Lledó;204;110;94
44;Teruel;138;Loscos;220;118;102
44;Teruel;142;Maicas;31;15;16
44;Teruel;143;Manzanera;474;262;212
44;Teruel;144;Martín del Río;494;251;243
44;Teruel;145;Mas de las Matas;1483;755;728
44;Teruel;146;Mata de los Olmos (La);272;129;143
44;Teruel;147;Mazaleón;605;308;297
44;Teruel;148;Mezquita de Jarque;137;73;64
44;Teruel;149;Mirambel;144;80;64
44;Teruel;150;Miravete de la Sierra;49;30;19
44;Teruel;151;Molinos;335;176;159
44;Teruel;152;Monforte de Moyuela;63;37;26
44;Teruel;153;Monreal del Campo;2318;1149;1169
44;Teruel;154;Monroyo;377;203;174
44;Teruel;155;Montalbán;1591;813;778
44;Teruel;156;Monteagudo del Castillo;68;39;29
44;Teruel;157;Monterde de Albarracín;72;35;37
44;Teruel;158;Mora de Rubielos;1360;703;657
44;Teruel;159;Moscardón;55;29;26
44;Teruel;160;Mosqueruela;692;368;324
44;Teruel;161;Muniesa;755;388;367
44;Teruel;163;Noguera de Albarracín;181;89;92
44;Teruel;164;Nogueras;21;15;6
44;Teruel;165;Nogueruelas;219;120;99
44;Teruel;167;Obón;54;27;27
44;Teruel;168;Odón;269;125;144
44;Teruel;169;Ojos Negros;577;302;275
44;Teruel;171;Olba;198;102;96
44;Teruel;172;Oliete;479;242;237
44;Teruel;173;Olmos (Los);150;79;71
44;Teruel;174;Orihuela del Tremedal;611;301;310
44;Teruel;175;Orrios;196;100;96
44;Teruel;176;Palomar de Arroyos;261;148;113
44;Teruel;177;Pancrudo;177;95;82
44;Teruel;178;Parras de Castellote (Las);90;48;42
44;Teruel;179;Peñarroya de Tastavins;538;271;267
44;Teruel;180;Peracense;117;63;54
44;Teruel;181;Peralejos;94;48;46
44;Teruel;182;Perales del Alfambra;297;159;138
44;Teruel;183;Pitarque;113;55;58
44;Teruel;184;Plou;51;27;24
44;Teruel;185;Pobo (El);150;81;69
44;Teruel;187;Portellada (La);321;168;153
44;Teruel;189;Pozondón;84;44;40
44;Teruel;190;Pozuel del Campo;113;62;51
44;Teruel;191;Puebla de Híjar (La);1105;539;566
44;Teruel;192;Puebla de Valverde (La);490;261;229
44;Teruel;193;Puertomingalvo;148;79;69
44;Teruel;194;Ráfales;207;103;104
44;Teruel;195;Rillo;142;77;65
44;Teruel;196;Riodeva;229;111;118
44;Teruel;197;Ródenas;95;45;50
44;Teruel;198;Royuela;240;138;102
44;Teruel;199;Rubiales;60;33;27
44;Teruel;200;Rubielos de la Cérida;60;29;31
44;Teruel;201;Rubielos de Mora;635;320;315
44;Teruel;203;Salcedillo;8;4;4
44;Teruel;204;Saldón;43;25;18
44;Teruel;205;Samper de Calanda;999;481;518
44;Teruel;206;San Agustín;147;73;74
44;Teruel;207;San Martín del Río;294;140;154
44;Teruel;208;Santa Cruz de Nogueras;27;16;11
44;Teruel;209;Santa Eulalia;1218;594;624
44;Teruel;210;Sarrión;1009;529;480
44;Teruel;211;Segura de los Baños;52;27;25
44;Teruel;212;Seno;51;25;26
44;Teruel;213;Singra;99;49;50
44;Teruel;215;Terriente;188;108;80
44;Teruel;216;Teruel;30047;14520;15527
44;Teruel;217;Toril y Masegoso;32;19;13
44;Teruel;218;Tormón;40;20;20
44;Teruel;219;Tornos;257;138;119
44;Teruel;220;Torralba de los Sisones;221;114;107
44;Teruel;223;Torre de Arcas;106;51;55
44;Teruel;224;Torre de las Arcas;34;20;14
44;Teruel;225;Torre del Compte;177;85;92
44;Teruel;227;Torre los Negros;93;47;46
44;Teruel;221;Torrecilla de Alcañiz;438;230;208
44;Teruel;222;Torrecilla del Rebollar;185;99;86
44;Teruel;226;Torrelacárcel;293;151;142
44;Teruel;228;Torremocha de Jiloca;170;81;89
44;Teruel;229;Torres de Albarracín;157;86;71
44;Teruel;230;Torrevelilla;208;104;104
44;Teruel;231;Torrijas;77;35;42
44;Teruel;232;Torrijo del Campo;570;288;282
44;Teruel;234;Tramacastiel;118;56;62
44;Teruel;235;Tramacastilla;132;62;70
44;Teruel;236;Tronchón;93;48;45
44;Teruel;237;Urrea de Gaén;600;296;304
44;Teruel;238;Utrillas;3291;1699;1592
44;Teruel;239;Valacloche;19;12;7
44;Teruel;240;Valbona;183;99;84
44;Teruel;241;Valdealgorfa;753;371;382
44;Teruel;243;Valdecuenca;40;20;20
44;Teruel;244;Valdelinares;125;70;55
44;Teruel;245;Valdeltormo;377;195;182
44;Teruel;246;Valderrobres;1880;968;912
44;Teruel;247;Valjunquera;438;225;213
44;Teruel;249;Vallecillo (El);72;38;34
44;Teruel;250;Veguillas de la Sierra;27;17;10
44;Teruel;251;Villafranca del Campo;387;194;193
44;Teruel;252;Villahermosa del Campo;68;39;29
44;Teruel;256;Villanueva del Rebollar de la Sierra;51;29;22
44;Teruel;257;Villar del Cobo;230;117;113
44;Teruel;258;Villar del Salz;106;58;48
44;Teruel;260;Villarluengo;191;110;81
44;Teruel;261;Villarquemado;995;498;497
44;Teruel;262;Villarroya de los Pinares;200;100;100
44;Teruel;263;Villastar;350;185;165
44;Teruel;264;Villel;333;174;159
44;Teruel;265;Vinaceite;293;154;139
44;Teruel;266;Visiedo;203;91;112
44;Teruel;267;Vivel del Río Martín;96;50;46
44;Teruel;268;Zoma (La);32;17;15
45;Toledo;001;Ajofrín;2149;1115;1034
45;Toledo;002;Alameda de la Sagra;2823;1483;1340
45;Toledo;003;Albarreal de Tajo;618;308;310
45;Toledo;004;Alcabón;618;317;301
45;Toledo;005;Alcañizo;327;172;155
45;Toledo;006;Alcaudete de la Jara;1857;876;981
45;Toledo;007;Alcolea de Tajo;776;385;391
45;Toledo;008;Aldea en Cabo;180;95;85
45;Toledo;009;Aldeanueva de Barbarroya;835;427;408
45;Toledo;010;Aldeanueva de San Bartolomé;618;308;310
45;Toledo;011;Almendral de la Cañada;405;211;194
45;Toledo;012;Almonacid de Toledo;795;410;385
45;Toledo;013;Almorox;2217;1152;1065
45;Toledo;014;Añover de Tajo;4557;2376;2181
45;Toledo;015;Arcicóllar;585;285;300
45;Toledo;016;Argés;2389;1181;1208
45;Toledo;017;Azután;366;189;177
45;Toledo;018;Barcience;112;57;55
45;Toledo;019;Bargas;6638;3308;3330
45;Toledo;020;Belvís de la Jara;1715;832;883
45;Toledo;021;Borox;2193;1097;1096
45;Toledo;022;Buenaventura;539;260;279
45;Toledo;023;Burguillos de Toledo;909;462;447
45;Toledo;024;Burujón;1280;658;622
45;Toledo;025;Cabañas de la Sagra;1249;644;605
45;Toledo;026;Cabañas de Yepes;253;132;121
45;Toledo;027;Cabezamesada;491;254;237
45;Toledo;028;Calera y Chozas;3767;1892;1875
45;Toledo;029;Caleruela;309;157;152
45;Toledo;030;Calzada de Oropesa;595;297;298
45;Toledo;031;Camarena;2215;1121;1094
45;Toledo;032;Camarenilla;516;258;258
45;Toledo;033;Campillo de la Jara (El);534;282;252
45;Toledo;034;Camuñas;1735;870;865
45;Toledo;035;Cardiel de los Montes;142;82;60
45;Toledo;036;Carmena;820;416;404
45;Toledo;037;Carpio de Tajo (El);2266;1106;1160
45;Toledo;038;Carranque;1573;808;765
45;Toledo;039;Carriches;288;143;145
45;Toledo;040;Casar de Escalona (El);921;446;475
45;Toledo;041;Casarrubios del Monte;2765;1427;1338
45;Toledo;042;Casasbuenas;230;115;115
45;Toledo;043;Castillo de Bayuela;1006;499;507
45;Toledo;045;Cazalegas;1149;570;579
45;Toledo;046;Cebolla;2789;1384;1405
45;Toledo;047;Cedillo del Condado;1507;766;741
45;Toledo;048;Cerralbos (Los);455;228;227
45;Toledo;049;Cervera de los Montes;400;212;188
45;Toledo;056;Chozas de Canales;1011;505;506
45;Toledo;057;Chueca;269;139;130
45;Toledo;050;Ciruelos;342;189;153
45;Toledo;051;Cobeja;1790;894;896
45;Toledo;052;Cobisa;1393;723;670
45;Toledo;053;Consuegra;10081;5000;5081
45;Toledo;054;Corral de Almaguer;5665;2841;2824
45;Toledo;055;Cuerva;1291;635;656
45;Toledo;058;Domingo Pérez;494;242;252
45;Toledo;059;Dosbarrios;2081;1051;1030
45;Toledo;060;Erustes;191;98;93
45;Toledo;061;Escalona;2130;1077;1053
45;Toledo;062;Escalonilla;1443;698;745
45;Toledo;063;Espinoso del Rey;638;328;310
45;Toledo;064;Esquivias;3800;1910;1890
45;Toledo;065;Estrella (La);430;224;206
45;Toledo;066;Fuensalida;7661;3865;3796
45;Toledo;067;Gálvez;3069;1546;1523
45;Toledo;068;Garciotum;159;74;85
45;Toledo;069;Gerindote;1835;934;901
45;Toledo;070;Guadamur;1593;820;773
45;Toledo;071;Guardia (La);2417;1191;1226
45;Toledo;072;Herencias (Las);735;379;356
45;Toledo;073;Herreruela de Oropesa;439;215;224
45;Toledo;074;Hinojosa de San Vicente;497;271;226
45;Toledo;075;Hontanar;117;66;51
45;Toledo;076;Hormigos;429;213;216
45;Toledo;077;Huecas;435;230;205
45;Toledo;078;Huerta de Valdecarábanos;1685;834;851
45;Toledo;079;Iglesuela (La);450;222;228
45;Toledo;080;Illán de Vacas;4;3;1
45;Toledo;081;Illescas;10106;5063;5043
45;Toledo;082;Lagartera;1870;914;956
45;Toledo;083;Layos;262;134;128
45;Toledo;084;Lillo;2894;1458;1436
45;Toledo;085;Lominchar;1136;593;543
45;Toledo;086;Lucillos;511;251;260
45;Toledo;087;Madridejos;10475;5177;5298
45;Toledo;088;Magán;1127;564;563
45;Toledo;089;Malpica de Tajo;1875;949;926
45;Toledo;090;Manzaneque;494;248;246
45;Toledo;091;Maqueda;480;241;239
45;Toledo;092;Marjaliza;323;160;163
45;Toledo;093;Marrupe;128;65;63
45;Toledo;094;Mascaraque;491;231;260
45;Toledo;095;Mata (La);998;494;504
45;Toledo;096;Mazarambroz;1208;599;609
45;Toledo;097;Mejorada;1075;540;535
45;Toledo;098;Menasalbas;2955;1545;1410
45;Toledo;099;Méntrida;2023;1026;997
45;Toledo;100;Mesegar de Tajo;231;115;116
45;Toledo;101;Miguel Esteban;4712;2334;2378
45;Toledo;102;Mocejón;4146;2123;2023
45;Toledo;103;Mohedas de la Jara;623;319;304
45;Toledo;104;Montearagón;440;228;212
45;Toledo;105;Montesclaros;471;239;232
45;Toledo;106;Mora;9352;4609;4743
45;Toledo;107;Nambroca;2539;1280;1259
45;Toledo;108;Nava de Ricomalillo (La);743;373;370
45;Toledo;109;Navahermosa;3893;1993;1900
45;Toledo;110;Navalcán;2316;1220;1096
45;Toledo;111;Navalmoralejo;79;37;42
45;Toledo;112;Navalmorales (Los);2668;1341;1327
45;Toledo;113;Navalucillos (Los);2729;1365;1364
45;Toledo;114;Navamorcuende;726;382;344
45;Toledo;115;Noblejas;3016;1535;1481
45;Toledo;116;Noez;820;410;410
45;Toledo;117;Nombela;933;485;448
45;Toledo;118;Novés;1544;786;758
45;Toledo;119;Numancia de la Sagra;2402;1249;1153
45;Toledo;120;Nuño Gómez;179;91;88
45;Toledo;121;Ocaña;6135;3040;3095
45;Toledo;122;Olías del Rey;4178;2095;2083
45;Toledo;123;Ontígola;1192;643;549
45;Toledo;124;Orgaz;2668;1337;1331
45;Toledo;125;Oropesa;2736;1360;1376
45;Toledo;126;Otero;210;100;110
45;Toledo;127;Palomeque;475;251;224
45;Toledo;128;Pantoja;2403;1226;1177
45;Toledo;129;Paredes de Escalona;120;57;63
45;Toledo;130;Parrillas;434;216;218
45;Toledo;131;Pelahustán;374;195;179
45;Toledo;132;Pepino;868;444;424
45;Toledo;133;Polán;3310;1681;1629
45;Toledo;134;Portillo de Toledo;1974;1017;957
45;Toledo;135;Puebla de Almoradiel (La);5374;2696;2678
45;Toledo;136;Puebla de Montalbán (La);7086;3557;3529
45;Toledo;137;Pueblanueva (La);2017;1026;991
45;Toledo;138;Puente del Arzobispo (El);1577;757;820
45;Toledo;139;Puerto de San Vicente;283;139;144
45;Toledo;140;Pulgar;1232;625;607
45;Toledo;141;Quero;1318;657;661
45;Toledo;142;Quintanar de la Orden;9448;4685;4763
45;Toledo;143;Quismondo;1327;657;670
45;Toledo;144;Real de San Vicente (El);1006;514;492
45;Toledo;145;Recas;2610;1373;1237
45;Toledo;146;Retamoso;164;86;78
45;Toledo;147;Rielves;508;256;252
45;Toledo;148;Robledo del Mazo;518;270;248
45;Toledo;149;Romeral (El);890;438;452
45;Toledo;150;San Bartolomé de las Abiertas;490;258;232
45;Toledo;151;San Martín de Montalbán;741;363;378
45;Toledo;152;San Martín de Pusa;782;393;389
45;Toledo;153;San Pablo de los Montes;2098;1062;1036
45;Toledo;154;San Román de los Montes;712;375;337
45;Toledo;155;Santa Ana de Pusa;401;211;190
45;Toledo;156;Santa Cruz de la Zarza;4409;2212;2197
45;Toledo;157;Santa Cruz del Retamar;1614;823;791
45;Toledo;158;Santa Olalla;2510;1285;1225
45;Toledo;901;Santo Domingo-Caudilla;779;381;398
45;Toledo;159;Sartajada;109;66;43
45;Toledo;160;Segurilla;956;479;477
45;Toledo;161;Seseña;3978;2067;1911
45;Toledo;162;Sevilleja de la Jara;1060;556;504
45;Toledo;163;Sonseca;9383;4731;4652
45;Toledo;164;Sotillo de las Palomas;214;109;105
45;Toledo;165;Talavera de la Reina;73204;35699;37505
45;Toledo;166;Tembleque;2101;1062;1039
45;Toledo;167;Toboso (El);2088;1019;1069
45;Toledo;168;Toledo;67617;32535;35082
45;Toledo;169;Torralba de Oropesa;275;128;147
45;Toledo;171;Torre de Esteban Hambrán (La);1490;761;729
45;Toledo;170;Torrecilla de la Jara;299;150;149
45;Toledo;172;Torrico;899;468;431
45;Toledo;173;Torrijos;9969;4897;5072
45;Toledo;174;Totanés;369;192;177
45;Toledo;175;Turleque;991;493;498
45;Toledo;176;Ugena;1305;685;620
45;Toledo;177;Urda;2996;1493;1503
45;Toledo;179;Valdeverdeja;811;369;442
45;Toledo;180;Valmojado;2374;1214;1160
45;Toledo;181;Velada;2372;1225;1147
45;Toledo;182;Ventas con Peña Aguilera (Las);1380;707;673
45;Toledo;183;Ventas de Retamosa (Las);778;400;378
45;Toledo;184;Ventas de San Julián (Las);223;100;123
45;Toledo;186;Villa de Don Fadrique (La);4164;2059;2105
45;Toledo;185;Villacañas;9311;4602;4709
45;Toledo;187;Villafranca de los Caballeros;5321;2620;2701
45;Toledo;188;Villaluenga de la Sagra;2639;1312;1327
45;Toledo;189;Villamiel de Toledo;470;234;236
45;Toledo;190;Villaminaya;656;331;325
45;Toledo;191;Villamuelas;750;370;380
45;Toledo;192;Villanueva de Alcardete;3304;1664;1640
45;Toledo;193;Villanueva de Bogas;835;415;420
45;Toledo;194;Villarejo de Montalbán;95;49;46
45;Toledo;195;Villarrubia de Santiago;2901;1443;1458
45;Toledo;196;Villaseca de la Sagra;1598;804;794
45;Toledo;197;Villasequilla;2352;1216;1136
45;Toledo;198;Villatobas;2244;1137;1107
45;Toledo;199;Viso de San Juan (El);1106;585;521
45;Toledo;200;Yébenes (Los);6313;3149;3164
45;Toledo;201;Yeles;1636;869;767
45;Toledo;202;Yepes;4360;2219;2141
45;Toledo;203;Yuncler;1930;968;962
45;Toledo;204;Yunclillos;608;308;300
45;Toledo;205;Yuncos;3611;1908;1703
46;Valencia/València;001;Ademuz;1176;589;587
46;Valencia/València;002;Ador;1140;573;567
46;Valencia/València;004;Agullent;2213;1073;1140
46;Valencia/València;042;Aielo de Malferit;3961;1949;2012
46;Valencia/València;043;Aielo de Rugat;193;103;90
46;Valencia/València;005;Alaquàs;26179;13005;13174
46;Valencia/València;006;Albaida;5810;2851;2959
46;Valencia/València;007;Albal;11578;5757;5821
46;Valencia/València;008;Albalat de la Ribera;3501;1700;1801
46;Valencia/València;009;Albalat dels Sorells;3527;1714;1813
46;Valencia/València;010;Albalat dels Tarongers;683;358;325
46;Valencia/València;011;Alberic;9150;4469;4681
46;Valencia/València;012;Alborache;903;460;443
46;Valencia/València;013;Alboraya;15819;7852;7967
46;Valencia/València;014;Albuixech;3048;1487;1561
46;Valencia/València;016;Alcàntera de Xúquer;1424;702;722
46;Valencia/València;015;Alcàsser;7343;3700;3643
46;Valencia/València;018;Alcublas;852;453;399
46;Valencia/València;020;Alcúdia de Crespins (L');4126;2038;2088
46;Valencia/València;019;Alcúdia (L');10500;5186;5314
46;Valencia/València;021;Aldaia;24297;12166;12131
46;Valencia/València;022;Alfafar;19205;9464;9741
46;Valencia/València;024;Alfara de Algimia;505;251;254
46;Valencia/València;025;Alfara del Patriarca;2726;1332;1394
46;Valencia/València;026;Alfarp;1303;628;675
46;Valencia/València;027;Alfarrasí;1205;585;620
46;Valencia/València;023;Alfauir;357;186;171
46;Valencia/València;028;Algar de Palancia;423;210;213
46;Valencia/València;029;Algemesí;25045;12336;12709
46;Valencia/València;030;Algimia de Alfara;839;420;419
46;Valencia/València;031;Alginet;11898;5932;5966
46;Valencia/València;032;Almàssera;5644;2704;2940
46;Valencia/València;033;Almiserà;267;127;140
46;Valencia/València;034;Almoines;1697;836;861
46;Valencia/València;035;Almussafes;7122;3561;3561
46;Valencia/València;036;Alpuente;945;492;453
46;Valencia/València;037;Alquería de la Condesa/Alqueria de la Comtessa (l');1416;673;743
46;Valencia/València;017;Alzira;40441;19750;20691
46;Valencia/València;038;Andilla;303;170;133
46;Valencia/València;039;Anna;2553;1282;1271
46;Valencia/València;040;Antella;1508;748;760
46;Valencia/València;041;Aras de los Olmos;390;219;171
46;Valencia/València;003;Atzeneta d'Albaida;1230;629;601
46;Valencia/València;044;Ayora;5515;2816;2699
46;Valencia/València;046;Barx;1221;594;627
46;Valencia/València;045;Barxeta;1626;830;796
46;Valencia/València;047;Bèlgida;674;325;349
46;Valencia/València;048;Bellreguard;3754;1867;1887
46;Valencia/València;049;Bellús;395;195;200
46;Valencia/València;050;Benagéber;190;102;88
46;Valencia/València;051;Benaguasil;9158;4612;4546
46;Valencia/València;052;Benavites;641;309;332
46;Valencia/València;053;Beneixida;647;313;334
46;Valencia/València;054;Benetússer;13659;6762;6897
46;Valencia/València;055;Beniarjó;1179;567;612
46;Valencia/València;056;Beniatjar;237;121;116
46;Valencia/València;057;Benicolet;478;245;233
46;Valencia/València;904;Benicull de Xúquer;"";"";""
46;Valencia/València;060;Benifaió;12054;5942;6112
46;Valencia/València;059;Benifairó de la Valldigna;1643;817;826
46;Valencia/València;058;Benifairó de les Valls;1966;965;1001
46;Valencia/València;061;Beniflá;157;71;86
46;Valencia/València;062;Benigánim;5451;2774;2677
46;Valencia/València;063;Benimodo;1770;907;863
46;Valencia/València;064;Benimuslem;555;278;277
46;Valencia/València;065;Beniparrell;1564;800;764
46;Valencia/València;066;Benirredrà;1086;519;567
46;Valencia/València;067;Benisanó;1739;892;847
46;Valencia/València;068;Benissoda;299;167;132
46;Valencia/València;069;Benisuera;190;89;101
46;Valencia/València;070;Bétera;12916;6431;6485
46;Valencia/València;071;Bicorp;682;337;345
46;Valencia/València;072;Bocairent;4545;2250;2295
46;Valencia/València;073;Bolbaite;1412;719;693
46;Valencia/València;074;Bonrepòs i Mirambell;2299;1131;1168
46;Valencia/València;075;Bufali;214;104;110
46;Valencia/València;076;Bugarra;837;414;423
46;Valencia/València;077;Buñol;9358;4631;4727
46;Valencia/València;078;Burjassot;34869;16950;17919
46;Valencia/València;079;Calles;425;232;193
46;Valencia/València;080;Camporrobles;1392;705;687
46;Valencia/València;081;Canals;12937;6398;6539
46;Valencia/València;082;Canet d'En Berenguer;2216;1091;1125
46;Valencia/València;083;Carcaixent;20487;9988;10499
46;Valencia/València;084;Càrcer;2069;990;1079
46;Valencia/València;085;Carlet;14041;6888;7153
46;Valencia/València;086;Carrícola;75;35;40
46;Valencia/València;087;Casas Altas;158;83;75
46;Valencia/València;088;Casas Bajas;292;157;135
46;Valencia/València;089;Casinos;2397;1233;1164
46;Valencia/València;090;Castelló de Rugat;2050;1050;1000
46;Valencia/València;091;Castellonet de la Conquesta;148;80;68
46;Valencia/València;092;Castielfabib;522;281;241
46;Valencia/València;093;Catadau;2301;1135;1166
46;Valencia/València;094;Catarroja;20692;10182;10510
46;Valencia/València;095;Caudete de las Fuentes;808;408;400
46;Valencia/València;096;Cerdà;296;146;150
46;Valencia/València;107;Chella;2528;1252;1276
46;Valencia/València;106;Chelva;2105;1068;1037
46;Valencia/València;108;Chera;566;296;270
46;Valencia/València;109;Cheste;6906;3481;3425
46;Valencia/València;111;Chiva;9327;4665;4662
46;Valencia/València;112;Chulilla;765;376;389
46;Valencia/València;097;Cofrentes;998;490;508
46;Valencia/València;098;Corbera;3078;1480;1598
46;Valencia/València;099;Cortes de Pallás;740;389;351
46;Valencia/València;100;Cotes;359;165;194
46;Valencia/València;105;Cullera;20459;10108;10351
46;Valencia/València;113;Daimús;1544;785;759
46;Valencia/València;114;Domeño;494;257;237
46;Valencia/València;115;Dos Aguas;401;225;176
46;Valencia/València;116;Eliana (L');12652;6322;6330
46;Valencia/València;117;Emperador;203;100;103
46;Valencia/València;118;Enguera;4695;2325;2370
46;Valencia/València;119;Ènova (L');1046;527;519
46;Valencia/València;120;Estivella;1095;514;581
46;Valencia/València;121;Estubeny;151;70;81
46;Valencia/València;122;Faura;2847;1422;1425
46;Valencia/València;123;Favara;1686;814;872
46;Valencia/València;126;Foios;5304;2572;2732
46;Valencia/València;128;Font de la Figuera (La);2100;1070;1030
46;Valencia/València;127;Font d'En Carròs (La);3180;1586;1594
46;Valencia/València;124;Fontanars dels Alforins;975;502;473
46;Valencia/València;125;Fortaleny;995;502;493
46;Valencia/València;129;Fuenterrobles;708;367;341
46;Valencia/València;131;Gandia;58676;28690;29986
46;Valencia/València;902;Gátova;"";"";""
46;Valencia/València;130;Gavarda;1229;594;635
46;Valencia/València;132;Genovés;2351;1168;1183
46;Valencia/València;133;Gestalgar;696;343;353
46;Valencia/València;134;Gilet;1480;735;745
46;Valencia/València;135;Godella;11058;5413;5645
46;Valencia/València;136;Godelleta;2174;1065;1109
46;Valencia/València;137;Granja de la Costera (La);344;163;181
46;Valencia/València;138;Guadasequies;377;195;182
46;Valencia/València;139;Guadassuar;5331;2654;2677
46;Valencia/València;140;Guardamar de la Safor;69;37;32
46;Valencia/València;141;Higueruelas;571;292;279
46;Valencia/València;142;Jalance;1098;560;538
46;Valencia/València;144;Jarafuel;947;496;451
46;Valencia/València;154;Llanera de Ranes;1028;531;497
46;Valencia/València;155;Llaurí;1263;631;632
46;Valencia/València;147;Llíria;16300;8145;8155
46;Valencia/València;153;Llocnou de Sant Jeroni;562;274;288
46;Valencia/València;151;Llocnou d'En Fenollet;766;375;391
46;Valencia/València;156;Llombai;2263;1136;1127
46;Valencia/València;157;Llosa de Ranes (La);3620;1861;1759
46;Valencia/València;150;Llutxent;2394;1213;1181
46;Valencia/València;148;Loriguilla;1003;509;494
46;Valencia/València;149;Losa del Obispo;456;221;235
46;Valencia/València;152;Lugar Nuevo de la Corona;100;47;53
46;Valencia/València;158;Macastre;1000;488;512
46;Valencia/València;159;Manises;25912;12771;13141
46;Valencia/València;160;Manuel;2460;1186;1274
46;Valencia/València;161;Marines;1348;705;643
46;Valencia/València;162;Masalavés;1470;747;723
46;Valencia/València;163;Massalfassar;1335;656;679
46;Valencia/València;164;Massamagrell;12424;6092;6332
46;Valencia/València;165;Massanassa;7633;3721;3912
46;Valencia/València;166;Meliana;9112;4439;4673
46;Valencia/València;167;Millares;653;318;335
46;Valencia/València;168;Miramar;1179;577;602
46;Valencia/València;169;Mislata;40528;19812;20716
46;Valencia/València;170;Mogente/Moixent;4251;2150;2101
46;Valencia/València;171;Moncada;18479;9169;9310
46;Valencia/València;172;Monserrat;3090;1584;1506
46;Valencia/València;173;Montaverner;1681;847;834
46;Valencia/València;174;Montesa;1240;622;618
46;Valencia/València;175;Montichelvo;612;312;300
46;Valencia/València;176;Montroy;1519;777;742
46;Valencia/València;177;Museros;4166;2075;2091
46;Valencia/València;178;Náquera;2574;1297;1277
46;Valencia/València;179;Navarrés;2747;1385;1362
46;Valencia/València;180;Novelé/Novetlè;674;325;349
46;Valencia/València;181;Oliva;20656;10172;10484
46;Valencia/València;183;Olleria (L');7071;3613;3458
46;Valencia/València;182;Olocau;816;423;393
46;Valencia/València;184;Ontinyent;31530;15555;15975
46;Valencia/València;185;Otos;525;266;259
46;Valencia/València;186;Paiporta;17782;8863;8919
46;Valencia/València;187;Palma de Gandía;1523;750;773
46;Valencia/València;188;Palmera;524;264;260
46;Valencia/València;189;Palomar (El);499;248;251
46;Valencia/València;190;Paterna;47190;23314;23876
46;Valencia/València;191;Pedralba;2068;1059;1009
46;Valencia/València;192;Petrés;746;366;380
46;Valencia/València;193;Picanya;8791;4379;4412
46;Valencia/València;194;Picassent;15708;7973;7735
46;Valencia/València;195;Piles;1963;957;1006
46;Valencia/València;196;Pinet;224;118;106
46;Valencia/València;199;Pobla de Farnals (La);5266;2638;2628
46;Valencia/València;202;Pobla de Vallbona (La);11112;5665;5447
46;Valencia/València;200;Pobla del Duc (La);2430;1190;1240
46;Valencia/València;203;Pobla Llarga (La);4380;2139;2241
46;Valencia/València;197;Polinyà de Xúquer;3019;1499;1520
46;Valencia/València;198;Potríes;935;461;474
46;Valencia/València;205;Puçol;14211;6975;7236
46;Valencia/València;201;Puebla de San Miguel;79;41;38
46;Valencia/València;204;Puig;7043;3447;3596
46;Valencia/València;101;Quart de les Valls;1082;515;567
46;Valencia/València;102;Quart de Poblet;26409;13010;13399
46;Valencia/València;103;Quartell;1376;670;706
46;Valencia/València;104;Quatretonda;2528;1293;1235
46;Valencia/València;206;Quesa;797;402;395
46;Valencia/València;207;Rafelbuñol/Rafelbunyol;5407;2639;2768
46;Valencia/València;208;Rafelcofer;1416;670;746
46;Valencia/València;209;Rafelguaraf;2440;1198;1242
46;Valencia/València;210;Ráfol de Salem;376;177;199
46;Valencia/València;211;Real de Gandía;1804;866;938
46;Valencia/València;212;Real ;1791;916;875
46;Valencia/València;213;Requena;18957;9508;9449
46;Valencia/València;214;Riba-roja de Túria;12250;6114;6136
46;Valencia/València;215;Riola;1584;781;803
46;Valencia/València;216;Rocafort;5008;2444;2564
46;Valencia/València;217;Rotglá y Corberá;1025;508;517
46;Valencia/València;218;Rótova;1320;664;656
46;Valencia/València;219;Rugat;195;98;97
46;Valencia/València;220;Sagunto/Sagunt;56836;27654;29182
46;Valencia/València;221;Salem;465;234;231
46;Valencia/València;903;San Antonio de Benagéber;2434;1269;1165
46;Valencia/València;222;San Juan de Énova;353;160;193
46;Valencia/València;223;Sedaví;8287;4037;4250
46;Valencia/València;224;Segart;210;96;114
46;Valencia/València;225;Sellent;480;250;230
46;Valencia/València;226;Sempere;34;20;14
46;Valencia/València;227;Senyera;921;443;478
46;Valencia/València;228;Serra;1835;930;905
46;Valencia/València;229;Siete Aguas;1283;650;633
46;Valencia/València;230;Silla;15710;7938;7772
46;Valencia/València;231;Simat de la Valldigna;3118;1592;1526
46;Valencia/València;232;Sinarcas;1244;651;593
46;Valencia/València;233;Sollana;4469;2162;2307
46;Valencia/València;234;Sot de Chera;325;165;160
46;Valencia/València;235;Sueca;25173;12367;12806
46;Valencia/València;236;Sumacàrcer;1370;691;679
46;Valencia/València;237;Tavernes Blanques;8406;4133;4273
46;Valencia/València;238;Tavernes de la Valldigna;16300;8108;8192
46;Valencia/València;239;Teresa de Cofrentes;710;360;350
46;Valencia/València;240;Terrateig;202;103;99
46;Valencia/València;241;Titaguas;554;302;252
46;Valencia/València;242;Torrebaja;439;224;215
46;Valencia/València;243;Torrella;180;90;90
46;Valencia/València;244;Torrent;63616;31522;32094
46;Valencia/València;245;Torres Torres;421;206;215
46;Valencia/València;246;Tous;1199;582;617
46;Valencia/València;247;Tuéjar;1290;675;615
46;Valencia/València;248;Turís;4655;2377;2278
46;Valencia/València;249;Utiel;11822;5873;5949
46;Valencia/València;250;Valencia;739412;351211;388201
46;Valencia/València;251;Vallada;3064;1542;1522
46;Valencia/València;252;Vallanca;237;115;122
46;Valencia/València;253;Vallés;107;60;47
46;Valencia/València;254;Venta del Moro;1592;806;786
46;Valencia/València;256;Vilamarxant;5862;2988;2874
46;Valencia/València;255;Villalonga;3621;1804;1817
46;Valencia/València;257;Villanueva de Castellón;6930;3420;3510
46;Valencia/València;258;Villar del Arzobispo;3441;1715;1726
46;Valencia/València;259;Villargordo del Cabriel;710;366;344
46;Valencia/València;260;Vinalesa;2294;1089;1205
46;Valencia/València;145;Xàtiva;25365;12319;13046
46;Valencia/València;143;Xeraco;4888;2445;2443
46;Valencia/València;146;Xeresa;1879;949;930
46;Valencia/València;110;Xirivella;25957;12787;13170
46;Valencia/València;261;Yátova;1987;1028;959
46;Valencia/València;262;Yesa (La);282;144;138
46;Valencia/València;263;Zarra;425;227;198
47;Valladolid;001;Adalia;87;45;42
47;Valladolid;002;Aguasal;25;13;12
47;Valladolid;003;Aguilar de Campos;366;191;175
47;Valladolid;004;Alaejos;1666;863;803
47;Valladolid;005;Alcazarén;721;385;336
47;Valladolid;006;Aldea de San Miguel;240;121;119
47;Valladolid;007;Aldeamayor de San Martín;1379;697;682
47;Valladolid;008;Almenara de Adaja;32;16;16
47;Valladolid;009;Amusquillo;178;96;82
47;Valladolid;010;Arroyo de la Encomienda;3098;1604;1494
47;Valladolid;011;Ataquines;891;463;428
47;Valladolid;012;Bahabón;200;100;100
47;Valladolid;013;Barcial de la Loma;161;81;80
47;Valladolid;014;Barruelo del Valle;74;40;34
47;Valladolid;015;Becilla de Valderaduey;439;237;202
47;Valladolid;016;Benafarces;107;51;56
47;Valladolid;017;Bercero;292;154;138
47;Valladolid;018;Berceruelo;43;23;20
47;Valladolid;019;Berrueces;103;56;47
47;Valladolid;020;Bobadilla del Campo;407;209;198
47;Valladolid;021;Bocigas;153;75;78
47;Valladolid;022;Bocos de Duero;77;33;44
47;Valladolid;023;Boecillo;1539;801;738
47;Valladolid;024;Bolaños de Campos;386;198;188
47;Valladolid;025;Brahojos de Medina;182;102;80
47;Valladolid;026;Bustillo de Chaves;95;47;48
47;Valladolid;027;Cabezón de Pisuerga;1781;914;867
47;Valladolid;028;Cabezón de Valderaduey;55;29;26
47;Valladolid;029;Cabreros del Monte;98;54;44
47;Valladolid;030;Campaspero;1488;773;715
47;Valladolid;031;Campillo (El);251;142;109
47;Valladolid;032;Camporredondo;214;119;95
47;Valladolid;033;Canalejas de Peñafiel;299;150;149
47;Valladolid;034;Canillas de Esgueva;134;70;64
47;Valladolid;035;Carpio;1204;635;569
47;Valladolid;036;Casasola de Arión;386;210;176
47;Valladolid;037;Castrejón de Trabancos;272;145;127
47;Valladolid;038;Castrillo de Duero;212;101;111
47;Valladolid;039;Castrillo-Tejeriego;271;143;128
47;Valladolid;040;Castrobol;89;41;48
47;Valladolid;041;Castrodeza;250;137;113
47;Valladolid;042;Castromembibre;90;48;42
47;Valladolid;043;Castromonte;462;239;223
47;Valladolid;044;Castronuevo de Esgueva;311;163;148
47;Valladolid;045;Castronuño;1087;544;543
47;Valladolid;046;Castroponce;207;107;100
47;Valladolid;047;Castroverde de Cerrato;275;161;114
47;Valladolid;048;Ceinos de Campos;275;147;128
47;Valladolid;049;Cervillego de la Cruz;155;78;77
47;Valladolid;050;Cigales;2881;1413;1468
47;Valladolid;051;Ciguñuela;379;199;180
47;Valladolid;052;Cistérniga;3206;1680;1526
47;Valladolid;053;Cogeces de Íscar;153;83;70
47;Valladolid;054;Cogeces del Monte;956;512;444
47;Valladolid;055;Corcos;272;140;132
47;Valladolid;056;Corrales de Duero;141;83;58
47;Valladolid;057;Cubillas de Santa Marta;274;147;127
47;Valladolid;058;Cuenca de Campos;302;150;152
47;Valladolid;059;Curiel de Duero;126;71;55
47;Valladolid;060;Encinas de Esgueva;390;208;182
47;Valladolid;061;Esguevillas de Esgueva;432;222;210
47;Valladolid;062;Fombellida;294;149;145
47;Valladolid;063;Fompedraza;148;83;65
47;Valladolid;064;Fontihoyuelo;47;29;18
47;Valladolid;065;Fresno el Viejo;1287;657;630
47;Valladolid;066;Fuensaldaña;972;474;498
47;Valladolid;067;Fuente el Sol;305;158;147
47;Valladolid;068;Fuente-Olmedo;68;34;34
47;Valladolid;069;Gallegos de Hornija;152;76;76
47;Valladolid;070;Gatón de Campos;45;28;17
47;Valladolid;071;Geria;477;257;220
47;Valladolid;073;Herrín de Campos;214;100;114
47;Valladolid;074;Hornillos de Eresma;161;86;75
47;Valladolid;075;Íscar;6125;3080;3045
47;Valladolid;076;Laguna de Duero;15864;8021;7843
47;Valladolid;077;Langayo;473;250;223
47;Valladolid;079;Llano de Olmedo;97;51;46
47;Valladolid;078;Lomoviejo;264;129;135
47;Valladolid;080;Manzanillo;74;39;35
47;Valladolid;081;Marzales;76;37;39
47;Valladolid;082;Matapozuelos;1001;505;496
47;Valladolid;083;Matilla de los Caños;101;59;42
47;Valladolid;084;Mayorga;1720;824;896
47;Valladolid;086;Medina de Rioseco;5001;2445;2556
47;Valladolid;085;Medina del Campo;20023;9815;10208
47;Valladolid;087;Megeces;480;241;239
47;Valladolid;088;Melgar de Abajo;187;95;92
47;Valladolid;089;Melgar de Arriba;307;153;154
47;Valladolid;090;Mojados;2443;1223;1220
47;Valladolid;091;Monasterio de Vega;88;47;41
47;Valladolid;092;Montealegre de Campos;172;95;77
47;Valladolid;093;Montemayor de Pililla;1054;554;500
47;Valladolid;094;Moral de la Reina;240;120;120
47;Valladolid;095;Moraleja de las Panaderas;30;18;12
47;Valladolid;096;Morales de Campos;202;103;99
47;Valladolid;097;Mota del Marqués;453;216;237
47;Valladolid;098;Mucientes;613;308;305
47;Valladolid;099;Mudarra (La);274;148;126
47;Valladolid;100;Muriel;219;108;111
47;Valladolid;101;Nava del Rey;2287;1116;1171
47;Valladolid;102;Nueva Villa de las Torres;421;233;188
47;Valladolid;103;Olivares de Duero;348;192;156
47;Valladolid;104;Olmedo;3487;1682;1805
47;Valladolid;105;Olmos de Esgueva;189;105;84
47;Valladolid;106;Olmos de Peñafiel;86;43;43
47;Valladolid;109;Palazuelo de Vedija;252;130;122
47;Valladolid;110;Parrilla (La);639;312;327
47;Valladolid;111;Pedraja de Portillo (La);1083;541;542
47;Valladolid;112;Pedrajas de San Esteban;3229;1630;1599
47;Valladolid;113;Pedrosa del Rey;242;133;109
47;Valladolid;114;Peñafiel;5132;2584;2548
47;Valladolid;115;Peñaflor de Hornija;476;255;221
47;Valladolid;116;Pesquera de Duero;534;284;250
47;Valladolid;117;Piña de Esgueva;418;215;203
47;Valladolid;118;Piñel de Abajo;217;113;104
47;Valladolid;119;Piñel de Arriba;155;76;79
47;Valladolid;121;Pollos;827;425;402
47;Valladolid;122;Portillo;2532;1282;1250
47;Valladolid;123;Pozal de Gallinas;508;270;238
47;Valladolid;124;Pozaldez;524;258;266
47;Valladolid;125;Pozuelo de la Orden;79;45;34
47;Valladolid;126;Puras;62;29;33
47;Valladolid;127;Quintanilla de Arriba;229;121;108
47;Valladolid;129;Quintanilla de Onésimo;1190;618;572
47;Valladolid;130;Quintanilla de Trigueros;109;56;53
47;Valladolid;128;Quintanilla del Molar;83;35;48
47;Valladolid;131;Rábano;253;127;126
47;Valladolid;132;Ramiro;83;48;35
47;Valladolid;133;Renedo de Esgueva;961;495;466
47;Valladolid;134;Roales de Campos;254;128;126
47;Valladolid;135;Robladillo;107;53;54
47;Valladolid;137;Roturas;28;15;13
47;Valladolid;138;Rubí de Bracamonte;340;177;163
47;Valladolid;139;Rueda;1495;764;731
47;Valladolid;140;Saelices de Mayorga;195;101;94
47;Valladolid;141;Salvador de Zapardiel;203;110;93
47;Valladolid;142;San Cebrián de Mazote;234;126;108
47;Valladolid;143;San Llorente;209;112;97
47;Valladolid;144;San Martín de Valvení;118;69;49
47;Valladolid;145;San Miguel del Arroyo;814;428;386
47;Valladolid;146;San Miguel del Pino;234;124;110
47;Valladolid;147;San Pablo de la Moraleja;182;98;84
47;Valladolid;148;San Pedro de Latarce;664;358;306
47;Valladolid;149;San Pelayo;40;20;20
47;Valladolid;150;San Román de Hornija;454;223;231
47;Valladolid;151;San Salvador;50;26;24
47;Valladolid;156;San Vicente del Palacio;252;130;122
47;Valladolid;152;Santa Eufemia del Arroyo;137;67;70
47;Valladolid;153;Santervás de Campos;172;91;81
47;Valladolid;154;Santibáñez de Valcorba;240;127;113
47;Valladolid;155;Santovenia de Pisuerga;2109;1072;1037
47;Valladolid;157;Sardón de Duero;641;328;313
47;Valladolid;158;Seca (La);1066;576;490
47;Valladolid;159;Serrada;1037;530;507
47;Valladolid;160;Siete Iglesias de Trabancos;633;328;305
47;Valladolid;161;Simancas;3105;1578;1527
47;Valladolid;162;Tamariz de Campos;105;54;51
47;Valladolid;163;Tiedra;419;205;214
47;Valladolid;164;Tordehumos;569;289;280
47;Valladolid;165;Tordesillas;8002;4054;3948
47;Valladolid;169;Torre de Esgueva;111;54;57
47;Valladolid;170;Torre de Peñafiel;49;27;22
47;Valladolid;166;Torrecilla de la Abadesa;384;200;184
47;Valladolid;167;Torrecilla de la Orden;383;191;192
47;Valladolid;168;Torrecilla de la Torre;38;22;16
47;Valladolid;171;Torrelobatón;583;287;296
47;Valladolid;172;Torrescárcela;169;90;79
47;Valladolid;173;Traspinedo;821;419;402
47;Valladolid;174;Trigueros del Valle;294;150;144
47;Valladolid;175;Tudela de Duero;6170;3172;2998
47;Valladolid;176;Unión de Campos (La);318;156;162
47;Valladolid;177;Urones de Castroponce;157;88;69
47;Valladolid;178;Urueña;217;112;105
47;Valladolid;179;Valbuena de Duero;529;276;253
47;Valladolid;180;Valdearcos de la Vega;144;70;74
47;Valladolid;181;Valdenebro de los Valles;244;125;119
47;Valladolid;182;Valdestillas;1563;790;773
47;Valladolid;183;Valdunquillo;229;108;121
47;Valladolid;186;Valladolid;319998;153922;166076
47;Valladolid;184;Valoria la Buena;651;339;312
47;Valladolid;185;Valverde de Campos;118;62;56
47;Valladolid;187;Vega de Ruiponce;143;68;75
47;Valladolid;188;Vega de Valdetronco;196;104;92
47;Valladolid;189;Velascálvaro;197;102;95
47;Valladolid;190;Velilla;153;78;75
47;Valladolid;191;Velliza;168;96;72
47;Valladolid;192;Ventosa de la Cuesta;163;87;76
47;Valladolid;193;Viana de Cega;1525;773;752
47;Valladolid;195;Villabáñez;490;262;228
47;Valladolid;196;Villabaruz de Campos;54;27;27
47;Valladolid;197;Villabrágima;1221;632;589
47;Valladolid;198;Villacarralón;116;59;57
47;Valladolid;199;Villacid de Campos;116;60;56
47;Valladolid;200;Villaco;136;80;56
47;Valladolid;203;Villafrades de Campos;116;53;63
47;Valladolid;204;Villafranca de Duero;389;196;193
47;Valladolid;205;Villafrechós;533;275;258
47;Valladolid;206;Villafuerte;151;75;76
47;Valladolid;207;Villagarcía de Campos;453;243;210
47;Valladolid;208;Villagómez la Nueva;106;49;57
47;Valladolid;209;Villalán de Campos;58;27;31
47;Valladolid;210;Villalar de los Comuneros;500;239;261
47;Valladolid;211;Villalba de la Loma;49;27;22
47;Valladolid;212;Villalba de los Alcores;566;297;269
47;Valladolid;213;Villalbarba;172;85;87
47;Valladolid;214;Villalón de Campos;2168;1050;1118
47;Valladolid;215;Villamuriel de Campos;94;45;49
47;Valladolid;216;Villán de Tordesillas;184;92;92
47;Valladolid;217;Villanubla;921;480;441
47;Valladolid;218;Villanueva de Duero;973;503;470
47;Valladolid;219;Villanueva de la Condesa;41;24;17
47;Valladolid;220;Villanueva de los Caballeros;285;138;147
47;Valladolid;221;Villanueva de los Infantes;150;78;72
47;Valladolid;222;Villanueva de San Mancio;118;63;55
47;Valladolid;223;Villardefrades;239;123;116
47;Valladolid;224;Villarmentero de Esgueva;136;68;68
47;Valladolid;225;Villasexmir;125;65;60
47;Valladolid;226;Villavaquerín;228;122;106
47;Valladolid;227;Villavellid;68;38;30
47;Valladolid;228;Villaverde de Medina;595;320;275
47;Valladolid;229;Villavicencio de los Caballeros;335;153;182
47;Valladolid;194;Viloria;383;205;178
47;Valladolid;230;Wamba;390;210;180
47;Valladolid;231;Zaratán;1243;644;599
47;Valladolid;232;Zarza (La);164;83;81
48;Vizcaya;001;Abadiño;6858;3440;3418
48;Vizcaya;002;Abanto y Ciérvana-Abanto Zierbena;8920;4395;4525
48;Vizcaya;911;Ajangiz;416;214;202
48;Vizcaya;912;Alonsotegi;2775;1349;1426
48;Vizcaya;003;Amorebieta-Etxano;16243;8080;8163
48;Vizcaya;004;Amoroto;364;192;172
48;Vizcaya;005;Arakaldo;88;52;36
48;Vizcaya;006;Arantzazu;270;130;140
48;Vizcaya;093;Areatza;1044;471;573
48;Vizcaya;009;Arrankudiaga;745;352;393
48;Vizcaya;914;Arratzu;395;191;204
48;Vizcaya;010;Arrieta;488;239;249
48;Vizcaya;011;Arrigorriaga;10531;5180;5351
48;Vizcaya;023;Artea;616;293;323
48;Vizcaya;008;Artzentales;670;364;306
48;Vizcaya;091;Atxondo;1460;733;727
48;Vizcaya;070;Aulesti;647;337;310
48;Vizcaya;012;Bakio;1587;806;781
48;Vizcaya;090;Balmaseda;7106;3419;3687
48;Vizcaya;013;Barakaldo;98212;48009;50203
48;Vizcaya;014;Barrika;1106;566;540
48;Vizcaya;015;Basauri;47575;23558;24017
48;Vizcaya;092;Bedia;984;495;489
48;Vizcaya;016;Berango;4823;2386;2437
48;Vizcaya;017;Bermeo;17011;8359;8652
48;Vizcaya;018;Berriatua;940;486;454
48;Vizcaya;019;Berriz;4123;2086;2037
48;Vizcaya;020;Bilbao;357589;169755;187834
48;Vizcaya;021;Busturia;1654;842;812
48;Vizcaya;901;Derio;4609;2295;2314
48;Vizcaya;026;Dima;1054;533;521
48;Vizcaya;027;Durango;24515;11997;12518
48;Vizcaya;028;Ea;818;403;415
48;Vizcaya;031;Elantxobe;470;209;261
48;Vizcaya;032;Elorrio;7233;3629;3604
48;Vizcaya;902;Erandio;23207;11405;11802
48;Vizcaya;033;Ereño;259;130;129
48;Vizcaya;034;Ermua;17260;8798;8462
48;Vizcaya;079;Errigoiti;462;257;205
48;Vizcaya;029;Etxebarri, Anteiglesia de San Esteban-Etxebarri Doneztebeko Elizatea;6597;3357;3240
48;Vizcaya;030;Etxebarria;804;419;385
48;Vizcaya;906;Forua;986;495;491
48;Vizcaya;035;Fruiz;328;162;166
48;Vizcaya;036;Galdakao;29417;14589;14828
48;Vizcaya;037;Galdames;782;407;375
48;Vizcaya;038;Gamiz-Fika;1085;552;533
48;Vizcaya;039;Garay;240;122;118
48;Vizcaya;040;Gatika;1216;618;598
48;Vizcaya;041;Gautegiz Arteaga;811;402;409
48;Vizcaya;046;Gernika-Lumo;15491;7519;7972
48;Vizcaya;044;Getxo;83459;39893;43566
48;Vizcaya;047;Gizaburuaga;140;69;71
48;Vizcaya;042;Gordexola;1445;719;726
48;Vizcaya;043;Gorliz;3970;1982;1988
48;Vizcaya;045;Güeñes;5859;2891;2968
48;Vizcaya;048;Ibarrangelu;515;242;273
48;Vizcaya;094;Igorre;3938;1974;1964
48;Vizcaya;049;Ispaster;620;329;291
48;Vizcaya;910;Iurreta;4329;2144;2185
48;Vizcaya;050;Izurtza;272;134;138
48;Vizcaya;022;Karrantza Harana/Valle de Carranza;3037;1593;1444
48;Vizcaya;907;Kortezubi;362;192;170
48;Vizcaya;051;Lanestosa;291;149;142
48;Vizcaya;052;Larrabetzu;1550;778;772
48;Vizcaya;053;Laukiz;946;493;453
48;Vizcaya;054;Leioa;27645;13675;13970
48;Vizcaya;057;Lekeitio;7443;3662;3781
48;Vizcaya;055;Lemoa;2487;1236;1251
48;Vizcaya;056;Lemoiz;898;475;423
48;Vizcaya;081;Lezama;2109;1054;1055
48;Vizcaya;903;Loiu;1898;946;952
48;Vizcaya;058;Mallabia;1102;583;519
48;Vizcaya;059;Mañaria;476;251;225
48;Vizcaya;060;Markina-Xemein;4699;2332;2367
48;Vizcaya;061;Maruri-Jatabe;589;289;300
48;Vizcaya;062;Mendata;333;176;157
48;Vizcaya;063;Mendexa;337;180;157
48;Vizcaya;064;Meñaka;493;247;246
48;Vizcaya;066;Morga;384;213;171
48;Vizcaya;068;Mundaka;1787;848;939
48;Vizcaya;069;Mungia;13396;6590;6806
48;Vizcaya;007;Munitibar-Arbatzegi Gerrikaitz;386;207;179
48;Vizcaya;908;Murueta;218;116;102
48;Vizcaya;071;Muskiz;6196;3055;3141
48;Vizcaya;067;Muxika;1374;709;665
48;Vizcaya;909;Nabarniz;232;113;119
48;Vizcaya;073;Ondarroa;10013;5001;5012
48;Vizcaya;075;Orozko;1963;981;982
48;Vizcaya;083;Ortuella;8791;4293;4498
48;Vizcaya;072;Otxandio;1016;535;481
48;Vizcaya;077;Plentzia;3463;1654;1809
48;Vizcaya;078;Portugalete;53241;26053;27188
48;Vizcaya;082;Santurtzi;48515;23801;24714
48;Vizcaya;084;Sestao;33288;16204;17084
48;Vizcaya;904;Sondika;3854;1861;1993
48;Vizcaya;085;Sopelana;9917;4951;4966
48;Vizcaya;086;Sopuerta;2229;1120;1109
48;Vizcaya;076;Sukarrieta;329;168;161
48;Vizcaya;087;Trucios-Turtzioz;544;266;278
48;Vizcaya;088;Ubide;168;81;87
48;Vizcaya;065;Ugao-Miraballes;4158;2089;2069
48;Vizcaya;089;Urduliz;2923;1466;1457
48;Vizcaya;074;Urduña-Orduña;3876;1984;1892
48;Vizcaya;080;Valle de Trápaga-Trapagaran;12609;6232;6377
48;Vizcaya;095;Zaldibar;2897;1399;1498
48;Vizcaya;096;Zalla;7640;3758;3882
48;Vizcaya;905;Zamudio;2953;1482;1471
48;Vizcaya;097;Zaratamo;1649;841;808
48;Vizcaya;024;Zeanuri;1173;606;567
48;Vizcaya;025;Zeberio;930;481;449
48;Vizcaya;913;Zierbena;1180;625;555
48;Vizcaya;915;Ziortza-Bolibar;"";"";""
49;Zamora;002;Abezames;112;56;56
49;Zamora;003;Alcañices;1151;575;576
49;Zamora;004;Alcubilla de Nogales;210;102;108
49;Zamora;005;Alfaraz de Sayago;216;117;99
49;Zamora;006;Algodre;209;108;101
49;Zamora;007;Almaraz de Duero;479;237;242
49;Zamora;008;Almeida de Sayago;680;345;335
49;Zamora;009;Andavías;515;253;262
49;Zamora;010;Arcenillas;290;145;145
49;Zamora;011;Arcos de la Polvorosa;304;162;142
49;Zamora;012;Argañín;105;45;60
49;Zamora;013;Argujillo;384;200;184
49;Zamora;014;Arquillinos;188;96;92
49;Zamora;015;Arrabalde;399;188;211
49;Zamora;016;Aspariegos;383;187;196
49;Zamora;017;Asturianos;360;182;178
49;Zamora;018;Ayoó de Vidriales;491;240;251
49;Zamora;019;Barcial del Barco;310;172;138
49;Zamora;020;Belver de los Montes;501;261;240
49;Zamora;021;Benavente;16452;8018;8434
49;Zamora;022;Benegiles;427;225;202
49;Zamora;023;Bermillo de Sayago;1496;782;714
49;Zamora;024;Bóveda de Toro (La);1007;511;496
49;Zamora;025;Bretó;253;131;122
49;Zamora;026;Bretocino;332;177;155
49;Zamora;027;Brime de Sog;258;119;139
49;Zamora;028;Brime de Urz;157;85;72
49;Zamora;029;Burganes de Valverde;916;470;446
49;Zamora;030;Bustillo del Oro;163;82;81
49;Zamora;031;Cabañas de Sayago;199;96;103
49;Zamora;032;Calzadilla de Tera;516;247;269
49;Zamora;033;Camarzana de Tera;1083;539;544
49;Zamora;034;Cañizal;639;339;300
49;Zamora;035;Cañizo;328;166;162
49;Zamora;036;Carbajales de Alba;696;340;356
49;Zamora;037;Carbellino;275;141;134
49;Zamora;038;Casaseca de Campeán;165;86;79
49;Zamora;039;Casaseca de las Chanas;365;182;183
49;Zamora;040;Castrillo de la Guareña;166;81;85
49;Zamora;041;Castrogonzalo;560;301;259
49;Zamora;042;Castronuevo;356;181;175
49;Zamora;043;Castroverde de Campos;409;207;202
49;Zamora;044;Cazurra;100;55;45
49;Zamora;046;Cerecinos de Campos;443;230;213
49;Zamora;047;Cerecinos del Carrizal;165;88;77
49;Zamora;048;Cernadilla;182;87;95
49;Zamora;050;Cobreros;835;418;417
49;Zamora;052;Coomonte;342;180;162
49;Zamora;053;Coreses;1206;621;585
49;Zamora;054;Corrales;1150;554;596
49;Zamora;055;Cotanes del Monte;166;88;78
49;Zamora;056;Cubillos;394;201;193
49;Zamora;057;Cubo de Benavente;187;100;87
49;Zamora;058;Cubo de Tierra del Vino (El);477;245;232
49;Zamora;059;Cuelgamures;145;80;65
49;Zamora;061;Entrala;168;86;82
49;Zamora;062;Espadañedo;233;118;115
49;Zamora;063;Faramontanos de Tábara;510;256;254
49;Zamora;064;Fariza;720;363;357
49;Zamora;065;Fermoselle;1646;824;822
49;Zamora;066;Ferreras de Abajo;624;302;322
49;Zamora;067;Ferreras de Arriba;536;272;264
49;Zamora;068;Ferreruela;686;357;329
49;Zamora;069;Figueruela de Arriba;579;281;298
49;Zamora;071;Fonfría;1187;609;578
49;Zamora;075;Fresno de la Polvorosa;220;103;117
49;Zamora;076;Fresno de la Ribera;428;237;191
49;Zamora;077;Fresno de Sayago;283;142;141
49;Zamora;078;Friera de Valverde;280;144;136
49;Zamora;079;Fuente Encalada;156;78;78
49;Zamora;080;Fuentelapeña;1070;549;521
49;Zamora;082;Fuentes de Ropel;602;304;298
49;Zamora;081;Fuentesaúco;1875;943;932
49;Zamora;083;Fuentesecas;90;42;48
49;Zamora;084;Fuentespreadas;415;228;187
49;Zamora;085;Galende;1401;689;712
49;Zamora;086;Gallegos del Pan;169;87;82
49;Zamora;087;Gallegos del Río;868;458;410
49;Zamora;088;Gamones;102;60;42
49;Zamora;090;Gema;270;134;136
49;Zamora;091;Granja de Moreruela;392;191;201
49;Zamora;092;Granucillo;267;135;132
49;Zamora;093;Guarrate;390;211;179
49;Zamora;094;Hermisende;454;244;210
49;Zamora;095;Hiniesta (La);389;187;202
49;Zamora;096;Jambrina;271;134;137
49;Zamora;097;Justel;179;95;84
49;Zamora;098;Losacino;360;193;167
49;Zamora;099;Losacio;170;92;78
49;Zamora;100;Lubián;389;191;198
49;Zamora;101;Luelmo;257;130;127
49;Zamora;102;Maderal (El);312;159;153
49;Zamora;103;Madridanos;576;291;285
49;Zamora;104;Mahide;573;295;278
49;Zamora;105;Maire de Castroponce;252;131;121
49;Zamora;107;Malva;239;119;120
49;Zamora;108;Manganeses de la Lampreana;801;407;394
49;Zamora;109;Manganeses de la Polvorosa;892;440;452
49;Zamora;110;Manzanal de Arriba;471;236;235
49;Zamora;112;Manzanal de los Infantes;190;101;89
49;Zamora;111;Manzanal del Barco;203;110;93
49;Zamora;113;Matilla de Arzón;268;145;123
49;Zamora;114;Matilla la Seca;70;35;35
49;Zamora;115;Mayalde;240;119;121
49;Zamora;116;Melgar de Tera;603;296;307
49;Zamora;117;Micereces de Tera;657;336;321
49;Zamora;118;Milles de la Polvorosa;279;135;144
49;Zamora;119;Molacillos;319;166;153
49;Zamora;120;Molezuelas de la Carballeda;116;57;59
49;Zamora;121;Mombuey;479;237;242
49;Zamora;122;Monfarracinos;584;315;269
49;Zamora;123;Montamarta;689;330;359
49;Zamora;124;Moral de Sayago;391;210;181
49;Zamora;126;Moraleja de Sayago;297;156;141
49;Zamora;125;Moraleja del Vino;1252;658;594
49;Zamora;128;Morales de Rey;776;371;405
49;Zamora;129;Morales de Toro;1112;561;551
49;Zamora;130;Morales de Valverde;315;150;165
49;Zamora;127;Morales del Vino;1576;810;766
49;Zamora;131;Moralina;387;197;190
49;Zamora;132;Moreruela de los Infanzones;485;254;231
49;Zamora;133;Moreruela de Tábara;545;280;265
49;Zamora;134;Muelas de los Caballeros;250;132;118
49;Zamora;135;Muelas del Pan;906;441;465
49;Zamora;136;Muga de Sayago;517;251;266
49;Zamora;137;Navianos de Valverde;267;143;124
49;Zamora;138;Olmillos de Castro;437;225;212
49;Zamora;139;Otero de Bodas;279;151;128
49;Zamora;141;Pajares de la Lampreana;515;262;253
49;Zamora;143;Palacios de Sanabria;347;169;178
49;Zamora;142;Palacios del Pan;255;114;141
49;Zamora;145;Pedralba de la Pradería;306;145;161
49;Zamora;146;Pego (El);466;236;230
49;Zamora;147;Peleagonzalo;461;236;225
49;Zamora;148;Peleas de Abajo;271;120;151
49;Zamora;149;Peñausende;598;303;295
49;Zamora;150;Peque;224;111;113
49;Zamora;151;Perdigón (El);798;408;390
49;Zamora;152;Pereruela;755;376;379
49;Zamora;153;Perilla de Castro;263;129;134
49;Zamora;154;Pías;248;126;122
49;Zamora;155;Piedrahita de Castro;160;84;76
49;Zamora;156;Pinilla de Toro;388;193;195
49;Zamora;157;Pino del Oro;249;134;115
49;Zamora;158;Piñero (El);322;170;152
49;Zamora;160;Pobladura de Valderaduey;82;39;43
49;Zamora;159;Pobladura del Valle;327;159;168
49;Zamora;162;Porto;345;179;166
49;Zamora;163;Pozoantiguo;349;174;175
49;Zamora;164;Pozuelo de Tábara;252;123;129
49;Zamora;165;Prado;103;52;51
49;Zamora;166;Puebla de Sanabria;1699;817;882
49;Zamora;167;Pueblica de Valverde;326;164;162
49;Zamora;170;Quintanilla de Urz;155;79;76
49;Zamora;168;Quintanilla del Monte;153;68;85
49;Zamora;169;Quintanilla del Olmo;63;28;35
49;Zamora;171;Quiruelas de Vidriales;1001;470;531
49;Zamora;172;Rabanales;876;450;426
49;Zamora;173;Rábano de Aliste;502;251;251
49;Zamora;174;Requejo;216;97;119
49;Zamora;175;Revellinos;347;189;158
49;Zamora;176;Riofrío de Aliste;1102;570;532
49;Zamora;177;Rionegro del Puente;404;201;203
49;Zamora;178;Roales;397;203;194
49;Zamora;179;Robleda-Cervantes;461;221;240
49;Zamora;180;Roelos de Sayago;170;89;81
49;Zamora;181;Rosinos de la Requejada;527;252;275
49;Zamora;183;Salce;151;83;68
49;Zamora;184;Samir de los Caños;245;127;118
49;Zamora;185;San Agustín del Pozo;214;113;101
49;Zamora;186;San Cebrián de Castro;401;189;212
49;Zamora;187;San Cristóbal de Entreviñas;1642;832;810
49;Zamora;188;San Esteban del Molar;185;98;87
49;Zamora;189;San Justo;388;187;201
49;Zamora;190;San Martín de Valderaduey;106;49;57
49;Zamora;191;San Miguel de la Ribera;412;206;206
49;Zamora;192;San Miguel del Valle;245;113;132
49;Zamora;193;San Pedro de Ceque;719;353;366
49;Zamora;194;San Pedro de la Nave-Almendra;532;260;272
49;Zamora;208;San Vicente de la Cabeza;636;331;305
49;Zamora;209;San Vitero;744;389;355
49;Zamora;197;Santa Clara de Avedillo;260;126;134
49;Zamora;199;Santa Colomba de las Monjas;337;173;164
49;Zamora;200;Santa Cristina de la Polvorosa;1294;664;630
49;Zamora;201;Santa Croya de Tera;498;248;250
49;Zamora;202;Santa Eufemia del Barco;307;169;138
49;Zamora;203;Santa María de la Vega;509;267;242
49;Zamora;204;Santa María de Valverde;104;48;56
49;Zamora;205;Santibáñez de Tera;592;297;295
49;Zamora;206;Santibáñez de Vidriales;1418;696;722
49;Zamora;207;Santovenia;434;206;228
49;Zamora;210;Sanzoles;717;368;349
49;Zamora;214;Tábara;984;502;482
49;Zamora;216;Tapioles;256;136;120
49;Zamora;219;Toro;9396;4558;4838
49;Zamora;220;Torre del Valle (La);191;104;87
49;Zamora;221;Torregamones;343;169;174
49;Zamora;222;Torres del Carrizal;531;276;255
49;Zamora;223;Trabazos;959;480;479
49;Zamora;224;Trefacio;247;122;125
49;Zamora;225;Uña de Quintana;239;119;120
49;Zamora;226;Vadillo de la Guareña;374;194;180
49;Zamora;227;Valcabado;360;184;176
49;Zamora;228;Valdefinjas;102;59;43
49;Zamora;229;Valdescorriel;189;95;94
49;Zamora;230;Vallesa de la Guareña;185;99;86
49;Zamora;231;Vega de Tera;528;249;279
49;Zamora;232;Vega de Villalobos;168;76;92
49;Zamora;233;Vegalatrave;159;83;76
49;Zamora;234;Venialbo;547;285;262
49;Zamora;235;Vezdemarbán;722;350;372
49;Zamora;236;Vidayanes;119;57;62
49;Zamora;237;Videmala;218;104;114
49;Zamora;238;Villabrázaro;392;198;194
49;Zamora;239;Villabuena del Puente;999;526;473
49;Zamora;240;Villadepera;285;135;150
49;Zamora;241;Villaescusa;383;196;187
49;Zamora;242;Villafáfila;662;327;335
49;Zamora;243;Villaferrueña;161;83;78
49;Zamora;244;Villageriz;74;40;34
49;Zamora;245;Villalazán;396;195;201
49;Zamora;246;Villalba de la Lampreana;331;174;157
49;Zamora;247;Villalcampo;703;345;358
49;Zamora;248;Villalobos;322;152;170
49;Zamora;249;Villalonso;138;68;70
49;Zamora;250;Villalpando;1749;860;889
49;Zamora;251;Villalube;326;166;160
49;Zamora;252;Villamayor de Campos;561;286;275
49;Zamora;255;Villamor de los Escuderos;593;296;297
49;Zamora;256;Villanázar;388;182;206
49;Zamora;257;Villanueva de Azoague;390;196;194
49;Zamora;258;Villanueva de Campeán;194;96;98
49;Zamora;259;Villanueva de las Peras;195;97;98
49;Zamora;260;Villanueva del Campo;1102;550;552
49;Zamora;263;Villar de Fallaves;108;56;52
49;Zamora;264;Villar del Buey;887;481;406
49;Zamora;261;Villaralbo;1593;791;802
49;Zamora;262;Villardeciervos;527;248;279
49;Zamora;265;Villardiegua de la Ribera;177;86;91
49;Zamora;266;Villárdiga;114;59;55
49;Zamora;267;Villardondiego;135;73;62
49;Zamora;268;Villarrín de Campos;663;341;322
49;Zamora;269;Villaseco del Pan;340;168;172
49;Zamora;270;Villavendimio;207;115;92
49;Zamora;272;Villaveza de Valverde;149;76;73
49;Zamora;271;Villaveza del Agua;278;144;134
49;Zamora;273;Viñas;294;147;147
49;Zamora;275;Zamora;64906;30796;34110
50;Zaragoza;001;Abanto;184;98;86
50;Zaragoza;002;Acered;273;140;133
50;Zaragoza;003;Agón;192;102;90
50;Zaragoza;004;Aguarón;753;370;383
50;Zaragoza;005;Aguilón;277;135;142
50;Zaragoza;006;Ainzón;1233;628;605
50;Zaragoza;007;Aladrén;62;34;28
50;Zaragoza;008;Alagón;5616;2794;2822
50;Zaragoza;009;Alarba;160;91;69
50;Zaragoza;010;Alberite de San Juan;98;51;47
50;Zaragoza;011;Albeta;120;58;62
50;Zaragoza;012;Alborge;139;71;68
50;Zaragoza;013;Alcalá de Ebro;297;142;155
50;Zaragoza;014;Alcalá de Moncayo;147;77;70
50;Zaragoza;015;Alconchel de Ariza;168;92;76
50;Zaragoza;016;Aldehuela de Liestos;59;31;28
50;Zaragoza;017;Alfajarín;1478;753;725
50;Zaragoza;018;Alfamén;1320;694;626
50;Zaragoza;019;Alforque;94;51;43
50;Zaragoza;020;Alhama de Aragón;1204;584;620
50;Zaragoza;021;Almochuel;45;25;20
50;Zaragoza;022;Almolda (La);701;351;350
50;Zaragoza;023;Almonacid de la Cuba;352;176;176
50;Zaragoza;024;Almonacid de la Sierra;866;453;413
50;Zaragoza;025;Almunia de Doña Godina (La);5438;2763;2675
50;Zaragoza;026;Alpartir;610;321;289
50;Zaragoza;027;Ambel;361;165;196
50;Zaragoza;028;Anento;102;62;40
50;Zaragoza;029;Aniñón;906;478;428
50;Zaragoza;030;Añón de Moncayo;312;181;131
50;Zaragoza;031;Aranda de Moncayo;242;130;112
50;Zaragoza;032;Arándiga;506;258;248
50;Zaragoza;033;Ardisa;76;41;35
50;Zaragoza;034;Ariza;1329;682;647
50;Zaragoza;035;Artieda;103;57;46
50;Zaragoza;036;Asín;105;51;54
50;Zaragoza;037;Atea;246;138;108
50;Zaragoza;038;Ateca;2044;1003;1041
50;Zaragoza;039;Azuara;723;382;341
50;Zaragoza;040;Badules;116;61;55
50;Zaragoza;041;Bagüés;47;26;21
50;Zaragoza;042;Balconchán;27;13;14
50;Zaragoza;043;Bárboles;330;174;156
50;Zaragoza;044;Bardallur;301;145;156
50;Zaragoza;045;Belchite;1639;840;799
50;Zaragoza;046;Belmonte de Gracián;300;161;139
50;Zaragoza;047;Berdejo;50;27;23
50;Zaragoza;048;Berrueco;42;24;18
50;Zaragoza;901;Biel;188;104;84
50;Zaragoza;050;Bijuesca;132;75;57
50;Zaragoza;051;Biota;1238;630;608
50;Zaragoza;052;Bisimbre;129;58;71
50;Zaragoza;053;Boquiñeni;1005;507;498
50;Zaragoza;054;Bordalba;101;59;42
50;Zaragoza;055;Borja;4235;2086;2149
50;Zaragoza;056;Botorrita;487;257;230
50;Zaragoza;057;Brea de Aragón;2031;1017;1014
50;Zaragoza;058;Bubierca;108;53;55
50;Zaragoza;059;Bujaraloz;1018;539;479
50;Zaragoza;060;Bulbuente;251;140;111
50;Zaragoza;061;Bureta;324;162;162
50;Zaragoza;062;Burgo de Ebro (El);1531;777;754
50;Zaragoza;063;Buste (El);107;57;50
50;Zaragoza;064;Cabañas de Ebro;526;273;253
50;Zaragoza;065;Cabolafuente;93;51;42
50;Zaragoza;066;Cadrete;1572;835;737
50;Zaragoza;067;Calatayud;17352;8291;9061
50;Zaragoza;068;Calatorao;2722;1407;1315
50;Zaragoza;069;Calcena;93;51;42
50;Zaragoza;070;Calmarza;95;48;47
50;Zaragoza;071;Campillo de Aragón;195;108;87
50;Zaragoza;072;Carenas;235;117;118
50;Zaragoza;073;Cariñena;2891;1483;1408
50;Zaragoza;074;Caspe;7845;3839;4006
50;Zaragoza;075;Castejón de Alarba;118;65;53
50;Zaragoza;076;Castejón de las Armas;142;71;71
50;Zaragoza;077;Castejón de Valdejasa;342;178;164
50;Zaragoza;078;Castiliscar;403;205;198
50;Zaragoza;079;Cervera de la Cañada;351;170;181
50;Zaragoza;080;Cerveruela;6;5;1
50;Zaragoza;081;Cetina;736;364;372
50;Zaragoza;092;Chiprana;381;188;193
50;Zaragoza;093;Chodes;124;60;64
50;Zaragoza;082;Cimballa;146;80;66
50;Zaragoza;083;Cinco Olivas;133;66;67
50;Zaragoza;084;Clarés de Ribota;102;53;49
50;Zaragoza;085;Codo;277;134;143
50;Zaragoza;086;Codos;287;168;119
50;Zaragoza;087;Contamina;55;29;26
50;Zaragoza;088;Cosuenda;425;219;206
50;Zaragoza;089;Cuarte de Huerva;1760;914;846
50;Zaragoza;090;Cubel;240;118;122
50;Zaragoza;091;Cuerlas (Las);97;49;48
50;Zaragoza;094;Daroca;2294;1144;1150
50;Zaragoza;095;Ejea de los Caballeros;15426;7844;7582
50;Zaragoza;096;Embid de Ariza;70;36;34
50;Zaragoza;098;Encinacorba;321;173;148
50;Zaragoza;099;Épila;3943;2042;1901
50;Zaragoza;100;Erla;474;225;249
50;Zaragoza;101;Escatrón;1327;652;675
50;Zaragoza;102;Fabara;1225;648;577
50;Zaragoza;104;Farlete;457;227;230
50;Zaragoza;105;Fayón;390;204;186
50;Zaragoza;106;Fayos (Los);191;102;89
50;Zaragoza;107;Figueruelas;1034;524;510
50;Zaragoza;108;Fombuena;20;14;6
50;Zaragoza;109;Frago (El);96;59;37
50;Zaragoza;110;Frasno (El);556;293;263
50;Zaragoza;111;Fréscano;264;129;135
50;Zaragoza;113;Fuendejalón;891;451;440
50;Zaragoza;114;Fuendetodos;175;92;83
50;Zaragoza;115;Fuentes de Ebro;3834;1985;1849
50;Zaragoza;116;Fuentes de Jiloca;366;194;172
50;Zaragoza;117;Gallocanta;181;94;87
50;Zaragoza;118;Gallur;2942;1491;1451
50;Zaragoza;119;Gelsa;1261;638;623
50;Zaragoza;120;Godojos;71;35;36
50;Zaragoza;121;Gotor;388;206;182
50;Zaragoza;122;Grisel;67;39;28
50;Zaragoza;123;Grisén;474;238;236
50;Zaragoza;124;Herrera de los Navarros;611;325;286
50;Zaragoza;125;Ibdes;583;291;292
50;Zaragoza;126;Illueca;3319;1624;1695
50;Zaragoza;128;Isuerre;64;36;28
50;Zaragoza;129;Jaraba;323;170;153
50;Zaragoza;130;Jarque;578;308;270
50;Zaragoza;131;Jaulín;305;158;147
50;Zaragoza;132;Joyosa (La);383;196;187
50;Zaragoza;133;Lagata;153;80;73
50;Zaragoza;134;Langa del Castillo;190;88;102
50;Zaragoza;135;Layana;145;70;75
50;Zaragoza;136;Lécera;850;411;439
50;Zaragoza;138;Lechón;53;32;21
50;Zaragoza;137;Leciñena;1378;693;685
50;Zaragoza;139;Letux;481;244;237
50;Zaragoza;140;Litago;184;106;78
50;Zaragoza;141;Lituénigo;117;57;60
50;Zaragoza;142;Lobera de Onsella;57;34;23
50;Zaragoza;143;Longares;884;464;420
50;Zaragoza;144;Longás;49;31;18
50;Zaragoza;146;Lucena de Jalón;252;128;124
50;Zaragoza;147;Luceni;1064;532;532
50;Zaragoza;148;Luesia;413;214;199
50;Zaragoza;149;Luesma;23;13;10
50;Zaragoza;150;Lumpiaque;938;483;455
50;Zaragoza;151;Luna;929;492;437
50;Zaragoza;152;Maella;2025;1022;1003
50;Zaragoza;153;Magallón;1220;659;561
50;Zaragoza;154;Mainar;185;100;85
50;Zaragoza;155;Malanquilla;127;66;61
50;Zaragoza;156;Maleján;304;159;145
50;Zaragoza;160;Mallén;2977;1530;1447
50;Zaragoza;157;Malón;463;239;224
50;Zaragoza;159;Maluenda;998;477;521
50;Zaragoza;161;Manchones;159;76;83
50;Zaragoza;162;Mara;217;110;107
50;Zaragoza;163;María de Huerva;922;450;472
50;Zaragoza;902;Marracos;128;66;62
50;Zaragoza;164;Mediana de Aragón;511;257;254
50;Zaragoza;165;Mequinenza;2532;1266;1266
50;Zaragoza;166;Mesones de Isuela;379;186;193
50;Zaragoza;167;Mezalocha;315;174;141
50;Zaragoza;168;Mianos;38;21;17
50;Zaragoza;169;Miedes de Aragón;521;269;252
50;Zaragoza;170;Monegrillo;538;297;241
50;Zaragoza;171;Moneva;111;54;57
50;Zaragoza;172;Monreal de Ariza;306;157;149
50;Zaragoza;173;Monterde;278;142;136
50;Zaragoza;174;Montón;144;72;72
50;Zaragoza;175;Morata de Jalón;1574;780;794
50;Zaragoza;176;Morata de Jiloca;350;187;163
50;Zaragoza;177;Morés;503;265;238
50;Zaragoza;178;Moros;533;265;268
50;Zaragoza;179;Moyuela;358;184;174
50;Zaragoza;180;Mozota;114;57;57
50;Zaragoza;181;Muel;1105;557;548
50;Zaragoza;182;Muela (La);1205;630;575
50;Zaragoza;183;Munébrega;483;253;230
50;Zaragoza;184;Murero;147;84;63
50;Zaragoza;185;Murillo de Gállego;164;98;66
50;Zaragoza;186;Navardún;61;32;29
50;Zaragoza;187;Nigüella;116;63;53
50;Zaragoza;188;Nombrevilla;35;16;19
50;Zaragoza;189;Nonaspe;1081;544;537
50;Zaragoza;190;Novallas;738;354;384
50;Zaragoza;191;Novillas;683;352;331
50;Zaragoza;192;Nuévalos;309;179;130
50;Zaragoza;193;Nuez de Ebro;574;301;273
50;Zaragoza;194;Olvés;176;92;84
50;Zaragoza;195;Orcajo;47;24;23
50;Zaragoza;196;Orera;134;68;66
50;Zaragoza;197;Orés;103;61;42
50;Zaragoza;198;Oseja;55;31;24
50;Zaragoza;199;Osera de Ebro;353;169;184
50;Zaragoza;200;Paniza;711;348;363
50;Zaragoza;201;Paracuellos de Jiloca;493;222;271
50;Zaragoza;202;Paracuellos de la Ribera;304;142;162
50;Zaragoza;203;Pastriz;971;470;501
50;Zaragoza;204;Pedrola;2588;1316;1272
50;Zaragoza;205;Pedrosas (Las);101;48;53
50;Zaragoza;206;Perdiguera;446;233;213
50;Zaragoza;207;Piedratajada;142;72;70
50;Zaragoza;208;Pina de Ebro;2221;1099;1122
50;Zaragoza;209;Pinseque;1500;749;751
50;Zaragoza;210;Pintanos (Los);96;48;48
50;Zaragoza;211;Plasencia de Jalón;369;201;168
50;Zaragoza;212;Pleitas;64;38;26
50;Zaragoza;213;Plenas;155;78;77
50;Zaragoza;214;Pomer;27;15;12
50;Zaragoza;215;Pozuel de Ariza;22;15;7
50;Zaragoza;216;Pozuelo de Aragón;347;190;157
50;Zaragoza;217;Pradilla de Ebro;653;341;312
50;Zaragoza;218;Puebla de Albortón;151;80;71
50;Zaragoza;219;Puebla de Alfindén (La);1657;848;809
50;Zaragoza;220;Puendeluna;61;35;26
50;Zaragoza;221;Purujosa;43;32;11
50;Zaragoza;222;Quinto;2149;1077;1072
50;Zaragoza;223;Remolinos;1248;625;623
50;Zaragoza;224;Retascón;77;44;33
50;Zaragoza;225;Ricla;1858;985;873
50;Zaragoza;227;Romanos;146;85;61
50;Zaragoza;228;Rueda de Jalón;366;187;179
50;Zaragoza;229;Ruesca;92;47;45
50;Zaragoza;241;Sabiñán;955;462;493
50;Zaragoza;230;Sádaba;1691;849;842
50;Zaragoza;231;Salillas de Jalón;358;191;167
50;Zaragoza;232;Salvatierra de Esca;289;148;141
50;Zaragoza;233;Samper del Salz;142;71;71
50;Zaragoza;234;San Martín de la Virgen de Moncayo;306;161;145
50;Zaragoza;235;San Mateo de Gállego;2069;1064;1005
50;Zaragoza;236;Santa Cruz de Grío;232;129;103
50;Zaragoza;237;Santa Cruz de Moncayo;116;53;63
50;Zaragoza;238;Santa Eulalia de Gállego;130;62;68
50;Zaragoza;239;Santed;77;37;40
50;Zaragoza;240;Sástago;1459;729;730
50;Zaragoza;242;Sediles;105;55;50
50;Zaragoza;243;Sestrica;481;246;235
50;Zaragoza;244;Sierra de Luna;259;132;127
50;Zaragoza;245;Sigüés;178;94;84
50;Zaragoza;246;Sisamón;83;49;34
50;Zaragoza;247;Sobradiel;621;310;311
50;Zaragoza;248;Sos del Rey Católico;813;405;408
50;Zaragoza;249;Tabuenca;480;260;220
50;Zaragoza;250;Talamantes;68;40;28
50;Zaragoza;251;Tarazona;10442;5039;5403
50;Zaragoza;252;Tauste;6977;3455;3522
50;Zaragoza;253;Terrer;665;318;347
50;Zaragoza;254;Tierga;257;142;115
50;Zaragoza;255;Tobed;278;138;140
50;Zaragoza;256;Torralba de los Frailes;106;52;54
50;Zaragoza;257;Torralba de Ribota;229;125;104
50;Zaragoza;258;Torralbilla;71;36;35
50;Zaragoza;259;Torrehermosa;115;63;52
50;Zaragoza;260;Torrelapaja;43;21;22
50;Zaragoza;261;Torrellas;317;162;155
50;Zaragoza;262;Torres de Berrellén;1401;702;699
50;Zaragoza;263;Torrijo de la Cañada;414;214;200
50;Zaragoza;264;Tosos;203;104;99
50;Zaragoza;265;Trasmoz;63;32;31
50;Zaragoza;266;Trasobares;234;122;112
50;Zaragoza;267;Uncastillo;919;451;468
50;Zaragoza;268;Undués de Lerda;52;32;20
50;Zaragoza;269;Urrea de Jalón;340;175;165
50;Zaragoza;270;Urriés;82;51;31
50;Zaragoza;271;Used;387;210;177
50;Zaragoza;272;Utebo;9758;4926;4832
50;Zaragoza;274;Val de San Martín;75;34;41
50;Zaragoza;273;Valdehorna;60;30;30
50;Zaragoza;275;Valmadrid;68;40;28
50;Zaragoza;276;Valpalmas;201;100;101
50;Zaragoza;277;Valtorres;99;48;51
50;Zaragoza;278;Velilla de Ebro;278;140;138
50;Zaragoza;279;Velilla de Jiloca;121;61;60
50;Zaragoza;280;Vera de Moncayo;480;248;232
50;Zaragoza;281;Vierlas;101;50;51
50;Zaragoza;283;Villadoz;86;48;38
50;Zaragoza;284;Villafeliche;235;118;117
50;Zaragoza;285;Villafranca de Ebro;681;326;355
50;Zaragoza;286;Villalba de Perejil;117;61;56
50;Zaragoza;287;Villalengua;433;226;207
50;Zaragoza;903;Villamayor de Gállego;"";"";""
50;Zaragoza;288;Villanueva de Gállego;2963;1503;1460
50;Zaragoza;290;Villanueva de Huerva;593;310;283
50;Zaragoza;289;Villanueva de Jiloca;121;60;61
50;Zaragoza;291;Villar de los Navarros;156;78;78
50;Zaragoza;292;Villarreal de Huerva;177;100;77
50;Zaragoza;293;Villarroya de la Sierra;690;356;334
50;Zaragoza;294;Villarroya del Campo;89;43;46
50;Zaragoza;282;Vilueña (La);95;39;56
50;Zaragoza;295;Vistabella;35;20;15
50;Zaragoza;296;Zaida (La);603;300;303
50;Zaragoza;297;Zaragoza;603367;290375;312992
50;Zaragoza;298;Zuera;5439;2795;2644
51;Ceuta;001;Ceuta;73704;37115;36589
52;Melilla;001;Melilla;56929;28952;27977
