01;Álava;001;Alegría-Dulantzi;996;505;491
01;Álava;002;Amurrio;9481;4752;4729
01;Álava;049;Añana;193;98;95
01;Álava;003;Aramaio;1351;709;642
01;Álava;006;Armiñón;156;79;77
01;Álava;037;Arraia-Maeztu;839;443;396
01;Álava;008;Arrazua-Ubarrundia;606;327;279
01;Álava;004;Artziniega;1165;573;592
01;Álava;009;Asparrena;1562;782;780
01;Álava;010;Ayala/Aiara;2133;1040;1093
01;Álava;011;Baños de Ebro/Mañueta;352;185;167
01;Álava;013;Barrundia;601;340;261
01;Álava;014;Berantevilla;429;218;211
01;Álava;016;Bernedo;596;334;262
01;Álava;017;Campezo/Kanpezu;1215;632;583
01;Álava;021;Elburgo/Burgelu;201;108;93
01;Álava;022;Elciego;914;461;453
01;Álava;023;Elvillar/Bilar;382;199;183
01;Álava;056;Harana/Valle de Arana;438;236;202
01;Álava;901;Iruña Oka/Iruña de Oca;1564;823;741
01;Álava;027;Iruraiz-Gauna;467;255;212
01;Álava;019;Kripan;202;107;95
01;Álava;020;Kuartango;340;186;154
01;Álava;028;Labastida;993;536;457
01;Álava;030;Lagrán;203;110;93
01;Álava;031;Laguardia;1502;780;722
01;Álava;032;Lanciego/Lantziego;607;324;283
01;Álava;902;Lantarón;859;444;415
01;Álava;033;Lapuebla de Labarca;841;423;418
01;Álava;058;Legutiano;1310;719;591
01;Álava;034;Leza;205;107;98
01;Álava;036;Llodio;21107;10743;10364
01;Álava;039;Moreda de Álava;287;153;134
01;Álava;041;Navaridas;223;118;105
01;Álava;042;Okondo;783;420;363
01;Álava;043;Oyón/Oion;2306;1150;1156
01;Álava;044;Peñacerrada-Urizaharra;236;132;104
01;Álava;046;Ribera Alta;540;316;224
01;Álava;047;Ribera Baja/Erribera Beitia;397;207;190
01;Álava;051;Salvatierra/Agurain;3611;1817;1794
01;Álava;052;Samaniego;305;154;151
01;Álava;053;San Millán/Donemiliaga;770;409;361
01;Álava;054;Urkabustaiz;876;447;429
01;Álava;055;Valdegovía;892;501;391
01;Álava;057;Villabuena de Álava/Eskuernaga;358;186;172
01;Álava;059;Vitoria-Gasteiz;200742;99637;101105
01;Álava;060;Yécora/Lekora;257;130;127
01;Álava;061;Zalduondo;121;65;56
01;Álava;062;Zambrana;348;182;166
01;Álava;018;Zigoitia;735;401;334
01;Álava;063;Zuia;1266;617;649
02;Albacete;001;Abengibre;1140;571;569
02;Albacete;002;Alatoz;805;423;382
02;Albacete;003;Albacete;125764;61977;63787
02;Albacete;004;Albatana;957;480;477
02;Albacete;005;Alborea;926;465;461
02;Albacete;006;Alcadozo;934;474;460
02;Albacete;007;Alcalá del Júcar;1839;937;902
02;Albacete;008;Alcaraz;2125;1049;1076
02;Albacete;009;Almansa;21720;10606;11114
02;Albacete;010;Alpera;2372;1217;1155
02;Albacete;011;Ayna;1509;763;746
02;Albacete;012;Balazote;2201;1107;1094
02;Albacete;014;Ballestero (El);793;391;402
02;Albacete;013;Balsa de Ves;318;158;160
02;Albacete;015;Barrax;2069;1026;1043
02;Albacete;016;Bienservida;1235;647;588
02;Albacete;017;Bogarra;1830;965;865
02;Albacete;018;Bonete;1303;658;645
02;Albacete;019;Bonillo (El);3469;1726;1743
02;Albacete;020;Carcelén;903;448;455
02;Albacete;021;Casas de Juan Núñez;1319;678;641
02;Albacete;022;Casas de Lázaro;553;291;262
02;Albacete;023;Casas de Ves;1356;688;668
02;Albacete;024;Casas-Ibáñez;3911;1966;1945
02;Albacete;025;Caudete;8142;4044;4098
02;Albacete;026;Cenizate;1101;566;535
02;Albacete;029;Chinchilla de Monte-Aragón;3540;1827;1713
02;Albacete;027;Corral-Rubio;575;294;281
02;Albacete;028;Cotillas;324;171;153
02;Albacete;030;Elche de la Sierra;4179;2040;2139
02;Albacete;032;Fuensanta;477;225;252
02;Albacete;033;Fuente-Álamo;2597;1330;1267
02;Albacete;034;Fuentealbilla;1932;994;938
02;Albacete;031;Férez;1004;498;506
02;Albacete;035;Gineta (La);2362;1140;1222
02;Albacete;036;Golosalvo;163;79;84
02;Albacete;037;Hellín;24487;12080;12407
02;Albacete;038;Herrera (La);476;260;216
02;Albacete;039;Higueruela;1423;706;717
02;Albacete;040;Hoya-Gonzalo;758;386;372
02;Albacete;041;Jorquera;817;431;386
02;Albacete;042;Letur;1793;923;870
02;Albacete;043;Lezuza;2221;1125;1096
02;Albacete;044;Liétor;2012;1042;970
02;Albacete;045;Madrigueras;4500;2255;2245
02;Albacete;046;Mahora;1492;741;751
02;Albacete;047;Masegoso;333;186;147
02;Albacete;048;Minaya;2120;1062;1058
02;Albacete;049;Molinicos;2007;1021;986
02;Albacete;050;Montalvos;177;93;84
02;Albacete;051;Montealegre del Castillo;2284;1134;1150
02;Albacete;052;Motilleja;556;271;285
02;Albacete;053;Munera;4306;2213;2093
02;Albacete;054;Navas de Jorquera;615;320;295
02;Albacete;055;Nerpio;2439;1276;1163
02;Albacete;056;Ontur;2817;1361;1456
02;Albacete;057;Ossa de Montiel;2831;1455;1376
02;Albacete;058;Paterna del Madera;717;379;338
02;Albacete;060;Peñas de San Pedro;1526;800;726
02;Albacete;059;Peñascosa;568;301;267
02;Albacete;061;Pétrola;1236;624;612
02;Albacete;062;Povedilla;817;426;391
02;Albacete;064;Pozo-Lorente;557;275;282
02;Albacete;063;Pozohondo;2165;1101;1064
02;Albacete;065;Pozuelo;730;364;366
02;Albacete;066;Recueja (La);477;248;229
02;Albacete;067;Riópar;1445;734;711
02;Albacete;068;Robledo;533;286;247
02;Albacete;069;Roda (La);12701;6342;6359
02;Albacete;070;Salobre;751;396;355
02;Albacete;071;San Pedro;1465;743;722
02;Albacete;072;Socovos;2405;1217;1188
02;Albacete;073;Tarazona de la Mancha;5945;2997;2948
02;Albacete;074;Tobarra;7499;3730;3769
02;Albacete;075;Valdeganga;2365;1188;1177
02;Albacete;076;Vianos;568;294;274
02;Albacete;077;Villa de Ves;49;26;23
02;Albacete;078;Villalgordo del Júcar;1339;657;682
02;Albacete;079;Villamalea;3443;1811;1632
02;Albacete;080;Villapalacios;1133;562;571
02;Albacete;081;Villarrobledo;20829;10276;10553
02;Albacete;082;Villatoya;240;134;106
02;Albacete;083;Villavaliente;361;181;180
02;Albacete;084;Villaverde de Guadalimar;744;411;333
02;Albacete;085;Viveros;698;359;339
02;Albacete;086;Yeste;5276;2733;2543
03;Alicante/Alacant;001;Adsubia;557;280;277
03;Alicante/Alacant;002;Agost;3818;1929;1889
03;Alicante/Alacant;003;Agres;722;372;350
03;Alicante/Alacant;004;Aigües;332;158;174
03;Alicante/Alacant;005;Albatera;8761;4405;4356
03;Alicante/Alacant;006;Alcalalí;649;327;322
03;Alicante/Alacant;007;Alcocer de Planes;119;56;63
03;Alicante/Alacant;008;Alcoleja;333;151;182
03;Alicante/Alacant;009;Alcoy/Alcoi;66312;31936;34376
03;Alicante/Alacant;010;Alfafara;405;200;205
03;Alicante/Alacant;011;Alfàs del Pi (L');6889;3387;3502
03;Alicante/Alacant;012;Algorfa;1104;551;553
03;Alicante/Alacant;013;Algueña;1547;759;788
03;Alicante/Alacant;014;Alicante/Alacant;258004;124566;133438
03;Alicante/Alacant;015;Almoradí;14048;7046;7002
03;Alicante/Alacant;016;Almudaina;146;68;78
03;Alicante/Alacant;017;Alquería d'Asnar (L');419;208;211
03;Alicante/Alacant;018;Altea;12087;5967;6120
03;Alicante/Alacant;019;Aspe;15618;7725;7893
03;Alicante/Alacant;020;Balones;174;78;96
03;Alicante/Alacant;021;Banyeres de Mariola;6966;3443;3523
03;Alicante/Alacant;022;Benasau;224;107;117
03;Alicante/Alacant;023;Beneixama;1866;917;949
03;Alicante/Alacant;024;Benejúzar;4498;2250;2248
03;Alicante/Alacant;025;Benferri;973;489;484
03;Alicante/Alacant;026;Beniarbeig;1169;585;584
03;Alicante/Alacant;027;Beniardá;260;126;134
03;Alicante/Alacant;028;Beniarrés;1610;805;805
03;Alicante/Alacant;030;Benidoleig;780;370;410
03;Alicante/Alacant;031;Benidorm;34831;17309;17522
03;Alicante/Alacant;032;Benifallim;200;100;100
03;Alicante/Alacant;033;Benifato;121;60;61
03;Alicante/Alacant;029;Benigembla;389;194;195
03;Alicante/Alacant;034;Benijófar;1373;632;741
03;Alicante/Alacant;035;Benilloba;971;492;479
03;Alicante/Alacant;036;Benillup;75;39;36
03;Alicante/Alacant;037;Benimantell;435;211;224
03;Alicante/Alacant;038;Benimarfull;409;194;215
03;Alicante/Alacant;039;Benimassot;110;53;57
03;Alicante/Alacant;040;Benimeli;341;168;173
03;Alicante/Alacant;041;Benissa;7269;3631;3638
03;Alicante/Alacant;042;Benitachell/Poble Nou de Benitatxell (el);1610;805;805
03;Alicante/Alacant;043;Biar;3348;1625;1723
03;Alicante/Alacant;044;Bigastro;4319;2194;2125
03;Alicante/Alacant;045;Bolulla;268;134;134
03;Alicante/Alacant;046;Busot;742;361;381
03;Alicante/Alacant;048;Callosa d'En Sarrià;7788;3845;3943
03;Alicante/Alacant;049;Callosa de Segura;15308;7625;7683
03;Alicante/Alacant;047;Calpe/Calp;10266;5100;5166
03;Alicante/Alacant;050;Campello (El);9231;4580;4651
03;Alicante/Alacant;051;Campo de Mirra/Camp de Mirra (el);381;188;193
03;Alicante/Alacant;053;Castalla;7073;3508;3565
03;Alicante/Alacant;054;Castell de Castells;596;296;300
03;Alicante/Alacant;055;Catral;4451;2233;2218
03;Alicante/Alacant;052;Cañada;1069;523;546
03;Alicante/Alacant;056;Cocentaina;10404;5103;5301
03;Alicante/Alacant;057;Confrides;342;184;158
03;Alicante/Alacant;058;Cox;5229;2672;2557
03;Alicante/Alacant;059;Crevillent;21748;11001;10747
03;Alicante/Alacant;061;Daya Nueva;1206;601;605
03;Alicante/Alacant;062;Daya Vieja;247;123;124
03;Alicante/Alacant;064;Dolores;5691;2830;2861
03;Alicante/Alacant;063;Dénia;23182;11412;11770
03;Alicante/Alacant;065;Elche/Elx;177529;87991;89538
03;Alicante/Alacant;066;Elda;56189;27504;28685
03;Alicante/Alacant;067;Facheca;151;80;71
03;Alicante/Alacant;068;Famorca;83;36;47
03;Alicante/Alacant;069;Finestrat;1062;530;532
03;Alicante/Alacant;070;Formentera del Segura;1901;941;960
03;Alicante/Alacant;072;Gaianes;330;159;171
03;Alicante/Alacant;071;Gata de Gorgos;5156;2571;2585
03;Alicante/Alacant;073;Gorga;306;155;151
03;Alicante/Alacant;074;Granja de Rocamora;1878;948;930
03;Alicante/Alacant;075;Guadalest;171;88;83
03;Alicante/Alacant;076;Guardamar del Segura;6316;3066;3250
03;Alicante/Alacant;077;Hondón de las Nieves;1493;743;750
03;Alicante/Alacant;078;Hondón de los Frailes;550;275;275
03;Alicante/Alacant;079;Ibi;20377;10081;10296
03;Alicante/Alacant;080;Jacarilla;1411;705;706
03;Alicante/Alacant;081;Jalón/Xaló;1765;866;899
03;Alicante/Alacant;083;Jijona/Xixona;7436;3532;3904
03;Alicante/Alacant;082;Jávea/Xàbia;12774;6286;6488
03;Alicante/Alacant;085;Llíber;419;205;214
03;Alicante/Alacant;084;Lorcha/Orxa (L');909;455;454
03;Alicante/Alacant;086;Millena;134;64;70
03;Alicante/Alacant;088;Monforte del Cid;4801;2470;2331
03;Alicante/Alacant;903;Montesinos (Los);"";"";""
03;Alicante/Alacant;089;Monóvar/Monòver;11864;5783;6081
03;Alicante/Alacant;091;Murla;363;156;207
03;Alicante/Alacant;092;Muro de Alcoy;6349;3173;3176
03;Alicante/Alacant;090;Mutxamel;8621;4330;4291
03;Alicante/Alacant;093;Novelda;21293;10479;10814
03;Alicante/Alacant;094;Nucia (la);5389;2661;2728
03;Alicante/Alacant;095;Ondara;4660;2278;2382
03;Alicante/Alacant;096;Onil;6531;3263;3268
03;Alicante/Alacant;097;Orba;1549;730;819
03;Alicante/Alacant;099;Orihuela;45938;22439;23499
03;Alicante/Alacant;098;Orxeta;467;231;236
03;Alicante/Alacant;100;Parcent;657;332;325
03;Alicante/Alacant;101;Pedreguer;5682;2748;2934
03;Alicante/Alacant;102;Pego;9416;4663;4753
03;Alicante/Alacant;103;Penàguila;383;194;189
03;Alicante/Alacant;104;Petrer;22166;11053;11113
03;Alicante/Alacant;902;Pilar de la Horadada;6509;3291;3218
03;Alicante/Alacant;105;Pinoso;5559;2742;2817
03;Alicante/Alacant;106;Planes;843;424;419
03;Alicante/Alacant;901;Poblets (Els);1017;487;530
03;Alicante/Alacant;107;Polop;1865;915;950
03;Alicante/Alacant;060;Quatretondeta;228;111;117
03;Alicante/Alacant;109;Rafal;2537;1258;1279
03;Alicante/Alacant;111;Redován;4869;2472;2397
03;Alicante/Alacant;112;Relleu;862;436;426
03;Alicante/Alacant;113;Rojales;5061;2538;2523
03;Alicante/Alacant;114;Romana (La);2002;1011;991
03;Alicante/Alacant;110;Ràfol d'Almúnia (El);375;184;191
03;Alicante/Alacant;115;Sagra;401;190;211
03;Alicante/Alacant;116;Salinas;1064;562;502
03;Alicante/Alacant;118;San Fulgencio;1588;794;794
03;Alicante/Alacant;904;San Isidro;"";"";""
03;Alicante/Alacant;120;San Miguel de Salinas;2448;1257;1191
03;Alicante/Alacant;122;San Vicente del Raspeig/Sant Vicent del Raspeig;25646;12700;12946
03;Alicante/Alacant;117;Sanet y Negrals;549;253;296
03;Alicante/Alacant;119;Sant Joan d'Alacant;11881;5849;6032
03;Alicante/Alacant;121;Santa Pola;13347;6642;6705
03;Alicante/Alacant;123;Sax;7931;3962;3969
03;Alicante/Alacant;124;Sella;619;316;303
03;Alicante/Alacant;125;Senija;433;223;210
03;Alicante/Alacant;128;Teulada;4556;2240;2316
03;Alicante/Alacant;129;Tibi;1025;510;515
03;Alicante/Alacant;130;Tollos;48;30;18
03;Alicante/Alacant;131;Tormos;251;131;120
03;Alicante/Alacant;132;Torremanzanas/Torre de les Maçanes (la);743;355;388
03;Alicante/Alacant;133;Torrevieja;17433;8494;8939
03;Alicante/Alacant;127;Tárbena;718;368;350
03;Alicante/Alacant;134;Vall d'Alcalà (La);162;79;83
03;Alicante/Alacant;135;Vall de Ebo;379;185;194
03;Alicante/Alacant;136;Vall de Gallinera;805;402;403
03;Alicante/Alacant;137;Vall de Laguar (La);1011;502;509
03;Alicante/Alacant;138;Verger (El);3655;1758;1897
03;Alicante/Alacant;139;Villajoyosa/Vila Joiosa (La);21927;10738;11189
03;Alicante/Alacant;140;Villena;30428;15079;15349
04;Almería;001;Abla;1732;838;894
04;Almería;002;Abrucena;1594;801;793
04;Almería;003;Adra;19536;9762;9774
04;Almería;004;Albánchez;859;415;444
04;Almería;005;Alboloduy;1023;479;544
04;Almería;006;Albox;10362;5254;5108
04;Almería;007;Alcolea;877;436;441
04;Almería;008;Alcóntar;700;355;345
04;Almería;009;Alcudia de Monteagud;210;93;117
04;Almería;010;Alhabia;879;437;442
04;Almería;011;Alhama de Almería;3095;1541;1554
04;Almería;012;Alicún;244;110;134
04;Almería;013;Almería;154911;75162;79749
04;Almería;014;Almócita;224;111;113
04;Almería;015;Alsodux;124;50;74
04;Almería;016;Antas;2548;1273;1275
04;Almería;017;Arboleas;1532;752;780
04;Almería;018;Armuña de Almanzora;342;159;183
04;Almería;019;Bacares;343;180;163
04;Almería;020;Bayárcal;452;239;213
04;Almería;021;Bayarque;253;125;128
04;Almería;022;Bédar;591;306;285
04;Almería;023;Beires;172;81;91
04;Almería;024;Benahadux;2049;989;1060
04;Almería;026;Benitagla;122;59;63
04;Almería;027;Benizalón;445;231;214
04;Almería;028;Bentarique;349;177;172
04;Almería;029;Berja;11633;5729;5904
04;Almería;030;Canjáyar;2199;1096;1103
04;Almería;031;Cantoria;3382;1697;1685
04;Almería;032;Carboneras;5602;2918;2684
04;Almería;033;Castro de Filabres;158;76;82
04;Almería;036;Chercos;366;177;189
04;Almería;037;Chirivel;2061;1042;1019
04;Almería;034;Cóbdar;306;162;144
04;Almería;035;Cuevas del Almanzora;9050;4491;4559
04;Almería;038;Dalías;3628;1793;1835
04;Almería;039;Darrical;391;194;197
04;Almería;902;Ejido (El);37154;18826;18328
04;Almería;041;Enix;240;112;128
04;Almería;043;Felix;682;310;372
04;Almería;044;Fines;1568;785;783
04;Almería;045;Fiñana;2770;1342;1428
04;Almería;046;Fondón;1042;528;514
04;Almería;047;Gádor;2524;1227;1297
04;Almería;048;Gallardos (Los);1679;853;826
04;Almería;049;Garrucha;3833;1964;1869
04;Almería;050;Gérgal;1257;614;643
04;Almería;051;Huécija;595;294;301
04;Almería;052;Huércal de Almería;3732;1835;1897
04;Almería;053;Huércal-Overa;12782;6306;6476
04;Almería;054;Illar;552;251;301
04;Almería;055;Instinción;675;333;342
04;Almería;056;Laroya;170;88;82
04;Almería;057;Láujar de Andarax;1902;937;965
04;Almería;058;Líjar;558;279;279
04;Almería;059;Lubrín;2206;1076;1130
04;Almería;060;Lucainena de las Torres;677;331;346
04;Almería;061;Lúcar;810;403;407
04;Almería;062;Macael;5601;2811;2790
04;Almería;063;María;1903;991;912
04;Almería;064;Mojácar;2923;1473;1450
04;Almería;903;Mojonera (La);5144;2627;2517
04;Almería;065;Nacimiento;602;309;293
04;Almería;066;Níjar;12248;6221;6027
04;Almería;067;Ohanes;977;490;487
04;Almería;068;Olula de Castro;247;134;113
04;Almería;069;Olula del Río;5208;2623;2585
04;Almería;070;Oria;2653;1323;1330
04;Almería;071;Padules;617;317;300
04;Almería;072;Partaloa;490;244;246
04;Almería;073;Paterna del Río;458;231;227
04;Almería;074;Pechina;2093;1018;1075
04;Almería;075;Pulpí;4236;2120;2116
04;Almería;076;Purchena;1858;937;921
04;Almería;077;Rágol;499;243;256
04;Almería;078;Rioja;1179;572;607
04;Almería;079;Roquetas de Mar;22555;11302;11253
04;Almería;080;Santa Cruz de Marchena;272;123;149
04;Almería;081;Santa Fe de Mondújar;449;219;230
04;Almería;082;Senés;529;273;256
04;Almería;083;Serón;3247;1611;1636
04;Almería;084;Sierro;725;380;345
04;Almería;085;Somontín;570;290;280
04;Almería;086;Sorbas;2931;1474;1457
04;Almería;087;Suflí;255;134;121
04;Almería;088;Tabernas;3280;1631;1649
04;Almería;089;Taberno;1028;508;520
04;Almería;090;Tahal;607;302;305
04;Almería;091;Terque;526;257;269
04;Almería;092;Tíjola;3647;1852;1795
04;Almería;901;Tres Villas (Las);742;400;342
04;Almería;093;Turre;2072;1003;1069
04;Almería;094;Turrillas;296;155;141
04;Almería;095;Uleila del Campo;1090;552;538
04;Almería;096;Urrácal;393;191;202
04;Almería;097;Velefique;440;220;220
04;Almería;098;Vélez-Blanco;2612;1331;1281
04;Almería;099;Vélez-Rubio;6680;3247;3433
04;Almería;100;Vera;5531;2689;2842
04;Almería;101;Viator;2656;1304;1352
04;Almería;102;Vícar;10166;5205;4961
04;Almería;103;Zurgena;2213;1090;1123
05;Ávila;001;Adanero;416;225;191
05;Ávila;002;Adrada (La);1838;955;883
05;Ávila;005;Albornos;328;176;152
05;Ávila;007;Aldeanueva de Santa Cruz;251;132;119
05;Ávila;008;Aldeaseca;450;224;226
05;Ávila;010;Aldehuela (La);326;169;157
05;Ávila;012;Amavida;234;118;116
05;Ávila;013;Arenal (El);1193;606;587
05;Ávila;014;Arenas de San Pedro;6877;3461;3416
05;Ávila;015;Arevalillo;221;105;116
05;Ávila;016;Arévalo;7009;3409;3600
05;Ávila;017;Aveinte;177;87;90
05;Ávila;018;Avellaneda;83;38;45
05;Ávila;019;Ávila;44221;21379;22842
05;Ávila;021;Barco de Ávila (El);2719;1350;1369
05;Ávila;022;Barraco (El);2192;1121;1071
05;Ávila;023;Barromán;359;189;170
05;Ávila;024;Becedas;694;346;348
05;Ávila;025;Becedillas;232;126;106
05;Ávila;026;Bercial de Zapardiel;397;195;202
05;Ávila;027;Berlanas (Las);413;205;208
05;Ávila;029;Bernuy-Zapardiel;329;171;158
05;Ávila;030;Berrocalejo de Aragona;42;21;21
05;Ávila;033;Blascomillán;421;207;214
05;Ávila;034;Blasconuño de Matacabras;38;19;19
05;Ávila;035;Blascosancho;203;105;98
05;Ávila;036;Bohodón (El);252;137;115
05;Ávila;037;Bohoyo;651;358;293
05;Ávila;038;Bonilla de la Sierra;293;156;137
05;Ávila;039;Brabos;93;49;44
05;Ávila;040;Bularros;160;87;73
05;Ávila;041;Burgohondo;1526;769;757
05;Ávila;042;Cabezas de Alambre;318;164;154
05;Ávila;043;Cabezas del Pozo;268;132;136
05;Ávila;044;Cabezas del Villar;690;373;317
05;Ávila;045;Cabizuela;165;86;79
05;Ávila;046;Canales;100;49;51
05;Ávila;047;Candeleda;5491;2786;2705
05;Ávila;048;Cantiveros;270;138;132
05;Ávila;049;Cardeñosa;650;342;308
05;Ávila;051;Carrera (La);377;194;183
05;Ávila;052;Casas del Puerto de Villatoro;146;83;63
05;Ávila;053;Casasola;263;138;125
05;Ávila;054;Casavieja;1735;886;849
05;Ávila;055;Casillas;1038;528;510
05;Ávila;056;Castellanos de Zapardiel;201;116;85
05;Ávila;057;Cebreros;3442;1731;1711
05;Ávila;058;Cepeda la Mora;206;110;96
05;Ávila;067;Chamartín;139;73;66
05;Ávila;059;Cillán;187;91;96
05;Ávila;060;Cisla;262;129;133
05;Ávila;061;Colilla (La);248;124;124
05;Ávila;062;Collado de Contreras;352;191;161
05;Ávila;063;Collado del Mirón;139;70;69
05;Ávila;064;Constanzana;240;132;108
05;Ávila;065;Crespos;841;436;405
05;Ávila;066;Cuevas del Valle;721;384;337
05;Ávila;903;Diego del Carpio;467;248;219
05;Ávila;069;Donjimeno;160;84;76
05;Ávila;070;Donvidas;104;51;53
05;Ávila;072;Espinosa de los Caballeros;141;78;63
05;Ávila;073;Flores de Ávila;577;304;273
05;Ávila;074;Fontíveros;1176;596;580
05;Ávila;075;Fresnedilla;170;82;88
05;Ávila;076;Fresno (El);455;230;225
05;Ávila;077;Fuente el Saúz;406;197;209
05;Ávila;078;Fuentes de Año;304;152;152
05;Ávila;079;Gallegos de Altamiros;150;82;68
05;Ávila;080;Gallegos de Sobrinos;146;71;75
05;Ávila;081;Garganta del Villar;116;64;52
05;Ávila;082;Gavilanes;863;455;408
05;Ávila;083;Gemuño;299;151;148
05;Ávila;085;Gil García;107;54;53
05;Ávila;084;Gilbuena;228;125;103
05;Ávila;086;Gimialcón;169;88;81
05;Ávila;087;Gotarrendura;230;81;149
05;Ávila;088;Grandes y San Martín;91;44;47
05;Ávila;089;Guisando;833;425;408
05;Ávila;090;Gutierre-Muñoz;162;80;82
05;Ávila;092;Hernansancho;286;141;145
05;Ávila;093;Herradón de Pinares;513;261;252
05;Ávila;094;Herreros de Suso;405;200;205
05;Ávila;095;Higuera de las Dueñas;330;173;157
05;Ávila;096;Hija de Dios (La);179;97;82
05;Ávila;097;Horcajada (La);1116;560;556
05;Ávila;099;Horcajo de las Torres;1029;558;471
05;Ávila;100;Hornillo (El);586;296;290
05;Ávila;102;Hoyo de Pinares (El);2683;1369;1314
05;Ávila;101;Hoyocasero;548;284;264
05;Ávila;103;Hoyorredondo;194;89;105
05;Ávila;106;Hoyos de Miguel Muñoz;83;46;37
05;Ávila;104;Hoyos del Collado;67;41;26
05;Ávila;105;Hoyos del Espino;424;218;206
05;Ávila;107;Hurtumpascual;197;100;97
05;Ávila;108;Junciana;123;61;62
05;Ávila;109;Langa;646;342;304
05;Ávila;110;Lanzahíta;945;500;445
05;Ávila;113;Llanos de Tormes (Los);202;104;98
05;Ávila;112;Losar del Barco (El);225;125;100
05;Ávila;114;Madrigal de las Altas Torres;2373;1227;1146
05;Ávila;115;Maello;721;367;354
05;Ávila;116;Malpartida de Corneja;327;161;166
05;Ávila;117;Mamblas;336;178;158
05;Ávila;118;Mancera de Arriba;230;122;108
05;Ávila;119;Manjabálago;125;66;59
05;Ávila;120;Marlín;56;29;27
05;Ávila;121;Martiherrero;215;110;105
05;Ávila;122;Martínez;323;169;154
05;Ávila;123;Mediana de Voltoya;129;73;56
05;Ávila;124;Medinilla;367;185;182
05;Ávila;125;Mengamuñoz;89;45;44
05;Ávila;126;Mesegar de Corneja;163;77;86
05;Ávila;127;Mijares;1165;598;567
05;Ávila;128;Mingorría;614;313;301
05;Ávila;129;Mirón (El);403;217;186
05;Ávila;130;Mironcillo;152;87;65
05;Ávila;131;Mirueña de los Infanzones;314;155;159
05;Ávila;132;Mombeltrán;1382;735;647
05;Ávila;133;Monsalupe;152;78;74
05;Ávila;134;Moraleja de Matacabras;98;49;49
05;Ávila;135;Muñana;656;349;307
05;Ávila;136;Muñico;223;122;101
05;Ávila;138;Muñogalindo;519;278;241
05;Ávila;139;Muñogrande;124;67;57
05;Ávila;140;Muñomer del Peco;136;82;54
05;Ávila;141;Muñopepe;126;64;62
05;Ávila;142;Muñosancho;230;106;124
05;Ávila;143;Muñotello;181;102;79
05;Ávila;144;Narrillos del Álamo;220;118;102
05;Ávila;145;Narrillos del Rebollar;119;60;59
05;Ávila;149;Narros de Saldueña;277;138;139
05;Ávila;147;Narros del Castillo;353;190;163
05;Ávila;148;Narros del Puerto;69;40;29
05;Ávila;152;Nava de Arévalo;1230;648;582
05;Ávila;153;Nava del Barco;287;138;149
05;Ávila;151;Navacepedilla de Corneja;193;98;95
05;Ávila;154;Navadijos;101;51;50
05;Ávila;155;Navaescurial;137;78;59
05;Ávila;156;Navahondilla;144;56;88
05;Ávila;157;Navalacruz;424;214;210
05;Ávila;158;Navalmoral;765;387;378
05;Ávila;159;Navalonguilla;617;308;309
05;Ávila;160;Navalosa;617;308;309
05;Ávila;161;Navalperal de Pinares;1005;494;511
05;Ávila;162;Navalperal de Tormes;212;102;110
05;Ávila;163;Navaluenga;2182;1119;1063
05;Ávila;164;Navaquesera;127;65;62
05;Ávila;165;Navarredonda de Gredos;576;296;280
05;Ávila;166;Navarredondilla;361;177;184
05;Ávila;167;Navarrevisca;445;238;207
05;Ávila;168;Navas del Marqués (Las);4165;2090;2075
05;Ávila;169;Navatalgordo;1224;630;594
05;Ávila;170;Navatejares;207;98;109
05;Ávila;171;Neila de San Miguel;178;94;84
05;Ávila;172;Niharra;245;125;120
05;Ávila;173;Ojos-Albos;41;20;21
05;Ávila;174;Orbita;128;71;57
05;Ávila;175;Oso (El);283;151;132
05;Ávila;176;Padiernos;334;182;152
05;Ávila;177;Pajares de Adaja;240;123;117
05;Ávila;178;Palacios de Goda;632;306;326
05;Ávila;179;Papatrigo;426;206;220
05;Ávila;180;Parral (El);208;100;108
05;Ávila;181;Pascualcobo;86;45;41
05;Ávila;182;Pedro Bernardo;2024;1049;975
05;Ávila;183;Pedro-Rodríguez;271;128;143
05;Ávila;184;Peguerinos;462;238;224
05;Ávila;185;Peñalba de Ávila;188;102;86
05;Ávila;186;Piedrahíta;2465;1198;1267
05;Ávila;187;Piedralaves;2215;1112;1103
05;Ávila;188;Poveda;122;62;60
05;Ávila;189;Poyales del Hoyo;895;444;451
05;Ávila;190;Pozanco;80;44;36
05;Ávila;191;Pradosegar;225;116;109
05;Ávila;192;Puerto Castilla;219;106;113
05;Ávila;193;Rasueros;497;264;233
05;Ávila;194;Riocabado;266;150;116
05;Ávila;195;Riofrío;418;225;193
05;Ávila;196;Rivilla de Barajas;121;64;57
05;Ávila;197;Salobral;140;69;71
05;Ávila;198;Salvadiós;159;85;74
05;Ávila;199;San Bartolomé de Béjar;141;62;79
05;Ávila;200;San Bartolomé de Corneja;192;100;92
05;Ávila;201;San Bartolomé de Pinares;890;471;419
05;Ávila;206;San Esteban de los Patos;66;36;30
05;Ávila;208;San Esteban de Zapardiel;139;68;71
05;Ávila;207;San Esteban del Valle;1136;578;558
05;Ávila;209;San García de Ingelmos;249;128;121
05;Ávila;901;San Juan de Gredos;562;285;277
05;Ávila;210;San Juan de la Encinilla;197;89;108
05;Ávila;211;San Juan de la Nava;793;410;383
05;Ávila;212;San Juan del Molinillo;459;244;215
05;Ávila;213;San Juan del Olmo;260;138;122
05;Ávila;214;San Lorenzo de Tormes;92;44;48
05;Ávila;215;San Martín de la Vega del Alberche;389;214;175
05;Ávila;216;San Martín del Pimpollar;317;167;150
05;Ávila;217;San Miguel de Corneja;150;81;69
05;Ávila;218;San Miguel de Serrezuela;292;153;139
05;Ávila;219;San Pascual;85;44;41
05;Ávila;220;San Pedro del Arroyo;571;298;273
05;Ávila;231;San Vicente de Arévalo;269;137;132
05;Ávila;204;Sanchidrián;901;446;455
05;Ávila;205;Sanchorreja;175;91;84
05;Ávila;222;Santa Cruz de Pinares;285;163;122
05;Ávila;221;Santa Cruz del Valle;739;365;374
05;Ávila;226;Santa María de los Caballeros;254;129;125
05;Ávila;224;Santa María del Arroyo;178;87;91
05;Ávila;225;Santa María del Berrocal;790;390;400
05;Ávila;902;Santa María del Cubillo;485;270;215
05;Ávila;227;Santa María del Tiétar;377;188;189
05;Ávila;228;Santiago del Collado;390;228;162
05;Ávila;904;Santiago del Tormes;483;252;231
05;Ávila;229;Santo Domingo de las Posadas;122;63;59
05;Ávila;230;Santo Tomé de Zabarcos;152;82;70
05;Ávila;232;Serrada (La);186;97;89
05;Ávila;233;Serranillos;598;308;290
05;Ávila;234;Sigeres;98;45;53
05;Ávila;235;Sinlabajos;315;166;149
05;Ávila;236;Solana de Ávila;358;187;171
05;Ávila;237;Solana de Rioalmar;388;203;185
05;Ávila;238;Solosancho;1411;737;674
05;Ávila;239;Sotalbo;306;163;143
05;Ávila;240;Sotillo de la Adrada;3316;1667;1649
05;Ávila;241;Tiemblo (El);3871;1935;1936
05;Ávila;242;Tiñosillos;777;413;364
05;Ávila;243;Tolbaños;208;101;107
05;Ávila;244;Tormellas;166;85;81
05;Ávila;245;Tornadizos de Ávila;357;176;181
05;Ávila;247;Torre (La);599;323;276
05;Ávila;246;Tórtoles;195;103;92
05;Ávila;249;Umbrías;244;122;122
05;Ávila;251;Vadillo de la Sierra;227;133;94
05;Ávila;252;Valdecasa;158;82;76
05;Ávila;253;Vega de Santa María;155;83;72
05;Ávila;254;Velayos;350;176;174
05;Ávila;256;Villaflor;231;114;117
05;Ávila;257;Villafranca de la Sierra;313;168;145
05;Ávila;905;Villanueva de Ávila;"";"";""
05;Ávila;258;Villanueva de Gómez;217;106;111
05;Ávila;259;Villanueva del Aceral;266;124;142
05;Ávila;260;Villanueva del Campillo;274;140;134
05;Ávila;261;Villar de Corneja;129;62;67
05;Ávila;262;Villarejo del Valle;516;268;248
05;Ávila;263;Villatoro;294;159;135
05;Ávila;264;Viñegra de Moraña;105;59;46
05;Ávila;265;Vita;155;87;68
05;Ávila;266;Zapardiel de la Cañada;285;142;143
05;Ávila;267;Zapardiel de la Ribera;170;88;82
06;Badajoz;001;Acedera;1083;572;511
06;Badajoz;002;Aceuchal;5127;2561;2566
06;Badajoz;003;Ahillones;1413;697;716
06;Badajoz;004;Alange;1992;1034;958
06;Badajoz;005;Albuera (La);1774;891;883
06;Badajoz;006;Alburquerque;5612;2845;2767
06;Badajoz;007;Alconchel;2787;1385;1402
06;Badajoz;008;Alconera;859;439;420
06;Badajoz;009;Aljucén;228;123;105
06;Badajoz;010;Almendral;1588;780;808
06;Badajoz;011;Almendralejo;25137;12213;12924
06;Badajoz;012;Arroyo de San Serván;3694;1875;1819
06;Badajoz;013;Atalaya;387;192;195
06;Badajoz;014;Azuaga;10218;5021;5197
06;Badajoz;015;Badajoz;120240;58203;62037
06;Badajoz;016;Barcarrota;4394;2198;2196
06;Badajoz;017;Baterno;494;254;240
06;Badajoz;018;Benquerencia de la Serena;1431;715;716
06;Badajoz;019;Berlanga;2978;1487;1491
06;Badajoz;020;Bienvenida;2746;1379;1367
06;Badajoz;021;Bodonal de la Sierra;1572;790;782
06;Badajoz;022;Burguillos del Cerro;3403;1699;1704
06;Badajoz;023;Cabeza del Buey;6751;3326;3425
06;Badajoz;024;Cabeza la Vaca;1944;956;988
06;Badajoz;025;Calamonte;5404;2681;2723
06;Badajoz;026;Calera de León;1235;630;605
06;Badajoz;027;Calzadilla de los Barros;871;433;438
06;Badajoz;028;Campanario;6055;2891;3164
06;Badajoz;029;Campillo de Llerena;1952;959;993
06;Badajoz;030;Capilla;275;132;143
06;Badajoz;031;Carmonita;770;414;356
06;Badajoz;032;Carrascalejo (El);31;15;16
06;Badajoz;033;Casas de Don Pedro;1969;964;1005
06;Badajoz;034;Casas de Reina;346;156;190
06;Badajoz;035;Castilblanco;2004;1004;1000
06;Badajoz;036;Castuera;8376;4145;4231
06;Badajoz;042;Cheles;1438;723;715
06;Badajoz;037;Codosera (La);2657;1372;1285
06;Badajoz;038;Cordobilla de Lácara;1159;599;560
06;Badajoz;039;Coronada (La);2680;1337;1343
06;Badajoz;040;Corte de Peleas;1316;669;647
06;Badajoz;041;Cristina;546;290;256
06;Badajoz;043;Don Álvaro;606;308;298
06;Badajoz;044;Don Benito;28829;14467;14362
06;Badajoz;045;Entrín Bajo;715;353;362
06;Badajoz;046;Esparragalejo;1382;708;674
06;Badajoz;047;Esparragosa de la Serena;1215;601;614
06;Badajoz;048;Esparragosa de Lares;1431;696;735
06;Badajoz;049;Feria;1780;881;899
06;Badajoz;050;Fregenal de la Sierra;6028;2921;3107
06;Badajoz;051;Fuenlabrada de los Montes;2475;1247;1228
06;Badajoz;052;Fuente de Cantos;5179;2588;2591
06;Badajoz;053;Fuente del Arco;1001;514;487
06;Badajoz;054;Fuente del Maestre;7019;3507;3512
06;Badajoz;055;Fuentes de León;3062;1453;1609
06;Badajoz;056;Garbayuela;656;346;310
06;Badajoz;057;Garlitos;962;477;485
06;Badajoz;058;Garrovilla (La);2670;1378;1292
06;Badajoz;059;Granja de Torrehermosa;3014;1477;1537
06;Badajoz;060;Guareña;7809;3916;3893
06;Badajoz;061;Haba (La);1868;904;964
06;Badajoz;062;Helechosa de los Montes;956;498;458
06;Badajoz;063;Herrera del Duque;4283;2142;2141
06;Badajoz;064;Higuera de la Serena;1458;735;723
06;Badajoz;065;Higuera de Llerena;637;303;334
06;Badajoz;066;Higuera de Vargas;3114;1549;1565
06;Badajoz;067;Higuera la Real;2945;1482;1463
06;Badajoz;068;Hinojosa del Valle;755;409;346
06;Badajoz;069;Hornachos;4114;2090;2024
06;Badajoz;070;Jerez de los Caballeros;9280;4630;4650
06;Badajoz;071;Lapa (La);384;193;191
06;Badajoz;073;Llera;1210;613;597
06;Badajoz;074;Llerena;5856;2821;3035
06;Badajoz;072;Lobón;2744;1434;1310
06;Badajoz;075;Magacela;1006;519;487
06;Badajoz;076;Maguilla;1405;701;704
06;Badajoz;077;Malcocinado;735;382;353
06;Badajoz;078;Malpartida de la Serena;1076;532;544
06;Badajoz;079;Manchita;782;413;369
06;Badajoz;080;Medellín;2593;1309;1284
06;Badajoz;081;Medina de las Torres;1997;993;1004
06;Badajoz;082;Mengabril;541;280;261
06;Badajoz;083;Mérida;52225;25436;26789
06;Badajoz;084;Mirandilla;1347;674;673
06;Badajoz;085;Monesterio;5240;2617;2623
06;Badajoz;086;Montemolín;2045;1021;1024
06;Badajoz;087;Monterrubio de la Serena;3731;1847;1884
06;Badajoz;088;Montijo;14626;7195;7431
06;Badajoz;089;Morera (La);809;412;397
06;Badajoz;090;Nava de Santiago (La);1252;629;623
06;Badajoz;091;Navalvillar de Pela;5422;2729;2693
06;Badajoz;092;Nogales;789;412;377
06;Badajoz;093;Oliva de la Frontera;7011;3435;3576
06;Badajoz;094;Oliva de Mérida;2332;1169;1163
06;Badajoz;095;Olivenza;10525;5190;5335
06;Badajoz;096;Orellana de la Sierra;547;268;279
06;Badajoz;097;Orellana la Vieja;4551;2297;2254
06;Badajoz;098;Palomas;717;365;352
06;Badajoz;099;Parra (La);1451;740;711
06;Badajoz;100;Peñalsordo;2042;977;1065
06;Badajoz;101;Peraleda del Zaucejo;863;423;440
06;Badajoz;102;Puebla de Alcocer;1914;961;953
06;Badajoz;103;Puebla de la Calzada;5674;2840;2834
06;Badajoz;104;Puebla de la Reina;923;475;448
06;Badajoz;107;Puebla de Obando;2197;1119;1078
06;Badajoz;108;Puebla de Sancho Pérez;3107;1529;1578
06;Badajoz;105;Puebla del Maestre;1260;608;652
06;Badajoz;106;Puebla del Prior;646;340;306
06;Badajoz;109;Quintana de la Serena;5056;2516;2540
06;Badajoz;110;Reina;301;154;147
06;Badajoz;111;Rena;674;354;320
06;Badajoz;112;Retamal de Llerena;751;380;371
06;Badajoz;113;Ribera del Fresno;3662;1765;1897
06;Badajoz;114;Risco;279;141;138
06;Badajoz;115;Roca de la Sierra (La);1782;901;881
06;Badajoz;116;Salvaleón;2581;1342;1239
06;Badajoz;117;Salvatierra de los Barros;2070;1036;1034
06;Badajoz;119;San Pedro de Mérida;805;417;388
06;Badajoz;123;San Vicente de Alcántara;6265;3094;3171
06;Badajoz;118;Sancti-Spíritus;419;204;215
06;Badajoz;120;Santa Amalia;4171;2096;2075
06;Badajoz;121;Santa Marta;4114;2072;2042
06;Badajoz;122;Santos de Maimona (Los);7524;3755;3769
06;Badajoz;124;Segura de León;2627;1315;1312
06;Badajoz;125;Siruela;2818;1375;1443
06;Badajoz;126;Solana de los Barros;2853;1465;1388
06;Badajoz;127;Talarrubias;4198;2050;2148
06;Badajoz;128;Talavera la Real;5310;2692;2618
06;Badajoz;129;Táliga;823;436;387
06;Badajoz;130;Tamurejo;352;167;185
06;Badajoz;131;Torre de Miguel Sesmero;1357;667;690
06;Badajoz;132;Torremayor;1138;572;566
06;Badajoz;133;Torremejía;1924;969;955
06;Badajoz;134;Trasierra;740;392;348
06;Badajoz;135;Trujillanos;982;504;478
06;Badajoz;136;Usagre;2284;1160;1124
06;Badajoz;137;Valdecaballeros;1855;938;917
06;Badajoz;901;Valdelacalzada;"";"";""
06;Badajoz;138;Valdetorres;1467;749;718
06;Badajoz;139;Valencia de las Torres;1031;522;509
06;Badajoz;140;Valencia del Mombuey;1049;511;538
06;Badajoz;141;Valencia del Ventoso;2682;1344;1338
06;Badajoz;146;Valle de la Serena;2043;1000;1043
06;Badajoz;147;Valle de Matamoros;694;338;356
06;Badajoz;148;Valle de Santa Ana;1425;726;699
06;Badajoz;142;Valverde de Burguillos;428;214;214
06;Badajoz;143;Valverde de Leganés;3598;1818;1780
06;Badajoz;144;Valverde de Llerena;1002;490;512
06;Badajoz;145;Valverde de Mérida;1172;600;572
06;Badajoz;149;Villafranca de los Barros;12642;6207;6435
06;Badajoz;150;Villagarcía de la Torre;1213;621;592
06;Badajoz;151;Villagonzalo;1657;788;869
06;Badajoz;152;Villalba de los Barros;1765;861;904
06;Badajoz;153;Villanueva de la Serena;23827;11731;12096
06;Badajoz;154;Villanueva del Fresno;4013;1981;2032
06;Badajoz;156;Villar de Rena;2020;1066;954
06;Badajoz;155;Villar del Rey;2485;1278;1207
06;Badajoz;157;Villarta de los Montes;978;468;510
06;Badajoz;158;Zafra;13816;6619;7197
06;Badajoz;159;Zahínos;3192;1585;1607
06;Badajoz;160;Zalamea de la Serena;5985;2936;3049
06;Badajoz;162;Zarza (La);3626;1839;1787
06;Badajoz;161;Zarza-Capilla;772;377;395
07;Balears (Illes);002;Alaior;6007;2961;3046
07;Balears (Illes);001;Alaró;3554;1701;1853
07;Balears (Illes);003;Alcúdia;6869;3401;3468
07;Balears (Illes);004;Algaida;3163;1581;1582
07;Balears (Illes);005;Andratx;6515;3186;3329
07;Balears (Illes);901;Ariany;928;453;475
07;Balears (Illes);006;Artà;5769;2828;2941
07;Balears (Illes);007;Banyalbufar;430;211;219
07;Balears (Illes);008;Binissalem;4708;2278;2430
07;Balears (Illes);009;Búger;1021;502;519
07;Balears (Illes);010;Bunyola;3649;1795;1854
07;Balears (Illes);011;Calvià;14986;7713;7273
07;Balears (Illes);012;Campanet;2202;1103;1099
07;Balears (Illes);013;Campos;6467;3234;3233
07;Balears (Illes);014;Capdepera;5786;2914;2872
07;Balears (Illes);064;Castell (Es);4637;2343;2294
07;Balears (Illes);015;Ciutadella de Menorca;19311;9611;9700
07;Balears (Illes);016;Consell;1997;983;1014
07;Balears (Illes);017;Costitx;749;356;393
07;Balears (Illes);018;Deyá;531;260;271
07;Balears (Illes);026;Eivissa;27685;14024;13661
07;Balears (Illes);019;Escorca;233;140;93
07;Balears (Illes);020;Esporles;2838;1402;1436
07;Balears (Illes);021;Estellencs;316;158;158
07;Balears (Illes);022;Felanitx;13698;6782;6916
07;Balears (Illes);023;Ferreries;3383;1821;1562
07;Balears (Illes);024;Formentera;4735;2433;2302
07;Balears (Illes);025;Fornalutx;507;246;261
07;Balears (Illes);027;Inca;21867;10704;11163
07;Balears (Illes);028;Lloret de Vistalegre;819;397;422
07;Balears (Illes);029;Lloseta;4452;2209;2243
07;Balears (Illes);030;Llubí;1971;976;995
07;Balears (Illes);031;Llucmajor;15939;7897;8042
07;Balears (Illes);032;Mahón;22028;10804;11224
07;Balears (Illes);033;Manacor;24397;11983;12414
07;Balears (Illes);034;Mancor de la Vall;910;449;461
07;Balears (Illes);035;Maria de la Salut;1866;911;955
07;Balears (Illes);036;Marratxí;10232;5152;5080
07;Balears (Illes);037;Mercadal (Es);3038;1535;1503
07;Balears (Illes);902;Migjorn Gran (Es);"";"";""
07;Balears (Illes);038;Montuïri;2165;1034;1131
07;Balears (Illes);039;Muro;5899;2921;2978
07;Balears (Illes);040;Palma de Mallorca;306840;149638;157202
07;Balears (Illes);041;Petra;2646;1271;1375
07;Balears (Illes);044;Pobla (Sa);10426;5163;5263
07;Balears (Illes);042;Pollença;11657;5787;5870
07;Balears (Illes);043;Porreres;4495;2222;2273
07;Balears (Illes);045;Puigpunyent;1116;561;555
07;Balears (Illes);059;Salines (Ses);2919;1491;1428
07;Balears (Illes);046;Sant Antoni de Portmany;12244;6113;6131
07;Balears (Illes);049;Sant Joan;1801;883;918
07;Balears (Illes);050;Sant Joan de Labritja;3540;1743;1797
07;Balears (Illes);048;Sant Josep de sa Talaia;9095;4659;4436
07;Balears (Illes);051;Sant Llorenç des Cardassar;4323;2176;2147
07;Balears (Illes);052;Sant Lluís;2880;1448;1432
07;Balears (Illes);053;Santa Eugènia;938;466;472
07;Balears (Illes);054;Santa Eulalia del Río;14545;7336;7209
07;Balears (Illes);055;Santa Margalida;5166;2577;2589
07;Balears (Illes);056;Santa María del Camí;3998;1984;2014
07;Balears (Illes);057;Santanyí;6640;3374;3266
07;Balears (Illes);058;Selva;2999;1483;1516
07;Balears (Illes);047;Sencelles;1538;736;802
07;Balears (Illes);060;Sineu;2623;1295;1328
07;Balears (Illes);061;Sóller;10204;4945;5259
07;Balears (Illes);062;Son Servera;5936;3007;2929
07;Balears (Illes);063;Valldemossa;1305;616;689
07;Balears (Illes);065;Vilafranca de Bonany;2176;1069;1107
08;Barcelona;001;Abrera;4504;2287;2217
08;Barcelona;002;Aguilar de Segarra;211;107;104
08;Barcelona;014;Aiguafreda;2013;988;1025
08;Barcelona;003;Alella;5401;2609;2792
08;Barcelona;004;Alpens;250;131;119
08;Barcelona;005;Ametlla del Vallès (L');2639;1277;1362
08;Barcelona;006;Arenys de Mar;10414;4988;5426
08;Barcelona;007;Arenys de Munt;4659;2241;2418
08;Barcelona;008;Argençola;193;102;91
08;Barcelona;009;Argentona;7427;3686;3741
08;Barcelona;010;Artés;4050;1969;2081
08;Barcelona;011;Avià;1813;919;894
08;Barcelona;012;Avinyó;2022;990;1032
08;Barcelona;013;Avinyonet del Penedès;1190;607;583
08;Barcelona;015;Badalona;224233;111831;112402
08;Barcelona;904;Badia del Vallès;"";"";""
08;Barcelona;016;Bagà;2162;1096;1066
08;Barcelona;017;Balenyà;3160;1618;1542
08;Barcelona;018;Balsareny;3469;1699;1770
08;Barcelona;252;Barberà del Vallès;30008;15634;14374
08;Barcelona;019;Barcelona;1703744;807528;896216
08;Barcelona;020;Begues;1590;763;827
08;Barcelona;021;Bellprat;93;49;44
08;Barcelona;022;Berga;13838;6729;7109
08;Barcelona;023;Bigues i Riells;2038;1032;1006
08;Barcelona;024;Borredà;447;212;235
08;Barcelona;025;Bruc (El);721;370;351
08;Barcelona;026;Brull (El);184;95;89
08;Barcelona;027;Cabanyes (Les);362;190;172
08;Barcelona;029;Cabrera de Mar;2065;1030;1035
08;Barcelona;028;Cabrera d'Igualada;270;146;124
08;Barcelona;030;Cabrils;2168;1031;1137
08;Barcelona;031;Calaf;3216;1583;1633
08;Barcelona;034;Calders;489;261;228
08;Barcelona;033;Caldes de Montbui;10470;5163;5307
08;Barcelona;032;Caldes d'Estrac;1351;655;696
08;Barcelona;035;Calella;11330;5302;6028
08;Barcelona;037;Calldetenes;1404;701;703
08;Barcelona;038;Callús;1496;718;778
08;Barcelona;036;Calonge de Segarra;197;105;92
08;Barcelona;039;Campins;185;88;97
08;Barcelona;040;Canet de Mar;8682;4240;4442
08;Barcelona;041;Canovelles;12586;6339;6247
08;Barcelona;042;Cànoves i Samalús;741;368;373
08;Barcelona;043;Canyelles;600;329;271
08;Barcelona;044;Capellades;4910;2394;2516
08;Barcelona;045;Capolat;115;62;53
08;Barcelona;046;Cardedeu;8113;4027;4086
08;Barcelona;047;Cardona;6692;3270;3422
08;Barcelona;048;Carme;698;365;333
08;Barcelona;049;Casserres;1788;876;912
08;Barcelona;057;Castell de l'Areny;34;20;14
08;Barcelona;052;Castellar de n'Hug;183;98;85
08;Barcelona;050;Castellar del Riu;58;33;25
08;Barcelona;051;Castellar del Vallès;11830;5898;5932
08;Barcelona;053;Castellbell i el Vilar;3310;1616;1694
08;Barcelona;054;Castellbisbal;4092;2093;1999
08;Barcelona;055;Castellcir;230;125;105
08;Barcelona;056;Castelldefels;28209;14110;14099
08;Barcelona;058;Castellet i la Gornal;1078;548;530
08;Barcelona;060;Castellfollit de Riubregós;271;132;139
08;Barcelona;059;Castellfollit del Boix;318;153;165
08;Barcelona;061;Castellgalí;701;353;348
08;Barcelona;062;Castellnou de Bages;106;54;52
08;Barcelona;063;Castellolí;441;213;228
08;Barcelona;064;Castellterçol;1986;962;1024
08;Barcelona;065;Castellví de la Marca;1375;690;685
08;Barcelona;066;Castellví de Rosanes;468;234;234
08;Barcelona;067;Centelles;5653;2774;2879
08;Barcelona;268;Cercs;1806;902;904
08;Barcelona;266;Cerdanyola del Vallès;53968;27033;26935
08;Barcelona;068;Cervelló;4167;2084;2083
08;Barcelona;069;Collbató;738;362;376
08;Barcelona;070;Collsuspina;220;115;105
08;Barcelona;071;Copons;314;155;159
08;Barcelona;072;Corbera de Llobregat;3723;1896;1827
08;Barcelona;073;Cornellà de Llobregat;86971;43108;43863
08;Barcelona;074;Cubelles;2531;1288;1243
08;Barcelona;075;Dosrius;914;485;429
08;Barcelona;076;Esparreguera;11393;5743;5650
08;Barcelona;077;Esplugues de Llobregat;47598;23672;23926
08;Barcelona;078;Espunyola (L');300;159;141
08;Barcelona;079;Estany (L');388;180;208
08;Barcelona;134;Figaró-Montmany;640;333;307
08;Barcelona;080;Fígols;31;16;15
08;Barcelona;082;Fogars de la Selva;299;152;147
08;Barcelona;081;Fogars de Montclús;272;140;132
08;Barcelona;083;Folgueroles;1069;526;543
08;Barcelona;084;Fonollosa;646;330;316
08;Barcelona;085;Font-rubí;1132;587;545
08;Barcelona;086;Franqueses del Vallès (Les);9483;4777;4706
08;Barcelona;090;Gaià;143;74;69
08;Barcelona;087;Gallifa;80;41;39
08;Barcelona;088;Garriga (La);8733;4221;4512
08;Barcelona;089;Gavà;33076;16576;16500
08;Barcelona;091;Gelida;3803;1892;1911
08;Barcelona;092;Gironella;5360;2583;2777
08;Barcelona;093;Gisclareny;31;16;15
08;Barcelona;094;Granada (La);1196;591;605
08;Barcelona;095;Granera;50;30;20
08;Barcelona;096;Granollers;48380;23827;24553
08;Barcelona;097;Gualba;587;295;292
08;Barcelona;099;Guardiola de Berguedà;1302;630;672
08;Barcelona;100;Gurb;1650;852;798
08;Barcelona;101;Hospitalet de Llobregat (L');277688;137275;140413
08;Barcelona;162;Hostalets de Pierola (Els);852;436;416
08;Barcelona;102;Igualada;31107;15144;15963
08;Barcelona;103;Jorba;498;248;250
08;Barcelona;104;Llacuna (La);740;386;354
08;Barcelona;105;Llagosta (La);12192;6065;6127
08;Barcelona;107;Lliçà d'Amunt;3887;1968;1919
08;Barcelona;108;Lliçà de Vall;2156;1117;1039
08;Barcelona;106;Llinars del Vallès;5057;2558;2499
08;Barcelona;109;Lluçà;295;162;133
08;Barcelona;110;Malgrat de Mar;10854;5373;5481
08;Barcelona;111;Malla;251;118;133
08;Barcelona;112;Manlleu;16211;7991;8220
08;Barcelona;113;Manresa;65285;31511;33774
08;Barcelona;242;Marganell;215;81;134
08;Barcelona;114;Martorell;16185;8060;8125
08;Barcelona;115;Martorelles;4525;2258;2267
08;Barcelona;116;Masies de Roda (Les);621;303;318
08;Barcelona;117;Masies de Voltregà (Les);2481;1213;1268
08;Barcelona;118;Masnou (El);15521;7479;8042
08;Barcelona;119;Masquefa;2488;1237;1251
08;Barcelona;120;Matadepera;3603;1822;1781
08;Barcelona;121;Mataró;100189;49199;50990
08;Barcelona;122;Mediona;979;506;473
08;Barcelona;138;Moià;3168;1526;1642
08;Barcelona;123;Molins de Rei;18241;9009;9232
08;Barcelona;124;Mollet del Vallès;38568;19224;19344
08;Barcelona;128;Monistrol de Calders;622;312;310
08;Barcelona;127;Monistrol de Montserrat;2610;1278;1332
08;Barcelona;125;Montcada i Reixac;26093;12951;13142
08;Barcelona;130;Montclar;258;112;146
08;Barcelona;131;Montesquiu;924;445;479
08;Barcelona;126;Montgat;7337;3620;3717
08;Barcelona;132;Montmajor;690;348;342
08;Barcelona;133;Montmaneu;281;162;119
08;Barcelona;135;Montmeló;7024;3513;3511
08;Barcelona;136;Montornès del Vallès;10511;5246;5265
08;Barcelona;137;Montseny;278;145;133
08;Barcelona;129;Muntanyola;169;94;75
08;Barcelona;139;Mura;171;94;77
08;Barcelona;140;Navarcles;5017;2489;2528
08;Barcelona;141;Navàs;5253;2567;2686
08;Barcelona;142;Nou de Berguedà (La);140;77;63
08;Barcelona;143;Òdena;2578;1316;1262
08;Barcelona;145;Olèrdola;1574;823;751
08;Barcelona;146;Olesa de Bonesvalls;337;173;164
08;Barcelona;147;Olesa de Montserrat;14517;7235;7282
08;Barcelona;148;Olivella;202;101;101
08;Barcelona;149;Olost;945;465;480
08;Barcelona;144;Olvan;1089;520;569
08;Barcelona;150;Orís;223;116;107
08;Barcelona;151;Oristà;915;456;459
08;Barcelona;152;Orpí;153;78;75
08;Barcelona;153;Òrrius;320;175;145
08;Barcelona;154;Pacs del Penedès;388;204;184
08;Barcelona;155;Palafolls;2922;1447;1475
08;Barcelona;156;Palau-solità i Plegamans;5023;2580;2443
08;Barcelona;157;Pallejà;5947;2930;3017
08;Barcelona;905;Palma de Cervelló (La);"";"";""
08;Barcelona;158;Papiol (El);3086;1512;1574
08;Barcelona;159;Parets del Vallès;10022;5047;4975
08;Barcelona;160;Perafita;358;173;185
08;Barcelona;161;Piera;5301;2669;2632
08;Barcelona;163;Pineda de Mar;14111;7063;7048
08;Barcelona;164;Pla del Penedès (El);1001;509;492
08;Barcelona;165;Pobla de Claramunt (La);1688;848;840
08;Barcelona;166;Pobla de Lillet (La);1893;939;954
08;Barcelona;167;Polinyà;2762;1390;1372
08;Barcelona;182;Pont de Vilomara i Rocafort (El);2198;1088;1110
08;Barcelona;168;Pontons;223;121;102
08;Barcelona;169;Prat de Llobregat (El);63411;31937;31474
08;Barcelona;171;Prats de Lluçanès;2483;1243;1240
08;Barcelona;170;Prats de Rei (Els);581;286;295
08;Barcelona;230;Premià de Dalt;5262;2635;2627
08;Barcelona;172;Premià de Mar;20399;10266;10133
08;Barcelona;174;Puigdàlber;310;155;155
08;Barcelona;175;Puig-reig;5059;2492;2567
08;Barcelona;176;Pujalt;179;91;88
08;Barcelona;177;Quar (La);39;19;20
08;Barcelona;178;Rajadell;290;145;145
08;Barcelona;179;Rellinars;193;95;98
08;Barcelona;180;Ripollet;25890;12934;12956
08;Barcelona;181;Roca del Vallès (La);5215;2610;2605
08;Barcelona;183;Roda de Ter;4714;2272;2442
08;Barcelona;184;Rubí;47069;23652;23417
08;Barcelona;185;Rubió;136;70;66
08;Barcelona;901;Rupit i Pruit;373;187;186
08;Barcelona;187;Sabadell;187506;91775;95731
08;Barcelona;188;Sagàs;250;129;121
08;Barcelona;190;Saldes;339;189;150
08;Barcelona;191;Sallent;7867;3800;4067
08;Barcelona;194;Sant Adrià de Besòs;34673;17246;17427
08;Barcelona;195;Sant Agustí de Lluçanès;129;68;61
08;Barcelona;196;Sant Andreu de la Barca;14486;7297;7189
08;Barcelona;197;Sant Andreu de Llavaneres;3530;1743;1787
08;Barcelona;198;Sant Antoni de Vilamajor;1830;912;918
08;Barcelona;199;Sant Bartomeu del Grau;1088;568;520
08;Barcelona;200;Sant Boi de Llobregat;76008;38095;37913
08;Barcelona;201;Sant Boi de Lluçanès;516;260;256
08;Barcelona;203;Sant Cebrià de Vallalta;711;375;336
08;Barcelona;202;Sant Celoni;12302;6103;6199
08;Barcelona;204;Sant Climent de Llobregat;2131;1064;1067
08;Barcelona;205;Sant Cugat del Vallès;35784;17656;18128
08;Barcelona;206;Sant Cugat Sesgarrigues;736;371;365
08;Barcelona;207;Sant Esteve de Palautordera;1065;542;523
08;Barcelona;208;Sant Esteve Sesrovires;1769;913;856
08;Barcelona;210;Sant Feliu de Codines;3357;1630;1727
08;Barcelona;211;Sant Feliu de Llobregat;37626;18734;18892
08;Barcelona;212;Sant Feliu Sasserra;629;312;317
08;Barcelona;209;Sant Fost de Campsentelles;3939;1988;1951
08;Barcelona;213;Sant Fruitós de Bages;4685;2339;2346
08;Barcelona;215;Sant Hipòlit de Voltregà;2993;1437;1556
08;Barcelona;193;Sant Iscle de Vallalta;508;264;244
08;Barcelona;216;Sant Jaume de Frontanyà;23;14;9
08;Barcelona;218;Sant Joan de Vilatorrada;7663;3839;3824
08;Barcelona;217;Sant Joan Despí;24072;12043;12029
08;Barcelona;903;Sant Julià de Cerdanyola;"";"";""
08;Barcelona;220;Sant Julià de Vilatorta;1734;844;890
08;Barcelona;221;Sant Just Desvern;11365;5486;5879
08;Barcelona;222;Sant Llorenç d'Hortons;962;489;473
08;Barcelona;223;Sant Llorenç Savall;1875;871;1004
08;Barcelona;225;Sant Martí d'Albars;139;76;63
08;Barcelona;224;Sant Martí de Centelles;703;356;347
08;Barcelona;226;Sant Martí de Tous;1006;503;503
08;Barcelona;227;Sant Martí Sarroca;2341;1172;1169
08;Barcelona;228;Sant Martí Sesgueioles;401;201;200
08;Barcelona;229;Sant Mateu de Bages;597;303;294
08;Barcelona;231;Sant Pere de Ribes;11974;6026;5948
08;Barcelona;232;Sant Pere de Riudebitlles;2192;1074;1118
08;Barcelona;233;Sant Pere de Torelló;2060;963;1097
08;Barcelona;234;Sant Pere de Vilamajor;877;464;413
08;Barcelona;189;Sant Pere Sallavinera;193;98;95
08;Barcelona;235;Sant Pol de Mar;2450;1207;1243
08;Barcelona;236;Sant Quintí de Mediona;1557;773;784
08;Barcelona;237;Sant Quirze de Besora;2032;965;1067
08;Barcelona;238;Sant Quirze del Vallès;6838;3359;3479
08;Barcelona;239;Sant Quirze Safaja;246;116;130
08;Barcelona;240;Sant Sadurní d'Anoia;8854;4438;4416
08;Barcelona;241;Sant Sadurní d'Osormort;79;39;40
08;Barcelona;098;Sant Salvador de Guardiola;904;462;442
08;Barcelona;262;Sant Vicenç de Castellet;7648;3673;3975
08;Barcelona;264;Sant Vicenç de Montalt;1545;785;760
08;Barcelona;265;Sant Vicenç de Torelló;1767;841;926
08;Barcelona;263;Sant Vicenç dels Horts;20465;10232;10233
08;Barcelona;243;Santa Cecilia de Voltregà;191;108;83
08;Barcelona;244;Santa Coloma de Cervelló;2683;1338;1345
08;Barcelona;245;Santa Coloma de Gramenet;135310;67638;67672
08;Barcelona;246;Santa Eugènia de Berga;1365;706;659
08;Barcelona;247;Santa Eulàlia de Riuprimer;823;415;408
08;Barcelona;248;Santa Eulàlia de Ronçana;2512;1280;1232
08;Barcelona;249;Santa Fe del Penedès;191;89;102
08;Barcelona;250;Santa Margarida de Montbui;9203;4625;4578
08;Barcelona;251;Santa Margarida i els Monjos;3598;1863;1735
08;Barcelona;253;Santa Maria de Besora;196;95;101
08;Barcelona;254;Santa Maria de Corcó;1973;956;1017
08;Barcelona;256;Santa Maria de Martorelles;390;195;195
08;Barcelona;255;Santa Maria de Merlès;260;131;129
08;Barcelona;257;Santa Maria de Miralles;98;50;48
08;Barcelona;259;Santa Maria de Palautordera;4468;2267;2201
08;Barcelona;258;Santa Maria d'Oló;1054;532;522
08;Barcelona;260;Santa Perpètua de Mogoda;15313;7743;7570
08;Barcelona;261;Santa Susanna;673;331;342
08;Barcelona;192;Santpedor;3967;1924;2043
08;Barcelona;267;Sentmenat;3987;1982;2005
08;Barcelona;269;Seva;1625;815;810
08;Barcelona;270;Sitges;12201;5938;6263
08;Barcelona;271;Sobremunt;77;39;38
08;Barcelona;272;Sora;226;122;104
08;Barcelona;273;Subirats;2157;1101;1056
08;Barcelona;274;Súria;6691;3318;3373
08;Barcelona;276;Tagamanent;136;67;69
08;Barcelona;277;Talamanca;59;31;28
08;Barcelona;278;Taradell;4290;2136;2154
08;Barcelona;275;Tavèrnoles;213;109;104
08;Barcelona;280;Tavertet;113;60;53
08;Barcelona;281;Teià;2950;1477;1473
08;Barcelona;279;Terrassa;160245;78479;81766
08;Barcelona;282;Tiana;4019;2019;2000
08;Barcelona;283;Tona;5360;2663;2697
08;Barcelona;284;Tordera;7797;3909;3888
08;Barcelona;285;Torelló;11153;5468;5685
08;Barcelona;286;Torre de Claramunt (La);1453;747;706
08;Barcelona;287;Torrelavit;1180;595;585
08;Barcelona;288;Torrelles de Foix;1149;613;536
08;Barcelona;289;Torrelles de Llobregat;1871;959;912
08;Barcelona;290;Ullastrell;873;434;439
08;Barcelona;291;Vacarisses;644;320;324
08;Barcelona;292;Vallbona d'Anoia;1050;528;522
08;Barcelona;293;Vallcebre;343;184;159
08;Barcelona;294;Vallgorguina;655;326;329
08;Barcelona;295;Vallirana;5111;2571;2540
08;Barcelona;296;Vallromanes;447;226;221
08;Barcelona;297;Veciana;197;107;90
08;Barcelona;298;Vic;28609;13655;14954
08;Barcelona;299;Vilada;601;306;295
08;Barcelona;301;Viladecans;45423;22950;22473
08;Barcelona;300;Viladecavalls;2508;1257;1251
08;Barcelona;305;Vilafranca del Penedès;26665;12960;13705
08;Barcelona;306;Vilalba Sasserra;290;157;133
08;Barcelona;303;Vilanova de Sau;317;149;168
08;Barcelona;302;Vilanova del Camí;8670;4317;4353
08;Barcelona;902;Vilanova del Vallès;1221;599;622
08;Barcelona;307;Vilanova i la Geltrú;45258;22379;22879
08;Barcelona;214;Vilassar de Dalt;6298;3074;3224
08;Barcelona;219;Vilassar de Mar;10396;5125;5271
08;Barcelona;304;Vilobí del Penedès;774;389;385
08;Barcelona;308;Viver i Serrateix;235;126;109
09;Burgos;001;Abajas;56;29;27
09;Burgos;003;Adrada de Haza;341;184;157
09;Burgos;006;Aguas Cándidas;134;75;59
09;Burgos;007;Aguilar de Bureba;136;78;58
09;Burgos;009;Albillos;171;99;72
09;Burgos;010;Alcocero de Mola;69;42;27
09;Burgos;011;Alfoz de Bricia;176;83;93
09;Burgos;907;Alfoz de Quintanadueñas;468;238;230
09;Burgos;012;Alfoz de Santa Gadea;172;91;81
09;Burgos;013;Altable;81;47;34
09;Burgos;014;Altos (Los);340;196;144
09;Burgos;016;Ameyugo;73;47;26
09;Burgos;017;Anguix;207;107;100
09;Burgos;018;Aranda de Duero;28676;14452;14224
09;Burgos;019;Arandilla;238;143;95
09;Burgos;020;Arauzo de Miel;484;268;216
09;Burgos;021;Arauzo de Salce;101;59;42
09;Burgos;022;Arauzo de Torre;142;79;63
09;Burgos;023;Arcos;283;157;126
09;Burgos;024;Arenillas de Riopisuerga;242;135;107
09;Burgos;025;Arija;334;155;179
09;Burgos;026;Arlanzón;444;231;213
09;Burgos;027;Arraya de Oca;50;26;24
09;Burgos;029;Atapuerca;186;88;98
09;Burgos;030;Ausines (Los);151;82;69
09;Burgos;032;Avellanosa de Muñó;247;132;115
09;Burgos;033;Bahabón de Esgueva;204;118;86
09;Burgos;034;Balbases (Los);440;234;206
09;Burgos;035;Baños de Valdearados;623;352;271
09;Burgos;036;Bañuelos de Bureba;61;40;21
09;Burgos;037;Barbadillo de Herreros;164;78;86
09;Burgos;038;Barbadillo del Mercado;238;120;118
09;Burgos;039;Barbadillo del Pez;132;73;59
09;Burgos;041;Barrio de Muñó;45;24;21
09;Burgos;043;Barrios de Bureba (Los);381;189;192
09;Burgos;044;Barrios de Colina;81;46;35
09;Burgos;045;Basconcillos del Tozo;517;268;249
09;Burgos;046;Bascuñana;101;55;46
09;Burgos;047;Belbimbre;91;46;45
09;Burgos;048;Belorado;2128;1077;1051
09;Burgos;050;Berberana;113;59;54
09;Burgos;051;Berlangas de Roa;378;187;191
09;Burgos;052;Berzosa de Bureba;61;34;27
09;Burgos;054;Bozoó;98;51;47
09;Burgos;055;Brazacorta;114;59;55
09;Burgos;056;Briviesca;5200;2590;2610
09;Burgos;057;Bugedo;119;86;33
09;Burgos;058;Buniel;173;90;83
09;Burgos;059;Burgos;158857;77480;81377
09;Burgos;060;Busto de Bureba;399;209;190
09;Burgos;061;Cabañes de Esgueva;349;171;178
09;Burgos;062;Cabezón de la Sierra;55;23;32
09;Burgos;063;Cabia;238;137;101
09;Burgos;064;Caleruega;492;270;222
09;Burgos;065;Campillo de Aranda;224;117;107
09;Burgos;066;Campolara;112;61;51
09;Burgos;067;Canicosa de la Sierra;779;403;376
09;Burgos;068;Cantabrana;78;42;36
09;Burgos;070;Carazo;51;26;25
09;Burgos;071;Carcedo de Bureba;51;28;23
09;Burgos;072;Carcedo de Burgos;112;65;47
09;Burgos;073;Cardeñadijo;356;195;161
09;Burgos;074;Cardeñajimeno;303;164;139
09;Burgos;075;Cardeñuela Riopico;65;35;30
09;Burgos;076;Carrias;71;44;27
09;Burgos;077;Cascajares de Bureba;80;46;34
09;Burgos;078;Cascajares de la Sierra;36;19;17
09;Burgos;079;Castellanos de Castro;83;48;35
09;Burgos;083;Castil de Peones;64;34;30
09;Burgos;082;Castildelgado;102;53;49
09;Burgos;084;Castrillo de la Reina;395;230;165
09;Burgos;085;Castrillo de la Vega;706;364;342
09;Burgos;088;Castrillo de Riopisuerga;127;71;56
09;Burgos;086;Castrillo del Val;140;85;55
09;Burgos;090;Castrillo Matajudíos;88;48;40
09;Burgos;091;Castrojeriz;1175;584;591
09;Burgos;093;Cayuela;131;77;54
09;Burgos;094;Cebrecos;89;47;42
09;Burgos;095;Celada del Camino;104;48;56
09;Burgos;098;Cerezo de Río Tirón;977;513;464
09;Burgos;100;Cerratón de Juarros;75;41;34
09;Burgos;101;Ciadoncha;154;81;73
09;Burgos;102;Cillaperlata;109;58;51
09;Burgos;103;Cilleruelo de Abajo;428;236;192
09;Burgos;104;Cilleruelo de Arriba;108;60;48
09;Burgos;105;Ciruelos de Cervera;211;109;102
09;Burgos;108;Cogollos;219;119;100
09;Burgos;109;Condado de Treviño;1100;603;497
09;Burgos;110;Contreras;107;64;43
09;Burgos;112;Coruña del Conde;208;117;91
09;Burgos;113;Covarrubias;745;385;360
09;Burgos;114;Cubillo del Campo;82;46;36
09;Burgos;115;Cubo de Bureba;178;89;89
09;Burgos;117;Cueva de Roa (La);159;93;66
09;Burgos;119;Cuevas de San Clemente;99;44;55
09;Burgos;120;Encío;58;33;25
09;Burgos;122;Espinosa de Cervera;125;76;49
09;Burgos;124;Espinosa de los Monteros;2496;1292;1204
09;Burgos;123;Espinosa del Camino;62;32;30
09;Burgos;125;Estépar;1044;552;492
09;Burgos;127;Fontioso;120;63;57
09;Burgos;128;Frandovínez;97;52;45
09;Burgos;129;Fresneda de la Sierra Tirón;134;65;69
09;Burgos;130;Fresneña;170;93;77
09;Burgos;131;Fresnillo de las Dueñas;352;183;169
09;Burgos;132;Fresno de Río Tirón;326;187;139
09;Burgos;133;Fresno de Rodilla;33;18;15
09;Burgos;134;Frías;332;173;159
09;Burgos;135;Fuentebureba;141;66;75
09;Burgos;136;Fuentecén;378;212;166
09;Burgos;137;Fuentelcésped;294;139;155
09;Burgos;138;Fuentelisendo;162;88;74
09;Burgos;139;Fuentemolinos;166;90;76
09;Burgos;140;Fuentenebro;245;137;108
09;Burgos;141;Fuentespina;595;320;275
09;Burgos;143;Galbarros;29;20;9
09;Burgos;144;Gallega (La);113;61;52
09;Burgos;148;Grijalba;183;89;94
09;Burgos;149;Grisaleña;81;48;33
09;Burgos;151;Gumiel de Izán;758;409;349
09;Burgos;152;Gumiel de Mercado;562;297;265
09;Burgos;154;Hacinas;243;131;112
09;Burgos;155;Haza;47;26;21
09;Burgos;159;Hontanas;102;59;43
09;Burgos;160;Hontangas;196;107;89
09;Burgos;162;Hontoria de la Cantera;173;82;91
09;Burgos;164;Hontoria de Valdearados;317;183;134
09;Burgos;163;Hontoria del Pinar;1114;601;513
09;Burgos;166;Hormazas (Las);194;98;96
09;Burgos;167;Hornillos del Camino;109;55;54
09;Burgos;168;Horra (La);579;300;279
09;Burgos;169;Hortigüela;129;76;53
09;Burgos;170;Hoyales de Roa;408;198;210
09;Burgos;172;Huérmeces;172;96;76
09;Burgos;173;Huerta de Arriba;247;126;121
09;Burgos;174;Huerta de Rey;1315;694;621
09;Burgos;175;Humada;353;205;148
09;Burgos;176;Hurones;72;43;29
09;Burgos;177;Ibeas de Juarros;856;449;407
09;Burgos;178;Ibrillos;138;75;63
09;Burgos;179;Iglesiarrubia;77;41;36
09;Burgos;180;Iglesias;239;122;117
09;Burgos;181;Isar;506;242;264
09;Burgos;182;Itero del Castillo;152;74;78
09;Burgos;183;Jaramillo de la Fuente;42;20;22
09;Burgos;184;Jaramillo Quemado;24;13;11
09;Burgos;189;Junta de Traslaloma;261;143;118
09;Burgos;190;Junta de Villalba de Losa;108;60;48
09;Burgos;191;Jurisdicción de Lara;69;37;32
09;Burgos;192;Jurisdicción de San Zadornil;90;49;41
09;Burgos;194;Lerma;2635;1307;1328
09;Burgos;195;Llano de Bureba;81;44;37
09;Burgos;196;Madrigal del Monte;210;102;108
09;Burgos;197;Madrigalejo del Monte;175;98;77
09;Burgos;198;Mahamud;207;102;105
09;Burgos;199;Mambrilla de Castrejón;183;95;88
09;Burgos;200;Mambrillas de Lara;90;46;44
09;Burgos;201;Mamolar;112;62;50
09;Burgos;202;Manciles;53;28;25
09;Burgos;206;Mazuela;100;50;50
09;Burgos;208;Mecerreyes;382;182;200
09;Burgos;209;Medina de Pomar;5266;2610;2656
09;Burgos;211;Melgar de Fernamental;2361;1183;1178
09;Burgos;213;Merindad de Cuesta-Urria;650;359;291
09;Burgos;214;Merindad de Montija;1119;598;521
09;Burgos;431;Villafranca Montes de Oca;246;130;116
09;Burgos;432;Villafruela;383;199;184
09;Burgos;433;Villagalijo;83;45;38
09;Burgos;434;Villagonzalo Pedernales;492;250;242
09;Burgos;437;Villahoz;491;236;255
09;Burgos;438;Villalba de Duero;562;301;261
09;Burgos;439;Villalbilla de Burgos;493;275;218
09;Burgos;440;Villalbilla de Gumiel;174;93;81
09;Burgos;441;Villaldemiro;99;46;53
09;Burgos;442;Villalmanzo;481;262;219
09;Burgos;443;Villamayor de los Montes;333;170;163
09;Burgos;444;Villamayor de Treviño;133;77;56
09;Burgos;445;Villambistia;110;59;51
09;Burgos;446;Villamedianilla;40;18;22
09;Burgos;447;Villamiel de la Sierra;43;26;17
09;Burgos;448;Villangómez;436;225;211
09;Burgos;449;Villanueva de Argaño;120;69;51
09;Burgos;450;Villanueva de Carazo;29;19;10
09;Burgos;451;Villanueva de Gumiel;349;188;161
09;Burgos;454;Villanueva de Teba;98;53;45
09;Burgos;455;Villaquirán de la Puebla;77;43;34
09;Burgos;456;Villaquirán de los Infantes;236;121;115
09;Burgos;903;Villarcayo de Merindad de Castilla la Vieja;4475;2203;2272
09;Burgos;458;Villariezo;145;77;68
09;Burgos;460;Villasandino;363;188;175
09;Burgos;463;Villasur de Herreros;310;158;152
09;Burgos;464;Villatuelda;98;54;44
09;Burgos;466;Villaverde del Monte;259;142;117
09;Burgos;467;Villaverde-Mogina;157;88;69
09;Burgos;471;Villayerno Morquillas;133;62;71
09;Burgos;472;Villazopeque;104;56;48
09;Burgos;473;Villegas;155;79;76
09;Burgos;476;Villoruebo;31;20;11
09;Burgos;424;Viloria de Rioja;89;47;42
09;Burgos;425;Vilviestre del Pinar;922;462;460
09;Burgos;478;Vizcaínos;68;35;33
09;Burgos;480;Zael;179;86;93
09;Burgos;482;Zarzosa de Río Pisuerga;81;41;40
09;Burgos;483;Zazuar;366;194;172
09;Burgos;485;Zuñeda;126;68;58
09;Burgos;906;Merindad de Río Ubierna;1057;562;495
09;Burgos;215;Merindad de Sotoscueva;784;403;381
09;Burgos;216;Merindad de Valdeporres;620;325;295
09;Burgos;217;Merindad de Valdivielso;712;358;354
09;Burgos;218;Milagros;461;228;233
09;Burgos;219;Miranda de Ebro;35892;17952;17940
09;Burgos;220;Miraveche;159;83;76
09;Burgos;221;Modúbar de la Emparedada;206;114;92
09;Burgos;223;Monasterio de la Sierra;33;17;16
09;Burgos;224;Monasterio de Rodilla;232;119;113
09;Burgos;225;Moncalvillo;173;96;77
09;Burgos;226;Monterrubio de la Demanda;114;65;49
09;Burgos;227;Montorio;192;92;100
09;Burgos;228;Moradillo de Roa;246;129;117
09;Burgos;229;Nava de Roa;369;185;184
09;Burgos;230;Navas de Bureba;59;30;29
09;Burgos;231;Nebreda;159;99;60
09;Burgos;232;Neila;265;135;130
09;Burgos;235;Olmedillo de Roa;346;175;171
09;Burgos;236;Olmillos de Muñó;61;31;30
09;Burgos;238;Oña;1812;932;880
09;Burgos;239;Oquillas;76;42;34
09;Burgos;241;Orbaneja Riopico;118;65;53
09;Burgos;242;Padilla de Abajo;147;83;64
09;Burgos;243;Padilla de Arriba;163;86;77
09;Burgos;244;Padrones de Bureba;114;60;54
09;Burgos;246;Palacios de la Sierra;1011;515;496
09;Burgos;247;Palacios de Riopisuerga;58;28;30
09;Burgos;248;Palazuelos de la Sierra;75;41;34
09;Burgos;249;Palazuelos de Muñó;87;48;39
09;Burgos;250;Pampliega;472;246;226
09;Burgos;251;Pancorbo;625;313;312
09;Burgos;253;Pardilla;126;61;65
09;Burgos;255;Partido de la Sierra en Tobalina;87;52;35
09;Burgos;256;Pedrosa de Duero;717;378;339
09;Burgos;259;Pedrosa de Río Úrbel;327;172;155
09;Burgos;257;Pedrosa del Páramo;123;68;55
09;Burgos;258;Pedrosa del Príncipe;341;182;159
09;Burgos;261;Peñaranda de Duero;738;381;357
09;Burgos;262;Peral de Arlanza;298;159;139
09;Burgos;265;Piérnigas;52;32;20
09;Burgos;266;Pineda de la Sierra;121;68;53
09;Burgos;267;Pineda Trasmonte;248;127;121
09;Burgos;268;Pinilla de los Barruecos;218;112;106
09;Burgos;269;Pinilla de los Moros;60;37;23
09;Burgos;270;Pinilla Trasmonte;326;165;161
09;Burgos;272;Poza de la Sal;553;257;296
09;Burgos;273;Prádanos de Bureba;100;59;41
09;Burgos;274;Pradoluengo;1766;863;903
09;Burgos;275;Presencio;320;172;148
09;Burgos;276;Puebla de Arganzón (La);330;175;155
09;Burgos;277;Puentedura;170;91;79
09;Burgos;279;Quemada;299;164;135
09;Burgos;281;Quintana del Pidio;240;129;111
09;Burgos;280;Quintanabureba;74;45;29
09;Burgos;283;Quintanaélez;153;83;70
09;Burgos;287;Quintanaortuño;130;65;65
09;Burgos;288;Quintanapalla;169;91;78
09;Burgos;289;Quintanar de la Sierra;2970;1534;1436
09;Burgos;292;Quintanavides;95;44;51
09;Burgos;294;Quintanilla de la Mata;198;113;85
09;Burgos;901;Quintanilla del Agua y Tordueles;732;371;361
09;Burgos;295;Quintanilla del Coco;146;81;65
09;Burgos;298;Quintanilla San García;176;94;82
09;Burgos;301;Quintanilla Vivar;286;133;153
09;Burgos;297;Quintanillas (Las);361;189;172
09;Burgos;302;Rabanera del Pinar;242;105;137
09;Burgos;303;Rábanos;64;36;28
09;Burgos;304;Rabé de las Calzadas;164;93;71
09;Burgos;306;Rebolledo de la Torre;222;110;112
09;Burgos;307;Redecilla del Camino;156;89;67
09;Burgos;308;Redecilla del Campo;123;66;57
09;Burgos;309;Regumiel de la Sierra;595;302;293
09;Burgos;310;Reinoso;35;22;13
09;Burgos;311;Retuerta;80;42;38
09;Burgos;314;Revilla del Campo;164;84;80
09;Burgos;316;Revilla Vallejera;189;107;82
09;Burgos;312;Revilla y Ahedo (La);140;71;69
09;Burgos;315;Revillarruz;183;94;89
09;Burgos;317;Rezmondo;29;15;14
09;Burgos;318;Riocavado de la Sierra;74;41;33
09;Burgos;321;Roa;2538;1300;1238
09;Burgos;323;Rojas;104;55;49
09;Burgos;325;Royuela de Río Franco;455;251;204
09;Burgos;326;Rubena;174;89;85
09;Burgos;327;Rublacedo de Abajo;45;22;23
09;Burgos;328;Rucandio;127;64;63
09;Burgos;329;Salas de Bureba;226;125;101
09;Burgos;330;Salas de los Infantes;2218;1142;1076
09;Burgos;332;Saldaña de Burgos;80;41;39
09;Burgos;334;Salinillas de Bureba;77;48;29
09;Burgos;335;San Adrián de Juarros;43;20;23
09;Burgos;337;San Juan del Monte;254;130;124
09;Burgos;338;San Mamés de Burgos;143;79;64
09;Burgos;339;San Martín de Rubiales;421;224;197
09;Burgos;340;San Millán de Lara;123;68;55
09;Burgos;360;San Vicente del Valle;37;19;18
09;Burgos;343;Santa Cecilia;140;74;66
09;Burgos;345;Santa Cruz de la Salceda;229;114;115
09;Burgos;346;Santa Cruz del Valle Urbión;164;99;65
09;Burgos;347;Santa Gadea del Cid;214;111;103
09;Burgos;348;Santa Inés;262;141;121
09;Burgos;350;Santa María del Campo;815;429;386
09;Burgos;351;Santa María del Invierno;77;45;32
09;Burgos;352;Santa María del Mercadillo;252;144;108
09;Burgos;353;Santa María Rivarredonda;181;95;86
09;Burgos;354;Santa Olalla de Bureba;51;21;30
09;Burgos;355;Santibáñez de Esgueva;218;111;107
09;Burgos;356;Santibáñez del Val;89;49;40
09;Burgos;358;Santo Domingo de Silos;369;239;130
09;Burgos;361;Sargentes de la Lora;227;118;109
09;Burgos;362;Sarracín;158;78;80
09;Burgos;363;Sasamón;1793;948;845
09;Burgos;365;Sequera de Haza (La);84;49;35
09;Burgos;366;Solarana;153;78;75
09;Burgos;368;Sordillos;47;27;20
09;Burgos;369;Sotillo de la Ribera;600;333;267
09;Burgos;372;Sotragero;139;81;58
09;Burgos;373;Sotresgudo;947;513;434
09;Burgos;374;Susinos del Páramo;83;39;44
09;Burgos;375;Tamarón;60;31;29
09;Burgos;377;Tardajos;695;363;332
09;Burgos;378;Tejada;62;32;30
09;Burgos;380;Terradillos de Esgueva;143;73;70
09;Burgos;381;Tinieblas de la Sierra;31;17;14
09;Burgos;382;Tobar;63;34;29
09;Burgos;384;Tordómar;461;254;207
09;Burgos;386;Torrecilla del Monte;94;48;46
09;Burgos;387;Torregalindo;203;112;91
09;Burgos;388;Torrelara;17;9;8
09;Burgos;389;Torrepadre;235;126;109
09;Burgos;390;Torresandino;946;501;445
09;Burgos;391;Tórtoles de Esgueva;697;373;324
09;Burgos;392;Tosantos;93;46;47
09;Burgos;394;Trespaderne;1250;663;587
09;Burgos;395;Tubilla del Agua;172;95;77
09;Burgos;396;Tubilla del Lago;254;125;129
09;Burgos;398;Úrbel del Castillo;152;78;74
09;Burgos;400;Vadocondes;578;296;282
09;Burgos;403;Valdeande;233;119;114
09;Burgos;405;Valdezate;274;146;128
09;Burgos;406;Valdorros;112;60;52
09;Burgos;408;Vallarta de Bureba;112;63;49
09;Burgos;904;Valle de las Navas;668;372;296
09;Burgos;908;Valle de Losa;816;443;373
09;Burgos;409;Valle de Manzanedo;148;77;71
09;Burgos;410;Valle de Mena;5010;2539;2471
09;Burgos;411;Valle de Oca;226;115;111
09;Burgos;902;Valle de Santibáñez;747;396;351
09;Burgos;905;Valle de Sedano;476;246;230
09;Burgos;412;Valle de Tobalina;1132;606;526
09;Burgos;413;Valle de Valdebezana;1028;535;493
09;Burgos;414;Valle de Valdelaguna;325;162;163
09;Burgos;415;Valle de Valdelucio;475;253;222
09;Burgos;416;Valle de Zamanzas;53;28;25
09;Burgos;417;Vallejera;70;38;32
09;Burgos;418;Valles de Palenzuela;121;65;56
09;Burgos;419;Valluércanes;172;103;69
09;Burgos;407;Valmala;45;22;23
09;Burgos;422;Vid de Bureba (La);57;30;27
09;Burgos;421;Vid y Barrios (La);429;243;186
09;Burgos;423;Vileña;47;26;21
09;Burgos;427;Villadiego;2705;1412;1293
09;Burgos;428;Villaescusa de Roa;219;118;101
09;Burgos;429;Villaescusa la Sombría;79;43;36
09;Burgos;430;Villaespasa;45;27;18
10;Cáceres;001;Abadía;344;193;151
10;Cáceres;002;Abertura;545;276;269
10;Cáceres;003;Acebo;932;470;462
10;Cáceres;004;Acehúche;1076;529;547
10;Cáceres;005;Aceituna;821;425;396
10;Cáceres;006;Ahigal;2067;1069;998
10;Cáceres;007;Albalá del Caudillo;1121;548;573
10;Cáceres;008;Alcántara;2273;1126;1147
10;Cáceres;009;Alcollarín;402;199;203
10;Cáceres;010;Alcuéscar;3469;1873;1596
10;Cáceres;012;Aldea del Cano;872;416;456
10;Cáceres;013;Aldea del Obispo (La);533;266;267
10;Cáceres;011;Aldeacentenera;1115;548;567
10;Cáceres;014;Aldeanueva de la Vera;2879;1442;1437
10;Cáceres;015;Aldeanueva del Camino;1088;518;570
10;Cáceres;016;Aldehuela de Jerte;457;252;205
10;Cáceres;017;Alía;2046;1000;1046
10;Cáceres;018;Aliseda;2617;1301;1316
10;Cáceres;019;Almaraz;1343;690;653
10;Cáceres;020;Almoharín;2258;1132;1126
10;Cáceres;021;Arroyo de la Luz;6680;3316;3364
10;Cáceres;023;Arroyomolinos;1241;631;610
10;Cáceres;022;Arroyomolinos de la Vera;773;392;381
10;Cáceres;024;Baños de Montemayor;844;394;450
10;Cáceres;025;Barrado;645;311;334
10;Cáceres;026;Belvís de Monroy;519;263;256
10;Cáceres;027;Benquerencia;127;69;58
10;Cáceres;028;Berrocalejo;148;67;81
10;Cáceres;029;Berzocana;813;424;389
10;Cáceres;030;Bohonal de Ibor;810;446;364
10;Cáceres;031;Botija;235;114;121
10;Cáceres;032;Brozas;2629;1293;1336
10;Cáceres;033;Cabañas del Castillo;770;403;367
10;Cáceres;034;Cabezabellosa;680;343;337
10;Cáceres;035;Cabezuela del Valle;2601;1319;1282
10;Cáceres;036;Cabrero;571;317;254
10;Cáceres;037;Cáceres;69770;33343;36427
10;Cáceres;038;Cachorrilla;142;61;81
10;Cáceres;039;Cadalso;726;369;357
10;Cáceres;040;Calzadilla;709;332;377
10;Cáceres;041;Caminomorisco;1543;811;732
10;Cáceres;042;Campillo de Deleitosa;190;96;94
10;Cáceres;043;Campo Lugar;1418;714;704
10;Cáceres;044;Cañamero;2256;1157;1099
10;Cáceres;045;Cañaveral;1945;919;1026
10;Cáceres;046;Carbajo;301;156;145
10;Cáceres;047;Carcaboso;1405;744;661
10;Cáceres;048;Carrascalejo;544;269;275
10;Cáceres;049;Casar de Cáceres;4046;2056;1990
10;Cáceres;050;Casar de Palomero;1743;873;870
10;Cáceres;051;Casares de las Hurdes;1111;587;524
10;Cáceres;052;Casas de Don Antonio;268;122;146
10;Cáceres;053;Casas de Don Gómez;509;254;255
10;Cáceres;056;Casas de Millán;932;475;457
10;Cáceres;057;Casas de Miravete;201;106;95
10;Cáceres;054;Casas del Castañar;786;383;403
10;Cáceres;055;Casas del Monte;1031;533;498
10;Cáceres;058;Casatejada;1462;712;750
10;Cáceres;059;Casillas de Coria;804;387;417
10;Cáceres;060;Castañar de Ibor;1627;821;806
10;Cáceres;061;Ceclavín;2608;1326;1282
10;Cáceres;062;Cedillo;654;326;328
10;Cáceres;063;Cerezo;283;133;150
10;Cáceres;064;Cilleros;2543;1261;1282
10;Cáceres;065;Collado;543;292;251
10;Cáceres;066;Conquista de la Sierra;215;107;108
10;Cáceres;067;Coria;11111;5556;5555
10;Cáceres;068;Cuacos de Yuste;1070;553;517
10;Cáceres;069;Cumbre (La);1383;687;696
10;Cáceres;070;Deleitosa;1181;579;602
10;Cáceres;071;Descargamaría;330;175;155
10;Cáceres;072;Eljas;1634;825;809
10;Cáceres;073;Escurial;1024;505;519
10;Cáceres;075;Fresnedoso de Ibor;553;289;264
10;Cáceres;076;Galisteo;2368;1208;1160
10;Cáceres;077;Garciaz;1225;619;606
10;Cáceres;078;Garganta (La);729;378;351
10;Cáceres;079;Garganta la Olla;1335;686;649
10;Cáceres;080;Gargantilla;614;315;299
10;Cáceres;081;Gargüera;291;148;143
10;Cáceres;082;Garrovillas de Alconétar;2744;1305;1439
10;Cáceres;083;Garvín;162;92;70
10;Cáceres;084;Gata;2316;1150;1166
10;Cáceres;085;Gordo (El);359;177;182
10;Cáceres;086;Granja (La);510;266;244
10;Cáceres;087;Guadalupe;2807;1379;1428
10;Cáceres;088;Guijo de Coria;411;209;202
10;Cáceres;089;Guijo de Galisteo;1957;1016;941
10;Cáceres;090;Guijo de Granadilla;893;435;458
10;Cáceres;091;Guijo de Santa Bárbara;691;353;338
10;Cáceres;092;Herguijuela;574;280;294
10;Cáceres;093;Hernán-Pérez;534;277;257
10;Cáceres;094;Herrera de Alcántara;476;237;239
10;Cáceres;095;Herreruela;603;300;303
10;Cáceres;096;Hervás;3788;1851;1937
10;Cáceres;097;Higuera;145;71;74
10;Cáceres;098;Hinojal;495;242;253
10;Cáceres;099;Holguera;963;480;483
10;Cáceres;100;Hoyos;1082;535;547
10;Cáceres;101;Huélaga;223;112;111
10;Cáceres;102;Ibahernando;943;473;470
10;Cáceres;103;Jaraicejo;867;430;437
10;Cáceres;104;Jaraíz de la Vera;7619;3775;3844
10;Cáceres;105;Jarandilla de la Vera;3245;1643;1602
10;Cáceres;106;Jarilla;233;109;124
10;Cáceres;107;Jerte;1464;759;705
10;Cáceres;108;Ladrillar;691;354;337
10;Cáceres;109;Logrosán;3258;1589;1669
10;Cáceres;110;Losar de la Vera;3194;1591;1603
10;Cáceres;111;Madrigal de la Vera;1855;969;886
10;Cáceres;112;Madrigalejo;2837;1410;1427
10;Cáceres;113;Madroñera;3475;1716;1759
10;Cáceres;114;Majadas;1173;589;584
10;Cáceres;115;Malpartida de Cáceres;3604;1772;1832
10;Cáceres;116;Malpartida de Plasencia;4417;2191;2226
10;Cáceres;117;Marchagaz;472;231;241
10;Cáceres;118;Mata de Alcántara;451;222;229
10;Cáceres;119;Membrío;1024;490;534
10;Cáceres;120;Mesas de Ibor;243;133;110
10;Cáceres;121;Miajadas;9359;4661;4698
10;Cáceres;122;Millanes;258;139;119
10;Cáceres;123;Mirabel;1006;519;487
10;Cáceres;124;Mohedas de Granadilla;1361;709;652
10;Cáceres;125;Monroy;1360;684;676
10;Cáceres;126;Montánchez;2752;1363;1389
10;Cáceres;127;Montehermoso;5338;2686;2652
10;Cáceres;128;Moraleja;8432;4287;4145
10;Cáceres;129;Morcillo;551;257;294
10;Cáceres;130;Navaconcejo;2263;1151;1112
10;Cáceres;131;Navalmoral de la Mata;13788;6824;6964
10;Cáceres;132;Navalvillar de Ibor;665;345;320
10;Cáceres;133;Navas del Madroño;1787;903;884
10;Cáceres;134;Navezuelas;886;479;407
10;Cáceres;135;Nuñomoral;2331;1258;1073
10;Cáceres;136;Oliva de Plasencia;434;216;218
10;Cáceres;137;Palomero;644;332;312
10;Cáceres;138;Pasarón de la Vera;816;406;410
10;Cáceres;139;Pedroso de Acim;207;111;96
10;Cáceres;140;Peraleda de la Mata;1582;784;798
10;Cáceres;141;Peraleda de San Román;526;271;255
10;Cáceres;142;Perales del Puerto;1055;516;539
10;Cáceres;143;Pescueza;295;146;149
10;Cáceres;144;Pesga (La);1555;794;761
10;Cáceres;145;Piedras Albas;302;137;165
10;Cáceres;146;Pinofranqueado;2032;1052;980
10;Cáceres;147;Piornal;1715;868;847
10;Cáceres;148;Plasencia;32902;16126;16776
10;Cáceres;149;Plasenzuela;543;266;277
10;Cáceres;150;Portaje;528;264;264
10;Cáceres;151;Portezuelo;371;182;189
10;Cáceres;152;Pozuelo de Zarzón;752;363;389
10;Cáceres;153;Puerto de Santa Cruz;479;235;244
10;Cáceres;154;Rebollar;291;154;137
10;Cáceres;155;Riolobos;1884;994;890
10;Cáceres;156;Robledillo de Gata;243;124;119
10;Cáceres;157;Robledillo de la Vera;522;273;249
10;Cáceres;158;Robledillo de Trujillo;629;317;312
10;Cáceres;159;Robledollano;557;295;262
10;Cáceres;160;Romangordo;218;109;109
10;Cáceres;901;Rosalejo;"";"";""
10;Cáceres;161;Ruanes;111;59;52
10;Cáceres;162;Salorino;1076;511;565
10;Cáceres;163;Salvatierra de Santiago;556;285;271
10;Cáceres;164;San Martín de Trevejo;988;499;489
10;Cáceres;165;Santa Ana;462;232;230
10;Cáceres;166;Santa Cruz de la Sierra;418;211;207
10;Cáceres;167;Santa Cruz de Paniagua;599;313;286
10;Cáceres;168;Santa Marta de Magasca;455;231;224
10;Cáceres;169;Santiago de Alcántara;1106;561;545
10;Cáceres;170;Santiago del Campo;390;208;182
10;Cáceres;171;Santibáñez el Alto;728;380;348
10;Cáceres;172;Santibáñez el Bajo;1158;617;541
10;Cáceres;173;Saucedilla;487;260;227
10;Cáceres;174;Segura de Toro;234;124;110
10;Cáceres;175;Serradilla;2444;1221;1223
10;Cáceres;176;Serrejón;546;280;266
10;Cáceres;177;Sierra de Fuentes;1576;775;801
10;Cáceres;178;Talaván;1054;511;543
10;Cáceres;179;Talaveruela de la Vera;587;274;313
10;Cáceres;180;Talayuela;7591;3901;3690
10;Cáceres;181;Tejeda de Tiétar;1198;637;561
10;Cáceres;182;Toril;376;190;186
10;Cáceres;183;Tornavacas;1570;807;763
10;Cáceres;184;Torno (El);1241;640;601
10;Cáceres;187;Torre de Don Miguel;832;416;416
10;Cáceres;188;Torre de Santa María;881;444;437
10;Cáceres;185;Torrecilla de los Ángeles;789;414;375
10;Cáceres;186;Torrecillas de la Tiesa;1382;684;698
10;Cáceres;190;Torrejón el Rubio;864;444;420
10;Cáceres;189;Torrejoncillo;3974;1927;2047
10;Cáceres;191;Torremenga;557;285;272
10;Cáceres;192;Torremocha;1480;724;756
10;Cáceres;193;Torreorgaz;1454;736;718
10;Cáceres;194;Torrequemada;675;323;352
10;Cáceres;195;Trujillo;9240;4407;4833
10;Cáceres;196;Valdastillas;479;241;238
10;Cáceres;197;Valdecañas de Tajo;242;137;105
10;Cáceres;198;Valdefuentes;1686;829;857
10;Cáceres;199;Valdehúncar;188;93;95
10;Cáceres;200;Valdelacasa de Tajo;1060;505;555
10;Cáceres;201;Valdemorales;292;155;137
10;Cáceres;202;Valdeobispo;959;484;475
10;Cáceres;203;Valencia de Alcántara;7482;3724;3758
10;Cáceres;204;Valverde de la Vera;822;399;423
10;Cáceres;205;Valverde del Fresno;2876;1452;1424
10;Cáceres;206;Viandar de la Vera;503;253;250
10;Cáceres;207;Villa del Campo;811;399;412
10;Cáceres;208;Villa del Rey;219;113;106
10;Cáceres;209;Villamesías;531;254;277
10;Cáceres;210;Villamiel;923;461;462
10;Cáceres;211;Villanueva de la Sierra;907;448;459
10;Cáceres;212;Villanueva de la Vera;2173;1097;1076
10;Cáceres;214;Villar de Plasencia;410;202;208
10;Cáceres;213;Villar del Pedroso;1105;553;552
10;Cáceres;215;Villasbuenas de Gata;606;307;299
10;Cáceres;216;Zarza de Granadilla;1975;1018;957
10;Cáceres;217;Zarza de Montánchez;860;436;424
10;Cáceres;218;Zarza la Mayor;1928;938;990
10;Cáceres;219;Zorita;2707;1326;1381
11;Cádiz;001;Alcalá de los Gazules;5692;2975;2717
11;Cádiz;002;Alcalá del Valle;5278;2690;2588
11;Cádiz;003;Algar;2178;1152;1026
11;Cádiz;004;Algeciras;97601;48140;49461
11;Cádiz;005;Algodonales;5993;3123;2870
11;Cádiz;006;Arcos de la Frontera;26915;13514;13401
11;Cádiz;007;Barbate;22221;11173;11048
11;Cádiz;008;Barrios (Los);12496;6390;6106
11;Cádiz;901;Benalup-Casas Viejas;"";"";""
11;Cádiz;009;Benaocaz;509;250;259
11;Cádiz;010;Bornos;7894;3982;3912
11;Cádiz;011;Bosque (El);1783;909;874
11;Cádiz;013;Castellar de la Frontera;2147;1113;1034
11;Cádiz;015;Chiclana de la Frontera;42226;21503;20723
11;Cádiz;016;Chipiona;13618;6988;6630
11;Cádiz;014;Conil de la Frontera;14508;7497;7011
11;Cádiz;012;Cádiz;156113;75408;80705
11;Cádiz;017;Espera;4217;2213;2004
11;Cádiz;018;Gastor (El);2310;1226;1084
11;Cádiz;019;Grazalema;2304;1196;1108
11;Cádiz;020;Jerez de la Frontera;179349;88292;91057
11;Cádiz;021;Jimena de la Frontera;8563;4451;4112
11;Cádiz;022;Línea de la Concepción (La);59260;28870;30390
11;Cádiz;023;Medina-Sidonia;15896;8260;7636
11;Cádiz;024;Olvera;9239;4701;4538
11;Cádiz;025;Paterna de Rivera;4724;2460;2264
11;Cádiz;026;Prado del Rey;5423;2738;2685
11;Cádiz;028;Puerto Real;28141;14178;13963
11;Cádiz;029;Puerto Serrano;6208;3151;3057
11;Cádiz;027;Puerto de Santa María (El);61032;30484;30548
11;Cádiz;030;Rota;21583;10926;10657
11;Cádiz;031;San Fernando;80791;39967;40824
11;Cádiz;902;San José del Valle;"";"";""
11;Cádiz;033;San Roque;21497;10789;10708
11;Cádiz;032;Sanlúcar de Barrameda;53566;26867;26699
11;Cádiz;034;Setenil de las Bodegas;3333;1695;1638
11;Cádiz;035;Tarifa;14537;7341;7196
11;Cádiz;036;Torre Alháquime;1066;540;526
11;Cádiz;037;Trebujena;6824;3485;3339
11;Cádiz;038;Ubrique;17904;8892;9012
11;Cádiz;039;Vejer de la Frontera;13080;6702;6378
11;Cádiz;040;Villaluenga del Rosario;513;265;248
11;Cádiz;041;Villamartín;12181;6032;6149
11;Cádiz;042;Zahara;1706;878;828
12;Castellón/Castelló;002;Aín;140;69;71
12;Castellón/Castelló;003;Albocàsser;1567;760;807
12;Castellón/Castelló;004;Alcalà de Xivert;4632;2317;2315
12;Castellón/Castelló;005;Alcora (L');8265;4179;4086
12;Castellón/Castelló;006;Alcudia de Veo;197;93;104
12;Castellón/Castelló;007;Alfondeguilla;931;471;460
12;Castellón/Castelló;008;Algimia de Almonacid;398;212;186
12;Castellón/Castelló;009;Almazora/Almassora;15529;7711;7818
12;Castellón/Castelló;010;Almedíjar;307;151;156
12;Castellón/Castelló;011;Almenara;5044;2524;2520
12;Castellón/Castelló;901;Alquerías del Niño Perdido;3665;1801;1864
12;Castellón/Castelló;012;Altura;3038;1500;1538
12;Castellón/Castelló;013;Arañuel;135;64;71
12;Castellón/Castelló;014;Ares del Maestre;381;197;184
12;Castellón/Castelló;015;Argelita;102;52;50
12;Castellón/Castelló;016;Artana;2007;1005;1002
12;Castellón/Castelló;001;Atzeneta del Maestrat;1733;876;857
12;Castellón/Castelló;017;Ayódar;237;116;121
12;Castellón/Castelló;018;Azuébar;414;200;214
12;Castellón/Castelló;020;Barracas;206;110;96
12;Castellón/Castelló;022;Bejís;510;260;250
12;Castellón/Castelló;024;Benafer;129;71;58
12;Castellón/Castelló;025;Benafigos;299;162;137
12;Castellón/Castelló;026;Benasal;1521;738;783
12;Castellón/Castelló;027;Benicarló;17201;8392;8809
12;Castellón/Castelló;028;Benicasim/Benicàssim;5311;2654;2657
12;Castellón/Castelló;029;Benlloch;1015;521;494
12;Castellón/Castelló;021;Betxí;5149;2605;2544
12;Castellón/Castelló;031;Borriol;2446;1238;1208
12;Castellón/Castelló;032;Burriana;25369;12402;12967
12;Castellón/Castelló;033;Cabanes;2656;1288;1368
12;Castellón/Castelló;034;Càlig;1787;876;911
12;Castellón/Castelló;036;Canet lo Roig;1117;554;563
12;Castellón/Castelló;037;Castell de Cabres;31;14;17
12;Castellón/Castelló;038;Castellfort;304;158;146
12;Castellón/Castelló;039;Castellnovo;1115;568;547
12;Castellón/Castelló;040;Castellón de la Plana/Castelló de la Plana;128664;63066;65598
12;Castellón/Castelló;041;Castillo de Villamalefa;174;88;86
12;Castellón/Castelló;042;Catí;1013;515;498
12;Castellón/Castelló;043;Caudiel;729;367;362
12;Castellón/Castelló;044;Cervera del Maestre;856;421;435
12;Castellón/Castelló;052;Chert/Xert;1146;560;586
12;Castellón/Castelló;053;Chilches/Xilxes;2155;1084;1071
12;Castellón/Castelló;055;Chodos/Xodos;167;90;77
12;Castellón/Castelló;056;Chóvar;429;220;209
12;Castellón/Castelló;045;Cinctorres;653;302;351
12;Castellón/Castelló;046;Cirat;397;194;203
12;Castellón/Castelló;048;Cortes de Arenoso;418;229;189
12;Castellón/Castelló;049;Costur;481;245;236
12;Castellón/Castelló;050;Coves de Vinromà (les);2105;1048;1057
12;Castellón/Castelló;051;Culla;1085;543;542
12;Castellón/Castelló;057;Eslida;867;429;438
12;Castellón/Castelló;058;Espadilla;53;22;31
12;Castellón/Castelló;059;Fanzara;299;147;152
12;Castellón/Castelló;060;Figueroles;590;299;291
12;Castellón/Castelló;061;Forcall;666;316;350
12;Castellón/Castelló;063;Fuente la Reina;35;19;16
12;Castellón/Castelló;064;Fuentes de Ayódar;94;52;42
12;Castellón/Castelló;065;Gaibiel;280;141;139
12;Castellón/Castelló;066;Gatova;569;278;291
12;Castellón/Castelló;067;Geldo;766;390;376
12;Castellón/Castelló;068;Herbés;143;79;64
12;Castellón/Castelló;069;Higueras;43;23;20
12;Castellón/Castelló;070;Jana (La);991;495;496
12;Castellón/Castelló;071;Jérica;1757;889;868
12;Castellón/Castelló;074;Llosa (La);948;474;474
12;Castellón/Castelló;072;Lucena del Cid;1768;861;907
12;Castellón/Castelló;073;Ludiente;283;141;142
12;Castellón/Castelló;075;Mata de Morella (La);224;108;116
12;Castellón/Castelló;076;Matet;160;85;75
12;Castellón/Castelló;077;Moncofa;3474;1711;1763
12;Castellón/Castelló;078;Montán;421;216;205
12;Castellón/Castelló;079;Montanejos;485;253;232
12;Castellón/Castelló;080;Morella;3097;1502;1595
12;Castellón/Castelló;081;Navajas;517;252;265
12;Castellón/Castelló;082;Nules;11263;5544;5719
12;Castellón/Castelló;083;Olocau del Rey;173;95;78
12;Castellón/Castelló;084;Onda;17983;8967;9016
12;Castellón/Castelló;085;Oropesa del Mar/Orpesa;1996;1021;975
12;Castellón/Castelló;087;Palanques;27;16;11
12;Castellón/Castelló;088;Pavías;71;39;32
12;Castellón/Castelló;089;Peñíscola;3283;1638;1645
12;Castellón/Castelló;090;Pina de Montalgrao;224;124;100
12;Castellón/Castelló;093;Pobla de Benifassà (La);254;123;131
12;Castellón/Castelló;094;Pobla Tornesa (La);501;248;253
12;Castellón/Castelló;091;Portell de Morella;328;170;158
12;Castellón/Castelló;092;Puebla de Arenoso;228;110;118
12;Castellón/Castelló;095;Ribesalbes;1400;688;712
12;Castellón/Castelló;096;Rossell;1290;656;634
12;Castellón/Castelló;097;Sacañet;69;30;39
12;Castellón/Castelló;098;Salzadella (La);924;457;467
12;Castellón/Castelló;101;San Rafael del Río;530;265;265
12;Castellón/Castelló;902;Sant Joan de Moró;"";"";""
12;Castellón/Castelló;099;Sant Jordi/San Jorge;598;291;307
12;Castellón/Castelló;100;Sant Mateu;1923;921;1002
12;Castellón/Castelló;102;Santa Magdalena de Pulpis;747;378;369
12;Castellón/Castelló;103;Sarratella;135;68;67
12;Castellón/Castelló;104;Segorbe;7678;3749;3929
12;Castellón/Castelló;105;Sierra Engarcerán;1180;613;567
12;Castellón/Castelló;106;Soneja;1543;780;763
12;Castellón/Castelló;107;Sot de Ferrer;424;214;210
12;Castellón/Castelló;108;Sueras/Suera;616;312;304
12;Castellón/Castelló;109;Tales;802;375;427
12;Castellón/Castelló;110;Teresa;470;241;229
12;Castellón/Castelló;111;Tírig;716;351;365
12;Castellón/Castelló;112;Todolella;166;84;82
12;Castellón/Castelló;113;Toga;118;51;67
12;Castellón/Castelló;114;Torás;329;174;155
12;Castellón/Castelló;115;Toro (El);328;173;155
12;Castellón/Castelló;116;Torralba del Pinar;70;36;34
12;Castellón/Castelló;119;Torre d'En Besora (La);272;142;130
12;Castellón/Castelló;120;Torre Endoménech;326;164;162
12;Castellón/Castelló;117;Torreblanca;4607;2331;2276
12;Castellón/Castelló;118;Torrechiva;57;32;25
12;Castellón/Castelló;121;Traiguera;1735;882;853
12;Castellón/Castelló;122;Useras/Useres (Les);1262;641;621
12;Castellón/Castelló;124;Vall d'Alba;2033;1028;1005
12;Castellón/Castelló;125;Vall de Almonacid;286;141;145
12;Castellón/Castelló;126;Vall d'Uixó (La);27565;13777;13788
12;Castellón/Castelló;123;Vallat;35;17;18
12;Castellón/Castelló;127;Vallibona;138;64;74
12;Castellón/Castelló;128;Vilafamés;3033;1577;1456
12;Castellón/Castelló;132;Vilanova d'Alcolea;848;420;428
12;Castellón/Castelló;134;Vilar de Canes;231;119;112
12;Castellón/Castelló;129;Villafranca del Cid;2910;1373;1537
12;Castellón/Castelló;130;Villahermosa del Río;549;288;261
12;Castellón/Castelló;131;Villamalur;174;94;80
12;Castellón/Castelló;133;Villanueva de Viver;148;78;70
12;Castellón/Castelló;135;Villarreal/Vila-real;37035;18284;18751
12;Castellón/Castelló;136;Villavieja;3457;1720;1737
12;Castellón/Castelló;137;Villores;103;53;50
12;Castellón/Castelló;138;Vinaròs;17868;8703;9165
12;Castellón/Castelló;139;Vistabella del Maestrazgo;632;311;321
12;Castellón/Castelló;140;Viver;1275;638;637
12;Castellón/Castelló;141;Zorita del Maestrazgo;155;71;84
12;Castellón/Castelló;142;Zucaina;255;139;116
13;Ciudad Real;001;Abenójar;2147;1092;1055
13;Ciudad Real;002;Agudo;2402;1212;1190
13;Ciudad Real;003;Alamillo;799;408;391
13;Ciudad Real;004;Albaladejo;2043;988;1055
13;Ciudad Real;005;Alcázar de San Juan;26302;12835;13467
13;Ciudad Real;006;Alcoba;938;472;466
13;Ciudad Real;007;Alcolea de Calatrava;1628;811;817
13;Ciudad Real;008;Alcubillas;895;436;459
13;Ciudad Real;009;Aldea del Rey;2543;1225;1318
13;Ciudad Real;010;Alhambra;1481;741;740
13;Ciudad Real;011;Almadén;9111;4405;4706
13;Ciudad Real;012;Almadenejos;793;420;373
13;Ciudad Real;013;Almagro;8355;4020;4335
13;Ciudad Real;014;Almedina;1007;484;523
13;Ciudad Real;015;Almodóvar del Campo;8631;4336;4295
13;Ciudad Real;016;Almuradiel;850;422;428
13;Ciudad Real;017;Anchuras;543;283;260
13;Ciudad Real;903;Arenales de San Gregorio;"";"";""
13;Ciudad Real;018;Arenas de San Juan;1094;566;528
13;Ciudad Real;019;Argamasilla de Alba;7224;3584;3640
13;Ciudad Real;020;Argamasilla de Calatrava;5787;2870;2917
13;Ciudad Real;021;Arroba de los Montes;749;389;360
13;Ciudad Real;022;Ballesteros de Calatrava;736;364;372
13;Ciudad Real;023;Bolaños de Calatrava;10170;5034;5136
13;Ciudad Real;024;Brazatortas;1499;748;751
13;Ciudad Real;025;Cabezarados;439;224;215
13;Ciudad Real;026;Cabezarrubias del Puerto;816;417;399
13;Ciudad Real;027;Calzada de Calatrava;5258;2584;2674
13;Ciudad Real;028;Campo de Criptana;13773;6737;7036
13;Ciudad Real;029;Cañada de Calatrava;102;57;45
13;Ciudad Real;030;Caracuel de Calatrava;204;102;102
13;Ciudad Real;031;Carrión de Calatrava;2476;1193;1283
13;Ciudad Real;032;Carrizosa;1799;896;903
13;Ciudad Real;033;Castellar de Santiago;2599;1266;1333
13;Ciudad Real;038;Chillón;2789;1357;1432
13;Ciudad Real;034;Ciudad Real;55072;26199;28873
13;Ciudad Real;035;Corral de Calatrava;1437;701;736
13;Ciudad Real;036;Cortijos (Los);1264;639;625
13;Ciudad Real;037;Cózar;1658;807;851
13;Ciudad Real;039;Daimiel;17198;8371;8827
13;Ciudad Real;040;Fernán Caballero;1142;545;597
13;Ciudad Real;041;Fontanarejo;518;265;253
13;Ciudad Real;042;Fuencaliente;1473;779;694
13;Ciudad Real;043;Fuenllana;378;163;215
13;Ciudad Real;044;Fuente el Fresno;3729;1825;1904
13;Ciudad Real;045;Granátula de Calatrava;1225;594;631
13;Ciudad Real;046;Guadalmez;1193;616;577
13;Ciudad Real;047;Herencia;7131;3520;3611
13;Ciudad Real;048;Hinojosas de Calatrava;1073;515;558
13;Ciudad Real;049;Horcajo de los Montes;1251;641;610
13;Ciudad Real;050;Labores (Las);693;343;350
13;Ciudad Real;904;Llanos del Caudillo;"";"";""
13;Ciudad Real;051;Luciana;540;283;257
13;Ciudad Real;052;Malagón;8148;4016;4132
13;Ciudad Real;053;Manzanares;17870;8686;9184
13;Ciudad Real;054;Membrilla;6747;3375;3372
13;Ciudad Real;055;Mestanza;1260;610;650
13;Ciudad Real;056;Miguelturra;7271;3581;3690
13;Ciudad Real;057;Montiel;1776;886;890
13;Ciudad Real;058;Moral de Calatrava;5355;2577;2778
13;Ciudad Real;059;Navalpino;397;203;194
13;Ciudad Real;060;Navas de Estena;520;282;238
13;Ciudad Real;061;Pedro Muñoz;7251;3622;3629
13;Ciudad Real;062;Picón;605;320;285
13;Ciudad Real;063;Piedrabuena;5135;2571;2564
13;Ciudad Real;064;Poblete;672;342;330
13;Ciudad Real;065;Porzuna;4115;2083;2032
13;Ciudad Real;066;Pozuelo de Calatrava;2355;1144;1211
13;Ciudad Real;067;Pozuelos de Calatrava (Los);687;366;321
13;Ciudad Real;068;Puebla de Don Rodrigo;1420;748;672
13;Ciudad Real;069;Puebla del Príncipe;1169;598;571
13;Ciudad Real;070;Puerto Lápice;1057;529;528
13;Ciudad Real;071;Puertollano;51755;25373;26382
13;Ciudad Real;072;Retuerta del Bullaque;1130;584;546
13;Ciudad Real;901;Robledo (El);1299;678;621
13;Ciudad Real;902;Ruidera;"";"";""
13;Ciudad Real;073;Saceruela;866;448;418
13;Ciudad Real;074;San Carlos del Valle;1306;661;645
13;Ciudad Real;075;San Lorenzo de Calatrava;426;226;200
13;Ciudad Real;076;Santa Cruz de los Cáñamos;735;373;362
13;Ciudad Real;077;Santa Cruz de Mudela;5071;2447;2624
13;Ciudad Real;078;Socuéllamos;11923;5840;6083
13;Ciudad Real;080;Solana del Pino;803;398;405
13;Ciudad Real;079;Solana (La);14367;7129;7238
13;Ciudad Real;081;Terrinches;1220;605;615
13;Ciudad Real;082;Tomelloso;28344;13878;14466
13;Ciudad Real;083;Torralba de Calatrava;3158;1524;1634
13;Ciudad Real;084;Torre de Juan Abad;2042;998;1044
13;Ciudad Real;085;Torrenueva;3401;1672;1729
13;Ciudad Real;086;Valdemanco del Esteras;368;188;180
13;Ciudad Real;087;Valdepeñas;25337;12245;13092
13;Ciudad Real;088;Valenzuela de Calatrava;871;412;459
13;Ciudad Real;089;Villahermosa;3373;1597;1776
13;Ciudad Real;090;Villamanrique;2010;997;1013
13;Ciudad Real;091;Villamayor de Calatrava;854;430;424
13;Ciudad Real;092;Villanueva de la Fuente;3230;1614;1616
13;Ciudad Real;093;Villanueva de los Infantes;6333;3031;3302
13;Ciudad Real;094;Villanueva de San Carlos;619;305;314
13;Ciudad Real;095;Villar del Pozo;106;52;54
13;Ciudad Real;096;Villarrubia de los Ojos;9458;4746;4712
13;Ciudad Real;097;Villarta de San Juan;3001;1474;1527
13;Ciudad Real;098;Viso del Marqués;3466;1698;1768
14;Córdoba;001;Adamuz;4610;2327;2283
14;Córdoba;002;Aguilar de la Frontera;12862;6318;6544
14;Córdoba;003;Alcaracejos;1527;775;752
14;Córdoba;004;Almedinilla;2813;1401;1412
14;Córdoba;005;Almodóvar del Río;6866;3446;3420
14;Córdoba;006;Añora;1832;880;952
14;Córdoba;007;Baena;18836;9330;9506
14;Córdoba;008;Belalcázar;4172;2016;2156
14;Córdoba;009;Belmez;4697;2268;2429
14;Córdoba;010;Benamejí;4653;2289;2364
14;Córdoba;011;Blázquez (Los);808;413;395
14;Córdoba;012;Bujalance;8912;4402;4510
14;Córdoba;013;Cabra;20181;9861;10320
14;Córdoba;015;Carcabuey;3085;1510;1575
14;Córdoba;016;Cardeña;2205;1113;1092
14;Córdoba;017;Carlota (La);8853;4437;4416
14;Córdoba;018;Carpio (El);4850;2383;2467
14;Córdoba;019;Castro del Río;7883;3844;4039
14;Córdoba;014;Cañete de las Torres;3490;1756;1734
14;Córdoba;020;Conquista;594;292;302
14;Córdoba;021;Córdoba;298372;144075;154297
14;Córdoba;023;Dos Torres;2510;1226;1284
14;Córdoba;022;Doña Mencía;5193;2565;2628
14;Córdoba;024;Encinas Reales;2229;1094;1135
14;Córdoba;025;Espejo;5173;2535;2638
14;Córdoba;026;Espiel;2883;1424;1459
14;Córdoba;027;Fernán-Núñez;9241;4593;4648
14;Córdoba;029;Fuente Obejuna;7033;3567;3466
14;Córdoba;030;Fuente Palmera;9105;4620;4485
14;Córdoba;028;Fuente la Lancha;527;261;266
14;Córdoba;031;Fuente-Tójar;923;449;474
14;Córdoba;032;Granjuela (La);568;293;275
14;Córdoba;033;Guadalcázar;1250;636;614
14;Córdoba;034;Guijo (El);530;273;257
14;Córdoba;035;Hinojosa del Duque;8244;3935;4309
14;Córdoba;036;Hornachuelos;5310;2707;2603
14;Córdoba;037;Iznájar;6287;3166;3121
14;Córdoba;038;Lucena;31243;15591;15652
14;Córdoba;039;Luque;3467;1711;1756
14;Córdoba;040;Montalbán de Córdoba;4402;2203;2199
14;Córdoba;041;Montemayor;3707;1875;1832
14;Córdoba;042;Montilla;22188;10973;11215
14;Córdoba;043;Montoro;9992;4907;5085
14;Córdoba;044;Monturque;2000;1019;981
14;Córdoba;045;Moriles;3673;1826;1847
14;Córdoba;046;Nueva Carteya;5870;2957;2913
14;Córdoba;047;Obejo;1505;745;760
14;Córdoba;048;Palenciana;1759;875;884
14;Córdoba;049;Palma del Río;18692;9306;9386
14;Córdoba;050;Pedro Abad;3045;1491;1554
14;Córdoba;051;Pedroche;1937;962;975
14;Córdoba;052;Peñarroya-Pueblonuevo;13842;6605;7237
14;Córdoba;053;Posadas;7030;3528;3502
14;Córdoba;054;Pozoblanco;14556;6957;7599
14;Córdoba;055;Priego de Córdoba;20788;10168;10620
14;Córdoba;056;Puente Genil;26961;13138;13823
14;Córdoba;057;Rambla (La);7062;3507;3555
14;Córdoba;058;Rute;10142;4924;5218
14;Córdoba;059;San Sebastián de los Ballesteros;823;422;401
14;Córdoba;061;Santa Eufemia;1389;693;696
14;Córdoba;060;Santaella;5771;2894;2877
14;Córdoba;062;Torrecampo;1698;822;876
14;Córdoba;063;Valenzuela;1703;810;893
14;Córdoba;064;Valsequillo;641;321;320
14;Córdoba;065;Victoria (La);1741;860;881
14;Córdoba;066;Villa del Río;7117;3599;3518
14;Córdoba;067;Villafranca de Córdoba;3562;1799;1763
14;Córdoba;068;Villaharta;672;322;350
14;Córdoba;069;Villanueva de Córdoba;10527;5098;5429
14;Córdoba;070;Villanueva del Duque;2179;1011;1168
14;Córdoba;071;Villanueva del Rey;1408;726;682
14;Córdoba;072;Villaralto;1884;894;990
14;Córdoba;073;Villaviciosa de Córdoba;4293;2181;2112
14;Córdoba;074;Viso (El);3666;1800;1866
14;Córdoba;075;Zuheros;1060;521;539
15;Coruña (A);001;Abegondo;6163;3048;3115
15;Coruña (A);002;Ames;9647;4617;5030
15;Coruña (A);003;Aranga;2679;1322;1357
15;Coruña (A);004;Ares;4816;2355;2461
15;Coruña (A);005;Arteixo;16982;8552;8430
15;Coruña (A);006;Arzúa;7376;3704;3672
15;Coruña (A);007;Baña (A);7487;3667;3820
15;Coruña (A);008;Bergondo;5565;2686;2879
15;Coruña (A);009;Betanzos;11775;5486;6289
15;Coruña (A);010;Boimorto;3296;1666;1630
15;Coruña (A);011;Boiro;17762;8577;9185
15;Coruña (A);012;Boqueixón;5018;2506;2512
15;Coruña (A);013;Brión;7043;3406;3637
15;Coruña (A);014;Cabana de Bergantiños;7201;3638;3563
15;Coruña (A);015;Cabanas;3288;1587;1701
15;Coruña (A);016;Camariñas;7467;3729;3738
15;Coruña (A);017;Cambre;10784;5253;5531
15;Coruña (A);018;Capela (A);1859;926;933
15;Coruña (A);019;Carballo;27098;13470;13628
15;Coruña (A);901;Cariño;"";"";""
15;Coruña (A);020;Carnota;7194;3474;3720
15;Coruña (A);021;Carral;5659;2818;2841
15;Coruña (A);022;Cedeira;7938;3876;4062
15;Coruña (A);023;Cee;7815;3835;3980
15;Coruña (A);024;Cerceda;7423;3650;3773
15;Coruña (A);025;Cerdido;2132;1040;1092
15;Coruña (A);026;Cesuras;3321;1659;1662
15;Coruña (A);027;Coirós;1632;815;817
15;Coruña (A);028;Corcubión;2104;1020;1084
15;Coruña (A);029;Coristanco;10303;5229;5074
15;Coruña (A);030;A Coruña;242437;114097;128340
15;Coruña (A);031;Culleredo;13395;6517;6878
15;Coruña (A);032;Curtis;5126;2541;2585
15;Coruña (A);033;Dodro;3682;1778;1904
15;Coruña (A);034;Dumbría;5082;2520;2562
15;Coruña (A);035;Fene;15811;7785;8026
15;Coruña (A);036;Ferrol;86329;40849;45480
15;Coruña (A);037;Fisterra;5532;2769;2763
15;Coruña (A);038;Frades;3627;1840;1787
15;Coruña (A);039;Irixoa;2037;986;1051
15;Coruña (A);041;Laracha (A);12027;6018;6009
15;Coruña (A);040;Laxe;3792;1894;1898
15;Coruña (A);042;Lousame;5034;2456;2578
15;Coruña (A);043;Malpica de Bergantiños;8574;4226;4348
15;Coruña (A);045;Mazaricos;7295;3533;3762
15;Coruña (A);044;Mañón;2515;1211;1304
15;Coruña (A);046;Melide;8310;4136;4174
15;Coruña (A);047;Mesía;4249;2136;2113
15;Coruña (A);048;Miño;5281;2519;2762
15;Coruña (A);049;Moeche;1893;910;983
15;Coruña (A);050;Monfero;3309;1686;1623
15;Coruña (A);051;Mugardos;6982;3399;3583
15;Coruña (A);053;Muros;12080;5836;6244
15;Coruña (A);052;Muxía;7062;3467;3595
15;Coruña (A);054;Narón;30333;14773;15560
15;Coruña (A);055;Neda;6816;3253;3563
15;Coruña (A);056;Negreira;7260;3464;3796
15;Coruña (A);057;Noia;14358;6978;7380
15;Coruña (A);058;Oleiros;16482;8008;8474
15;Coruña (A);059;Ordes;11917;5862;6055
15;Coruña (A);060;Oroso;4073;2014;2059
15;Coruña (A);061;Ortigueira;16248;7786;8462
15;Coruña (A);062;Outes;10106;4807;5299
15;Coruña (A);063;Oza dos Ríos;3478;1705;1773
15;Coruña (A);064;Paderne;3075;1473;1602
15;Coruña (A);065;Padrón;10200;4953;5247
15;Coruña (A);066;Pino (O);5697;2853;2844
15;Coruña (A);067;Pobra do Caramiñal (A);10357;4950;5407
15;Coruña (A);068;Ponteceso;8647;4362;4285
15;Coruña (A);069;Pontedeume;8628;4161;4467
15;Coruña (A);070;Pontes de García Rodríguez (As);13544;6856;6688
15;Coruña (A);071;Porto do Son;11224;5501;5723
15;Coruña (A);072;Rianxo;13218;6507;6711
15;Coruña (A);073;Ribeira;25306;12426;12880
15;Coruña (A);074;Rois;6110;2994;3116
15;Coruña (A);075;Sada;8240;3938;4302
15;Coruña (A);076;San Sadurniño;4079;1968;2111
15;Coruña (A);077;Santa Comba;12112;5935;6177
15;Coruña (A);078;Santiago de Compostela;86818;41355;45463
15;Coruña (A);079;Santiso;2827;1479;1348
15;Coruña (A);080;Sobrado;3133;1608;1525
15;Coruña (A);081;Somozas (As);1827;903;924
15;Coruña (A);082;Teo;11258;5487;5771
15;Coruña (A);083;Toques;2191;1136;1055
15;Coruña (A);084;Tordoia;6092;2936;3156
15;Coruña (A);085;Touro;5596;2776;2820
15;Coruña (A);086;Trazo;5034;2538;2496
15;Coruña (A);088;Val do Dubra;6240;3084;3156
15;Coruña (A);087;Valdoviño;7132;3562;3570
15;Coruña (A);089;Vedra;5721;2753;2968
15;Coruña (A);091;Vilarmaior;1604;775;829
15;Coruña (A);090;Vilasantar;2383;1209;1174
15;Coruña (A);092;Vimianzo;9667;4790;4877
15;Coruña (A);093;Zas;7079;3459;3620
16;Cuenca;001;Abia de la Obispalía;118;65;53
16;Cuenca;002;Acebrón (El);345;169;176
16;Cuenca;003;Alarcón;251;132;119
16;Cuenca;004;Albaladejo del Cuende;528;282;246
16;Cuenca;005;Albalate de las Nogueras;474;258;216
16;Cuenca;006;Albendea;243;125;118
16;Cuenca;007;Alberca de Záncara (La);2039;1007;1032
16;Cuenca;008;Alcalá de la Vega;238;123;115
16;Cuenca;009;Alcantud;187;98;89
16;Cuenca;011;Alcohujate;92;48;44
16;Cuenca;012;Alconchel de la Estrella;245;117;128
16;Cuenca;010;Alcázar del Rey;314;158;156
16;Cuenca;013;Algarra;40;20;20
16;Cuenca;014;Aliaguilla;989;497;492
16;Cuenca;015;Almarcha (La);762;374;388
16;Cuenca;016;Almendros;480;243;237
16;Cuenca;017;Almodóvar del Pinar;601;312;289
16;Cuenca;018;Almonacid del Marquesado;631;324;307
16;Cuenca;019;Altarejos;517;260;257
16;Cuenca;020;Arandilla del Arroyo;65;34;31
16;Cuenca;905;Arcas del Villar;384;191;193
16;Cuenca;022;Arcos de la Sierra;151;82;69
16;Cuenca;024;Arguisuelas;251;128;123
16;Cuenca;025;Arrancacepas;52;26;26
16;Cuenca;026;Atalaya del Cañavate;162;79;83
16;Cuenca;027;Barajas de Melo;781;386;395
16;Cuenca;029;Barchín del Hoyo;190;104;86
16;Cuenca;030;Bascuñana de San Pedro;39;19;20
16;Cuenca;031;Beamud;101;58;43
16;Cuenca;032;Belinchón;357;178;179
16;Cuenca;033;Belmonte;2779;1297;1482
16;Cuenca;034;Belmontejo;342;179;163
16;Cuenca;035;Beteta;470;234;236
16;Cuenca;036;Boniches;265;129;136
16;Cuenca;038;Buciegas;118;61;57
16;Cuenca;039;Buenache de Alarcón;728;368;360
16;Cuenca;040;Buenache de la Sierra;114;69;45
16;Cuenca;041;Buendía;473;237;236
16;Cuenca;042;Campillo de Altobuey;1835;920;915
16;Cuenca;043;Campillos-Paravientos;177;95;82
16;Cuenca;044;Campillos-Sierra;104;57;47
16;Cuenca;901;Campos del Paraíso;1576;730;846
16;Cuenca;045;Canalejas del Arroyo;469;242;227
16;Cuenca;055;Carboneras de Guadazaón;1134;605;529
16;Cuenca;056;Cardenete;811;417;394
16;Cuenca;057;Carrascosa;180;99;81
16;Cuenca;058;Carrascosa de Haro;210;101;109
16;Cuenca;060;Casas de Benítez;1280;632;648
16;Cuenca;061;Casas de Fernando Alonso;1516;743;773
16;Cuenca;062;Casas de Garcimolina;41;18;23
16;Cuenca;063;Casas de Guijarro;218;108;110
16;Cuenca;064;Casas de Haro;972;480;492
16;Cuenca;065;Casas de los Pinos;638;322;316
16;Cuenca;066;Casasimarro;3144;1564;1580
16;Cuenca;067;Castejón;305;160;145
16;Cuenca;068;Castillejo de Iniesta;203;116;87
16;Cuenca;070;Castillejo-Sierra;64;29;35
16;Cuenca;072;Castillo de Garcimuñoz;339;173;166
16;Cuenca;071;Castillo-Albaráñez;40;19;21
16;Cuenca;047;Cañada Juncosa;443;231;212
16;Cuenca;046;Cañada del Hoyo;444;227;217
16;Cuenca;048;Cañamares;626;336;290
16;Cuenca;049;Cañavate (El);347;178;169
16;Cuenca;050;Cañaveras;513;257;256
16;Cuenca;051;Cañaveruelas;290;149;141
16;Cuenca;052;Cañete;991;492;499
16;Cuenca;053;Cañizares;739;403;336
16;Cuenca;073;Cervera del Llano;413;212;201
16;Cuenca;023;Chillarón de Cuenca;313;158;155
16;Cuenca;081;Chumillas;78;41;37
16;Cuenca;074;Cierva (La);66;37;29
16;Cuenca;078;Cuenca;41407;20008;21399
16;Cuenca;079;Cueva del Hierro;65;39;26
16;Cuenca;082;Enguídanos;757;392;365
16;Cuenca;083;Fresneda de Altarejos;115;65;50
16;Cuenca;084;Fresneda de la Sierra;108;49;59
16;Cuenca;085;Frontera (La);289;152;137
16;Cuenca;086;Fuente de Pedro Naharro;1350;673;677
16;Cuenca;087;Fuentelespino de Haro;452;243;209
16;Cuenca;088;Fuentelespino de Moya;198;95;103
16;Cuenca;904;Fuentenava de Jábaga;292;152;140
16;Cuenca;089;Fuentes;605;308;297
16;Cuenca;091;Fuertescusa;129;59;70
16;Cuenca;092;Gabaldón;217;123;94
16;Cuenca;093;Garaballa;242;127;115
16;Cuenca;094;Gascueña;225;111;114
16;Cuenca;095;Graja de Campalbo;176;98;78
16;Cuenca;096;Graja de Iniesta;393;206;187
16;Cuenca;097;Henarejos;406;202;204
16;Cuenca;098;Herrumblar (El);792;407;385
16;Cuenca;099;Hinojosa (La);428;208;220
16;Cuenca;100;Hinojosos (Los);1433;716;717
16;Cuenca;101;Hito (El);302;148;154
16;Cuenca;102;Honrubia;1729;874;855
16;Cuenca;103;Hontanaya;659;329;330
16;Cuenca;104;Hontecillas;118;57;61
16;Cuenca;106;Horcajo de Santiago;3678;1835;1843
16;Cuenca;108;Huelves;92;44;48
16;Cuenca;110;Huerta de la Obispalía;206;116;90
16;Cuenca;111;Huerta del Marquesado;203;107;96
16;Cuenca;112;Huete;2596;1309;1287
16;Cuenca;107;Huélamo;137;72;65
16;Cuenca;109;Huérguina;103;54;49
16;Cuenca;113;Iniesta;3661;1804;1857
16;Cuenca;115;Laguna del Marquesado;85;48;37
16;Cuenca;116;Lagunaseca;118;57;61
16;Cuenca;117;Landete;1726;858;868
16;Cuenca;118;Ledaña;2228;1132;1096
16;Cuenca;119;Leganiel;349;171;178
16;Cuenca;121;Majadas (Las);445;234;211
16;Cuenca;122;Mariana;333;159;174
16;Cuenca;123;Masegosa;170;83;87
16;Cuenca;124;Mesas (Las);2720;1397;1323
16;Cuenca;125;Minglanilla;2395;1199;1196
16;Cuenca;126;Mira;1272;634;638
16;Cuenca;128;Monreal del Llano;107;54;53
16;Cuenca;129;Montalbanejo;256;126;130
16;Cuenca;130;Montalbo;934;496;438
16;Cuenca;131;Monteagudo de las Salinas;142;77;65
16;Cuenca;132;Mota de Altarejos;86;45;41
16;Cuenca;133;Mota del Cuervo;5586;2769;2817
16;Cuenca;134;Motilla del Palancar;4749;2375;2374
16;Cuenca;135;Moya;398;208;190
16;Cuenca;137;Narboneta;135;70;65
16;Cuenca;139;Olivares de Júcar;788;385;403
16;Cuenca;140;Olmeda de la Cuesta;75;38;37
16;Cuenca;141;Olmeda del Rey;296;141;155
16;Cuenca;142;Olmedilla de Alarcón;275;142;133
16;Cuenca;143;Olmedilla de Eliz;40;23;17
16;Cuenca;145;Osa de la Vega;768;388;380
16;Cuenca;147;Pajaroncillo;123;64;59
16;Cuenca;146;Pajarón;170;90;80
16;Cuenca;148;Palomares del Campo;1072;535;537
16;Cuenca;149;Palomera;145;69;76
16;Cuenca;150;Paracuellos;243;124;119
16;Cuenca;151;Paredes;88;46;42
16;Cuenca;152;Parra de las Vegas (La);81;39;42
16;Cuenca;153;Pedernoso (El);1464;714;750
16;Cuenca;154;Pedroñeras (Las);6660;3359;3301
16;Cuenca;155;Peral (El);792;402;390
16;Cuenca;156;Peraleja (La);275;141;134
16;Cuenca;157;Pesquera (La);366;192;174
16;Cuenca;158;Picazo (El);791;381;410
16;Cuenca;159;Pinarejo;651;335;316
16;Cuenca;160;Pineda de Gigüela;244;124;120
16;Cuenca;161;Piqueras del Castillo;112;64;48
16;Cuenca;162;Portalrubio de Guadamejud;150;75;75
16;Cuenca;163;Portilla;122;60;62
16;Cuenca;165;Poyatos;140;75;65
16;Cuenca;166;Pozoamargo;433;214;219
16;Cuenca;908;Pozorrubielos de la Mancha;351;176;175
16;Cuenca;167;Pozorrubio;578;284;294
16;Cuenca;169;Pozuelo (El);114;56;58
16;Cuenca;170;Priego;1221;628;593
16;Cuenca;171;Provencio (El);2996;1474;1522
16;Cuenca;172;Puebla de Almenara;766;386;380
16;Cuenca;173;Puebla de Don Francisco;547;282;265
16;Cuenca;174;Puebla del Salvador;376;207;169
16;Cuenca;175;Quintanar del Rey;5669;2896;2773
16;Cuenca;176;Rada de Haro;76;38;38
16;Cuenca;177;Reíllo;168;79;89
16;Cuenca;181;Rozalén del Monte;187;88;99
16;Cuenca;185;Saceda-Trasierra;67;34;33
16;Cuenca;186;Saelices;917;470;447
16;Cuenca;187;Salinas del Manzano;169;91;78
16;Cuenca;188;Salmeroncillos;225;118;107
16;Cuenca;189;Salvacañete;381;206;175
16;Cuenca;190;San Clemente;6454;3186;3268
16;Cuenca;191;San Lorenzo de la Parrilla;1853;939;914
16;Cuenca;192;San Martín de Boniches;110;54;56
16;Cuenca;193;San Pedro Palmiches;135;79;56
16;Cuenca;194;Santa Cruz de Moya;520;266;254
16;Cuenca;196;Santa María de los Llanos;943;474;469
16;Cuenca;195;Santa María del Campo Rus;1164;580;584
16;Cuenca;197;Santa María del Val;157;81;76
16;Cuenca;198;Sisante;2021;1030;991
16;Cuenca;199;Solera de Gabaldón;62;35;27
16;Cuenca;909;Sotorribas;1125;584;541
16;Cuenca;202;Talayuelas;1325;684;641
16;Cuenca;203;Tarancón;10299;5089;5210
16;Cuenca;205;Tejadillos;214;106;108
16;Cuenca;206;Tinajas;486;254;232
16;Cuenca;209;Torralba;263;134;129
16;Cuenca;211;Torrejoncillo del Rey;984;484;500
16;Cuenca;212;Torrubia del Campo;420;207;213
16;Cuenca;213;Torrubia del Castillo;62;30;32
16;Cuenca;215;Tragacete;448;241;207
16;Cuenca;216;Tresjuncos;683;347;336
16;Cuenca;217;Tribaldos;202;107;95
16;Cuenca;204;Tébar;542;287;255
16;Cuenca;218;Uclés;370;174;196
16;Cuenca;219;Uña;162;79;83
16;Cuenca;906;Valdecolmenas (Los);186;89;97
16;Cuenca;224;Valdemeca;106;61;45
16;Cuenca;225;Valdemorillo de la Sierra;105;51;54
16;Cuenca;227;Valdemoro-Sierra;213;119;94
16;Cuenca;228;Valdeolivas;351;180;171
16;Cuenca;902;Valdetórtola;220;121;99
16;Cuenca;903;Valeras (Las);1575;790;785
16;Cuenca;231;Valhermoso de la Fuente;79;37;42
16;Cuenca;234;Valsalobre;70;35;35
16;Cuenca;236;Valverde de Júcar;1571;779;792
16;Cuenca;237;Valverdejo;178;93;85
16;Cuenca;238;Vara de Rey;1023;511;512
16;Cuenca;239;Vega del Codorno;304;146;158
16;Cuenca;240;Vellisca;268;125;143
16;Cuenca;242;Villaconejos de Trabaque;581;299;282
16;Cuenca;243;Villaescusa de Haro;649;331;318
16;Cuenca;244;Villagarcía del Llano;1013;513;500
16;Cuenca;245;Villalba de la Sierra;542;283;259
16;Cuenca;246;Villalba del Rey;954;497;457
16;Cuenca;247;Villalgordo del Marquesado;212;105;107
16;Cuenca;248;Villalpardo;1158;600;558
16;Cuenca;249;Villamayor de Santiago;2990;1476;1514
16;Cuenca;250;Villanueva de Guadamejud;175;80;95
16;Cuenca;251;Villanueva de la Jara;2579;1290;1289
16;Cuenca;253;Villar de Cañas;573;289;284
16;Cuenca;254;Villar de Domingo García;311;154;157
16;Cuenca;263;Villar de Olalla;824;423;401
16;Cuenca;255;Villar de la Encina;284;138;146
16;Cuenca;258;Villar del Humo;519;265;254
16;Cuenca;259;Villar del Infantado;66;39;27
16;Cuenca;910;Villar y Velasco;189;101;88
16;Cuenca;264;Villarejo de Fuentes;990;488;502
16;Cuenca;265;Villarejo de la Peñuela;46;25;21
16;Cuenca;266;Villarejo-Periesteban;603;310;293
16;Cuenca;269;Villares del Saz;1017;502;515
16;Cuenca;270;Villarrubio;301;141;160
16;Cuenca;271;Villarta;837;444;393
16;Cuenca;272;Villas de la Ventosa;559;296;263
16;Cuenca;273;Villaverde y Pasaconsol;507;249;258
16;Cuenca;275;Vindel;35;18;17
16;Cuenca;274;Víllora;328;160;168
16;Cuenca;276;Yémeda;61;31;30
16;Cuenca;277;Zafra de Záncara;328;167;161
16;Cuenca;278;Zafrilla;182;91;91
16;Cuenca;279;Zarza de Tajo;367;169;198
16;Cuenca;280;Zarzuela;375;184;191
17;Girona;001;Agullana;654;338;316
17;Girona;002;Aiguaviva;357;177;180
17;Girona;003;Albanyà;109;64;45
17;Girona;004;Albons;479;240;239
17;Girona;006;Alp;901;468;433
17;Girona;007;Amer;2416;1184;1232
17;Girona;008;Anglès;5129;2565;2564
17;Girona;009;Arbúcies;4231;2111;2120
17;Girona;010;Argelaguer;333;166;167
17;Girona;011;Armentera (L');754;353;401
17;Girona;012;Avinyonet de Puigventós;346;175;171
17;Girona;015;Banyoles;12996;6310;6686
17;Girona;016;Bàscara;758;394;364
17;Girona;013;Begur;2548;1288;1260
17;Girona;018;Bellcaire d'Empordà;480;237;243
17;Girona;019;Besalú;2131;1034;1097
17;Girona;020;Bescanó;2786;1385;1401
17;Girona;021;Beuda;109;63;46
17;Girona;022;Bisbal d'Empordà (La);7659;3810;3849
17;Girona;234;Biure;288;143;145
17;Girona;023;Blanes;22781;11355;11426
17;Girona;029;Boadella d'Empordà;221;116;105
17;Girona;024;Bolvir;216;103;113
17;Girona;025;Bordils;1246;608;638
17;Girona;026;Borrassà;496;250;246
17;Girona;027;Breda;3168;1624;1544
17;Girona;028;Brunyola;409;206;203
17;Girona;031;Cabanelles;264;137;127
17;Girona;030;Cabanes;840;432;408
17;Girona;032;Cadaqués;1668;820;848
17;Girona;033;Caldes de Malavella;2812;1360;1452
17;Girona;034;Calonge;4100;2043;2057
17;Girona;035;Camós;617;328;289
17;Girona;036;Campdevànol;3579;1770;1809
17;Girona;037;Campelles;156;85;71
17;Girona;038;Campllong;267;146;121
17;Girona;039;Camprodon;2279;1114;1165
17;Girona;040;Canet d'Adri;457;243;214
17;Girona;041;Cantallops;259;122;137
17;Girona;042;Capmany;425;226;199
17;Girona;044;Cassà de la Selva;7147;3493;3654
17;Girona;046;Castellfollit de la Roca;1085;517;568
17;Girona;047;Castelló d'Empúries;3473;1723;1750
17;Girona;048;Castell-Platja d'Aro;4374;2191;2183
17;Girona;189;Cellera de Ter (La);2002;962;1040
17;Girona;049;Celrà;2310;1141;1169
17;Girona;050;Cervià de Ter;637;309;328
17;Girona;051;Cistella;210;102;108
17;Girona;054;Colera;434;219;215
17;Girona;055;Colomers;213;108;105
17;Girona;057;Corçà;1138;577;561
17;Girona;056;Cornellà del Terri;1780;911;869
17;Girona;058;Crespià;219;118;101
17;Girona;901;Cruïlles, Monells i Sant Sadurní de l'Heura;1030;516;514
17;Girona;060;Darnius;475;251;224
17;Girona;061;Das;140;74;66
17;Girona;062;Escala (L');4821;2453;2368
17;Girona;063;Espinelves;240;129;111
17;Girona;064;Espolla;407;213;194
17;Girona;065;Esponellà;372;170;202
17;Girona;005;Far d'Empordà (El);440;229;211
17;Girona;066;Figueres;32035;15699;16336
17;Girona;067;Flaçà;961;469;492
17;Girona;068;Foixà;314;157;157
17;Girona;069;Fontanals de Cerdanya;354;186;168
17;Girona;070;Fontanilles;129;71;58
17;Girona;071;Fontcoberta;757;395;362
17;Girona;902;Forallac;1507;746;761
17;Girona;073;Fornells de la Selva;1005;476;529
17;Girona;074;Fortià;477;233;244
17;Girona;075;Garrigàs;310;162;148
17;Girona;076;Garrigoles;158;86;72
17;Girona;077;Garriguella;611;320;291
17;Girona;078;Ger;248;125;123
17;Girona;079;Girona;67447;32606;34841
17;Girona;080;Gombrèn;251;127;124
17;Girona;081;Gualta;289;144;145
17;Girona;082;Guils de Cerdanya;262;139;123
17;Girona;083;Hostalric;2694;1340;1354
17;Girona;084;Isòvol;200;94;106
17;Girona;085;Jafre;350;181;169
17;Girona;086;Jonquera (La);2588;1342;1246
17;Girona;087;Juià;276;140;136
17;Girona;088;Lladó;483;246;237
17;Girona;089;Llagostera;5124;2574;2550
17;Girona;090;Llambilles;428;214;214
17;Girona;091;Llanars;390;205;185
17;Girona;092;Llançà;3271;1667;1604
17;Girona;093;Llers;683;353;330
17;Girona;094;Llívia;924;465;459
17;Girona;095;Lloret de Mar;14715;7379;7336
17;Girona;096;Llosses (Les);409;212;197
17;Girona;102;Maçanet de Cabrenys;745;363;382
17;Girona;103;Maçanet de la Selva;2507;1271;1236
17;Girona;097;Madremanya;208;93;115
17;Girona;098;Maià de Montcal;386;191;195
17;Girona;100;Masarac;264;130;134
17;Girona;101;Massanes;455;249;206
17;Girona;099;Meranges;64;37;27
17;Girona;105;Mieres;361;182;179
17;Girona;106;Mollet de Peralada;180;99;81
17;Girona;107;Molló;381;198;183
17;Girona;109;Montagut i Oix;819;419;400
17;Girona;110;Mont-ras;1134;592;542
17;Girona;111;Navata;627;301;326
17;Girona;112;Ogassa;283;154;129
17;Girona;114;Olot;25771;12430;13341
17;Girona;115;Ordis;300;160;140
17;Girona;116;Osor;520;272;248
17;Girona;117;Palafrugell;16101;7981;8120
17;Girona;118;Palamós;12321;6086;6235
17;Girona;119;Palau de Santa Eulàlia;80;40;40
17;Girona;121;Palau-sator;318;166;152
17;Girona;120;Palau-saverdera;684;341;343
17;Girona;122;Palmerola;21;13;8
17;Girona;123;Palol de Revardit;378;197;181
17;Girona;124;Pals;1692;850;842
17;Girona;125;Pardines;118;62;56
17;Girona;126;Parlavà;348;188;160
17;Girona;128;Pau;318;154;164
17;Girona;129;Pedret i Marzà;142;63;79
17;Girona;130;Pera (La);373;188;185
17;Girona;132;Peralada;1244;635;609
17;Girona;133;Planes d'Hostoles (Les);1842;891;951
17;Girona;134;Planoles;296;152;144
17;Girona;135;Pont de Molins;375;190;185
17;Girona;136;Pontós;207;118;89
17;Girona;137;Porqueres;2822;1397;1425
17;Girona;140;Port de la Selva (El);782;380;402
17;Girona;138;Portbou;2011;992;1019
17;Girona;139;Preses (Les);1338;663;675
17;Girona;141;Puigcerdà;6067;3049;3018
17;Girona;142;Quart;1664;839;825
17;Girona;043;Queralbs;205;112;93
17;Girona;143;Rabós;156;77;79
17;Girona;144;Regencós;257;145;112
17;Girona;145;Ribes de Freser;2628;1259;1369
17;Girona;146;Riells i Viabrea;764;384;380
17;Girona;147;Ripoll;11646;5684;5962
17;Girona;148;Riudarenes;1122;562;560
17;Girona;149;Riudaura;388;189;199
17;Girona;150;Riudellots de la Selva;1186;613;573
17;Girona;151;Riumors;206;93;113
17;Girona;152;Roses;9467;4883;4584
17;Girona;153;Rupià;219;106;113
17;Girona;154;Sales de Llierca;53;33;20
17;Girona;155;Salt;21351;10598;10753
17;Girona;157;Sant Andreu Salou;155;81;74
17;Girona;183;Sant Aniol de Finestres;271;138;133
17;Girona;158;Sant Climent Sescebes;460;241;219
17;Girona;159;Sant Feliu de Buixalleu;619;323;296
17;Girona;160;Sant Feliu de Guíxols;15729;7599;8130
17;Girona;161;Sant Feliu de Pallerols;1062;508;554
17;Girona;162;Sant Ferriol;175;100;75
17;Girona;163;Sant Gregori;1753;906;847
17;Girona;164;Sant Hilari Sacalm;4561;2321;2240
17;Girona;165;Sant Jaume de Llierca;776;394;382
17;Girona;167;Sant Joan de les Abadesses;4079;1969;2110
17;Girona;168;Sant Joan de Mollet;311;152;159
17;Girona;185;Sant Joan les Fonts;2933;1467;1466
17;Girona;166;Sant Jordi Desvalls;585;287;298
17;Girona;169;Sant Julià de Ramis;1635;817;818
17;Girona;903;Sant Julià del Llor i Bonmatí;862;412;450
17;Girona;171;Sant Llorenç de la Muga;154;73;81
17;Girona;172;Sant Martí de Llémena;323;178;145
17;Girona;173;Sant Martí Vell;201;97;104
17;Girona;174;Sant Miquel de Campmajor;225;129;96
17;Girona;175;Sant Miquel de Fluvià;538;275;263
17;Girona;176;Sant Mori;131;63;68
17;Girona;177;Sant Pau de Segúries;609;302;307
17;Girona;178;Sant Pere Pescador;1158;592;566
17;Girona;180;Santa Coloma de Farners;7676;3870;3806
17;Girona;181;Santa Cristina d'Aro;1483;784;699
17;Girona;182;Santa Llogaia d'Àlguema;312;159;153
17;Girona;184;Santa Pau;1312;661;651
17;Girona;186;Sarrià de Ter;3538;1771;1767
17;Girona;187;Saus;704;359;345
17;Girona;188;Selva de Mar (La);150;80;70
17;Girona;190;Serinyà;704;343;361
17;Girona;191;Serra de Daró;188;98;90
17;Girona;192;Setcases;162;83;79
17;Girona;193;Sils;2061;1039;1022
17;Girona;052;Siurana;175;78;97
17;Girona;194;Susqueda;123;66;57
17;Girona;195;Tallada d'Empordà (La);357;179;178
17;Girona;196;Terrades;191;92;99
17;Girona;197;Torrent;210;109;101
17;Girona;198;Torroella de Fluvià;274;145;129
17;Girona;199;Torroella de Montgrí;6351;3182;3169
17;Girona;200;Tortellà;743;361;382
17;Girona;201;Toses;142;82;60
17;Girona;202;Tossa de Mar;3421;1721;1700
17;Girona;204;Ullà;755;378;377
17;Girona;205;Ullastret;274;133;141
17;Girona;203;Ultramort;213;109;104
17;Girona;206;Urús;100;47;53
17;Girona;014;Vajol (La);67;37;30
17;Girona;208;Vall de Bianya (La);1055;527;528
17;Girona;207;Vall d'en Bas (La);2612;1333;1279
17;Girona;170;Vallfogona de Ripollès;251;124;127
17;Girona;209;Vall-llobrega;229;118;111
17;Girona;210;Ventalló;523;274;249
17;Girona;211;Verges;1134;553;581
17;Girona;212;Vidrà;178;86;92
17;Girona;213;Vidreres;3616;1823;1793
17;Girona;214;Vilabertran;793;400;393
17;Girona;215;Vilablareix;924;465;459
17;Girona;217;Viladamat;359;190;169
17;Girona;216;Viladasens;186;96;90
17;Girona;218;Vilademuls;758;395;363
17;Girona;220;Viladrau;810;411;399
17;Girona;221;Vilafant;2208;1092;1116
17;Girona;223;Vilajuïga;681;335;346
17;Girona;224;Vilallonga de Ter;435;221;214
17;Girona;225;Vilamacolum;253;122;131
17;Girona;226;Vilamalla;503;246;257
17;Girona;227;Vilamaniscle;119;53;66
17;Girona;228;Vilanant;285;143;142
17;Girona;230;Vila-sacra;406;201;205
17;Girona;222;Vilaür;101;46;55
17;Girona;233;Vilobí d'Onyar;1922;992;930
17;Girona;232;Vilopriu;180;87;93
18;Granada;001;Agrón;484;242;242
18;Granada;002;Alamedilla;1144;571;573
18;Granada;003;Albolote;8213;4070;4143
18;Granada;004;Albondón;1471;757;714
18;Granada;005;Albuñán;553;283;270
18;Granada;006;Albuñol;5579;2778;2801
18;Granada;007;Albuñuelas;1426;729;697
18;Granada;010;Aldeire;985;492;493
18;Granada;011;Alfacar;3154;1607;1547
18;Granada;012;Algarinejo;5192;2656;2536
18;Granada;013;Alhama de Granada;6169;3152;3017
18;Granada;014;Alhendín;3352;1692;1660
18;Granada;015;Alicún de Ortega;811;423;388
18;Granada;016;Almegíjar;553;280;273
18;Granada;017;Almuñécar;17421;8699;8722
18;Granada;904;Alpujarra de la Sierra;1483;759;724
18;Granada;018;Alquife;1404;695;709
18;Granada;020;Arenas del Rey;2178;1128;1050
18;Granada;021;Armilla;12061;5908;6153
18;Granada;022;Atarfe;9821;4815;5006
18;Granada;023;Baza;20682;10043;10639
18;Granada;024;Beas de Granada;839;419;420
18;Granada;025;Beas de Guadix;479;251;228
18;Granada;027;Benalúa;3631;1851;1780
18;Granada;028;Benalúa de las Villas;1389;685;704
18;Granada;029;Benamaurel;2753;1421;1332
18;Granada;030;Bérchules;1032;524;508
18;Granada;032;Bubión;320;168;152
18;Granada;033;Busquístar;434;226;208
18;Granada;034;Cacín;954;492;462
18;Granada;035;Cádiar;2137;1094;1043
18;Granada;036;Cájar;1638;741;897
18;Granada;114;Calahorra (La);1091;529;562
18;Granada;037;Calicasas;595;287;308
18;Granada;038;Campotéjar;1476;720;756
18;Granada;039;Caniles;6127;3004;3123
18;Granada;040;Cáñar;389;188;201
18;Granada;042;Capileira;591;294;297
18;Granada;043;Carataunas;177;88;89
18;Granada;044;Cástaras;386;200;186
18;Granada;045;Castilléjar;2429;1212;1217
18;Granada;046;Castril;3628;1877;1751
18;Granada;047;Cenes de la Vega;1481;760;721
18;Granada;059;Chauchina;4018;1990;2028
18;Granada;061;Chimeneas;1648;826;822
18;Granada;062;Churriana de la Vega;4827;2390;2437
18;Granada;048;Cijuela;1170;566;604
18;Granada;049;Cogollos de Guadix;847;453;394
18;Granada;050;Cogollos de la Vega;1901;958;943
18;Granada;051;Colomera;2033;1039;994
18;Granada;053;Cortes de Baza;3306;1691;1615
18;Granada;054;Cortes y Graena;1014;527;487
18;Granada;912;Cuevas del Campo;2587;1291;1296
18;Granada;056;Cúllar;5847;2875;2972
18;Granada;057;Cúllar Vega;1447;735;712
18;Granada;063;Darro;1630;809;821
18;Granada;064;Dehesas de Guadix;1018;513;505
18;Granada;066;Deifontes;2467;1276;1191
18;Granada;067;Diezma;1131;593;538
18;Granada;068;Dílar;1308;646;662
18;Granada;069;Dólar;777;386;391
18;Granada;070;Dúdar;279;145;134
18;Granada;071;Dúrcal;5564;2781;2783
18;Granada;072;Escúzar;1151;576;575
18;Granada;074;Ferreira;451;215;236
18;Granada;076;Fonelas;1613;827;786
18;Granada;078;Freila;1425;714;711
18;Granada;079;Fuente Vaqueros;3741;1874;1867
18;Granada;905;Gabias (Las);5434;2710;2724
18;Granada;082;Galera;1936;954;982
18;Granada;083;Gobernador;450;213;237
18;Granada;084;Gójar;2002;1006;996
18;Granada;085;Gor;1565;781;784
18;Granada;086;Gorafe;764;396;368
18;Granada;087;Granada;256800;121599;135201
18;Granada;088;Guadahortuna;2555;1311;1244
18;Granada;089;Guadix;20286;9964;10322
18;Granada;906;Guajares (Los);1642;843;799
18;Granada;093;Gualchos;2989;1486;1503
18;Granada;094;Güejar Sierra;2582;1313;1269
18;Granada;095;Güevéjar;1146;561;585
18;Granada;096;Huélago;771;403;368
18;Granada;097;Huéneja;1635;813;822
18;Granada;098;Huéscar;10403;5171;5232
18;Granada;099;Huétor de Santillán;1370;715;655
18;Granada;100;Huétor Tájar;7571;3793;3778
18;Granada;101;Huétor Vega;5870;2938;2932
18;Granada;102;Illora;10436;5296;5140
18;Granada;103;Itrabo;1200;610;590
18;Granada;105;Iznalloz;6950;3557;3393
18;Granada;107;Jayena;1515;792;723
18;Granada;108;Jerez del Marquesado;1338;675;663
18;Granada;109;Jete;722;355;367
18;Granada;111;Jun;843;421;422
18;Granada;112;Juviles;197;94;103
18;Granada;115;Láchar;2147;1111;1036
18;Granada;116;Lanjarón;4218;2093;2125
18;Granada;117;Lanteira;789;402;387
18;Granada;119;Lecrín;2642;1298;1344
18;Granada;120;Lentegí;372;182;190
18;Granada;121;Lobras;256;125;131
18;Granada;122;Loja;21883;10998;10885
18;Granada;123;Lugros;623;331;292
18;Granada;124;Lújar;702;366;336
18;Granada;126;Malahá (La);1683;858;825
18;Granada;127;Maracena;11215;5578;5637
18;Granada;128;Marchal;542;260;282
18;Granada;132;Moclín;5082;2574;2508
18;Granada;133;Molvízar;2467;1237;1230
18;Granada;134;Monachil;3760;1901;1859
18;Granada;135;Montefrío;8411;4295;4116
18;Granada;136;Montejícar;2999;1521;1478
18;Granada;137;Montillana;1429;735;694
18;Granada;138;Moraleda de Zafayona;2574;1306;1268
18;Granada;909;Morelábor;1153;568;585
18;Granada;140;Motril;44882;22277;22605
18;Granada;141;Murtas;1224;611;613
18;Granada;903;Nevada;1595;824;771
18;Granada;143;Nigüelas;1218;619;599
18;Granada;144;Nívar;488;250;238
18;Granada;145;Ogíjares;2996;1508;1488
18;Granada;146;Orce;1636;819;817
18;Granada;147;Órgiva;5198;2598;2600
18;Granada;148;Otívar;1214;614;600
18;Granada;149;Otura;2222;1089;1133
18;Granada;150;Padul;6158;3057;3101
18;Granada;151;Pampaneira;363;185;178
18;Granada;152;Pedro Martínez;2017;1003;1014
18;Granada;153;Peligros;5328;2660;2668
18;Granada;154;Peza (La);1744;899;845
18;Granada;910;Pinar (El);1468;729;739
18;Granada;157;Pinos Genil;921;469;452
18;Granada;158;Pinos Puente;13598;6727;6871
18;Granada;159;Píñar;1571;818;753
18;Granada;161;Polícar;275;150;125
18;Granada;162;Polopos;1370;717;653
18;Granada;163;Pórtugos;448;229;219
18;Granada;164;Puebla de Don Fadrique;2911;1445;1466
18;Granada;165;Pulianas;2334;1153;1181
18;Granada;167;Purullena;2774;1397;1377
18;Granada;168;Quéntar;1261;642;619
18;Granada;170;Rubite;546;285;261
18;Granada;171;Salar;2875;1428;1447
18;Granada;173;Salobreña;9027;4451;4576
18;Granada;174;Santa Cruz del Comercio;626;335;291
18;Granada;175;Santa Fe;11761;5734;6027
18;Granada;176;Soportújar;272;145;127
18;Granada;177;Sorvilán;999;505;494
18;Granada;901;Taha (La);921;470;451
18;Granada;178;Torre-Cardela;1504;755;749
18;Granada;179;Torvizcón;1322;657;665
18;Granada;180;Trevélez;879;460;419
18;Granada;181;Turón;511;284;227
18;Granada;182;Ugíjar;3147;1536;1611
18;Granada;907;Valle del Zalabí;2665;1339;1326
18;Granada;902;Valle (El);1638;833;805
18;Granada;183;Válor;1200;605;595
18;Granada;911;Vegas del Genil;2614;1315;1299
18;Granada;184;Vélez de Benaudalla;2648;1328;1320
18;Granada;185;Ventas de Huelma;776;390;386
18;Granada;908;Villamena;1171;553;618
18;Granada;187;Villanueva de las Torres;1121;595;526
18;Granada;188;Villanueva Mesía;1826;907;919
18;Granada;189;Víznar;686;343;343
18;Granada;192;Zafarraya;2264;1143;1121
18;Granada;913;Zagra;"";"";""
18;Granada;193;Zubia (La);7210;3584;3626
18;Granada;194;Zújar;3533;1796;1737
19;Guadalajara;001;Abánades;133;77;56
19;Guadalajara;002;Ablanque;166;89;77
19;Guadalajara;003;Adobes;33;15;18
19;Guadalajara;004;Alaminos;126;59;67
19;Guadalajara;005;Alarilla;108;57;51
19;Guadalajara;006;Albalate de Zorita;1072;565;507
19;Guadalajara;007;Albares;557;280;277
19;Guadalajara;008;Albendiego;73;39;34
19;Guadalajara;009;Alcocer;362;174;188
19;Guadalajara;010;Alcolea de las Peñas;46;28;18
19;Guadalajara;011;Alcolea del Pinar;561;283;278
19;Guadalajara;013;Alcoroches;188;103;85
19;Guadalajara;015;Aldeanueva de Guadalajara;125;64;61
19;Guadalajara;016;Algar de Mesa;104;52;52
19;Guadalajara;017;Algora;125;76;49
19;Guadalajara;018;Alhóndiga;306;166;140
19;Guadalajara;019;Alique;20;9;11
19;Guadalajara;020;Almadrones;134;83;51
19;Guadalajara;021;Almoguera;799;403;396
19;Guadalajara;022;Almonacid de Zorita;1022;542;480
19;Guadalajara;023;Alocén;133;65;68
19;Guadalajara;024;Alovera;1355;675;680
19;Guadalajara;027;Alustante;341;176;165
19;Guadalajara;031;Angón;35;20;15
19;Guadalajara;032;Anguita;415;212;203
19;Guadalajara;033;Anquela del Ducado;98;51;47
19;Guadalajara;034;Anquela del Pedregal;42;22;20
19;Guadalajara;036;Aranzueque;366;183;183
19;Guadalajara;037;Arbancón;236;133;103
19;Guadalajara;038;Arbeteta;52;30;22
19;Guadalajara;039;Argecilla;139;83;56
19;Guadalajara;040;Armallones;102;56;46
19;Guadalajara;041;Armuña de Tajuña;108;59;49
19;Guadalajara;042;Arroyo de las Fraguas;19;11;8
19;Guadalajara;043;Atanzón;127;69;58
19;Guadalajara;044;Atienza;549;290;259
19;Guadalajara;045;Auñón;296;160;136
19;Guadalajara;046;Azuqueca de Henares;10845;5487;5358
19;Guadalajara;047;Baides;96;50;46
19;Guadalajara;048;Baños de Tajo;37;25;12
19;Guadalajara;049;Bañuelos;45;23;22
19;Guadalajara;050;Barriopedro;28;12;16
19;Guadalajara;051;Berninches;132;80;52
19;Guadalajara;052;Bodera (La);59;34;25
19;Guadalajara;053;Brihuega;3475;1847;1628
19;Guadalajara;054;Budia;373;195;178
19;Guadalajara;055;Bujalaro;156;87;69
19;Guadalajara;057;Bustares;162;88;74
19;Guadalajara;058;Cabanillas del Campo;941;499;442
19;Guadalajara;059;Campillo de Dueñas;193;109;84
19;Guadalajara;060;Campillo de Ranas;109;50;59
19;Guadalajara;061;Campisábalos;84;41;43
19;Guadalajara;064;Canredondo;139;76;63
19;Guadalajara;065;Cantalojas;192;108;84
19;Guadalajara;066;Cañizar;129;69;60
19;Guadalajara;067;Cardoso de la Sierra (El);123;75;48
19;Guadalajara;070;Casa de Uceda;154;77;77
19;Guadalajara;071;Casar (El);1322;679;643
19;Guadalajara;073;Casas de San Galindo;39;21;18
19;Guadalajara;074;Caspueñas;57;29;28
19;Guadalajara;075;Castejón de Henares;141;75;66
19;Guadalajara;076;Castellar de la Muela;73;41;32
19;Guadalajara;078;Castilforte;46;24;22
19;Guadalajara;079;Castilnuevo;16;4;12
19;Guadalajara;080;Cendejas de Enmedio;173;84;89
19;Guadalajara;081;Cendejas de la Torre;166;97;69
19;Guadalajara;082;Centenera;104;56;48
19;Guadalajara;103;Checa;506;256;250
19;Guadalajara;104;Chequilla;34;18;16
19;Guadalajara;106;Chillarón del Rey;151;80;71
19;Guadalajara;105;Chiloeches;1053;547;506
19;Guadalajara;086;Cifuentes;2549;1334;1215
19;Guadalajara;087;Cincovillas;47;23;24
19;Guadalajara;088;Ciruelas;76;39;37
19;Guadalajara;089;Ciruelos del Pinar;101;52;49
19;Guadalajara;090;Cobeta;153;79;74
19;Guadalajara;091;Cogollor;75;41;34
19;Guadalajara;092;Cogolludo;699;373;326
19;Guadalajara;095;Condemios de Abajo;36;20;16
19;Guadalajara;096;Condemios de Arriba;224;120;104
19;Guadalajara;097;Congostrina;48;22;26
19;Guadalajara;098;Copernal;33;18;15
19;Guadalajara;099;Corduente;560;299;261
19;Guadalajara;102;Cubillo de Uceda (El);161;81;80
19;Guadalajara;107;Driebes;420;232;188
19;Guadalajara;108;Durón;101;58;43
19;Guadalajara;109;Embid;83;47;36
19;Guadalajara;110;Escamilla;180;97;83
19;Guadalajara;111;Escariche;255;124;131
19;Guadalajara;112;Escopete;65;28;37
19;Guadalajara;113;Espinosa de Henares;520;249;271
19;Guadalajara;114;Esplegares;85;47;38
19;Guadalajara;115;Establés;75;38;37
19;Guadalajara;116;Estriégana;38;18;20
19;Guadalajara;117;Fontanar;700;354;346
19;Guadalajara;118;Fuembellida;26;14;12
19;Guadalajara;119;Fuencemillán;146;76;70
19;Guadalajara;120;Fuentelahiguera de Albatages;256;126;130
19;Guadalajara;121;Fuentelencina;231;123;108
19;Guadalajara;122;Fuentelsaz;176;86;90
19;Guadalajara;123;Fuentelviejo;101;51;50
19;Guadalajara;124;Fuentenovilla;261;145;116
19;Guadalajara;125;Gajanejos;117;68;49
19;Guadalajara;126;Galápagos;212;118;94
19;Guadalajara;127;Galve de Sorbe;206;105;101
19;Guadalajara;129;Gascueña de Bornova;42;23;19
19;Guadalajara;130;Guadalajara;59492;29579;29913
19;Guadalajara;132;Henche;25;16;9
19;Guadalajara;133;Heras de Ayuso;140;74;66
19;Guadalajara;134;Herrería;46;22;24
19;Guadalajara;135;Hiendelaencina;199;112;87
19;Guadalajara;136;Hijes;30;18;12
19;Guadalajara;138;Hita;270;151;119
19;Guadalajara;139;Hombrados;76;40;36
19;Guadalajara;142;Hontoba;148;73;75
19;Guadalajara;143;Horche;1137;600;537
19;Guadalajara;145;Hortezuela de Océn;116;64;52
19;Guadalajara;146;Huerce (La);34;19;15
19;Guadalajara;147;Huérmeces del Cerro;66;39;27
19;Guadalajara;148;Huertahernando;81;47;34
19;Guadalajara;150;Hueva;162;89;73
19;Guadalajara;151;Humanes;1292;667;625
19;Guadalajara;152;Illana;743;378;365
19;Guadalajara;153;Iniéstola;28;16;12
19;Guadalajara;154;Inviernas (Las);119;67;52
19;Guadalajara;155;Irueste;90;45;45
19;Guadalajara;156;Jadraque;1276;638;638
19;Guadalajara;157;Jirueque;71;41;30
19;Guadalajara;159;Ledanca;217;112;105
19;Guadalajara;160;Loranca de Tajuña;306;162;144
19;Guadalajara;161;Lupiana;272;138;134
19;Guadalajara;162;Luzaga;154;69;85
19;Guadalajara;163;Luzón;116;60;56
19;Guadalajara;165;Majaelrayo;70;34;36
19;Guadalajara;166;Málaga del Fresno;254;136;118
19;Guadalajara;167;Malaguilla;218;120;98
19;Guadalajara;168;Mandayona;571;267;304
19;Guadalajara;169;Mantiel;23;11;12
19;Guadalajara;170;Maranchón;278;136;142
19;Guadalajara;171;Marchamalo;"";"";""
19;Guadalajara;172;Masegoso de Tajuña;125;61;64
19;Guadalajara;173;Matarrubia;50;31;19
19;Guadalajara;174;Matillas;317;161;156
19;Guadalajara;175;Mazarete;110;55;55
19;Guadalajara;176;Mazuecos;478;247;231
19;Guadalajara;177;Medranda;173;95;78
19;Guadalajara;178;Megina;92;43;49
19;Guadalajara;179;Membrillera;101;58;43
19;Guadalajara;181;Miedes de Atienza;178;90;88
19;Guadalajara;182;Mierla (La);37;22;15
19;Guadalajara;184;Millana;112;54;58
19;Guadalajara;183;Milmarcos;125;62;63
19;Guadalajara;185;Miñosa (La);76;41;35
19;Guadalajara;186;Mirabueno;137;76;61
19;Guadalajara;187;Miralrío;132;71;61
19;Guadalajara;188;Mochales;184;90;94
19;Guadalajara;189;Mohernando;144;86;58
19;Guadalajara;190;Molina de Aragón;3959;2019;1940
19;Guadalajara;191;Monasterio;18;9;9
19;Guadalajara;192;Mondéjar;2240;1101;1139
19;Guadalajara;193;Montarrón;90;49;41
19;Guadalajara;194;Moratilla de los Meleros;123;69;54
19;Guadalajara;195;Morenilla;74;45;29
19;Guadalajara;196;Muduex;136;74;62
19;Guadalajara;197;Navas de Jadraque (Las);32;17;15
19;Guadalajara;198;Negredo;27;11;16
19;Guadalajara;199;Ocentejo;55;24;31
19;Guadalajara;200;Olivar (El);53;30;23
19;Guadalajara;201;Olmeda de Cobeta;94;37;57
19;Guadalajara;202;Olmeda de Jadraque (La);13;8;5
19;Guadalajara;203;Ordial (El);62;23;39
19;Guadalajara;204;Orea;362;189;173
19;Guadalajara;208;Pálmaces de Jadraque;110;59;51
19;Guadalajara;209;Pardos;65;34;31
19;Guadalajara;210;Paredes de Sigüenza;88;45;43
19;Guadalajara;211;Pareja;520;260;260
19;Guadalajara;212;Pastrana;1306;655;651
19;Guadalajara;213;Pedregal (El);128;67;61
19;Guadalajara;214;Peñalén;201;97;104
19;Guadalajara;215;Peñalver;348;197;151
19;Guadalajara;216;Peralejos de las Truchas;191;102;89
19;Guadalajara;217;Peralveche;73;40;33
19;Guadalajara;218;Pinilla de Jadraque;100;53;47
19;Guadalajara;219;Pinilla de Molina;36;18;18
19;Guadalajara;220;Pioz;175;98;77
19;Guadalajara;221;Piqueras;40;24;16
19;Guadalajara;222;Pobo de Dueñas (El);208;111;97
19;Guadalajara;223;Poveda de la Sierra;189;94;95
19;Guadalajara;224;Pozo de Almoguera;248;127;121
19;Guadalajara;225;Pozo de Guadalajara;343;189;154
19;Guadalajara;226;Prádena de Atienza;56;33;23
19;Guadalajara;227;Prados Redondos;132;75;57
19;Guadalajara;228;Puebla de Beleña;40;23;17
19;Guadalajara;229;Puebla de Valles;90;49;41
19;Guadalajara;230;Quer;117;60;57
19;Guadalajara;231;Rebollosa de Jadraque;44;23;21
19;Guadalajara;232;Recuenco (El);160;81;79
19;Guadalajara;233;Renera;56;27;29
19;Guadalajara;234;Retiendas;44;24;20
19;Guadalajara;235;Riba de Saelices;198;112;86
19;Guadalajara;237;Rillo de Gallo;102;50;52
19;Guadalajara;238;Riofrío del Llano;110;60;50
19;Guadalajara;239;Robledillo de Mohernando;190;99;91
19;Guadalajara;240;Robledo de Corpes;109;52;57
19;Guadalajara;241;Romanillos de Atienza;90;52;38
19;Guadalajara;242;Romanones;199;110;89
19;Guadalajara;243;Rueda de la Sierra;105;54;51
19;Guadalajara;244;Sacecorbo;164;85;79
19;Guadalajara;245;Sacedón;1881;958;923
19;Guadalajara;246;Saelices de la Sal;84;41;43
19;Guadalajara;247;Salmerón;320;165;155
19;Guadalajara;248;San Andrés del Congosto;82;45;37
19;Guadalajara;249;San Andrés del Rey;52;25;27
19;Guadalajara;250;Santiuste;21;10;11
19;Guadalajara;251;Saúca;66;35;31
19;Guadalajara;252;Sayatón;214;108;106
19;Guadalajara;254;Selas;85;40;45
19;Guadalajara;901;Semillas;35;20;15
19;Guadalajara;255;Setiles;275;140;135
19;Guadalajara;256;Sienes;113;67;46
19;Guadalajara;257;Sigüenza;5200;2591;2609
19;Guadalajara;258;Solanillos del Extremo;128;65;63
19;Guadalajara;259;Somolinos;57;26;31
19;Guadalajara;260;Sotillo (El);56;36;20
19;Guadalajara;261;Sotodosos;89;44;45
19;Guadalajara;262;Tamajón;213;115;98
19;Guadalajara;263;Taragudo;33;18;15
19;Guadalajara;264;Taravilla;84;41;43
19;Guadalajara;265;Tartanedo;279;141;138
19;Guadalajara;266;Tendilla;430;229;201
19;Guadalajara;267;Terzaga;55;31;24
19;Guadalajara;268;Tierzo;52;26;26
19;Guadalajara;269;Toba (La);145;78;67
19;Guadalajara;271;Tordellego;118;56;62
19;Guadalajara;270;Tordelrábano;25;10;15
19;Guadalajara;272;Tordesilos;178;90;88
19;Guadalajara;274;Torija;385;195;190
19;Guadalajara;279;Torre del Burgo;57;30;27
19;Guadalajara;276;Torrecilla del Ducado;11;6;5
19;Guadalajara;277;Torrecuadrada de Molina;25;15;10
19;Guadalajara;278;Torrecuadradilla;96;54;42
19;Guadalajara;280;Torrejón del Rey;412;222;190
19;Guadalajara;281;Torremocha de Jadraque;19;13;6
19;Guadalajara;282;Torremocha del Campo;431;234;197
19;Guadalajara;283;Torremocha del Pinar;118;57;61
19;Guadalajara;284;Torremochuela;10;5;5
19;Guadalajara;285;Torrubia;57;30;27
19;Guadalajara;286;Tórtola de Henares;442;227;215
19;Guadalajara;287;Tortuera;317;158;159
19;Guadalajara;288;Tortuero;31;18;13
19;Guadalajara;289;Traíd;60;31;29
19;Guadalajara;290;Trijueque;312;162;150
19;Guadalajara;291;Trillo;1418;744;674
19;Guadalajara;293;Uceda;423;218;205
19;Guadalajara;294;Ujados;56;31;25
19;Guadalajara;296;Utande;86;49;37
19;Guadalajara;297;Valdarachas;30;14;16
19;Guadalajara;298;Valdearenas;75;37;38
19;Guadalajara;299;Valdeavellano;102;50;52
19;Guadalajara;300;Valdeaveruelo;129;69;60
19;Guadalajara;301;Valdeconcha;60;25;35
19;Guadalajara;302;Valdegrudas;80;41;39
19;Guadalajara;303;Valdelcubo;81;45;36
19;Guadalajara;304;Valdenuño Fernández;155;82;73
19;Guadalajara;305;Valdepeñas de la Sierra;320;173;147
19;Guadalajara;306;Valderrebollo;47;29;18
19;Guadalajara;307;Valdesotos;58;27;31
19;Guadalajara;308;Valfermoso de Tajuña;91;53;38
19;Guadalajara;309;Valhermoso;60;31;29
19;Guadalajara;310;Valtablado del Río;19;12;7
19;Guadalajara;311;Valverde de los Arroyos;86;44;42
19;Guadalajara;314;Viana de Jadraque;80;42;38
19;Guadalajara;317;Villanueva de Alcorón;384;206;178
19;Guadalajara;318;Villanueva de Argecilla;56;30;26
19;Guadalajara;319;Villanueva de la Torre;113;49;64
19;Guadalajara;321;Villares de Jadraque;50;25;25
19;Guadalajara;322;Villaseca de Henares;102;53;49
19;Guadalajara;323;Villaseca de Uceda;63;31;32
19;Guadalajara;324;Villel de Mesa;306;150;156
19;Guadalajara;325;Viñuelas;166;88;78
19;Guadalajara;326;Yebes;63;33;30
19;Guadalajara;327;Yebra;662;337;325
19;Guadalajara;329;Yélamos de Abajo;120;60;60
19;Guadalajara;330;Yélamos de Arriba;174;92;82
19;Guadalajara;331;Yunquera de Henares;1885;969;916
19;Guadalajara;332;Yunta (La);212;105;107
19;Guadalajara;333;Zaorejas;269;139;130
19;Guadalajara;334;Zarzuela de Jadraque;42;26;16
19;Guadalajara;335;Zorita de los Canes;105;53;52
20;Guipúzcoa;001;Abaltzisketa;289;156;133
20;Guipúzcoa;002;Aduna;350;186;164
20;Guipúzcoa;016;Aia;1763;1004;759
20;Guipúzcoa;003;Aizarnazabal;545;297;248
20;Guipúzcoa;004;Albiztur;319;172;147
20;Guipúzcoa;005;Alegia;1681;894;787
20;Guipúzcoa;006;Alkiza;265;150;115
20;Guipúzcoa;906;Altzaga;"";"";""
20;Guipúzcoa;007;Altzo;341;193;148
20;Guipúzcoa;008;Amezketa;1115;614;501
20;Guipúzcoa;009;Andoain;16008;7980;8028
20;Guipúzcoa;010;Anoeta;1902;938;964
20;Guipúzcoa;011;Antzuola;2107;1100;1007
20;Guipúzcoa;012;Arama;161;82;79
20;Guipúzcoa;013;Aretxabaleta;5999;3057;2942
20;Guipúzcoa;055;Arrasate/Mondragón;26325;13191;13134
20;Guipúzcoa;014;Asteasu;1275;694;581
20;Guipúzcoa;903;Astigarraga;"";"";""
20;Guipúzcoa;015;Ataun;1841;947;894
20;Guipúzcoa;017;Azkoitia;10673;5338;5335
20;Guipúzcoa;018;Azpeitia;13251;6694;6557
20;Guipúzcoa;904;Baliarrain;"";"";""
20;Guipúzcoa;019;Beasain;12454;6314;6140
20;Guipúzcoa;020;Beizama;170;91;79
20;Guipúzcoa;021;Belauntza;315;169;146
20;Guipúzcoa;022;Berastegi;964;540;424
20;Guipúzcoa;074;Bergara;15755;7855;7900
20;Guipúzcoa;023;Berrobi;593;325;268
20;Guipúzcoa;024;Bidegoyan;493;279;214
20;Guipúzcoa;029;Deba;4847;2497;2350
20;Guipúzcoa;069;Donostia/San Sebastián;176586;83000;93586
20;Guipúzcoa;030;Eibar;34545;17041;17504
20;Guipúzcoa;031;Elduain;262;147;115
20;Guipúzcoa;033;Elgeta;1042;531;511
20;Guipúzcoa;032;Elgoibar;12364;6289;6075
20;Guipúzcoa;067;Errenteria;43653;21770;21883
20;Guipúzcoa;066;Errezil;742;413;329
20;Guipúzcoa;034;Eskoriatza;4000;2084;1916
20;Guipúzcoa;035;Ezkio-Itsaso;598;308;290
20;Guipúzcoa;038;Gabiria;460;255;205
20;Guipúzcoa;037;Gaintza;124;72;52
20;Guipúzcoa;907;Gaztelu;"";"";""
20;Guipúzcoa;039;Getaria;2337;1168;1169
20;Guipúzcoa;040;Hernani;19120;9525;9595
20;Guipúzcoa;041;Hernialde;287;156;131
20;Guipúzcoa;036;Hondarribia;13056;6505;6551
20;Guipúzcoa;042;Ibarra;4564;2357;2207
20;Guipúzcoa;043;Idiazabal;2074;1051;1023
20;Guipúzcoa;044;Ikaztegieta;659;346;313
20;Guipúzcoa;045;Irún;54301;26617;27684
20;Guipúzcoa;046;Irura;652;320;332
20;Guipúzcoa;047;Itsasondo;785;397;388
20;Guipúzcoa;048;Larraul;163;100;63
20;Guipúzcoa;902;Lasarte-Oria;18569;9287;9282
20;Guipúzcoa;049;Lazkao;5283;2711;2572
20;Guipúzcoa;050;Leaburu;599;325;274
20;Guipúzcoa;051;Legazpi;10317;5341;4976
20;Guipúzcoa;052;Legorreta;1609;804;805
20;Guipúzcoa;068;Leintz-Gatzaga;213;117;96
20;Guipúzcoa;053;Lezo;5682;2800;2882
20;Guipúzcoa;054;Lizartza;734;390;344
20;Guipúzcoa;901;Mendaro;1584;803;781
20;Guipúzcoa;057;Mutiloa;198;98;100
20;Guipúzcoa;056;Mutriku;4643;2324;2319
20;Guipúzcoa;063;Oiartzun;8182;4083;4099
20;Guipúzcoa;058;Olaberria;1262;641;621
20;Guipúzcoa;076;Ordizia;9473;4657;4816
20;Guipúzcoa;905;Orendain;"";"";""
20;Guipúzcoa;060;Orexa;83;43;40
20;Guipúzcoa;061;Orio;4303;2184;2119
20;Guipúzcoa;062;Ormaiztegi;1284;636;648
20;Guipúzcoa;059;Oñati;10894;5472;5422
20;Guipúzcoa;064;Pasaia;19513;9580;9933
20;Guipúzcoa;070;Segura;1377;699;678
20;Guipúzcoa;065;Soraluze/Placencia de las Armas;5219;2615;2604
20;Guipúzcoa;071;Tolosa;18336;8855;9481
20;Guipúzcoa;072;Urnieta;4445;2278;2167
20;Guipúzcoa;077;Urretxu;6431;3316;3115
20;Guipúzcoa;073;Usurbil;5584;2862;2722
20;Guipúzcoa;075;Villabona;5336;2705;2631
20;Guipúzcoa;078;Zaldibia;1706;897;809
20;Guipúzcoa;079;Zarautz;16605;8259;8346
20;Guipúzcoa;025;Zegama;1461;745;716
20;Guipúzcoa;026;Zerain;235;114;121
20;Guipúzcoa;027;Zestoa;3593;1887;1706
20;Guipúzcoa;028;Zizurkil;2790;1415;1375
20;Guipúzcoa;081;Zumaia;8104;4068;4036
20;Guipúzcoa;080;Zumarraga;11588;5844;5744
21;Huelva;001;Alájar;906;449;457
21;Huelva;002;Aljaraque;5464;2713;2751
21;Huelva;003;Almendro (El);892;464;428
21;Huelva;004;Almonaster la Real;2398;1177;1221
21;Huelva;005;Almonte;14815;7448;7367
21;Huelva;006;Alosno;5038;2443;2595
21;Huelva;007;Aracena;6355;3073;3282
21;Huelva;008;Aroche;3859;1887;1972
21;Huelva;009;Arroyomolinos de León;1319;652;667
21;Huelva;010;Ayamonte;16874;8374;8500
21;Huelva;011;Beas;4021;2000;2021
21;Huelva;012;Berrocal;442;225;217
21;Huelva;013;Bollullos Par del Condado;12395;6166;6229
21;Huelva;014;Bonares;4885;2462;2423
21;Huelva;015;Cabezas Rubias;962;498;464
21;Huelva;016;Cala;1555;777;778
21;Huelva;017;Calañas;5412;2659;2753
21;Huelva;018;Campillo (El);2902;1415;1487
21;Huelva;019;Campofrío;909;461;448
21;Huelva;020;Cañaveral de León;603;287;316
21;Huelva;021;Cartaya;9949;4984;4965
21;Huelva;022;Castaño del Robledo;211;109;102
21;Huelva;023;Cerro de Andévalo (El);3103;1532;1571
21;Huelva;030;Chucena;1924;984;940
21;Huelva;024;Corteconcepción;731;375;356
21;Huelva;025;Cortegana;5501;2681;2820
21;Huelva;026;Cortelazor;375;185;190
21;Huelva;027;Cumbres de Enmedio;61;29;32
21;Huelva;028;Cumbres de San Bartolomé;759;383;376
21;Huelva;029;Cumbres Mayores;2505;1203;1302
21;Huelva;031;Encinasola;2429;1176;1253
21;Huelva;032;Escacena del Campo;2239;1107;1132
21;Huelva;033;Fuenteheridos;649;321;328
21;Huelva;034;Galaroza;1686;815;871
21;Huelva;035;Gibraleón;9757;4885;4872
21;Huelva;036;Granada de Río-Tinto (La);228;125;103
21;Huelva;037;Granado (El);717;372;345
21;Huelva;038;Higuera de la Sierra;1427;705;722
21;Huelva;039;Hinojales;499;251;248
21;Huelva;040;Hinojos;3453;1770;1683
21;Huelva;041;Huelva;135938;65809;70129
21;Huelva;042;Isla Cristina;16007;7947;8060
21;Huelva;043;Jabugo;2557;1250;1307
21;Huelva;044;Lepe;15413;7826;7587
21;Huelva;045;Linares de la Sierra;284;138;146
21;Huelva;046;Lucena del Puerto;2013;1008;1005
21;Huelva;047;Manzanilla;2479;1236;1243
21;Huelva;048;Marines (Los);372;186;186
21;Huelva;049;Minas de Riotinto;6217;2953;3264
21;Huelva;050;Moguer;11116;5625;5491
21;Huelva;051;Nava (La);387;187;200
21;Huelva;052;Nerva;7333;3571;3762
21;Huelva;053;Niebla;3951;2012;1939
21;Huelva;054;Palma del Condado (La);9285;4622;4663
21;Huelva;055;Palos de la Frontera;6414;3227;3187
21;Huelva;056;Paterna del Campo;3815;2010;1805
21;Huelva;057;Paymogo;1539;735;804
21;Huelva;058;Puebla de Guzmán;3374;1702;1672
21;Huelva;059;Puerto Moral;241;112;129
21;Huelva;060;Punta Umbría;9676;4872;4804
21;Huelva;061;Rociana del Condado;6166;3153;3013
21;Huelva;062;Rosal de la Frontera;2084;1005;1079
21;Huelva;063;San Bartolomé de la Torre;2750;1404;1346
21;Huelva;064;San Juan del Puerto;5479;2742;2737
21;Huelva;066;San Silvestre de Guzmán;769;377;392
21;Huelva;065;Sanlúcar de Guadiana;440;214;226
21;Huelva;067;Santa Ana la Real;582;276;306
21;Huelva;068;Santa Bárbara de Casa;1574;778;796
21;Huelva;069;Santa Olalla del Cala;2421;1205;1216
21;Huelva;070;Trigueros;7002;3499;3503
21;Huelva;071;Valdelarco;336;157;179
21;Huelva;072;Valverde del Camino;11975;5753;6222
21;Huelva;073;Villablanca;1952;1003;949
21;Huelva;074;Villalba del Alcor;3796;1881;1915
21;Huelva;075;Villanueva de las Cruces;484;238;246
21;Huelva;076;Villanueva de los Castillejos;2682;1329;1353
21;Huelva;077;Villarrasa;2264;1159;1105
21;Huelva;078;Zalamea la Real;3939;1931;2008
21;Huelva;079;Zufre;1498;782;716
22;Huesca;001;Abiego;350;180;170
22;Huesca;002;Abizanda;117;68;49
22;Huesca;003;Adahuesca;191;95;96
22;Huesca;004;Agüero;186;101;85
22;Huesca;907;Aínsa-Sobrarbe;1345;703;642
22;Huesca;006;Aisa;297;151;146
22;Huesca;007;Albalate de Cinca;1240;638;602
22;Huesca;008;Albalatillo;294;148;146
22;Huesca;009;Albelda;1108;566;542
22;Huesca;011;Albero Alto;119;58;61
22;Huesca;012;Albero Bajo;142;74;68
22;Huesca;013;Alberuela de Tubo;467;242;225
22;Huesca;014;Alcalá de Gurrea;462;232;230
22;Huesca;015;Alcalá del Obispo;451;222;229
22;Huesca;016;Alcampell;1210;616;594
22;Huesca;017;Alcolea de Cinca;1225;616;609
22;Huesca;018;Alcubierre;554;285;269
22;Huesca;019;Alerre;135;65;70
22;Huesca;020;Alfántega;139;76;63
22;Huesca;021;Almudévar;2544;1335;1209
22;Huesca;022;Almunia de San Juan;810;400;410
22;Huesca;023;Almuniente;718;361;357
22;Huesca;024;Alquézar;279;138;141
22;Huesca;025;Altorricón;1592;849;743
22;Huesca;027;Angüés;560;302;258
22;Huesca;028;Ansó;541;279;262
22;Huesca;029;Antillón;182;87;95
22;Huesca;032;Aragüés del Puerto;129;85;44
22;Huesca;035;Arén;453;241;212
22;Huesca;036;Argavieso;128;73;55
22;Huesca;037;Arguis;55;29;26
22;Huesca;039;Ayerbe;1309;657;652
22;Huesca;040;Azanuy-Alins;291;142;149
22;Huesca;041;Azara;234;120;114
22;Huesca;042;Azlor;212;111;101
22;Huesca;043;Baélls;207;109;98
22;Huesca;044;Bailo;388;221;167
22;Huesca;045;Baldellou;210;110;100
22;Huesca;046;Ballobar;1229;607;622
22;Huesca;047;Banastás;102;46;56
22;Huesca;048;Barbastro;15083;7412;7671
22;Huesca;049;Barbués;130;62;68
22;Huesca;050;Barbuñales;123;66;57
22;Huesca;051;Bárcabo;114;66;48
22;Huesca;052;Belver de Cinca;1625;846;779
22;Huesca;053;Benabarre;1272;681;591
22;Huesca;054;Benasque;895;476;419
22;Huesca;055;Berbegal;542;263;279
22;Huesca;057;Bielsa;469;240;229
22;Huesca;058;Bierge;217;117;100
22;Huesca;059;Biescas;1240;648;592
22;Huesca;060;Binaced;1699;862;837
22;Huesca;061;Binéfar;7993;4035;3958
22;Huesca;062;Bisaurri;281;166;115
22;Huesca;063;Biscarrués;263;137;126
22;Huesca;064;Blecua y Torres;229;116;113
22;Huesca;066;Boltaña;890;438;452
22;Huesca;067;Bonansa;66;38;28
22;Huesca;068;Borau;76;42;34
22;Huesca;069;Broto;496;252;244
22;Huesca;072;Caldearenas;332;171;161
22;Huesca;074;Campo;420;195;225
22;Huesca;075;Camporrélls;338;153;185
22;Huesca;076;Canal de Berdún;509;262;247
22;Huesca;077;Candasnos;698;361;337
22;Huesca;078;Canfranc;556;296;260
22;Huesca;079;Capdesaso;219;111;108
22;Huesca;080;Capella;485;250;235
22;Huesca;081;Casbas de Huesca;356;186;170
22;Huesca;083;Castejón de Monegros;867;433;434
22;Huesca;084;Castejón de Sos;434;219;215
22;Huesca;082;Castejón del Puente;439;215;224
22;Huesca;085;Castelflorite;182;93;89
22;Huesca;086;Castiello de Jaca;171;80;91
22;Huesca;087;Castigaleu;94;51;43
22;Huesca;088;Castillazuelo;276;146;130
22;Huesca;089;Castillonroy;464;233;231
22;Huesca;094;Chalamera;181;101;80
22;Huesca;095;Chía;141;79;62
22;Huesca;096;Chimillas;152;83;69
22;Huesca;090;Colungo;166;82;84
22;Huesca;099;Esplús;1499;744;755
22;Huesca;102;Estada;236;121;115
22;Huesca;103;Estadilla;1061;546;515
22;Huesca;105;Estopiñán del Castillo;209;107;102
22;Huesca;106;Fago;53;32;21
22;Huesca;107;Fanlo;43;29;14
22;Huesca;109;Fiscal;313;170;143
22;Huesca;110;Fonz;1345;669;676
22;Huesca;111;Foradada del Toscar;291;149;142
22;Huesca;112;Fraga;11470;5759;5711
22;Huesca;113;Fueva (La);700;389;311
22;Huesca;114;Gistaín;"";"";""
22;Huesca;115;Grado (El);609;314;295
22;Huesca;116;Grañén;2397;1216;1181
22;Huesca;117;Graus;3485;1767;1718
22;Huesca;119;Gurrea de Gállego;2117;1068;1049
22;Huesca;122;Hoz de Jaca;85;35;50
22;Huesca;908;Hoz y Costean;305;165;140
22;Huesca;124;Huerto;349;187;162
22;Huesca;125;Huesca;40949;19883;21066
22;Huesca;126;Ibieca;129;67;62
22;Huesca;127;Igriés;161;92;69
22;Huesca;128;Ilche;321;165;156
22;Huesca;129;Isábena;309;167;142
22;Huesca;130;Jaca;10640;5283;5357
22;Huesca;131;Jasa;119;65;54
22;Huesca;133;Labuerda;183;93;90
22;Huesca;135;Laluenga;344;182;162
22;Huesca;136;Lalueza;1463;799;664
22;Huesca;137;Lanaja;1944;999;945
22;Huesca;139;Laperdiguera;111;59;52
22;Huesca;141;Lascellas-Ponzano;209;101;108
22;Huesca;142;Lascuarre;177;88;89
22;Huesca;143;Laspaúles;331;191;140
22;Huesca;144;Laspuña;292;158;134
22;Huesca;149;Loarre;432;231;201
22;Huesca;150;Loporzano;463;232;231
22;Huesca;151;Loscorrales;146;79;67
22;Huesca;905;Lupiñén-Ortilla;416;222;194
22;Huesca;155;Monesma y Cajigar;111;52;59
22;Huesca;156;Monflorite-Lascasas;190;101;89
22;Huesca;157;Montanuy;377;219;158
22;Huesca;158;Monzón;14668;7423;7245
22;Huesca;160;Naval;293;146;147
22;Huesca;162;Novales;222;102;120
22;Huesca;163;Nueno;218;117;101
22;Huesca;164;Olvena;62;33;29
22;Huesca;165;Ontiñena;750;378;372
22;Huesca;167;Osso de Cinca;764;397;367
22;Huesca;168;Palo;41;24;17
22;Huesca;170;Panticosa;568;302;266
22;Huesca;172;Peñalba;822;399;423
22;Huesca;173;Peñas de Riglos (Las);343;188;155
22;Huesca;174;Peralta de Alcofea;835;405;430
22;Huesca;175;Peralta de Calasanz;432;231;201
22;Huesca;176;Peraltilla;183;97;86
22;Huesca;177;Perarrúa;167;83;84
22;Huesca;178;Pertusa;161;80;81
22;Huesca;181;Piracés;114;67;47
22;Huesca;182;Plan;545;299;246
22;Huesca;184;Poleñino;291;146;145
22;Huesca;186;Pozán de Vero;300;154;146
22;Huesca;187;Puebla de Castro (La);297;142;155
22;Huesca;188;Puente de Montañana;167;88;79
22;Huesca;902;Puente la Reina de Jaca;307;154;153
22;Huesca;189;Puértolas;204;116;88
22;Huesca;190;Pueyo de Araguás (El);169;100;69
22;Huesca;193;Pueyo de Santa Cruz;415;215;200
22;Huesca;195;Quicena;126;60;66
22;Huesca;197;Robres;802;402;400
22;Huesca;199;Sabiñánigo;9008;4648;4360
22;Huesca;200;Sahún;323;172;151
22;Huesca;201;Salas Altas;452;232;220
22;Huesca;202;Salas Bajas;242;116;126
22;Huesca;203;Salillas;147;74;73
22;Huesca;204;Sallent de Gállego;911;462;449
22;Huesca;205;San Esteban de Litera;816;397;419
22;Huesca;207;San Juan de Plan;174;101;73
22;Huesca;903;San Miguel del Cinca;971;509;462
22;Huesca;206;Sangarrén;317;158;159
22;Huesca;208;Santa Cilia;221;119;102
22;Huesca;209;Santa Cruz de la Serós;141;82;59
22;Huesca;906;Santa María de Dulcis;253;121;132
22;Huesca;212;Santaliestra y San Quílez;121;60;61
22;Huesca;213;Sariñena;4437;2231;2206
22;Huesca;214;Secastilla;212;92;120
22;Huesca;215;Seira;220;106;114
22;Huesca;217;Sena;727;371;356
22;Huesca;218;Senés de Alcubierre;73;34;39
22;Huesca;220;Sesa;329;168;161
22;Huesca;221;Sesué;76;42;34
22;Huesca;222;Siétamo;382;202;180
22;Huesca;223;Sopeira;156;86;70
22;Huesca;904;Sotonera (La);1411;726;685
22;Huesca;225;Tamarite de Litera;4147;2072;2075
22;Huesca;226;Tardienta;1316;673;643
22;Huesca;227;Tella-Sin;377;196;181
22;Huesca;228;Tierz;209;107;102
22;Huesca;229;Tolva;281;147;134
22;Huesca;230;Torla;349;194;155
22;Huesca;232;Torralba de Aragón;170;77;93
22;Huesca;233;Torre la Ribera;125;73;52
22;Huesca;234;Torrente de Cinca;1227;623;604
22;Huesca;235;Torres de Alcanadre;156;94;62
22;Huesca;236;Torres de Barbués;466;249;217
22;Huesca;239;Tramaced;144;84;60
22;Huesca;242;Valfarta;112;57;55
22;Huesca;243;Valle de Bardají;71;37;34
22;Huesca;901;Valle de Hecho;1062;564;498
22;Huesca;244;Valle de Lierp;69;37;32
22;Huesca;245;Velilla de Cinca;556;275;281
22;Huesca;909;Vencillón;"";"";""
22;Huesca;246;Veracruz;130;73;57
22;Huesca;247;Viacamp y Litera;52;31;21
22;Huesca;248;Vicién;136;78;58
22;Huesca;249;Villanova;103;53;50
22;Huesca;250;Villanúa;199;108;91
22;Huesca;251;Villanueva de Sigena;521;272;249
22;Huesca;252;Yebra de Basa;189;103;86
22;Huesca;253;Yésero;58;27;31
22;Huesca;254;Zaidín;1874;933;941
23;Jaén;001;Albanchez de Mágina;1856;906;950
23;Jaén;002;Alcalá la Real;20410;10176;10234
23;Jaén;003;Alcaudete;11975;5958;6017
23;Jaén;004;Aldeaquemada;659;335;324
23;Jaén;005;Andújar;36027;17844;18183
23;Jaén;006;Arjona;6053;3055;2998
23;Jaén;007;Arjonilla;3961;1981;1980
23;Jaén;008;Arquillos;1884;969;915
23;Jaén;009;Baeza;14812;7211;7601
23;Jaén;010;Bailén;16184;8154;8030
23;Jaén;011;Baños de la Encina;2819;1427;1392
23;Jaén;012;Beas de Segura;8787;4417;4370
23;Jaén;902;Bedmar y Garcíez;4063;2038;2025
23;Jaén;014;Begíjar;3144;1564;1580
23;Jaén;015;Bélmez de la Moraleda;2099;1042;1057
23;Jaén;016;Benatae;757;375;382
23;Jaén;017;Cabra del Santo Cristo;2639;1363;1276
23;Jaén;018;Cambil;4020;2061;1959
23;Jaén;019;Campillo de Arenas;2424;1240;1184
23;Jaén;020;Canena;2124;1023;1101
23;Jaén;021;Carboneros;758;375;383
23;Jaén;901;Cárcheles;1679;809;870
23;Jaén;024;Carolina (La);15163;7409;7754
23;Jaén;025;Castellar;3697;1842;1855
23;Jaén;026;Castillo de Locubín;6088;3025;3063
23;Jaén;027;Cazalilla;965;497;468
23;Jaén;028;Cazorla;9282;4560;4722
23;Jaén;029;Chiclana de Segura;2201;1098;1103
23;Jaén;030;Chilluévar;2111;1065;1046
23;Jaén;031;Escañuela;1064;547;517
23;Jaén;032;Espelúy;856;418;438
23;Jaén;033;Frailes;2019;1016;1003
23;Jaén;034;Fuensanta de Martos;3674;1804;1870
23;Jaén;035;Fuerte del Rey;1174;585;589
23;Jaén;037;Génave;872;434;438
23;Jaén;038;Guardia de Jaén (La);1829;937;892
23;Jaén;039;Guarromán;3179;1573;1606
23;Jaén;041;Higuera de Calatrava;821;434;387
23;Jaén;042;Hinojares;761;384;377
23;Jaén;043;Hornos;858;450;408
23;Jaén;044;Huelma;6032;3002;3030
23;Jaén;045;Huesa;2939;1461;1478
23;Jaén;046;Ibros;3244;1617;1627
23;Jaén;047;Iruela (La);2360;1188;1172
23;Jaén;048;Iznatoraf;1426;687;739
23;Jaén;049;Jabalquinto;2763;1373;1390
23;Jaén;050;Jaén;103698;50087;53611
23;Jaén;051;Jamilena;3088;1569;1519
23;Jaén;052;Jimena;1882;933;949
23;Jaén;053;Jódar;12194;6121;6073
23;Jaén;040;Lahiguera;1973;973;1000
23;Jaén;054;Larva;807;416;391
23;Jaén;055;Linares;57526;28197;29329
23;Jaén;056;Lopera;3924;1944;1980
23;Jaén;057;Lupión;1261;599;662
23;Jaén;058;Mancha Real;8157;4032;4125
23;Jaén;059;Marmolejo;7347;3695;3652
23;Jaén;060;Martos;22036;10785;11251
23;Jaén;061;Mengíbar;8193;4089;4104
23;Jaén;062;Montizón;2143;1077;1066
23;Jaén;063;Navas de San Juan;5434;2676;2758
23;Jaén;064;Noalejo;2422;1241;1181
23;Jaén;065;Orcera;2550;1310;1240
23;Jaén;066;Peal de Becerro;5531;2763;2768
23;Jaén;067;Pegalajar;3280;1603;1677
23;Jaén;069;Porcuna;7319;3656;3663
23;Jaén;070;Pozo Alcón;6094;3063;3031
23;Jaén;071;Puente de Génave;2172;1104;1068
23;Jaén;072;Puerta de Segura (La);3132;1570;1562
23;Jaén;073;Quesada;7393;3709;3684
23;Jaén;074;Rus;3660;1824;1836
23;Jaén;075;Sabiote;4550;2234;2316
23;Jaén;076;Santa Elena;1087;553;534
23;Jaén;077;Santiago de Calatrava;1124;565;559
23;Jaén;904;Santiago-Pontones;5544;2844;2700
23;Jaén;079;Santisteban del Puerto;5150;2589;2561
23;Jaén;080;Santo Tomé;2939;1482;1457
23;Jaén;081;Segura de la Sierra;2704;1403;1301
23;Jaén;082;Siles;2885;1438;1447
23;Jaén;084;Sorihuela del Guadalimar;1507;767;740
23;Jaén;086;Torre del Campo;11072;5441;5631
23;Jaén;085;Torreblascopedro;3342;1684;1658
23;Jaén;087;Torredonjimeno;13388;6555;6833
23;Jaén;088;Torreperogil;7807;3823;3984
23;Jaén;090;Torres;2166;1091;1075
23;Jaén;091;Torres de Albánchez;1236;627;609
23;Jaén;092;Úbeda;30720;15075;15645
23;Jaén;093;Valdepeñas de Jaén;5097;2585;2512
23;Jaén;094;Vilches;5420;2717;2703
23;Jaén;095;Villacarrillo;12225;6093;6132
23;Jaén;096;Villanueva de la Reina;3611;1803;1808
23;Jaén;097;Villanueva del Arzobispo;9021;4439;4582
23;Jaén;098;Villardompardo;1319;642;677
23;Jaén;099;Villares (Los);4309;2120;2189
23;Jaén;101;Villarrodrigo;937;479;458
23;Jaén;903;Villatorres;3956;1991;1965
24;León;001;Acebedo;422;214;208
24;León;002;Algadefe;464;240;224
24;León;003;Alija del Infantado;1304;664;640
24;León;004;Almanza;972;482;490
24;León;005;Antigua (La);911;468;443
24;León;006;Ardón;845;443;402
24;León;007;Arganza;1243;603;640
24;León;008;Astorga;12562;6008;6554
24;León;009;Balboa;803;392;411
24;León;010;Bañeza (La);9110;4394;4716
24;León;011;Barjas;782;424;358
24;León;012;Barrios de Luna (Los);456;228;228
24;León;014;Bembibre;10448;5294;5154
24;León;015;Benavides;3406;1786;1620
24;León;016;Benuza;1013;528;485
24;León;017;Bercianos del Páramo;1123;556;567
24;León;018;Bercianos del Real Camino;323;169;154
24;León;019;Berlanga del Bierzo;524;254;270
24;León;020;Boca de Huérgano;829;436;393
24;León;021;Boñar;3146;1552;1594
24;León;022;Borrenes;723;368;355
24;León;023;Brazuelo;368;189;179
24;León;024;Burgo Ranero (El);1288;658;630
24;León;025;Burón;638;337;301
24;León;026;Bustillo del Páramo;2425;1234;1191
24;León;027;Cabañas Raras;1208;632;576
24;León;028;Cabreros del Río;764;387;377
24;León;029;Cabrillanes;1512;758;754
24;León;030;Cacabelos;4668;2376;2292
24;León;031;Calzada del Coto;385;215;170
24;León;032;Campazas;238;113;125
24;León;033;Campo de Villavidel;490;254;236
24;León;034;Camponaraya;3080;1514;1566
24;León;036;Candín;603;327;276
24;León;037;Cármenes;625;286;339
24;León;038;Carracedelo;3561;1803;1758
24;León;039;Carrizo;2821;1454;1367
24;León;040;Carrocera;814;398;416
24;León;041;Carucedo;827;387;440
24;León;042;Castilfalé;147;77;70
24;León;043;Castrillo de Cabrera;465;239;226
24;León;044;Castrillo de la Valduerna;355;172;183
24;León;046;Castrocalbón;1575;779;796
24;León;047;Castrocontrigo;1514;760;754
24;León;049;Castropodame;2033;1016;1017
24;León;050;Castrotierra de Valmadrigal;199;105;94
24;León;051;Cea;983;510;473
24;León;052;Cebanico;372;201;171
24;León;053;Cebrones del Río;955;484;471
24;León;065;Chozas de Abajo;2377;1231;1146
24;León;054;Cimanes de la Vega;814;396;418
24;León;055;Cimanes del Tejar;1325;672;653
24;León;056;Cistierna;5338;2685;2653
24;León;057;Congosto;2164;1063;1101
24;León;058;Corbillos de los Oteros;453;217;236
24;León;059;Corullón;1805;898;907
24;León;060;Crémenes;1717;839;878
24;León;061;Cuadros;1882;884;998
24;León;062;Cubillas de los Oteros;280;130;150
24;León;063;Cubillas de Rueda;851;425;426
24;León;064;Cubillos del Sil;1153;600;553
24;León;066;Destriana;1190;568;622
24;León;067;Encinedo;1240;662;578
24;León;068;Ercina (La);1048;512;536
24;León;069;Escobar de Campos;112;65;47
24;León;070;Fabero;7019;3526;3493
24;León;071;Folgoso de la Ribera;1778;902;876
24;León;072;Fresnedo;568;286;282
24;León;073;Fresno de la Vega;854;415;439
24;León;074;Fuentes de Carbajal;190;105;85
24;León;076;Garrafe de Torío;1168;573;595
24;León;077;Gordaliza del Pino;484;240;244
24;León;078;Gordoncillo;771;375;396
24;León;079;Gradefes;1685;820;865
24;León;080;Grajal de Campos;437;193;244
24;León;081;Gusendos de los Oteros;322;160;162
24;León;082;Hospital de Órbigo;1207;606;601
24;León;083;Igüeña;2803;1512;1291
24;León;084;Izagre;475;226;249
24;León;086;Joarilla de las Matas;550;290;260
24;León;087;Laguna Dalga;1179;587;592
24;León;088;Laguna de Negrillos;2047;1045;1002
24;León;089;León;135521;64398;71123
24;León;092;Llamas de la Ribera;1590;810;780
24;León;090;Lucillo;628;331;297
24;León;091;Luyego;1107;535;572
24;León;093;Magaz de Cepeda;753;361;392
24;León;094;Mansilla de las Mulas;1814;903;911
24;León;095;Mansilla Mayor;538;262;276
24;León;096;Maraña;255;130;125
24;León;097;Matadeón de los Oteros;384;204;180
24;León;098;Matallana de Torío;2138;1051;1087
24;León;099;Matanza;472;232;240
24;León;100;Molinaseca;748;381;367
24;León;101;Murias de Paredes;1016;477;539
24;León;102;Noceda del Bierzo;1177;575;602
24;León;103;Oencia;628;331;297
24;León;104;Omañas (Las);554;269;285
24;León;105;Onzonilla;1351;666;685
24;León;106;Oseja de Sajambre;443;230;213
24;León;107;Pajares de los Oteros;530;279;251
24;León;108;Palacios de la Valduerna;705;359;346
24;León;109;Palacios del Sil;2061;1058;1003
24;León;110;Páramo del Sil;2559;1290;1269
24;León;111;Pedrosa del Rey;173;90;83
24;León;112;Peranzanes;509;259;250
24;León;113;Pobladura de Pelayo García;863;431;432
24;León;114;Pola de Gordón (La);6775;3317;3458
24;León;115;Ponferrada;59399;29294;30105
24;León;116;Posada de Valdeón;635;328;307
24;León;117;Pozuelo del Páramo;851;448;403
24;León;118;Prado de la Guzpeña;231;121;110
24;León;119;Priaranza del Bierzo;1147;597;550
24;León;120;Prioro;638;329;309
24;León;121;Puebla de Lillo;831;431;400
24;León;122;Puente de Domingo Flórez;2127;1130;997
24;León;123;Quintana del Castillo;1500;767;733
24;León;124;Quintana del Marco;780;405;375
24;León;125;Quintana y Congosto;1074;551;523
24;León;127;Regueras de Arriba;511;283;228
24;León;129;Reyero;236;125;111
24;León;130;Riaño;914;472;442
24;León;131;Riego de la Vega;1429;708;721
24;León;132;Riello;1412;682;730
24;León;133;Rioseco de Tapia;705;375;330
24;León;134;Robla (La);5521;2790;2731
24;León;136;Roperuelos del Páramo;1062;538;524
24;León;137;Sabero;2920;1480;1440
24;León;139;Sahagún;3503;1741;1762
24;León;141;San Adrián del Valle;253;120;133
24;León;142;San Andrés del Rabanedo;16095;7820;8275
24;León;144;San Cristóbal de la Polantera;1499;759;740
24;León;145;San Emiliano;1203;593;610
24;León;146;San Esteban de Nogales;577;269;308
24;León;148;San Justo de la Vega;2606;1312;1294
24;León;149;San Millán de los Caballeros;243;121;122
24;León;150;San Pedro Bercianos;462;236;226
24;León;143;Sancedo;704;360;344
24;León;151;Santa Colomba de Curueño;814;400;414
24;León;152;Santa Colomba de Somoza;655;327;328
24;León;153;Santa Cristina de Valmadrigal;497;260;237
24;León;154;Santa Elena de Jamuz;1605;815;790
24;León;155;Santa María de la Isla;882;466;416
24;León;158;Santa María de Ordás;609;302;307
24;León;156;Santa María del Monte de Cea;572;286;286
24;León;157;Santa María del Páramo;3037;1480;1557
24;León;159;Santa Marina del Rey;3085;1542;1543
24;León;160;Santas Martas;1363;693;670
24;León;161;Santiago Millas;432;212;220
24;León;162;Santovenia de la Valdoncina;1274;607;667
24;León;163;Sariegos;1622;805;817
24;León;164;Sena de Luna;704;343;361
24;León;165;Sobrado;725;369;356
24;León;166;Soto de la Vega;2298;1173;1125
24;León;167;Soto y Amío;1310;625;685
24;León;168;Toral de los Guzmanes;856;442;414
24;León;169;Toreno;5546;2902;2644
24;León;170;Torre del Bierzo;4139;2101;2038
24;León;171;Trabadelo;840;442;398
24;León;172;Truchas;1463;720;743
24;León;173;Turcia;1805;929;876
24;León;174;Urdiales del Páramo;1091;547;544
24;León;185;Val de San Lorenzo;903;439;464
24;León;175;Valdefresno;1632;818;814
24;León;176;Valdefuentes del Páramo;570;301;269
24;León;177;Valdelugueros;537;274;263
24;León;178;Valdemora;165;85;80
24;León;179;Valdepiélago;526;259;267
24;León;180;Valdepolo;1996;1066;930
24;León;181;Valderas;2598;1300;1298
24;León;182;Valderrey;893;433;460
24;León;183;Valderrueda;1820;908;912
24;León;184;Valdesamario;401;199;202
24;León;187;Valdevimbre;1486;758;728
24;León;188;Valencia de Don Juan;3777;1891;1886
24;León;191;Vallecillo;245;129;116
24;León;189;Valverde de la Virgen;3430;1754;1676
24;León;190;Valverde-Enrique;322;156;166
24;León;193;Vecilla (La);562;284;278
24;León;196;Vega de Espinareda;3651;1856;1795
24;León;197;Vega de Infanzones;997;501;496
24;León;198;Vega de Valcarce;1398;710;688
24;León;194;Vegacervera;374;194;180
24;León;199;Vegaquemada;737;359;378
24;León;201;Vegas del Condado;1814;909;905
24;León;202;Villablino;15554;7894;7660
24;León;203;Villabraz;238;126;112
24;León;205;Villadangos del Páramo;1068;523;545
24;León;206;Villadecanes;2632;1302;1330
24;León;207;Villademor de la Vega;597;308;289
24;León;209;Villafranca del Bierzo;5302;2662;2640
24;León;210;Villagatón;1340;701;639
24;León;211;Villamandos;631;305;326
24;León;901;Villamanín;1881;957;924
24;León;212;Villamañán;1681;836;845
24;León;213;Villamartín de Don Sancho;274;140;134
24;León;214;Villamejil;1272;661;611
24;León;215;Villamol;354;171;183
24;León;216;Villamontán de la Valduerna;1547;796;751
24;León;217;Villamoratiel de las Matas;298;159;139
24;León;218;Villanueva de las Manzanas;795;369;426
24;León;219;Villaobispo de Otero;861;448;413
24;León;902;Villaornate y Castro;670;336;334
24;León;221;Villaquejida;1270;652;618
24;León;222;Villaquilambre;4415;2173;2242
24;León;223;Villarejo de Órbigo;3815;1873;1942
24;León;224;Villares de Órbigo;1218;620;598
24;León;225;Villasabariego;1422;704;718
24;León;226;Villaselán;458;246;212
24;León;227;Villaturiel;1866;955;911
24;León;228;Villazala;1410;722;688
24;León;229;Villazanzo de Valderaduey;962;506;456
24;León;230;Zotes del Páramo;1033;538;495
25;Lleida;001;Abella de la Conca;163;83;80
25;Lleida;002;Àger;625;320;305
25;Lleida;003;Agramunt;4744;2384;2360
25;Lleida;038;Aitona;2360;1181;1179
25;Lleida;004;Alamús (Els);673;339;334
25;Lleida;005;Alàs i Cerc;426;227;199
25;Lleida;006;Albagés (L');593;291;302
25;Lleida;007;Albatàrrec;1016;494;522
25;Lleida;008;Albesa;1455;734;721
25;Lleida;009;Albi (L');835;428;407
25;Lleida;010;Alcanó;283;139;144
25;Lleida;011;Alcarràs;4425;2230;2195
25;Lleida;012;Alcoletge;1436;722;714
25;Lleida;013;Alfarràs;3139;1551;1588
25;Lleida;014;Alfés;348;182;166
25;Lleida;015;Algerri;597;287;310
25;Lleida;016;Alguaire;2864;1438;1426
25;Lleida;017;Alins;292;153;139
25;Lleida;019;Almacelles;5447;2776;2671
25;Lleida;020;Almatret;588;302;286
25;Lleida;021;Almenar;3608;1844;1764
25;Lleida;022;Alòs de Balaguer;182;102;80
25;Lleida;023;Alpicat;3445;1793;1652
25;Lleida;024;Alt Àneu;333;183;150
25;Lleida;027;Anglesola;1327;660;667
25;Lleida;029;Arbeca;2382;1180;1202
25;Lleida;031;Arres;52;32;20
25;Lleida;032;Arsèguel;82;43;39
25;Lleida;033;Artesa de Lleida;1176;572;604
25;Lleida;034;Artesa de Segre;3240;1664;1576
25;Lleida;036;Aspa;269;137;132
25;Lleida;037;Avellanes i Santa Linya (Les);542;285;257
25;Lleida;039;Baix Pallars;429;237;192
25;Lleida;040;Balaguer;13116;6480;6636
25;Lleida;041;Barbens;819;421;398
25;Lleida;042;Baronia de Rialb (La);274;148;126
25;Lleida;044;Bassella;388;199;189
25;Lleida;045;Bausen;63;41;22
25;Lleida;046;Belianes;604;294;310
25;Lleida;170;Bellaguarda;398;203;195
25;Lleida;047;Bellcaire d'Urgell;1463;721;742
25;Lleida;048;Bell-lloc d'Urgell;2212;1106;1106
25;Lleida;049;Bellmunt d'Urgell;239;122;117
25;Lleida;050;Bellpuig;3790;1885;1905
25;Lleida;051;Bellver de Cerdanya;1598;823;775
25;Lleida;052;Bellvís;2336;1165;1171
25;Lleida;053;Benavent de Segrià;728;378;350
25;Lleida;055;Biosca;279;137;142
25;Lleida;057;Bòrdes (Es);193;94;99
25;Lleida;058;Borges Blanques (Les);5227;2572;2655
25;Lleida;059;Bossòst;793;395;398
25;Lleida;056;Bovera;503;253;250
25;Lleida;060;Cabanabona;125;61;64
25;Lleida;061;Cabó;160;93;67
25;Lleida;062;Camarasa;1004;505;499
25;Lleida;063;Canejan;122;67;55
25;Lleida;904;Castell de Mur;147;72;75
25;Lleida;064;Castellar de la Ribera;168;83;85
25;Lleida;067;Castelldans;1006;510;496
25;Lleida;068;Castellnou de Seana;774;383;391
25;Lleida;069;Castelló de Farfanya;634;321;313
25;Lleida;070;Castellserà;1238;605;633
25;Lleida;071;Cava;51;32;19
25;Lleida;072;Cervera;6562;3203;3359
25;Lleida;073;Cervià de les Garrigues;930;465;465
25;Lleida;074;Ciutadilla;257;132;125
25;Lleida;075;Clariana de Cardener;158;78;80
25;Lleida;076;Cogul (El);246;119;127
25;Lleida;077;Coll de Nargó;677;347;330
25;Lleida;163;Coma i la Pedra (La);258;146;112
25;Lleida;161;Conca de Dalt;482;257;225
25;Lleida;078;Corbins;1034;536;498
25;Lleida;079;Cubells;414;219;195
25;Lleida;081;Espluga Calba (L');445;235;210
25;Lleida;082;Espot;221;117;104
25;Lleida;088;Estamariu;139;73;66
25;Lleida;085;Estaràs;197;99;98
25;Lleida;086;Esterri d'Àneu;575;287;288
25;Lleida;087;Esterri de Cardós;63;29;34
25;Lleida;089;Farrera;96;53;43
25;Lleida;908;Fígols i Alinyà;378;213;165
25;Lleida;092;Floresta (La);189;94;95
25;Lleida;093;Fondarella;561;276;285
25;Lleida;094;Foradada;160;88;72
25;Lleida;096;Fuliola (La);1344;693;651
25;Lleida;097;Fulleda;120;57;63
25;Lleida;098;Gavet de la Conca;386;191;195
25;Lleida;912;Gimenells i el Pla de la Font;"";"";""
25;Lleida;099;Golmés;1243;614;629
25;Lleida;100;Gósol;188;100;88
25;Lleida;101;Granadella (La);940;478;462
25;Lleida;102;Granja d'Escarp (La);1169;586;583
25;Lleida;103;Granyanella;119;60;59
25;Lleida;105;Granyena de les Garrigues;200;98;102
25;Lleida;104;Granyena de Segarra;206;110;96
25;Lleida;109;Guimerà;476;230;246
25;Lleida;903;Guingueta d'Àneu (La);264;134;130
25;Lleida;110;Guissona;2699;1355;1344
25;Lleida;111;Guixers;160;93;67
25;Lleida;115;Isona i Conca Dellà;1509;764;745
25;Lleida;112;Ivars de Noguera;362;178;184
25;Lleida;113;Ivars d'Urgell;1776;876;900
25;Lleida;114;Ivorra;190;94;96
25;Lleida;910;Josa i Tuixén;135;69;66
25;Lleida;118;Juncosa;601;308;293
25;Lleida;119;Juneda;3032;1530;1502
25;Lleida;121;Les;625;317;308
25;Lleida;122;Linyola;2390;1223;1167
25;Lleida;123;Lladorre;218;119;99
25;Lleida;124;Lladurs;261;139;122
25;Lleida;125;Llardecans;715;363;352
25;Lleida;126;Llavorsí;275;143;132
25;Lleida;120;Lleida;108207;52992;55215
25;Lleida;127;Lles de Cerdanya;311;170;141
25;Lleida;128;Llimiana;132;74;58
25;Lleida;129;Llobera;244;128;116
25;Lleida;133;Maials;1185;589;596
25;Lleida;130;Maldà;341;174;167
25;Lleida;131;Massalcoreig;706;345;361
25;Lleida;132;Massoteres;158;85;73
25;Lleida;134;Menàrguens;917;457;460
25;Lleida;135;Miralcamp;1204;585;619
25;Lleida;137;Mollerussa;8537;4228;4309
25;Lleida;136;Molsosa (La);134;66;68
25;Lleida;139;Montellà i Martinet;560;297;263
25;Lleida;140;Montferrer i Castellbò;629;338;291
25;Lleida;138;Montgai;895;451;444
25;Lleida;142;Montoliu de Lleida;449;218;231
25;Lleida;141;Montoliu de Segarra;214;112;102
25;Lleida;143;Montornès de Segarra;132;57;75
25;Lleida;145;Nalec;105;47;58
25;Lleida;025;Naut Aran;1187;642;545
25;Lleida;146;Navès;300;154;146
25;Lleida;148;Odèn;330;181;149
25;Lleida;149;Oliana;2066;1060;1006
25;Lleida;150;Oliola;252;140;112
25;Lleida;151;Olius;476;245;231
25;Lleida;152;Oluges (Les);237;119;118
25;Lleida;153;Omellons (Els);281;143;138
25;Lleida;154;Omells de na Gaia (Els);161;86;75
25;Lleida;155;Organyà;1071;549;522
25;Lleida;156;Os de Balaguer;862;499;363
25;Lleida;157;Ossó de Sió;270;129;141
25;Lleida;158;Palau d'Anglesola (El);1648;846;802
25;Lleida;164;Penelles;620;309;311
25;Lleida;165;Peramola;409;218;191
25;Lleida;166;Pinell de Solsonès;272;142;130
25;Lleida;167;Pinós;395;214;181
25;Lleida;911;Plans de Sió (Els);740;372;368
25;Lleida;168;Poal (El);692;355;337
25;Lleida;169;Pobla de Cérvoles (La);193;99;94
25;Lleida;171;Pobla de Segur (La);3282;1596;1686
25;Lleida;030;Pont de Bar (El);170;94;76
25;Lleida;173;Pont de Suert (El);2436;1223;1213
25;Lleida;172;Ponts;2277;1143;1134
25;Lleida;174;Portella (La);630;336;294
25;Lleida;175;Prats i Sansor;112;61;51
25;Lleida;176;Preixana;469;235;234
25;Lleida;177;Preixens;609;263;346
25;Lleida;179;Prullans;195;96;99
25;Lleida;180;Puiggròs;287;139;148
25;Lleida;181;Puigverd d'Agramunt;258;134;124
25;Lleida;182;Puigverd de Lleida;951;443;508
25;Lleida;183;Rialp;437;238;199
25;Lleida;905;Ribera d'Ondara;508;263;245
25;Lleida;185;Ribera d'Urgellet;812;440;372
25;Lleida;186;Riner;283;154;129
25;Lleida;913;Riu de Cerdanya;"";"";""
25;Lleida;189;Rosselló;1569;778;791
25;Lleida;190;Salàs de Pallars;393;191;202
25;Lleida;191;Sanaüja;474;234;240
25;Lleida;196;Sant Esteve de la Sarga;141;84;57
25;Lleida;192;Sant Guim de Freixenet;1081;545;536
25;Lleida;197;Sant Guim de la Plana;210;108;102
25;Lleida;193;Sant Llorenç de Morunys;892;469;423
25;Lleida;902;Sant Martí de Riucorb;816;418;398
25;Lleida;194;Sant Ramon;612;299;313
25;Lleida;201;Sarroca de Bellera;126;72;54
25;Lleida;200;Sarroca de Lleida;524;266;258
25;Lleida;202;Senterada;129;78;51
25;Lleida;035;Sentiu de Sió (La);504;250;254
25;Lleida;204;Seròs;1950;1035;915
25;Lleida;203;Seu d'Urgell (La);10041;5017;5024
25;Lleida;205;Sidamon;455;226;229
25;Lleida;206;Soleràs (El);508;258;250
25;Lleida;207;Solsona;6582;3303;3279
25;Lleida;208;Soriguera;293;156;137
25;Lleida;209;Sort;1554;792;762
25;Lleida;210;Soses;1534;782;752
25;Lleida;211;Sudanell;812;424;388
25;Lleida;212;Sunyer;323;161;162
25;Lleida;215;Talarn;380;201;179
25;Lleida;216;Talavera;305;147;158
25;Lleida;217;Tàrrega;11148;5430;5718
25;Lleida;218;Tarrés;93;47;46
25;Lleida;219;Tarroja de Segarra;206;107;99
25;Lleida;220;Térmens;1420;704;716
25;Lleida;221;Tírvia;109;55;54
25;Lleida;222;Tiurana;207;111;96
25;Lleida;223;Torà;1226;632;594
25;Lleida;224;Torms (Els);220;120;100
25;Lleida;225;Tornabous;947;472;475
25;Lleida;227;Torre de Cabdella (La);740;368;372
25;Lleida;226;Torrebesses;366;187;179
25;Lleida;228;Torrefarrera;1475;764;711
25;Lleida;907;Torrefeta i Florejacs;739;358;381
25;Lleida;230;Torregrossa;2251;1115;1136
25;Lleida;231;Torrelameu;599;321;278
25;Lleida;232;Torres de Segre;1897;971;926
25;Lleida;233;Torre-serona;309;156;153
25;Lleida;234;Tremp;5581;2773;2808
25;Lleida;043;Vall de Boí (La);549;306;243
25;Lleida;901;Vall de Cardós;326;173;153
25;Lleida;238;Vallbona de les Monges;292;131;161
25;Lleida;240;Vallfogona de Balaguer;1376;700;676
25;Lleida;906;Valls d'Aguilar (Les);235;126;109
25;Lleida;239;Valls de Valira (Les);741;393;348
25;Lleida;909;Vansa i Fórnols (La);160;86;74
25;Lleida;242;Verdú;941;466;475
25;Lleida;243;Vielha e Mijaran;3048;1541;1507
25;Lleida;244;Vilagrassa;410;207;203
25;Lleida;245;Vilaller;632;337;295
25;Lleida;247;Vilamòs;87;48;39
25;Lleida;248;Vilanova de Bellpuig;1261;617;644
25;Lleida;254;Vilanova de la Barca;866;434;432
25;Lleida;249;Vilanova de l'Aguda;286;151;135
25;Lleida;250;Vilanova de Meià;521;267;254
25;Lleida;251;Vilanova de Segrià;685;337;348
25;Lleida;252;Vila-sana;545;271;274
25;Lleida;253;Vilosell (El);214;101;113
25;Lleida;255;Vinaixa;723;358;365
26;Rioja (La);001;Ábalos;314;176;138
26;Rioja (La);002;Agoncillo;872;460;412
26;Rioja (La);003;Aguilar del Río Alhama;935;475;460
26;Rioja (La);004;Ajamil;71;42;29
26;Rioja (La);005;Albelda de Iregua;2315;1193;1122
26;Rioja (La);006;Alberite;1937;975;962
26;Rioja (La);007;Alcanadre;995;504;491
26;Rioja (La);008;Aldeanueva de Ebro;2683;1381;1302
26;Rioja (La);009;Alesanco;579;299;280
26;Rioja (La);010;Alesón;174;90;84
26;Rioja (La);011;Alfaro;9142;4552;4590
26;Rioja (La);012;Almarza de Cameros;32;19;13
26;Rioja (La);013;Anguciana;375;190;185
26;Rioja (La);014;Anguiano;777;427;350
26;Rioja (La);015;Arenzana de Abajo;425;227;198
26;Rioja (La);016;Arenzana de Arriba;48;25;23
26;Rioja (La);017;Arnedillo;419;209;210
26;Rioja (La);018;Arnedo;12325;6126;6199
26;Rioja (La);019;Arrúbal;410;219;191
26;Rioja (La);020;Ausejo;745;382;363
26;Rioja (La);021;Autol;3475;1751;1724
26;Rioja (La);022;Azofra;448;239;209
26;Rioja (La);023;Badarán;899;482;417
26;Rioja (La);024;Bañares;555;281;274
26;Rioja (La);026;Baños de Río Tobía;1839;916;923
26;Rioja (La);025;Baños de Rioja;147;85;62
26;Rioja (La);027;Berceo;260;142;118
26;Rioja (La);028;Bergasa;228;123;105
26;Rioja (La);029;Bergasillas Bajera;29;16;13
26;Rioja (La);030;Bezares;25;14;11
26;Rioja (La);031;Bobadilla;209;98;111
26;Rioja (La);032;Brieva de Cameros;76;39;37
26;Rioja (La);033;Briñas;206;103;103
26;Rioja (La);034;Briones;980;529;451
26;Rioja (La);035;Cabezón de Cameros;42;23;19
26;Rioja (La);036;Calahorra;18405;8874;9531
26;Rioja (La);037;Camprovín;287;146;141
26;Rioja (La);038;Canales de la Sierra;92;50;42
26;Rioja (La);039;Canillas de Río Tuerto;93;48;45
26;Rioja (La);040;Cañas;126;61;65
26;Rioja (La);041;Cárdenas;296;140;156
26;Rioja (La);042;Casalarreina;910;466;444
26;Rioja (La);043;Castañares de Rioja;581;302;279
26;Rioja (La);044;Castroviejo;54;28;26
26;Rioja (La);045;Cellorigo;24;13;11
26;Rioja (La);046;Cenicero;2237;1133;1104
26;Rioja (La);047;Cervera del Río Alhama;3838;1896;1942
26;Rioja (La);048;Cidamón;102;59;43
26;Rioja (La);049;Cihuri;209;107;102
26;Rioja (La);050;Cirueña;146;85;61
26;Rioja (La);051;Clavijo;181;94;87
26;Rioja (La);052;Cordovín;281;134;147
26;Rioja (La);053;Corera;285;144;141
26;Rioja (La);054;Cornago;824;438;386
26;Rioja (La);055;Corporales;82;42;40
26;Rioja (La);056;Cuzcurrita de Río Tirón;587;311;276
26;Rioja (La);057;Daroca de Rioja;58;35;23
26;Rioja (La);058;Enciso;172;93;79
26;Rioja (La);059;Entrena;1118;598;520
26;Rioja (La);060;Estollo;153;78;75
26;Rioja (La);061;Ezcaray;1764;923;841
26;Rioja (La);062;Foncea;161;90;71
26;Rioja (La);063;Fonzaleche;230;118;112
26;Rioja (La);064;Fuenmayor;2119;1052;1067
26;Rioja (La);065;Galbárruli;59;34;25
26;Rioja (La);066;Galilea;271;152;119
26;Rioja (La);067;Gallinero de Cameros;22;13;9
26;Rioja (La);068;Gimileo;97;50;47
26;Rioja (La);069;Grañón;577;306;271
26;Rioja (La);070;Grávalos;362;185;177
26;Rioja (La);071;Haro;9138;4453;4685
26;Rioja (La);072;Herce;394;196;198
26;Rioja (La);073;Herramélluri;200;104;96
26;Rioja (La);074;Hervías;259;136;123
26;Rioja (La);075;Hormilla;539;278;261
26;Rioja (La);076;Hormilleja;217;111;106
26;Rioja (La);077;Hornillos de Cameros;31;16;15
26;Rioja (La);078;Hornos de Moncalvillo;96;49;47
26;Rioja (La);079;Huércanos;981;503;478
26;Rioja (La);080;Igea;1050;564;486
26;Rioja (La);081;Jalón de Cameros;41;24;17
26;Rioja (La);082;Laguna de Cameros;205;111;94
26;Rioja (La);083;Lagunilla del Jubera;413;204;209
26;Rioja (La);084;Lardero;2773;1384;1389
26;Rioja (La);086;Ledesma de la Cogolla;27;17;10
26;Rioja (La);087;Leiva;388;189;199
26;Rioja (La);088;Leza de Río Leza;26;19;7
26;Rioja (La);089;Logroño;116273;56287;59986
26;Rioja (La);091;Lumbreras;177;105;72
26;Rioja (La);092;Manjarrés;151;81;70
26;Rioja (La);093;Mansilla de la Sierra;56;36;20
26;Rioja (La);094;Manzanares de Rioja;173;92;81
26;Rioja (La);095;Matute;225;111;114
26;Rioja (La);096;Medrano;293;151;142
26;Rioja (La);098;Munilla;105;51;54
26;Rioja (La);099;Murillo de Río Leza;1716;849;867
26;Rioja (La);100;Muro de Aguas;54;32;22
26;Rioja (La);101;Muro en Cameros;45;30;15
26;Rioja (La);102;Nájera;6648;3331;3317
26;Rioja (La);103;Nalda;969;511;458
26;Rioja (La);104;Navajún;22;14;8
26;Rioja (La);105;Navarrete;2067;1086;981
26;Rioja (La);106;Nestares;53;26;27
26;Rioja (La);107;Nieva de Cameros;139;74;65
26;Rioja (La);109;Ochánduri;124;61;63
26;Rioja (La);108;Ocón;362;198;164
26;Rioja (La);110;Ojacastro;283;166;117
26;Rioja (La);111;Ollauri;324;170;154
26;Rioja (La);112;Ortigosa de Cameros;364;180;184
26;Rioja (La);113;Pazuengos;41;24;17
26;Rioja (La);114;Pedroso;117;61;56
26;Rioja (La);115;Pinillos;28;16;12
26;Rioja (La);117;Pradejón;2823;1427;1396
26;Rioja (La);118;Pradillo;110;55;55
26;Rioja (La);119;Préjano;261;130;131
26;Rioja (La);120;Quel;2062;1070;992
26;Rioja (La);121;Rabanera;46;23;23
26;Rioja (La);122;Rasillo de Cameros (El);124;60;64
26;Rioja (La);123;Redal (El);258;128;130
26;Rioja (La);124;Ribafrecha;1130;598;532
26;Rioja (La);125;Rincón de Soto;3428;1731;1697
26;Rioja (La);126;Robres del Castillo;31;18;13
26;Rioja (La);127;Rodezno;408;204;204
26;Rioja (La);128;Sajazarra;203;103;100
26;Rioja (La);129;San Asensio;1516;784;732
26;Rioja (La);130;San Millán de la Cogolla;318;185;133
26;Rioja (La);131;San Millán de Yécora;96;55;41
26;Rioja (La);132;San Román de Cameros;182;97;85
26;Rioja (La);139;San Torcuato;163;87;76
26;Rioja (La);142;San Vicente de la Sonsierra;1206;618;588
26;Rioja (La);134;Santa Coloma;193;110;83
26;Rioja (La);135;Santa Engracia del Jubera;228;131;97
26;Rioja (La);136;Santa Eulalia Bajera;127;68;59
26;Rioja (La);138;Santo Domingo de la Calzada;5801;2909;2892
26;Rioja (La);140;Santurde de Rioja;350;174;176
26;Rioja (La);141;Santurdejo;251;137;114
26;Rioja (La);143;Sojuela;106;59;47
26;Rioja (La);144;Sorzano;276;148;128
26;Rioja (La);145;Sotés;303;157;146
26;Rioja (La);146;Soto en Cameros;110;62;48
26;Rioja (La);147;Terroba;35;17;18
26;Rioja (La);148;Tirgo;304;156;148
26;Rioja (La);149;Tobía;73;41;32
26;Rioja (La);150;Tormantos;250;137;113
26;Rioja (La);153;Torre en Cameros;15;11;4
26;Rioja (La);151;Torrecilla en Cameros;576;293;283
26;Rioja (La);152;Torrecilla sobre Alesanco;116;57;59
26;Rioja (La);154;Torremontalbo;14;8;6
26;Rioja (La);155;Treviana;359;193;166
26;Rioja (La);157;Tricio;426;210;216
26;Rioja (La);158;Tudelilla;557;284;273
26;Rioja (La);160;Uruñuela;739;385;354
26;Rioja (La);161;Valdemadera;22;13;9
26;Rioja (La);162;Valgañón;195;104;91
26;Rioja (La);163;Ventosa;165;87;78
26;Rioja (La);164;Ventrosa;101;44;57
26;Rioja (La);165;Viguera;421;226;195
26;Rioja (La);166;Villalba de Rioja;194;106;88
26;Rioja (La);167;Villalobar de Rioja;150;87;63
26;Rioja (La);168;Villamediana de Iregua;1945;994;951
26;Rioja (La);169;Villanueva de Cameros;125;63;62
26;Rioja (La);170;Villar de Arnedo (El);808;396;412
26;Rioja (La);171;Villar de Torre;386;202;184
26;Rioja (La);172;Villarejo;49;27;22
26;Rioja (La);173;Villarroya;14;7;7
26;Rioja (La);174;Villarta-Quintana;258;132;126
26;Rioja (La);175;Villavelayo;82;48;34
26;Rioja (La);176;Villaverde de Rioja;105;61;44
26;Rioja (La);177;Villoslada de Cameros;404;219;185
26;Rioja (La);178;Viniegra de Abajo;148;74;74
26;Rioja (La);179;Viniegra de Arriba;49;28;21
26;Rioja (La);180;Zarratón;320;162;158
26;Rioja (La);181;Zarzosa;24;15;9
26;Rioja (La);183;Zorraquín;44;27;17
27;Lugo;001;Abadín;4800;2338;2462
27;Lugo;002;Alfoz;2837;1388;1449
27;Lugo;003;Antas de Ulla;4193;2079;2114
27;Lugo;004;Baleira;2506;1308;1198
27;Lugo;901;Baralla;4339;2243;2096
27;Lugo;005;Barreiros;4079;1993;2086
27;Lugo;006;Becerreá;4753;2440;2313
27;Lugo;007;Begonte;4762;2372;2390
27;Lugo;008;Bóveda;2545;1265;1280
27;Lugo;902;Burela;"";"";""
27;Lugo;009;Carballedo;5119;2556;2563
27;Lugo;010;Castro de Rei;6217;3148;3069
27;Lugo;011;Castroverde;4314;2193;2121
27;Lugo;012;Cervantes;3226;1757;1469
27;Lugo;013;Cervo;11285;5615;5670
27;Lugo;016;Chantada;11271;5492;5779
27;Lugo;014;Corgo (O);5226;2639;2587
27;Lugo;015;Cospeito;7033;3482;3551
27;Lugo;017;Folgoso do Courel;2653;1381;1272
27;Lugo;018;Fonsagrada (A);8335;4384;3951
27;Lugo;019;Foz;9744;4683;5061
27;Lugo;020;Friol;5578;2815;2763
27;Lugo;022;Guitiriz;7467;3706;3761
27;Lugo;023;Guntín;4468;2186;2282
27;Lugo;024;Incio (O);3645;1880;1765
27;Lugo;026;Láncara;4165;2145;2020
27;Lugo;027;Lourenzá;3285;1603;1682
27;Lugo;028;Lugo;77043;36640;40403
27;Lugo;029;Meira;2026;991;1035
27;Lugo;030;Mondoñedo;6472;3047;3425
27;Lugo;031;Monforte de Lemos;20496;9882;10614
27;Lugo;032;Monterroso;5056;2677;2379
27;Lugo;033;Muras;2004;1002;1002
27;Lugo;034;Navia de Suarna;3373;1774;1599
27;Lugo;035;Negueira de Muñiz;385;208;177
27;Lugo;037;Nogais (As);2174;1160;1014
27;Lugo;038;Ourol;2303;1066;1237
27;Lugo;039;Outeiro de Rei;4511;2228;2283
27;Lugo;040;Palas de Rei;6190;3069;3121
27;Lugo;041;Pantón;5773;2786;2987
27;Lugo;042;Paradela;3366;1669;1697
27;Lugo;043;Páramo (O);2233;1149;1084
27;Lugo;044;Pastoriza (A);4919;2478;2441
27;Lugo;045;Pedrafita do Cebreiro;2422;1299;1123
27;Lugo;047;Pobra do Brollón (A);3520;1727;1793
27;Lugo;046;Pol;2699;1346;1353
27;Lugo;048;Pontenova (A);4121;2019;2102
27;Lugo;049;Portomarín;2492;1273;1219
27;Lugo;050;Quiroga;5738;2856;2882
27;Lugo;056;Rábade;1967;1001;966
27;Lugo;051;Ribadeo;9009;4247;4762
27;Lugo;052;Ribas de Sil;2021;1010;1011
27;Lugo;053;Ribeira de Piquín;1245;624;621
27;Lugo;054;Riotorto;2507;1244;1263
27;Lugo;055;Samos;3104;1661;1443
27;Lugo;057;Sarria;12858;6385;6473
27;Lugo;058;Saviñao (O);7206;3569;3637
27;Lugo;059;Sober;4992;2456;2536
27;Lugo;060;Taboada;6064;3013;3051
27;Lugo;061;Trabada;2217;1082;1135
27;Lugo;062;Triacastela;1172;619;553
27;Lugo;063;Valadouro (O);3100;1529;1571
27;Lugo;064;Vicedo (O);2976;1449;1527
27;Lugo;065;Vilalba;16347;7968;8379
27;Lugo;066;Viveiro;14956;7163;7793
27;Lugo;021;Xermade;3429;1674;1755
27;Lugo;025;Xove;3792;1908;1884
28;Madrid;001;Acebeda (La);61;34;27
28;Madrid;002;Ajalvir;1081;583;498
28;Madrid;003;Alameda del Valle;145;79;66
28;Madrid;004;Álamo (El);2035;1056;979
28;Madrid;005;Alcalá de Henares;145320;72924;72396
28;Madrid;006;Alcobendas;71542;35540;36002
28;Madrid;007;Alcorcón;138448;68839;69609
28;Madrid;008;Aldea del Fresno;1000;508;492
28;Madrid;009;Algete;7729;3990;3739
28;Madrid;010;Alpedrete;2794;1407;1387
28;Madrid;011;Ambite;318;158;160
28;Madrid;012;Anchuelo;504;272;232
28;Madrid;013;Aranjuez;37079;18046;19033
28;Madrid;014;Arganda del Rey;24365;12122;12243
28;Madrid;015;Arroyomolinos;298;153;145
28;Madrid;016;Atazar (El);91;49;42
28;Madrid;017;Batres;263;132;131
28;Madrid;018;Becerril de la Sierra;1647;821;826
28;Madrid;019;Belmonte de Tajo;1107;559;548
28;Madrid;021;Berrueco (El);237;129;108
28;Madrid;020;Berzosa del Lozoya;65;37;28
28;Madrid;022;Boadilla del Monte;8694;4383;4311
28;Madrid;023;Boalo (El);1501;763;738
28;Madrid;024;Braojos;130;73;57
28;Madrid;025;Brea de Tajo;506;266;240
28;Madrid;026;Brunete;1633;818;815
28;Madrid;027;Buitrago del Lozoya;1221;650;571
28;Madrid;028;Bustarviejo;1134;573;561
28;Madrid;029;Cabanillas de la Sierra;340;170;170
28;Madrid;030;Cabrera (La);808;410;398
28;Madrid;031;Cadalso de los Vidrios;2049;1061;988
28;Madrid;032;Camarma de Esteruelas;1315;669;646
28;Madrid;033;Campo Real;2039;1040;999
28;Madrid;034;Canencia;464;243;221
28;Madrid;035;Carabaña;1034;526;508
28;Madrid;036;Casarrubuelos;524;290;234
28;Madrid;037;Cenicientos;2147;1077;1070
28;Madrid;038;Cercedilla;3872;1904;1968
28;Madrid;039;Cervera de Buitrago;95;48;47
28;Madrid;051;Chapinería;761;399;362
28;Madrid;052;Chinchón;4053;2039;2014
28;Madrid;040;Ciempozuelos;10171;5161;5010
28;Madrid;041;Cobeña;870;445;425
28;Madrid;046;Collado Mediano;1702;835;867
28;Madrid;047;Collado Villalba;20937;10391;10546
28;Madrid;043;Colmenar de Oreja;5206;2530;2676
28;Madrid;042;Colmenar del Arroyo;410;206;204
28;Madrid;045;Colmenar Viejo;30328;14993;15335
28;Madrid;044;Colmenarejo;1692;874;818
28;Madrid;048;Corpa;358;186;172
28;Madrid;049;Coslada;65598;32972;32626
28;Madrid;050;Cubas de la Sagra;841;398;443
28;Madrid;053;Daganzo de Arriba;1202;610;592
28;Madrid;054;Escorial (El);6236;3081;3155
28;Madrid;055;Estremera;1108;573;535
28;Madrid;056;Fresnedillas de la Oliva;413;207;206
28;Madrid;057;Fresno de Torote;162;80;82
28;Madrid;058;Fuenlabrada;122752;62075;60677
28;Madrid;059;Fuente el Saz de Jarama;1886;966;920
28;Madrid;060;Fuentidueña de Tajo;1243;623;620
28;Madrid;061;Galapagar;7281;3711;3570
28;Madrid;062;Garganta de los Montes;303;153;150
28;Madrid;063;Gargantilla del Lozoya y Pinilla de Buitrago;228;128;100
28;Madrid;064;Gascones;94;49;45
28;Madrid;065;Getafe;132786;66162;66624
28;Madrid;066;Griñón;1565;817;748
28;Madrid;067;Guadalix de la Sierra;1519;774;745
28;Madrid;068;Guadarrama;6054;2995;3059
28;Madrid;069;Hiruela (La);40;25;15
28;Madrid;070;Horcajo de la Sierra;132;67;65
28;Madrid;071;Horcajuelo de la Sierra;71;36;35
28;Madrid;072;Hoyo de Manzanares;2597;1323;1274
28;Madrid;073;Humanes de Madrid;5991;3015;2976
28;Madrid;074;Leganés;167748;84351;83397
28;Madrid;075;Loeches;2080;1055;1025
28;Madrid;076;Lozoya;442;230;212
28;Madrid;901;Lozoyuela-Navas-Sieteiglesias;622;339;283
28;Madrid;078;Madarcos;34;16;18
28;Madrid;079;Madrid;3100507;1459870;1640637
28;Madrid;080;Majadahonda;29756;14663;15093
28;Madrid;082;Manzanares el Real;1784;922;862
28;Madrid;083;Meco;1549;797;752
28;Madrid;084;Mejorada del Campo;11759;5923;5836
28;Madrid;085;Miraflores de la Sierra;2494;1237;1257
28;Madrid;086;Molar (El);2667;1390;1277
28;Madrid;087;Molinos (Los);2341;1086;1255
28;Madrid;088;Montejo de la Sierra;229;126;103
28;Madrid;089;Moraleja de Enmedio;1301;638;663
28;Madrid;090;Moralzarzal;1675;835;840
28;Madrid;091;Morata de Tajuña;4697;2321;2376
28;Madrid;092;Móstoles;176993;88306;88687
28;Madrid;093;Navacerrada;1547;860;687
28;Madrid;094;Navalafuente;277;150;127
28;Madrid;095;Navalagamella;528;259;269
28;Madrid;096;Navalcarnero;9063;4572;4491
28;Madrid;097;Navarredonda y San Mamés;126;68;58
28;Madrid;099;Navas del Rey;971;492;479
28;Madrid;100;Nuevo Baztán;535;300;235
28;Madrid;101;Olmeda de las Fuentes;134;72;62
28;Madrid;102;Orusco de Tajuña;589;293;296
28;Madrid;104;Paracuellos de Jarama;3810;1942;1868
28;Madrid;106;Parla;64546;32546;32000
28;Madrid;107;Patones;351;176;175
28;Madrid;108;Pedrezuela;735;378;357
28;Madrid;109;Pelayos de la Presa;756;387;369
28;Madrid;110;Perales de Tajuña;1876;904;972
28;Madrid;111;Pezuela de las Torres;508;269;239
28;Madrid;112;Pinilla del Valle;141;75;66
28;Madrid;113;Pinto;20474;10239;10235
28;Madrid;114;Piñuécar-Gandullas;164;78;86
28;Madrid;115;Pozuelo de Alarcón;36551;17922;18629
28;Madrid;116;Pozuelo del Rey;222;114;108
28;Madrid;117;Prádena del Rincón;103;57;46
28;Madrid;118;Puebla de la Sierra;79;42;37
28;Madrid;902;Puentes Viejas;415;216;199
28;Madrid;119;Quijorna;555;296;259
28;Madrid;120;Rascafría;1260;653;607
28;Madrid;121;Redueña;122;60;62
28;Madrid;122;Ribatejada;237;123;114
28;Madrid;123;Rivas-Vaciamadrid;6302;3171;3131
28;Madrid;124;Robledillo de la Jara;67;31;36
28;Madrid;125;Robledo de Chavela;1681;850;831
28;Madrid;126;Robregordo;102;53;49
28;Madrid;127;Rozas de Madrid (Las);22255;10989;11266
28;Madrid;128;Rozas de Puerto Real;399;201;198
28;Madrid;129;San Agustín del Guadalix;2551;1308;1243
28;Madrid;130;San Fernando de Henares;23337;11747;11590
28;Madrid;131;San Lorenzo de El Escorial;9029;4389;4640
28;Madrid;132;San Martín de la Vega;5692;2921;2771
28;Madrid;133;San Martín de Valdeiglesias;5102;2576;2526
28;Madrid;134;San Sebastián de los Reyes;50531;25389;25142
28;Madrid;135;Santa María de la Alameda;758;408;350
28;Madrid;136;Santorcaz;520;268;252
28;Madrid;137;Santos de la Humosa (Los);883;449;434
28;Madrid;138;Serna del Monte (La);84;44;40
28;Madrid;140;Serranillos del Valle;445;236;209
28;Madrid;141;Sevilla la Nueva;686;359;327
28;Madrid;143;Somosierra;107;64;43
28;Madrid;144;Soto del Real;1739;876;863
28;Madrid;145;Talamanca de Jarama;964;492;472
28;Madrid;146;Tielmes;1849;971;878
28;Madrid;147;Titulcia;855;423;432
28;Madrid;148;Torrejón de Ardoz;81658;41136;40522
28;Madrid;149;Torrejón de la Calzada;1033;537;496
28;Madrid;150;Torrejón de Velasco;1286;661;625
28;Madrid;151;Torrelaguna;2558;1251;1307
28;Madrid;152;Torrelodones;5249;2583;2666
28;Madrid;153;Torremocha de Jarama;194;97;97
28;Madrid;154;Torres de la Alameda;2642;1328;1314
28;Madrid;903;Tres Cantos;"";"";""
28;Madrid;155;Valdaracete;743;355;388
28;Madrid;156;Valdeavero;491;254;237
28;Madrid;157;Valdelaguna;580;303;277
28;Madrid;158;Valdemanco;434;230;204
28;Madrid;159;Valdemaqueda;446;223;223
28;Madrid;160;Valdemorillo;2385;1216;1169
28;Madrid;161;Valdemoro;17066;9004;8062
28;Madrid;162;Valdeolmos-Alalpardo;668;375;293
28;Madrid;163;Valdepiélagos;318;161;157
28;Madrid;164;Valdetorres de Jarama;1079;548;531
28;Madrid;165;Valdilecha;1530;772;758
28;Madrid;166;Valverde de Alcalá;212;115;97
28;Madrid;167;Velilla de San Antonio;1872;947;925
28;Madrid;168;Vellón (El);889;456;433
28;Madrid;169;Venturada;268;136;132
28;Madrid;171;Villa del Prado;3184;1593;1591
28;Madrid;170;Villaconejos;2899;1482;1417
28;Madrid;172;Villalbilla;1526;792;734
28;Madrid;173;Villamanrique de Tajo;556;281;275
28;Madrid;174;Villamanta;1075;551;524
28;Madrid;175;Villamantilla;290;149;141
28;Madrid;176;Villanueva de la Cañada;2907;1487;1420
28;Madrid;178;Villanueva de Perales;358;194;164
28;Madrid;177;Villanueva del Pardillo;1514;772;742
28;Madrid;179;Villar del Olmo;426;220;206
28;Madrid;180;Villarejo de Salvanés;4556;2282;2274
28;Madrid;181;Villaviciosa de Odón;8732;4187;4545
28;Madrid;182;Villavieja del Lozoya;156;71;85
28;Madrid;183;Zarzalejo;804;420;384
29;Málaga;001;Alameda;4747;2376;2371
29;Málaga;002;Alcaucín;1483;750;733
29;Málaga;003;Alfarnate;1588;817;771
29;Málaga;004;Alfarnatejo;438;238;200
29;Málaga;005;Algarrobo;4707;2390;2317
29;Málaga;006;Algatocín;1100;575;525
29;Málaga;007;Alhaurín de la Torre;10508;5331;5177
29;Málaga;008;Alhaurín el Grande;16254;8098;8156
29;Málaga;009;Almáchar;2054;1067;987
29;Málaga;010;Almargen;2423;1204;1219
29;Málaga;011;Almogía;4168;2099;2069
29;Málaga;012;Álora;13810;6900;6910
29;Málaga;013;Alozaina;2976;1549;1427
29;Málaga;014;Alpandeire;385;204;181
29;Málaga;015;Antequera;40844;20054;20790
29;Málaga;016;Árchez;389;212;177
29;Málaga;017;Archidona;10175;5139;5036
29;Málaga;018;Ardales;3133;1598;1535
29;Málaga;019;Arenas;1329;719;610
29;Málaga;020;Arriate;3280;1661;1619
29;Málaga;021;Atajate;150;85;65
29;Málaga;022;Benadalid;274;149;125
29;Málaga;023;Benahavís;2054;1028;1026
29;Málaga;024;Benalauría;603;312;291
29;Málaga;025;Benalmádena;20454;10327;10127
29;Málaga;026;Benamargosa;1694;864;830
29;Málaga;027;Benamocarra;2727;1370;1357
29;Málaga;028;Benaoján;1813;900;913
29;Málaga;029;Benarrabá;782;398;384
29;Málaga;030;Borge (El);1111;570;541
29;Málaga;031;Burgo (El);2176;1143;1033
29;Málaga;032;Campillos;7457;3791;3666
29;Málaga;033;Canillas de Aceituno;2733;1396;1337
29;Málaga;034;Canillas de Albaida;647;341;306
29;Málaga;035;Cañete la Real;2382;1251;1131
29;Málaga;036;Carratraca;1010;505;505
29;Málaga;037;Cartajima;425;218;207
29;Málaga;038;Cártama;11573;5819;5754
29;Málaga;039;Casabermeja;3029;1589;1440
29;Málaga;040;Casarabonela;2860;1486;1374
29;Málaga;041;Casares;3124;1592;1532
29;Málaga;042;Coín;20258;10337;9921
29;Málaga;043;Colmenar;3322;1646;1676
29;Málaga;044;Comares;1727;885;842
29;Málaga;045;Cómpeta;2274;1128;1146
29;Málaga;046;Cortes de la Frontera;4110;2064;2046
29;Málaga;047;Cuevas Bajas;1657;796;861
29;Málaga;049;Cuevas de San Marcos;4215;2098;2117
29;Málaga;048;Cuevas del Becerro;2094;1074;1020
29;Málaga;050;Cútar;646;318;328
29;Málaga;051;Estepona;28261;14155;14106
29;Málaga;052;Faraján;364;189;175
29;Málaga;053;Frigiliana;2105;1041;1064
29;Málaga;054;Fuengirola;35229;17431;17798
29;Málaga;055;Fuente de Piedra;2162;1090;1072
29;Málaga;056;Gaucín;2037;1063;974
29;Málaga;057;Genalguacil;781;407;374
29;Málaga;058;Guaro;2117;1071;1046
29;Málaga;059;Humilladero;2332;1189;1143
29;Málaga;060;Igualeja;1115;570;545
29;Málaga;061;Istán;1616;813;803
29;Málaga;062;Iznate;746;377;369
29;Málaga;063;Jimera de Líbar;552;284;268
29;Málaga;064;Jubrique;1069;545;524
29;Málaga;065;Júzcar;299;170;129
29;Málaga;066;Macharaviaya;350;174;176
29;Málaga;067;Málaga;566330;274090;292240
29;Málaga;068;Manilva;4430;2289;2141
29;Málaga;069;Marbella;75351;37506;37845
29;Málaga;070;Mijas;25048;12575;12473
29;Málaga;071;Moclinejo;1156;592;564
29;Málaga;072;Mollina;3210;1581;1629
29;Málaga;073;Monda;1753;891;862
29;Málaga;074;Montejaque;1394;694;700
29;Málaga;075;Nerja;12261;6112;6149
29;Málaga;076;Ojén;2136;1122;1014
29;Málaga;077;Parauta;398;199;199
29;Málaga;079;Periana;3659;1919;1740
29;Málaga;080;Pizarra;6285;3178;3107
29;Málaga;081;Pujerra;337;192;145
29;Málaga;082;Rincón de la Victoria;9367;4637;4730
29;Málaga;083;Riogordo;2836;1447;1389
29;Málaga;084;Ronda;32556;16080;16476
29;Málaga;085;Salares;309;159;150
29;Málaga;086;Sayalonga;1140;580;560
29;Málaga;087;Sedella;590;309;281
29;Málaga;088;Sierra de Yeguas;3259;1617;1642
29;Málaga;089;Teba;4494;2324;2170
29;Málaga;090;Tolox;3114;1629;1485
29;Málaga;901;Torremolinos;"";"";""
29;Málaga;091;Torrox;10168;5197;4971
29;Málaga;092;Totalán;615;316;299
29;Málaga;093;Valle de Abdalajís;3167;1617;1550
29;Málaga;094;Vélez-Málaga;51132;25626;25506
29;Málaga;095;Villanueva de Algaidas;4461;2220;2241
29;Málaga;098;Villanueva de Tapia;1562;793;769
29;Málaga;096;Villanueva del Rosario;3135;1552;1583
29;Málaga;097;Villanueva del Trabuco;4444;2262;2182
29;Málaga;099;Viñuela;1196;613;583
29;Málaga;100;Yunquera;3139;1615;1524
30;Murcia;001;Abanilla;7004;3434;3570
30;Murcia;002;Abarán;11623;5737;5886
30;Murcia;003;Águilas;23162;11577;11585
30;Murcia;004;Albudeite;1527;754;773
30;Murcia;005;Alcantarilla;27454;13325;14129
30;Murcia;902;Alcázares (Los);2927;1402;1525
30;Murcia;006;Aledo;1051;532;519
30;Murcia;007;Alguazas;6513;3208;3305
30;Murcia;008;Alhama de Murcia;13872;6783;7089
30;Murcia;009;Archena;13195;6538;6657
30;Murcia;010;Beniel;6479;3228;3251
30;Murcia;011;Blanca;6059;2917;3142
30;Murcia;012;Bullas;10145;5103;5042
30;Murcia;013;Calasparra;8909;4459;4450
30;Murcia;014;Campos del Río;2046;1012;1034
30;Murcia;015;Caravaca de la Cruz;22825;11293;11532
30;Murcia;016;Cartagena;169036;83324;85712
30;Murcia;017;Cehegín;15099;7511;7588
30;Murcia;018;Ceutí;6032;3053;2979
30;Murcia;019;Cieza;30419;14839;15580
30;Murcia;020;Fortuna;6114;3074;3040
30;Murcia;021;Fuente Álamo de Murcia;8806;4420;4386
30;Murcia;022;Jumilla;20840;10383;10457
30;Murcia;023;Librilla;3737;1845;1892
30;Murcia;024;Lorca;65617;32325;33292
30;Murcia;025;Lorquí;5301;2644;2657
30;Murcia;026;Mazarrón;13292;6673;6619
30;Murcia;027;Molina de Segura;35402;17527;17875
30;Murcia;028;Moratalla;10130;5126;5004
30;Murcia;029;Mula;13070;6488;6582
30;Murcia;030;Murcia;305278;148455;156823
30;Murcia;031;Ojós;651;316;335
30;Murcia;032;Pliego;3441;1721;1720
30;Murcia;033;Puerto Lumbreras;9471;4605;4866
30;Murcia;034;Ricote;1767;853;914
30;Murcia;035;San Javier;13859;6952;6907
30;Murcia;036;San Pedro del Pinatar;11096;5472;5624
30;Murcia;901;Santomera;7841;3931;3910
30;Murcia;037;Torre-Pacheco;15729;7971;7758
30;Murcia;038;Torres de Cotillas (Las);13012;6550;6462
30;Murcia;039;Totana;19810;9847;9963
30;Murcia;040;Ulea;1126;569;557
30;Murcia;041;Unión (La);14734;7321;7413
30;Murcia;042;Villanueva del Río Segura;1731;863;868
30;Murcia;043;Yecla;26574;13155;13419
31;Navarra;001;Abáigar;103;60;43
31;Navarra;002;Abárzuza;497;239;258
31;Navarra;003;Abaurregaina/Abaurrea Alta;228;128;100
31;Navarra;004;Abaurrepea/Abaurrea Baja;51;32;19
31;Navarra;005;Aberin;377;183;194
31;Navarra;006;Ablitas;2353;1199;1154
31;Navarra;007;Adiós;128;64;64
31;Navarra;008;Aguilar de Codés;165;81;84
31;Navarra;009;Aibar/Oibar;1007;506;501
31;Navarra;011;Allín;841;443;398
31;Navarra;012;Allo;1215;599;616
31;Navarra;010;Altsasu/Alsasua;7071;3606;3465
31;Navarra;013;Améscoa Baja;956;494;462
31;Navarra;014;Ancín;299;155;144
31;Navarra;015;Andosilla;2501;1254;1247
31;Navarra;016;Ansoáin;10940;5552;5388
31;Navarra;017;Anue;450;252;198
31;Navarra;018;Añorbe;403;220;183
31;Navarra;019;Aoiz/Agoitz;1881;938;943
31;Navarra;020;Araitz;685;396;289
31;Navarra;025;Arakil;2863;1495;1368
31;Navarra;021;Aranarache;110;55;55
31;Navarra;023;Aranguren;1272;706;566
31;Navarra;024;Arano;195;105;90
31;Navarra;022;Arantza;731;403;328
31;Navarra;026;Aras;255;129;126
31;Navarra;027;Arbizu;912;492;420
31;Navarra;028;Arce/Artzi;293;159;134
31;Navarra;029;Arcos (Los);1411;699;712
31;Navarra;030;Arellano;222;120;102
31;Navarra;031;Areso;315;166;149
31;Navarra;032;Arguedas;2437;1212;1225
31;Navarra;033;Aria;72;46;26
31;Navarra;034;Aribe;80;39;41
31;Navarra;035;Armañanzas;126;59;67
31;Navarra;036;Arróniz;1308;680;628
31;Navarra;037;Arruazu;117;62;55
31;Navarra;038;Artajona;1765;928;837
31;Navarra;039;Artazu;113;60;53
31;Navarra;040;Atez;187;109;78
31;Navarra;058;Auritz/Burguete;342;157;185
31;Navarra;041;Ayegui;634;324;310
31;Navarra;042;Azagra;3242;1590;1652
31;Navarra;043;Azuelo;92;47;45
31;Navarra;044;Bakaiku;373;206;167
31;Navarra;901;Barañain;14481;7171;7310
31;Navarra;045;Barásoain;433;227;206
31;Navarra;046;Barbarin;128;57;71
31;Navarra;047;Bargota;422;218;204
31;Navarra;048;Barillas;209;99;110
31;Navarra;049;Basaburua;850;464;386
31;Navarra;050;Baztan;8239;4215;4024
31;Navarra;137;Beintza-Labaien;335;192;143
31;Navarra;051;Beire;353;165;188
31;Navarra;052;Belascoáin;82;44;38
31;Navarra;250;Bera/Vera de Bidasoa;3559;1821;1738
31;Navarra;053;Berbinzana;797;390;407
31;Navarra;905;Beriáin;"";"";""
31;Navarra;902;Berrioplano;"";"";""
31;Navarra;903;Berriozar;"";"";""
31;Navarra;054;Bertizarana;650;327;323
31;Navarra;055;Betelu;349;189;160
31;Navarra;253;Bidaurreta;121;65;56
31;Navarra;056;Biurrun-Olcoz;195;110;85
31;Navarra;057;Buñuel;2514;1236;1278
31;Navarra;059;Burgui/Burgi;279;152;127
31;Navarra;060;Burlada/Burlata;14017;6925;7092
31;Navarra;061;Busto (El);135;70;65
31;Navarra;062;Cabanillas;1450;734;716
31;Navarra;063;Cabredo;145;73;72
31;Navarra;064;Cadreita;1908;915;993
31;Navarra;065;Caparroso;2418;1172;1246
31;Navarra;066;Cárcar;1256;607;649
31;Navarra;067;Carcastillo;2695;1367;1328
31;Navarra;068;Cascante;3543;1719;1824
31;Navarra;069;Cáseda;1175;583;592
31;Navarra;070;Castejón;3303;1639;1664
31;Navarra;071;Castillonuevo;19;12;7
31;Navarra;072;Cintruénigo;5440;2713;2727
31;Navarra;074;Cirauqui;491;270;221
31;Navarra;075;Ciriza;53;27;26
31;Navarra;076;Cizur;4959;2476;2483
31;Navarra;077;Corella;6358;3165;3193
31;Navarra;078;Cortes;3302;1692;1610
31;Navarra;079;Desojo;171;92;79
31;Navarra;080;Dicastillo;811;424;387
31;Navarra;081;Donamaria;395;202;193
31;Navarra;221;Doneztebe/Santesteban;1162;578;584
31;Navarra;083;Echarri;54;30;24
31;Navarra;086;Egüés;980;459;521
31;Navarra;087;Elgorriaga;184;93;91
31;Navarra;089;Enériz;191;98;93
31;Navarra;090;Eratsun;238;142;96
31;Navarra;091;Ergoiena;566;312;254
31;Navarra;092;Erro;850;446;404
31;Navarra;094;Eslava;236;117;119
31;Navarra;095;Esparza de Salazar;159;88;71
31;Navarra;096;Espronceda;221;124;97
31;Navarra;097;Estella/Lizarra;12554;6126;6428
31;Navarra;098;Esteribar;1446;764;682
31;Navarra;099;Etayo;112;58;54
31;Navarra;082;Etxalar;859;440;419
31;Navarra;084;Etxarri-Aranatz;2322;1209;1113
31;Navarra;085;Etxauri;383;199;184
31;Navarra;100;Eulate;434;222;212
31;Navarra;101;Ezcabarte;965;506;459
31;Navarra;093;Ezcároz/Ezkaroze;401;214;187
31;Navarra;102;Ezkurra;300;175;125
31;Navarra;103;Ezprogui;83;42;41
31;Navarra;104;Falces;2844;1397;1447
31;Navarra;105;Fitero;2186;1095;1091
31;Navarra;106;Fontellas;491;243;248
31;Navarra;107;Funes;2138;1067;1071
31;Navarra;108;Fustiñana;2361;1214;1147
31;Navarra;109;Galar;3270;1639;1631
31;Navarra;110;Gallipienzo;199;106;93
31;Navarra;111;Gallués/Galoze;143;86;57
31;Navarra;112;Garaioa;168;90;78
31;Navarra;113;Garde;228;121;107
31;Navarra;114;Garínoain;292;153;139
31;Navarra;115;Garralda;278;145;133
31;Navarra;116;Genevilla;169;90;79
31;Navarra;117;Goizueta;1092;591;501
31;Navarra;118;Goñi;218;119;99
31;Navarra;119;Güesa/Gorza;106;60;46
31;Navarra;120;Guesálaz;460;262;198
31;Navarra;121;Guirguillano;93;51;42
31;Navarra;256;Hiriberri/Villanueva de Aezkoa;193;103;90
31;Navarra;122;Huarte/Uharte;2780;1393;1387
31;Navarra;124;Ibargoiti;185;109;76
31;Navarra;259;Igantzi;594;316;278
31;Navarra;125;Igúzquiza;373;183;190
31;Navarra;126;Imotz;439;242;197
31;Navarra;127;Irañeta;177;103;74
31;Navarra;904;Irurtzun;"";"";""
31;Navarra;128;Isaba/Izaba;603;292;311
31;Navarra;129;Ituren;487;244;243
31;Navarra;130;Iturmendi;384;197;187
31;Navarra;131;Iza;525;288;237
31;Navarra;132;Izagaondoa;148;86;62
31;Navarra;133;Izalzu/Itzaltzu;52;24;28
31;Navarra;134;Jaurrieta;353;187;166
31;Navarra;135;Javier;170;80;90
31;Navarra;136;Juslapeña;409;224;185
31;Navarra;138;Lakuntza;1015;520;495
31;Navarra;139;Lana;250;142;108
31;Navarra;140;Lantz;145;87;58
31;Navarra;141;Lapoblación;210;114;96
31;Navarra;142;Larraga;1893;967;926
31;Navarra;143;Larraona;207;109;98
31;Navarra;144;Larraun;2063;1118;945
31;Navarra;145;Lazagurría;250;134;116
31;Navarra;146;Leache;73;42;31
31;Navarra;147;Legarda;78;39;39
31;Navarra;148;Legaria;180;88;92
31;Navarra;149;Leitza;3187;1638;1549
31;Navarra;908;Lekunberri;"";"";""
31;Navarra;150;Leoz;148;91;57
31;Navarra;151;Lerga;130;69;61
31;Navarra;152;Lerín;2173;1093;1080
31;Navarra;153;Lesaka;2942;1519;1423
31;Navarra;154;Lezáun;298;162;136
31;Navarra;155;Liédena;364;176;188
31;Navarra;156;Lizoáin;234;128;106
31;Navarra;157;Lodosa;4609;2328;2281
31;Navarra;158;Lónguida/Longida;348;188;160
31;Navarra;159;Lumbier;1471;762;709
31;Navarra;160;Luquin;159;86;73
31;Navarra;248;Luzaide/Valcarlos;571;291;280
31;Navarra;161;Mañeru;403;208;195
31;Navarra;162;Marañón;106;58;48
31;Navarra;163;Marcilla;2421;1244;1177
31;Navarra;164;Mélida;956;489;467
31;Navarra;165;Mendavia;3566;1791;1775
31;Navarra;166;Mendaza;495;229;266
31;Navarra;167;Mendigorría;986;511;475
31;Navarra;168;Metauten;373;195;178
31;Navarra;169;Milagro;2455;1229;1226
31;Navarra;170;Mirafuentes;61;29;32
31;Navarra;171;Miranda de Arga;1035;515;520
31;Navarra;172;Monreal;283;152;131
31;Navarra;173;Monteagudo;1174;579;595
31;Navarra;174;Morentin;132;60;72
31;Navarra;175;Mues;156;74;82
31;Navarra;176;Murchante;2926;1446;1480
31;Navarra;177;Murieta;276;157;119
31;Navarra;178;Murillo el Cuende;534;282;252
31;Navarra;179;Murillo el Fruto;885;449;436
31;Navarra;180;Muruzábal;201;104;97
31;Navarra;181;Navascués;299;183;116
31;Navarra;182;Nazar;54;32;22
31;Navarra;088;Noáin (Valle de Elorz)/Noain (Elortzibar);3347;1666;1681
31;Navarra;183;Obanos;698;334;364
31;Navarra;185;Ochagavía;722;377;345
31;Navarra;184;Oco;103;61;42
31;Navarra;186;Odieta;354;195;159
31;Navarra;187;Oitz;171;106;65
31;Navarra;188;Olaibar;184;99;85
31;Navarra;189;Olazti/Olazagutía;1836;951;885
31;Navarra;190;Olejua;76;38;38
31;Navarra;191;Olite;3064;1510;1554
31;Navarra;194;Ollo;370;207;163
31;Navarra;192;Olóriz;178;97;81
31;Navarra;193;Olza;2203;1124;1079
31;Navarra;195;Orbaitzeta;260;144;116
31;Navarra;196;Orbara;71;36;35
31;Navarra;906;Orcoyen;"";"";""
31;Navarra;197;Orísoain;103;55;48
31;Navarra;198;Oronz;70;39;31
31;Navarra;199;Oroz-Betelu;281;147;134
31;Navarra;211;Orreaga/Roncesvalles;31;17;14
31;Navarra;200;Oteiza;974;489;485
31;Navarra;201;Pamplona/Iruña;178666;86262;92404
31;Navarra;202;Peralta;4507;2207;2300
31;Navarra;203;Petilla de Aragón;66;33;33
31;Navarra;204;Piedramillera;112;58;54
31;Navarra;205;Pitillas;681;339;342
31;Navarra;206;Puente la Reina/Gares;2077;1048;1029
31;Navarra;207;Pueyo;328;168;160
31;Navarra;208;Ribaforada;3101;1586;1515
31;Navarra;209;Romanzado;156;92;64
31;Navarra;210;Roncal/Erronkari;416;212;204
31;Navarra;212;Sada;307;161;146
31;Navarra;213;Saldías;181;93;88
31;Navarra;214;Salinas de Oro;112;60;52
31;Navarra;215;San Adrián;4777;2342;2435
31;Navarra;217;San Martín de Unx;628;330;298
31;Navarra;216;Sangüesa/Zangoza;4616;2350;2266
31;Navarra;219;Sansol;171;85;86
31;Navarra;220;Santacara;1156;581;575
31;Navarra;222;Sarriés/Sartze;106;60;46
31;Navarra;223;Sartaguda;1441;724;717
31;Navarra;224;Sesma;1637;818;819
31;Navarra;225;Sorlada;80;41;39
31;Navarra;226;Sunbilla;752;399;353
31;Navarra;227;Tafalla;10244;5037;5207
31;Navarra;228;Tiebas-Muruarte de Reta;611;319;292
31;Navarra;229;Tirapu;71;38;33
31;Navarra;230;Torralba del Río;188;101;87
31;Navarra;231;Torres del Río;247;120;127
31;Navarra;232;Tudela;26267;12824;13443
31;Navarra;233;Tulebras;104;33;71
31;Navarra;234;Ucar;117;61;56
31;Navarra;123;Uharte-Arakil;879;463;416
31;Navarra;235;Ujué;334;174;160
31;Navarra;236;Ultzama;1624;846;778
31;Navarra;237;Unciti;206;115;91
31;Navarra;238;Unzué;130;64;66
31;Navarra;239;Urdazubi/Urdax;527;267;260
31;Navarra;240;Urdiain;739;388;351
31;Navarra;241;Urraul Alto;159;89;70
31;Navarra;242;Urraul Bajo;295;133;162
31;Navarra;244;Urrotz;243;141;102
31;Navarra;243;Urroz;372;189;183
31;Navarra;245;Urzainqui;122;65;57
31;Navarra;246;Uterga;141;68;73
31;Navarra;247;Uztárroz/Uztarroze;337;168;169
31;Navarra;249;Valtierra;2545;1272;1273
31;Navarra;251;Viana;3466;1773;1693
31;Navarra;252;Vidángoz/Bidankoze;120;58;62
31;Navarra;254;Villafranca;2642;1283;1359
31;Navarra;255;Villamayor de Monjardín;112;66;46
31;Navarra;257;Villatuerta;793;405;388
31;Navarra;258;Villava/Atarrabia;7076;3566;3510
31;Navarra;260;Yerri;1611;842;769
31;Navarra;261;Yesa;312;180;132
31;Navarra;262;Zabalza;147;65;82
31;Navarra;073;Ziordia;397;187;210
31;Navarra;907;Zizur Mayor/Zizur Nagusia;"";"";""
31;Navarra;263;Zubieta;357;212;145
31;Navarra;264;Zugarramurdi;288;155;133
31;Navarra;265;Zúñiga;138;78;60
32;Ourense;001;Allariz;6145;2965;3180
32;Ourense;002;Amoeiro;2663;1281;1382
32;Ourense;003;Arnoia (A);1297;619;678
32;Ourense;004;Avión;4584;2176;2408
32;Ourense;005;Baltar;3065;1528;1537
32;Ourense;006;Bande;4226;2045;2181
32;Ourense;007;Baños de Molgas;4433;2229;2204
32;Ourense;008;Barbadás;4178;2000;2178
32;Ourense;009;Barco de Valdeorras (O);10196;5015;5181
32;Ourense;010;Beade;1226;596;630
32;Ourense;011;Beariz;2013;888;1125
32;Ourense;012;Blancos (Os);2228;1140;1088
32;Ourense;013;Boborás;5171;2456;2715
32;Ourense;014;Bola (A);2310;1119;1191
32;Ourense;015;Bolo (O);3062;1531;1531
32;Ourense;016;Calvos de Randín;2232;1118;1114
32;Ourense;018;Carballeda de Avia;2478;1200;1278
32;Ourense;017;Carballeda de Valdeorras;3339;1722;1617
32;Ourense;019;Carballiño (O);11506;5501;6005
32;Ourense;020;Cartelle;5719;2819;2900
32;Ourense;022;Castrelo de Miño;5319;2676;2643
32;Ourense;021;Castrelo do Val;1993;1008;985
32;Ourense;023;Castro Caldelas;3192;1590;1602
32;Ourense;024;Celanova;7364;3548;3816
32;Ourense;025;Cenlle;2280;1061;1219
32;Ourense;029;Chandrexa de Queixa;1315;698;617
32;Ourense;026;Coles;3485;1722;1763
32;Ourense;027;Cortegada;2173;1058;1115
32;Ourense;028;Cualedro;5854;3002;2852
32;Ourense;030;Entrimo;2632;1237;1395
32;Ourense;031;Esgos;2657;1306;1351
32;Ourense;033;Gomesende;2239;1075;1164
32;Ourense;034;Gudiña (A);2612;1331;1281
32;Ourense;035;Irixo (O);3914;1927;1987
32;Ourense;038;Larouco;893;430;463
32;Ourense;039;Laza;2838;1402;1436
32;Ourense;040;Leiro;2554;1215;1339
32;Ourense;041;Lobeira;3120;1499;1621
32;Ourense;042;Lobios;5022;2426;2596
32;Ourense;043;Maceda;4869;2355;2514
32;Ourense;044;Manzaneda;1914;967;947
32;Ourense;045;Maside;5100;2458;2642
32;Ourense;046;Melón;2194;993;1201
32;Ourense;047;Merca (A);4230;2078;2152
32;Ourense;048;Mezquita (A);2019;1030;989
32;Ourense;049;Montederramo;1808;918;890
32;Ourense;050;Monterrei;4985;2506;2479
32;Ourense;051;Muíños;4187;2050;2137
32;Ourense;052;Nogueira de Ramuín;3492;1660;1832
32;Ourense;053;Oímbra;2172;1105;1067
32;Ourense;054;Ourense;103397;48799;54598
32;Ourense;055;Paderne de Allariz;2251;1062;1189
32;Ourense;056;Padrenda;5043;2474;2569
32;Ourense;057;Parada de Sil;2079;1001;1078
32;Ourense;058;Pereiro de Aguiar (O);6384;3115;3269
32;Ourense;059;Peroxa (A);3489;1659;1830
32;Ourense;060;Petín;1501;748;753
32;Ourense;061;Piñor;2223;1110;1113
32;Ourense;063;Pobra de Trives (A);4086;2036;2050
32;Ourense;064;Pontedeva;917;441;476
32;Ourense;062;Porqueira;1966;979;987
32;Ourense;065;Punxín;1270;606;664
32;Ourense;066;Quintela de Leirado;1462;708;754
32;Ourense;067;Rairiz de Veiga;4337;2156;2181
32;Ourense;068;Ramirás;3429;1678;1751
32;Ourense;069;Ribadavia;6850;3314;3536
32;Ourense;071;Riós;5092;2551;2541
32;Ourense;072;Rúa (A);5235;2604;2631
32;Ourense;073;Rubiá;3051;1528;1523
32;Ourense;074;San Amaro;2606;1287;1319
32;Ourense;075;San Cibrao das Viñas;3588;1720;1868
32;Ourense;076;San Cristovo de Cea;5247;2568;2679
32;Ourense;070;San Xoán de Río;1715;854;861
32;Ourense;077;Sandiás;2633;1283;1350
32;Ourense;078;Sarreaus;4089;2046;2043
32;Ourense;079;Taboadela;3151;1528;1623
32;Ourense;080;Teixeira (A);2016;1011;1005
32;Ourense;081;Toén;3420;1691;1729
32;Ourense;082;Trasmiras;4069;2081;1988
32;Ourense;083;Veiga (A);3288;1622;1666
32;Ourense;084;Verea;2885;1409;1476
32;Ourense;085;Verín;11125;5410;5715
32;Ourense;086;Viana do Bolo;6169;3134;3035
32;Ourense;087;Vilamarín;2390;1159;1231
32;Ourense;088;Vilamartín de Valdeorras;3126;1608;1518
32;Ourense;089;Vilar de Barrio;4326;2207;2119
32;Ourense;090;Vilar de Santos;1902;960;942
32;Ourense;091;Vilardevós;3698;1923;1775
32;Ourense;092;Vilariño de Conso;1264;691;573
32;Ourense;032;Xinzo de Limia;10573;5216;5357
32;Ourense;036;Xunqueira de Ambía;3394;1683;1711
32;Ourense;037;Xunqueira de Espadanedo;1481;719;762
33;Asturias;001;Allande;3259;1699;1560
33;Asturias;002;Aller;20054;9984;10070
33;Asturias;003;Amieva;1115;577;538
33;Asturias;004;Avilés;86858;42519;44339
33;Asturias;005;Belmonte de Miranda;3491;1808;1683
33;Asturias;006;Bimenes;2740;1286;1454
33;Asturias;007;Boal;3398;1697;1701
33;Asturias;008;Cabrales;2627;1319;1308
33;Asturias;009;Cabranes;1638;773;865
33;Asturias;010;Candamo;3257;1584;1673
33;Asturias;012;Cangas de Onís;6397;3228;3169
33;Asturias;011;Cangas del Narcea;20162;10450;9712
33;Asturias;013;Caravia;637;317;320
33;Asturias;014;Carreño;11541;5655;5886
33;Asturias;015;Caso;2277;1160;1117
33;Asturias;016;Castrillón;22079;10819;11260
33;Asturias;017;Castropol;5129;2480;2649
33;Asturias;018;Coaña;4204;2027;2177
33;Asturias;019;Colunga;5194;2505;2689
33;Asturias;020;Corvera de Asturias;18188;9116;9072
33;Asturias;021;Cudillero;7176;3575;3601
33;Asturias;022;Degaña;1854;994;860
33;Asturias;023;Franco (El);4373;2127;2246
33;Asturias;024;Gijón;258759;123776;134983
33;Asturias;025;Gozón;12265;5997;6268
33;Asturias;026;Grado;12691;6217;6474
33;Asturias;027;Grandas de Salime;1637;853;784
33;Asturias;028;Ibias;2895;1550;1345
33;Asturias;029;Illano;902;469;433
33;Asturias;030;Illas;1457;756;701
33;Asturias;031;Langreo;53889;26052;27837
33;Asturias;032;Laviana;15538;7689;7849
33;Asturias;033;Lena;14728;7273;7455
33;Asturias;035;Llanera;10317;5102;5215
33;Asturias;036;Llanes;13772;6558;7214
33;Asturias;037;Mieres;57532;28013;29519
33;Asturias;038;Morcín;3353;1665;1688
33;Asturias;039;Muros de Nalón;2870;1353;1517
33;Asturias;040;Nava;5776;2817;2959
33;Asturias;041;Navia;9081;4408;4673
33;Asturias;042;Noreña;4213;1983;2230
33;Asturias;043;Onís;1370;707;663
33;Asturias;044;Oviedo;186363;87983;98380
33;Asturias;045;Parres;6027;2952;3075
33;Asturias;046;Peñamellera Alta;986;495;491
33;Asturias;047;Peñamellera Baja;1954;963;991
33;Asturias;048;Pesoz;369;185;184
33;Asturias;049;Piloña;10272;4984;5288
33;Asturias;050;Ponga;989;551;438
33;Asturias;051;Pravia;10304;4953;5351
33;Asturias;052;Proaza;1110;541;569
33;Asturias;053;Quirós;1876;955;921
33;Asturias;054;Regueras (Las);2589;1293;1296
33;Asturias;055;Ribadedeva;2365;1117;1248
33;Asturias;056;Ribadesella;6586;3147;3439
33;Asturias;057;Ribera de Arriba;2297;1138;1159
33;Asturias;058;Riosa;2967;1552;1415
33;Asturias;059;Salas;8807;4375;4432
33;Asturias;061;San Martín de Oscos;707;366;341
33;Asturias;060;San Martín del Rey Aurelio;25260;12367;12893
33;Asturias;063;San Tirso de Abres;802;405;397
33;Asturias;062;Santa Eulalia de Oscos;758;403;355
33;Asturias;064;Santo Adriano;418;201;217
33;Asturias;065;Sariego;1719;839;880
33;Asturias;066;Siero;42297;20490;21807
33;Asturias;067;Sobrescobio;873;439;434
33;Asturias;068;Somiedo;2008;1026;982
33;Asturias;069;Soto del Barco;5026;2391;2635
33;Asturias;070;Tapia de Casariego;4611;2225;2386
33;Asturias;071;Taramundi;1154;567;587
33;Asturias;072;Teverga;3034;1530;1504
33;Asturias;073;Tineo;17652;8926;8726
33;Asturias;034;Valdés;18163;8927;9236
33;Asturias;074;Vegadeo;5198;2495;2703
33;Asturias;075;Villanueva de Oscos;542;281;261
33;Asturias;076;Villaviciosa;15609;7663;7946
33;Asturias;077;Villayón;2399;1230;1169
33;Asturias;078;Yernes y Tameza;232;113;119
34;Palencia;001;Abarca de Campos;53;28;25
34;Palencia;003;Abia de las Torres;255;128;127
34;Palencia;004;Aguilar de Campoo;7332;3608;3724
34;Palencia;005;Alar del Rey;1700;826;874
34;Palencia;006;Alba de Cerrato;154;78;76
34;Palencia;009;Amayuelas de Arriba;79;44;35
34;Palencia;010;Ampudia;889;443;446
34;Palencia;011;Amusco;736;392;344
34;Palencia;012;Antigüedad;494;269;225
34;Palencia;015;Arconada;118;61;57
34;Palencia;017;Astudillo;1587;829;758
34;Palencia;018;Autilla del Pino;358;183;175
34;Palencia;019;Autillo de Campos;232;108;124
34;Palencia;020;Ayuela;133;74;59
34;Palencia;022;Baltanás;1725;901;824
34;Palencia;024;Baquerín de Campos;43;27;16
34;Palencia;025;Bárcena de Campos;80;34;46
34;Palencia;027;Barruelo de Santullán;2476;1186;1290
34;Palencia;028;Báscones de Ojeda;264;133;131
34;Palencia;029;Becerril de Campos;1320;644;676
34;Palencia;031;Belmonte de Campos;75;34;41
34;Palencia;032;Berzosilla;103;51;52
34;Palencia;033;Boada de Campos;31;16;15
34;Palencia;035;Boadilla de Rioseco;235;114;121
34;Palencia;034;Boadilla del Camino;265;135;130
34;Palencia;036;Brañosera;364;182;182
34;Palencia;037;Buenavista de Valdavia;561;273;288
34;Palencia;038;Bustillo de la Vega;451;242;209
34;Palencia;039;Bustillo del Páramo de Carrión;135;70;65
34;Palencia;041;Calahorra de Boedo;180;87;93
34;Palencia;042;Calzada de los Molinos;473;254;219
34;Palencia;045;Capillas;165;81;84
34;Palencia;046;Cardeñosa de Volpejera;67;29;38
34;Palencia;047;Carrión de los Condes;2657;1260;1397
34;Palencia;048;Castil de Vela;147;70;77
34;Palencia;049;Castrejón de la Peña;843;450;393
34;Palencia;050;Castrillo de Don Juan;502;272;230
34;Palencia;051;Castrillo de Onielo;224;111;113
34;Palencia;052;Castrillo de Villavega;390;197;193
34;Palencia;053;Castromocho;310;157;153
34;Palencia;055;Cervatos de la Cueza;455;227;228
34;Palencia;056;Cervera de Pisuerga;3125;1577;1548
34;Palencia;057;Cevico de la Torre;803;402;401
34;Palencia;058;Cevico Navero;398;207;191
34;Palencia;059;Cisneros;708;355;353
34;Palencia;060;Cobos de Cerrato;282;144;138
34;Palencia;061;Collazos de Boedo;189;107;82
34;Palencia;062;Congosto de Valdavia;360;190;170
34;Palencia;063;Cordovilla la Real;189;105;84
34;Palencia;066;Cubillas de Cerrato;152;76;76
34;Palencia;067;Dehesa de Montejo;384;215;169
34;Palencia;068;Dehesa de Romanos;83;45;38
34;Palencia;069;Dueñas;3117;1604;1513
34;Palencia;070;Espinosa de Cerrato;377;193;184
34;Palencia;071;Espinosa de Villagonzalo;359;173;186
34;Palencia;072;Frechilla;326;155;171
34;Palencia;073;Fresno del Río;243;122;121
34;Palencia;074;Frómista;1148;587;561
34;Palencia;076;Fuentes de Nava;1005;488;517
34;Palencia;077;Fuentes de Valdepero;252;133;119
34;Palencia;079;Grijota;818;410;408
34;Palencia;080;Guardo;9808;5026;4782
34;Palencia;081;Guaza de Campos;109;57;52
34;Palencia;082;Hérmedes de Cerrato;199;97;102
34;Palencia;083;Herrera de Pisuerga;3006;1525;1481
34;Palencia;084;Herrera de Valdecañas;219;111;108
34;Palencia;086;Hontoria de Cerrato;134;68;66
34;Palencia;087;Hornillos de Cerrato;197;93;104
34;Palencia;088;Husillos;223;120;103
34;Palencia;089;Itero de la Vega;309;172;137
34;Palencia;091;Lagartos;239;132;107
34;Palencia;092;Lantadilla;660;325;335
34;Palencia;094;Ledigos;146;75;71
34;Palencia;903;Loma de Ucieza;472;249;223
34;Palencia;096;Lomas;84;41;43
34;Palencia;098;Magaz de Pisuerga;575;304;271
34;Palencia;099;Manquillos;96;52;44
34;Palencia;100;Mantinos;266;142;124
34;Palencia;101;Marcilla de Campos;118;52;66
34;Palencia;102;Mazariegos;289;153;136
34;Palencia;103;Mazuecos de Valdeginate;170;79;91
34;Palencia;104;Melgar de Yuso;509;268;241
34;Palencia;106;Meneses de Campos;211;113;98
34;Palencia;107;Micieces de Ojeda;158;79;79
34;Palencia;108;Monzón de Campos;1002;515;487
34;Palencia;109;Moratinos;123;62;61
34;Palencia;110;Mudá;218;108;110
34;Palencia;112;Nogal de las Huertas;123;66;57
34;Palencia;113;Olea de Boedo;55;25;30
34;Palencia;114;Olmos de Ojeda;524;286;238
34;Palencia;116;Osornillo;127;65;62
34;Palencia;901;Osorno la Mayor;2044;1051;993
34;Palencia;120;Palencia;75951;36644;39307
34;Palencia;121;Palenzuela;434;233;201
34;Palencia;122;Páramo de Boedo;145;75;70
34;Palencia;123;Paredes de Nava;2804;1390;1414
34;Palencia;124;Payo de Ojeda;120;65;55
34;Palencia;125;Pedraza de Campos;197;107;90
34;Palencia;126;Pedrosa de la Vega;440;235;205
34;Palencia;127;Perales;182;94;88
34;Palencia;904;Pernía (La);601;318;283
34;Palencia;129;Pino del Río;335;186;149
34;Palencia;130;Piña de Campos;422;229;193
34;Palencia;131;Población de Arroyo;120;65;55
34;Palencia;132;Población de Campos;271;144;127
34;Palencia;133;Población de Cerrato;163;85;78
34;Palencia;134;Polentinos;161;75;86
34;Palencia;135;Pomar de Valdivia;733;364;369
34;Palencia;136;Poza de la Vega;328;184;144
34;Palencia;137;Pozo de Urama;56;29;27
34;Palencia;139;Prádanos de Ojeda;282;143;139
34;Palencia;140;Puebla de Valdavia (La);242;117;125
34;Palencia;141;Quintana del Puente;436;213;223
34;Palencia;143;Quintanilla de Onsoña;328;183;145
34;Palencia;146;Reinoso de Cerrato;106;51;55
34;Palencia;147;Renedo de la Vega;346;179;167
34;Palencia;149;Requena de Campos;70;36;34
34;Palencia;151;Respenda de la Peña;400;214;186
34;Palencia;152;Revenga de Campos;239;118;121
34;Palencia;154;Revilla de Collazos;122;67;55
34;Palencia;155;Ribas de Campos;287;149;138
34;Palencia;156;Riberos de la Cueza;120;65;55
34;Palencia;157;Saldaña;3102;1615;1487
34;Palencia;158;Salinas de Pisuerga;315;169;146
34;Palencia;159;San Cebrián de Campos;624;356;268
34;Palencia;160;San Cebrián de Mudá;302;154;148
34;Palencia;161;San Cristóbal de Boedo;69;36;33
34;Palencia;163;San Mamés de Campos;163;77;86
34;Palencia;165;San Román de la Cuba;162;86;76
34;Palencia;167;Santa Cecilia del Alcor;191;104;87
34;Palencia;168;Santa Cruz de Boedo;91;45;46
34;Palencia;169;Santervás de la Vega;687;381;306
34;Palencia;170;Santibáñez de Ecla;138;52;86
34;Palencia;171;Santibáñez de la Peña;2188;1092;1096
34;Palencia;174;Santoyo;356;172;184
34;Palencia;175;Serna (La);154;82;72
34;Palencia;177;Soto de Cerrato;291;142;149
34;Palencia;176;Sotobañado y Priorato;245;126;119
34;Palencia;178;Tabanera de Cerrato;233;112;121
34;Palencia;179;Tabanera de Valdavia;75;41;34
34;Palencia;180;Támara de Campos;115;60;55
34;Palencia;181;Tariego de Cerrato;575;295;280
34;Palencia;182;Torquemada;1385;709;676
34;Palencia;184;Torremormojón;108;46;62
34;Palencia;185;Triollo;141;76;65
34;Palencia;186;Valbuena de Pisuerga;90;54;36
34;Palencia;189;Valdeolmillos;115;56;59
34;Palencia;190;Valderrábano;136;72;64
34;Palencia;192;Valde-Ucieza;192;112;80
34;Palencia;196;Valle de Cerrato;178;95;83
34;Palencia;902;Valle del Retortillo;342;165;177
34;Palencia;199;Velilla del Río Carrión;2292;1166;1126
34;Palencia;023;Venta de Baños;6968;3452;3516
34;Palencia;201;Vertavillo;345;183;162
34;Palencia;093;Vid de Ojeda (La);194;106;88
34;Palencia;202;Villabasta de Valdavia;49;22;27
34;Palencia;204;Villacidaler;127;62;65
34;Palencia;205;Villaconancio;114;58;56
34;Palencia;206;Villada;1492;724;768
34;Palencia;208;Villaeles de Valdavia;128;69;59
34;Palencia;210;Villahán;199;111;88
34;Palencia;211;Villaherreros;369;176;193
34;Palencia;213;Villalaco;93;43;50
34;Palencia;214;Villalba de Guardo;264;141;123
34;Palencia;215;Villalcázar de Sirga;277;126;151
34;Palencia;216;Villalcón;130;62;68
34;Palencia;217;Villalobón;250;134;116
34;Palencia;218;Villaluenga de la Vega;899;496;403
34;Palencia;220;Villamartín de Campos;196;96;100
34;Palencia;221;Villamediana;308;164;144
34;Palencia;222;Villameriel;214;108;106
34;Palencia;223;Villamoronta;369;191;178
34;Palencia;224;Villamuera de la Cueza;111;63;48
34;Palencia;225;Villamuriel de Cerrato;3600;1838;1762
34;Palencia;227;Villanueva del Rebollar;114;59;55
34;Palencia;228;Villanuño de Valdavia;169;94;75
34;Palencia;229;Villaprovedo;142;81;61
34;Palencia;230;Villarmentero de Campos;33;13;20
34;Palencia;231;Villarrabé;334;172;162
34;Palencia;232;Villarramiel;1253;631;622
34;Palencia;233;Villasarracino;417;204;213
34;Palencia;234;Villasila de Valdavia;143;79;64
34;Palencia;236;Villaturde;375;190;185
34;Palencia;237;Villaumbrales;1003;516;487
34;Palencia;238;Villaviudas;555;283;272
34;Palencia;240;Villerías de Campos;152;84;68
34;Palencia;241;Villodre;64;35;29
34;Palencia;242;Villodrigo;155;80;75
34;Palencia;243;Villoldo;618;318;300
34;Palencia;245;Villota del Páramo;628;351;277
34;Palencia;246;Villovieco;159;85;74
35;Palmas (Las);001;Agaete;5261;2653;2608
35;Palmas (Las);002;Agüimes;15040;7630;7410
35;Palmas (Las);003;Antigua;2218;1164;1054
35;Palmas (Las);004;Arrecife;33272;16892;16380
35;Palmas (Las);005;Artenara;1107;579;528
35;Palmas (Las);006;Arucas;27340;13877;13463
35;Palmas (Las);007;Betancuria;598;313;285
35;Palmas (Las);008;Firgas;5670;2850;2820
35;Palmas (Las);009;Gáldar;20909;10577;10332
35;Palmas (Las);010;Haría;2849;1471;1378
35;Palmas (Las);011;Ingenio;21499;10912;10587
35;Palmas (Las);016;Las Palmas de Gran Canaria;358272;177186;181086
35;Palmas (Las);012;Mogán;8333;4375;3958
35;Palmas (Las);013;Moya;7913;4042;3871
35;Palmas (Las);014;Oliva (La);4358;2295;2063
35;Palmas (Las);015;Pájara;4251;2227;2024
35;Palmas (Las);017;Puerto del Rosario;14896;8097;6799
35;Palmas (Las);018;San Bartolomé;5444;2829;2615
35;Palmas (Las);019;San Bartolomé de Tirajana;27498;14340;13158
35;Palmas (Las);020;San Nicolás de Tolentino;7826;3943;3883
35;Palmas (Las);021;Santa Brígida;13109;6550;6559
35;Palmas (Las);022;Santa Lucía de Tirajana;31128;15896;15232
35;Palmas (Las);023;Santa María de Guía de Gran Canaria;12908;6540;6368
35;Palmas (Las);024;Teguise;6754;3522;3232
35;Palmas (Las);025;Tejeda;2164;1041;1123
35;Palmas (Las);026;Telde;75106;37784;37322
35;Palmas (Las);027;Teror;10777;5372;5405
35;Palmas (Las);028;Tías;5954;3120;2834
35;Palmas (Las);029;Tinajo;3264;1655;1609
35;Palmas (Las);030;Tuineje;6388;3365;3023
35;Palmas (Las);032;Valleseco;4217;2169;2048
35;Palmas (Las);031;Valsequillo de Gran Canaria;6115;3136;2979
35;Palmas (Las);033;Vega de San Mateo;7258;3726;3532
35;Palmas (Las);034;Yaiza;2097;1110;987
36;Pontevedra;020;Agolada;5027;2461;2566
36;Pontevedra;001;Arbo;5294;2543;2751
36;Pontevedra;003;Baiona;10357;5079;5278
36;Pontevedra;002;Barro;3954;1876;2078
36;Pontevedra;004;Bueu;12407;6128;6279
36;Pontevedra;005;Caldas de Reis;9301;4450;4851
36;Pontevedra;006;Cambados;13182;6487;6695
36;Pontevedra;007;Campo Lameiro;2777;1301;1476
36;Pontevedra;008;Cangas;22488;11069;11419
36;Pontevedra;009;Cañiza (A);8605;4113;4492
36;Pontevedra;010;Catoira;3708;1832;1876
36;Pontevedra;011;Cerdedo;4504;2036;2468
36;Pontevedra;012;Cotobade;6018;2763;3255
36;Pontevedra;013;Covelo;5755;2643;3112
36;Pontevedra;014;Crecente;4390;2066;2324
36;Pontevedra;015;Cuntis;6650;3092;3558
36;Pontevedra;016;Dozón;2824;1419;1405
36;Pontevedra;017;Estrada (A);25876;12134;13742
36;Pontevedra;018;Forcarei;8057;3910;4147
36;Pontevedra;019;Fornelos de Montes;2643;1237;1406
36;Pontevedra;021;Gondomar;10332;5080;5252
36;Pontevedra;022;Grove (O);10737;5353;5384
36;Pontevedra;023;Guarda (A);10170;4917;5253
36;Pontevedra;901;Illa de Arousa (A);"";"";""
36;Pontevedra;024;Lalín;20296;9975;10321
36;Pontevedra;025;Lama (A);4420;2000;2420
36;Pontevedra;026;Marín;23552;11446;12106
36;Pontevedra;027;Meaño;5987;2921;3066
36;Pontevedra;028;Meis;5434;2596;2838
36;Pontevedra;029;Moaña;18136;8796;9340
36;Pontevedra;030;Mondariz;7236;3463;3773
36;Pontevedra;031;Mondariz-Balneario;635;298;337
36;Pontevedra;032;Moraña;5233;2491;2742
36;Pontevedra;033;Mos;13686;6695;6991
36;Pontevedra;034;Neves (As);6579;3117;3462
36;Pontevedra;035;Nigrán;14057;6903;7154
36;Pontevedra;036;Oia;3281;1627;1654
36;Pontevedra;037;Pazos de Borbén;3752;1745;2007
36;Pontevedra;041;Poio;12972;6361;6611
36;Pontevedra;043;Ponte Caldelas;8460;3993;4467
36;Pontevedra;042;Ponteareas;17121;8268;8853
36;Pontevedra;044;Pontecesures;2781;1349;1432
36;Pontevedra;038;Pontevedra;67314;31846;35468
36;Pontevedra;039;Porriño (O);14748;7179;7569
36;Pontevedra;040;Portas;3771;1801;1970
36;Pontevedra;045;Redondela;27550;13402;14148
36;Pontevedra;046;Ribadumia;4228;2031;2197
36;Pontevedra;047;Rodeiro;4808;2497;2311
36;Pontevedra;048;Rosal (O);5983;2942;3041
36;Pontevedra;049;Salceda de Caselas;5929;2891;3038
36;Pontevedra;050;Salvaterra de Miño;9623;4599;5024
36;Pontevedra;051;Sanxenxo;15417;7619;7798
36;Pontevedra;052;Silleda;10460;4992;5468
36;Pontevedra;053;Soutomaior;5340;2536;2804
36;Pontevedra;054;Tomiño;11081;5450;5631
36;Pontevedra;055;Tui;16223;7800;8423
36;Pontevedra;056;Valga;6577;3243;3334
36;Pontevedra;057;Vigo;262560;125430;137130
36;Pontevedra;059;Vila de Cruces;8521;4181;4340
36;Pontevedra;058;Vilaboa;6246;3042;3204
36;Pontevedra;060;Vilagarcía de Arousa;32037;15597;16440
36;Pontevedra;061;Vilanova de Arousa;15805;7748;8057
37;Salamanca;001;Abusejo;378;198;180
37;Salamanca;002;Agallas;329;178;151
37;Salamanca;003;Ahigal de los Aceiteros;253;127;126
37;Salamanca;004;Ahigal de Villarino;59;34;25
37;Salamanca;005;Alameda de Gardón (La);265;130;135
37;Salamanca;006;Alamedilla (La);304;149;155
37;Salamanca;007;Alaraz;774;410;364
37;Salamanca;008;Alba de Tormes;4211;2111;2100
37;Salamanca;009;Alba de Yeltes;406;207;199
37;Salamanca;010;Alberca (La);1130;585;545
37;Salamanca;011;Alberguería de Argañán (La);339;172;167
37;Salamanca;012;Alconada;292;154;138
37;Salamanca;015;Aldea del Obispo;514;261;253
37;Salamanca;013;Aldeacipreste;402;216;186
37;Salamanca;014;Aldeadávila de la Ribera;1939;1020;919
37;Salamanca;016;Aldealengua;380;191;189
37;Salamanca;017;Aldeanueva de Figueroa;472;237;235
37;Salamanca;018;Aldeanueva de la Sierra;127;74;53
37;Salamanca;019;Aldearrodrigo;243;128;115
37;Salamanca;020;Aldearrubia;537;273;264
37;Salamanca;021;Aldeaseca de Alba;197;100;97
37;Salamanca;022;Aldeaseca de la Frontera;437;222;215
37;Salamanca;023;Aldeatejada;579;288;291
37;Salamanca;024;Aldeavieja de Tormes;170;90;80
37;Salamanca;025;Aldehuela de la Bóveda;428;215;213
37;Salamanca;026;Aldehuela de Yeltes;433;210;223
37;Salamanca;027;Almenara de Tormes;248;119;129
37;Salamanca;028;Almendra;260;137;123
37;Salamanca;029;Anaya de Alba;433;222;211
37;Salamanca;030;Añover de Tormes;134;64;70
37;Salamanca;031;Arabayona de Mógica;658;352;306
37;Salamanca;032;Arapiles;480;246;234
37;Salamanca;033;Arcediano;151;74;77
37;Salamanca;034;Arco (El);109;60;49
37;Salamanca;035;Armenteros;413;190;223
37;Salamanca;037;Atalaya (La);229;124;105
37;Salamanca;038;Babilafuente;1041;541;500
37;Salamanca;039;Bañobárez;610;318;292
37;Salamanca;040;Barbadillo;657;319;338
37;Salamanca;041;Barbalos;178;86;92
37;Salamanca;042;Barceo;120;64;56
37;Salamanca;044;Barruecopardo;766;385;381
37;Salamanca;045;Bastida (La);54;25;29
37;Salamanca;046;Béjar;17554;8418;9136
37;Salamanca;047;Beleña;128;58;70
37;Salamanca;049;Bermellar;260;130;130
37;Salamanca;050;Berrocal de Huebra;188;97;91
37;Salamanca;051;Berrocal de Salvatierra;193;97;96
37;Salamanca;052;Boada;497;249;248
37;Salamanca;054;Bodón (El);448;227;221
37;Salamanca;055;Bogajo;280;140;140
37;Salamanca;056;Bouza (La);70;36;34
37;Salamanca;057;Bóveda del Río Almar;368;187;181
37;Salamanca;058;Brincones;159;76;83
37;Salamanca;059;Buenamadre;248;125;123
37;Salamanca;060;Buenavista;129;65;64
37;Salamanca;061;Cabaco (El);356;183;173
37;Salamanca;063;Cabeza de Béjar (La);164;79;85
37;Salamanca;065;Cabeza del Caballo;623;325;298
37;Salamanca;062;Cabezabellosa de la Calzada;179;102;77
37;Salamanca;067;Cabrerizos;686;340;346
37;Salamanca;068;Cabrillas;698;329;369
37;Salamanca;069;Calvarrasa de Abajo;1089;539;550
37;Salamanca;070;Calvarrasa de Arriba;634;338;296
37;Salamanca;071;Calzada de Béjar (La);141;73;68
37;Salamanca;072;Calzada de Don Diego;332;165;167
37;Salamanca;073;Calzada de Valdunciel;720;348;372
37;Salamanca;074;Campillo de Azaba;410;200;210
37;Salamanca;077;Campo de Peñaranda (El);497;257;240
37;Salamanca;078;Candelario;1247;592;655
37;Salamanca;079;Canillas de Abajo;183;99;84
37;Salamanca;080;Cantagallo;323;162;161
37;Salamanca;081;Cantalapiedra;1723;862;861
37;Salamanca;082;Cantalpino;1442;755;687
37;Salamanca;083;Cantaracillo;323;157;166
37;Salamanca;085;Carbajosa de la Sagrada;527;266;261
37;Salamanca;086;Carpio de Azaba;126;69;57
37;Salamanca;087;Carrascal de Barregas;342;179;163
37;Salamanca;088;Carrascal del Obispo;325;159;166
37;Salamanca;089;Casafranca;98;44;54
37;Salamanca;090;Casas del Conde (Las);162;72;90
37;Salamanca;091;Casillas de Flores;356;165;191
37;Salamanca;092;Castellanos de Moriscos;338;149;189
37;Salamanca;185;Castellanos de Villiquera;443;223;220
37;Salamanca;096;Castillejo de Martín Viejo;433;225;208
37;Salamanca;097;Castraz;134;71;63
37;Salamanca;098;Cepeda;640;313;327
37;Salamanca;099;Cereceda de la Sierra;144;79;65
37;Salamanca;100;Cerezal de Peñahorcada;198;99;99
37;Salamanca;101;Cerralbo;351;191;160
37;Salamanca;102;Cerro (El);693;345;348
37;Salamanca;103;Cespedosa de Tormes;795;429;366
37;Salamanca;114;Chagarcía Medianero;207;109;98
37;Salamanca;104;Cilleros de la Bastida;67;29;38
37;Salamanca;106;Cipérez;634;325;309
37;Salamanca;107;Ciudad Rodrigo;15695;7553;8142
37;Salamanca;108;Coca de Alba;223;107;116
37;Salamanca;109;Colmenar de Montemayor;408;204;204
37;Salamanca;110;Cordovilla;168;88;80
37;Salamanca;112;Cristóbal;279;150;129
37;Salamanca;113;Cubo de Don Sancho (El);729;380;349
37;Salamanca;115;Dios le Guarde;209;108;101
37;Salamanca;116;Doñinos de Ledesma;124;60;64
37;Salamanca;117;Doñinos de Salamanca;652;327;325
37;Salamanca;118;Ejeme;289;156;133
37;Salamanca;120;Encina de San Silvestre;135;67;68
37;Salamanca;119;Encina (La);341;182;159
37;Salamanca;121;Encinas de Abajo;775;412;363
37;Salamanca;122;Encinas de Arriba;307;156;151
37;Salamanca;123;Encinasola de los Comendadores;408;210;198
37;Salamanca;124;Endrinal;371;199;172
37;Salamanca;125;Escurial de la Sierra;379;179;200
37;Salamanca;126;Espadaña;76;40;36
37;Salamanca;127;Espeja;412;208;204
37;Salamanca;128;Espino de la Orbada;459;236;223
37;Salamanca;129;Florida de Liébana;249;140;109
37;Salamanca;130;Forfoleda;292;138;154
37;Salamanca;131;Frades de la Sierra;347;184;163
37;Salamanca;132;Fregeneda (La);707;340;367
37;Salamanca;133;Fresnedoso;198;100;98
37;Salamanca;134;Fresno Alhándiga;429;227;202
37;Salamanca;135;Fuente de San Esteban (La);1886;951;935
37;Salamanca;136;Fuenteguinaldo;1246;616;630
37;Salamanca;137;Fuenteliante;172;89;83
37;Salamanca;138;Fuenterroble de Salvatierra;316;161;155
37;Salamanca;139;Fuentes de Béjar;342;140;202
37;Salamanca;140;Fuentes de Oñoro;1560;764;796
37;Salamanca;141;Gajates;308;159;149
37;Salamanca;142;Galindo y Perahuy;168;86;82
37;Salamanca;143;Galinduste;713;370;343
37;Salamanca;144;Galisancho;810;417;393
37;Salamanca;145;Gallegos de Argañán;630;318;312
37;Salamanca;146;Gallegos de Solmirón;374;181;193
37;Salamanca;147;Garcibuey;372;205;167
37;Salamanca;148;Garcihernández;722;383;339
37;Salamanca;149;Garcirrey;137;67;70
37;Salamanca;150;Gejuelo del Barro;62;32;30
37;Salamanca;151;Golpejas;260;140;120
37;Salamanca;152;Gomecello;686;332;354
37;Salamanca;154;Guadramiro;291;164;127
37;Salamanca;155;Guijo de Ávila;127;70;57
37;Salamanca;156;Guijuelo;4549;2272;2277
37;Salamanca;157;Herguijuela de Ciudad Rodrigo;222;109;113
37;Salamanca;158;Herguijuela de la Sierra;489;237;252
37;Salamanca;159;Herguijuela del Campo;189;100;89
37;Salamanca;160;Hinojosa de Duero;994;478;516
37;Salamanca;161;Horcajo de Montemayor;231;122;109
37;Salamanca;162;Horcajo Medianero;563;295;268
37;Salamanca;163;Hoya (La);38;23;15
37;Salamanca;164;Huerta;306;165;141
37;Salamanca;165;Iruelos;85;42;43
37;Salamanca;166;Ituero de Azaba;450;231;219
37;Salamanca;167;Juzbado;259;131;128
37;Salamanca;168;Lagunilla;895;474;421
37;Salamanca;169;Larrodrigo;375;191;184
37;Salamanca;170;Ledesma;2065;1013;1052
37;Salamanca;171;Ledrada;665;322;343
37;Salamanca;172;Linares de Riofrío;1241;617;624
37;Salamanca;173;Lumbrales;2621;1279;1342
37;Salamanca;175;Machacón;611;318;293
37;Salamanca;174;Macotera;2083;1044;1039
37;Salamanca;176;Madroñal;173;88;85
37;Salamanca;177;Maíllo (El);495;246;249
37;Salamanca;178;Malpartida;248;132;116
37;Salamanca;179;Mancera de Abajo;475;243;232
37;Salamanca;180;Manzano (El);139;79;60
37;Salamanca;181;Martiago;573;282;291
37;Salamanca;183;Martín de Yeltes;770;390;380
37;Salamanca;182;Martinamor;124;66;58
37;Salamanca;184;Masueco;604;304;300
37;Salamanca;186;Mata de Ledesma (La);214;99;115
37;Salamanca;187;Matilla de los Caños del Río;788;402;386
37;Salamanca;188;Maya (La);335;179;156
37;Salamanca;189;Membribe de la Sierra;122;66;56
37;Salamanca;190;Mieza;498;258;240
37;Salamanca;191;Milano (El);232;125;107
37;Salamanca;192;Miranda de Azán;127;62;65
37;Salamanca;193;Miranda del Castañar;833;425;408
37;Salamanca;194;Mogarraz;481;228;253
37;Salamanca;195;Molinillo;94;48;46
37;Salamanca;196;Monforte de la Sierra;170;87;83
37;Salamanca;197;Monleón;176;97;79
37;Salamanca;198;Monleras;325;169;156
37;Salamanca;199;Monsagro;299;164;135
37;Salamanca;200;Montejo;259;134;125
37;Salamanca;201;Montemayor del Río;504;258;246
37;Salamanca;202;Monterrubio de Armuña;106;56;50
37;Salamanca;203;Monterrubio de la Sierra;202;105;97
37;Salamanca;204;Morasverdes;529;276;253
37;Salamanca;205;Morille;213;110;103
37;Salamanca;206;Moríñigo;181;97;84
37;Salamanca;207;Moriscos;143;78;65
37;Salamanca;208;Moronta;185;91;94
37;Salamanca;209;Mozárbez;377;192;185
37;Salamanca;211;Narros de Matalayegua;413;221;192
37;Salamanca;213;Nava de Béjar;150;73;77
37;Salamanca;214;Nava de Francia;189;103;86
37;Salamanca;215;Nava de Sotrobal;300;157;143
37;Salamanca;212;Navacarros;111;58;53
37;Salamanca;216;Navales;441;246;195
37;Salamanca;217;Navalmoral de Béjar;106;55;51
37;Salamanca;218;Navamorales;267;140;127
37;Salamanca;219;Navarredonda de la Rinconada;425;214;211
37;Salamanca;221;Navasfrías;956;471;485
37;Salamanca;222;Negrilla de Palencia;136;66;70
37;Salamanca;223;Olmedo de Camaces;219;110;109
37;Salamanca;224;Orbada (La);345;171;174
37;Salamanca;225;Pajares de la Laguna;161;81;80
37;Salamanca;226;Palacios del Arzobispo;311;161;150
37;Salamanca;228;Palaciosrubios;722;376;346
37;Salamanca;229;Palencia de Negrilla;272;134;138
37;Salamanca;230;Parada de Arriba;257;133;124
37;Salamanca;231;Parada de Rubiales;437;223;214
37;Salamanca;232;Paradinas de San Juan;734;399;335
37;Salamanca;233;Pastores;108;56;52
37;Salamanca;234;Payo (El);728;349;379
37;Salamanca;235;Pedraza de Alba;304;168;136
37;Salamanca;236;Pedrosillo de Alba;364;185;179
37;Salamanca;237;Pedrosillo de los Aires;578;314;264
37;Salamanca;238;Pedrosillo el Ralo;159;79;80
37;Salamanca;239;Pedroso de la Armuña (El);431;206;225
37;Salamanca;240;Pelabravo;590;297;293
37;Salamanca;241;Pelarrodríguez;256;138;118
37;Salamanca;242;Pelayos;104;54;50
37;Salamanca;243;Peña (La);248;126;122
37;Salamanca;244;Peñacaballera;275;138;137
37;Salamanca;245;Peñaparda;616;291;325
37;Salamanca;246;Peñaranda de Bracamonte;6377;3139;3238
37;Salamanca;247;Peñarandilla;349;177;172
37;Salamanca;248;Peralejos de Abajo;282;129;153
37;Salamanca;249;Peralejos de Arriba;102;54;48
37;Salamanca;250;Pereña de la Ribera;577;301;276
37;Salamanca;251;Peromingo;154;73;81
37;Salamanca;252;Pinedas;305;155;150
37;Salamanca;253;Pino de Tormes (El);195;105;90
37;Salamanca;254;Pitiegua;345;181;164
37;Salamanca;255;Pizarral;119;55;64
37;Salamanca;256;Poveda de las Cintas;454;247;207
37;Salamanca;257;Pozos de Hinojo;139;71;68
37;Salamanca;258;Puebla de Azaba;484;253;231
37;Salamanca;259;Puebla de San Medel;81;41;40
37;Salamanca;260;Puebla de Yeltes;317;173;144
37;Salamanca;261;Puente del Congosto;468;231;237
37;Salamanca;262;Puertas;167;87;80
37;Salamanca;263;Puerto de Béjar;612;296;316
37;Salamanca;264;Puerto Seguro;142;77;65
37;Salamanca;265;Rágama;401;214;187
37;Salamanca;266;Redonda (La);136;66;70
37;Salamanca;267;Retortillo;349;175;174
37;Salamanca;268;Rinconada de la Sierra (La);236;112;124
37;Salamanca;269;Robleda;718;363;355
37;Salamanca;270;Robliza de Cojos;271;123;148
37;Salamanca;271;Rollán;638;334;304
37;Salamanca;272;Saelices el Chico;240;132;108
37;Salamanca;273;Sagrada (La);239;121;118
37;Salamanca;303;Sahugo (El);392;201;191
37;Salamanca;274;Salamanca;155612;74154;81458
37;Salamanca;275;Saldeana;265;142;123
37;Salamanca;276;Salmoral;520;264;256
37;Salamanca;277;Salvatierra de Tormes;98;45;53
37;Salamanca;278;San Cristóbal de la Cuesta;255;129;126
37;Salamanca;284;San Esteban de la Sierra;542;281;261
37;Salamanca;285;San Felices de los Gallegos;822;416;406
37;Salamanca;286;San Martín del Castañar;442;225;217
37;Salamanca;287;San Miguel de Valero;536;255;281
37;Salamanca;036;San Miguel del Robledo;137;72;65
37;Salamanca;288;San Morales;187;97;90
37;Salamanca;289;San Muñoz;447;234;213
37;Salamanca;291;San Pedro de Rozados;522;259;263
37;Salamanca;290;San Pedro del Valle;322;164;158
37;Salamanca;292;San Pelayo de Guareña;148;75;73
37;Salamanca;280;Sanchón de la Ribera;205;104;101
37;Salamanca;281;Sanchón de la Sagrada;72;34;38
37;Salamanca;282;Sanchotello;413;215;198
37;Salamanca;279;Sancti-Spíritus;1546;773;773
37;Salamanca;283;Sando;286;160;126
37;Salamanca;293;Santa María de Sando;259;145;114
37;Salamanca;294;Santa Marta de Tormes;4632;2286;2346
37;Salamanca;296;Santiago de la Puebla;885;467;418
37;Salamanca;297;Santibáñez de Béjar;856;410;446
37;Salamanca;298;Santibáñez de la Sierra;325;177;148
37;Salamanca;299;Santiz;338;181;157
37;Salamanca;300;Santos (Los);903;477;426
37;Salamanca;301;Sardón de los Frailes;116;66;50
37;Salamanca;302;Saucelle;665;353;312
37;Salamanca;304;Sepulcro-Hilario;369;185;184
37;Salamanca;305;Sequeros;303;147;156
37;Salamanca;306;Serradilla del Arroyo;619;313;306
37;Salamanca;307;Serradilla del Llano;419;220;199
37;Salamanca;309;Sierpe (La);63;31;32
37;Salamanca;310;Sieteiglesias de Tormes;218;114;104
37;Salamanca;311;Sobradillo;462;223;239
37;Salamanca;312;Sorihuela;539;267;272
37;Salamanca;313;Sotoserrano;862;459;403
37;Salamanca;314;Tabera de Abajo;168;84;84
37;Salamanca;315;Tala (La);228;119;109
37;Salamanca;316;Tamames;1198;602;596
37;Salamanca;317;Tarazona de Guareña;521;283;238
37;Salamanca;318;Tardáguila;312;169;143
37;Salamanca;319;Tejado (El);242;114;128
37;Salamanca;320;Tejeda y Segoyuela;196;93;103
37;Salamanca;321;Tenebrón;281;135;146
37;Salamanca;322;Terradillos;1050;523;527
37;Salamanca;323;Topas;836;441;395
37;Salamanca;324;Tordillos;738;365;373
37;Salamanca;325;Tornadizo (El);173;88;85
37;Salamanca;327;Torresmenudas;286;140;146
37;Salamanca;328;Trabanca;304;163;141
37;Salamanca;329;Tremedal de Tormes;81;42;39
37;Salamanca;330;Valdecarros;551;276;275
37;Salamanca;331;Valdefuentes de Sangusín;387;202;185
37;Salamanca;332;Valdehijaderos;162;88;74
37;Salamanca;333;Valdelacasa;370;189;181
37;Salamanca;334;Valdelageve;171;95;76
37;Salamanca;335;Valdelosa;582;289;293
37;Salamanca;336;Valdemierque;79;42;37
37;Salamanca;337;Valderrodrigo;245;121;124
37;Salamanca;338;Valdunciel;146;70;76
37;Salamanca;339;Valero;587;294;293
37;Salamanca;343;Vallejera de Riofrío;68;25;43
37;Salamanca;340;Valsalabroso;302;153;149
37;Salamanca;341;Valverde de Valdelacasa;94;47;47
37;Salamanca;342;Valverdón;278;152;126
37;Salamanca;344;Vecinos;334;172;162
37;Salamanca;345;Vega de Tirados;257;131;126
37;Salamanca;346;Veguillas (Las);381;183;198
37;Salamanca;347;Vellés (La);523;264;259
37;Salamanca;348;Ventosa del Río Almar;190;93;97
37;Salamanca;349;Vídola (La);278;141;137
37;Salamanca;351;Villaflores;605;302;303
37;Salamanca;352;Villagonzalo de Tormes;271;149;122
37;Salamanca;353;Villalba de los Llanos;239;122;117
37;Salamanca;354;Villamayor;1041;536;505
37;Salamanca;355;Villanueva del Conde;369;183;186
37;Salamanca;356;Villar de Argañán;179;96;83
37;Salamanca;357;Villar de Ciervo;548;286;262
37;Salamanca;358;Villar de Gallimazo;360;187;173
37;Salamanca;359;Villar de la Yegua;491;249;242
37;Salamanca;360;Villar de Peralonso;470;232;238
37;Salamanca;361;Villar de Samaniego;192;103;89
37;Salamanca;362;Villares de la Reina;977;486;491
37;Salamanca;363;Villares de Yeltes;211;110;101
37;Salamanca;364;Villarino de los Aires;1484;740;744
37;Salamanca;365;Villarmayor;257;132;125
37;Salamanca;366;Villarmuerto;105;53;52
37;Salamanca;367;Villasbuenas;423;210;213
37;Salamanca;368;Villasdardo;43;21;22
37;Salamanca;369;Villaseco de los Gamitos;224;114;110
37;Salamanca;370;Villaseco de los Reyes;525;263;262
37;Salamanca;371;Villasrubias;459;235;224
37;Salamanca;372;Villaverde de Guareña;243;124;119
37;Salamanca;373;Villavieja de Yeltes;1669;816;853
37;Salamanca;374;Villoria;1492;750;742
37;Salamanca;375;Villoruela;1107;541;566
37;Salamanca;350;Vilvestre;735;367;368
37;Salamanca;376;Vitigudino;3063;1490;1573
37;Salamanca;377;Yecla de Yeltes;479;239;240
37;Salamanca;378;Zamarra;229;115;114
37;Salamanca;379;Zamayón;212;121;91
37;Salamanca;380;Zarapicos;76;32;44
37;Salamanca;381;Zarza de Pumareda (La);281;152;129
37;Salamanca;382;Zorita de la Frontera;395;208;187
38;Santa Cruz de Tenerife;001;Adeje;7471;3742;3729
38;Santa Cruz de Tenerife;002;Agulo;1464;741;723
38;Santa Cruz de Tenerife;003;Alajeró;1130;590;540
38;Santa Cruz de Tenerife;004;Arafo;3867;1882;1985
38;Santa Cruz de Tenerife;005;Arico;4243;2221;2022
38;Santa Cruz de Tenerife;006;Arona;19841;10015;9826
38;Santa Cruz de Tenerife;007;Barlovento;2628;1312;1316
38;Santa Cruz de Tenerife;008;Breña Alta;5171;2588;2583
38;Santa Cruz de Tenerife;009;Breña Baja;3252;1612;1640
38;Santa Cruz de Tenerife;010;Buenavista del Norte;5389;2740;2649
38;Santa Cruz de Tenerife;011;Candelaria;8278;4135;4143
38;Santa Cruz de Tenerife;012;Fasnia;2260;1122;1138
38;Santa Cruz de Tenerife;013;Frontera;3601;1790;1811
38;Santa Cruz de Tenerife;014;Fuencaliente de la Palma;1830;917;913
38;Santa Cruz de Tenerife;015;Garachico;6033;2979;3054
38;Santa Cruz de Tenerife;016;Garafía;2069;1042;1027
38;Santa Cruz de Tenerife;017;Granadilla de Abona;14726;7461;7265
38;Santa Cruz de Tenerife;018;Guancha (La);5135;2563;2572
38;Santa Cruz de Tenerife;019;Guía de Isora;11515;5636;5879
38;Santa Cruz de Tenerife;020;Güímar;14365;7147;7218
38;Santa Cruz de Tenerife;021;Hermigua;2724;1351;1373
38;Santa Cruz de Tenerife;022;Icod de los Vinos;21867;10828;11039
38;Santa Cruz de Tenerife;024;Llanos de Aridane (Los);15973;7888;8085
38;Santa Cruz de Tenerife;025;Matanza de Acentejo (La);5645;2901;2744
38;Santa Cruz de Tenerife;026;Orotava (La);35528;17606;17922
38;Santa Cruz de Tenerife;027;Paso (El);6794;3349;3445
38;Santa Cruz de Tenerife;028;Puerto de la Cruz;25418;12471;12947
38;Santa Cruz de Tenerife;029;Puntagorda;1692;867;825
38;Santa Cruz de Tenerife;030;Puntallana;2282;1161;1121
38;Santa Cruz de Tenerife;031;Realejos (Los);28175;13913;14262
38;Santa Cruz de Tenerife;032;Rosario (El);6154;3056;3098
38;Santa Cruz de Tenerife;033;San Andrés y Sauces;5520;2752;2768
38;Santa Cruz de Tenerife;023;San Cristóbal de La Laguna;107593;53109;54484
38;Santa Cruz de Tenerife;034;San Juan de la Rambla;4713;2354;2359
38;Santa Cruz de Tenerife;035;San Miguel de Abona;4522;2303;2219
38;Santa Cruz de Tenerife;036;San Sebastián de la Gomera;5586;2812;2774
38;Santa Cruz de Tenerife;037;Santa Cruz de la Palma;17706;8501;9205
38;Santa Cruz de Tenerife;038;Santa Cruz de Tenerife;211209;102589;108620
38;Santa Cruz de Tenerife;039;Santa Úrsula;8371;4185;4186
38;Santa Cruz de Tenerife;040;Santiago del Teide;4362;2181;2181
38;Santa Cruz de Tenerife;041;Sauzal (El);5691;2836;2855
38;Santa Cruz de Tenerife;042;Silos (Los);5448;2673;2775
38;Santa Cruz de Tenerife;043;Tacoronte;16846;8428;8418
38;Santa Cruz de Tenerife;044;Tanque (El);2756;1370;1386
38;Santa Cruz de Tenerife;045;Tazacorte;7020;3519;3501
38;Santa Cruz de Tenerife;046;Tegueste;7180;3592;3588
38;Santa Cruz de Tenerife;047;Tijarafe;2734;1393;1341
38;Santa Cruz de Tenerife;049;Valle Gran Rey;3004;1556;1448
38;Santa Cruz de Tenerife;050;Vallehermoso;3385;1676;1709
38;Santa Cruz de Tenerife;048;Valverde;3604;1791;1813
38;Santa Cruz de Tenerife;051;Victoria de Acentejo (La);7378;3742;3636
38;Santa Cruz de Tenerife;052;Vilaflor;1540;783;757
38;Santa Cruz de Tenerife;053;Villa de Mazo;5068;2540;2528
39;Cantabria;001;Alfoz de Lloredo;2918;1494;1424
39;Cantabria;002;Ampuero;3332;1661;1671
39;Cantabria;003;Anievas;487;244;243
39;Cantabria;004;Arenas de Iguña;2467;1259;1208
39;Cantabria;005;Argoños;645;320;325
39;Cantabria;006;Arnuero;1839;914;925
39;Cantabria;007;Arredondo;807;420;387
39;Cantabria;008;Astillero (El);12419;6163;6256
39;Cantabria;009;Bárcena de Cicero;2353;1186;1167
39;Cantabria;010;Bárcena de Pie de Concha;955;458;497
39;Cantabria;011;Bareyo;1626;846;780
39;Cantabria;012;Cabezón de la Sal;6464;3199;3265
39;Cantabria;013;Cabezón de Liébana;949;495;454
39;Cantabria;014;Cabuérniga;1195;596;599
39;Cantabria;015;Camaleño;1350;692;658
39;Cantabria;016;Camargo;19240;9497;9743
39;Cantabria;027;Campoo de Enmedio;4227;2163;2064
39;Cantabria;017;Campoo de Yuso;935;475;460
39;Cantabria;018;Cartes;2208;1091;1117
39;Cantabria;019;Castañeda;1626;802;824
39;Cantabria;020;Castro-Urdiales;13119;6546;6573
39;Cantabria;021;Cieza;824;412;412
39;Cantabria;022;Cillorigo de Liébana;1292;684;608
39;Cantabria;023;Colindres;5342;2681;2661
39;Cantabria;024;Comillas;2505;1196;1309
39;Cantabria;025;Corrales de Buelna (Los);9728;4851;4877
39;Cantabria;026;Corvera de Toranzo;2298;1149;1149
39;Cantabria;028;Entrambasaguas;2647;1303;1344
39;Cantabria;029;Escalante;768;377;391
39;Cantabria;030;Guriezo;1871;950;921
39;Cantabria;031;Hazas de Cesto;1381;696;685
39;Cantabria;032;Hermandad de Campoo de Suso;1968;1026;942
39;Cantabria;033;Herrerías;944;502;442
39;Cantabria;034;Lamasón;501;269;232
39;Cantabria;035;Laredo;12986;6394;6592
39;Cantabria;036;Liendo;821;423;398
39;Cantabria;037;Liérganes;2388;1179;1209
39;Cantabria;038;Limpias;1174;592;582
39;Cantabria;039;Luena;1289;677;612
39;Cantabria;040;Marina de Cudeyo;4649;2305;2344
39;Cantabria;041;Mazcuerras;1856;953;903
39;Cantabria;042;Medio Cudeyo;5592;2739;2853
39;Cantabria;043;Meruelo;876;443;433
39;Cantabria;044;Miengo;3040;1512;1528
39;Cantabria;045;Miera;791;386;405
39;Cantabria;046;Molledo;2302;1119;1183
39;Cantabria;047;Noja;1526;779;747
39;Cantabria;048;Penagos;1856;923;933
39;Cantabria;049;Peñarrubia;397;193;204
39;Cantabria;050;Pesaguero;516;277;239
39;Cantabria;051;Pesquera;119;51;68
39;Cantabria;052;Piélagos;9205;4593;4612
39;Cantabria;053;Polaciones;403;228;175
39;Cantabria;054;Polanco;3759;1817;1942
39;Cantabria;055;Potes;1483;744;739
39;Cantabria;056;Puente Viesgo;2515;1264;1251
39;Cantabria;057;Ramales de la Victoria;2501;1249;1252
39;Cantabria;058;Rasines;1110;567;543
39;Cantabria;059;Reinosa;13006;6380;6626
39;Cantabria;060;Reocín;6445;3220;3225
39;Cantabria;061;Ribamontán al Mar;2721;1398;1323
39;Cantabria;062;Ribamontán al Monte;2184;1131;1053
39;Cantabria;063;Rionansa;1845;965;880
39;Cantabria;064;Riotuerto;1671;814;857
39;Cantabria;065;Rozas de Valdearroyo (Las);291;153;138
39;Cantabria;066;Ruente;1028;526;502
39;Cantabria;067;Ruesga;1455;732;723
39;Cantabria;068;Ruiloba;798;401;397
39;Cantabria;069;San Felices de Buelna;2429;1216;1213
39;Cantabria;070;San Miguel de Aguayo;193;105;88
39;Cantabria;071;San Pedro del Romeral;1003;521;482
39;Cantabria;072;San Roque de Riomiera;649;340;309
39;Cantabria;080;San Vicente de la Barquera;4471;2303;2168
39;Cantabria;073;Santa Cruz de Bezana;4057;2030;2027
39;Cantabria;074;Santa María de Cayón;5903;2970;2933
39;Cantabria;075;Santander;187222;88876;98346
39;Cantabria;076;Santillana del Mar;3894;1913;1981
39;Cantabria;077;Santiurde de Reinosa;474;246;228
39;Cantabria;078;Santiurde de Toranzo;1881;960;921
39;Cantabria;079;Santoña;11045;5417;5628
39;Cantabria;081;Saro;612;324;288
39;Cantabria;082;Selaya;2054;1046;1008
39;Cantabria;083;Soba;2014;1075;939
39;Cantabria;084;Solórzano;1111;558;553
39;Cantabria;085;Suances;5719;2826;2893
39;Cantabria;086;Tojos (Los);446;228;218
39;Cantabria;087;Torrelavega;58885;28812;30073
39;Cantabria;088;Tresviso;95;55;40
39;Cantabria;089;Tudanca;392;217;175
39;Cantabria;090;Udías;879;433;446
39;Cantabria;095;Val de San Vicente;2623;1344;1279
39;Cantabria;091;Valdáliga;2864;1477;1387
39;Cantabria;092;Valdeolea;2165;1122;1043
39;Cantabria;093;Valdeprado del Río;461;236;225
39;Cantabria;094;Valderredible;1457;753;704
39;Cantabria;096;Vega de Liébana;1201;619;582
39;Cantabria;097;Vega de Pas;1288;660;628
39;Cantabria;098;Villacarriedo;2172;1089;1083
39;Cantabria;099;Villaescusa;2963;1462;1501
39;Cantabria;100;Villafufre;1212;613;599
39;Cantabria;101;Villaverde de Trucíos;465;247;218
39;Cantabria;102;Voto;2717;1411;1306
40;Segovia;001;Abades;952;486;466
40;Segovia;002;Adrada de Pirón;49;26;23
40;Segovia;003;Adrados;332;151;181
40;Segovia;004;Aguilafuente;826;410;416
40;Segovia;005;Alconada de Maderuelo;70;35;35
40;Segovia;012;Aldea Real;461;244;217
40;Segovia;006;Aldealcorvo;47;23;24
40;Segovia;007;Aldealengua de Pedraza;111;59;52
40;Segovia;008;Aldealengua de Santa María;119;70;49
40;Segovia;009;Aldeanueva de la Serrezuela;54;32;22
40;Segovia;010;Aldeanueva del Codonal;291;143;148
40;Segovia;013;Aldeasoña;189;90;99
40;Segovia;014;Aldehorno;109;62;47
40;Segovia;015;Aldehuela del Codonal;67;25;42
40;Segovia;016;Aldeonte;129;67;62
40;Segovia;017;Anaya;138;75;63
40;Segovia;018;Añe;142;75;67
40;Segovia;019;Arahuetes;58;30;28
40;Segovia;020;Arcones;311;164;147
40;Segovia;021;Arevalillo de Cega;37;19;18
40;Segovia;022;Armuña;368;180;188
40;Segovia;024;Ayllón;1326;664;662
40;Segovia;025;Barbolla;263;135;128
40;Segovia;026;Basardilla;102;51;51
40;Segovia;028;Bercial;186;95;91
40;Segovia;029;Bercimuel;100;42;58
40;Segovia;030;Bernardos;849;409;440
40;Segovia;031;Bernuy de Porreros;363;187;176
40;Segovia;032;Boceguillas;596;292;304
40;Segovia;033;Brieva;56;35;21
40;Segovia;034;Caballar;123;62;61
40;Segovia;035;Cabañas de Polendos;129;63;66
40;Segovia;036;Cabezuela;788;414;374
40;Segovia;037;Calabazas de Fuentidueña;132;64;68
40;Segovia;039;Campo de San Pedro;444;249;195
40;Segovia;040;Cantalejo;3619;1809;1810
40;Segovia;041;Cantimpalos;1391;699;692
40;Segovia;043;Carbonero el Mayor;2486;1248;1238
40;Segovia;044;Carrascal del Río;255;130;125
40;Segovia;045;Casla;141;69;72
40;Segovia;046;Castillejo de Mesleón;147;76;71
40;Segovia;047;Castro de Fuentidueña;127;73;54
40;Segovia;048;Castrojimeno;70;40;30
40;Segovia;049;Castroserna de Abajo;91;51;40
40;Segovia;051;Castroserracín;53;31;22
40;Segovia;052;Cedillo de la Torre;172;87;85
40;Segovia;053;Cerezo de Abajo;179;87;92
40;Segovia;054;Cerezo de Arriba;214;112;102
40;Segovia;065;Chañe;804;421;383
40;Segovia;055;Cilleruelo de San Mamés;75;41;34
40;Segovia;056;Cobos de Fuentidueña;109;50;59
40;Segovia;057;Coca;2129;1047;1082
40;Segovia;058;Codorniz;568;281;287
40;Segovia;059;Collado Hermoso;112;53;59
40;Segovia;060;Condado de Castilnovo;189;104;85
40;Segovia;061;Corral de Ayllón;148;86;62
40;Segovia;902;Cozuelos de Fuentidueña;283;140;143
40;Segovia;062;Cubillo;74;41;33
40;Segovia;063;Cuéllar;9267;4697;4570
40;Segovia;905;Cuevas de Provanco;"";"";""
40;Segovia;068;Domingo García;43;19;24
40;Segovia;069;Donhierro;123;74;49
40;Segovia;070;Duruelo;110;57;53
40;Segovia;071;Encinas;88;44;44
40;Segovia;072;Encinillas;96;46;50
40;Segovia;073;Escalona del Prado;670;332;338
40;Segovia;074;Escarabajosa de Cabezas;433;231;202
40;Segovia;075;Escobar de Polendos;276;137;139
40;Segovia;076;Espinar (El);5099;2563;2536
40;Segovia;077;Espirdo;211;126;85
40;Segovia;078;Fresneda de Cuéllar;302;158;144
40;Segovia;079;Fresno de Cantespino;243;126;117
40;Segovia;080;Fresno de la Fuente;104;55;49
40;Segovia;081;Frumales;299;148;151
40;Segovia;082;Fuente de Santa Cruz;233;120;113
40;Segovia;083;Fuente el Olmo de Fuentidueña;233;115;118
40;Segovia;084;Fuente el Olmo de Íscar;137;76;61
40;Segovia;086;Fuentepelayo;1085;561;524
40;Segovia;087;Fuentepiñel;218;107;111
40;Segovia;088;Fuenterrebollo;544;269;275
40;Segovia;089;Fuentesaúco de Fuentidueña;431;222;209
40;Segovia;091;Fuentesoto;222;112;110
40;Segovia;092;Fuentidueña;260;125;135
40;Segovia;093;Gallegos;121;61;60
40;Segovia;094;Garcillán;361;194;167
40;Segovia;095;Gomezserracín;675;347;328
40;Segovia;097;Grajera;79;41;38
40;Segovia;099;Honrubia de la Cuesta;117;62;55
40;Segovia;100;Hontalbilla;601;316;285
40;Segovia;101;Hontanares de Eresma;143;76;67
40;Segovia;103;Huertos (Los);173;87;86
40;Segovia;104;Ituero y Lama;54;29;25
40;Segovia;105;Juarros de Riomoros;104;52;52
40;Segovia;106;Juarros de Voltoya;340;184;156
40;Segovia;107;Labajos;198;105;93
40;Segovia;108;Laguna de Contreras;254;133;121
40;Segovia;109;Languilla;189;96;93
40;Segovia;110;Lastras de Cuéllar;692;360;332
40;Segovia;111;Lastras del Pozo;126;64;62
40;Segovia;112;Lastrilla (La);467;230;237
40;Segovia;113;Losa (La);271;136;135
40;Segovia;115;Maderuelo;188;92;96
40;Segovia;903;Marazoleja;199;109;90
40;Segovia;118;Marazuela;102;53;49
40;Segovia;119;Martín Miguel;230;111;119
40;Segovia;120;Martín Muñoz de la Dehesa;181;98;83
40;Segovia;121;Martín Muñoz de las Posadas;696;352;344
40;Segovia;122;Marugán;232;124;108
40;Segovia;124;Mata de Cuéllar;356;189;167
40;Segovia;123;Matabuena;232;115;117
40;Segovia;125;Matilla (La);136;72;64
40;Segovia;126;Melque de Cercos;197;97;100
40;Segovia;127;Membibre de la Hoz;116;59;57
40;Segovia;128;Migueláñez;207;103;104
40;Segovia;129;Montejo de Arévalo;368;208;160
40;Segovia;130;Montejo de la Vega de la Serrezuela;237;122;115
40;Segovia;131;Monterrubio;88;40;48
40;Segovia;132;Moral de Hornuez;169;86;83
40;Segovia;134;Mozoncillo;1119;575;544
40;Segovia;135;Muñopedro;498;257;241
40;Segovia;136;Muñoveros;260;135;125
40;Segovia;138;Nava de la Asunción;2660;1368;1292
40;Segovia;139;Navafría;450;239;211
40;Segovia;140;Navalilla;238;119;119
40;Segovia;141;Navalmanzano;1246;639;607
40;Segovia;142;Navares de Ayuso;92;49;43
40;Segovia;143;Navares de Enmedio;218;108;110
40;Segovia;144;Navares de las Cuevas;37;19;18
40;Segovia;145;Navas de Oro;1612;808;804
40;Segovia;904;Navas de Riofrío;197;89;108
40;Segovia;146;Navas de San Antonio;357;190;167
40;Segovia;148;Nieva;406;204;202
40;Segovia;149;Olombrada;986;527;459
40;Segovia;150;Orejana;132;70;62
40;Segovia;151;Ortigosa de Pestaño;115;62;53
40;Segovia;901;Ortigosa del Monte;285;146;139
40;Segovia;152;Otero de Herreros;856;432;424
40;Segovia;154;Pajarejos;51;23;28
40;Segovia;155;Palazuelos de Eresma;1060;549;511
40;Segovia;156;Pedraza;464;225;239
40;Segovia;157;Pelayos del Arroyo;64;34;30
40;Segovia;158;Perosillo;35;21;14
40;Segovia;159;Pinarejos;273;147;126
40;Segovia;160;Pinarnegrillo;231;117;114
40;Segovia;161;Pradales;70;39;31
40;Segovia;162;Prádena;597;299;298
40;Segovia;163;Puebla de Pedraza;116;59;57
40;Segovia;164;Rapariegos;324;171;153
40;Segovia;165;Rebollo;165;92;73
40;Segovia;166;Remondo;412;203;209
40;Segovia;168;Riaguas de San Bartolomé;101;56;45
40;Segovia;170;Riaza;1496;787;709
40;Segovia;171;Ribota;54;27;27
40;Segovia;172;Riofrío de Riaza;65;36;29
40;Segovia;173;Roda de Eresma;106;50;56
40;Segovia;174;Sacramenia;974;510;464
40;Segovia;176;Samboal;809;415;394
40;Segovia;177;San Cristóbal de Cuéllar;319;157;162
40;Segovia;178;San Cristóbal de la Vega;209;102;107
40;Segovia;906;San Cristóbal de Segovia;"";"";""
40;Segovia;181;San Ildefonso;4914;2397;2517
40;Segovia;182;San Martín y Mudrián;400;203;197
40;Segovia;183;San Miguel de Bernuy;249;128;121
40;Segovia;184;San Pedro de Gaíllos;329;170;159
40;Segovia;179;Sanchonuño;767;380;387
40;Segovia;180;Sangarcía;598;309;289
40;Segovia;185;Santa María la Real de Nieva;1767;882;885
40;Segovia;186;Santa Marta del Cerro;66;33;33
40;Segovia;188;Santiuste de Pedraza;153;80;73
40;Segovia;189;Santiuste de San Juan Bautista;935;471;464
40;Segovia;190;Santo Domingo de Pirón;59;29;30
40;Segovia;191;Santo Tomé del Puerto;413;208;205
40;Segovia;192;Sauquillo de Cabezas;288;152;136
40;Segovia;193;Sebúlcor;268;144;124
40;Segovia;194;Segovia;53849;25953;27896
40;Segovia;195;Sepúlveda;1520;770;750
40;Segovia;196;Sequera de Fresno;86;48;38
40;Segovia;198;Sotillo;79;37;42
40;Segovia;199;Sotosalbos;111;55;56
40;Segovia;200;Tabanera la Luenga;102;55;47
40;Segovia;201;Tolocirio;85;42;43
40;Segovia;206;Torre Val de San Pedro;184;97;87
40;Segovia;202;Torreadrada;199;100;99
40;Segovia;203;Torrecaballeros;236;113;123
40;Segovia;204;Torrecilla del Pinar;434;205;229
40;Segovia;205;Torreiglesias;461;249;212
40;Segovia;207;Trescasas;174;95;79
40;Segovia;208;Turégano;1209;596;613
40;Segovia;210;Urueñas;184;99;85
40;Segovia;211;Valdeprados;56;25;31
40;Segovia;212;Valdevacas de Montejo;51;29;22
40;Segovia;213;Valdevacas y Guijar;183;101;82
40;Segovia;218;Valle de Tabladillo;249;130;119
40;Segovia;219;Vallelado;928;470;458
40;Segovia;220;Valleruela de Pedraza;78;44;34
40;Segovia;221;Valleruela de Sepúlveda;97;50;47
40;Segovia;214;Valseca;354;180;174
40;Segovia;215;Valtiendas;295;158;137
40;Segovia;216;Valverde del Majano;539;274;265
40;Segovia;222;Veganzones;367;182;185
40;Segovia;223;Vegas de Matute;302;160;142
40;Segovia;224;Ventosilla y Tejadilla;32;17;15
40;Segovia;225;Villacastín;1667;869;798
40;Segovia;228;Villaverde de Íscar;813;415;398
40;Segovia;229;Villaverde de Montejo;104;53;51
40;Segovia;230;Villeguillo;161;89;72
40;Segovia;231;Yanguas de Eresma;235;106;129
40;Segovia;233;Zarzuela del Monte;566;289;277
40;Segovia;234;Zarzuela del Pinar;702;371;331
41;Sevilla;001;Aguadulce;1947;973;974
41;Sevilla;002;Alanís;2221;1119;1102
41;Sevilla;003;Albaida del Aljarafe;1694;864;830
41;Sevilla;004;Alcalá de Guadaira;50567;25212;25355
41;Sevilla;005;Alcalá del Río;8910;4556;4354
41;Sevilla;006;Alcolea del Río;3489;1703;1786
41;Sevilla;007;Algaba (La);12231;6143;6088
41;Sevilla;008;Algámitas;1582;812;770
41;Sevilla;009;Almadén de la Plata;1920;985;935
41;Sevilla;010;Almensilla;1655;815;840
41;Sevilla;011;Arahal;17239;8556;8683
41;Sevilla;012;Aznalcázar;3090;1557;1533
41;Sevilla;013;Aznalcóllar;5417;2751;2666
41;Sevilla;014;Badolatosa;3160;1594;1566
41;Sevilla;015;Benacazón;4648;2339;2309
41;Sevilla;016;Bollullos de la Mitación;4306;2136;2170
41;Sevilla;017;Bormujos;4925;2414;2511
41;Sevilla;018;Brenes;9921;4997;4924
41;Sevilla;019;Burguillos;3128;1577;1551
41;Sevilla;020;Cabezas de San Juan (Las);14728;7564;7164
41;Sevilla;021;Camas;25427;12509;12918
41;Sevilla;022;Campana (La);5456;2784;2672
41;Sevilla;023;Cantillana;8824;4415;4409
41;Sevilla;901;Cañada Rosal;2702;1354;1348
41;Sevilla;024;Carmona;24029;12056;11973
41;Sevilla;025;Carrión de los Céspedes;2463;1194;1269
41;Sevilla;026;Casariche;4880;2488;2392
41;Sevilla;027;Castilblanco de los Arroyos;3786;1922;1864
41;Sevilla;028;Castilleja de Guzmán;222;109;113
41;Sevilla;029;Castilleja de la Cuesta;13709;6788;6921
41;Sevilla;030;Castilleja del Campo;612;306;306
41;Sevilla;031;Castillo de las Guardas (El);1840;946;894
41;Sevilla;032;Cazalla de la Sierra;5371;2700;2671
41;Sevilla;033;Constantina;7882;3892;3990
41;Sevilla;034;Coria del Río;21537;10752;10785
41;Sevilla;035;Coripe;1855;962;893
41;Sevilla;036;Coronil (El);5217;2688;2529
41;Sevilla;037;Corrales (Los);3861;1985;1876
41;Sevilla;903;Cuervo de Sevilla (El);"";"";""
41;Sevilla;038;Dos Hermanas;67330;33211;34119
41;Sevilla;039;Écija;35434;17509;17925
41;Sevilla;040;Espartinas;2345;1210;1135
41;Sevilla;041;Estepa;10553;5185;5368
41;Sevilla;042;Fuentes de Andalucía;7630;3807;3823
41;Sevilla;043;Garrobo (El);747;371;376
41;Sevilla;044;Gelves;3711;1782;1929
41;Sevilla;045;Gerena;5067;2536;2531
41;Sevilla;046;Gilena;3717;1860;1857
41;Sevilla;047;Gines;4834;2374;2460
41;Sevilla;048;Guadalcanal;3303;1635;1668
41;Sevilla;049;Guillena;7614;3865;3749
41;Sevilla;050;Herrera;5500;2719;2781
41;Sevilla;051;Huévar del Aljarafe;2110;1099;1011
41;Sevilla;052;Lantejuela (La);3240;1670;1570
41;Sevilla;053;Lebrija;28313;14372;13941
41;Sevilla;054;Lora de Estepa;669;338;331
41;Sevilla;055;Lora del Río;19113;9435;9678
41;Sevilla;056;Luisiana (La);4075;2087;1988
41;Sevilla;057;Madroño (El);464;245;219
41;Sevilla;058;Mairena del Alcor;13839;6904;6935
41;Sevilla;059;Mairena del Aljarafe;16916;8487;8429
41;Sevilla;060;Marchena;17387;8525;8862
41;Sevilla;061;Marinaleda;2405;1193;1212
41;Sevilla;062;Martín de la Jara;2714;1436;1278
41;Sevilla;063;Molares (Los);2681;1369;1312
41;Sevilla;064;Montellano;7052;3566;3486
41;Sevilla;065;Morón de la Frontera;28653;14314;14339
41;Sevilla;066;Navas de la Concepción (Las);2131;1058;1073
41;Sevilla;067;Olivares;6275;3232;3043
41;Sevilla;068;Osuna;16807;8313;8494
41;Sevilla;069;Palacios y Villafranca (Los);28244;14338;13906
41;Sevilla;070;Palomares del Río;1771;910;861
41;Sevilla;071;Paradas;7191;3612;3579
41;Sevilla;072;Pedrera;4716;2388;2328
41;Sevilla;073;Pedroso (El);2476;1217;1259
41;Sevilla;074;Peñaflor;4051;2062;1989
41;Sevilla;075;Pilas;10222;4953;5269
41;Sevilla;076;Pruna;3920;2020;1900
41;Sevilla;077;Puebla de Cazalla (La);10572;5361;5211
41;Sevilla;078;Puebla de los Infantes (La);3949;1994;1955
41;Sevilla;079;Puebla del Río (La);15495;7831;7664
41;Sevilla;080;Real de la Jara (El);1841;934;907
41;Sevilla;081;Rinconada (La);20289;10305;9984
41;Sevilla;082;Roda de Andalucía (La);4072;2027;2045
41;Sevilla;083;Ronquillo (El);1417;712;705
41;Sevilla;084;Rubio (El);3847;1946;1901
41;Sevilla;085;Salteras;2327;1164;1163
41;Sevilla;086;San Juan de Aznalfarache;21241;10472;10769
41;Sevilla;088;San Nicolás del Puerto;747;391;356
41;Sevilla;087;Sanlúcar la Mayor;8729;4368;4361
41;Sevilla;089;Santiponce;6142;3057;3085
41;Sevilla;090;Saucejo (El);4081;2070;2011
41;Sevilla;091;Sevilla;655435;313409;342026
41;Sevilla;092;Tocina;8336;4136;4200
41;Sevilla;093;Tomares;9217;4550;4667
41;Sevilla;094;Umbrete;4052;2036;2016
41;Sevilla;095;Utrera;41021;20561;20460
41;Sevilla;096;Valencina de la Concepción;3886;1974;1912
41;Sevilla;902;Villafranco del Guadalquivir;"";"";""
41;Sevilla;097;Villamanrique de la Condesa;3472;1735;1737
41;Sevilla;100;Villanueva de San Juan;1846;929;917
41;Sevilla;098;Villanueva del Ariscal;3721;1759;1962
41;Sevilla;099;Villanueva del Río y Minas;5841;2836;3005
41;Sevilla;101;Villaverde del Río;6156;3149;3007
41;Sevilla;102;Viso del Alcor (El);14757;7502;7255
42;Soria;001;Abejar;375;195;180
42;Soria;003;Adradas;143;75;68
42;Soria;004;Ágreda;3710;1794;1916
42;Soria;006;Alconaba;159;89;70
42;Soria;007;Alcubilla de Avellaneda;307;160;147
42;Soria;008;Alcubilla de las Peñas;130;64;66
42;Soria;009;Aldealafuente;179;85;94
42;Soria;010;Aldealices;40;19;21
42;Soria;011;Aldealpozo;30;14;16
42;Soria;012;Aldealseñor;59;31;28
42;Soria;013;Aldehuela de Periáñez;54;28;26
42;Soria;014;Aldehuelas (Las);184;95;89
42;Soria;015;Alentisque;69;38;31
42;Soria;016;Aliud;64;29;35
42;Soria;017;Almajano;204;100;104
42;Soria;018;Almaluez;453;225;228
42;Soria;019;Almarza;655;343;312
42;Soria;020;Almazán;5810;2916;2894
42;Soria;021;Almazul;251;123;128
42;Soria;022;Almenar de Soria;507;261;246
42;Soria;023;Alpanseque;172;94;78
42;Soria;024;Arancón;121;66;55
42;Soria;025;Arcos de Jalón;2436;1226;1210
42;Soria;026;Arenillas;55;28;27
42;Soria;027;Arévalo de la Sierra;162;88;74
42;Soria;028;Ausejo de la Sierra;73;39;34
42;Soria;029;Baraona;362;186;176
42;Soria;030;Barca;203;109;94
42;Soria;031;Barcones;71;40;31
42;Soria;032;Bayubas de Abajo;355;192;163
42;Soria;033;Bayubas de Arriba;106;55;51
42;Soria;034;Beratón;53;32;21
42;Soria;035;Berlanga de Duero;1516;759;757
42;Soria;036;Blacos;94;54;40
42;Soria;037;Bliecos;75;39;36
42;Soria;038;Borjabad;81;42;39
42;Soria;039;Borobia;502;251;251
42;Soria;041;Buberos;64;30;34
42;Soria;042;Buitrago;54;30;24
42;Soria;043;Burgo de Osma-Ciudad de Osma;5070;2484;2586
42;Soria;044;Cabrejas del Campo;102;56;46
42;Soria;045;Cabrejas del Pinar;542;292;250
42;Soria;046;Calatañazor;82;43;39
42;Soria;048;Caltojar;204;104;100
42;Soria;049;Candilichera;276;143;133
42;Soria;050;Cañamaque;79;41;38
42;Soria;051;Carabantes;54;29;25
42;Soria;052;Caracena;11;7;4
42;Soria;053;Carrascosa de Abajo;56;30;26
42;Soria;054;Carrascosa de la Sierra;27;12;15
42;Soria;055;Casarejos;325;164;161
42;Soria;056;Castilfrío de la Sierra;42;21;21
42;Soria;058;Castillejo de Robledo;281;157;124
42;Soria;057;Castilruiz;457;236;221
42;Soria;059;Centenera de Andaluz;48;23;25
42;Soria;060;Cerbón;94;53;41
42;Soria;061;Cidones;345;177;168
42;Soria;062;Cigudosa;114;62;52
42;Soria;063;Cihuela;137;70;67
42;Soria;064;Ciria;117;59;58
42;Soria;065;Cirujales del Río;44;23;21
42;Soria;068;Coscurita;205;116;89
42;Soria;069;Covaleda;2213;1148;1065
42;Soria;070;Cubilla;119;67;52
42;Soria;071;Cubo de la Solana;415;210;205
42;Soria;073;Cueva de Ágreda;157;80;77
42;Soria;075;Dévanos;196;100;96
42;Soria;076;Deza;550;282;268
42;Soria;078;Duruelo de la Sierra;1568;803;765
42;Soria;079;Escobosa de Almazán;58;30;28
42;Soria;080;Espeja de San Marcelino;354;192;162
42;Soria;081;Espejón;259;134;125
42;Soria;082;Estepa de San Juan;20;9;11
42;Soria;083;Frechilla de Almazán;69;36;33
42;Soria;084;Fresno de Caracena;71;39;32
42;Soria;085;Fuentearmegil;498;259;239
42;Soria;086;Fuentecambrón;98;55;43
42;Soria;087;Fuentecantos;56;25;31
42;Soria;088;Fuentelmonge;201;98;103
42;Soria;089;Fuentelsaz de Soria;78;40;38
42;Soria;090;Fuentepinilla;218;110;108
42;Soria;092;Fuentes de Magaña;166;81;85
42;Soria;093;Fuentestrún;112;62;50
42;Soria;094;Garray;331;168;163
42;Soria;095;Golmayo;551;295;256
42;Soria;096;Gómara;680;332;348
42;Soria;097;Gormaz;41;19;22
42;Soria;098;Herrera de Soria;48;26;22
42;Soria;100;Hinojosa del Campo;72;42;30
42;Soria;103;Langa de Duero;1191;619;572
42;Soria;105;Liceras;84;41;43
42;Soria;106;Losilla (La);29;17;12
42;Soria;107;Magaña;137;73;64
42;Soria;108;Maján;35;18;17
42;Soria;110;Matalebreras;173;92;81
42;Soria;111;Matamala de Almazán;554;289;265
42;Soria;113;Medinaceli;929;474;455
42;Soria;115;Miño de Medinaceli;189;89;100
42;Soria;116;Miño de San Esteban;148;81;67
42;Soria;117;Molinos de Duero;216;104;112
42;Soria;118;Momblona;63;36;27
42;Soria;119;Monteagudo de las Vicarías;408;200;208
42;Soria;120;Montejo de Tiermes;330;176;154
42;Soria;121;Montenegro de Cameros;141;74;67
42;Soria;123;Morón de Almazán;400;189;211
42;Soria;124;Muriel de la Fuente;109;59;50
42;Soria;125;Muriel Viejo;119;63;56
42;Soria;127;Nafría de Ucero;123;61;62
42;Soria;128;Narros;65;36;29
42;Soria;129;Navaleno;925;458;467
42;Soria;130;Nepas;122;70;52
42;Soria;131;Nolay;121;66;55
42;Soria;132;Noviercas;317;151;166
42;Soria;134;Ólvega;3301;1696;1605
42;Soria;135;Oncala;145;85;60
42;Soria;139;Pinilla del Campo;35;19;16
42;Soria;140;Portillo de Soria;25;15;10
42;Soria;141;Póveda de Soria (La);186;94;92
42;Soria;142;Pozalmuro;147;71;76
42;Soria;144;Quintana Redonda;781;403;378
42;Soria;145;Quintanas de Gormaz;245;118;127
42;Soria;148;Quiñonería;28;12;16
42;Soria;149;Rábanos (Los);486;275;211
42;Soria;151;Rebollar;53;30;23
42;Soria;152;Recuerda;215;110;105
42;Soria;153;Rello;67;27;40
42;Soria;154;Renieblas;133;71;62
42;Soria;155;Retortillo de Soria;318;176;142
42;Soria;156;Reznos;62;32;30
42;Soria;157;Riba de Escalote (La);45;27;18
42;Soria;158;Rioseco de Soria;176;94;82
42;Soria;159;Rollamienta;50;27;23
42;Soria;160;Royo (El);413;195;218
42;Soria;161;Salduero;237;128;109
42;Soria;162;San Esteban de Gormaz;3746;1923;1823
42;Soria;163;San Felices;119;65;54
42;Soria;164;San Leonardo de Yagüe;2140;1076;1064
42;Soria;165;San Pedro Manrique;553;274;279
42;Soria;166;Santa Cruz de Yanguas;71;44;27
42;Soria;167;Santa María de Huerta;579;281;298
42;Soria;168;Santa María de las Hoyas;262;136;126
42;Soria;171;Serón de Nágima;351;172;179
42;Soria;172;Soliedra;47;27;20
42;Soria;173;Soria;31507;15060;16447
42;Soria;174;Sotillo del Rincón;198;100;98
42;Soria;175;Suellacabras;60;26;34
42;Soria;176;Tajahuerce;55;29;26
42;Soria;177;Tajueco;170;93;77
42;Soria;178;Talveila;264;139;125
42;Soria;181;Tardelcuende;763;363;400
42;Soria;182;Taroda;122;63;59
42;Soria;183;Tejado;290;149;141
42;Soria;184;Torlengua;163;76;87
42;Soria;185;Torreblacos;66;28;38
42;Soria;187;Torrubia de Soria;124;70;54
42;Soria;188;Trévago;103;52;51
42;Soria;189;Ucero;102;53;49
42;Soria;190;Vadillo;188;97;91
42;Soria;191;Valdeavellano de Tera;250;126;124
42;Soria;192;Valdegeña;69;36;33
42;Soria;193;Valdelagua del Cerro;60;29;31
42;Soria;194;Valdemaluque;395;200;195
42;Soria;195;Valdenebro;220;115;105
42;Soria;196;Valdeprado;35;15;20
42;Soria;197;Valderrodilla;165;79;86
42;Soria;198;Valtajeros;46;24;22
42;Soria;200;Velamazán;203;111;92
42;Soria;201;Velilla de la Sierra;16;8;8
42;Soria;202;Velilla de los Ajos;77;38;39
42;Soria;204;Viana de Duero;115;60;55
42;Soria;205;Villaciervos;115;58;57
42;Soria;206;Villanueva de Gormaz;23;13;10
42;Soria;207;Villar del Ala;46;19;27
42;Soria;208;Villar del Campo;58;29;29
42;Soria;209;Villar del Río;228;117;111
42;Soria;211;Villares de Soria (Los);124;59;65
42;Soria;212;Villasayas;141;80;61
42;Soria;213;Villaseca de Arciel;63;32;31
42;Soria;215;Vinuesa;1170;616;554
42;Soria;216;Vizmanos;49;31;18
42;Soria;217;Vozmediano;70;36;34
42;Soria;218;Yanguas;102;52;50
42;Soria;219;Yelo;107;51;56
43;Tarragona;001;Aiguamúrcia;602;319;283
43;Tarragona;002;Albinyana;640;331;309
43;Tarragona;003;Albiol (L');79;42;37
43;Tarragona;004;Alcanar;8046;3940;4106
43;Tarragona;005;Alcover;3485;1740;1745
43;Tarragona;904;Aldea (L');3411;1828;1583
43;Tarragona;006;Aldover;850;406;444
43;Tarragona;007;Aleixar (L');637;315;322
43;Tarragona;008;Alfara de Carles;432;219;213
43;Tarragona;009;Alforja;1089;535;554
43;Tarragona;010;Alió;350;182;168
43;Tarragona;011;Almoster;382;190;192
43;Tarragona;012;Altafulla;1472;747;725
43;Tarragona;013;Ametlla de Mar (L');4162;2079;2083
43;Tarragona;906;Ampolla (L');"";"";""
43;Tarragona;014;Amposta;15350;7660;7690
43;Tarragona;016;Arboç (L');3735;1880;1855
43;Tarragona;015;Arbolí;129;64;65
43;Tarragona;017;Argentera (L');152;71;81
43;Tarragona;018;Arnes;558;282;276
43;Tarragona;019;Ascó;1842;930;912
43;Tarragona;020;Banyeres del Penedès;1561;819;742
43;Tarragona;021;Barberà de la Conca;436;219;217
43;Tarragona;022;Batea;2068;1046;1022
43;Tarragona;023;Bellmunt del Priorat;333;166;167
43;Tarragona;024;Bellvei;927;480;447
43;Tarragona;025;Benifallet;1018;503;515
43;Tarragona;026;Benissanet;1079;523;556
43;Tarragona;027;Bisbal de Falset (La);312;158;154
43;Tarragona;028;Bisbal del Penedès (La);1306;660;646
43;Tarragona;029;Blancafort;427;211;216
43;Tarragona;030;Bonastre;284;140;144
43;Tarragona;031;Borges del Camp (Les);1370;685;685
43;Tarragona;032;Bot;984;497;487
43;Tarragona;033;Botarell;441;219;222
43;Tarragona;034;Bràfim;595;281;314
43;Tarragona;035;Cabacés;367;184;183
43;Tarragona;036;Cabra del Camp;421;218;203
43;Tarragona;037;Calafell;6025;3015;3010
43;Tarragona;903;Camarles;2911;1474;1437
43;Tarragona;038;Cambrils;13824;6927;6897
43;Tarragona;039;Capafonts;104;52;52
43;Tarragona;040;Capçanes;429;197;232
43;Tarragona;041;Caseres;341;170;171
43;Tarragona;042;Castellvell del Camp;712;351;361
43;Tarragona;043;Catllar (El);891;450;441
43;Tarragona;045;Colldejou;206;104;102
43;Tarragona;046;Conesa;136;63;73
43;Tarragona;047;Constantí;5674;2935;2739
43;Tarragona;048;Corbera d'Ebre;1123;579;544
43;Tarragona;049;Cornudella de Montsant;939;477;462
43;Tarragona;050;Creixell;661;331;330
43;Tarragona;051;Cunit;1430;718;712
43;Tarragona;901;Deltebre;10213;5171;5042
43;Tarragona;053;Duesaigües;216;115;101
43;Tarragona;054;Espluga de Francolí (L');3711;1797;1914
43;Tarragona;055;Falset;2615;1267;1348
43;Tarragona;056;Fatarella (La);1432;731;701
43;Tarragona;057;Febró (La);43;22;21
43;Tarragona;058;Figuera (La);141;68;73
43;Tarragona;059;Figuerola del Camp;229;116;113
43;Tarragona;060;Flix;5011;2529;2482
43;Tarragona;061;Forès;66;31;35
43;Tarragona;062;Freginals;407;199;208
43;Tarragona;063;Galera (La);796;384;412
43;Tarragona;064;Gandesa;2722;1368;1354
43;Tarragona;065;Garcia;598;291;307
43;Tarragona;066;Garidells (Els);185;91;94
43;Tarragona;067;Ginestar;934;469;465
43;Tarragona;068;Godall;796;376;420
43;Tarragona;069;Gratallops;267;129;138
43;Tarragona;070;Guiamets (Els);302;156;146
43;Tarragona;071;Horta de Sant Joan;1396;699;697
43;Tarragona;072;Lloar (El);166;83;83
43;Tarragona;073;Llorac;103;46;57
43;Tarragona;074;Llorenç del Penedès;1225;594;631
43;Tarragona;076;Marçà;608;289;319
43;Tarragona;075;Margalef;167;86;81
43;Tarragona;077;Mas de Barberans;777;383;394
43;Tarragona;078;Masdenverge;930;475;455
43;Tarragona;079;Masllorenç;390;191;199
43;Tarragona;080;Masó (La);285;138;147
43;Tarragona;081;Maspujols;378;194;184
43;Tarragona;082;Masroig (El);600;294;306
43;Tarragona;083;Milà (El);153;66;87
43;Tarragona;084;Miravet;844;437;407
43;Tarragona;085;Molar (El);346;172;174
43;Tarragona;086;Montblanc;5679;2817;2862
43;Tarragona;088;Montbrió del Camp;1428;717;711
43;Tarragona;089;Montferri;156;77;79
43;Tarragona;090;Montmell (El);239;122;117
43;Tarragona;091;Mont-ral;177;87;90
43;Tarragona;092;Mont-roig del Camp;4837;2448;2389
43;Tarragona;093;Móra d'Ebre;4255;2083;2172
43;Tarragona;094;Móra la Nova;2856;1428;1428
43;Tarragona;095;Morell (El);2234;1126;1108
43;Tarragona;096;Morera de Montsant (La);188;90;98
43;Tarragona;097;Nou de Gaià (La);368;199;169
43;Tarragona;098;Nulles;372;176;196
43;Tarragona;100;Pallaresos (Els);475;253;222
43;Tarragona;099;Palma d'Ebre (La);481;224;257
43;Tarragona;101;Passanant;212;111;101
43;Tarragona;102;Paüls;753;378;375
43;Tarragona;103;Perafort;503;263;240
43;Tarragona;104;Perelló (El);3751;1898;1853
43;Tarragona;105;Piles (Les);132;73;59
43;Tarragona;106;Pinell de Brai (El);1244;642;602
43;Tarragona;107;Pira;350;172;178
43;Tarragona;108;Pla de Santa Maria (El);1501;760;741
43;Tarragona;109;Pobla de Mafumet (La);824;406;418
43;Tarragona;110;Pobla de Massaluca (La);500;260;240
43;Tarragona;111;Pobla de Montornès (La);791;405;386
43;Tarragona;112;Poboleda;386;192;194
43;Tarragona;113;Pont d'Armentera (El);599;283;316
43;Tarragona;141;Pontils;124;59;65
43;Tarragona;114;Porrera;469;240;229
43;Tarragona;115;Pradell de la Teixeta;277;143;134
43;Tarragona;116;Prades;540;279;261
43;Tarragona;117;Prat de Comte;232;107;125
43;Tarragona;118;Pratdip;478;227;251
43;Tarragona;119;Puigpelat;439;217;222
43;Tarragona;120;Querol;209;108;101
43;Tarragona;121;Rasquera;906;476;430
43;Tarragona;122;Renau;47;27;20
43;Tarragona;123;Reus;81816;40021;41795
43;Tarragona;124;Riba (La);996;492;504
43;Tarragona;125;Riba-roja d'Ebre;1784;931;853
43;Tarragona;126;Riera de Gaià (La);945;443;502
43;Tarragona;127;Riudecanyes;578;292;286
43;Tarragona;128;Riudecols;931;485;446
43;Tarragona;129;Riudoms;4794;2387;2407
43;Tarragona;130;Rocafort de Queralt;284;152;132
43;Tarragona;131;Roda de Barà;1767;898;869
43;Tarragona;132;Rodonyà;369;192;177
43;Tarragona;133;Roquetes;5813;2872;2941
43;Tarragona;134;Rourell (El);284;155;129
43;Tarragona;135;Salomó;457;230;227
43;Tarragona;905;Salou;"";"";""
43;Tarragona;136;Sant Carles de la Ràpita;10343;5141;5202
43;Tarragona;137;Sant Jaume dels Domenys;1156;584;572
43;Tarragona;902;Sant Jaume d'Enveja;3476;1764;1712
43;Tarragona;138;Santa Bàrbara;3327;1631;1696
43;Tarragona;139;Santa Coloma de Queralt;2615;1263;1352
43;Tarragona;140;Santa Oliva;1320;682;638
43;Tarragona;142;Sarral;1383;691;692
43;Tarragona;143;Savallà del Comtat;60;28;32
43;Tarragona;144;Secuita (La);942;463;479
43;Tarragona;145;Selva del Camp (La);3369;1659;1710
43;Tarragona;146;Senan;29;20;9
43;Tarragona;044;Sénia (La);4677;2352;2325
43;Tarragona;147;Solivella;743;345;398
43;Tarragona;148;Tarragona;107356;52735;54621
43;Tarragona;149;Tivenys;1104;544;560
43;Tarragona;150;Tivissa;1836;901;935
43;Tarragona;151;Torre de Fontaubella (La);77;35;42
43;Tarragona;152;Torre de l'Espanyol (La);739;368;371
43;Tarragona;153;Torredembarra;5954;2968;2986
43;Tarragona;154;Torroja del Priorat;147;74;73
43;Tarragona;155;Tortosa;28862;13909;14953
43;Tarragona;156;Ulldecona;5210;2538;2672
43;Tarragona;157;Ulldemolins;560;293;267
43;Tarragona;158;Vallclara;108;55;53
43;Tarragona;159;Vallfogona de Riucorb;116;60;56
43;Tarragona;160;Vallmoll;995;507;488
43;Tarragona;161;Valls;19602;9688;9914
43;Tarragona;162;Vandellòs i l'Hospitalet de l'Infant;4384;2235;2149
43;Tarragona;163;Vendrell (El);13616;6738;6878
43;Tarragona;164;Vespella de Gaià;69;36;33
43;Tarragona;165;Vilabella;816;389;427
43;Tarragona;175;Vilalba dels Arcs;808;432;376
43;Tarragona;166;Vilallonga del Camp;1177;575;602
43;Tarragona;168;Vilanova de Prades;169;84;85
43;Tarragona;167;Vilanova d'Escornalbou;453;220;233
43;Tarragona;169;Vilaplana;514;262;252
43;Tarragona;170;Vila-rodona;1031;534;497
43;Tarragona;171;Vila-seca;17758;8923;8835
43;Tarragona;172;Vilaverd;384;191;193
43;Tarragona;173;Vilella Alta (La);142;72;70
43;Tarragona;174;Vilella Baixa (La);190;97;93
43;Tarragona;176;Vimbodí;1148;586;562
43;Tarragona;177;Vinebre;467;227;240
43;Tarragona;178;Vinyols i els Arcs;830;445;385
43;Tarragona;052;Xerta;1286;619;667
44;Teruel;001;Ababuj;97;58;39
44;Teruel;002;Abejuela;91;48;43
44;Teruel;003;Aguatón;40;21;19
44;Teruel;004;Aguaviva;655;329;326
44;Teruel;005;Aguilar del Alfambra;116;55;61
44;Teruel;006;Alacón;526;268;258
44;Teruel;007;Alba;366;189;177
44;Teruel;008;Albalate del Arzobispo;2670;1293;1377
44;Teruel;009;Albarracín;1121;561;560
44;Teruel;010;Albentosa;307;149;158
44;Teruel;011;Alcaine;35;22;13
44;Teruel;012;Alcalá de la Selva;512;272;240
44;Teruel;013;Alcañiz;11895;5832;6063
44;Teruel;014;Alcorisa;3176;1607;1569
44;Teruel;016;Alfambra;878;440;438
44;Teruel;017;Aliaga;519;268;251
44;Teruel;021;Allepuz;197;106;91
44;Teruel;022;Alloza;986;482;504
44;Teruel;023;Allueva;10;6;4
44;Teruel;018;Almohaja;34;18;16
44;Teruel;019;Alobras;135;71;64
44;Teruel;020;Alpeñés;33;21;12
44;Teruel;024;Anadón;33;16;17
44;Teruel;025;Andorra;8858;4593;4265
44;Teruel;026;Arcos de las Salinas;180;99;81
44;Teruel;027;Arens de Lledó;288;136;152
44;Teruel;028;Argente;341;164;177
44;Teruel;029;Ariño;956;492;464
44;Teruel;031;Azaila;292;160;132
44;Teruel;032;Bádenas;34;17;17
44;Teruel;033;Báguena;679;331;348
44;Teruel;034;Bañón;252;130;122
44;Teruel;035;Barrachina;221;113;108
44;Teruel;036;Bea;29;17;12
44;Teruel;037;Beceite;717;377;340
44;Teruel;039;Bello;540;250;290
44;Teruel;038;Belmonte de San José;205;102;103
44;Teruel;040;Berge;271;137;134
44;Teruel;041;Bezas;72;39;33
44;Teruel;042;Blancas;275;133;142
44;Teruel;043;Blesa;191;102;89
44;Teruel;044;Bordón;164;88;76
44;Teruel;045;Bronchales;475;239;236
44;Teruel;046;Bueña;166;87;79
44;Teruel;047;Burbáguena;401;187;214
44;Teruel;048;Cabra de Mora;106;57;49
44;Teruel;049;Calaceite;1351;688;663
44;Teruel;050;Calamocha;4460;2233;2227
44;Teruel;051;Calanda;3568;1798;1770
44;Teruel;052;Calomarde;99;52;47
44;Teruel;053;Camañas;185;102;83
44;Teruel;054;Camarena de la Sierra;145;75;70
44;Teruel;055;Camarillas;153;87;66
44;Teruel;056;Caminreal;990;492;498
44;Teruel;059;Cantavieja;802;434;368
44;Teruel;060;Cañada de Benatanduz;89;51;38
44;Teruel;061;Cañada de Verich (La);123;65;58
44;Teruel;062;Cañada Vellida;88;52;36
44;Teruel;063;Cañizar del Olivar;167;87;80
44;Teruel;064;Cascante del Río;164;93;71
44;Teruel;065;Castejón de Tornos;141;71;70
44;Teruel;066;Castel de Cabra;286;142;144
44;Teruel;070;Castellar (El);119;66;53
44;Teruel;071;Castellote;1011;515;496
44;Teruel;067;Castelnou;140;76;64
44;Teruel;068;Castelserás;978;516;462
44;Teruel;074;Cedrillas;580;303;277
44;Teruel;075;Celadas;516;268;248
44;Teruel;076;Cella;3161;1602;1559
44;Teruel;077;Cerollera (La);110;57;53
44;Teruel;080;Codoñera (La);392;201;191
44;Teruel;082;Corbalán;95;52;43
44;Teruel;084;Cortes de Aragón;163;80;83
44;Teruel;085;Cosa;140;78;62
44;Teruel;086;Cretas;776;387;389
44;Teruel;087;Crivillén;170;92;78
44;Teruel;088;Cuba (La);102;49;53
44;Teruel;089;Cubla;81;41;40
44;Teruel;090;Cucalón;121;65;56
44;Teruel;092;Cuervo (El);166;80;86
44;Teruel;093;Cuevas de Almudén;134;72;62
44;Teruel;094;Cuevas Labradas;232;114;118
44;Teruel;096;Ejulve;263;148;115
44;Teruel;097;Escorihuela;298;153;145
44;Teruel;099;Escucha;1353;728;625
44;Teruel;100;Estercuel;443;233;210
44;Teruel;101;Ferreruela de Huerva;125;61;64
44;Teruel;102;Fonfría;40;19;21
44;Teruel;103;Formiche Alto;236;123;113
44;Teruel;105;Fórnoles;138;59;79
44;Teruel;106;Fortanete;266;134;132
44;Teruel;107;Foz-Calanda;277;147;130
44;Teruel;108;Fresneda (La);533;269;264
44;Teruel;109;Frías de Albarracín;215;117;98
44;Teruel;110;Fuenferrada;62;32;30
44;Teruel;111;Fuentes Calientes;193;102;91
44;Teruel;112;Fuentes Claras;800;404;396
44;Teruel;113;Fuentes de Rubielos;93;53;40
44;Teruel;114;Fuentespalda;452;239;213
44;Teruel;115;Galve;167;90;77
44;Teruel;116;Gargallo;148;81;67
44;Teruel;117;Gea de Albarracín;533;263;270
44;Teruel;118;Ginebrosa (La);316;172;144
44;Teruel;119;Griegos;185;108;77
44;Teruel;120;Guadalaviar;324;162;162
44;Teruel;121;Gúdar;101;59;42
44;Teruel;122;Híjar;2150;1067;1083
44;Teruel;123;Hinojosa de Jarque;242;132;110
44;Teruel;124;Hoz de la Vieja (La);204;110;94
44;Teruel;125;Huesa del Común;206;105;101
44;Teruel;126;Iglesuela del Cid (La);548;279;269
44;Teruel;127;Jabaloyas;138;65;73
44;Teruel;128;Jarque de la Val;122;68;54
44;Teruel;129;Jatiel;65;28;37
44;Teruel;130;Jorcas;86;49;37
44;Teruel;131;Josa;62;34;28
44;Teruel;132;Lagueruela;90;48;42
44;Teruel;133;Lanzuela;50;28;22
44;Teruel;135;Libros;239;117;122
44;Teruel;136;Lidón;117;58;59
44;Teruel;137;Linares de Mora;384;211;173
44;Teruel;141;Lledó;258;131;127
44;Teruel;138;Loscos;274;142;132
44;Teruel;142;Maicas;21;8;13
44;Teruel;143;Manzanera;562;303;259
44;Teruel;144;Martín del Río;590;300;290
44;Teruel;145;Mas de las Matas;1544;769;775
44;Teruel;146;Mata de los Olmos (La);304;149;155
44;Teruel;147;Mazaleón;700;356;344
44;Teruel;148;Mezquita de Jarque;192;103;89
44;Teruel;149;Mirambel;158;80;78
44;Teruel;150;Miravete de la Sierra;56;30;26
44;Teruel;151;Molinos;408;196;212
44;Teruel;152;Monforte de Moyuela;121;66;55
44;Teruel;153;Monreal del Campo;2376;1185;1191
44;Teruel;154;Monroyo;414;204;210
44;Teruel;155;Montalbán;2058;1045;1013
44;Teruel;156;Monteagudo del Castillo;97;56;41
44;Teruel;157;Monterde de Albarracín;91;42;49
44;Teruel;158;Mora de Rubielos;1390;717;673
44;Teruel;159;Moscardón;84;41;43
44;Teruel;160;Mosqueruela;784;406;378
44;Teruel;161;Muniesa;936;476;460
44;Teruel;163;Noguera de Albarracín;192;95;97
44;Teruel;164;Nogueras;36;22;14
44;Teruel;165;Nogueruelas;262;132;130
44;Teruel;167;Obón;78;40;38
44;Teruel;168;Odón;326;160;166
44;Teruel;169;Ojos Negros;920;469;451
44;Teruel;171;Olba;261;133;128
44;Teruel;172;Oliete;619;313;306
44;Teruel;173;Olmos (Los);194;106;88
44;Teruel;174;Orihuela del Tremedal;706;332;374
44;Teruel;175;Orrios;220;117;103
44;Teruel;176;Palomar de Arroyos;357;190;167
44;Teruel;177;Pancrudo;276;153;123
44;Teruel;178;Parras de Castellote (Las);129;67;62
44;Teruel;179;Peñarroya de Tastavins;618;309;309
44;Teruel;180;Peracense;111;53;58
44;Teruel;181;Peralejos;126;61;65
44;Teruel;182;Perales del Alfambra;348;194;154
44;Teruel;183;Pitarque;129;63;66
44;Teruel;184;Plou;64;30;34
44;Teruel;185;Pobo (El);198;108;90
44;Teruel;187;Portellada (La);387;203;184
44;Teruel;189;Pozondón;115;60;55
44;Teruel;190;Pozuel del Campo;160;86;74
44;Teruel;191;Puebla de Híjar (La);1371;655;716
44;Teruel;192;Puebla de Valverde (La);522;267;255
44;Teruel;193;Puertomingalvo;200;99;101
44;Teruel;194;Ráfales;285;145;140
44;Teruel;195;Rillo;221;120;101
44;Teruel;196;Riodeva;304;153;151
44;Teruel;197;Ródenas;116;59;57
44;Teruel;198;Royuela;245;141;104
44;Teruel;199;Rubiales;37;17;20
44;Teruel;200;Rubielos de la Cérida;78;40;38
44;Teruel;201;Rubielos de Mora;646;316;330
44;Teruel;203;Salcedillo;10;5;5
44;Teruel;204;Saldón;61;40;21
44;Teruel;205;Samper de Calanda;1272;617;655
44;Teruel;206;San Agustín;215;113;102
44;Teruel;207;San Martín del Río;415;202;213
44;Teruel;208;Santa Cruz de Nogueras;35;20;15
44;Teruel;209;Santa Eulalia;1581;769;812
44;Teruel;210;Sarrión;1134;590;544
44;Teruel;211;Segura de los Baños;87;49;38
44;Teruel;212;Seno;72;37;35
44;Teruel;213;Singra;141;74;67
44;Teruel;215;Terriente;217;116;101
44;Teruel;216;Teruel;27475;13357;14118
44;Teruel;217;Toril y Masegoso;51;29;22
44;Teruel;218;Tormón;61;31;30
44;Teruel;219;Tornos;322;165;157
44;Teruel;220;Torralba de los Sisones;274;140;134
44;Teruel;223;Torre de Arcas;137;64;73
44;Teruel;224;Torre de las Arcas;45;27;18
44;Teruel;225;Torre del Compte;235;108;127
44;Teruel;227;Torre los Negros;119;57;62
44;Teruel;221;Torrecilla de Alcañiz;505;259;246
44;Teruel;222;Torrecilla del Rebollar;220;115;105
44;Teruel;226;Torrelacárcel;387;196;191
44;Teruel;228;Torremocha de Jiloca;235;109;126
44;Teruel;229;Torres de Albarracín;215;112;103
44;Teruel;230;Torrevelilla;230;113;117
44;Teruel;231;Torrijas;86;47;39
44;Teruel;232;Torrijo del Campo;715;366;349
44;Teruel;234;Tramacastiel;153;71;82
44;Teruel;235;Tramacastilla;163;83;80
44;Teruel;236;Tronchón;140;70;70
44;Teruel;237;Urrea de Gaén;751;357;394
44;Teruel;238;Utrillas;4335;2234;2101
44;Teruel;239;Valacloche;39;21;18
44;Teruel;240;Valbona;221;120;101
44;Teruel;241;Valdealgorfa;875;442;433
44;Teruel;243;Valdecuenca;38;21;17
44;Teruel;244;Valdelinares;145;77;68
44;Teruel;245;Valdeltormo;490;253;237
44;Teruel;246;Valderrobres;1843;919;924
44;Teruel;247;Valjunquera;518;259;259
44;Teruel;249;Vallecillo (El);20;11;9
44;Teruel;250;Veguillas de la Sierra;34;17;17
44;Teruel;251;Villafranca del Campo;498;256;242
44;Teruel;252;Villahermosa del Campo;107;55;52
44;Teruel;256;Villanueva del Rebollar de la Sierra;63;31;32
44;Teruel;257;Villar del Cobo;265;136;129
44;Teruel;258;Villar del Salz;161;85;76
44;Teruel;260;Villarluengo;265;133;132
44;Teruel;261;Villarquemado;1113;559;554
44;Teruel;262;Villarroya de los Pinares;227;116;111
44;Teruel;263;Villastar;389;198;191
44;Teruel;264;Villel;427;210;217
44;Teruel;265;Vinaceite;393;206;187
44;Teruel;266;Visiedo;305;161;144
44;Teruel;267;Vivel del Río Martín;168;87;81
44;Teruel;268;Zoma (La);43;22;21
45;Toledo;001;Ajofrín;2087;1075;1012
45;Toledo;002;Alameda de la Sagra;2631;1366;1265
45;Toledo;003;Albarreal de Tajo;581;283;298
45;Toledo;004;Alcabón;504;248;256
45;Toledo;005;Alcañizo;439;223;216
45;Toledo;006;Alcaudete de la Jara;1621;782;839
45;Toledo;007;Alcolea de Tajo;898;434;464
45;Toledo;008;Aldea en Cabo;235;124;111
45;Toledo;009;Aldeanueva de Barbarroya;1038;516;522
45;Toledo;010;Aldeanueva de San Bartolomé;904;451;453
45;Toledo;011;Almendral de la Cañada;483;250;233
45;Toledo;012;Almonacid de Toledo;924;446;478
45;Toledo;013;Almorox;2194;1136;1058
45;Toledo;014;Añover de Tajo;4317;2196;2121
45;Toledo;015;Arcicóllar;457;232;225
45;Toledo;016;Argés;1630;832;798
45;Toledo;017;Azután;389;204;185
45;Toledo;018;Barcience;125;63;62
45;Toledo;019;Bargas;5530;2790;2740
45;Toledo;020;Belvís de la Jara;2123;1039;1084
45;Toledo;021;Borox;1940;966;974
45;Toledo;022;Buenaventura;529;267;262
45;Toledo;023;Burguillos de Toledo;606;309;297
45;Toledo;024;Burujón;1252;660;592
45;Toledo;025;Cabañas de la Sagra;911;473;438
45;Toledo;026;Cabañas de Yepes;283;148;135
45;Toledo;027;Cabezamesada;654;331;323
45;Toledo;028;Calera y Chozas;3672;1867;1805
45;Toledo;029;Caleruela;414;201;213
45;Toledo;030;Calzada de Oropesa;722;345;377
45;Toledo;031;Camarena;1890;960;930
45;Toledo;032;Camarenilla;574;289;285
45;Toledo;033;Campillo de la Jara (El);758;382;376
45;Toledo;034;Camuñas;1819;905;914
45;Toledo;035;Cardiel de los Montes;148;68;80
45;Toledo;036;Carmena;852;421;431
45;Toledo;037;Carpio de Tajo (El);2477;1171;1306
45;Toledo;038;Carranque;901;443;458
45;Toledo;039;Carriches;327;156;171
45;Toledo;040;Casar de Escalona (El);942;483;459
45;Toledo;041;Casarrubios del Monte;1618;809;809
45;Toledo;042;Casasbuenas;281;141;140
45;Toledo;043;Castillo de Bayuela;1091;571;520
45;Toledo;045;Cazalegas;1156;586;570
45;Toledo;046;Cebolla;2556;1282;1274
45;Toledo;047;Cedillo del Condado;987;512;475
45;Toledo;048;Cerralbos (Los);530;264;266
45;Toledo;049;Cervera de los Montes;490;255;235
45;Toledo;056;Chozas de Canales;923;467;456
45;Toledo;057;Chueca;257;127;130
45;Toledo;050;Ciruelos;363;178;185
45;Toledo;051;Cobeja;1611;800;811
45;Toledo;052;Cobisa;195;95;100
45;Toledo;053;Consuegra;9999;4895;5104
45;Toledo;054;Corral de Almaguer;6305;3121;3184
45;Toledo;055;Cuerva;1260;625;635
45;Toledo;058;Domingo Pérez;608;308;300
45;Toledo;059;Dosbarrios;2075;1073;1002
45;Toledo;060;Erustes;218;109;109
45;Toledo;061;Escalona;1676;828;848
45;Toledo;062;Escalonilla;1512;749;763
45;Toledo;063;Espinoso del Rey;740;374;366
45;Toledo;064;Esquivias;3228;1621;1607
45;Toledo;065;Estrella (La);696;363;333
45;Toledo;066;Fuensalida;6344;3188;3156
45;Toledo;067;Gálvez;3260;1657;1603
45;Toledo;068;Garciotum;183;87;96
45;Toledo;069;Gerindote;1625;825;800
45;Toledo;070;Guadamur;1526;775;751
45;Toledo;071;Guardia (La);2540;1238;1302
45;Toledo;072;Herencias (Las);893;453;440
45;Toledo;073;Herreruela de Oropesa;529;265;264
45;Toledo;074;Hinojosa de San Vicente;591;318;273
45;Toledo;075;Hontanar;117;62;55
45;Toledo;076;Hormigos;398;209;189
45;Toledo;077;Huecas;367;193;174
45;Toledo;078;Huerta de Valdecarábanos;1766;856;910
45;Toledo;079;Iglesuela (La);531;275;256
45;Toledo;080;Illán de Vacas;11;7;4
45;Toledo;081;Illescas;7145;3636;3509
45;Toledo;082;Lagartera;2044;989;1055
45;Toledo;083;Layos;260;129;131
45;Toledo;084;Lillo;3055;1492;1563
45;Toledo;085;Lominchar;1009;528;481
45;Toledo;086;Lucillos;563;270;293
45;Toledo;087;Madridejos;10283;4980;5303
45;Toledo;088;Magán;754;388;366
45;Toledo;089;Malpica de Tajo;1847;937;910
45;Toledo;090;Manzaneque;519;256;263
45;Toledo;091;Maqueda;481;249;232
45;Toledo;092;Marjaliza;371;182;189
45;Toledo;093;Marrupe;150;77;73
45;Toledo;094;Mascaraque;544;258;286
45;Toledo;095;Mata (La);1102;542;560
45;Toledo;096;Mazarambroz;1240;621;619
45;Toledo;097;Mejorada;1227;628;599
45;Toledo;098;Menasalbas;3038;1567;1471
45;Toledo;099;Méntrida;1505;771;734
45;Toledo;100;Mesegar de Tajo;286;145;141
45;Toledo;101;Miguel Esteban;4645;2283;2362
45;Toledo;102;Mocejón;3730;1886;1844
45;Toledo;103;Mohedas de la Jara;843;426;417
45;Toledo;104;Montearagón;514;258;256
45;Toledo;105;Montesclaros;526;250;276
45;Toledo;106;Mora;9402;4563;4839
45;Toledo;107;Nambroca;1722;848;874
45;Toledo;108;Nava de Ricomalillo (La);817;427;390
45;Toledo;109;Navahermosa;3768;1934;1834
45;Toledo;110;Navalcán;2654;1363;1291
45;Toledo;111;Navalmoralejo;143;67;76
45;Toledo;112;Navalmorales (Los);3004;1473;1531
45;Toledo;113;Navalucillos (Los);3329;1684;1645
45;Toledo;114;Navamorcuende;873;460;413
45;Toledo;115;Noblejas;2881;1456;1425
45;Toledo;116;Noez;944;477;467
45;Toledo;117;Nombela;917;478;439
45;Toledo;118;Novés;1428;723;705
45;Toledo;119;Numancia de la Sagra;944;479;465
45;Toledo;120;Nuño Gómez;191;96;95
45;Toledo;121;Ocaña;5456;2695;2761
45;Toledo;122;Olías del Rey;2507;1270;1237
45;Toledo;123;Ontígola;642;319;323
45;Toledo;124;Orgaz;2760;1382;1378
45;Toledo;125;Oropesa;3265;1619;1646
45;Toledo;126;Otero;226;101;125
45;Toledo;127;Palomeque;368;188;180
45;Toledo;128;Pantoja;1973;1014;959
45;Toledo;129;Paredes de Escalona;96;45;51
45;Toledo;130;Parrillas;611;302;309
45;Toledo;131;Pelahustán;495;252;243
45;Toledo;132;Pepino;580;303;277
45;Toledo;133;Polán;2958;1492;1466
45;Toledo;134;Portillo de Toledo;1854;948;906
45;Toledo;135;Puebla de Almoradiel (La);5520;2757;2763
45;Toledo;136;Puebla de Montalbán (La);6466;3234;3232
45;Toledo;137;Pueblanueva (La);2048;1046;1002
45;Toledo;138;Puente del Arzobispo (El);1578;761;817
45;Toledo;139;Puerto de San Vicente;399;199;200
45;Toledo;140;Pulgar;1181;579;602
45;Toledo;141;Quero;1589;777;812
45;Toledo;142;Quintanar de la Orden;8918;4416;4502
45;Toledo;143;Quismondo;1309;644;665
45;Toledo;144;Real de San Vicente (El);992;509;483
45;Toledo;145;Recas;2138;1104;1034
45;Toledo;146;Retamoso;196;106;90
45;Toledo;147;Rielves;446;222;224
45;Toledo;148;Robledo del Mazo;712;367;345
45;Toledo;149;Romeral (El);1144;554;590
45;Toledo;150;San Bartolomé de las Abiertas;567;279;288
45;Toledo;151;San Martín de Montalbán;855;425;430
45;Toledo;152;San Martín de Pusa;841;444;397
45;Toledo;153;San Pablo de los Montes;1982;1009;973
45;Toledo;154;San Román de los Montes;413;203;210
45;Toledo;155;Santa Ana de Pusa;455;239;216
45;Toledo;156;Santa Cruz de la Zarza;4289;2160;2129
45;Toledo;157;Santa Cruz del Retamar;1392;702;690
45;Toledo;158;Santa Olalla;2238;1108;1130
45;Toledo;901;Santo Domingo-Caudilla;855;415;440
45;Toledo;159;Sartajada;154;83;71
45;Toledo;160;Segurilla;1041;511;530
45;Toledo;161;Seseña;2641;1355;1286
45;Toledo;162;Sevilleja de la Jara;1392;714;678
45;Toledo;163;Sonseca;8185;4071;4114
45;Toledo;164;Sotillo de las Palomas;214;113;101
45;Toledo;165;Talavera de la Reina;67680;33319;34361
45;Toledo;166;Tembleque;2251;1106;1145
45;Toledo;167;Toboso (El);2374;1163;1211
45;Toledo;168;Toledo;58297;28480;29817
45;Toledo;169;Torralba de Oropesa;333;157;176
45;Toledo;171;Torre de Esteban Hambrán (La);1356;706;650
45;Toledo;170;Torrecilla de la Jara;354;193;161
45;Toledo;172;Torrico;1054;537;517
45;Toledo;173;Torrijos;8889;4394;4495
45;Toledo;174;Totanés;375;190;185
45;Toledo;175;Turleque;1242;614;628
45;Toledo;176;Ugena;379;199;180
45;Toledo;177;Urda;3281;1614;1667
45;Toledo;179;Valdeverdeja;1054;495;559
45;Toledo;180;Valmojado;2200;1120;1080
45;Toledo;181;Velada;2262;1152;1110
45;Toledo;182;Ventas con Peña Aguilera (Las);1461;736;725
45;Toledo;183;Ventas de Retamosa (Las);518;266;252
45;Toledo;184;Ventas de San Julián (Las);234;114;120
45;Toledo;186;Villa de Don Fadrique (La);4301;2082;2219
45;Toledo;185;Villacañas;8520;4246;4274
45;Toledo;187;Villafranca de los Caballeros;5543;2708;2835
45;Toledo;188;Villaluenga de la Sagra;2578;1288;1290
45;Toledo;189;Villamiel de Toledo;256;127;129
45;Toledo;190;Villaminaya;744;366;378
45;Toledo;191;Villamuelas;762;399;363
45;Toledo;192;Villanueva de Alcardete;3357;1679;1678
45;Toledo;193;Villanueva de Bogas;909;465;444
45;Toledo;194;Villarejo de Montalbán;116;53;63
45;Toledo;195;Villarrubia de Santiago;3082;1521;1561
45;Toledo;196;Villaseca de la Sagra;1571;784;787
45;Toledo;197;Villasequilla;2379;1210;1169
45;Toledo;198;Villatobas;2530;1268;1262
45;Toledo;199;Viso de San Juan (El);442;220;222
45;Toledo;200;Yébenes (Los);6473;3283;3190
45;Toledo;201;Yeles;937;473;464
45;Toledo;202;Yepes;4423;2204;2219
45;Toledo;203;Yuncler;1723;879;844
45;Toledo;204;Yunclillos;558;287;271
45;Toledo;205;Yuncos;2593;1323;1270
46;Valencia/València;001;Ademuz;1436;726;710
46;Valencia/València;002;Ador;1180;598;582
46;Valencia/València;004;Agullent;2020;978;1042
46;Valencia/València;042;Aielo de Malferit;3845;1894;1951
46;Valencia/València;043;Aielo de Rugat;203;103;100
46;Valencia/València;005;Alaquàs;24268;12038;12230
46;Valencia/València;006;Albaida;5868;2915;2953
46;Valencia/València;007;Albal;8715;4369;4346
46;Valencia/València;008;Albalat de la Ribera;3646;1789;1857
46;Valencia/València;009;Albalat dels Sorells;3621;1781;1840
46;Valencia/València;010;Albalat dels Tarongers;557;271;286
46;Valencia/València;011;Alberic;8770;4314;4456
46;Valencia/València;012;Alborache;908;457;451
46;Valencia/València;013;Alboraya;11351;5530;5821
46;Valencia/València;014;Albuixech;2925;1450;1475
46;Valencia/València;016;Alcàntera de Xúquer;1501;747;754
46;Valencia/València;015;Alcàsser;7161;3588;3573
46;Valencia/València;018;Alcublas;932;492;440
46;Valencia/València;020;Alcúdia de Crespins (L');4289;2126;2163
46;Valencia/València;019;Alcúdia (L');10172;4978;5194
46;Valencia/València;021;Aldaia;21778;10892;10886
46;Valencia/València;022;Alfafar;20258;10133;10125
46;Valencia/València;024;Alfara de Algimia;556;277;279
46;Valencia/València;025;Alfara del Patriarca;2805;1390;1415
46;Valencia/València;026;Alfarp;1306;630;676
46;Valencia/València;027;Alfarrasí;1275;631;644
46;Valencia/València;023;Alfauir;311;154;157
46;Valencia/València;028;Algar de Palancia;415;195;220
46;Valencia/València;029;Algemesí;25195;12373;12822
46;Valencia/València;030;Algimia de Alfara;915;449;466
46;Valencia/València;031;Alginet;11537;5763;5774
46;Valencia/València;032;Almàssera;5610;2735;2875
46;Valencia/València;033;Almiserà;216;104;112
46;Valencia/València;034;Almoines;1895;945;950
46;Valencia/València;035;Almussafes;5797;2906;2891
46;Valencia/València;036;Alpuente;1288;680;608
46;Valencia/València;037;Alquería de la Condesa/Alqueria de la Comtessa (l');1640;779;861
46;Valencia/València;017;Alzira;40234;19623;20611
46;Valencia/València;038;Andilla;159;84;75
46;Valencia/València;039;Anna;2569;1278;1291
46;Valencia/València;040;Antella;1651;815;836
46;Valencia/València;041;Aras de los Olmos;506;276;230
46;Valencia/València;003;Atzeneta d'Albaida;1253;633;620
46;Valencia/València;044;Ayora;5730;2974;2756
46;Valencia/València;046;Barx;941;466;475
46;Valencia/València;045;Barxeta;1616;806;810
46;Valencia/València;047;Bèlgida;699;329;370
46;Valencia/València;048;Bellreguard;3847;1897;1950
46;Valencia/València;049;Bellús;417;208;209
46;Valencia/València;050;Benagéber;125;64;61
46;Valencia/València;051;Benaguasil;9031;4531;4500
46;Valencia/València;052;Benavites;675;326;349
46;Valencia/València;053;Beneixida;617;298;319
46;Valencia/València;054;Benetússer;13915;6881;7034
46;Valencia/València;055;Beniarjó;1256;599;657
46;Valencia/València;056;Beniatjar;276;137;139
46;Valencia/València;057;Benicolet;492;257;235
46;Valencia/València;060;Benifaió;12251;6070;6181
46;Valencia/València;059;Benifairó de la Valldigna;1652;818;834
46;Valencia/València;058;Benifairó de les Valls;1978;988;990
46;Valencia/València;061;Beniflá;155;71;84
46;Valencia/València;062;Benigánim;5254;2662;2592
46;Valencia/València;063;Benimodo;1712;875;837
46;Valencia/València;064;Benimuslem;572;280;292
46;Valencia/València;065;Beniparrell;1411;701;710
46;Valencia/València;066;Benirredrà;840;396;444
46;Valencia/València;067;Benisanó;1683;852;831
46;Valencia/València;068;Benissoda;300;166;134
46;Valencia/València;069;Benisuera;221;105;116
46;Valencia/València;070;Bétera;8924;4462;4462
46;Valencia/València;071;Bicorp;763;386;377
46;Valencia/València;072;Bocairent;5019;2449;2570
46;Valencia/València;073;Bolbaite;1390;713;677
46;Valencia/València;074;Bonrepòs i Mirambell;2287;1116;1171
46;Valencia/València;075;Bufali;223;117;106
46;Valencia/València;076;Bugarra;910;457;453
46;Valencia/València;077;Buñol;9660;4813;4847
46;Valencia/València;078;Burjassot;35024;17090;17934
46;Valencia/València;079;Calles;473;252;221
46;Valencia/València;080;Camporrobles;1575;771;804
46;Valencia/València;081;Canals;11958;5889;6069
46;Valencia/València;082;Canet d'En Berenguer;1438;701;737
46;Valencia/València;083;Carcaixent;20688;10018;10670
46;Valencia/València;084;Càrcer;2044;993;1051
46;Valencia/València;085;Carlet;14038;6903;7135
46;Valencia/València;086;Carrícola;68;30;38
46;Valencia/València;087;Casas Altas;212;102;110
46;Valencia/València;088;Casas Bajas;419;210;209
46;Valencia/València;089;Casinos;2217;1123;1094
46;Valencia/València;090;Castelló de Rugat;2117;1086;1031
46;Valencia/València;091;Castellonet de la Conquesta;90;46;44
46;Valencia/València;092;Castielfabib;741;389;352
46;Valencia/València;093;Catadau;2192;1114;1078
46;Valencia/València;094;Catarroja;20832;10223;10609
46;Valencia/València;095;Caudete de las Fuentes;1030;519;511
46;Valencia/València;096;Cerdà;245;128;117
46;Valencia/València;107;Chella;2601;1305;1296
46;Valencia/València;106;Chelva;2203;1120;1083
46;Valencia/València;108;Chera;641;326;315
46;Valencia/València;109;Cheste;7010;3533;3477
46;Valencia/València;111;Chiva;7500;3729;3771
46;Valencia/València;112;Chulilla;702;349;353
46;Valencia/València;097;Cofrentes;932;485;447
46;Valencia/València;098;Corbera;3224;1579;1645
46;Valencia/València;099;Cortes de Pallás;964;503;461
46;Valencia/València;100;Cotes;380;179;201
46;Valencia/València;105;Cullera;20157;9927;10230
46;Valencia/València;113;Daimús;1224;606;618
46;Valencia/València;114;Domeño;366;187;179
46;Valencia/València;115;Dos Aguas;486;271;215
46;Valencia/València;116;Eliana (L');6554;3282;3272
46;Valencia/València;117;Emperador;170;78;92
46;Valencia/València;118;Enguera;5073;2498;2575
46;Valencia/València;119;Ènova (L');1215;594;621
46;Valencia/València;120;Estivella;1123;518;605
46;Valencia/València;121;Estubeny;171;78;93
46;Valencia/València;122;Faura;2776;1391;1385
46;Valencia/València;123;Favara;1713;835;878
46;Valencia/València;126;Foios;5371;2601;2770
46;Valencia/València;128;Font de la Figuera (La);2240;1103;1137
46;Valencia/València;127;Font d'En Carròs (La);3308;1645;1663
46;Valencia/València;124;Fontanars dels Alforins;1000;537;463
46;Valencia/València;125;Fortaleny;1048;526;522
46;Valencia/València;129;Fuenterrobles;812;411;401
46;Valencia/València;131;Gandia;51092;25016;26076
46;Valencia/València;130;Gavarda;1288;656;632
46;Valencia/València;132;Genovés;2151;1072;1079
46;Valencia/València;133;Gestalgar;604;301;303
46;Valencia/València;134;Gilet;1100;535;565
46;Valencia/València;135;Godella;8496;4146;4350
46;Valencia/València;136;Godelleta;1934;950;984
46;Valencia/València;137;Granja de la Costera (La);408;198;210
46;Valencia/València;138;Guadasequies;356;181;175
46;Valencia/València;139;Guadassuar;5513;2787;2726
46;Valencia/València;140;Guardamar de la Safor;62;34;28
46;Valencia/València;141;Higueruelas;600;312;288
46;Valencia/València;142;Jalance;1344;682;662
46;Valencia/València;144;Jarafuel;1151;602;549
46;Valencia/València;154;Llanera de Ranes;969;493;476
46;Valencia/València;155;Llaurí;1512;742;770
46;Valencia/València;147;Llíria;13530;6667;6863
46;Valencia/València;153;Llocnou de Sant Jeroni;594;285;309
46;Valencia/València;151;Llocnou d'En Fenollet;647;311;336
46;Valencia/València;156;Llombai;2151;1084;1067
46;Valencia/València;157;Llosa de Ranes (La);3565;1823;1742
46;Valencia/València;150;Llutxent;2424;1243;1181
46;Valencia/València;148;Loriguilla;1172;599;573
46;Valencia/València;149;Losa del Obispo;500;241;259
46;Valencia/València;152;Lugar Nuevo de la Corona;107;54;53
46;Valencia/València;158;Macastre;897;443;454
46;Valencia/València;159;Manises;25131;12366;12765
46;Valencia/València;160;Manuel;2480;1205;1275
46;Valencia/València;161;Marines;1197;599;598
46;Valencia/València;162;Masalavés;1526;764;762
46;Valencia/València;163;Massalfassar;1476;730;746
46;Valencia/València;164;Massamagrell;12081;6045;6036
46;Valencia/València;165;Massanassa;7614;3744;3870
46;Valencia/València;166;Meliana;9106;4522;4584
46;Valencia/València;167;Millares;827;409;418
46;Valencia/València;168;Miramar;939;458;481
46;Valencia/València;169;Mislata;35815;17609;18206
46;Valencia/València;170;Mogente/Moixent;4134;2133;2001
46;Valencia/València;171;Moncada;17852;8851;9001
46;Valencia/València;172;Monserrat;2508;1270;1238
46;Valencia/València;173;Montaverner;1728;886;842
46;Valencia/València;174;Montesa;1248;631;617
46;Valencia/València;175;Montichelvo;675;339;336
46;Valencia/València;176;Montroy;1475;748;727
46;Valencia/València;177;Museros;3984;1978;2006
46;Valencia/València;178;Náquera;1580;789;791
46;Valencia/València;179;Navarrés;2759;1382;1377
46;Valencia/València;180;Novelé/Novetlè;591;288;303
46;Valencia/València;181;Oliva;20224;10049;10175
46;Valencia/València;183;Olleria (L');6839;3450;3389
46;Valencia/València;182;Olocau;575;296;279
46;Valencia/València;184;Ontinyent;29162;14392;14770
46;Valencia/València;185;Otos;547;272;275
46;Valencia/València;186;Paiporta;15220;7529;7691
46;Valencia/València;187;Palma de Gandía;1524;748;776
46;Valencia/València;188;Palmera;487;228;259
46;Valencia/València;189;Palomar (El);488;236;252
46;Valencia/València;190;Paterna;35683;17704;17979
46;Valencia/València;191;Pedralba;2084;1055;1029
46;Valencia/València;192;Petrés;598;286;312
46;Valencia/València;193;Picanya;7362;3682;3680
46;Valencia/València;194;Picassent;14524;7311;7213
46;Valencia/València;195;Piles;2013;962;1051
46;Valencia/València;196;Pinet;276;152;124
46;Valencia/València;199;Pobla de Farnals (La);4176;2054;2122
46;Valencia/València;202;Pobla de Vallbona (La);7562;3904;3658
46;Valencia/València;200;Pobla del Duc (La);2642;1306;1336
46;Valencia/València;203;Pobla Llarga (La);4498;2195;2303
46;Valencia/València;197;Polinyà de Xúquer;3037;1506;1531
46;Valencia/València;198;Potríes;953;469;484
46;Valencia/València;205;Puçol;12173;6005;6168
46;Valencia/València;201;Puebla de San Miguel;45;23;22
46;Valencia/València;204;Puig;5699;2814;2885
46;Valencia/València;101;Quart de les Valls;1128;529;599
46;Valencia/València;102;Quart de Poblet;27247;13492;13755
46;Valencia/València;103;Quartell;1359;677;682
46;Valencia/València;104;Quatretonda;2608;1327;1281
46;Valencia/València;206;Quesa;870;436;434
46;Valencia/València;207;Rafelbuñol/Rafelbunyol;4821;2403;2418
46;Valencia/València;208;Rafelcofer;1449;685;764
46;Valencia/València;209;Rafelguaraf;2399;1188;1211
46;Valencia/València;210;Ráfol de Salem;415;191;224
46;Valencia/València;211;Real de Gandía;1938;887;1051
46;Valencia/València;212;Real de Montroi;1831;946;885
46;Valencia/València;213;Requena;18229;9162;9067
46;Valencia/València;214;Riba-roja de Túria;9448;4665;4783
46;Valencia/València;215;Riola;1723;867;856
46;Valencia/València;216;Rocafort;3312;1639;1673
46;Valencia/València;217;Rotglá y Corberá;1064;533;531
46;Valencia/València;218;Rótova;1395;704;691
46;Valencia/València;219;Rugat;200;102;98
46;Valencia/València;220;Sagunto/Sagunt;55957;27574;28383
46;Valencia/València;221;Salem;490;239;251
46;Valencia/València;222;San Juan de Énova;393;187;206
46;Valencia/València;223;Sedaví;8487;4174;4313
46;Valencia/València;224;Segart;159;72;87
46;Valencia/València;225;Sellent;515;265;250
46;Valencia/València;226;Sempere;49;21;28
46;Valencia/València;227;Senyera;815;395;420
46;Valencia/València;228;Serra;1336;660;676
46;Valencia/València;229;Siete Aguas;1232;580;652
46;Valencia/València;230;Silla;16209;8224;7985
46;Valencia/València;231;Simat de la Valldigna;3267;1651;1616
46;Valencia/València;232;Sinarcas;1382;718;664
46;Valencia/València;233;Sollana;4377;2192;2185
46;Valencia/València;234;Sot de Chera;328;168;160
46;Valencia/València;235;Sueca;24400;12001;12399
46;Valencia/València;236;Sumacàrcer;1431;722;709
46;Valencia/València;237;Tavernes Blanques;7898;3866;4032
46;Valencia/València;238;Tavernes de la Valldigna;16200;8056;8144
46;Valencia/València;239;Teresa de Cofrentes;874;459;415
46;Valencia/València;240;Terrateig;244;123;121
46;Valencia/València;241;Titaguas;643;338;305
46;Valencia/València;242;Torrebaja;457;243;214
46;Valencia/València;243;Torrella;177;86;91
46;Valencia/València;244;Torrent;54739;27221;27518
46;Valencia/València;245;Torres Torres;396;188;208
46;Valencia/València;246;Tous;1241;623;618
46;Valencia/València;247;Tuéjar;1468;774;694
46;Valencia/València;248;Turís;3993;2047;1946
46;Valencia/València;249;Utiel;12125;6123;6002
46;Valencia/València;250;Valencia;732491;349067;383424
46;Valencia/València;251;Vallada;2868;1437;1431
46;Valencia/València;252;Vallanca;300;143;157
46;Valencia/València;253;Vallés;123;68;55
46;Valencia/València;254;Venta del Moro;2015;1024;991
46;Valencia/València;256;Vilamarxant;4844;2462;2382
46;Valencia/València;255;Villalonga;3677;1844;1833
46;Valencia/València;257;Villanueva de Castellón;7053;3425;3628
46;Valencia/València;258;Villar del Arzobispo;3410;1696;1714
46;Valencia/València;259;Villargordo del Cabriel;937;484;453
46;Valencia/València;260;Vinalesa;2342;1105;1237
46;Valencia/València;145;Xàtiva;24237;11764;12473
46;Valencia/València;143;Xeraco;4505;2247;2258
46;Valencia/València;146;Xeresa;2046;1026;1020
46;Valencia/València;110;Xirivella;24604;12256;12348
46;Valencia/València;261;Yátova;2206;1150;1056
46;Valencia/València;262;Yesa (La);339;172;167
46;Valencia/València;263;Zarra;559;282;277
47;Valladolid;001;Adalia;105;57;48
47;Valladolid;002;Aguasal;31;18;13
47;Valladolid;003;Aguilar de Campos;475;243;232
47;Valladolid;004;Alaejos;2015;1025;990
47;Valladolid;005;Alcazarén;804;432;372
47;Valladolid;006;Aldea de San Miguel;268;134;134
47;Valladolid;007;Aldeamayor de San Martín;1064;532;532
47;Valladolid;008;Almenara de Adaja;44;24;20
47;Valladolid;009;Amusquillo;223;119;104
47;Valladolid;010;Arroyo de la Encomienda;1200;607;593
47;Valladolid;011;Ataquines;1034;531;503
47;Valladolid;012;Bahabón;285;143;142
47;Valladolid;013;Barcial de la Loma;198;100;98
47;Valladolid;014;Barruelo del Valle;91;43;48
47;Valladolid;015;Becilla de Valderaduey;537;263;274
47;Valladolid;016;Benafarces;110;52;58
47;Valladolid;017;Bercero;312;159;153
47;Valladolid;018;Berceruelo;38;21;17
47;Valladolid;019;Berrueces;150;83;67
47;Valladolid;020;Bobadilla del Campo;497;257;240
47;Valladolid;021;Bocigas;127;68;59
47;Valladolid;022;Bocos de Duero;91;38;53
47;Valladolid;023;Boecillo;725;360;365
47;Valladolid;024;Bolaños de Campos;478;243;235
47;Valladolid;025;Brahojos de Medina;231;134;97
47;Valladolid;026;Bustillo de Chaves;133;64;69
47;Valladolid;027;Cabezón de Pisuerga;1511;767;744
47;Valladolid;028;Cabezón de Valderaduey;63;30;33
47;Valladolid;029;Cabreros del Monte;156;74;82
47;Valladolid;030;Campaspero;1825;940;885
47;Valladolid;031;Campillo (El);282;160;122
47;Valladolid;032;Camporredondo;262;140;122
47;Valladolid;033;Canalejas de Peñafiel;378;199;179
47;Valladolid;034;Canillas de Esgueva;174;92;82
47;Valladolid;035;Carpio;1354;708;646
47;Valladolid;036;Casasola de Arión;466;241;225
47;Valladolid;037;Castrejón de Trabancos;324;181;143
47;Valladolid;038;Castrillo de Duero;289;150;139
47;Valladolid;039;Castrillo-Tejeriego;356;188;168
47;Valladolid;040;Castrobol;132;55;77
47;Valladolid;041;Castrodeza;293;147;146
47;Valladolid;042;Castromembibre;113;56;57
47;Valladolid;043;Castromonte;566;297;269
47;Valladolid;044;Castronuevo de Esgueva;303;160;143
47;Valladolid;045;Castronuño;1338;686;652
47;Valladolid;046;Castroponce;257;133;124
47;Valladolid;047;Castroverde de Cerrato;366;192;174
47;Valladolid;048;Ceinos de Campos;334;179;155
47;Valladolid;049;Cervillego de la Cruz;217;104;113
47;Valladolid;050;Cigales;1684;816;868
47;Valladolid;051;Ciguñuela;341;173;168
47;Valladolid;052;Cistérniga;1140;572;568
47;Valladolid;053;Cogeces de Íscar;168;87;81
47;Valladolid;054;Cogeces del Monte;1081;568;513
47;Valladolid;055;Corcos;272;143;129
47;Valladolid;056;Corrales de Duero;177;97;80
47;Valladolid;057;Cubillas de Santa Marta;315;153;162
47;Valladolid;058;Cuenca de Campos;365;176;189
47;Valladolid;059;Curiel de Duero;196;109;87
47;Valladolid;060;Encinas de Esgueva;481;244;237
47;Valladolid;061;Esguevillas de Esgueva;506;264;242
47;Valladolid;062;Fombellida;339;181;158
47;Valladolid;063;Fompedraza;158;90;68
47;Valladolid;064;Fontihoyuelo;67;34;33
47;Valladolid;065;Fresno el Viejo;1527;770;757
47;Valladolid;066;Fuensaldaña;626;313;313
47;Valladolid;067;Fuente el Sol;402;210;192
47;Valladolid;068;Fuente-Olmedo;92;45;47
47;Valladolid;069;Gallegos de Hornija;163;80;83
47;Valladolid;070;Gatón de Campos;71;37;34
47;Valladolid;071;Geria;426;233;193
47;Valladolid;073;Herrín de Campos;266;131;135
47;Valladolid;074;Hornillos de Eresma;177;94;83
47;Valladolid;075;Íscar;5780;2908;2872
47;Valladolid;076;Laguna de Duero;9065;4552;4513
47;Valladolid;077;Langayo;560;291;269
47;Valladolid;079;Llano de Olmedo;118;59;59
47;Valladolid;078;Lomoviejo;317;164;153
47;Valladolid;080;Manzanillo;71;38;33
47;Valladolid;081;Marzales;82;41;41
47;Valladolid;082;Matapozuelos;966;496;470
47;Valladolid;083;Matilla de los Caños;98;51;47
47;Valladolid;084;Mayorga;1705;794;911
47;Valladolid;086;Medina de Rioseco;4993;2480;2513
47;Valladolid;085;Medina del Campo;19521;9631;9890
47;Valladolid;087;Megeces;495;253;242
47;Valladolid;088;Melgar de Abajo;280;132;148
47;Valladolid;089;Melgar de Arriba;367;180;187
47;Valladolid;090;Mojados;2038;1035;1003
47;Valladolid;091;Monasterio de Vega;141;64;77
47;Valladolid;092;Montealegre de Campos;198;102;96
47;Valladolid;093;Montemayor de Pililla;1193;629;564
47;Valladolid;094;Moral de la Reina;305;159;146
47;Valladolid;095;Moraleja de las Panaderas;30;19;11
47;Valladolid;096;Morales de Campos;231;113;118
47;Valladolid;097;Mota del Marqués;542;265;277
47;Valladolid;098;Mucientes;689;343;346
47;Valladolid;099;Mudarra (La);327;174;153
47;Valladolid;100;Muriel;326;154;172
47;Valladolid;101;Nava del Rey;2464;1196;1268
47;Valladolid;102;Nueva Villa de las Torres;458;239;219
47;Valladolid;103;Olivares de Duero;365;195;170
47;Valladolid;104;Olmedo;3712;1808;1904
47;Valladolid;105;Olmos de Esgueva;211;115;96
47;Valladolid;106;Olmos de Peñafiel;112;61;51
47;Valladolid;109;Palazuelo de Vedija;303;150;153
47;Valladolid;110;Parrilla (La);633;316;317
47;Valladolid;111;Pedraja de Portillo (La);984;480;504
47;Valladolid;112;Pedrajas de San Esteban;3092;1588;1504
47;Valladolid;113;Pedrosa del Rey;325;157;168
47;Valladolid;114;Peñafiel;5286;2684;2602
47;Valladolid;115;Peñaflor de Hornija;547;292;255
47;Valladolid;116;Pesquera de Duero;652;339;313
47;Valladolid;117;Piña de Esgueva;451;242;209
47;Valladolid;118;Piñel de Abajo;328;177;151
47;Valladolid;119;Piñel de Arriba;206;101;105
47;Valladolid;121;Pollos;942;503;439
47;Valladolid;122;Portillo;2590;1327;1263
47;Valladolid;123;Pozal de Gallinas;504;254;250
47;Valladolid;124;Pozaldez;637;305;332
47;Valladolid;125;Pozuelo de la Orden;125;64;61
47;Valladolid;126;Puras;75;38;37
47;Valladolid;127;Quintanilla de Arriba;296;156;140
47;Valladolid;129;Quintanilla de Onésimo;1159;620;539
47;Valladolid;130;Quintanilla de Trigueros;104;55;49
47;Valladolid;128;Quintanilla del Molar;104;50;54
47;Valladolid;131;Rábano;316;169;147
47;Valladolid;132;Ramiro;120;62;58
47;Valladolid;133;Renedo de Esgueva;776;416;360
47;Valladolid;134;Roales de Campos;332;175;157
47;Valladolid;135;Robladillo;113;58;55
47;Valladolid;137;Roturas;41;23;18
47;Valladolid;138;Rubí de Bracamonte;425;221;204
47;Valladolid;139;Rueda;1682;855;827
47;Valladolid;140;Saelices de Mayorga;292;152;140
47;Valladolid;141;Salvador de Zapardiel;258;129;129
47;Valladolid;142;San Cebrián de Mazote;300;160;140
47;Valladolid;143;San Llorente;244;121;123
47;Valladolid;144;San Martín de Valvení;122;68;54
47;Valladolid;145;San Miguel del Arroyo;956;493;463
47;Valladolid;146;San Miguel del Pino;250;131;119
47;Valladolid;147;San Pablo de la Moraleja;221;118;103
47;Valladolid;148;San Pedro de Latarce;771;414;357
47;Valladolid;149;San Pelayo;48;21;27
47;Valladolid;150;San Román de Hornija;607;310;297
47;Valladolid;151;San Salvador;55;29;26
47;Valladolid;156;San Vicente del Palacio;335;173;162
47;Valladolid;152;Santa Eufemia del Arroyo;156;78;78
47;Valladolid;153;Santervás de Campos;226;122;104
47;Valladolid;154;Santibáñez de Valcorba;225;113;112
47;Valladolid;155;Santovenia de Pisuerga;980;503;477
47;Valladolid;157;Sardón de Duero;637;316;321
47;Valladolid;158;Seca (La);1088;571;517
47;Valladolid;159;Serrada;1024;536;488
47;Valladolid;160;Siete Iglesias de Trabancos;742;378;364
47;Valladolid;161;Simancas;1752;897;855
47;Valladolid;162;Tamariz de Campos;104;51;53
47;Valladolid;163;Tiedra;458;221;237
47;Valladolid;164;Tordehumos;628;329;299
47;Valladolid;165;Tordesillas;7286;3678;3608
47;Valladolid;169;Torre de Esgueva;150;77;73
47;Valladolid;170;Torre de Peñafiel;80;41;39
47;Valladolid;166;Torrecilla de la Abadesa;406;216;190
47;Valladolid;167;Torrecilla de la Orden;477;238;239
47;Valladolid;168;Torrecilla de la Torre;51;30;21
47;Valladolid;171;Torrelobatón;690;338;352
47;Valladolid;172;Torrescárcela;217;111;106
47;Valladolid;173;Traspinedo;796;409;387
47;Valladolid;174;Trigueros del Valle;290;146;144
47;Valladolid;175;Tudela de Duero;4719;2383;2336
47;Valladolid;176;Unión de Campos (La);430;206;224
47;Valladolid;177;Urones de Castroponce;237;130;107
47;Valladolid;178;Urueña;263;136;127
47;Valladolid;179;Valbuena de Duero;580;311;269
47;Valladolid;180;Valdearcos de la Vega;173;86;87
47;Valladolid;181;Valdenebro de los Valles;271;147;124
47;Valladolid;182;Valdestillas;1383;710;673
47;Valladolid;183;Valdunquillo;325;158;167
47;Valladolid;186;Valladolid;329206;159708;169498
47;Valladolid;184;Valoria la Buena;687;367;320
47;Valladolid;185;Valverde de Campos;133;73;60
47;Valladolid;187;Vega de Ruiponce;229;110;119
47;Valladolid;188;Vega de Valdetronco;222;120;102
47;Valladolid;189;Velascálvaro;219;114;105
47;Valladolid;190;Velilla;164;87;77
47;Valladolid;191;Velliza;207;107;100
47;Valladolid;192;Ventosa de la Cuesta;194;104;90
47;Valladolid;193;Viana de Cega;961;487;474
47;Valladolid;195;Villabáñez;443;224;219
47;Valladolid;196;Villabaruz de Campos;66;31;35
47;Valladolid;197;Villabrágima;1347;692;655
47;Valladolid;198;Villacarralón;172;89;83
47;Valladolid;199;Villacid de Campos;145;80;65
47;Valladolid;200;Villaco;179;103;76
47;Valladolid;203;Villafrades de Campos;185;84;101
47;Valladolid;204;Villafranca de Duero;496;255;241
47;Valladolid;205;Villafrechós;611;312;299
47;Valladolid;206;Villafuerte;192;94;98
47;Valladolid;207;Villagarcía de Campos;497;261;236
47;Valladolid;208;Villagómez la Nueva;123;57;66
47;Valladolid;209;Villalán de Campos;67;35;32
47;Valladolid;210;Villalar de los Comuneros;508;257;251
47;Valladolid;211;Villalba de la Loma;57;31;26
47;Valladolid;212;Villalba de los Alcores;691;360;331
47;Valladolid;213;Villalbarba;195;96;99
47;Valladolid;214;Villalón de Campos;2239;1106;1133
47;Valladolid;215;Villamuriel de Campos;118;57;61
47;Valladolid;216;Villán de Tordesillas;179;90;89
47;Valladolid;217;Villanubla;986;510;476
47;Valladolid;218;Villanueva de Duero;849;441;408
47;Valladolid;219;Villanueva de la Condesa;58;32;26
47;Valladolid;220;Villanueva de los Caballeros;351;178;173
47;Valladolid;221;Villanueva de los Infantes;165;83;82
47;Valladolid;222;Villanueva de San Mancio;113;53;60
47;Valladolid;223;Villardefrades;334;172;162
47;Valladolid;224;Villarmentero de Esgueva;137;64;73
47;Valladolid;225;Villasexmir;150;81;69
47;Valladolid;226;Villavaquerín;263;141;122
47;Valladolid;227;Villavellid;113;53;60
47;Valladolid;228;Villaverde de Medina;699;369;330
47;Valladolid;229;Villavicencio de los Caballeros;436;204;232
47;Valladolid;194;Viloria;438;236;202
47;Valladolid;230;Wamba;431;222;209
47;Valladolid;231;Zaratán;1155;590;565
47;Valladolid;232;Zarza (La);200;103;97
48;Vizcaya;001;Abadiño;7076;3600;3476
48;Vizcaya;002;Abanto y Ciérvana-Abanto Zierbena;9486;4734;4752
48;Vizcaya;911;Ajangiz;"";"";""
48;Vizcaya;912;Alonsotegi;"";"";""
48;Vizcaya;003;Amorebieta-Etxano;15814;8006;7808
48;Vizcaya;004;Amoroto;410;219;191
48;Vizcaya;005;Arakaldo;91;55;36
48;Vizcaya;006;Arantzazu;319;160;159
48;Vizcaya;093;Areatza;1194;566;628
48;Vizcaya;009;Arrankudiaga;756;384;372
48;Vizcaya;914;Arratzu;"";"";""
48;Vizcaya;010;Arrieta;430;228;202
48;Vizcaya;011;Arrigorriaga;9526;4670;4856
48;Vizcaya;023;Artea;634;310;324
48;Vizcaya;008;Artzentales;677;377;300
48;Vizcaya;091;Atxondo;1511;775;736
48;Vizcaya;070;Aulesti;705;396;309
48;Vizcaya;012;Bakio;1218;614;604
48;Vizcaya;090;Balmaseda;7680;3774;3906
48;Vizcaya;013;Barakaldo;114090;56593;57497
48;Vizcaya;014;Barrika;761;364;397
48;Vizcaya;015;Basauri;51971;25991;25980
48;Vizcaya;092;Bedia;1154;569;585
48;Vizcaya;016;Berango;4003;1983;2020
48;Vizcaya;017;Bermeo;18415;9174;9241
48;Vizcaya;018;Berriatua;1071;570;501
48;Vizcaya;019;Berriz;4200;2127;2073
48;Vizcaya;020;Bilbao;382413;183774;198639
48;Vizcaya;021;Busturia;1827;912;915
48;Vizcaya;901;Derio;5065;2541;2524
48;Vizcaya;026;Dima;1036;540;496
48;Vizcaya;027;Durango;27244;13536;13708
48;Vizcaya;028;Ea;831;406;425
48;Vizcaya;031;Elantxobe;570;261;309
48;Vizcaya;032;Elorrio;7774;3917;3857
48;Vizcaya;902;Erandio;25137;12443;12694
48;Vizcaya;033;Ereño;299;154;145
48;Vizcaya;034;Ermua;18637;9576;9061
48;Vizcaya;079;Errigoiti;476;259;217
48;Vizcaya;029;Etxebarri, Anteiglesia de San Esteban-Etxebarri Doneztebeko Elizatea;6532;3291;3241
48;Vizcaya;030;Etxebarria;795;420;375
48;Vizcaya;906;Forua;"";"";""
48;Vizcaya;035;Fruiz;295;152;143
48;Vizcaya;036;Galdakao;27396;13709;13687
48;Vizcaya;037;Galdames;822;429;393
48;Vizcaya;038;Gamiz-Fika;883;469;414
48;Vizcaya;039;Garay;246;127;119
48;Vizcaya;040;Gatika;859;432;427
48;Vizcaya;041;Gautegiz Arteaga;806;393;413
48;Vizcaya;046;Gernika-Lumo;18188;8984;9204
48;Vizcaya;044;Getxo;78672;38114;40558
48;Vizcaya;047;Gizaburuaga;137;68;69
48;Vizcaya;042;Gordexola;1594;809;785
48;Vizcaya;043;Gorliz;2690;1288;1402
48;Vizcaya;045;Güeñes;6167;3051;3116
48;Vizcaya;048;Ibarrangelu;540;243;297
48;Vizcaya;094;Igorre;3870;1952;1918
48;Vizcaya;049;Ispaster;633;337;296
48;Vizcaya;910;Iurreta;"";"";""
48;Vizcaya;050;Izurtza;277;138;139
48;Vizcaya;022;Karrantza Harana/Valle de Carranza;3471;1834;1637
48;Vizcaya;907;Kortezubi;"";"";""
48;Vizcaya;051;Lanestosa;323;167;156
48;Vizcaya;052;Larrabetzu;1549;765;784
48;Vizcaya;053;Laukiz;1058;537;521
48;Vizcaya;054;Leioa;24122;11926;12196
48;Vizcaya;057;Lekeitio;7563;3712;3851
48;Vizcaya;055;Lemoa;3005;1529;1476
48;Vizcaya;056;Lemoiz;790;399;391
48;Vizcaya;081;Lezama;1916;969;947
48;Vizcaya;903;Loiu;1686;870;816
48;Vizcaya;058;Mallabia;1120;582;538
48;Vizcaya;059;Mañaria;526;280;246
48;Vizcaya;060;Markina-Xemein;5081;2587;2494
48;Vizcaya;061;Maruri-Jatabe;505;253;252
48;Vizcaya;062;Mendata;379;213;166
48;Vizcaya;063;Mendexa;349;181;168
48;Vizcaya;064;Meñaka;404;215;189
48;Vizcaya;066;Morga;354;188;166
48;Vizcaya;068;Mundaka;1685;785;900
48;Vizcaya;069;Mungia;11275;5579;5696
48;Vizcaya;007;Munitibar-Arbatzegi Gerrikaitz;487;258;229
48;Vizcaya;908;Murueta;"";"";""
48;Vizcaya;071;Muskiz;6264;3147;3117
48;Vizcaya;067;Muxika;1551;811;740
48;Vizcaya;909;Nabarniz;"";"";""
48;Vizcaya;073;Ondarroa;11157;5614;5543
48;Vizcaya;075;Orozko;1995;984;1011
48;Vizcaya;083;Ortuella;9210;4562;4648
48;Vizcaya;072;Otxandio;1197;630;567
48;Vizcaya;077;Plentzia;2774;1332;1442
48;Vizcaya;078;Portugalete;58117;28807;29310
48;Vizcaya;082;Santurtzi;52480;26002;26478
48;Vizcaya;084;Sestao;38217;18802;19415
48;Vizcaya;904;Sondika;3594;1766;1828
48;Vizcaya;085;Sopelana;7171;3623;3548
48;Vizcaya;086;Sopuerta;2193;1140;1053
48;Vizcaya;076;Sukarrieta;289;140;149
48;Vizcaya;087;Trucios-Turtzioz;524;254;270
48;Vizcaya;088;Ubide;159;76;83
48;Vizcaya;065;Ugao-Miraballes;4160;2117;2043
48;Vizcaya;089;Urduliz;2495;1261;1234
48;Vizcaya;074;Urduña-Orduña;4228;2140;2088
48;Vizcaya;080;Valle de Trápaga-Trapagaran;13348;6605;6743
48;Vizcaya;095;Zaldibar;3293;1551;1742
48;Vizcaya;096;Zalla;7287;3662;3625
48;Vizcaya;905;Zamudio;3264;1659;1605
48;Vizcaya;097;Zaratamo;1612;814;798
48;Vizcaya;024;Zeanuri;1248;647;601
48;Vizcaya;025;Zeberio;980;507;473
48;Vizcaya;913;Zierbena;"";"";""
49;Zamora;002;Abezames;149;72;77
49;Zamora;003;Alcañices;1267;652;615
49;Zamora;004;Alcubilla de Nogales;287;133;154
49;Zamora;005;Alfaraz de Sayago;308;157;151
49;Zamora;006;Algodre;282;147;135
49;Zamora;007;Almaraz de Duero;543;275;268
49;Zamora;008;Almeida de Sayago;831;424;407
49;Zamora;009;Andavías;581;281;300
49;Zamora;010;Arcenillas;264;134;130
49;Zamora;011;Arcos de la Polvorosa;343;183;160
49;Zamora;012;Argañín;149;69;80
49;Zamora;013;Argujillo;476;246;230
49;Zamora;014;Arquillinos;230;118;112
49;Zamora;015;Arrabalde;526;257;269
49;Zamora;016;Aspariegos;499;241;258
49;Zamora;017;Asturianos;467;230;237
49;Zamora;018;Ayoó de Vidriales;668;331;337
49;Zamora;019;Barcial del Barco;375;204;171
49;Zamora;020;Belver de los Montes;620;323;297
49;Zamora;021;Benavente;13786;6657;7129
49;Zamora;022;Benegiles;520;276;244
49;Zamora;023;Bermillo de Sayago;1858;945;913
49;Zamora;024;Bóveda de Toro (La);1177;595;582
49;Zamora;025;Bretó;322;154;168
49;Zamora;026;Bretocino;376;201;175
49;Zamora;027;Brime de Sog;335;144;191
49;Zamora;028;Brime de Urz;203;101;102
49;Zamora;029;Burganes de Valverde;980;508;472
49;Zamora;030;Bustillo del Oro;226;102;124
49;Zamora;031;Cabañas de Sayago;269;141;128
49;Zamora;032;Calzadilla de Tera;667;323;344
49;Zamora;033;Camarzana de Tera;1329;670;659
49;Zamora;034;Cañizal;744;381;363
49;Zamora;035;Cañizo;429;206;223
49;Zamora;036;Carbajales de Alba;790;384;406
49;Zamora;037;Carbellino;305;161;144
49;Zamora;038;Casaseca de Campeán;240;123;117
49;Zamora;039;Casaseca de las Chanas;441;221;220
49;Zamora;040;Castrillo de la Guareña;191;94;97
49;Zamora;041;Castrogonzalo;633;313;320
49;Zamora;042;Castronuevo;476;248;228
49;Zamora;043;Castroverde de Campos;572;279;293
49;Zamora;044;Cazurra;132;71;61
49;Zamora;046;Cerecinos de Campos;575;296;279
49;Zamora;047;Cerecinos del Carrizal;236;124;112
49;Zamora;048;Cernadilla;246;113;133
49;Zamora;050;Cobreros;1022;495;527
49;Zamora;052;Coomonte;408;199;209
49;Zamora;053;Coreses;1363;714;649
49;Zamora;054;Corrales;1560;773;787
49;Zamora;055;Cotanes del Monte;239;122;117
49;Zamora;056;Cubillos;502;267;235
49;Zamora;057;Cubo de Benavente;282;148;134
49;Zamora;058;Cubo de Tierra del Vino (El);500;269;231
49;Zamora;059;Cuelgamures;174;98;76
49;Zamora;061;Entrala;177;88;89
49;Zamora;062;Espadañedo;261;126;135
49;Zamora;063;Faramontanos de Tábara;641;321;320
49;Zamora;064;Fariza;888;436;452
49;Zamora;065;Fermoselle;2218;1096;1122
49;Zamora;066;Ferreras de Abajo;740;384;356
49;Zamora;067;Ferreras de Arriba;734;372;362
49;Zamora;068;Ferreruela;846;448;398
49;Zamora;069;Figueruela de Arriba;743;364;379
49;Zamora;071;Fonfría;1502;759;743
49;Zamora;075;Fresno de la Polvorosa;291;143;148
49;Zamora;076;Fresno de la Ribera;492;273;219
49;Zamora;077;Fresno de Sayago;412;207;205
49;Zamora;078;Friera de Valverde;371;185;186
49;Zamora;079;Fuente Encalada;225;117;108
49;Zamora;080;Fuentelapeña;1160;572;588
49;Zamora;082;Fuentes de Ropel;786;403;383
49;Zamora;081;Fuentesaúco;2089;1029;1060
49;Zamora;083;Fuentesecas;132;62;70
49;Zamora;084;Fuentespreadas;503;274;229
49;Zamora;085;Galende;1616;788;828
49;Zamora;086;Gallegos del Pan;239;120;119
49;Zamora;087;Gallegos del Río;1144;590;554
49;Zamora;088;Gamones;147;80;67
49;Zamora;090;Gema;380;185;195
49;Zamora;091;Granja de Moreruela;474;223;251
49;Zamora;092;Granucillo;381;194;187
49;Zamora;093;Guarrate;491;270;221
49;Zamora;094;Hermisende;626;301;325
49;Zamora;095;Hiniesta (La);445;223;222
49;Zamora;096;Jambrina;326;166;160
49;Zamora;097;Justel;275;143;132
49;Zamora;098;Losacino;460;240;220
49;Zamora;099;Losacio;201;105;96
49;Zamora;100;Lubián;548;263;285
49;Zamora;101;Luelmo;343;175;168
49;Zamora;102;Maderal (El);358;183;175
49;Zamora;103;Madridanos;657;355;302
49;Zamora;104;Mahide;727;364;363
49;Zamora;105;Maire de Castroponce;334;172;162
49;Zamora;107;Malva;335;159;176
49;Zamora;108;Manganeses de la Lampreana;1125;559;566
49;Zamora;109;Manganeses de la Polvorosa;1023;499;524
49;Zamora;110;Manzanal de Arriba;678;328;350
49;Zamora;112;Manzanal de los Infantes;253;123;130
49;Zamora;111;Manzanal del Barco;273;142;131
49;Zamora;113;Matilla de Arzón;398;208;190
49;Zamora;114;Matilla la Seca;108;55;53
49;Zamora;115;Mayalde;337;176;161
49;Zamora;116;Melgar de Tera;712;353;359
49;Zamora;117;Micereces de Tera;789;399;390
49;Zamora;118;Milles de la Polvorosa;328;165;163
49;Zamora;119;Molacillos;386;200;186
49;Zamora;120;Molezuelas de la Carballeda;207;102;105
49;Zamora;121;Mombuey;532;271;261
49;Zamora;122;Monfarracinos;614;321;293
49;Zamora;123;Montamarta;862;403;459
49;Zamora;124;Moral de Sayago;451;238;213
49;Zamora;126;Moraleja de Sayago;345;186;159
49;Zamora;125;Moraleja del Vino;1238;662;576
49;Zamora;128;Morales de Rey;862;433;429
49;Zamora;129;Morales de Toro;1234;605;629
49;Zamora;130;Morales de Valverde;431;210;221
49;Zamora;127;Morales del Vino;1076;565;511
49;Zamora;131;Moralina;415;210;205
49;Zamora;132;Moreruela de los Infanzones;560;298;262
49;Zamora;133;Moreruela de Tábara;667;338;329
49;Zamora;134;Muelas de los Caballeros;315;163;152
49;Zamora;135;Muelas del Pan;1014;510;504
49;Zamora;136;Muga de Sayago;556;267;289
49;Zamora;137;Navianos de Valverde;331;179;152
49;Zamora;138;Olmillos de Castro;663;344;319
49;Zamora;139;Otero de Bodas;362;185;177
49;Zamora;141;Pajares de la Lampreana;630;314;316
49;Zamora;143;Palacios de Sanabria;454;213;241
49;Zamora;142;Palacios del Pan;309;148;161
49;Zamora;145;Pedralba de la Pradería;560;285;275
49;Zamora;146;Pego (El);581;303;278
49;Zamora;147;Peleagonzalo;583;298;285
49;Zamora;148;Peleas de Abajo;225;115;110
49;Zamora;149;Peñausende;664;341;323
49;Zamora;150;Peque;300;139;161
49;Zamora;151;Perdigón (El);938;481;457
49;Zamora;152;Pereruela;962;477;485
49;Zamora;153;Perilla de Castro;412;207;205
49;Zamora;154;Pías;363;187;176
49;Zamora;155;Piedrahita de Castro;195;100;95
49;Zamora;156;Pinilla de Toro;502;236;266
49;Zamora;157;Pino del Oro;301;160;141
49;Zamora;158;Piñero (El);353;177;176
49;Zamora;160;Pobladura de Valderaduey;106;47;59
49;Zamora;159;Pobladura del Valle;436;207;229
49;Zamora;162;Porto;470;235;235
49;Zamora;163;Pozoantiguo;472;246;226
49;Zamora;164;Pozuelo de Tábara;328;165;163
49;Zamora;165;Prado;136;63;73
49;Zamora;166;Puebla de Sanabria;1823;876;947
49;Zamora;167;Pueblica de Valverde;446;227;219
49;Zamora;170;Quintanilla de Urz;175;95;80
49;Zamora;168;Quintanilla del Monte;196;101;95
49;Zamora;169;Quintanilla del Olmo;77;36;41
49;Zamora;171;Quiruelas de Vidriales;1173;583;590
49;Zamora;172;Rabanales;1126;577;549
49;Zamora;173;Rábano de Aliste;686;338;348
49;Zamora;174;Requejo;318;168;150
49;Zamora;175;Revellinos;424;220;204
49;Zamora;176;Riofrío de Aliste;1363;706;657
49;Zamora;177;Rionegro del Puente;518;243;275
49;Zamora;178;Roales;337;166;171
49;Zamora;179;Robleda-Cervantes;517;254;263
49;Zamora;180;Roelos de Sayago;224;111;113
49;Zamora;181;Rosinos de la Requejada;718;352;366
49;Zamora;183;Salce;189;95;94
49;Zamora;184;Samir de los Caños;304;155;149
49;Zamora;185;San Agustín del Pozo;251;135;116
49;Zamora;186;San Cebrián de Castro;501;248;253
49;Zamora;187;San Cristóbal de Entreviñas;1740;901;839
49;Zamora;188;San Esteban del Molar;272;138;134
49;Zamora;189;San Justo;482;232;250
49;Zamora;190;San Martín de Valderaduey;134;67;67
49;Zamora;191;San Miguel de la Ribera;515;263;252
49;Zamora;192;San Miguel del Valle;343;160;183
49;Zamora;193;San Pedro de Ceque;776;390;386
49;Zamora;194;San Pedro de la Nave-Almendra;610;307;303
49;Zamora;208;San Vicente de la Cabeza;853;437;416
49;Zamora;209;San Vitero;876;445;431
49;Zamora;197;Santa Clara de Avedillo;358;174;184
49;Zamora;199;Santa Colomba de las Monjas;393;199;194
49;Zamora;200;Santa Cristina de la Polvorosa;1357;686;671
49;Zamora;201;Santa Croya de Tera;616;308;308
49;Zamora;202;Santa Eufemia del Barco;410;216;194
49;Zamora;203;Santa María de la Vega;613;314;299
49;Zamora;204;Santa María de Valverde;146;83;63
49;Zamora;205;Santibáñez de Tera;754;389;365
49;Zamora;206;Santibáñez de Vidriales;1780;861;919
49;Zamora;207;Santovenia;604;306;298
49;Zamora;210;Sanzoles;856;430;426
49;Zamora;214;Tábara;1076;554;522
49;Zamora;216;Tapioles;282;154;128
49;Zamora;219;Toro;9692;4714;4978
49;Zamora;220;Torre del Valle (La);259;135;124
49;Zamora;221;Torregamones;444;218;226
49;Zamora;222;Torres del Carrizal;597;304;293
49;Zamora;223;Trabazos;1196;612;584
49;Zamora;224;Trefacio;264;125;139
49;Zamora;225;Uña de Quintana;336;170;166
49;Zamora;226;Vadillo de la Guareña;403;199;204
49;Zamora;227;Valcabado;322;165;157
49;Zamora;228;Valdefinjas;130;69;61
49;Zamora;229;Valdescorriel;233;112;121
49;Zamora;230;Vallesa de la Guareña;272;146;126
49;Zamora;231;Vega de Tera;705;338;367
49;Zamora;232;Vega de Villalobos;238;121;117
49;Zamora;233;Vegalatrave;208;110;98
49;Zamora;234;Venialbo;631;332;299
49;Zamora;235;Vezdemarbán;926;444;482
49;Zamora;236;Vidayanes;160;76;84
49;Zamora;237;Videmala;327;160;167
49;Zamora;238;Villabrázaro;543;276;267
49;Zamora;239;Villabuena del Puente;1218;624;594
49;Zamora;240;Villadepera;316;152;164
49;Zamora;241;Villaescusa;490;254;236
49;Zamora;242;Villafáfila;765;388;377
49;Zamora;243;Villaferrueña;232;117;115
49;Zamora;244;Villageriz;89;45;44
49;Zamora;245;Villalazán;437;224;213
49;Zamora;246;Villalba de la Lampreana;394;208;186
49;Zamora;247;Villalcampo;879;434;445
49;Zamora;248;Villalobos;421;196;225
49;Zamora;249;Villalonso;184;83;101
49;Zamora;250;Villalpando;1939;949;990
49;Zamora;251;Villalube;422;220;202
49;Zamora;252;Villamayor de Campos;817;398;419
49;Zamora;255;Villamor de los Escuderos;674;336;338
49;Zamora;256;Villanázar;469;223;246
49;Zamora;257;Villanueva de Azoague;467;235;232
49;Zamora;258;Villanueva de Campeán;225;111;114
49;Zamora;259;Villanueva de las Peras;270;133;137
49;Zamora;260;Villanueva del Campo;1324;645;679
49;Zamora;263;Villar de Fallaves;155;79;76
49;Zamora;264;Villar del Buey;1079;571;508
49;Zamora;261;Villaralbo;1467;741;726
49;Zamora;262;Villardeciervos;654;304;350
49;Zamora;265;Villardiegua de la Ribera;220;106;114
49;Zamora;266;Villárdiga;152;78;74
49;Zamora;267;Villardondiego;186;97;89
49;Zamora;268;Villarrín de Campos;773;372;401
49;Zamora;269;Villaseco del Pan;436;209;227
49;Zamora;270;Villavendimio;288;151;137
49;Zamora;272;Villaveza de Valverde;192;94;98
49;Zamora;271;Villaveza del Agua;328;175;153
49;Zamora;273;Viñas;356;180;176
49;Zamora;275;Zamora;60708;29036;31672
50;Zaragoza;001;Abanto;292;155;137
50;Zaragoza;002;Acered;381;197;184
50;Zaragoza;003;Agón;246;130;116
50;Zaragoza;004;Aguarón;798;393;405
50;Zaragoza;005;Aguilón;315;156;159
50;Zaragoza;006;Ainzón;1296;650;646
50;Zaragoza;007;Aladrén;53;23;30
50;Zaragoza;008;Alagón;5453;2710;2743
50;Zaragoza;009;Alarba;174;101;73
50;Zaragoza;010;Alberite de San Juan;117;61;56
50;Zaragoza;011;Albeta;153;74;79
50;Zaragoza;012;Alborge;132;58;74
50;Zaragoza;013;Alcalá de Ebro;365;183;182
50;Zaragoza;014;Alcalá de Moncayo;185;104;81
50;Zaragoza;015;Alconchel de Ariza;262;131;131
50;Zaragoza;016;Aldehuela de Liestos;86;46;40
50;Zaragoza;017;Alfajarín;1375;715;660
50;Zaragoza;018;Alfamén;1339;697;642
50;Zaragoza;019;Alforque;98;49;49
50;Zaragoza;020;Alhama de Aragón;1328;648;680
50;Zaragoza;021;Almochuel;67;35;32
50;Zaragoza;022;Almolda (La);782;382;400
50;Zaragoza;023;Almonacid de la Cuba;398;205;193
50;Zaragoza;024;Almonacid de la Sierra;890;458;432
50;Zaragoza;025;Almunia de Doña Godina (La);5039;2561;2478
50;Zaragoza;026;Alpartir;639;350;289
50;Zaragoza;027;Ambel;450;214;236
50;Zaragoza;028;Anento;29;19;10
50;Zaragoza;029;Aniñón;1021;541;480
50;Zaragoza;030;Añón de Moncayo;363;209;154
50;Zaragoza;031;Aranda de Moncayo;291;156;135
50;Zaragoza;032;Arándiga;628;312;316
50;Zaragoza;033;Ardisa;91;43;48
50;Zaragoza;034;Ariza;1567;749;818
50;Zaragoza;035;Artieda;111;58;53
50;Zaragoza;036;Asín;113;58;55
50;Zaragoza;037;Atea;311;171;140
50;Zaragoza;038;Ateca;2195;1065;1130
50;Zaragoza;039;Azuara;885;465;420
50;Zaragoza;040;Badules;132;71;61
50;Zaragoza;041;Bagüés;13;5;8
50;Zaragoza;042;Balconchán;39;21;18
50;Zaragoza;043;Bárboles;403;214;189
50;Zaragoza;044;Bardallur;368;183;185
50;Zaragoza;045;Belchite;1673;836;837
50;Zaragoza;046;Belmonte de Gracián;394;218;176
50;Zaragoza;047;Berdejo;37;18;19
50;Zaragoza;048;Berrueco;39;23;16
50;Zaragoza;901;Biel;247;132;115
50;Zaragoza;050;Bijuesca;135;70;65
50;Zaragoza;051;Biota;1449;749;700
50;Zaragoza;052;Bisimbre;166;79;87
50;Zaragoza;053;Boquiñeni;1130;587;543
50;Zaragoza;054;Bordalba;129;71;58
50;Zaragoza;055;Borja;4167;2056;2111
50;Zaragoza;056;Botorrita;405;221;184
50;Zaragoza;057;Brea de Aragón;2103;1036;1067
50;Zaragoza;058;Bubierca;146;69;77
50;Zaragoza;059;Bujaraloz;1132;588;544
50;Zaragoza;060;Bulbuente;310;158;152
50;Zaragoza;061;Bureta;377;195;182
50;Zaragoza;062;Burgo de Ebro (El);1119;550;569
50;Zaragoza;063;Buste (El);157;80;77
50;Zaragoza;064;Cabañas de Ebro;587;294;293
50;Zaragoza;065;Cabolafuente;128;72;56
50;Zaragoza;066;Cadrete;827;418;409
50;Zaragoza;067;Calatayud;17753;8473;9280
50;Zaragoza;068;Calatorao;2855;1449;1406
50;Zaragoza;069;Calcena;109;57;52
50;Zaragoza;070;Calmarza;153;76;77
50;Zaragoza;071;Campillo de Aragón;243;132;111
50;Zaragoza;072;Carenas;286;143;143
50;Zaragoza;073;Cariñena;2991;1507;1484
50;Zaragoza;074;Caspe;8353;4144;4209
50;Zaragoza;075;Castejón de Alarba;159;91;68
50;Zaragoza;076;Castejón de las Armas;174;88;86
50;Zaragoza;077;Castejón de Valdejasa;431;232;199
50;Zaragoza;078;Castiliscar;490;249;241
50;Zaragoza;079;Cervera de la Cañada;403;204;199
50;Zaragoza;080;Cerveruela;4;2;2
50;Zaragoza;081;Cetina;872;444;428
50;Zaragoza;092;Chiprana;478;239;239
50;Zaragoza;093;Chodes;191;92;99
50;Zaragoza;082;Cimballa;154;78;76
50;Zaragoza;083;Cinco Olivas;157;80;77
50;Zaragoza;084;Clarés de Ribota;140;72;68
50;Zaragoza;085;Codo;384;192;192
50;Zaragoza;086;Codos;357;206;151
50;Zaragoza;087;Contamina;85;40;45
50;Zaragoza;088;Cosuenda;485;242;243
50;Zaragoza;089;Cuarte de Huerva;1250;658;592
50;Zaragoza;090;Cubel;304;156;148
50;Zaragoza;091;Cuerlas (Las);93;51;42
50;Zaragoza;094;Daroca;2537;1262;1275
50;Zaragoza;095;Ejea de los Caballeros;15093;7677;7416
50;Zaragoza;096;Embid de Ariza;112;61;51
50;Zaragoza;098;Encinacorba;353;189;164
50;Zaragoza;099;Épila;3796;1915;1881
50;Zaragoza;100;Erla;600;291;309
50;Zaragoza;101;Escatrón;1436;719;717
50;Zaragoza;102;Fabara;1447;763;684
50;Zaragoza;104;Farlete;492;243;249
50;Zaragoza;105;Fayón;459;228;231
50;Zaragoza;106;Fayos (Los);211;111;100
50;Zaragoza;107;Figueruelas;774;388;386
50;Zaragoza;108;Fombuena;10;7;3
50;Zaragoza;109;Frago (El);130;75;55
50;Zaragoza;110;Frasno (El);717;377;340
50;Zaragoza;111;Fréscano;310;152;158
50;Zaragoza;113;Fuendejalón;1004;505;499
50;Zaragoza;114;Fuendetodos;171;95;76
50;Zaragoza;115;Fuentes de Ebro;3775;1961;1814
50;Zaragoza;116;Fuentes de Jiloca;461;241;220
50;Zaragoza;117;Gallocanta;199;103;96
50;Zaragoza;118;Gallur;3312;1656;1656
50;Zaragoza;119;Gelsa;1430;714;716
50;Zaragoza;120;Godojos;98;51;47
50;Zaragoza;121;Gotor;411;216;195
50;Zaragoza;122;Grisel;55;27;28
50;Zaragoza;123;Grisén;494;243;251
50;Zaragoza;124;Herrera de los Navarros;794;410;384
50;Zaragoza;125;Ibdes;679;353;326
50;Zaragoza;126;Illueca;3200;1577;1623
50;Zaragoza;128;Isuerre;65;35;30
50;Zaragoza;129;Jaraba;338;162;176
50;Zaragoza;130;Jarque;649;344;305
50;Zaragoza;131;Jaulín;305;152;153
50;Zaragoza;132;Joyosa (La);341;177;164
50;Zaragoza;133;Lagata;166;86;80
50;Zaragoza;134;Langa del Castillo;240;109;131
50;Zaragoza;135;Layana;206;103;103
50;Zaragoza;136;Lécera;1048;509;539
50;Zaragoza;138;Lechón;70;39;31
50;Zaragoza;137;Leciñena;1535;768;767
50;Zaragoza;139;Letux;523;268;255
50;Zaragoza;140;Litago;218;126;92
50;Zaragoza;141;Lituénigo;138;72;66
50;Zaragoza;142;Lobera de Onsella;82;50;32
50;Zaragoza;143;Longares;935;457;478
50;Zaragoza;144;Longás;22;16;6
50;Zaragoza;146;Lucena de Jalón;313;156;157
50;Zaragoza;147;Luceni;1186;587;599
50;Zaragoza;148;Luesia;534;289;245
50;Zaragoza;149;Luesma;29;14;15
50;Zaragoza;150;Lumpiaque;1098;560;538
50;Zaragoza;151;Luna;1063;549;514
50;Zaragoza;152;Maella;2278;1148;1130
50;Zaragoza;153;Magallón;1394;709;685
50;Zaragoza;154;Mainar;199;103;96
50;Zaragoza;155;Malanquilla;130;66;64
50;Zaragoza;156;Maleján;334;170;164
50;Zaragoza;160;Mallén;3002;1523;1479
50;Zaragoza;157;Malón;546;274;272
50;Zaragoza;159;Maluenda;1164;583;581
50;Zaragoza;161;Manchones;179;89;90
50;Zaragoza;162;Mara;283;144;139
50;Zaragoza;163;María de Huerva;717;358;359
50;Zaragoza;902;Marracos;"";"";""
50;Zaragoza;164;Mediana de Aragón;564;278;286
50;Zaragoza;165;Mequinenza;2800;1411;1389
50;Zaragoza;166;Mesones de Isuela;482;242;240
50;Zaragoza;167;Mezalocha;338;181;157
50;Zaragoza;168;Mianos;54;27;27
50;Zaragoza;169;Miedes de Aragón;638;322;316
50;Zaragoza;170;Monegrillo;592;327;265
50;Zaragoza;171;Moneva;95;43;52
50;Zaragoza;172;Monreal de Ariza;394;206;188
50;Zaragoza;173;Monterde;243;122;121
50;Zaragoza;174;Montón;184;91;93
50;Zaragoza;175;Morata de Jalón;1854;919;935
50;Zaragoza;176;Morata de Jiloca;435;225;210
50;Zaragoza;177;Morés;610;308;302
50;Zaragoza;178;Moros;700;363;337
50;Zaragoza;179;Moyuela;475;243;232
50;Zaragoza;180;Mozota;147;67;80
50;Zaragoza;181;Muel;1265;629;636
50;Zaragoza;182;Muela (La);933;490;443
50;Zaragoza;183;Munébrega;604;310;294
50;Zaragoza;184;Murero;183;100;83
50;Zaragoza;185;Murillo de Gállego;159;86;73
50;Zaragoza;186;Navardún;98;53;45
50;Zaragoza;187;Nigüella;150;75;75
50;Zaragoza;188;Nombrevilla;39;19;20
50;Zaragoza;189;Nonaspe;1192;611;581
50;Zaragoza;190;Novallas;866;420;446
50;Zaragoza;191;Novillas;786;406;380
50;Zaragoza;192;Nuévalos;314;172;142
50;Zaragoza;193;Nuez de Ebro;473;250;223
50;Zaragoza;194;Olvés;227;116;111
50;Zaragoza;195;Orcajo;50;23;27
50;Zaragoza;196;Orera;173;92;81
50;Zaragoza;197;Orés;153;85;68
50;Zaragoza;198;Oseja;19;10;9
50;Zaragoza;199;Osera de Ebro;340;155;185
50;Zaragoza;200;Paniza;804;397;407
50;Zaragoza;201;Paracuellos de Jiloca;555;259;296
50;Zaragoza;202;Paracuellos de la Ribera;413;198;215
50;Zaragoza;203;Pastriz;737;359;378
50;Zaragoza;204;Pedrola;2340;1182;1158
50;Zaragoza;205;Pedrosas (Las);106;50;56
50;Zaragoza;206;Perdiguera;528;273;255
50;Zaragoza;207;Piedratajada;279;135;144
50;Zaragoza;208;Pina de Ebro;2173;1079;1094
50;Zaragoza;209;Pinseque;1354;666;688
50;Zaragoza;210;Pintanos (Los);79;47;32
50;Zaragoza;211;Plasencia de Jalón;418;213;205
50;Zaragoza;212;Pleitas;91;46;45
50;Zaragoza;213;Plenas;187;93;94
50;Zaragoza;214;Pomer;31;14;17
50;Zaragoza;215;Pozuel de Ariza;37;22;15
50;Zaragoza;216;Pozuelo de Aragón;427;225;202
50;Zaragoza;217;Pradilla de Ebro;754;397;357
50;Zaragoza;218;Puebla de Albortón;183;92;91
50;Zaragoza;219;Puebla de Alfindén (La);1416;719;697
50;Zaragoza;220;Puendeluna;64;32;32
50;Zaragoza;221;Purujosa;8;6;2
50;Zaragoza;222;Quinto;2286;1152;1134
50;Zaragoza;223;Remolinos;1381;703;678
50;Zaragoza;224;Retascón;84;44;40
50;Zaragoza;225;Ricla;2280;1194;1086
50;Zaragoza;227;Romanos;179;97;82
50;Zaragoza;228;Rueda de Jalón;401;209;192
50;Zaragoza;229;Ruesca;102;55;47
50;Zaragoza;241;Sabiñán;1191;576;615
50;Zaragoza;230;Sádaba;2003;1008;995
50;Zaragoza;231;Salillas de Jalón;448;225;223
50;Zaragoza;232;Salvatierra de Esca;371;200;171
50;Zaragoza;233;Samper del Salz;84;38;46
50;Zaragoza;234;San Martín de la Virgen de Moncayo;333;177;156
50;Zaragoza;235;San Mateo de Gállego;1862;960;902
50;Zaragoza;236;Santa Cruz de Grío;270;154;116
50;Zaragoza;237;Santa Cruz de Moncayo;104;56;48
50;Zaragoza;238;Santa Eulalia de Gállego;132;70;62
50;Zaragoza;239;Santed;93;44;49
50;Zaragoza;240;Sástago;1721;865;856
50;Zaragoza;242;Sediles;118;63;55
50;Zaragoza;243;Sestrica;597;308;289
50;Zaragoza;244;Sierra de Luna;338;175;163
50;Zaragoza;245;Sigüés;210;110;100
50;Zaragoza;246;Sisamón;130;74;56
50;Zaragoza;247;Sobradiel;577;270;307
50;Zaragoza;248;Sos del Rey Católico;1004;512;492
50;Zaragoza;249;Tabuenca;567;291;276
50;Zaragoza;250;Talamantes;59;31;28
50;Zaragoza;251;Tarazona;11040;5312;5728
50;Zaragoza;252;Tauste;7246;3629;3617
50;Zaragoza;253;Terrer;824;387;437
50;Zaragoza;254;Tierga;322;172;150
50;Zaragoza;255;Tobed;349;173;176
50;Zaragoza;256;Torralba de los Frailes;141;72;69
50;Zaragoza;257;Torralba de Ribota;287;156;131
50;Zaragoza;258;Torralbilla;85;46;39
50;Zaragoza;259;Torrehermosa;145;73;72
50;Zaragoza;260;Torrelapaja;82;42;40
50;Zaragoza;261;Torrellas;388;191;197
50;Zaragoza;262;Torres de Berrellén;1459;744;715
50;Zaragoza;263;Torrijo de la Cañada;561;302;259
50;Zaragoza;264;Tosos;286;154;132
50;Zaragoza;265;Trasmoz;86;43;43
50;Zaragoza;266;Trasobares;317;168;149
50;Zaragoza;267;Uncastillo;931;469;462
50;Zaragoza;268;Undués de Lerda;49;25;24
50;Zaragoza;269;Urrea de Jalón;423;202;221
50;Zaragoza;270;Urriés;89;48;41
50;Zaragoza;271;Used;505;252;253
50;Zaragoza;272;Utebo;6819;3411;3408
50;Zaragoza;274;Val de San Martín;89;39;50
50;Zaragoza;273;Valdehorna;90;49;41
50;Zaragoza;275;Valmadrid;83;44;39
50;Zaragoza;276;Valpalmas;261;135;126
50;Zaragoza;277;Valtorres;151;75;76
50;Zaragoza;278;Velilla de Ebro;328;163;165
50;Zaragoza;279;Velilla de Jiloca;165;85;80
50;Zaragoza;280;Vera de Moncayo;560;284;276
50;Zaragoza;281;Vierlas;122;63;59
50;Zaragoza;283;Villadoz;118;63;55
50;Zaragoza;284;Villafeliche;285;143;142
50;Zaragoza;285;Villafranca de Ebro;679;335;344
50;Zaragoza;286;Villalba de Perejil;107;51;56
50;Zaragoza;287;Villalengua;545;289;256
50;Zaragoza;288;Villanueva de Gállego;2445;1231;1214
50;Zaragoza;290;Villanueva de Huerva;727;360;367
50;Zaragoza;289;Villanueva de Jiloca;155;85;70
50;Zaragoza;291;Villar de los Navarros;247;122;125
50;Zaragoza;292;Villarreal de Huerva;201;120;81
50;Zaragoza;293;Villarroya de la Sierra;906;446;460
50;Zaragoza;294;Villarroya del Campo;85;48;37
50;Zaragoza;282;Vilueña (La);139;66;73
50;Zaragoza;295;Vistabella;45;21;24
50;Zaragoza;296;Zaida (La);717;353;364
50;Zaragoza;297;Zaragoza;575317;278167;297150
50;Zaragoza;298;Zuera;5247;2664;2583
51;Ceuta;001;Ceuta;53239;26493;26746
52;Melilla;001;Melilla;53239;26493;26746
