01;Álava;001;Alegría-Dulantzi;999;503;496
01;Álava;002;Amurrio;9744;4867;4877
01;Álava;049;Añana;190;97;93
01;Álava;003;Aramaio;1310;682;628
01;Álava;006;Armiñón;127;66;61
01;Álava;037;Arraia-Maeztu;695;368;327
01;Álava;008;Arrazua-Ubarrundia;651;347;304
01;Álava;004;Artziniega;1227;598;629
01;Álava;009;Asparrena;1494;749;745
01;Álava;010;Ayala/Aiara;2065;1027;1038
01;Álava;011;Baños de Ebro/Mañueta;332;181;151
01;Álava;013;Barrundia;573;320;253
01;Álava;014;Berantevilla;421;217;204
01;Álava;016;Bernedo;556;312;244
01;Álava;017;Campezo/Kanpezu;1143;599;544
01;Álava;021;Elburgo/Burgelu;202;107;95
01;Álava;022;Elciego;908;448;460
01;Álava;023;Elvillar/Bilar;361;192;169
01;Álava;056;Harana/Valle de Arana;393;215;178
01;Álava;901;Iruña Oka/Iruña de Oca;1502;767;735
01;Álava;027;Iruraiz-Gauna;425;230;195
01;Álava;019;Kripan;201;103;98
01;Álava;020;Kuartango;350;199;151
01;Álava;028;Labastida;971;521;450
01;Álava;030;Lagrán;188;103;85
01;Álava;031;Laguardia;1486;762;724
01;Álava;032;Lanciego/Lantziego;641;351;290
01;Álava;902;Lantarón;804;420;384
01;Álava;033;Lapuebla de Labarca;814;408;406
01;Álava;058;Legutiano;1213;669;544
01;Álava;034;Leza;190;103;87
01;Álava;036;Llodio;20475;10324;10151
01;Álava;039;Moreda de Álava;272;149;123
01;Álava;041;Navaridas;217;115;102
01;Álava;042;Okondo;705;366;339
01;Álava;043;Oyón/Oion;2132;1064;1068
01;Álava;044;Peñacerrada-Urizaharra;222;120;102
01;Álava;046;Ribera Alta;499;295;204
01;Álava;047;Ribera Baja/Erribera Beitia;375;204;171
01;Álava;051;Salvatierra/Agurain;3650;1825;1825
01;Álava;052;Samaniego;271;135;136
01;Álava;053;San Millán/Donemiliaga;685;369;316
01;Álava;054;Urkabustaiz;860;451;409
01;Álava;055;Valdegovía;793;442;351
01;Álava;057;Villabuena de Álava/Eskuernaga;352;174;178
01;Álava;059;Vitoria-Gasteiz;206116;101646;104470
01;Álava;060;Yécora/Lekora;243;123;120
01;Álava;061;Zalduondo;120;67;53
01;Álava;062;Zambrana;327;176;151
01;Álava;018;Zigoitia;746;400;346
01;Álava;063;Zuia;1211;606;605
02;Albacete;001;Abengibre;1065;530;535
02;Albacete;002;Alatoz;794;412;382
02;Albacete;003;Albacete;130023;63646;66377
02;Albacete;004;Albatana;915;465;450
02;Albacete;005;Alborea;797;412;385
02;Albacete;006;Alcadozo;826;423;403
02;Albacete;007;Alcalá del Júcar;1678;853;825
02;Albacete;008;Alcaraz;1963;946;1017
02;Albacete;009;Almansa;22599;11089;11510
02;Albacete;010;Alpera;2307;1174;1133
02;Albacete;011;Ayna;1193;600;593
02;Albacete;012;Balazote;2203;1113;1090
02;Albacete;014;Ballestero (El);676;343;333
02;Albacete;013;Balsa de Ves;273;148;125
02;Albacete;015;Barrax;1979;995;984
02;Albacete;016;Bienservida;942;483;459
02;Albacete;017;Bogarra;1500;795;705
02;Albacete;018;Bonete;1301;661;640
02;Albacete;019;Bonillo (El);3347;1695;1652
02;Albacete;020;Carcelén;790;406;384
02;Albacete;021;Casas de Juan Núñez;1251;643;608
02;Albacete;022;Casas de Lázaro;524;267;257
02;Albacete;023;Casas de Ves;1029;527;502
02;Albacete;024;Casas-Ibáñez;3961;1981;1980
02;Albacete;025;Caudete;8306;4133;4173
02;Albacete;026;Cenizate;1073;549;524
02;Albacete;029;Chinchilla de Monte-Aragón;3202;1641;1561
02;Albacete;027;Corral-Rubio;498;256;242
02;Albacete;028;Cotillas;274;135;139
02;Albacete;030;Elche de la Sierra;3746;1835;1911
02;Albacete;032;Fuensanta;420;202;218
02;Albacete;033;Fuente-Álamo;2432;1221;1211
02;Albacete;034;Fuentealbilla;1868;942;926
02;Albacete;031;Férez;883;440;443
02;Albacete;035;Gineta (La);2133;1031;1102
02;Albacete;036;Golosalvo;137;70;67
02;Albacete;037;Hellín;24246;11950;12296
02;Albacete;038;Herrera (La);443;239;204
02;Albacete;039;Higueruela;1339;654;685
02;Albacete;040;Hoya-Gonzalo;740;377;363
02;Albacete;041;Jorquera;695;367;328
02;Albacete;042;Letur;1449;740;709
02;Albacete;043;Lezuza;2046;1047;999
02;Albacete;044;Liétor;1922;978;944
02;Albacete;045;Madrigueras;4373;2190;2183
02;Albacete;046;Mahora;1373;669;704
02;Albacete;047;Masegoso;194;107;87
02;Albacete;048;Minaya;1940;988;952
02;Albacete;049;Molinicos;1686;874;812
02;Albacete;050;Montalvos;123;63;60
02;Albacete;051;Montealegre del Castillo;2207;1112;1095
02;Albacete;052;Motilleja;571;292;279
02;Albacete;053;Munera;4087;2070;2017
02;Albacete;054;Navas de Jorquera;601;310;291
02;Albacete;055;Nerpio;2062;1079;983
02;Albacete;056;Ontur;2507;1242;1265
02;Albacete;057;Ossa de Montiel;2888;1448;1440
02;Albacete;058;Paterna del Madera;678;367;311
02;Albacete;060;Peñas de San Pedro;1362;713;649
02;Albacete;059;Peñascosa;463;245;218
02;Albacete;061;Pétrola;1056;533;523
02;Albacete;062;Povedilla;783;406;377
02;Albacete;064;Pozo-Lorente;543;259;284
02;Albacete;063;Pozohondo;2066;1057;1009
02;Albacete;065;Pozuelo;695;347;348
02;Albacete;066;Recueja (La);405;201;204
02;Albacete;067;Riópar;1369;703;666
02;Albacete;068;Robledo;502;256;246
02;Albacete;069;Roda (La);13168;6596;6572
02;Albacete;070;Salobre;670;351;319
02;Albacete;071;San Pedro;1328;682;646
02;Albacete;072;Socovos;2126;1090;1036
02;Albacete;073;Tarazona de la Mancha;5765;2903;2862
02;Albacete;074;Tobarra;7322;3650;3672
02;Albacete;075;Valdeganga;2160;1095;1065
02;Albacete;076;Vianos;520;265;255
02;Albacete;077;Villa de Ves;54;28;26
02;Albacete;078;Villalgordo del Júcar;1257;616;641
02;Albacete;079;Villamalea;3377;1744;1633
02;Albacete;080;Villapalacios;1019;518;501
02;Albacete;081;Villarrobledo;20705;10178;10527
02;Albacete;082;Villatoya;209;113;96
02;Albacete;083;Villavaliente;324;169;155
02;Albacete;084;Villaverde de Guadalimar;667;356;311
02;Albacete;085;Viveros;659;338;321
02;Albacete;086;Yeste;5025;2587;2438
03;Alicante/Alacant;001;Adsubia;545;269;276
03;Alicante/Alacant;002;Agost;3966;1999;1967
03;Alicante/Alacant;003;Agres;676;354;322
03;Alicante/Alacant;004;Aigües;372;188;184
03;Alicante/Alacant;005;Albatera;8868;4436;4432
03;Alicante/Alacant;006;Alcalalí;827;414;413
03;Alicante/Alacant;007;Alcocer de Planes;123;59;64
03;Alicante/Alacant;008;Alcoleja;297;137;160
03;Alicante/Alacant;009;Alcoy/Alcoi;65514;31441;34073
03;Alicante/Alacant;010;Alfafara;399;190;209
03;Alicante/Alacant;011;Alfàs del Pi (L');9075;4450;4625
03;Alicante/Alacant;012;Algorfa;1093;555;538
03;Alicante/Alacant;013;Algueña;1490;723;767
03;Alicante/Alacant;014;Alicante/Alacant;265473;127816;137657
03;Alicante/Alacant;015;Almoradí;12590;6287;6303
03;Alicante/Alacant;016;Almudaina;133;64;69
03;Alicante/Alacant;017;Alquería d'Asnar (L');408;195;213
03;Alicante/Alacant;018;Altea;12286;6078;6208
03;Alicante/Alacant;019;Aspe;16013;7940;8073
03;Alicante/Alacant;020;Balones;152;61;91
03;Alicante/Alacant;021;Banyeres de Mariola;7029;3500;3529
03;Alicante/Alacant;022;Benasau;221;106;115
03;Alicante/Alacant;023;Beneixama;1819;897;922
03;Alicante/Alacant;024;Benejúzar;4666;2342;2324
03;Alicante/Alacant;025;Benferri;949;479;470
03;Alicante/Alacant;026;Beniarbeig;1205;596;609
03;Alicante/Alacant;027;Beniardá;231;110;121
03;Alicante/Alacant;028;Beniarrés;1503;753;750
03;Alicante/Alacant;030;Benidoleig;800;397;403
03;Alicante/Alacant;031;Benidorm;42442;20899;21543
03;Alicante/Alacant;032;Benifallim;166;87;79
03;Alicante/Alacant;033;Benifato;124;64;60
03;Alicante/Alacant;029;Benigembla;354;176;178
03;Alicante/Alacant;034;Benijófar;1515;725;790
03;Alicante/Alacant;035;Benilloba;959;486;473
03;Alicante/Alacant;036;Benillup;76;40;36
03;Alicante/Alacant;037;Benimantell;453;211;242
03;Alicante/Alacant;038;Benimarfull;416;190;226
03;Alicante/Alacant;039;Benimassot;118;59;59
03;Alicante/Alacant;040;Benimeli;322;164;158
03;Alicante/Alacant;041;Benissa;8045;3989;4056
03;Alicante/Alacant;042;Benitachell/Poble Nou de Benitatxell (el);1641;832;809
03;Alicante/Alacant;043;Biar;3477;1679;1798
03;Alicante/Alacant;044;Bigastro;4508;2307;2201
03;Alicante/Alacant;045;Bolulla;277;140;137
03;Alicante/Alacant;046;Busot;971;479;492
03;Alicante/Alacant;048;Callosa d'En Sarrià;7491;3698;3793
03;Alicante/Alacant;049;Callosa de Segura;14780;7366;7414
03;Alicante/Alacant;047;Calpe/Calp;10683;5378;5305
03;Alicante/Alacant;050;Campello (El);10802;5343;5459
03;Alicante/Alacant;051;Campo de Mirra/Camp de Mirra (el);368;180;188
03;Alicante/Alacant;053;Castalla;7229;3553;3676
03;Alicante/Alacant;054;Castell de Castells;532;263;269
03;Alicante/Alacant;055;Catral;4478;2229;2249
03;Alicante/Alacant;052;Cañada;1073;527;546
03;Alicante/Alacant;056;Cocentaina;10550;5159;5391
03;Alicante/Alacant;057;Confrides;297;166;131
03;Alicante/Alacant;058;Cox;5350;2687;2663
03;Alicante/Alacant;059;Crevillent;22694;11456;11238
03;Alicante/Alacant;061;Daya Nueva;1199;603;596
03;Alicante/Alacant;062;Daya Vieja;202;101;101
03;Alicante/Alacant;064;Dolores;5817;2893;2924
03;Alicante/Alacant;063;Dénia;24764;12042;12722
03;Alicante/Alacant;065;Elche/Elx;188062;93127;94935
03;Alicante/Alacant;066;Elda;54350;26514;27836
03;Alicante/Alacant;067;Facheca;137;75;62
03;Alicante/Alacant;068;Famorca;70;32;38
03;Alicante/Alacant;069;Finestrat;1315;653;662
03;Alicante/Alacant;070;Formentera del Segura;2028;1007;1021
03;Alicante/Alacant;072;Gaianes;331;162;169
03;Alicante/Alacant;071;Gata de Gorgos;4959;2457;2502
03;Alicante/Alacant;073;Gorga;291;144;147
03;Alicante/Alacant;074;Granja de Rocamora;1961;1002;959
03;Alicante/Alacant;075;Guadalest;165;89;76
03;Alicante/Alacant;076;Guardamar del Segura;6899;3388;3511
03;Alicante/Alacant;077;Hondón de las Nieves;1426;712;714
03;Alicante/Alacant;078;Hondón de los Frailes;548;272;276
03;Alicante/Alacant;079;Ibi;20685;10268;10417
03;Alicante/Alacant;080;Jacarilla;1466;734;732
03;Alicante/Alacant;081;Jalón/Xaló;1957;967;990
03;Alicante/Alacant;083;Jijona/Xixona;7890;3724;4166
03;Alicante/Alacant;082;Jávea/Xàbia;16473;8182;8291
03;Alicante/Alacant;085;Llíber;469;229;240
03;Alicante/Alacant;084;Lorcha/Orxa (L');810;418;392
03;Alicante/Alacant;086;Millena;135;67;68
03;Alicante/Alacant;088;Monforte del Cid;5050;2599;2451
03;Alicante/Alacant;903;Montesinos (Los);2267;1151;1116
03;Alicante/Alacant;089;Monóvar/Monòver;12200;5913;6287
03;Alicante/Alacant;091;Murla;342;148;194
03;Alicante/Alacant;092;Muro de Alcoy;6548;3246;3302
03;Alicante/Alacant;090;Mutxamel;10281;5153;5128
03;Alicante/Alacant;093;Novelda;22026;10772;11254
03;Alicante/Alacant;094;Nucia (la);6078;3005;3073
03;Alicante/Alacant;095;Ondara;4825;2380;2445
03;Alicante/Alacant;096;Onil;6631;3313;3318
03;Alicante/Alacant;097;Orba;1499;710;789
03;Alicante/Alacant;099;Orihuela;49475;24266;25209
03;Alicante/Alacant;098;Orxeta;516;263;253
03;Alicante/Alacant;100;Parcent;738;364;374
03;Alicante/Alacant;101;Pedreguer;5694;2758;2936
03;Alicante/Alacant;102;Pego;9407;4636;4771
03;Alicante/Alacant;103;Penàguila;352;173;179
03;Alicante/Alacant;104;Petrer;24461;12192;12269
03;Alicante/Alacant;902;Pilar de la Horadada;7500;3769;3731
03;Alicante/Alacant;105;Pinoso;5621;2794;2827
03;Alicante/Alacant;106;Planes;769;380;389
03;Alicante/Alacant;901;Poblets (Els);1024;498;526
03;Alicante/Alacant;107;Polop;1855;918;937
03;Alicante/Alacant;060;Quatretondeta;200;98;102
03;Alicante/Alacant;109;Rafal;2668;1308;1360
03;Alicante/Alacant;111;Redován;5040;2564;2476
03;Alicante/Alacant;112;Relleu;742;372;370
03;Alicante/Alacant;113;Rojales;5277;2635;2642
03;Alicante/Alacant;114;Romana (La);1909;966;943
03;Alicante/Alacant;110;Ràfol d'Almúnia (El);376;183;193
03;Alicante/Alacant;115;Sagra;378;184;194
03;Alicante/Alacant;116;Salinas;1097;565;532
03;Alicante/Alacant;118;San Fulgencio;1591;807;784
03;Alicante/Alacant;904;San Isidro;"";"";""
03;Alicante/Alacant;120;San Miguel de Salinas;2955;1498;1457
03;Alicante/Alacant;122;San Vicente del Raspeig/Sant Vicent del Raspeig;29225;14491;14734
03;Alicante/Alacant;117;Sanet y Negrals;548;243;305
03;Alicante/Alacant;119;Sant Joan d'Alacant;13555;6677;6878
03;Alicante/Alacant;121;Santa Pola;14957;7434;7523
03;Alicante/Alacant;123;Sax;8314;4165;4149
03;Alicante/Alacant;124;Sella;590;308;282
03;Alicante/Alacant;125;Senija;486;247;239
03;Alicante/Alacant;128;Teulada;5230;2567;2663
03;Alicante/Alacant;129;Tibi;1045;527;518
03;Alicante/Alacant;130;Tollos;42;25;17
03;Alicante/Alacant;131;Tormos;283;140;143
03;Alicante/Alacant;132;Torremanzanas/Torre de les Maçanes (la);736;352;384
03;Alicante/Alacant;133;Torrevieja;25014;12254;12760
03;Alicante/Alacant;127;Tárbena;713;364;349
03;Alicante/Alacant;134;Vall d'Alcalà (La);174;82;92
03;Alicante/Alacant;135;Vall de Ebo;359;182;177
03;Alicante/Alacant;136;Vall de Gallinera;735;369;366
03;Alicante/Alacant;137;Vall de Laguar (La);988;484;504
03;Alicante/Alacant;138;Verger (El);3640;1743;1897
03;Alicante/Alacant;139;Villajoyosa/Vila Joiosa (La);21982;10833;11149
03;Alicante/Alacant;140;Villena;31232;15351;15881
04;Almería;001;Abla;1663;807;856
04;Almería;002;Abrucena;1432;689;743
04;Almería;003;Adra;20104;10049;10055
04;Almería;004;Albánchez;682;341;341
04;Almería;005;Alboloduy;898;412;486
04;Almería;006;Albox;10010;4974;5036
04;Almería;007;Alcolea;824;413;411
04;Almería;008;Alcóntar;629;327;302
04;Almería;009;Alcudia de Monteagud;212;96;116
04;Almería;010;Alhabia;774;386;388
04;Almería;011;Alhama de Almería;3050;1517;1533
04;Almería;012;Alicún;236;110;126
04;Almería;013;Almería;155120;75114;80006
04;Almería;014;Almócita;182;95;87
04;Almería;015;Alsodux;125;55;70
04;Almería;016;Antas;2514;1233;1281
04;Almería;017;Arboleas;1519;763;756
04;Almería;018;Armuña de Almanzora;376;181;195
04;Almería;019;Bacares;313;169;144
04;Almería;020;Bayárcal;389;211;178
04;Almería;021;Bayarque;245;120;125
04;Almería;022;Bédar;503;272;231
04;Almería;023;Beires;151;68;83
04;Almería;024;Benahadux;2277;1104;1173
04;Almería;026;Benitagla;117;59;58
04;Almería;027;Benizalón;346;181;165
04;Almería;028;Bentarique;365;187;178
04;Almería;029;Berja;12054;5970;6084
04;Almería;030;Canjáyar;1826;917;909
04;Almería;031;Cantoria;3309;1674;1635
04;Almería;032;Carboneras;5703;2943;2760
04;Almería;033;Castro de Filabres;167;79;88
04;Almería;036;Chercos;324;162;162
04;Almería;037;Chirivel;1995;987;1008
04;Almería;034;Cóbdar;283;145;138
04;Almería;035;Cuevas del Almanzora;9167;4551;4616
04;Almería;038;Dalías;3511;1734;1777
04;Almería;039;Darrical;417;205;212
04;Almería;902;Ejido (El);41374;20989;20385
04;Almería;041;Enix;241;114;127
04;Almería;043;Felix;616;307;309
04;Almería;044;Fines;1621;824;797
04;Almería;045;Fiñana;2563;1263;1300
04;Almería;046;Fondón;906;464;442
04;Almería;047;Gádor;2514;1230;1284
04;Almería;048;Gallardos (Los);1654;833;821
04;Almería;049;Garrucha;4382;2244;2138
04;Almería;050;Gérgal;1095;531;564
04;Almería;051;Huécija;558;279;279
04;Almería;052;Huércal de Almería;3887;1928;1959
04;Almería;053;Huércal-Overa;13090;6445;6645
04;Almería;054;Illar;504;239;265
04;Almería;055;Instinción;622;297;325
04;Almería;056;Laroya;115;60;55
04;Almería;057;Láujar de Andarax;1841;909;932
04;Almería;058;Líjar;535;267;268
04;Almería;059;Lubrín;2017;976;1041
04;Almería;060;Lucainena de las Torres;591;287;304
04;Almería;061;Lúcar;780;384;396
04;Almería;062;Macael;5976;3036;2940
04;Almería;063;María;1791;917;874
04;Almería;064;Mojácar;3539;1717;1822
04;Almería;903;Mojonera (La);5458;2788;2670
04;Almería;065;Nacimiento;490;248;242
04;Almería;066;Níjar;12554;6378;6176
04;Almería;067;Ohanes;883;450;433
04;Almería;068;Olula de Castro;233;119;114
04;Almería;069;Olula del Río;5734;2881;2853
04;Almería;070;Oria;2454;1239;1215
04;Almería;071;Padules;528;274;254
04;Almería;072;Partaloa;410;197;213
04;Almería;073;Paterna del Río;343;170;173
04;Almería;074;Pechina;2173;1076;1097
04;Almería;075;Pulpí;4578;2309;2269
04;Almería;076;Purchena;1715;854;861
04;Almería;077;Rágol;428;204;224
04;Almería;078;Rioja;1114;546;568
04;Almería;079;Roquetas de Mar;26842;13361;13481
04;Almería;080;Santa Cruz de Marchena;151;74;77
04;Almería;081;Santa Fe de Mondújar;423;210;213
04;Almería;082;Senés;360;182;178
04;Almería;083;Serón;3012;1495;1517
04;Almería;084;Sierro;559;290;269
04;Almería;085;Somontín;478;240;238
04;Almería;086;Sorbas;2716;1361;1355
04;Almería;087;Suflí;257;131;126
04;Almería;088;Tabernas;3217;1609;1608
04;Almería;089;Taberno;1056;520;536
04;Almería;090;Tahal;524;258;266
04;Almería;091;Terque;457;225;232
04;Almería;092;Tíjola;3642;1843;1799
04;Almería;901;Tres Villas (Las);710;370;340
04;Almería;093;Turre;2109;1034;1075
04;Almería;094;Turrillas;290;157;133
04;Almería;095;Uleila del Campo;1012;519;493
04;Almería;096;Urrácal;328;165;163
04;Almería;097;Velefique;370;196;174
04;Almería;098;Vélez-Blanco;2340;1193;1147
04;Almería;099;Vélez-Rubio;6312;3060;3252
04;Almería;100;Vera;5823;2861;2962
04;Almería;101;Viator;2802;1362;1440
04;Almería;102;Vícar;11885;6063;5822
04;Almería;103;Zurgena;2102;1036;1066
05;Ávila;001;Adanero;364;188;176
05;Ávila;002;Adrada (La);1915;996;919
05;Ávila;005;Albornos;295;154;141
05;Ávila;007;Aldeanueva de Santa Cruz;204;109;95
05;Ávila;008;Aldeaseca;415;200;215
05;Ávila;010;Aldehuela (La);309;158;151
05;Ávila;012;Amavida;214;104;110
05;Ávila;013;Arenal (El);1154;570;584
05;Ávila;014;Arenas de San Pedro;6413;3225;3188
05;Ávila;015;Arevalillo;185;95;90
05;Ávila;016;Arévalo;7375;3548;3827
05;Ávila;017;Aveinte;154;79;75
05;Ávila;018;Avellaneda;58;25;33
05;Ávila;019;Ávila;45977;22260;23717
05;Ávila;021;Barco de Ávila (El);2541;1268;1273
05;Ávila;022;Barraco (El);2047;1039;1008
05;Ávila;023;Barromán;297;163;134
05;Ávila;024;Becedas;566;295;271
05;Ávila;025;Becedillas;186;104;82
05;Ávila;026;Bercial de Zapardiel;374;181;193
05;Ávila;027;Berlanas (Las);410;206;204
05;Ávila;029;Bernuy-Zapardiel;301;157;144
05;Ávila;030;Berrocalejo de Aragona;46;22;24
05;Ávila;033;Blascomillán;377;178;199
05;Ávila;034;Blasconuño de Matacabras;31;18;13
05;Ávila;035;Blascosancho;174;89;85
05;Ávila;036;Bohodón (El);202;106;96
05;Ávila;037;Bohoyo;562;296;266
05;Ávila;038;Bonilla de la Sierra;227;121;106
05;Ávila;039;Brabos;83;44;39
05;Ávila;040;Bularros;151;81;70
05;Ávila;041;Burgohondo;1376;705;671
05;Ávila;042;Cabezas de Alambre;307;162;145
05;Ávila;043;Cabezas del Pozo;226;114;112
05;Ávila;044;Cabezas del Villar;579;314;265
05;Ávila;045;Cabizuela;168;82;86
05;Ávila;046;Canales;92;45;47
05;Ávila;047;Candeleda;5344;2705;2639
05;Ávila;048;Cantiveros;231;120;111
05;Ávila;049;Cardeñosa;604;317;287
05;Ávila;051;Carrera (La);356;178;178
05;Ávila;052;Casas del Puerto de Villatoro;129;69;60
05;Ávila;053;Casasola;196;102;94
05;Ávila;054;Casavieja;1647;863;784
05;Ávila;055;Casillas;1001;514;487
05;Ávila;056;Castellanos de Zapardiel;162;91;71
05;Ávila;057;Cebreros;3627;1811;1816
05;Ávila;058;Cepeda la Mora;168;94;74
05;Ávila;067;Chamartín;127;67;60
05;Ávila;059;Cillán;172;86;86
05;Ávila;060;Cisla;238;113;125
05;Ávila;061;Colilla (La);204;104;100
05;Ávila;062;Collado de Contreras;297;159;138
05;Ávila;063;Collado del Mirón;124;65;59
05;Ávila;064;Constanzana;222;119;103
05;Ávila;065;Crespos;817;429;388
05;Ávila;066;Cuevas del Valle;670;361;309
05;Ávila;903;Diego del Carpio;408;214;194
05;Ávila;069;Donjimeno;168;85;83
05;Ávila;070;Donvidas;86;41;45
05;Ávila;072;Espinosa de los Caballeros;125;69;56
05;Ávila;073;Flores de Ávila;508;272;236
05;Ávila;074;Fontíveros;1130;575;555
05;Ávila;075;Fresnedilla;137;64;73
05;Ávila;076;Fresno (El);430;224;206
05;Ávila;077;Fuente el Saúz;373;180;193
05;Ávila;078;Fuentes de Año;258;135;123
05;Ávila;079;Gallegos de Altamiros;128;72;56
05;Ávila;080;Gallegos de Sobrinos;131;57;74
05;Ávila;081;Garganta del Villar;102;60;42
05;Ávila;082;Gavilanes;798;429;369
05;Ávila;083;Gemuño;276;133;143
05;Ávila;085;Gil García;96;46;50
05;Ávila;084;Gilbuena;191;107;84
05;Ávila;086;Gimialcón;159;82;77
05;Ávila;087;Gotarrendura;208;71;137
05;Ávila;088;Grandes y San Martín;67;32;35
05;Ávila;089;Guisando;759;389;370
05;Ávila;090;Gutierre-Muñoz;142;71;71
05;Ávila;092;Hernansancho;248;126;122
05;Ávila;093;Herradón de Pinares;515;269;246
05;Ávila;094;Herreros de Suso;273;136;137
05;Ávila;095;Higuera de las Dueñas;322;169;153
05;Ávila;096;Hija de Dios (La);165;91;74
05;Ávila;097;Horcajada (La);1019;500;519
05;Ávila;099;Horcajo de las Torres;961;516;445
05;Ávila;100;Hornillo (El);561;276;285
05;Ávila;102;Hoyo de Pinares (El);2591;1313;1278
05;Ávila;101;Hoyocasero;461;246;215
05;Ávila;103;Hoyorredondo;156;79;77
05;Ávila;106;Hoyos de Miguel Muñoz;71;39;32
05;Ávila;104;Hoyos del Collado;55;37;18
05;Ávila;105;Hoyos del Espino;389;216;173
05;Ávila;107;Hurtumpascual;165;86;79
05;Ávila;108;Junciana;109;54;55
05;Ávila;109;Langa;630;330;300
05;Ávila;110;Lanzahíta;959;480;479
05;Ávila;113;Llanos de Tormes (Los);152;81;71
05;Ávila;112;Losar del Barco (El);188;102;86
05;Ávila;114;Madrigal de las Altas Torres;2120;1083;1037
05;Ávila;115;Maello;687;343;344
05;Ávila;116;Malpartida de Corneja;289;143;146
05;Ávila;117;Mamblas;332;174;158
05;Ávila;118;Mancera de Arriba;201;105;96
05;Ávila;119;Manjabálago;100;54;46
05;Ávila;120;Marlín;39;22;17
05;Ávila;121;Martiherrero;206;102;104
05;Ávila;122;Martínez;301;158;143
05;Ávila;123;Mediana de Voltoya;119;65;54
05;Ávila;124;Medinilla;287;152;135
05;Ávila;125;Mengamuñoz;80;35;45
05;Ávila;126;Mesegar de Corneja;142;70;72
05;Ávila;127;Mijares;1089;564;525
05;Ávila;128;Mingorría;589;300;289
05;Ávila;129;Mirón (El);355;194;161
05;Ávila;130;Mironcillo;139;80;59
05;Ávila;131;Mirueña de los Infanzones;275;136;139
05;Ávila;132;Mombeltrán;1215;652;563
05;Ávila;133;Monsalupe;123;61;62
05;Ávila;134;Moraleja de Matacabras;77;36;41
05;Ávila;135;Muñana;613;318;295
05;Ávila;136;Muñico;178;95;83
05;Ávila;138;Muñogalindo;487;274;213
05;Ávila;139;Muñogrande;126;66;60
05;Ávila;140;Muñomer del Peco;141;79;62
05;Ávila;141;Muñopepe;123;63;60
05;Ávila;142;Muñosancho;200;91;109
05;Ávila;143;Muñotello;151;82;69
05;Ávila;144;Narrillos del Álamo;194;97;97
05;Ávila;145;Narrillos del Rebollar;96;51;45
05;Ávila;149;Narros de Saldueña;263;138;125
05;Ávila;147;Narros del Castillo;316;171;145
05;Ávila;148;Narros del Puerto;58;33;25
05;Ávila;152;Nava de Arévalo;1144;594;550
05;Ávila;153;Nava del Barco;240;110;130
05;Ávila;151;Navacepedilla de Corneja;156;81;75
05;Ávila;154;Navadijos;86;49;37
05;Ávila;155;Navaescurial;125;73;52
05;Ávila;156;Navahondilla;155;63;92
05;Ávila;157;Navalacruz;341;164;177
05;Ávila;158;Navalmoral;672;342;330
05;Ávila;159;Navalonguilla;572;281;291
05;Ávila;160;Navalosa;600;317;283
05;Ávila;161;Navalperal de Pinares;943;453;490
05;Ávila;162;Navalperal de Tormes;150;74;76
05;Ávila;163;Navaluenga;2045;1034;1011
05;Ávila;164;Navaquesera;118;60;58
05;Ávila;165;Navarredonda de Gredos;499;255;244
05;Ávila;166;Navarredondilla;318;158;160
05;Ávila;167;Navarrevisca;431;229;202
05;Ávila;168;Navas del Marqués (Las);4165;2092;2073
05;Ávila;169;Navatalgordo;545;280;265
05;Ávila;170;Navatejares;132;61;71
05;Ávila;171;Neila de San Miguel;139;71;68
05;Ávila;172;Niharra;216;105;111
05;Ávila;173;Ojos-Albos;38;17;21
05;Ávila;174;Orbita;112;60;52
05;Ávila;175;Oso (El);268;145;123
05;Ávila;176;Padiernos;276;146;130
05;Ávila;177;Pajares de Adaja;203;107;96
05;Ávila;178;Palacios de Goda;610;293;317
05;Ávila;179;Papatrigo;384;195;189
05;Ávila;180;Parral (El);121;65;56
05;Ávila;181;Pascualcobo;56;32;24
05;Ávila;182;Pedro Bernardo;1563;801;762
05;Ávila;183;Pedro-Rodríguez;259;125;134
05;Ávila;184;Peguerinos;400;204;196
05;Ávila;185;Peñalba de Ávila;147;84;63
05;Ávila;186;Piedrahíta;2262;1127;1135
05;Ávila;187;Piedralaves;2155;1073;1082
05;Ávila;188;Poveda;107;60;47
05;Ávila;189;Poyales del Hoyo;828;410;418
05;Ávila;190;Pozanco;67;37;30
05;Ávila;191;Pradosegar;203;108;95
05;Ávila;192;Puerto Castilla;170;82;88
05;Ávila;193;Rasueros;428;229;199
05;Ávila;194;Riocabado;228;129;99
05;Ávila;195;Riofrío;356;200;156
05;Ávila;196;Rivilla de Barajas;104;57;47
05;Ávila;197;Salobral;129;65;64
05;Ávila;198;Salvadiós;153;81;72
05;Ávila;199;San Bartolomé de Béjar;110;53;57
05;Ávila;200;San Bartolomé de Corneja;140;76;64
05;Ávila;201;San Bartolomé de Pinares;806;433;373
05;Ávila;206;San Esteban de los Patos;46;24;22
05;Ávila;208;San Esteban de Zapardiel;100;45;55
05;Ávila;207;San Esteban del Valle;1015;515;500
05;Ávila;209;San García de Ingelmos;215;110;105
05;Ávila;901;San Juan de Gredos;495;243;252
05;Ávila;210;San Juan de la Encinilla;167;76;91
05;Ávila;211;San Juan de la Nava;749;388;361
05;Ávila;212;San Juan del Molinillo;400;223;177
05;Ávila;213;San Juan del Olmo;218;118;100
05;Ávila;214;San Lorenzo de Tormes;84;41;43
05;Ávila;215;San Martín de la Vega del Alberche;354;201;153
05;Ávila;216;San Martín del Pimpollar;348;186;162
05;Ávila;217;San Miguel de Corneja;133;66;67
05;Ávila;218;San Miguel de Serrezuela;265;139;126
05;Ávila;219;San Pascual;67;34;33
05;Ávila;220;San Pedro del Arroyo;516;269;247
05;Ávila;231;San Vicente de Arévalo;260;130;130
05;Ávila;204;Sanchidrián;765;374;391
05;Ávila;205;Sanchorreja;120;63;57
05;Ávila;222;Santa Cruz de Pinares;253;140;113
05;Ávila;221;Santa Cruz del Valle;671;332;339
05;Ávila;226;Santa María de los Caballeros;205;106;99
05;Ávila;224;Santa María del Arroyo;160;80;80
05;Ávila;225;Santa María del Berrocal;712;346;366
05;Ávila;902;Santa María del Cubillo;435;240;195
05;Ávila;227;Santa María del Tiétar;370;189;181
05;Ávila;228;Santiago del Collado;337;205;132
05;Ávila;904;Santiago del Tormes;396;199;197
05;Ávila;229;Santo Domingo de las Posadas;102;51;51
05;Ávila;230;Santo Tomé de Zabarcos;141;79;62
05;Ávila;232;Serrada (La);159;83;76
05;Ávila;233;Serranillos;532;280;252
05;Ávila;234;Sigeres;90;40;50
05;Ávila;235;Sinlabajos;283;148;135
05;Ávila;236;Solana de Ávila;292;149;143
05;Ávila;237;Solana de Rioalmar;365;189;176
05;Ávila;238;Solosancho;1200;639;561
05;Ávila;239;Sotalbo;285;149;136
05;Ávila;240;Sotillo de la Adrada;3389;1694;1695
05;Ávila;241;Tiemblo (El);3795;1904;1891
05;Ávila;242;Tiñosillos;753;400;353
05;Ávila;243;Tolbaños;170;84;86
05;Ávila;244;Tormellas;152;74;78
05;Ávila;245;Tornadizos de Ávila;346;167;179
05;Ávila;247;Torre (La);517;277;240
05;Ávila;246;Tórtoles;128;66;62
05;Ávila;249;Umbrías;187;91;96
05;Ávila;251;Vadillo de la Sierra;193;112;81
05;Ávila;252;Valdecasa;137;72;65
05;Ávila;253;Vega de Santa María;142;76;66
05;Ávila;254;Velayos;313;157;156
05;Ávila;256;Villaflor;199;103;96
05;Ávila;257;Villafranca de la Sierra;277;144;133
05;Ávila;905;Villanueva de Ávila;666;344;322
05;Ávila;258;Villanueva de Gómez;184;86;98
05;Ávila;259;Villanueva del Aceral;250;118;132
05;Ávila;260;Villanueva del Campillo;261;133;128
05;Ávila;261;Villar de Corneja;112;52;60
05;Ávila;262;Villarejo del Valle;466;247;219
05;Ávila;263;Villatoro;270;146;124
05;Ávila;264;Viñegra de Moraña;92;52;40
05;Ávila;265;Vita;129;77;52
05;Ávila;266;Zapardiel de la Cañada;239;117;122
05;Ávila;267;Zapardiel de la Ribera;159;81;78
06;Badajoz;001;Acedera;1043;560;483
06;Badajoz;002;Aceuchal;5053;2494;2559
06;Badajoz;003;Ahillones;1319;653;666
06;Badajoz;004;Alange;2003;1040;963
06;Badajoz;005;Albuera (La);1784;916;868
06;Badajoz;006;Alburquerque;5780;2924;2856
06;Badajoz;007;Alconchel;2348;1163;1185
06;Badajoz;008;Alconera;801;403;398
06;Badajoz;009;Aljucén;221;123;98
06;Badajoz;010;Almendral;1522;751;771
06;Badajoz;011;Almendralejo;24268;11818;12450
06;Badajoz;012;Arroyo de San Serván;3933;1996;1937
06;Badajoz;013;Atalaya;379;187;192
06;Badajoz;014;Azuaga;9935;4867;5068
06;Badajoz;015;Badajoz;122225;59030;63195
06;Badajoz;016;Barcarrota;4198;2087;2111
06;Badajoz;017;Baterno;433;215;218
06;Badajoz;018;Benquerencia de la Serena;1190;606;584
06;Badajoz;019;Berlanga;2732;1357;1375
06;Badajoz;020;Bienvenida;2437;1230;1207
06;Badajoz;021;Bodonal de la Sierra;1403;712;691
06;Badajoz;022;Burguillos del Cerro;3406;1667;1739
06;Badajoz;023;Cabeza del Buey;6435;3146;3289
06;Badajoz;024;Cabeza la Vaca;1768;886;882
06;Badajoz;025;Calamonte;5564;2733;2831
06;Badajoz;026;Calera de León;1209;610;599
06;Badajoz;027;Calzadilla de los Barros;838;422;416
06;Badajoz;028;Campanario;6069;2918;3151
06;Badajoz;029;Campillo de Llerena;1810;892;918
06;Badajoz;030;Capilla;250;116;134
06;Badajoz;031;Carmonita;727;396;331
06;Badajoz;032;Carrascalejo (El);29;15;14
06;Badajoz;033;Casas de Don Pedro;1928;940;988
06;Badajoz;034;Casas de Reina;330;144;186
06;Badajoz;035;Castilblanco;1526;750;776
06;Badajoz;036;Castuera;7499;3762;3737
06;Badajoz;042;Cheles;1360;690;670
06;Badajoz;037;Codosera (La);2549;1301;1248
06;Badajoz;038;Cordobilla de Lácara;1021;525;496
06;Badajoz;039;Coronada (La);2542;1282;1260
06;Badajoz;040;Corte de Peleas;1265;638;627
06;Badajoz;041;Cristina;538;287;251
06;Badajoz;043;Don Álvaro;604;305;299
06;Badajoz;044;Don Benito;28879;14326;14553
06;Badajoz;045;Entrín Bajo;668;329;339
06;Badajoz;046;Esparragalejo;1421;715;706
06;Badajoz;047;Esparragosa de la Serena;1136;572;564
06;Badajoz;048;Esparragosa de Lares;1306;639;667
06;Badajoz;049;Feria;1585;775;810
06;Badajoz;050;Fregenal de la Sierra;5585;2708;2877
06;Badajoz;051;Fuenlabrada de los Montes;2172;1066;1106
06;Badajoz;052;Fuente de Cantos;5075;2557;2518
06;Badajoz;053;Fuente del Arco;914;464;450
06;Badajoz;054;Fuente del Maestre;6756;3355;3401
06;Badajoz;055;Fuentes de León;2951;1417;1534
06;Badajoz;056;Garbayuela;619;332;287
06;Badajoz;057;Garlitos;883;440;443
06;Badajoz;058;Garrovilla (La);2682;1382;1300
06;Badajoz;059;Granja de Torrehermosa;2788;1389;1399
06;Badajoz;060;Guareña;7362;3737;3625
06;Badajoz;061;Haba (La);1625;821;804
06;Badajoz;062;Helechosa de los Montes;814;428;386
06;Badajoz;063;Herrera del Duque;4120;2073;2047
06;Badajoz;064;Higuera de la Serena;1332;666;666
06;Badajoz;065;Higuera de Llerena;553;263;290
06;Badajoz;066;Higuera de Vargas;3034;1524;1510
06;Badajoz;067;Higuera la Real;2842;1431;1411
06;Badajoz;068;Hinojosa del Valle;679;356;323
06;Badajoz;069;Hornachos;3786;1897;1889
06;Badajoz;070;Jerez de los Caballeros;10191;5096;5095
06;Badajoz;071;Lapa (La);368;181;187
06;Badajoz;073;Llera;1060;545;515
06;Badajoz;074;Llerena;5577;2698;2879
06;Badajoz;072;Lobón;2712;1406;1306
06;Badajoz;075;Magacela;922;477;445
06;Badajoz;076;Maguilla;1175;591;584
06;Badajoz;077;Malcocinado;644;344;300
06;Badajoz;078;Malpartida de la Serena;1070;544;526
06;Badajoz;079;Manchita;774;398;376
06;Badajoz;080;Medellín;2451;1242;1209
06;Badajoz;081;Medina de las Torres;1714;833;881
06;Badajoz;082;Mengabril;502;251;251
06;Badajoz;083;Mérida;49284;24141;25143
06;Badajoz;084;Mirandilla;1296;656;640
06;Badajoz;085;Monesterio;5203;2589;2614
06;Badajoz;086;Montemolín;1924;939;985
06;Badajoz;087;Monterrubio de la Serena;3294;1606;1688
06;Badajoz;088;Montijo;15008;7276;7732
06;Badajoz;089;Morera (La);807;410;397
06;Badajoz;090;Nava de Santiago (La);1166;588;578
06;Badajoz;091;Navalvillar de Pela;5082;2562;2520
06;Badajoz;092;Nogales;811;416;395
06;Badajoz;093;Oliva de la Frontera;6588;3282;3306
06;Badajoz;094;Oliva de Mérida;2175;1087;1088
06;Badajoz;095;Olivenza;10176;4997;5179
06;Badajoz;096;Orellana de la Sierra;495;256;239
06;Badajoz;097;Orellana la Vieja;3999;2016;1983
06;Badajoz;098;Palomas;703;363;340
06;Badajoz;099;Parra (La);1412;726;686
06;Badajoz;100;Peñalsordo;1853;878;975
06;Badajoz;101;Peraleda del Zaucejo;815;419;396
06;Badajoz;102;Puebla de Alcocer;1654;838;816
06;Badajoz;103;Puebla de la Calzada;5480;2736;2744
06;Badajoz;104;Puebla de la Reina;914;479;435
06;Badajoz;107;Puebla de Obando;2135;1060;1075
06;Badajoz;108;Puebla de Sancho Pérez;3032;1508;1524
06;Badajoz;105;Puebla del Maestre;1052;516;536
06;Badajoz;106;Puebla del Prior;627;333;294
06;Badajoz;109;Quintana de la Serena;5087;2530;2557
06;Badajoz;110;Reina;244;125;119
06;Badajoz;111;Rena;676;349;327
06;Badajoz;112;Retamal de Llerena;662;342;320
06;Badajoz;113;Ribera del Fresno;3466;1660;1806
06;Badajoz;114;Risco;233;118;115
06;Badajoz;115;Roca de la Sierra (La);1603;807;796
06;Badajoz;116;Salvaleón;2497;1276;1221
06;Badajoz;117;Salvatierra de los Barros;2020;994;1026
06;Badajoz;119;San Pedro de Mérida;809;428;381
06;Badajoz;123;San Vicente de Alcántara;6102;3001;3101
06;Badajoz;118;Sancti-Spíritus;403;193;210
06;Badajoz;120;Santa Amalia;4145;2094;2051
06;Badajoz;121;Santa Marta;4013;1987;2026
06;Badajoz;122;Santos de Maimona (Los);7674;3846;3828
06;Badajoz;124;Segura de León;2321;1150;1171
06;Badajoz;125;Siruela;2548;1249;1299
06;Badajoz;126;Solana de los Barros;2830;1456;1374
06;Badajoz;127;Talarrubias;3816;1874;1942
06;Badajoz;128;Talavera la Real;5237;2653;2584
06;Badajoz;129;Táliga;736;376;360
06;Badajoz;130;Tamurejo;311;149;162
06;Badajoz;131;Torre de Miguel Sesmero;1305;640;665
06;Badajoz;132;Torremayor;1144;561;583
06;Badajoz;133;Torremejía;1906;959;947
06;Badajoz;134;Trasierra;715;378;337
06;Badajoz;135;Trujillanos;942;488;454
06;Badajoz;136;Usagre;2213;1135;1078
06;Badajoz;137;Valdecaballeros;1779;889;890
06;Badajoz;901;Valdelacalzada;"";"";""
06;Badajoz;138;Valdetorres;1411;705;706
06;Badajoz;139;Valencia de las Torres;966;481;485
06;Badajoz;140;Valencia del Mombuey;951;468;483
06;Badajoz;141;Valencia del Ventoso;2531;1258;1273
06;Badajoz;146;Valle de la Serena;1808;883;925
06;Badajoz;147;Valle de Matamoros;585;287;298
06;Badajoz;148;Valle de Santa Ana;1338;683;655
06;Badajoz;142;Valverde de Burguillos;405;197;208
06;Badajoz;143;Valverde de Leganés;3583;1799;1784
06;Badajoz;144;Valverde de Llerena;934;455;479
06;Badajoz;145;Valverde de Mérida;1160;593;567
06;Badajoz;149;Villafranca de los Barros;12443;6121;6322
06;Badajoz;150;Villagarcía de la Torre;1103;569;534
06;Badajoz;151;Villagonzalo;1570;756;814
06;Badajoz;152;Villalba de los Barros;1759;887;872
06;Badajoz;153;Villanueva de la Serena;22879;11271;11608
06;Badajoz;154;Villanueva del Fresno;3602;1797;1805
06;Badajoz;156;Villar de Rena;1791;945;846
06;Badajoz;155;Villar del Rey;2344;1210;1134
06;Badajoz;157;Villarta de los Montes;868;418;450
06;Badajoz;158;Zafra;14266;6884;7382
06;Badajoz;159;Zahínos;3252;1631;1621
06;Badajoz;160;Zalamea de la Serena;5107;2526;2581
06;Badajoz;162;Zarza (La);3643;1825;1818
06;Badajoz;161;Zarza-Capilla;666;331;335
07;Balears (Illes);002;Alaior;6444;3215;3229
07;Balears (Illes);001;Alaró;3647;1739;1908
07;Balears (Illes);003;Alcúdia;8027;4000;4027
07;Balears (Illes);004;Algaida;3177;1603;1574
07;Balears (Illes);005;Andratx;6897;3407;3490
07;Balears (Illes);901;Ariany;853;410;443
07;Balears (Illes);006;Artà;5716;2801;2915
07;Balears (Illes);007;Banyalbufar;456;221;235
07;Balears (Illes);008;Binissalem;4681;2263;2418
07;Balears (Illes);009;Búger;921;454;467
07;Balears (Illes);010;Bunyola;4036;2021;2015
07;Balears (Illes);011;Calvià;20982;10597;10385
07;Balears (Illes);012;Campanet;2183;1073;1110
07;Balears (Illes);013;Campos;6419;3205;3214
07;Balears (Illes);014;Capdepera;6164;3088;3076
07;Balears (Illes);064;Castell (Es);5389;2691;2698
07;Balears (Illes);015;Ciutadella de Menorca;20874;10427;10447
07;Balears (Illes);016;Consell;2025;976;1049
07;Balears (Illes);017;Costitx;808;384;424
07;Balears (Illes);018;Deyá;552;272;280
07;Balears (Illes);026;Eivissa;29935;14898;15037
07;Balears (Illes);019;Escorca;210;118;92
07;Balears (Illes);020;Esporles;2971;1438;1533
07;Balears (Illes);021;Estellencs;338;171;167
07;Balears (Illes);022;Felanitx;14176;7023;7153
07;Balears (Illes);023;Ferreries;3681;1946;1735
07;Balears (Illes);024;Formentera;4333;2202;2131
07;Balears (Illes);025;Fornalutx;562;285;277
07;Balears (Illes);027;Inca;20438;10033;10405
07;Balears (Illes);028;Lloret de Vistalegre;814;392;422
07;Balears (Illes);029;Lloseta;4474;2206;2268
07;Balears (Illes);030;Llubí;1969;966;1003
07;Balears (Illes);031;Llucmajor;17357;8597;8760
07;Balears (Illes);032;Mahón;21541;10446;11095
07;Balears (Illes);033;Manacor;25573;12552;13021
07;Balears (Illes);034;Mancor de la Vall;888;429;459
07;Balears (Illes);035;Maria de la Salut;1784;868;916
07;Balears (Illes);036;Marratxí;11586;5777;5809
07;Balears (Illes);037;Mercadal (Es);2365;1174;1191
07;Balears (Illes);902;Migjorn Gran (Es);1049;546;503
07;Balears (Illes);038;Montuïri;2045;976;1069
07;Balears (Illes);039;Muro;5967;2924;3043
07;Balears (Illes);040;Palma de Mallorca;296754;144060;152694
07;Balears (Illes);041;Petra;2629;1271;1358
07;Balears (Illes);044;Pobla (Sa);10090;5109;4981
07;Balears (Illes);042;Pollença;11334;5617;5717
07;Balears (Illes);043;Porreres;4388;2175;2213
07;Balears (Illes);045;Puigpunyent;1152;574;578
07;Balears (Illes);059;Salines (Ses);3009;1504;1505
07;Balears (Illes);046;Sant Antoni de Portmany;13558;6852;6706
07;Balears (Illes);049;Sant Joan;1667;811;856
07;Balears (Illes);050;Sant Joan de Labritja;3555;1762;1793
07;Balears (Illes);048;Sant Josep de sa Talaia;9704;4938;4766
07;Balears (Illes);051;Sant Llorenç des Cardassar;4416;2176;2240
07;Balears (Illes);052;Sant Lluís;3088;1534;1554
07;Balears (Illes);053;Santa Eugènia;917;458;459
07;Balears (Illes);054;Santa Eulalia del Río;15557;7802;7755
07;Balears (Illes);055;Santa Margalida;5242;2555;2687
07;Balears (Illes);056;Santa María del Camí;4006;1992;2014
07;Balears (Illes);057;Santanyí;6956;3488;3468
07;Balears (Illes);058;Selva;2875;1419;1456
07;Balears (Illes);047;Sencelles;1671;809;862
07;Balears (Illes);060;Sineu;2581;1280;1301
07;Balears (Illes);061;Sóller;10238;5021;5217
07;Balears (Illes);062;Son Servera;6004;2954;3050
07;Balears (Illes);063;Valldemossa;1292;607;685
07;Balears (Illes);065;Vilafranca de Bonany;2148;1048;1100
08;Barcelona;001;Abrera;5464;2810;2654
08;Barcelona;002;Aguilar de Segarra;191;99;92
08;Barcelona;014;Aiguafreda;2063;996;1067
08;Barcelona;003;Alella;6895;3386;3509
08;Barcelona;004;Alpens;249;135;114
08;Barcelona;005;Ametlla del Vallès (L');3362;1649;1713
08;Barcelona;006;Arenys de Mar;11039;5295;5744
08;Barcelona;007;Arenys de Munt;4733;2269;2464
08;Barcelona;008;Argençola;195;103;92
08;Barcelona;009;Argentona;7848;3881;3967
08;Barcelona;010;Artés;4086;1995;2091
08;Barcelona;011;Avià;1778;914;864
08;Barcelona;012;Avinyó;2049;1007;1042
08;Barcelona;013;Avinyonet del Penedès;1194;609;585
08;Barcelona;015;Badalona;218725;108226;110499
08;Barcelona;904;Badia del Vallès;"";"";""
08;Barcelona;016;Bagà;2129;1052;1077
08;Barcelona;017;Balenyà;3231;1631;1600
08;Barcelona;018;Balsareny;3405;1677;1728
08;Barcelona;252;Barberà del Vallès;31147;15820;15327
08;Barcelona;019;Barcelona;1643542;775983;867559
08;Barcelona;020;Begues;2029;994;1035
08;Barcelona;021;Bellprat;89;47;42
08;Barcelona;022;Berga;13905;6716;7189
08;Barcelona;023;Bigues i Riells;2807;1461;1346
08;Barcelona;024;Borredà;446;206;240
08;Barcelona;025;Bruc (El);753;383;370
08;Barcelona;026;Brull (El);182;94;88
08;Barcelona;027;Cabanyes (Les);411;224;187
08;Barcelona;029;Cabrera de Mar;2812;1398;1414
08;Barcelona;028;Cabrera d'Igualada;216;120;96
08;Barcelona;030;Cabrils;2966;1434;1532
08;Barcelona;031;Calaf;3207;1583;1624
08;Barcelona;034;Calders;581;307;274
08;Barcelona;033;Caldes de Montbui;11293;5556;5737
08;Barcelona;032;Caldes d'Estrac;1463;701;762
08;Barcelona;035;Calella;11324;5250;6074
08;Barcelona;037;Calldetenes;1472;752;720
08;Barcelona;038;Callús;1396;680;716
08;Barcelona;036;Calonge de Segarra;197;105;92
08;Barcelona;039;Campins;190;87;103
08;Barcelona;040;Canet de Mar;8858;4308;4550
08;Barcelona;041;Canovelles;13326;6726;6600
08;Barcelona;042;Cànoves i Samalús;1033;515;518
08;Barcelona;043;Canyelles;730;390;340
08;Barcelona;044;Capellades;5031;2460;2571
08;Barcelona;045;Capolat;59;34;25
08;Barcelona;046;Cardedeu;9040;4495;4545
08;Barcelona;047;Cardona;6445;3148;3297
08;Barcelona;048;Carme;679;355;324
08;Barcelona;049;Casserres;1672;806;866
08;Barcelona;057;Castell de l'Areny;41;24;17
08;Barcelona;052;Castellar de n'Hug;162;87;75
08;Barcelona;050;Castellar del Riu;63;36;27
08;Barcelona;051;Castellar del Vallès;13500;6704;6796
08;Barcelona;053;Castellbell i el Vilar;2807;1394;1413
08;Barcelona;054;Castellbisbal;4983;2565;2418
08;Barcelona;055;Castellcir;247;129;118
08;Barcelona;056;Castelldefels;33017;16432;16585
08;Barcelona;058;Castellet i la Gornal;1107;549;558
08;Barcelona;060;Castellfollit de Riubregós;250;122;128
08;Barcelona;059;Castellfollit del Boix;315;150;165
08;Barcelona;061;Castellgalí;702;350;352
08;Barcelona;062;Castellnou de Bages;196;101;95
08;Barcelona;063;Castellolí;435;210;225
08;Barcelona;064;Castellterçol;1903;904;999
08;Barcelona;065;Castellví de la Marca;1437;723;714
08;Barcelona;066;Castellví de Rosanes;661;339;322
08;Barcelona;067;Centelles;5682;2767;2915
08;Barcelona;268;Cercs;1665;814;851
08;Barcelona;266;Cerdanyola del Vallès;56612;28220;28392
08;Barcelona;068;Cervelló;5389;2709;2680
08;Barcelona;069;Collbató;1074;542;532
08;Barcelona;070;Collsuspina;214;109;105
08;Barcelona;071;Copons;262;133;129
08;Barcelona;072;Corbera de Llobregat;5327;2672;2655
08;Barcelona;073;Cornellà de Llobregat;84927;42034;42893
08;Barcelona;074;Cubelles;3149;1589;1560
08;Barcelona;075;Dosrius;1211;611;600
08;Barcelona;076;Esparreguera;12612;6298;6314
08;Barcelona;077;Esplugues de Llobregat;48310;23998;24312
08;Barcelona;078;Espunyola (L');270;135;135
08;Barcelona;079;Estany (L');370;176;194
08;Barcelona;134;Figaró-Montmany;631;330;301
08;Barcelona;080;Fígols;33;17;16
08;Barcelona;082;Fogars de la Selva;397;197;200
08;Barcelona;081;Fogars de Montclús;245;124;121
08;Barcelona;083;Folgueroles;1160;573;587
08;Barcelona;084;Fonollosa;685;343;342
08;Barcelona;085;Font-rubí;1138;592;546
08;Barcelona;086;Franqueses del Vallès (Les);10294;5204;5090
08;Barcelona;090;Gaià;133;73;60
08;Barcelona;087;Gallifa;88;44;44
08;Barcelona;088;Garriga (La);9447;4612;4835
08;Barcelona;089;Gavà;35204;17585;17619
08;Barcelona;091;Gelida;3908;1958;1950
08;Barcelona;092;Gironella;5009;2421;2588
08;Barcelona;093;Gisclareny;32;17;15
08;Barcelona;094;Granada (La);1202;590;612
08;Barcelona;095;Granera;58;33;25
08;Barcelona;096;Granollers;51873;25544;26329
08;Barcelona;097;Gualba;629;330;299
08;Barcelona;099;Guardiola de Berguedà;1254;611;643
08;Barcelona;100;Gurb;1674;855;819
08;Barcelona;101;Hospitalet de Llobregat (L');272578;134322;138256
08;Barcelona;162;Hostalets de Pierola (Els);921;462;459
08;Barcelona;102;Igualada;31855;15444;16411
08;Barcelona;103;Jorba;513;249;264
08;Barcelona;104;Llacuna (La);792;399;393
08;Barcelona;105;Llagosta (La);11276;5611;5665
08;Barcelona;107;Lliçà d'Amunt;5417;2748;2669
08;Barcelona;108;Lliçà de Vall;3496;1794;1702
08;Barcelona;106;Llinars del Vallès;5586;2823;2763
08;Barcelona;109;Lluçà;282;157;125
08;Barcelona;110;Malgrat de Mar;11565;5671;5894
08;Barcelona;111;Malla;247;116;131
08;Barcelona;112;Manlleu;16148;7955;8193
08;Barcelona;113;Manresa;66320;31929;34391
08;Barcelona;242;Marganell;211;85;126
08;Barcelona;114;Martorell;16653;8334;8319
08;Barcelona;115;Martorelles;4888;2422;2466
08;Barcelona;116;Masies de Roda (Les);624;312;312
08;Barcelona;117;Masies de Voltregà (Les);2479;1220;1259
08;Barcelona;118;Masnou (El);18393;8885;9508
08;Barcelona;119;Masquefa;2653;1302;1351
08;Barcelona;120;Matadepera;4746;2381;2365
08;Barcelona;121;Mataró;101510;49865;51645
08;Barcelona;122;Mediona;1035;517;518
08;Barcelona;138;Moià;3280;1593;1687
08;Barcelona;123;Molins de Rei;17840;8788;9052
08;Barcelona;124;Mollet del Vallès;40877;20483;20394
08;Barcelona;128;Monistrol de Calders;621;304;317
08;Barcelona;127;Monistrol de Montserrat;2514;1249;1265
08;Barcelona;125;Montcada i Reixac;26356;13058;13298
08;Barcelona;130;Montclar;255;109;146
08;Barcelona;131;Montesquiu;855;417;438
08;Barcelona;126;Montgat;7286;3570;3716
08;Barcelona;132;Montmajor;494;255;239
08;Barcelona;133;Montmaneu;236;131;105
08;Barcelona;135;Montmeló;7454;3704;3750
08;Barcelona;136;Montornès del Vallès;10844;5406;5438
08;Barcelona;137;Montseny;286;153;133
08;Barcelona;129;Muntanyola;171;95;76
08;Barcelona;139;Mura;251;133;118
08;Barcelona;140;Navarcles;5111;2540;2571
08;Barcelona;141;Navàs;5538;2730;2808
08;Barcelona;142;Nou de Berguedà (La);140;75;65
08;Barcelona;143;Òdena;2534;1285;1249
08;Barcelona;145;Olèrdola;1607;822;785
08;Barcelona;146;Olesa de Bonesvalls;447;240;207
08;Barcelona;147;Olesa de Montserrat;14962;7465;7497
08;Barcelona;148;Olivella;401;193;208
08;Barcelona;149;Olost;960;467;493
08;Barcelona;144;Olvan;983;459;524
08;Barcelona;150;Orís;226;115;111
08;Barcelona;151;Oristà;922;468;454
08;Barcelona;152;Orpí;154;80;74
08;Barcelona;153;Òrrius;366;190;176
08;Barcelona;154;Pacs del Penedès;436;226;210
08;Barcelona;155;Palafolls;3186;1559;1627
08;Barcelona;156;Palau-solità i Plegamans;7479;3838;3641
08;Barcelona;157;Pallejà;6599;3300;3299
08;Barcelona;905;Palma de Cervelló (La);"";"";""
08;Barcelona;158;Papiol (El);3327;1643;1684
08;Barcelona;159;Parets del Vallès;10960;5516;5444
08;Barcelona;160;Perafita;338;160;178
08;Barcelona;161;Piera;6013;3003;3010
08;Barcelona;163;Pineda de Mar;16317;8113;8204
08;Barcelona;164;Pla del Penedès (El);964;477;487
08;Barcelona;165;Pobla de Claramunt (La);1635;819;816
08;Barcelona;166;Pobla de Lillet (La);1772;865;907
08;Barcelona;167;Polinyà;3385;1731;1654
08;Barcelona;182;Pont de Vilomara i Rocafort (El);2230;1101;1129
08;Barcelona;168;Pontons;256;136;120
08;Barcelona;169;Prat de Llobregat (El);64321;32249;32072
08;Barcelona;171;Prats de Lluçanès;2625;1304;1321
08;Barcelona;170;Prats de Rei (Els);562;276;286
08;Barcelona;230;Premià de Dalt;6550;3268;3282
08;Barcelona;172;Premià de Mar;22699;11318;11381
08;Barcelona;174;Puigdàlber;298;142;156
08;Barcelona;175;Puig-reig;4746;2321;2425
08;Barcelona;176;Pujalt;176;90;86
08;Barcelona;177;Quar (La);43;19;24
08;Barcelona;178;Rajadell;288;152;136
08;Barcelona;179;Rellinars;235;112;123
08;Barcelona;180;Ripollet;26782;13342;13440
08;Barcelona;181;Roca del Vallès (La);5791;2895;2896
08;Barcelona;183;Roda de Ter;5015;2406;2609
08;Barcelona;184;Rubí;50405;25206;25199
08;Barcelona;185;Rubió;117;64;53
08;Barcelona;901;Rupit i Pruit;343;173;170
08;Barcelona;187;Sabadell;189404;92471;96933
08;Barcelona;188;Sagàs;194;104;90
08;Barcelona;190;Saldes;328;179;149
08;Barcelona;191;Sallent;7686;3731;3955
08;Barcelona;194;Sant Adrià de Besòs;34154;16940;17214
08;Barcelona;195;Sant Agustí de Lluçanès;123;63;60
08;Barcelona;196;Sant Andreu de la Barca;14475;7421;7054
08;Barcelona;197;Sant Andreu de Llavaneres;4183;2056;2127
08;Barcelona;198;Sant Antoni de Vilamajor;2216;1082;1134
08;Barcelona;199;Sant Bartomeu del Grau;1121;586;535
08;Barcelona;200;Sant Boi de Llobregat;77932;38922;39010
08;Barcelona;201;Sant Boi de Lluçanès;530;266;264
08;Barcelona;203;Sant Cebrià de Vallalta;876;470;406
08;Barcelona;202;Sant Celoni;11957;5975;5982
08;Barcelona;204;Sant Climent de Llobregat;2289;1131;1158
08;Barcelona;205;Sant Cugat del Vallès;38937;19277;19660
08;Barcelona;206;Sant Cugat Sesgarrigues;716;370;346
08;Barcelona;207;Sant Esteve de Palautordera;1179;600;579
08;Barcelona;208;Sant Esteve Sesrovires;2642;1347;1295
08;Barcelona;210;Sant Feliu de Codines;3698;1775;1923
08;Barcelona;211;Sant Feliu de Llobregat;36608;18132;18476
08;Barcelona;212;Sant Feliu Sasserra;654;330;324
08;Barcelona;209;Sant Fost de Campsentelles;4938;2521;2417
08;Barcelona;213;Sant Fruitós de Bages;4778;2390;2388
08;Barcelona;215;Sant Hipòlit de Voltregà;2981;1455;1526
08;Barcelona;193;Sant Iscle de Vallalta;513;261;252
08;Barcelona;216;Sant Jaume de Frontanyà;28;14;14
08;Barcelona;218;Sant Joan de Vilatorrada;7974;3972;4002
08;Barcelona;217;Sant Joan Despí;24977;12455;12522
08;Barcelona;903;Sant Julià de Cerdanyola;"";"";""
08;Barcelona;220;Sant Julià de Vilatorta;1934;937;997
08;Barcelona;221;Sant Just Desvern;12471;5962;6509
08;Barcelona;222;Sant Llorenç d'Hortons;1085;547;538
08;Barcelona;223;Sant Llorenç Savall;1956;918;1038
08;Barcelona;225;Sant Martí d'Albars;125;70;55
08;Barcelona;224;Sant Martí de Centelles;642;322;320
08;Barcelona;226;Sant Martí de Tous;946;469;477
08;Barcelona;227;Sant Martí Sarroca;2394;1192;1202
08;Barcelona;228;Sant Martí Sesgueioles;363;181;182
08;Barcelona;229;Sant Mateu de Bages;545;275;270
08;Barcelona;231;Sant Pere de Ribes;13662;6828;6834
08;Barcelona;232;Sant Pere de Riudebitlles;2108;1046;1062
08;Barcelona;233;Sant Pere de Torelló;1996;950;1046
08;Barcelona;234;Sant Pere de Vilamajor;1141;582;559
08;Barcelona;189;Sant Pere Sallavinera;185;95;90
08;Barcelona;235;Sant Pol de Mar;2406;1183;1223
08;Barcelona;236;Sant Quintí de Mediona;1483;737;746
08;Barcelona;237;Sant Quirze de Besora;2028;980;1048
08;Barcelona;238;Sant Quirze del Vallès;9046;4456;4590
08;Barcelona;239;Sant Quirze Safaja;249;119;130
08;Barcelona;240;Sant Sadurní d'Anoia;9296;4648;4648
08;Barcelona;241;Sant Sadurní d'Osormort;74;36;38
08;Barcelona;098;Sant Salvador de Guardiola;1221;623;598
08;Barcelona;262;Sant Vicenç de Castellet;7393;3575;3818
08;Barcelona;264;Sant Vicenç de Montalt;1600;793;807
08;Barcelona;265;Sant Vicenç de Torelló;1702;814;888
08;Barcelona;263;Sant Vicenç dels Horts;20836;10483;10353
08;Barcelona;243;Santa Cecilia de Voltregà;187;104;83
08;Barcelona;244;Santa Coloma de Cervelló;3030;1490;1540
08;Barcelona;245;Santa Coloma de Gramenet;133138;66512;66626
08;Barcelona;246;Santa Eugènia de Berga;1590;818;772
08;Barcelona;247;Santa Eulàlia de Riuprimer;844;433;411
08;Barcelona;248;Santa Eulàlia de Ronçana;3029;1531;1498
08;Barcelona;249;Santa Fe del Penedès;200;91;109
08;Barcelona;250;Santa Margarida de Montbui;9308;4665;4643
08;Barcelona;251;Santa Margarida i els Monjos;3917;2023;1894
08;Barcelona;253;Santa Maria de Besora;201;102;99
08;Barcelona;254;Santa Maria de Corcó;1997;992;1005
08;Barcelona;256;Santa Maria de Martorelles;483;240;243
08;Barcelona;255;Santa Maria de Merlès;200;101;99
08;Barcelona;257;Santa Maria de Miralles;108;55;53
08;Barcelona;259;Santa Maria de Palautordera;4979;2539;2440
08;Barcelona;258;Santa Maria d'Oló;1015;517;498
08;Barcelona;260;Santa Perpètua de Mogoda;16792;8517;8275
08;Barcelona;261;Santa Susanna;982;482;500
08;Barcelona;192;Santpedor;4570;2221;2349
08;Barcelona;267;Sentmenat;4582;2271;2311
08;Barcelona;269;Seva;1765;891;874
08;Barcelona;270;Sitges;13109;6337;6772
08;Barcelona;271;Sobremunt;91;44;47
08;Barcelona;272;Sora;211;111;100
08;Barcelona;273;Subirats;2083;1046;1037
08;Barcelona;274;Súria;6540;3213;3327
08;Barcelona;276;Tagamanent;151;80;71
08;Barcelona;277;Talamanca;76;38;38
08;Barcelona;278;Taradell;4593;2272;2321
08;Barcelona;275;Tavèrnoles;208;99;109
08;Barcelona;280;Tavertet;132;70;62
08;Barcelona;281;Teià;3773;1895;1878
08;Barcelona;279;Terrassa;158063;77127;80936
08;Barcelona;282;Tiana;4685;2360;2325
08;Barcelona;283;Tona;5522;2728;2794
08;Barcelona;284;Tordera;8156;4069;4087
08;Barcelona;285;Torelló;11460;5602;5858
08;Barcelona;286;Torre de Claramunt (La);1545;791;754
08;Barcelona;287;Torrelavit;1231;627;604
08;Barcelona;288;Torrelles de Foix;1277;676;601
08;Barcelona;289;Torrelles de Llobregat;2352;1189;1163
08;Barcelona;290;Ullastrell;939;471;468
08;Barcelona;291;Vacarisses;863;434;429
08;Barcelona;292;Vallbona d'Anoia;1040;522;518
08;Barcelona;293;Vallcebre;308;163;145
08;Barcelona;294;Vallgorguina;755;377;378
08;Barcelona;295;Vallirana;6570;3279;3291
08;Barcelona;296;Vallromanes;657;323;334
08;Barcelona;297;Veciana;163;82;81
08;Barcelona;298;Vic;28736;13716;15020
08;Barcelona;299;Vilada;546;279;267
08;Barcelona;301;Viladecans;48294;24364;23930
08;Barcelona;300;Viladecavalls;3399;1694;1705
08;Barcelona;305;Vilafranca del Penedès;27818;13576;14242
08;Barcelona;306;Vilalba Sasserra;297;155;142
08;Barcelona;303;Vilanova de Sau;305;147;158
08;Barcelona;302;Vilanova del Camí;9317;4682;4635
08;Barcelona;902;Vilanova del Vallès;1468;730;738
08;Barcelona;307;Vilanova i la Geltrú;45864;22521;23343
08;Barcelona;214;Vilassar de Dalt;6791;3333;3458
08;Barcelona;219;Vilassar de Mar;12117;5937;6180
08;Barcelona;304;Vilobí del Penedès;815;417;398
08;Barcelona;308;Viver i Serrateix;209;116;93
09;Burgos;001;Abajas;51;24;27
09;Burgos;003;Adrada de Haza;317;165;152
09;Burgos;006;Aguas Cándidas;113;64;49
09;Burgos;007;Aguilar de Bureba;108;56;52
09;Burgos;009;Albillos;149;77;72
09;Burgos;010;Alcocero de Mola;62;36;26
09;Burgos;011;Alfoz de Bricia;134;67;67
09;Burgos;907;Alfoz de Quintanadueñas;479;251;228
09;Burgos;012;Alfoz de Santa Gadea;169;90;79
09;Burgos;013;Altable;76;47;29
09;Burgos;014;Altos (Los);292;170;122
09;Burgos;016;Ameyugo;63;32;31
09;Burgos;017;Anguix;187;95;92
09;Burgos;018;Aranda de Duero;29814;14928;14886
09;Burgos;019;Arandilla;220;134;86
09;Burgos;020;Arauzo de Miel;448;248;200
09;Burgos;021;Arauzo de Salce;81;50;31
09;Burgos;022;Arauzo de Torre;119;65;54
09;Burgos;023;Arcos;228;137;91
09;Burgos;024;Arenillas de Riopisuerga;241;129;112
09;Burgos;025;Arija;291;137;154
09;Burgos;026;Arlanzón;404;213;191
09;Burgos;027;Arraya de Oca;55;28;27
09;Burgos;029;Atapuerca;151;79;72
09;Burgos;030;Ausines (Los);121;67;54
09;Burgos;032;Avellanosa de Muñó;205;108;97
09;Burgos;033;Bahabón de Esgueva;171;100;71
09;Burgos;034;Balbases (Los);407;219;188
09;Burgos;035;Baños de Valdearados;565;311;254
09;Burgos;036;Bañuelos de Bureba;62;40;22
09;Burgos;037;Barbadillo de Herreros;164;84;80
09;Burgos;038;Barbadillo del Mercado;200;99;101
09;Burgos;039;Barbadillo del Pez;118;62;56
09;Burgos;041;Barrio de Muñó;36;21;15
09;Burgos;043;Barrios de Bureba (Los);335;177;158
09;Burgos;044;Barrios de Colina;80;45;35
09;Burgos;045;Basconcillos del Tozo;440;230;210
09;Burgos;046;Bascuñana;89;47;42
09;Burgos;047;Belbimbre;84;40;44
09;Burgos;048;Belorado;2189;1107;1082
09;Burgos;050;Berberana;98;51;47
09;Burgos;051;Berlangas de Roa;312;162;150
09;Burgos;052;Berzosa de Bureba;55;32;23
09;Burgos;054;Bozoó;109;58;51
09;Burgos;055;Brazacorta;98;53;45
09;Burgos;056;Briviesca;5663;2804;2859
09;Burgos;057;Bugedo;117;85;32
09;Burgos;058;Buniel;138;78;60
09;Burgos;059;Burgos;160278;77928;82350
09;Burgos;060;Busto de Bureba;332;173;159
09;Burgos;061;Cabañes de Esgueva;316;163;153
09;Burgos;062;Cabezón de la Sierra;90;41;49
09;Burgos;063;Cabia;202;106;96
09;Burgos;064;Caleruega;416;203;213
09;Burgos;065;Campillo de Aranda;183;101;82
09;Burgos;066;Campolara;113;61;52
09;Burgos;067;Canicosa de la Sierra;693;350;343
09;Burgos;068;Cantabrana;70;41;29
09;Burgos;070;Carazo;51;29;22
09;Burgos;071;Carcedo de Bureba;42;23;19
09;Burgos;072;Carcedo de Burgos;107;64;43
09;Burgos;073;Cardeñadijo;338;184;154
09;Burgos;074;Cardeñajimeno;320;174;146
09;Burgos;075;Cardeñuela Riopico;70;34;36
09;Burgos;076;Carrias;56;37;19
09;Burgos;077;Cascajares de Bureba;66;38;28
09;Burgos;078;Cascajares de la Sierra;17;10;7
09;Burgos;079;Castellanos de Castro;74;42;32
09;Burgos;083;Castil de Peones;55;27;28
09;Burgos;082;Castildelgado;95;47;48
09;Burgos;084;Castrillo de la Reina;354;210;144
09;Burgos;085;Castrillo de la Vega;643;341;302
09;Burgos;088;Castrillo de Riopisuerga;109;62;47
09;Burgos;086;Castrillo del Val;199;118;81
09;Burgos;090;Castrillo Matajudíos;82;45;37
09;Burgos;091;Castrojeriz;1124;566;558
09;Burgos;093;Cayuela;116;69;47
09;Burgos;094;Cebrecos;80;46;34
09;Burgos;095;Celada del Camino;104;45;59
09;Burgos;098;Cerezo de Río Tirón;882;467;415
09;Burgos;100;Cerratón de Juarros;69;36;33
09;Burgos;101;Ciadoncha;139;81;58
09;Burgos;102;Cillaperlata;86;47;39
09;Burgos;103;Cilleruelo de Abajo;396;215;181
09;Burgos;104;Cilleruelo de Arriba;97;53;44
09;Burgos;105;Ciruelos de Cervera;189;100;89
09;Burgos;108;Cogollos;208;116;92
09;Burgos;109;Condado de Treviño;924;513;411
09;Burgos;110;Contreras;89;54;35
09;Burgos;112;Coruña del Conde;184;100;84
09;Burgos;113;Covarrubias;657;340;317
09;Burgos;114;Cubillo del Campo;76;40;36
09;Burgos;115;Cubo de Bureba;154;77;77
09;Burgos;117;Cueva de Roa (La);150;85;65
09;Burgos;119;Cuevas de San Clemente;72;36;36
09;Burgos;120;Encío;67;37;30
09;Burgos;122;Espinosa de Cervera;127;76;51
09;Burgos;124;Espinosa de los Monteros;2399;1234;1165
09;Burgos;123;Espinosa del Camino;55;28;27
09;Burgos;125;Estépar;909;486;423
09;Burgos;127;Fontioso;105;54;51
09;Burgos;128;Frandovínez;98;52;46
09;Burgos;129;Fresneda de la Sierra Tirón;119;59;60
09;Burgos;130;Fresneña;143;79;64
09;Burgos;131;Fresnillo de las Dueñas;302;150;152
09;Burgos;132;Fresno de Río Tirón;292;169;123
09;Burgos;133;Fresno de Rodilla;34;19;15
09;Burgos;134;Frías;331;173;158
09;Burgos;135;Fuentebureba;102;49;53
09;Burgos;136;Fuentecén;329;176;153
09;Burgos;137;Fuentelcésped;236;118;118
09;Burgos;138;Fuentelisendo;141;73;68
09;Burgos;139;Fuentemolinos;145;76;69
09;Burgos;140;Fuentenebro;229;126;103
09;Burgos;141;Fuentespina;570;296;274
09;Burgos;143;Galbarros;31;22;9
09;Burgos;144;Gallega (La);94;56;38
09;Burgos;148;Grijalba;168;79;89
09;Burgos;149;Grisaleña;66;38;28
09;Burgos;151;Gumiel de Izán;711;383;328
09;Burgos;152;Gumiel de Mercado;457;247;210
09;Burgos;154;Hacinas;226;124;102
09;Burgos;155;Haza;52;26;26
09;Burgos;159;Hontanas;96;55;41
09;Burgos;160;Hontangas;165;90;75
09;Burgos;162;Hontoria de la Cantera;107;51;56
09;Burgos;164;Hontoria de Valdearados;266;157;109
09;Burgos;163;Hontoria del Pinar;985;529;456
09;Burgos;166;Hormazas (Las);169;85;84
09;Burgos;167;Hornillos del Camino;89;47;42
09;Burgos;168;Horra (La);507;263;244
09;Burgos;169;Hortigüela;115;60;55
09;Burgos;170;Hoyales de Roa;356;171;185
09;Burgos;172;Huérmeces;161;90;71
09;Burgos;173;Huerta de Arriba;226;117;109
09;Burgos;174;Huerta de Rey;1232;645;587
09;Burgos;175;Humada;296;172;124
09;Burgos;176;Hurones;63;40;23
09;Burgos;177;Ibeas de Juarros;839;443;396
09;Burgos;178;Ibrillos;116;65;51
09;Burgos;179;Iglesiarrubia;78;43;35
09;Burgos;180;Iglesias;213;110;103
09;Burgos;181;Isar;425;202;223
09;Burgos;182;Itero del Castillo;142;69;73
09;Burgos;183;Jaramillo de la Fuente;35;20;15
09;Burgos;184;Jaramillo Quemado;16;10;6
09;Burgos;189;Junta de Traslaloma;250;125;125
09;Burgos;190;Junta de Villalba de Losa;109;59;50
09;Burgos;191;Jurisdicción de Lara;61;34;27
09;Burgos;192;Jurisdicción de San Zadornil;78;41;37
09;Burgos;194;Lerma;2550;1283;1267
09;Burgos;195;Llano de Bureba;70;42;28
09;Burgos;196;Madrigal del Monte;185;89;96
09;Burgos;197;Madrigalejo del Monte;177;97;80
09;Burgos;198;Mahamud;179;88;91
09;Burgos;199;Mambrilla de Castrejón;180;95;85
09;Burgos;200;Mambrillas de Lara;81;41;40
09;Burgos;201;Mamolar;97;53;44
09;Burgos;202;Manciles;50;27;23
09;Burgos;206;Mazuela;94;48;46
09;Burgos;208;Mecerreyes;306;146;160
09;Burgos;209;Medina de Pomar;5336;2674;2662
09;Burgos;211;Melgar de Fernamental;2212;1129;1083
09;Burgos;213;Merindad de Cuesta-Urria;602;346;256
09;Burgos;214;Merindad de Montija;1067;565;502
09;Burgos;431;Villafranca Montes de Oca;216;114;102
09;Burgos;432;Villafruela;341;183;158
09;Burgos;433;Villagalijo;54;28;26
09;Burgos;434;Villagonzalo Pedernales;447;220;227
09;Burgos;437;Villahoz;446;214;232
09;Burgos;438;Villalba de Duero;551;305;246
09;Burgos;439;Villalbilla de Burgos;554;302;252
09;Burgos;440;Villalbilla de Gumiel;156;85;71
09;Burgos;441;Villaldemiro;93;42;51
09;Burgos;442;Villalmanzo;453;241;212
09;Burgos;443;Villamayor de los Montes;301;148;153
09;Burgos;444;Villamayor de Treviño;125;71;54
09;Burgos;445;Villambistia;84;47;37
09;Burgos;446;Villamedianilla;29;14;15
09;Burgos;447;Villamiel de la Sierra;35;22;13
09;Burgos;448;Villangómez;395;206;189
09;Burgos;449;Villanueva de Argaño;116;61;55
09;Burgos;450;Villanueva de Carazo;30;18;12
09;Burgos;451;Villanueva de Gumiel;324;172;152
09;Burgos;454;Villanueva de Teba;71;40;31
09;Burgos;455;Villaquirán de la Puebla;79;45;34
09;Burgos;456;Villaquirán de los Infantes;222;117;105
09;Burgos;903;Villarcayo de Merindad de Castilla la Vieja;4105;2061;2044
09;Burgos;458;Villariezo;152;80;72
09;Burgos;460;Villasandino;316;159;157
09;Burgos;463;Villasur de Herreros;349;179;170
09;Burgos;464;Villatuelda;82;44;38
09;Burgos;466;Villaverde del Monte;207;113;94
09;Burgos;467;Villaverde-Mogina;156;87;69
09;Burgos;471;Villayerno Morquillas;132;60;72
09;Burgos;472;Villazopeque;101;57;44
09;Burgos;473;Villegas;140;72;68
09;Burgos;476;Villoruebo;45;31;14
09;Burgos;424;Viloria de Rioja;83;45;38
09;Burgos;425;Vilviestre del Pinar;827;424;403
09;Burgos;478;Vizcaínos;49;26;23
09;Burgos;480;Zael;168;85;83
09;Burgos;482;Zarzosa de Río Pisuerga;81;44;37
09;Burgos;483;Zazuar;295;151;144
09;Burgos;485;Zuñeda;96;50;46
09;Burgos;906;Merindad de Río Ubierna;1117;589;528
09;Burgos;215;Merindad de Sotoscueva;711;374;337
09;Burgos;216;Merindad de Valdeporres;572;295;277
09;Burgos;217;Merindad de Valdivielso;650;340;310
09;Burgos;218;Milagros;474;247;227
09;Burgos;219;Miranda de Ebro;36550;18175;18375
09;Burgos;220;Miraveche;122;67;55
09;Burgos;221;Modúbar de la Emparedada;162;88;74
09;Burgos;223;Monasterio de la Sierra;33;18;15
09;Burgos;224;Monasterio de Rodilla;219;115;104
09;Burgos;225;Moncalvillo;155;89;66
09;Burgos;226;Monterrubio de la Demanda;94;52;42
09;Burgos;227;Montorio;172;82;90
09;Burgos;228;Moradillo de Roa;225;120;105
09;Burgos;229;Nava de Roa;350;175;175
09;Burgos;230;Navas de Bureba;50;25;25
09;Burgos;231;Nebreda;120;75;45
09;Burgos;232;Neila;242;118;124
09;Burgos;235;Olmedillo de Roa;270;136;134
09;Burgos;236;Olmillos de Muñó;53;30;23
09;Burgos;238;Oña;1945;968;977
09;Burgos;239;Oquillas;79;38;41
09;Burgos;241;Orbaneja Riopico;151;84;67
09;Burgos;242;Padilla de Abajo;122;65;57
09;Burgos;243;Padilla de Arriba;142;72;70
09;Burgos;244;Padrones de Bureba;95;51;44
09;Burgos;246;Palacios de la Sierra;1016;515;501
09;Burgos;247;Palacios de Riopisuerga;52;27;25
09;Burgos;248;Palazuelos de la Sierra;70;35;35
09;Burgos;249;Palazuelos de Muñó;67;36;31
09;Burgos;250;Pampliega;434;224;210
09;Burgos;251;Pancorbo;573;283;290
09;Burgos;253;Pardilla;113;56;57
09;Burgos;255;Partido de la Sierra en Tobalina;77;44;33
09;Burgos;256;Pedrosa de Duero;648;345;303
09;Burgos;259;Pedrosa de Río Úrbel;315;177;138
09;Burgos;257;Pedrosa del Páramo;122;68;54
09;Burgos;258;Pedrosa del Príncipe;339;171;168
09;Burgos;261;Peñaranda de Duero;658;346;312
09;Burgos;262;Peral de Arlanza;260;141;119
09;Burgos;265;Piérnigas;42;25;17
09;Burgos;266;Pineda de la Sierra;114;64;50
09;Burgos;267;Pineda Trasmonte;222;113;109
09;Burgos;268;Pinilla de los Barruecos;148;77;71
09;Burgos;269;Pinilla de los Moros;54;35;19
09;Burgos;270;Pinilla Trasmonte;287;147;140
09;Burgos;272;Poza de la Sal;494;242;252
09;Burgos;273;Prádanos de Bureba;89;53;36
09;Burgos;274;Pradoluengo;1742;832;910
09;Burgos;275;Presencio;331;175;156
09;Burgos;276;Puebla de Arganzón (La);232;126;106
09;Burgos;277;Puentedura;141;75;66
09;Burgos;279;Quemada;259;143;116
09;Burgos;281;Quintana del Pidio;215;117;98
09;Burgos;280;Quintanabureba;45;28;17
09;Burgos;283;Quintanaélez;131;69;62
09;Burgos;287;Quintanaortuño;113;55;58
09;Burgos;288;Quintanapalla;135;71;64
09;Burgos;289;Quintanar de la Sierra;2482;1280;1202
09;Burgos;292;Quintanavides;84;36;48
09;Burgos;294;Quintanilla de la Mata;174;100;74
09;Burgos;901;Quintanilla del Agua y Tordueles;663;345;318
09;Burgos;295;Quintanilla del Coco;128;67;61
09;Burgos;298;Quintanilla San García;144;76;68
09;Burgos;301;Quintanilla Vivar;306;150;156
09;Burgos;297;Quintanillas (Las);339;178;161
09;Burgos;302;Rabanera del Pinar;172;87;85
09;Burgos;303;Rábanos;58;32;26
09;Burgos;304;Rabé de las Calzadas;149;81;68
09;Burgos;306;Rebolledo de la Torre;199;99;100
09;Burgos;307;Redecilla del Camino;147;87;60
09;Burgos;308;Redecilla del Campo;102;50;52
09;Burgos;309;Regumiel de la Sierra;565;288;277
09;Burgos;310;Reinoso;32;20;12
09;Burgos;311;Retuerta;78;44;34
09;Burgos;314;Revilla del Campo;139;72;67
09;Burgos;316;Revilla Vallejera;186;102;84
09;Burgos;312;Revilla y Ahedo (La);133;68;65
09;Burgos;315;Revillarruz;136;70;66
09;Burgos;317;Rezmondo;27;13;14
09;Burgos;318;Riocavado de la Sierra;78;45;33
09;Burgos;321;Roa;2375;1212;1163
09;Burgos;323;Rojas;103;56;47
09;Burgos;325;Royuela de Río Franco;394;214;180
09;Burgos;326;Rubena;165;79;86
09;Burgos;327;Rublacedo de Abajo;41;20;21
09;Burgos;328;Rucandio;144;70;74
09;Burgos;329;Salas de Bureba;186;100;86
09;Burgos;330;Salas de los Infantes;2112;1060;1052
09;Burgos;332;Saldaña de Burgos;80;42;38
09;Burgos;334;Salinillas de Bureba;69;41;28
09;Burgos;335;San Adrián de Juarros;41;19;22
09;Burgos;337;San Juan del Monte;186;97;89
09;Burgos;338;San Mamés de Burgos;134;77;57
09;Burgos;339;San Martín de Rubiales;342;182;160
09;Burgos;340;San Millán de Lara;98;57;41
09;Burgos;360;San Vicente del Valle;33;20;13
09;Burgos;343;Santa Cecilia;146;78;68
09;Burgos;345;Santa Cruz de la Salceda;183;94;89
09;Burgos;346;Santa Cruz del Valle Urbión;143;82;61
09;Burgos;347;Santa Gadea del Cid;217;112;105
09;Burgos;348;Santa Inés;210;111;99
09;Burgos;350;Santa María del Campo;749;384;365
09;Burgos;351;Santa María del Invierno;63;37;26
09;Burgos;352;Santa María del Mercadillo;229;129;100
09;Burgos;353;Santa María Rivarredonda;139;73;66
09;Burgos;354;Santa Olalla de Bureba;55;23;32
09;Burgos;355;Santibáñez de Esgueva;197;97;100
09;Burgos;356;Santibáñez del Val;69;38;31
09;Burgos;358;Santo Domingo de Silos;339;216;123
09;Burgos;361;Sargentes de la Lora;198;101;97
09;Burgos;362;Sarracín;155;89;66
09;Burgos;363;Sasamón;1505;807;698
09;Burgos;365;Sequera de Haza (La);76;44;32
09;Burgos;366;Solarana;130;70;60
09;Burgos;368;Sordillos;43;25;18
09;Burgos;369;Sotillo de la Ribera;573;319;254
09;Burgos;372;Sotragero;122;72;50
09;Burgos;373;Sotresgudo;833;445;388
09;Burgos;374;Susinos del Páramo;62;34;28
09;Burgos;375;Tamarón;51;27;24
09;Burgos;377;Tardajos;745;422;323
09;Burgos;378;Tejada;57;32;25
09;Burgos;380;Terradillos de Esgueva;147;75;72
09;Burgos;381;Tinieblas de la Sierra;34;18;16
09;Burgos;382;Tobar;56;28;28
09;Burgos;384;Tordómar;407;229;178
09;Burgos;386;Torrecilla del Monte;84;44;40
09;Burgos;387;Torregalindo;170;89;81
09;Burgos;388;Torrelara;23;10;13
09;Burgos;389;Torrepadre;202;110;92
09;Burgos;390;Torresandino;841;446;395
09;Burgos;391;Tórtoles de Esgueva;618;334;284
09;Burgos;392;Tosantos;86;42;44
09;Burgos;394;Trespaderne;1234;654;580
09;Burgos;395;Tubilla del Agua;166;96;70
09;Burgos;396;Tubilla del Lago;229;117;112
09;Burgos;398;Úrbel del Castillo;117;61;56
09;Burgos;400;Vadocondes;497;254;243
09;Burgos;403;Valdeande;209;110;99
09;Burgos;405;Valdezate;242;128;114
09;Burgos;406;Valdorros;100;55;45
09;Burgos;408;Vallarta de Bureba;93;52;41
09;Burgos;904;Valle de las Navas;673;363;310
09;Burgos;908;Valle de Losa;741;416;325
09;Burgos;409;Valle de Manzanedo;104;57;47
09;Burgos;410;Valle de Mena;4622;2352;2270
09;Burgos;411;Valle de Oca;223;114;109
09;Burgos;902;Valle de Santibáñez;736;384;352
09;Burgos;905;Valle de Sedano;510;278;232
09;Burgos;412;Valle de Tobalina;1088;580;508
09;Burgos;413;Valle de Valdebezana;805;442;363
09;Burgos;414;Valle de Valdelaguna;287;144;143
09;Burgos;415;Valle de Valdelucio;432;229;203
09;Burgos;416;Valle de Zamanzas;49;27;22
09;Burgos;417;Vallejera;60;32;28
09;Burgos;418;Valles de Palenzuela;110;57;53
09;Burgos;419;Valluércanes;137;81;56
09;Burgos;407;Valmala;37;20;17
09;Burgos;422;Vid de Bureba (La);49;24;25
09;Burgos;421;Vid y Barrios (La);394;221;173
09;Burgos;423;Vileña;50;29;21
09;Burgos;427;Villadiego;2377;1265;1112
09;Burgos;428;Villaescusa de Roa;192;104;88
09;Burgos;429;Villaescusa la Sombría;71;43;28
09;Burgos;430;Villaespasa;44;27;17
10;Cáceres;001;Abadía;310;178;132
10;Cáceres;002;Abertura;532;278;254
10;Cáceres;003;Acebo;891;451;440
10;Cáceres;004;Acehúche;1014;509;505
10;Cáceres;005;Aceituna;790;401;389
10;Cáceres;006;Ahigal;1791;926;865
10;Cáceres;007;Albalá del Caudillo;968;477;491
10;Cáceres;008;Alcántara;2076;1053;1023
10;Cáceres;009;Alcollarín;385;181;204
10;Cáceres;010;Alcuéscar;3331;1749;1582
10;Cáceres;012;Aldea del Cano;791;384;407
10;Cáceres;013;Aldea del Obispo (La);439;224;215
10;Cáceres;011;Aldeacentenera;1086;533;553
10;Cáceres;014;Aldeanueva de la Vera;2616;1306;1310
10;Cáceres;015;Aldeanueva del Camino;978;466;512
10;Cáceres;016;Aldehuela de Jerte;403;233;170
10;Cáceres;017;Alía;1696;845;851
10;Cáceres;018;Aliseda;2476;1246;1230
10;Cáceres;019;Almaraz;1293;662;631
10;Cáceres;020;Almoharín;2129;1056;1073
10;Cáceres;021;Arroyo de la Luz;6619;3289;3330
10;Cáceres;023;Arroyomolinos;1157;593;564
10;Cáceres;022;Arroyomolinos de la Vera;671;332;339
10;Cáceres;024;Baños de Montemayor;765;360;405
10;Cáceres;025;Barrado;583;290;293
10;Cáceres;026;Belvís de Monroy;550;278;272
10;Cáceres;027;Benquerencia;117;65;52
10;Cáceres;028;Berrocalejo;157;72;85
10;Cáceres;029;Berzocana;745;383;362
10;Cáceres;030;Bohonal de Ibor;672;332;340
10;Cáceres;031;Botija;204;92;112
10;Cáceres;032;Brozas;2490;1233;1257
10;Cáceres;033;Cabañas del Castillo;688;352;336
10;Cáceres;034;Cabezabellosa;642;318;324
10;Cáceres;035;Cabezuela del Valle;2430;1229;1201
10;Cáceres;036;Cabrero;479;252;227
10;Cáceres;037;Cáceres;74589;35711;38878
10;Cáceres;038;Cachorrilla;112;54;58
10;Cáceres;039;Cadalso;584;297;287
10;Cáceres;040;Calzadilla;618;295;323
10;Cáceres;041;Caminomorisco;1329;703;626
10;Cáceres;042;Campillo de Deleitosa;175;86;89
10;Cáceres;043;Campo Lugar;1304;650;654
10;Cáceres;044;Cañamero;2078;1060;1018
10;Cáceres;045;Cañaveral;1717;823;894
10;Cáceres;046;Carbajo;313;165;148
10;Cáceres;047;Carcaboso;1326;695;631
10;Cáceres;048;Carrascalejo;495;237;258
10;Cáceres;049;Casar de Cáceres;4071;2063;2008
10;Cáceres;050;Casar de Palomero;1492;766;726
10;Cáceres;051;Casares de las Hurdes;1012;523;489
10;Cáceres;052;Casas de Don Antonio;270;130;140
10;Cáceres;053;Casas de Don Gómez;409;207;202
10;Cáceres;056;Casas de Millán;853;439;414
10;Cáceres;057;Casas de Miravete;169;90;79
10;Cáceres;054;Casas del Castañar;755;365;390
10;Cáceres;055;Casas del Monte;953;496;457
10;Cáceres;058;Casatejada;1410;707;703
10;Cáceres;059;Casillas de Coria;643;308;335
10;Cáceres;060;Castañar de Ibor;1366;692;674
10;Cáceres;061;Ceclavín;2405;1217;1188
10;Cáceres;062;Cedillo;605;302;303
10;Cáceres;063;Cerezo;262;125;137
10;Cáceres;064;Cilleros;2394;1197;1197
10;Cáceres;065;Collado;365;187;178
10;Cáceres;066;Conquista de la Sierra;197;98;99
10;Cáceres;067;Coria;11108;5559;5549
10;Cáceres;068;Cuacos de Yuste;975;507;468
10;Cáceres;069;Cumbre (La);1229;605;624
10;Cáceres;070;Deleitosa;1077;531;546
10;Cáceres;071;Descargamaría;261;135;126
10;Cáceres;072;Eljas;1360;694;666
10;Cáceres;073;Escurial;1003;504;499
10;Cáceres;075;Fresnedoso de Ibor;504;265;239
10;Cáceres;076;Galisteo;2065;1030;1035
10;Cáceres;077;Garciaz;1099;550;549
10;Cáceres;078;Garganta (La);675;351;324
10;Cáceres;079;Garganta la Olla;1277;657;620
10;Cáceres;080;Gargantilla;567;287;280
10;Cáceres;081;Gargüera;271;129;142
10;Cáceres;082;Garrovillas de Alconétar;2631;1254;1377
10;Cáceres;083;Garvín;120;70;50
10;Cáceres;084;Gata;2091;1036;1055
10;Cáceres;085;Gordo (El);357;179;178
10;Cáceres;086;Granja (La);473;252;221
10;Cáceres;087;Guadalupe;2507;1237;1270
10;Cáceres;088;Guijo de Coria;357;188;169
10;Cáceres;089;Guijo de Galisteo;1759;906;853
10;Cáceres;090;Guijo de Granadilla;824;402;422
10;Cáceres;091;Guijo de Santa Bárbara;583;291;292
10;Cáceres;092;Herguijuela;470;229;241
10;Cáceres;093;Hernán-Pérez;525;275;250
10;Cáceres;094;Herrera de Alcántara;408;199;209
10;Cáceres;095;Herreruela;548;274;274
10;Cáceres;096;Hervás;3832;1843;1989
10;Cáceres;097;Higuera;131;67;64
10;Cáceres;098;Hinojal;464;224;240
10;Cáceres;099;Holguera;870;432;438
10;Cáceres;100;Hoyos;1010;499;511
10;Cáceres;101;Huélaga;181;90;91
10;Cáceres;102;Ibahernando;840;423;417
10;Cáceres;103;Jaraicejo;759;376;383
10;Cáceres;104;Jaraíz de la Vera;7254;3589;3665
10;Cáceres;105;Jarandilla de la Vera;3110;1544;1566
10;Cáceres;106;Jarilla;195;100;95
10;Cáceres;107;Jerte;1363;712;651
10;Cáceres;108;Ladrillar;433;226;207
10;Cáceres;109;Logrosán;2760;1343;1417
10;Cáceres;110;Losar de la Vera;3118;1549;1569
10;Cáceres;111;Madrigal de la Vera;1827;928;899
10;Cáceres;112;Madrigalejo;2490;1237;1253
10;Cáceres;113;Madroñera;3315;1644;1671
10;Cáceres;114;Majadas;1130;582;548
10;Cáceres;115;Malpartida de Cáceres;3956;1980;1976
10;Cáceres;116;Malpartida de Plasencia;4148;2031;2117
10;Cáceres;117;Marchagaz;430;206;224
10;Cáceres;118;Mata de Alcántara;405;204;201
10;Cáceres;119;Membrío;1013;483;530
10;Cáceres;120;Mesas de Ibor;232;123;109
10;Cáceres;121;Miajadas;9633;4810;4823
10;Cáceres;122;Millanes;267;144;123
10;Cáceres;123;Mirabel;941;470;471
10;Cáceres;124;Mohedas de Granadilla;1128;583;545
10;Cáceres;125;Monroy;1345;664;681
10;Cáceres;126;Montánchez;2487;1240;1247
10;Cáceres;127;Montehermoso;5296;2667;2629
10;Cáceres;128;Moraleja;8015;3995;4020
10;Cáceres;129;Morcillo;601;284;317
10;Cáceres;130;Navaconcejo;2152;1100;1052
10;Cáceres;131;Navalmoral de la Mata;15089;7454;7635
10;Cáceres;132;Navalvillar de Ibor;634;321;313
10;Cáceres;133;Navas del Madroño;1698;845;853
10;Cáceres;134;Navezuelas;808;429;379
10;Cáceres;135;Nuñomoral;2195;1153;1042
10;Cáceres;136;Oliva de Plasencia;368;178;190
10;Cáceres;137;Palomero;609;315;294
10;Cáceres;138;Pasarón de la Vera;725;364;361
10;Cáceres;139;Pedroso de Acim;193;93;100
10;Cáceres;140;Peraleda de la Mata;1540;766;774
10;Cáceres;141;Peraleda de San Román;453;223;230
10;Cáceres;142;Perales del Puerto;1023;508;515
10;Cáceres;143;Pescueza;271;135;136
10;Cáceres;144;Pesga (La);1413;735;678
10;Cáceres;145;Piedras Albas;268;125;143
10;Cáceres;146;Pinofranqueado;1843;974;869
10;Cáceres;147;Piornal;1620;805;815
10;Cáceres;148;Plasencia;36060;17681;18379
10;Cáceres;149;Plasenzuela;514;262;252
10;Cáceres;150;Portaje;482;239;243
10;Cáceres;151;Portezuelo;352;164;188
10;Cáceres;152;Pozuelo de Zarzón;660;321;339
10;Cáceres;153;Puerto de Santa Cruz;469;227;242
10;Cáceres;154;Rebollar;279;148;131
10;Cáceres;155;Riolobos;1809;953;856
10;Cáceres;156;Robledillo de Gata;216;109;107
10;Cáceres;157;Robledillo de la Vera;465;226;239
10;Cáceres;158;Robledillo de Trujillo;553;282;271
10;Cáceres;159;Robledollano;443;236;207
10;Cáceres;160;Romangordo;213;107;106
10;Cáceres;901;Rosalejo;"";"";""
10;Cáceres;161;Ruanes;111;57;54
10;Cáceres;162;Salorino;971;472;499
10;Cáceres;163;Salvatierra de Santiago;475;248;227
10;Cáceres;164;San Martín de Trevejo;960;478;482
10;Cáceres;165;Santa Ana;372;187;185
10;Cáceres;166;Santa Cruz de la Sierra;403;209;194
10;Cáceres;167;Santa Cruz de Paniagua;529;275;254
10;Cáceres;168;Santa Marta de Magasca;401;202;199
10;Cáceres;169;Santiago de Alcántara;923;454;469
10;Cáceres;170;Santiago del Campo;382;196;186
10;Cáceres;171;Santibáñez el Alto;540;274;266
10;Cáceres;172;Santibáñez el Bajo;1086;588;498
10;Cáceres;173;Saucedilla;569;277;292
10;Cáceres;174;Segura de Toro;198;106;92
10;Cáceres;175;Serradilla;2254;1125;1129
10;Cáceres;176;Serrejón;488;250;238
10;Cáceres;177;Sierra de Fuentes;1521;749;772
10;Cáceres;178;Talaván;1092;534;558
10;Cáceres;179;Talaveruela de la Vera;539;259;280
10;Cáceres;180;Talayuela;7688;3912;3776
10;Cáceres;181;Tejeda de Tiétar;1086;577;509
10;Cáceres;182;Toril;183;101;82
10;Cáceres;183;Tornavacas;1453;757;696
10;Cáceres;184;Torno (El);1115;583;532
10;Cáceres;187;Torre de Don Miguel;733;366;367
10;Cáceres;188;Torre de Santa María;818;398;420
10;Cáceres;185;Torrecilla de los Ángeles;717;368;349
10;Cáceres;186;Torrecillas de la Tiesa;1303;653;650
10;Cáceres;190;Torrejón el Rubio;807;408;399
10;Cáceres;189;Torrejoncillo;3700;1782;1918
10;Cáceres;191;Torremenga;585;300;285
10;Cáceres;192;Torremocha;1353;649;704
10;Cáceres;193;Torreorgaz;1423;717;706
10;Cáceres;194;Torrequemada;636;293;343
10;Cáceres;195;Trujillo;9085;4324;4761
10;Cáceres;196;Valdastillas;437;214;223
10;Cáceres;197;Valdecañas de Tajo;131;71;60
10;Cáceres;198;Valdefuentes;1659;824;835
10;Cáceres;199;Valdehúncar;189;86;103
10;Cáceres;200;Valdelacasa de Tajo;756;354;402
10;Cáceres;201;Valdemorales;275;133;142
10;Cáceres;202;Valdeobispo;924;463;461
10;Cáceres;203;Valencia de Alcántara;6577;3210;3367
10;Cáceres;204;Valverde de la Vera;744;374;370
10;Cáceres;205;Valverde del Fresno;2827;1415;1412
10;Cáceres;206;Viandar de la Vera;337;166;171
10;Cáceres;207;Villa del Campo;715;355;360
10;Cáceres;208;Villa del Rey;170;84;86
10;Cáceres;209;Villamesías;469;223;246
10;Cáceres;210;Villamiel;822;409;413
10;Cáceres;211;Villanueva de la Sierra;718;354;364
10;Cáceres;212;Villanueva de la Vera;2076;1038;1038
10;Cáceres;214;Villar de Plasencia;352;173;179
10;Cáceres;213;Villar del Pedroso;938;476;462
10;Cáceres;215;Villasbuenas de Gata;533;268;265
10;Cáceres;216;Zarza de Granadilla;1849;956;893
10;Cáceres;217;Zarza de Montánchez;709;351;358
10;Cáceres;218;Zarza la Mayor;1728;865;863
10;Cáceres;219;Zorita;2275;1113;1162
11;Cádiz;001;Alcalá de los Gazules;5598;2899;2699
11;Cádiz;002;Alcalá del Valle;5316;2702;2614
11;Cádiz;003;Algar;1864;997;867
11;Cádiz;004;Algeciras;101256;49847;51409
11;Cádiz;005;Algodonales;5752;2992;2760
11;Cádiz;006;Arcos de la Frontera;26946;13552;13394
11;Cádiz;007;Barbate;21641;10834;10807
11;Cádiz;008;Barrios (Los);13669;6944;6725
11;Cádiz;901;Benalup-Casas Viejas;"";"";""
11;Cádiz;009;Benaocaz;528;271;257
11;Cádiz;010;Bornos;7867;3942;3925
11;Cádiz;011;Bosque (El);1777;898;879
11;Cádiz;013;Castellar de la Frontera;2269;1149;1120
11;Cádiz;015;Chiclana de la Frontera;46862;23947;22915
11;Cádiz;016;Chipiona;14297;7203;7094
11;Cádiz;014;Conil de la Frontera;15582;7965;7617
11;Cádiz;012;Cádiz;154347;74964;79383
11;Cádiz;017;Espera;4113;2120;1993
11;Cádiz;018;Gastor (El);2148;1140;1008
11;Cádiz;019;Grazalema;2240;1156;1084
11;Cádiz;020;Jerez de la Frontera;183316;90004;93312
11;Cádiz;021;Jimena de la Frontera;8862;4541;4321
11;Cádiz;022;Línea de la Concepción (La);58315;28386;29929
11;Cádiz;023;Medina-Sidonia;16309;8424;7885
11;Cádiz;024;Olvera;9091;4589;4502
11;Cádiz;025;Paterna de Rivera;4873;2507;2366
11;Cádiz;026;Prado del Rey;5539;2775;2764
11;Cádiz;028;Puerto Real;29638;14938;14700
11;Cádiz;029;Puerto Serrano;6479;3305;3174
11;Cádiz;027;Puerto de Santa María (El);65517;32746;32771
11;Cádiz;030;Rota;22691;11475;11216
11;Cádiz;031;San Fernando;85410;42122;43288
11;Cádiz;902;San José del Valle;"";"";""
11;Cádiz;033;San Roque;21224;10691;10533
11;Cádiz;032;Sanlúcar de Barrameda;56006;28028;27978
11;Cádiz;034;Setenil de las Bodegas;3194;1612;1582
11;Cádiz;035;Tarifa;14512;7306;7206
11;Cádiz;036;Torre Alháquime;1023;520;503
11;Cádiz;037;Trebujena;6981;3564;3417
11;Cádiz;038;Ubrique;18051;8969;9082
11;Cádiz;039;Vejer de la Frontera;12793;6525;6268
11;Cádiz;040;Villaluenga del Rosario;513;266;247
11;Cádiz;041;Villamartín;12385;6212;6173
11;Cádiz;042;Zahara;1610;832;778
12;Castellón/Castelló;002;Aín;131;65;66
12;Castellón/Castelló;003;Albocàsser;1509;737;772
12;Castellón/Castelló;004;Alcalà de Xivert;4786;2410;2376
12;Castellón/Castelló;005;Alcora (L');8367;4228;4139
12;Castellón/Castelló;006;Alcudia de Veo;191;90;101
12;Castellón/Castelló;007;Alfondeguilla;919;451;468
12;Castellón/Castelló;008;Algimia de Almonacid;333;183;150
12;Castellón/Castelló;009;Almazora/Almassora;15348;7520;7828
12;Castellón/Castelló;010;Almedíjar;298;144;154
12;Castellón/Castelló;011;Almenara;5030;2497;2533
12;Castellón/Castelló;901;Alquerías del Niño Perdido;3615;1761;1854
12;Castellón/Castelló;012;Altura;3022;1504;1518
12;Castellón/Castelló;013;Arañuel;110;47;63
12;Castellón/Castelló;014;Ares del Maestre;340;169;171
12;Castellón/Castelló;015;Argelita;106;53;53
12;Castellón/Castelló;016;Artana;1905;954;951
12;Castellón/Castelló;001;Atzeneta del Maestrat;1587;792;795
12;Castellón/Castelló;017;Ayódar;215;119;96
12;Castellón/Castelló;018;Azuébar;414;206;208
12;Castellón/Castelló;020;Barracas;171;94;77
12;Castellón/Castelló;022;Bejís;430;220;210
12;Castellón/Castelló;024;Benafer;126;66;60
12;Castellón/Castelló;025;Benafigos;262;146;116
12;Castellón/Castelló;026;Benasal;1458;709;749
12;Castellón/Castelló;027;Benicarló;18351;8985;9366
12;Castellón/Castelló;028;Benicasim/Benicàssim;6136;3080;3056
12;Castellón/Castelló;029;Benlloch;958;495;463
12;Castellón/Castelló;021;Betxí;5285;2688;2597
12;Castellón/Castelló;031;Borriol;2701;1365;1336
12;Castellón/Castelló;032;Burriana;25671;12586;13085
12;Castellón/Castelló;033;Cabanes;2456;1210;1246
12;Castellón/Castelló;034;Càlig;1764;861;903
12;Castellón/Castelló;036;Canet lo Roig;1052;518;534
12;Castellón/Castelló;037;Castell de Cabres;24;12;12
12;Castellón/Castelló;038;Castellfort;278;146;132
12;Castellón/Castelló;039;Castellnovo;1094;548;546
12;Castellón/Castelló;040;Castellón de la Plana/Castelló de la Plana;134213;65413;68800
12;Castellón/Castelló;041;Castillo de Villamalefa;138;68;70
12;Castellón/Castelló;042;Catí;923;468;455
12;Castellón/Castelló;043;Caudiel;705;350;355
12;Castellón/Castelló;044;Cervera del Maestre;784;381;403
12;Castellón/Castelló;052;Chert/Xert;1038;506;532
12;Castellón/Castelló;053;Chilches/Xilxes;2135;1079;1056
12;Castellón/Castelló;055;Chodos/Xodos;160;87;73
12;Castellón/Castelló;056;Chóvar;420;215;205
12;Castellón/Castelló;045;Cinctorres;613;280;333
12;Castellón/Castelló;046;Cirat;316;157;159
12;Castellón/Castelló;048;Cortes de Arenoso;427;230;197
12;Castellón/Castelló;049;Costur;482;241;241
12;Castellón/Castelló;050;Coves de Vinromà (les);1938;957;981
12;Castellón/Castelló;051;Culla;953;472;481
12;Castellón/Castelló;057;Eslida;846;413;433
12;Castellón/Castelló;058;Espadilla;79;33;46
12;Castellón/Castelló;059;Fanzara;290;141;149
12;Castellón/Castelló;060;Figueroles;586;290;296
12;Castellón/Castelló;061;Forcall;604;287;317
12;Castellón/Castelló;063;Fuente la Reina;40;20;20
12;Castellón/Castelló;064;Fuentes de Ayódar;80;42;38
12;Castellón/Castelló;065;Gaibiel;227;119;108
12;Castellón/Castelló;066;Gatova;469;234;235
12;Castellón/Castelló;067;Geldo;717;358;359
12;Castellón/Castelló;068;Herbés;135;69;66
12;Castellón/Castelló;069;Higueras;33;18;15
12;Castellón/Castelló;070;Jana (La);934;465;469
12;Castellón/Castelló;071;Jérica;1647;846;801
12;Castellón/Castelló;074;Llosa (La);957;478;479
12;Castellón/Castelló;072;Lucena del Cid;1659;812;847
12;Castellón/Castelló;073;Ludiente;265;132;133
12;Castellón/Castelló;075;Mata de Morella (La);217;100;117
12;Castellón/Castelló;076;Matet;142;71;71
12;Castellón/Castelló;077;Moncofa;3566;1798;1768
12;Castellón/Castelló;078;Montán;365;183;182
12;Castellón/Castelló;079;Montanejos;422;212;210
12;Castellón/Castelló;080;Morella;2881;1392;1489
12;Castellón/Castelló;081;Navajas;456;219;237
12;Castellón/Castelló;082;Nules;11533;5715;5818
12;Castellón/Castelló;083;Olocau del Rey;162;90;72
12;Castellón/Castelló;084;Onda;17975;8972;9003
12;Castellón/Castelló;085;Oropesa del Mar/Orpesa;2319;1182;1137
12;Castellón/Castelló;087;Palanques;24;15;9
12;Castellón/Castelló;088;Pavías;65;38;27
12;Castellón/Castelló;089;Peñíscola;3497;1737;1760
12;Castellón/Castelló;090;Pina de Montalgrao;207;114;93
12;Castellón/Castelló;093;Pobla de Benifassà (La);227;109;118
12;Castellón/Castelló;094;Pobla Tornesa (La);510;248;262
12;Castellón/Castelló;091;Portell de Morella;297;149;148
12;Castellón/Castelló;092;Puebla de Arenoso;203;102;101
12;Castellón/Castelló;095;Ribesalbes;1336;659;677
12;Castellón/Castelló;096;Rossell;1250;628;622
12;Castellón/Castelló;097;Sacañet;122;58;64
12;Castellón/Castelló;098;Salzadella (La);876;422;454
12;Castellón/Castelló;101;San Rafael del Río;494;249;245
12;Castellón/Castelló;902;Sant Joan de Moró;1590;811;779
12;Castellón/Castelló;099;Sant Jordi/San Jorge;562;271;291
12;Castellón/Castelló;100;Sant Mateu;1823;878;945
12;Castellón/Castelló;102;Santa Magdalena de Pulpis;749;384;365
12;Castellón/Castelló;103;Sarratella;114;64;50
12;Castellón/Castelló;104;Segorbe;7498;3662;3836
12;Castellón/Castelló;105;Sierra Engarcerán;1150;607;543
12;Castellón/Castelló;106;Soneja;1435;719;716
12;Castellón/Castelló;107;Sot de Ferrer;411;207;204
12;Castellón/Castelló;108;Sueras/Suera;590;296;294
12;Castellón/Castelló;109;Tales;785;382;403
12;Castellón/Castelló;110;Teresa;400;204;196
12;Castellón/Castelló;111;Tírig;635;309;326
12;Castellón/Castelló;112;Todolella;151;86;65
12;Castellón/Castelló;113;Toga;103;44;59
12;Castellón/Castelló;114;Torás;310;161;149
12;Castellón/Castelló;115;Toro (El);300;159;141
12;Castellón/Castelló;116;Torralba del Pinar;67;33;34
12;Castellón/Castelló;119;Torre d'En Besora (La);240;128;112
12;Castellón/Castelló;120;Torre Endoménech;288;142;146
12;Castellón/Castelló;117;Torreblanca;4613;2307;2306
12;Castellón/Castelló;118;Torrechiva;62;37;25
12;Castellón/Castelló;121;Traiguera;1646;840;806
12;Castellón/Castelló;122;Useras/Useres (Les);1154;583;571
12;Castellón/Castelló;124;Vall d'Alba;1900;955;945
12;Castellón/Castelló;125;Vall de Almonacid;271;133;138
12;Castellón/Castelló;126;Vall d'Uixó (La);27837;13846;13991
12;Castellón/Castelló;123;Vallat;35;16;19
12;Castellón/Castelló;127;Vallibona;92;45;47
12;Castellón/Castelló;128;Vilafamés;1424;735;689
12;Castellón/Castelló;132;Vilanova d'Alcolea;734;367;367
12;Castellón/Castelló;134;Vilar de Canes;202;99;103
12;Castellón/Castelló;129;Villafranca del Cid;2748;1302;1446
12;Castellón/Castelló;130;Villahermosa del Río;524;282;242
12;Castellón/Castelló;131;Villamalur;150;80;70
12;Castellón/Castelló;133;Villanueva de Viver;122;63;59
12;Castellón/Castelló;135;Villarreal/Vila-real;37927;18810;19117
12;Castellón/Castelló;136;Villavieja;3456;1699;1757
12;Castellón/Castelló;137;Villores;91;46;45
12;Castellón/Castelló;138;Vinaròs;20026;9773;10253
12;Castellón/Castelló;139;Vistabella del Maestrazgo;543;265;278
12;Castellón/Castelló;140;Viver;1196;602;594
12;Castellón/Castelló;141;Zorita del Maestrazgo;150;74;76
12;Castellón/Castelló;142;Zucaina;238;131;107
13;Ciudad Real;001;Abenójar;2016;1007;1009
13;Ciudad Real;002;Agudo;2219;1126;1093
13;Ciudad Real;003;Alamillo;742;378;364
13;Ciudad Real;004;Albaladejo;1921;943;978
13;Ciudad Real;005;Alcázar de San Juan;25996;12691;13305
13;Ciudad Real;006;Alcoba;842;428;414
13;Ciudad Real;007;Alcolea de Calatrava;1612;805;807
13;Ciudad Real;008;Alcubillas;784;384;400
13;Ciudad Real;009;Aldea del Rey;2370;1148;1222
13;Ciudad Real;010;Alhambra;1423;720;703
13;Ciudad Real;011;Almadén;8012;3901;4111
13;Ciudad Real;012;Almadenejos;683;361;322
13;Ciudad Real;013;Almagro;8356;4025;4331
13;Ciudad Real;014;Almedina;893;437;456
13;Ciudad Real;015;Almodóvar del Campo;7723;3844;3879
13;Ciudad Real;016;Almuradiel;852;406;446
13;Ciudad Real;017;Anchuras;500;262;238
13;Ciudad Real;903;Arenales de San Gregorio;"";"";""
13;Ciudad Real;018;Arenas de San Juan;1065;539;526
13;Ciudad Real;019;Argamasilla de Alba;6495;3198;3297
13;Ciudad Real;020;Argamasilla de Calatrava;5500;2753;2747
13;Ciudad Real;021;Arroba de los Montes;722;380;342
13;Ciudad Real;022;Ballesteros de Calatrava;643;319;324
13;Ciudad Real;023;Bolaños de Calatrava;10271;5118;5153
13;Ciudad Real;024;Brazatortas;1337;664;673
13;Ciudad Real;025;Cabezarados;415;213;202
13;Ciudad Real;026;Cabezarrubias del Puerto;782;400;382
13;Ciudad Real;027;Calzada de Calatrava;5068;2452;2616
13;Ciudad Real;028;Campo de Criptana;13727;6706;7021
13;Ciudad Real;029;Cañada de Calatrava;101;58;43
13;Ciudad Real;030;Caracuel de Calatrava;188;99;89
13;Ciudad Real;031;Carrión de Calatrava;2448;1188;1260
13;Ciudad Real;032;Carrizosa;1761;889;872
13;Ciudad Real;033;Castellar de Santiago;2359;1140;1219
13;Ciudad Real;038;Chillón;2587;1245;1342
13;Ciudad Real;034;Ciudad Real;57030;27097;29933
13;Ciudad Real;035;Corral de Calatrava;1381;692;689
13;Ciudad Real;036;Cortijos (Los);1078;529;549
13;Ciudad Real;037;Cózar;1492;722;770
13;Ciudad Real;039;Daimiel;16668;8094;8574
13;Ciudad Real;040;Fernán Caballero;1040;492;548
13;Ciudad Real;041;Fontanarejo;454;240;214
13;Ciudad Real;042;Fuencaliente;1375;742;633
13;Ciudad Real;043;Fuenllana;358;155;203
13;Ciudad Real;044;Fuente el Fresno;3546;1718;1828
13;Ciudad Real;045;Granátula de Calatrava;1065;511;554
13;Ciudad Real;046;Guadalmez;1116;571;545
13;Ciudad Real;047;Herencia;6894;3433;3461
13;Ciudad Real;048;Hinojosas de Calatrava;923;447;476
13;Ciudad Real;049;Horcajo de los Montes;1106;571;535
13;Ciudad Real;050;Labores (Las);695;338;357
13;Ciudad Real;904;Llanos del Caudillo;"";"";""
13;Ciudad Real;051;Luciana;501;256;245
13;Ciudad Real;052;Malagón;7888;3877;4011
13;Ciudad Real;053;Manzanares;17916;8729;9187
13;Ciudad Real;054;Membrilla;6706;3319;3387
13;Ciudad Real;055;Mestanza;1094;542;552
13;Ciudad Real;056;Miguelturra;7231;3557;3674
13;Ciudad Real;057;Montiel;1792;885;907
13;Ciudad Real;058;Moral de Calatrava;5201;2523;2678
13;Ciudad Real;059;Navalpino;360;179;181
13;Ciudad Real;060;Navas de Estena;456;243;213
13;Ciudad Real;061;Pedro Muñoz;7080;3516;3564
13;Ciudad Real;062;Picón;623;326;297
13;Ciudad Real;063;Piedrabuena;5213;2614;2599
13;Ciudad Real;064;Poblete;650;333;317
13;Ciudad Real;065;Porzuna;3868;1914;1954
13;Ciudad Real;066;Pozuelo de Calatrava;2355;1147;1208
13;Ciudad Real;067;Pozuelos de Calatrava (Los);646;327;319
13;Ciudad Real;068;Puebla de Don Rodrigo;1363;701;662
13;Ciudad Real;069;Puebla del Príncipe;1099;556;543
13;Ciudad Real;070;Puerto Lápice;1013;496;517
13;Ciudad Real;071;Puertollano;50910;24779;26131
13;Ciudad Real;072;Retuerta del Bullaque;1097;564;533
13;Ciudad Real;901;Robledo (El);1139;599;540
13;Ciudad Real;902;Ruidera;622;333;289
13;Ciudad Real;073;Saceruela;823;424;399
13;Ciudad Real;074;San Carlos del Valle;1298;652;646
13;Ciudad Real;075;San Lorenzo de Calatrava;382;196;186
13;Ciudad Real;076;Santa Cruz de los Cáñamos;673;334;339
13;Ciudad Real;077;Santa Cruz de Mudela;4894;2363;2531
13;Ciudad Real;078;Socuéllamos;11388;5561;5827
13;Ciudad Real;080;Solana del Pino;696;346;350
13;Ciudad Real;079;Solana (La);14160;7055;7105
13;Ciudad Real;081;Terrinches;1102;535;567
13;Ciudad Real;082;Tomelloso;28632;14048;14584
13;Ciudad Real;083;Torralba de Calatrava;3042;1480;1562
13;Ciudad Real;084;Torre de Juan Abad;1817;912;905
13;Ciudad Real;085;Torrenueva;3208;1600;1608
13;Ciudad Real;086;Valdemanco del Esteras;343;176;167
13;Ciudad Real;087;Valdepeñas;25530;12364;13166
13;Ciudad Real;088;Valenzuela de Calatrava;806;393;413
13;Ciudad Real;089;Villahermosa;2974;1388;1586
13;Ciudad Real;090;Villamanrique;1887;930;957
13;Ciudad Real;091;Villamayor de Calatrava;825;402;423
13;Ciudad Real;092;Villanueva de la Fuente;2990;1499;1491
13;Ciudad Real;093;Villanueva de los Infantes;6116;2923;3193
13;Ciudad Real;094;Villanueva de San Carlos;571;286;285
13;Ciudad Real;095;Villar del Pozo;104;54;50
13;Ciudad Real;096;Villarrubia de los Ojos;9461;4716;4745
13;Ciudad Real;097;Villarta de San Juan;2969;1483;1486
13;Ciudad Real;098;Viso del Marqués;3287;1610;1677
14;Córdoba;001;Adamuz;4528;2258;2270
14;Córdoba;002;Aguilar de la Frontera;13114;6512;6602
14;Córdoba;003;Alcaracejos;1509;757;752
14;Córdoba;004;Almedinilla;2591;1281;1310
14;Córdoba;005;Almodóvar del Río;7076;3544;3532
14;Córdoba;006;Añora;1651;808;843
14;Córdoba;007;Baena;20423;10040;10383
14;Córdoba;008;Belalcázar;4143;2005;2138
14;Córdoba;009;Belmez;4348;2070;2278
14;Córdoba;010;Benamejí;4540;2242;2298
14;Córdoba;011;Blázquez (Los);745;376;369
14;Córdoba;012;Bujalance;8487;4161;4326
14;Córdoba;013;Cabra;20306;9897;10409
14;Córdoba;015;Carcabuey;2945;1445;1500
14;Córdoba;016;Cardeña;2147;1061;1086
14;Córdoba;017;Carlota (La);8982;4487;4495
14;Córdoba;018;Carpio (El);4655;2296;2359
14;Córdoba;019;Castro del Río;7963;3888;4075
14;Córdoba;014;Cañete de las Torres;3457;1726;1731
14;Córdoba;020;Conquista;546;274;272
14;Córdoba;021;Córdoba;302154;145603;156551
14;Córdoba;023;Dos Torres;2518;1230;1288
14;Córdoba;022;Doña Mencía;5071;2502;2569
14;Córdoba;024;Encinas Reales;2291;1124;1167
14;Córdoba;025;Espejo;5074;2518;2556
14;Córdoba;026;Espiel;2625;1316;1309
14;Córdoba;027;Fernán-Núñez;9320;4636;4684
14;Córdoba;029;Fuente Obejuna;6322;3186;3136
14;Córdoba;030;Fuente Palmera;9371;4772;4599
14;Córdoba;028;Fuente la Lancha;490;241;249
14;Córdoba;031;Fuente-Tójar;903;442;461
14;Córdoba;032;Granjuela (La);534;277;257
14;Córdoba;033;Guadalcázar;1145;587;558
14;Córdoba;034;Guijo (El);447;230;217
14;Córdoba;035;Hinojosa del Duque;8141;3882;4259
14;Córdoba;036;Hornachuelos;5086;2619;2467
14;Córdoba;037;Iznájar;5752;2881;2871
14;Córdoba;038;Lucena;32173;15964;16209
14;Córdoba;039;Luque;3375;1651;1724
14;Córdoba;040;Montalbán de Córdoba;4500;2258;2242
14;Córdoba;041;Montemayor;3701;1858;1843
14;Córdoba;042;Montilla;22403;11080;11323
14;Córdoba;043;Montoro;9681;4757;4924
14;Córdoba;044;Monturque;2005;1022;983
14;Córdoba;045;Moriles;3660;1812;1848
14;Córdoba;046;Nueva Carteya;5735;2856;2879
14;Córdoba;047;Obejo;1467;723;744
14;Córdoba;048;Palenciana;1683;851;832
14;Córdoba;049;Palma del Río;18350;9131;9219
14;Córdoba;050;Pedro Abad;3001;1486;1515
14;Córdoba;051;Pedroche;1899;925;974
14;Córdoba;052;Peñarroya-Pueblonuevo;14035;6731;7304
14;Córdoba;053;Posadas;7099;3544;3555
14;Córdoba;054;Pozoblanco;15363;7352;8011
14;Córdoba;055;Priego de Córdoba;21177;10399;10778
14;Córdoba;056;Puente Genil;26387;12930;13457
14;Córdoba;057;Rambla (La);6865;3395;3470
14;Córdoba;058;Rute;10072;4885;5187
14;Córdoba;059;San Sebastián de los Ballesteros;827;426;401
14;Córdoba;061;Santa Eufemia;1259;639;620
14;Córdoba;060;Santaella;5728;2872;2856
14;Córdoba;062;Torrecampo;1571;761;810
14;Córdoba;063;Valenzuela;1567;738;829
14;Córdoba;064;Valsequillo;556;270;286
14;Córdoba;065;Victoria (La);1721;851;870
14;Córdoba;066;Villa del Río;7021;3543;3478
14;Córdoba;067;Villafranca de Córdoba;3594;1846;1748
14;Córdoba;068;Villaharta;656;320;336
14;Córdoba;069;Villanueva de Córdoba;10402;5057;5345
14;Córdoba;070;Villanueva del Duque;2063;949;1114
14;Córdoba;071;Villanueva del Rey;1317;688;629
14;Córdoba;072;Villaralto;1761;836;925
14;Córdoba;073;Villaviciosa de Córdoba;3981;2036;1945
14;Córdoba;074;Viso (El);3439;1671;1768
14;Córdoba;075;Zuheros;958;464;494
15;Coruña (A);001;Abegondo;5466;2713;2753
15;Coruña (A);002;Ames;10011;4833;5178
15;Coruña (A);003;Aranga;2506;1238;1268
15;Coruña (A);004;Ares;4511;2197;2314
15;Coruña (A);005;Arteixo;17931;9003;8928
15;Coruña (A);006;Arzúa;7016;3492;3524
15;Coruña (A);007;Baña (A);5864;2828;3036
15;Coruña (A);008;Bergondo;5392;2612;2780
15;Coruña (A);009;Betanzos;11930;5623;6307
15;Coruña (A);010;Boimorto;2999;1537;1462
15;Coruña (A);011;Boiro;17665;8652;9013
15;Coruña (A);012;Boqueixón;4230;2069;2161
15;Coruña (A);013;Brión;6375;3049;3326
15;Coruña (A);014;Cabana de Bergantiños;6291;3126;3165
15;Coruña (A);015;Cabanas;3074;1482;1592
15;Coruña (A);016;Camariñas;7410;3686;3724
15;Coruña (A);017;Cambre;12330;5973;6357
15;Coruña (A);018;Capela (A);1741;864;877
15;Coruña (A);019;Carballo;26033;12849;13184
15;Coruña (A);901;Cariño;5514;2710;2804
15;Coruña (A);020;Carnota;6795;3288;3507
15;Coruña (A);021;Carral;5229;2571;2658
15;Coruña (A);022;Cedeira;7673;3760;3913
15;Coruña (A);023;Cee;7109;3431;3678
15;Coruña (A);024;Cerceda;7015;3440;3575
15;Coruña (A);025;Cerdido;1908;918;990
15;Coruña (A);026;Cesuras;2977;1459;1518
15;Coruña (A);027;Coirós;1597;788;809
15;Coruña (A);028;Corcubión;2102;1015;1087
15;Coruña (A);029;Coristanco;9334;4675;4659
15;Coruña (A);030;A Coruña;246953;115929;131024
15;Coruña (A);031;Culleredo;14631;7140;7491
15;Coruña (A);032;Curtis;4660;2280;2380
15;Coruña (A);033;Dodro;3514;1702;1812
15;Coruña (A);034;Dumbría;5028;2445;2583
15;Coruña (A);035;Fene;14989;7333;7656
15;Coruña (A);036;Ferrol;83045;39052;43993
15;Coruña (A);037;Fisterra;5477;2756;2721
15;Coruña (A);038;Frades;3333;1693;1640
15;Coruña (A);039;Irixoa;1914;934;980
15;Coruña (A);041;Laracha (A);10521;5213;5308
15;Coruña (A);040;Laxe;3479;1725;1754
15;Coruña (A);042;Lousame;4667;2255;2412
15;Coruña (A);043;Malpica de Bergantiños;7950;3915;4035
15;Coruña (A);045;Mazaricos;7014;3394;3620
15;Coruña (A);044;Mañón;2242;1082;1160
15;Coruña (A);046;Melide;8304;4114;4190
15;Coruña (A);047;Mesía;3684;1852;1832
15;Coruña (A);048;Miño;5074;2412;2662
15;Coruña (A);049;Moeche;1763;847;916
15;Coruña (A);050;Monfero;3008;1536;1472
15;Coruña (A);051;Mugardos;6668;3216;3452
15;Coruña (A);053;Muros;11255;5403;5852
15;Coruña (A);052;Muxía;6725;3278;3447
15;Coruña (A);054;Narón;31594;15453;16141
15;Coruña (A);055;Neda;6456;3124;3332
15;Coruña (A);056;Negreira;6679;3147;3532
15;Coruña (A);057;Noia;14893;7202;7691
15;Coruña (A);058;Oleiros;18480;8925;9555
15;Coruña (A);059;Ordes;11704;5681;6023
15;Coruña (A);060;Oroso;3779;1842;1937
15;Coruña (A);061;Ortigueira;9925;4798;5127
15;Coruña (A);062;Outes;9273;4375;4898
15;Coruña (A);063;Oza dos Ríos;3338;1612;1726
15;Coruña (A);064;Paderne;2903;1381;1522
15;Coruña (A);065;Padrón;10019;4813;5206
15;Coruña (A);066;Pino (O);5281;2640;2641
15;Coruña (A);067;Pobra do Caramiñal (A);10390;4988;5402
15;Coruña (A);068;Ponteceso;8035;4035;4000
15;Coruña (A);069;Pontedeume;8817;4237;4580
15;Coruña (A);070;Pontes de García Rodríguez (As);13350;6732;6618
15;Coruña (A);071;Porto do Son;10709;5216;5493
15;Coruña (A);072;Rianxo;12744;6307;6437
15;Coruña (A);073;Ribeira;25285;12459;12826
15;Coruña (A);074;Rois;5643;2746;2897
15;Coruña (A);075;Sada;8935;4296;4639
15;Coruña (A);076;San Sadurniño;3781;1866;1915
15;Coruña (A);077;Santa Comba;11439;5567;5872
15;Coruña (A);078;Santiago de Compostela;87807;41319;46488
15;Coruña (A);079;Santiso;2480;1287;1193
15;Coruña (A);080;Sobrado;2894;1497;1397
15;Coruña (A);081;Somozas (As);1682;852;830
15;Coruña (A);082;Teo;12607;6124;6483
15;Coruña (A);083;Toques;1956;1014;942
15;Coruña (A);084;Tordoia;5847;2799;3048
15;Coruña (A);085;Touro;5029;2482;2547
15;Coruña (A);086;Trazo;4282;2127;2155
15;Coruña (A);088;Val do Dubra;5351;2631;2720
15;Coruña (A);087;Valdoviño;7008;3496;3512
15;Coruña (A);089;Vedra;5051;2428;2623
15;Coruña (A);091;Vilarmaior;1448;712;736
15;Coruña (A);090;Vilasantar;1896;970;926
15;Coruña (A);092;Vimianzo;9639;4766;4873
15;Coruña (A);093;Zas;6611;3238;3373
16;Cuenca;001;Abia de la Obispalía;118;67;51
16;Cuenca;002;Acebrón (El);315;156;159
16;Cuenca;003;Alarcón;227;115;112
16;Cuenca;004;Albaladejo del Cuende;465;249;216
16;Cuenca;005;Albalate de las Nogueras;427;231;196
16;Cuenca;006;Albendea;209;105;104
16;Cuenca;007;Alberca de Záncara (La);1875;928;947
16;Cuenca;008;Alcalá de la Vega;177;93;84
16;Cuenca;009;Alcantud;160;84;76
16;Cuenca;011;Alcohujate;72;37;35
16;Cuenca;012;Alconchel de la Estrella;244;121;123
16;Cuenca;010;Alcázar del Rey;283;145;138
16;Cuenca;013;Algarra;36;19;17
16;Cuenca;014;Aliaguilla;939;492;447
16;Cuenca;015;Almarcha (La);690;343;347
16;Cuenca;016;Almendros;417;203;214
16;Cuenca;017;Almodóvar del Pinar;593;304;289
16;Cuenca;018;Almonacid del Marquesado;597;307;290
16;Cuenca;019;Altarejos;402;203;199
16;Cuenca;020;Arandilla del Arroyo;57;27;30
16;Cuenca;905;Arcas del Villar;406;201;205
16;Cuenca;022;Arcos de la Sierra;135;73;62
16;Cuenca;024;Arguisuelas;213;110;103
16;Cuenca;025;Arrancacepas;40;21;19
16;Cuenca;026;Atalaya del Cañavate;141;66;75
16;Cuenca;027;Barajas de Melo;728;360;368
16;Cuenca;029;Barchín del Hoyo;152;83;69
16;Cuenca;030;Bascuñana de San Pedro;38;20;18
16;Cuenca;031;Beamud;103;56;47
16;Cuenca;032;Belinchón;325;161;164
16;Cuenca;033;Belmonte;2675;1230;1445
16;Cuenca;034;Belmontejo;292;147;145
16;Cuenca;035;Beteta;443;222;221
16;Cuenca;036;Boniches;205;101;104
16;Cuenca;038;Buciegas;104;52;52
16;Cuenca;039;Buenache de Alarcón;650;344;306
16;Cuenca;040;Buenache de la Sierra;111;66;45
16;Cuenca;041;Buendía;505;254;251
16;Cuenca;042;Campillo de Altobuey;1744;870;874
16;Cuenca;043;Campillos-Paravientos;161;84;77
16;Cuenca;044;Campillos-Sierra;90;48;42
16;Cuenca;901;Campos del Paraíso;1345;631;714
16;Cuenca;045;Canalejas del Arroyo;396;210;186
16;Cuenca;055;Carboneras de Guadazaón;1026;545;481
16;Cuenca;056;Cardenete;662;344;318
16;Cuenca;057;Carrascosa;143;77;66
16;Cuenca;058;Carrascosa de Haro;166;83;83
16;Cuenca;060;Casas de Benítez;1152;573;579
16;Cuenca;061;Casas de Fernando Alonso;1407;687;720
16;Cuenca;062;Casas de Garcimolina;42;18;24
16;Cuenca;063;Casas de Guijarro;187;95;92
16;Cuenca;064;Casas de Haro;898;445;453
16;Cuenca;065;Casas de los Pinos;584;285;299
16;Cuenca;066;Casasimarro;3011;1535;1476
16;Cuenca;067;Castejón;265;138;127
16;Cuenca;068;Castillejo de Iniesta;190;107;83
16;Cuenca;070;Castillejo-Sierra;66;30;36
16;Cuenca;072;Castillo de Garcimuñoz;316;162;154
16;Cuenca;071;Castillo-Albaráñez;35;18;17
16;Cuenca;047;Cañada Juncosa;414;214;200
16;Cuenca;046;Cañada del Hoyo;437;226;211
16;Cuenca;048;Cañamares;628;333;295
16;Cuenca;049;Cañavate (El);312;156;156
16;Cuenca;050;Cañaveras;444;228;216
16;Cuenca;051;Cañaveruelas;267;138;129
16;Cuenca;052;Cañete;802;398;404
16;Cuenca;053;Cañizares;652;337;315
16;Cuenca;073;Cervera del Llano;360;184;176
16;Cuenca;023;Chillarón de Cuenca;314;160;154
16;Cuenca;081;Chumillas;47;29;18
16;Cuenca;074;Cierva (La);60;33;27
16;Cuenca;078;Cuenca;42817;20620;22197
16;Cuenca;079;Cueva del Hierro;54;32;22
16;Cuenca;082;Enguídanos;652;338;314
16;Cuenca;083;Fresneda de Altarejos;90;52;38
16;Cuenca;084;Fresneda de la Sierra;90;43;47
16;Cuenca;085;Frontera (La);288;140;148
16;Cuenca;086;Fuente de Pedro Naharro;1247;623;624
16;Cuenca;087;Fuentelespino de Haro;418;225;193
16;Cuenca;088;Fuentelespino de Moya;152;74;78
16;Cuenca;904;Fuentenava de Jábaga;232;126;106
16;Cuenca;089;Fuentes;567;297;270
16;Cuenca;091;Fuertescusa;125;62;63
16;Cuenca;092;Gabaldón;201;110;91
16;Cuenca;093;Garaballa;178;94;84
16;Cuenca;094;Gascueña;206;98;108
16;Cuenca;095;Graja de Campalbo;145;81;64
16;Cuenca;096;Graja de Iniesta;348;185;163
16;Cuenca;097;Henarejos;367;177;190
16;Cuenca;098;Herrumblar (El);798;407;391
16;Cuenca;099;Hinojosa (La);398;202;196
16;Cuenca;100;Hinojosos (Los);1244;620;624
16;Cuenca;101;Hito (El);279;141;138
16;Cuenca;102;Honrubia;1696;844;852
16;Cuenca;103;Hontanaya;572;280;292
16;Cuenca;104;Hontecillas;112;51;61
16;Cuenca;106;Horcajo de Santiago;3640;1816;1824
16;Cuenca;108;Huelves;77;34;43
16;Cuenca;110;Huerta de la Obispalía;184;104;80
16;Cuenca;111;Huerta del Marquesado;183;97;86
16;Cuenca;112;Huete;2476;1261;1215
16;Cuenca;107;Huélamo;134;73;61
16;Cuenca;109;Huérguina;91;50;41
16;Cuenca;113;Iniesta;3632;1805;1827
16;Cuenca;115;Laguna del Marquesado;71;38;33
16;Cuenca;116;Lagunaseca;104;51;53
16;Cuenca;117;Landete;1660;826;834
16;Cuenca;118;Ledaña;2067;1032;1035
16;Cuenca;119;Leganiel;291;140;151
16;Cuenca;121;Majadas (Las);406;212;194
16;Cuenca;122;Mariana;303;147;156
16;Cuenca;123;Masegosa;142;72;70
16;Cuenca;124;Mesas (Las);2627;1335;1292
16;Cuenca;125;Minglanilla;2270;1140;1130
16;Cuenca;126;Mira;1181;600;581
16;Cuenca;128;Monreal del Llano;98;50;48
16;Cuenca;129;Montalbanejo;238;114;124
16;Cuenca;130;Montalbo;875;468;407
16;Cuenca;131;Monteagudo de las Salinas;132;72;60
16;Cuenca;132;Mota de Altarejos;75;44;31
16;Cuenca;133;Mota del Cuervo;5602;2774;2828
16;Cuenca;134;Motilla del Palancar;4863;2426;2437
16;Cuenca;135;Moya;316;168;148
16;Cuenca;137;Narboneta;99;52;47
16;Cuenca;139;Olivares de Júcar;677;342;335
16;Cuenca;140;Olmeda de la Cuesta;54;29;25
16;Cuenca;141;Olmeda del Rey;282;130;152
16;Cuenca;142;Olmedilla de Alarcón;254;131;123
16;Cuenca;143;Olmedilla de Eliz;36;20;16
16;Cuenca;145;Osa de la Vega;734;376;358
16;Cuenca;147;Pajaroncillo;98;51;47
16;Cuenca;146;Pajarón;155;82;73
16;Cuenca;148;Palomares del Campo;1087;532;555
16;Cuenca;149;Palomera;156;75;81
16;Cuenca;150;Paracuellos;186;89;97
16;Cuenca;151;Paredes;76;45;31
16;Cuenca;152;Parra de las Vegas (La);69;32;37
16;Cuenca;153;Pedernoso (El);1412;697;715
16;Cuenca;154;Pedroñeras (Las);6545;3313;3232
16;Cuenca;155;Peral (El);774;397;377
16;Cuenca;156;Peraleja (La);195;105;90
16;Cuenca;157;Pesquera (La);299;157;142
16;Cuenca;158;Picazo (El);728;355;373
16;Cuenca;159;Pinarejo;622;322;300
16;Cuenca;160;Pineda de Gigüela;207;109;98
16;Cuenca;161;Piqueras del Castillo;91;50;41
16;Cuenca;162;Portalrubio de Guadamejud;118;56;62
16;Cuenca;163;Portilla;109;56;53
16;Cuenca;165;Poyatos;128;71;57
16;Cuenca;166;Pozoamargo;356;169;187
16;Cuenca;908;Pozorrubielos de la Mancha;322;165;157
16;Cuenca;167;Pozorrubio;547;263;284
16;Cuenca;169;Pozuelo (El);114;57;57
16;Cuenca;170;Priego;1132;583;549
16;Cuenca;171;Provencio (El);2720;1352;1368
16;Cuenca;172;Puebla de Almenara;676;349;327
16;Cuenca;173;Puebla de Don Francisco;420;218;202
16;Cuenca;174;Puebla del Salvador;327;180;147
16;Cuenca;175;Quintanar del Rey;5809;2952;2857
16;Cuenca;176;Rada de Haro;66;33;33
16;Cuenca;177;Reíllo;159;76;83
16;Cuenca;181;Rozalén del Monte;162;76;86
16;Cuenca;185;Saceda-Trasierra;51;25;26
16;Cuenca;186;Saelices;829;420;409
16;Cuenca;187;Salinas del Manzano;149;81;68
16;Cuenca;188;Salmeroncillos;170;94;76
16;Cuenca;189;Salvacañete;361;197;164
16;Cuenca;190;San Clemente;6258;3096;3162
16;Cuenca;191;San Lorenzo de la Parrilla;1695;858;837
16;Cuenca;192;San Martín de Boniches;98;49;49
16;Cuenca;193;San Pedro Palmiches;127;68;59
16;Cuenca;194;Santa Cruz de Moya;427;226;201
16;Cuenca;196;Santa María de los Llanos;903;451;452
16;Cuenca;195;Santa María del Campo Rus;952;473;479
16;Cuenca;197;Santa María del Val;137;72;65
16;Cuenca;198;Sisante;1860;943;917
16;Cuenca;199;Solera de Gabaldón;42;25;17
16;Cuenca;909;Sotorribas;1010;511;499
16;Cuenca;202;Talayuelas;1251;649;602
16;Cuenca;203;Tarancón;10988;5423;5565
16;Cuenca;205;Tejadillos;216;105;111
16;Cuenca;206;Tinajas;425;230;195
16;Cuenca;209;Torralba;245;117;128
16;Cuenca;211;Torrejoncillo del Rey;829;404;425
16;Cuenca;212;Torrubia del Campo;380;172;208
16;Cuenca;213;Torrubia del Castillo;53;28;25
16;Cuenca;215;Tragacete;420;226;194
16;Cuenca;216;Tresjuncos;600;304;296
16;Cuenca;217;Tribaldos;159;79;80
16;Cuenca;204;Tébar;460;248;212
16;Cuenca;218;Uclés;305;144;161
16;Cuenca;219;Uña;166;86;80
16;Cuenca;906;Valdecolmenas (Los);169;85;84
16;Cuenca;224;Valdemeca;106;60;46
16;Cuenca;225;Valdemorillo de la Sierra;107;54;53
16;Cuenca;227;Valdemoro-Sierra;200;117;83
16;Cuenca;228;Valdeolivas;319;167;152
16;Cuenca;902;Valdetórtola;177;97;80
16;Cuenca;903;Valeras (Las);1428;712;716
16;Cuenca;231;Valhermoso de la Fuente;69;34;35
16;Cuenca;234;Valsalobre;77;38;39
16;Cuenca;236;Valverde de Júcar;1498;741;757
16;Cuenca;237;Valverdejo;163;84;79
16;Cuenca;238;Vara de Rey;809;399;410
16;Cuenca;239;Vega del Codorno;271;134;137
16;Cuenca;240;Vellisca;216;103;113
16;Cuenca;242;Villaconejos de Trabaque;580;293;287
16;Cuenca;243;Villaescusa de Haro;614;311;303
16;Cuenca;244;Villagarcía del Llano;1002;508;494
16;Cuenca;245;Villalba de la Sierra;538;269;269
16;Cuenca;246;Villalba del Rey;804;410;394
16;Cuenca;247;Villalgordo del Marquesado;187;91;96
16;Cuenca;248;Villalpardo;1132;573;559
16;Cuenca;249;Villamayor de Santiago;2918;1439;1479
16;Cuenca;250;Villanueva de Guadamejud;147;75;72
16;Cuenca;251;Villanueva de la Jara;2491;1246;1245
16;Cuenca;253;Villar de Cañas;513;258;255
16;Cuenca;254;Villar de Domingo García;299;156;143
16;Cuenca;263;Villar de Olalla;780;399;381
16;Cuenca;255;Villar de la Encina;268;134;134
16;Cuenca;258;Villar del Humo;500;254;246
16;Cuenca;259;Villar del Infantado;61;36;25
16;Cuenca;910;Villar y Velasco;172;93;79
16;Cuenca;264;Villarejo de Fuentes;915;446;469
16;Cuenca;265;Villarejo de la Peñuela;44;23;21
16;Cuenca;266;Villarejo-Periesteban;586;301;285
16;Cuenca;269;Villares del Saz;874;443;431
16;Cuenca;270;Villarrubio;265;128;137
16;Cuenca;271;Villarta;804;398;406
16;Cuenca;272;Villas de la Ventosa;447;242;205
16;Cuenca;273;Villaverde y Pasaconsol;435;221;214
16;Cuenca;275;Vindel;31;16;15
16;Cuenca;274;Víllora;277;133;144
16;Cuenca;276;Yémeda;40;18;22
16;Cuenca;277;Zafra de Záncara;281;143;138
16;Cuenca;278;Zafrilla;153;79;74
16;Cuenca;279;Zarza de Tajo;316;142;174
16;Cuenca;280;Zarzuela;342;163;179
17;Girona;001;Agullana;690;365;325
17;Girona;002;Aiguaviva;354;178;176
17;Girona;003;Albanyà;109;56;53
17;Girona;004;Albons;455;241;214
17;Girona;006;Alp;908;458;450
17;Girona;007;Amer;2302;1135;1167
17;Girona;008;Anglès;5137;2587;2550
17;Girona;009;Arbúcies;4550;2263;2287
17;Girona;010;Argelaguer;363;181;182
17;Girona;011;Armentera (L');743;358;385
17;Girona;012;Avinyonet de Puigventós;445;218;227
17;Girona;015;Banyoles;11938;5843;6095
17;Girona;016;Bàscara;775;398;377
17;Girona;013;Begur;2760;1390;1370
17;Girona;018;Bellcaire d'Empordà;485;243;242
17;Girona;019;Besalú;2098;1017;1081
17;Girona;020;Bescanó;2833;1419;1414
17;Girona;021;Beuda;130;67;63
17;Girona;022;Bisbal d'Empordà (La);7778;3841;3937
17;Girona;234;Biure;204;102;102
17;Girona;023;Blanes;25663;12938;12725
17;Girona;029;Boadella d'Empordà;209;105;104
17;Girona;024;Bolvir;226;109;117
17;Girona;025;Bordils;1330;657;673
17;Girona;026;Borrassà;476;237;239
17;Girona;027;Breda;3221;1675;1546
17;Girona;028;Brunyola;373;188;185
17;Girona;031;Cabanelles;232;123;109
17;Girona;030;Cabanes;782;408;374
17;Girona;032;Cadaqués;1810;889;921
17;Girona;033;Caldes de Malavella;3106;1513;1593
17;Girona;034;Calonge;5030;2489;2541
17;Girona;035;Camós;611;309;302
17;Girona;036;Campdevànol;3388;1659;1729
17;Girona;037;Campelles;138;72;66
17;Girona;038;Campllong;262;135;127
17;Girona;039;Camprodon;2218;1096;1122
17;Girona;040;Canet d'Adri;467;243;224
17;Girona;041;Cantallops;263;126;137
17;Girona;042;Capmany;404;207;197
17;Girona;044;Cassà de la Selva;7165;3541;3624
17;Girona;046;Castellfollit de la Roca;1029;497;532
17;Girona;047;Castelló d'Empúries;3637;1815;1822
17;Girona;048;Castell-Platja d'Aro;4823;2454;2369
17;Girona;189;Cellera de Ter (La);2069;1004;1065
17;Girona;049;Celrà;2358;1165;1193
17;Girona;050;Cervià de Ter;637;312;325
17;Girona;051;Cistella;205;102;103
17;Girona;054;Colera;441;226;215
17;Girona;055;Colomers;198;96;102
17;Girona;057;Corçà;1083;540;543
17;Girona;056;Cornellà del Terri;1800;907;893
17;Girona;058;Crespià;231;117;114
17;Girona;901;Cruïlles, Monells i Sant Sadurní de l'Heura;1054;528;526
17;Girona;060;Darnius;500;266;234
17;Girona;061;Das;142;75;67
17;Girona;062;Escala (L');5178;2557;2621
17;Girona;063;Espinelves;191;100;91
17;Girona;064;Espolla;390;198;192
17;Girona;065;Esponellà;383;191;192
17;Girona;005;Far d'Empordà (El);396;197;199
17;Girona;066;Figueres;34573;16895;17678
17;Girona;067;Flaçà;914;456;458
17;Girona;068;Foixà;301;147;154
17;Girona;069;Fontanals de Cerdanya;296;149;147
17;Girona;070;Fontanilles;117;65;52
17;Girona;071;Fontcoberta;923;474;449
17;Girona;902;Forallac;1492;744;748
17;Girona;073;Fornells de la Selva;1152;558;594
17;Girona;074;Fortià;502;246;256
17;Girona;075;Garrigàs;305;161;144
17;Girona;076;Garrigoles;151;84;67
17;Girona;077;Garriguella;643;324;319
17;Girona;078;Ger;270;139;131
17;Girona;079;Girona;68656;32994;35662
17;Girona;080;Gombrèn;239;116;123
17;Girona;081;Gualta;267;127;140
17;Girona;082;Guils de Cerdanya;278;145;133
17;Girona;083;Hostalric;2899;1446;1453
17;Girona;084;Isòvol;175;85;90
17;Girona;085;Jafre;351;175;176
17;Girona;086;Jonquera (La);2502;1273;1229
17;Girona;087;Juià;283;140;143
17;Girona;088;Lladó;484;242;242
17;Girona;089;Llagostera;5354;2696;2658
17;Girona;090;Llambilles;429;210;219
17;Girona;091;Llanars;389;200;189
17;Girona;092;Llançà;3495;1754;1741
17;Girona;093;Llers;790;414;376
17;Girona;094;Llívia;854;438;416
17;Girona;095;Lloret de Mar;15018;7535;7483
17;Girona;096;Llosses (Les);362;198;164
17;Girona;102;Maçanet de Cabrenys;690;349;341
17;Girona;103;Maçanet de la Selva;2954;1480;1474
17;Girona;097;Madremanya;179;81;98
17;Girona;098;Maià de Montcal;325;157;168
17;Girona;100;Masarac;258;126;132
17;Girona;101;Massanes;477;249;228
17;Girona;099;Meranges;64;34;30
17;Girona;105;Mieres;339;170;169
17;Girona;106;Mollet de Peralada;180;98;82
17;Girona;107;Molló;373;193;180
17;Girona;109;Montagut i Oix;774;400;374
17;Girona;110;Mont-ras;1371;719;652
17;Girona;111;Navata;661;320;341
17;Girona;112;Ogassa;256;147;109
17;Girona;114;Olot;26713;12810;13903
17;Girona;115;Ordis;304;168;136
17;Girona;116;Osor;494;252;242
17;Girona;117;Palafrugell;17417;8906;8511
17;Girona;118;Palamós;13338;6587;6751
17;Girona;119;Palau de Santa Eulàlia;81;43;38
17;Girona;121;Palau-sator;296;150;146
17;Girona;120;Palau-saverdera;686;341;345
17;Girona;122;Palmerola;"";"";""
17;Girona;123;Palol de Revardit;378;185;193
17;Girona;124;Pals;1676;862;814
17;Girona;125;Pardines;122;65;57
17;Girona;126;Parlavà;335;181;154
17;Girona;128;Pau;364;166;198
17;Girona;129;Pedret i Marzà;124;57;67
17;Girona;130;Pera (La);381;199;182
17;Girona;132;Peralada;1136;579;557
17;Girona;133;Planes d'Hostoles (Les);1803;886;917
17;Girona;134;Planoles;246;130;116
17;Girona;135;Pont de Molins;260;136;124
17;Girona;136;Pontós;193;111;82
17;Girona;137;Porqueres;3073;1529;1544
17;Girona;140;Port de la Selva (El);761;365;396
17;Girona;138;Portbou;1913;943;970
17;Girona;139;Preses (Les);1300;637;663
17;Girona;141;Puigcerdà;6329;3191;3138
17;Girona;142;Quart;2083;1067;1016
17;Girona;043;Queralbs;199;110;89
17;Girona;143;Rabós;138;63;75
17;Girona;144;Regencós;263;150;113
17;Girona;145;Ribes de Freser;2330;1114;1216
17;Girona;146;Riells i Viabrea;998;507;491
17;Girona;147;Ripoll;11334;5536;5798
17;Girona;148;Riudarenes;1108;557;551
17;Girona;149;Riudaura;364;175;189
17;Girona;150;Riudellots de la Selva;1308;663;645
17;Girona;151;Riumors;201;95;106
17;Girona;152;Roses;10303;5305;4998
17;Girona;153;Rupià;199;99;100
17;Girona;154;Sales de Llierca;54;31;23
17;Girona;155;Salt;21807;10906;10901
17;Girona;157;Sant Andreu Salou;137;75;62
17;Girona;183;Sant Aniol de Finestres;237;120;117
17;Girona;158;Sant Climent Sescebes;440;244;196
17;Girona;159;Sant Feliu de Buixalleu;592;318;274
17;Girona;160;Sant Feliu de Guíxols;16051;7817;8234
17;Girona;161;Sant Feliu de Pallerols;1087;527;560
17;Girona;162;Sant Ferriol;201;109;92
17;Girona;163;Sant Gregori;1867;968;899
17;Girona;164;Sant Hilari Sacalm;4704;2396;2308
17;Girona;165;Sant Jaume de Llierca;757;390;367
17;Girona;167;Sant Joan de les Abadesses;3896;1890;2006
17;Girona;168;Sant Joan de Mollet;312;151;161
17;Girona;185;Sant Joan les Fonts;2821;1400;1421
17;Girona;166;Sant Jordi Desvalls;602;300;302
17;Girona;169;Sant Julià de Ramis;1731;862;869
17;Girona;903;Sant Julià del Llor i Bonmatí;887;432;455
17;Girona;171;Sant Llorenç de la Muga;156;75;81
17;Girona;172;Sant Martí de Llémena;313;168;145
17;Girona;173;Sant Martí Vell;204;111;93
17;Girona;174;Sant Miquel de Campmajor;217;123;94
17;Girona;175;Sant Miquel de Fluvià;549;285;264
17;Girona;176;Sant Mori;146;68;78
17;Girona;177;Sant Pau de Segúries;647;323;324
17;Girona;178;Sant Pere Pescador;1199;598;601
17;Girona;180;Santa Coloma de Farners;8239;4208;4031
17;Girona;181;Santa Cristina d'Aro;1859;982;877
17;Girona;182;Santa Llogaia d'Àlguema;316;"";147
17;Girona;184;Santa Pau;1391;712;679
17;Girona;186;Sarrià de Ter;3237;1604;1633
17;Girona;187;Saus;705;357;348
17;Girona;188;Selva de Mar (La);167;88;79
17;Girona;190;Serinyà;763;386;377
17;Girona;191;Serra de Daró;184;95;89
17;Girona;192;Setcases;150;81;69
17;Girona;193;Sils;2356;1189;1167
17;Girona;052;Siurana;151;67;84
17;Girona;194;Susqueda;98;51;47
17;Girona;195;Tallada d'Empordà (La);331;166;165
17;Girona;196;Terrades;184;85;99
17;Girona;197;Torrent;182;91;91
17;Girona;198;Torroella de Fluvià;297;163;134
17;Girona;199;Torroella de Montgrí;7023;3561;3462
17;Girona;200;Tortellà;692;347;345
17;Girona;201;Toses;148;88;60
17;Girona;202;Tossa de Mar;3439;1726;1713
17;Girona;204;Ullà;707;351;356
17;Girona;205;Ullastret;259;134;125
17;Girona;203;Ultramort;201;100;101
17;Girona;206;Urús;124;61;63
17;Girona;014;Vajol (La);69;36;33
17;Girona;208;Vall de Bianya (La);1051;522;529
17;Girona;207;Vall d'en Bas (La);2531;1289;1242
17;Girona;170;Vallfogona de Ripollès;252;132;120
17;Girona;209;Vall-llobrega;209;111;98
17;Girona;210;Ventalló;521;266;255
17;Girona;211;Verges;1127;547;580
17;Girona;212;Vidrà;171;90;81
17;Girona;213;Vidreres;3783;1912;1871
17;Girona;214;Vilabertran;794;399;395
17;Girona;215;Vilablareix;1020;504;516
17;Girona;217;Viladamat;381;199;182
17;Girona;216;Viladasens;189;98;91
17;Girona;218;Vilademuls;755;374;381
17;Girona;220;Viladrau;883;448;435
17;Girona;221;Vilafant;2914;1445;1469
17;Girona;223;Vilajuïga;598;290;308
17;Girona;224;Vilallonga de Ter;429;221;208
17;Girona;225;Vilamacolum;215;111;104
17;Girona;226;Vilamalla;622;321;301
17;Girona;227;Vilamaniscle;126;61;65
17;Girona;228;Vilanant;251;128;123
17;Girona;230;Vila-sacra;414;201;213
17;Girona;222;Vilaür;104;50;54
17;Girona;233;Vilobí d'Onyar;2083;1094;989
17;Girona;232;Vilopriu;176;90;86
18;Granada;001;Agrón;445;223;222
18;Granada;002;Alamedilla;1045;516;529
18;Granada;003;Albolote;10184;5103;5081
18;Granada;004;Albondón;1358;678;680
18;Granada;005;Albuñán;491;246;245
18;Granada;006;Albuñol;5336;2626;2710
18;Granada;007;Albuñuelas;1367;691;676
18;Granada;010;Aldeire;790;393;397
18;Granada;011;Alfacar;3576;1806;1770
18;Granada;012;Algarinejo;5276;2706;2570
18;Granada;013;Alhama de Granada;6023;3026;2997
18;Granada;014;Alhendín;3674;1847;1827
18;Granada;015;Alicún de Ortega;795;399;396
18;Granada;016;Almegíjar;460;233;227
18;Granada;017;Almuñécar;20408;10150;10258
18;Granada;904;Alpujarra de la Sierra;1320;672;648
18;Granada;018;Alquife;1150;552;598
18;Granada;020;Arenas del Rey;2065;1072;993
18;Granada;021;Armilla;10921;5396;5525
18;Granada;022;Atarfe;10008;4941;5067
18;Granada;023;Baza;20519;10024;10495
18;Granada;024;Beas de Granada;894;459;435
18;Granada;025;Beas de Guadix;416;220;196
18;Granada;027;Benalúa;3441;1726;1715
18;Granada;028;Benalúa de las Villas;1392;695;697
18;Granada;029;Benamaurel;2496;1276;1220
18;Granada;030;Bérchules;881;450;431
18;Granada;032;Bubión;345;167;178
18;Granada;033;Busquístar;457;239;218
18;Granada;034;Cacín;882;455;427
18;Granada;035;Cádiar;2057;1034;1023
18;Granada;036;Cájar;2222;1035;1187
18;Granada;114;Calahorra (La);995;467;528
18;Granada;037;Calicasas;598;293;305
18;Granada;038;Campotéjar;1450;713;737
18;Granada;039;Caniles;5181;2522;2659
18;Granada;040;Cáñar;346;168;178
18;Granada;042;Capileira;577;282;295
18;Granada;043;Carataunas;215;113;102
18;Granada;044;Cástaras;340;175;165
18;Granada;045;Castilléjar;2248;1144;1104
18;Granada;046;Castril;3247;1681;1566
18;Granada;047;Cenes de la Vega;2385;1208;1177
18;Granada;059;Chauchina;3720;1845;1875
18;Granada;061;Chimeneas;1528;767;761
18;Granada;062;Churriana de la Vega;5536;2757;2779
18;Granada;048;Cijuela;1295;624;671
18;Granada;049;Cogollos de Guadix;774;410;364
18;Granada;050;Cogollos de la Vega;1939;974;965
18;Granada;051;Colomera;1865;947;918
18;Granada;053;Cortes de Baza;3039;1553;1486
18;Granada;054;Cortes y Graena;1005;523;482
18;Granada;912;Cuevas del Campo;2303;1135;1168
18;Granada;056;Cúllar;5457;2697;2760
18;Granada;057;Cúllar Vega;1732;866;866
18;Granada;063;Darro;1575;766;809
18;Granada;064;Dehesas de Guadix;663;334;329
18;Granada;066;Deifontes;2385;1205;1180
18;Granada;067;Diezma;1065;556;509
18;Granada;068;Dílar;1431;713;718
18;Granada;069;Dólar;731;363;368
18;Granada;070;Dúdar;252;128;124
18;Granada;071;Dúrcal;5804;2901;2903
18;Granada;072;Escúzar;968;496;472
18;Granada;074;Ferreira;424;202;222
18;Granada;076;Fonelas;1405;700;705
18;Granada;078;Freila;1282;648;634
18;Granada;079;Fuente Vaqueros;3826;1900;1926
18;Granada;905;Gabias (Las);6062;3011;3051
18;Granada;082;Galera;1660;817;843
18;Granada;083;Gobernador;413;202;211
18;Granada;084;Gójar;2353;1194;1159
18;Granada;085;Gor;1302;652;650
18;Granada;086;Gorafe;626;321;305
18;Granada;087;Granada;255212;120325;134887
18;Granada;088;Guadahortuna;2400;1222;1178
18;Granada;089;Guadix;20033;9903;10130
18;Granada;906;Guajares (Los);1525;779;746
18;Granada;093;Gualchos;2984;1511;1473
18;Granada;094;Güejar Sierra;2610;1328;1282
18;Granada;095;Güevéjar;1255;616;639
18;Granada;096;Huélago;675;347;328
18;Granada;097;Huéneja;1410;698;712
18;Granada;098;Huéscar;10031;5019;5012
18;Granada;099;Huétor de Santillán;1527;791;736
18;Granada;100;Huétor Tájar;7502;3746;3756
18;Granada;101;Huétor Vega;6505;3252;3253
18;Granada;102;Illora;10389;5216;5173
18;Granada;103;Itrabo;1109;559;550
18;Granada;105;Iznalloz;6534;3318;3216
18;Granada;107;Jayena;1498;781;717
18;Granada;108;Jerez del Marquesado;1217;607;610
18;Granada;109;Jete;728;353;375
18;Granada;111;Jun;1047;519;528
18;Granada;112;Juviles;213;104;109
18;Granada;115;Láchar;2258;1141;1117
18;Granada;116;Lanjarón;3972;1978;1994
18;Granada;117;Lanteira;715;363;352
18;Granada;119;Lecrín;2391;1172;1219
18;Granada;120;Lentegí;383;184;199
18;Granada;121;Lobras;222;114;108
18;Granada;122;Loja;20768;10339;10429
18;Granada;123;Lugros;486;269;217
18;Granada;124;Lújar;623;334;289
18;Granada;126;Malahá (La);1619;826;793
18;Granada;127;Maracena;12956;6438;6518
18;Granada;128;Marchal;465;223;242
18;Granada;132;Moclín;4744;2358;2386
18;Granada;133;Molvízar;2478;1236;1242
18;Granada;134;Monachil;4218;2136;2082
18;Granada;135;Montefrío;8183;4141;4042
18;Granada;136;Montejícar;3012;1552;1460
18;Granada;137;Montillana;1361;691;670
18;Granada;138;Moraleda de Zafayona;2573;1324;1249
18;Granada;909;Morelábor;1053;519;534
18;Granada;140;Motril;46500;22963;23537
18;Granada;141;Murtas;1164;598;566
18;Granada;903;Nevada;1515;764;751
18;Granada;143;Nigüelas;1191;606;585
18;Granada;144;Nívar;563;292;271
18;Granada;145;Ogíjares;5097;2568;2529
18;Granada;146;Orce;1536;781;755
18;Granada;147;Órgiva;5100;2568;2532
18;Granada;148;Otívar;1161;585;576
18;Granada;149;Otura;2615;1312;1303
18;Granada;150;Padul;6133;3054;3079
18;Granada;151;Pampaneira;326;172;154
18;Granada;152;Pedro Martínez;1574;800;774
18;Granada;153;Peligros;6269;3135;3134
18;Granada;154;Peza (La);1579;811;768
18;Granada;910;Pinar (El);1296;645;651
18;Granada;157;Pinos Genil;1085;566;519
18;Granada;158;Pinos Puente;13132;6548;6584
18;Granada;159;Píñar;1505;772;733
18;Granada;161;Polícar;258;135;123
18;Granada;162;Polopos;1210;643;567
18;Granada;163;Pórtugos;457;234;223
18;Granada;164;Puebla de Don Fadrique;2597;1298;1299
18;Granada;165;Pulianas;2549;1278;1271
18;Granada;167;Purullena;2514;1242;1272
18;Granada;168;Quéntar;1060;527;533
18;Granada;170;Rubite;436;232;204
18;Granada;171;Salar;2799;1385;1414
18;Granada;173;Salobreña;9474;4710;4764
18;Granada;174;Santa Cruz del Comercio;596;317;279
18;Granada;175;Santa Fe;12000;5863;6137
18;Granada;176;Soportújar;266;143;123
18;Granada;177;Sorvilán;952;471;481
18;Granada;901;Taha (La);956;483;473
18;Granada;178;Torre-Cardela;1220;604;616
18;Granada;179;Torvizcón;1172;589;583
18;Granada;180;Trevélez;823;445;378
18;Granada;181;Turón;458;259;199
18;Granada;182;Ugíjar;3014;1469;1545
18;Granada;907;Valle del Zalabí;2473;1227;1246
18;Granada;902;Valle (El);1533;755;778
18;Granada;183;Válor;1126;567;559
18;Granada;911;Vegas del Genil;2607;1307;1300
18;Granada;184;Vélez de Benaudalla;2478;1222;1256
18;Granada;185;Ventas de Huelma;680;335;345
18;Granada;908;Villamena;972;464;508
18;Granada;187;Villanueva de las Torres;1073;558;515
18;Granada;188;Villanueva Mesía;1911;965;946
18;Granada;189;Víznar;781;406;375
18;Granada;192;Zafarraya;2205;1111;1094
18;Granada;913;Zagra;1212;596;616
18;Granada;193;Zubia (La);8746;4312;4434
18;Granada;194;Zújar;2986;1500;1486
19;Guadalajara;001;Abánades;128;74;54
19;Guadalajara;002;Ablanque;163;87;76
19;Guadalajara;003;Adobes;43;20;23
19;Guadalajara;004;Alaminos;101;47;54
19;Guadalajara;005;Alarilla;117;62;55
19;Guadalajara;006;Albalate de Zorita;1008;523;485
19;Guadalajara;007;Albares;527;266;261
19;Guadalajara;008;Albendiego;63;33;30
19;Guadalajara;009;Alcocer;316;153;163
19;Guadalajara;010;Alcolea de las Peñas;43;25;18
19;Guadalajara;011;Alcolea del Pinar;478;237;241
19;Guadalajara;013;Alcoroches;198;102;96
19;Guadalajara;015;Aldeanueva de Guadalajara;109;54;55
19;Guadalajara;016;Algar de Mesa;90;48;42
19;Guadalajara;017;Algora;115;64;51
19;Guadalajara;018;Alhóndiga;272;154;118
19;Guadalajara;019;Alique;39;9;30
19;Guadalajara;020;Almadrones;112;70;42
19;Guadalajara;021;Almoguera;782;398;384
19;Guadalajara;022;Almonacid de Zorita;1012;513;499
19;Guadalajara;023;Alocén;138;71;67
19;Guadalajara;024;Alovera;1336;668;668
19;Guadalajara;027;Alustante;305;167;138
19;Guadalajara;031;Angón;37;22;15
19;Guadalajara;032;Anguita;334;164;170
19;Guadalajara;033;Anquela del Ducado;80;40;40
19;Guadalajara;034;Anquela del Pedregal;21;13;8
19;Guadalajara;036;Aranzueque;360;182;178
19;Guadalajara;037;Arbancón;216;120;96
19;Guadalajara;038;Arbeteta;51;28;23
19;Guadalajara;039;Argecilla;134;75;59
19;Guadalajara;040;Armallones;60;36;24
19;Guadalajara;041;Armuña de Tajuña;98;51;47
19;Guadalajara;042;Arroyo de las Fraguas;19;12;7
19;Guadalajara;043;Atanzón;113;63;50
19;Guadalajara;044;Atienza;497;255;242
19;Guadalajara;045;Auñón;283;144;139
19;Guadalajara;046;Azuqueca de Henares;11624;5877;5747
19;Guadalajara;047;Baides;83;45;38
19;Guadalajara;048;Baños de Tajo;34;21;13
19;Guadalajara;049;Bañuelos;39;20;19
19;Guadalajara;050;Barriopedro;26;10;16
19;Guadalajara;051;Berninches;142;78;64
19;Guadalajara;052;Bodera (La);59;34;25
19;Guadalajara;053;Brihuega;3035;1585;1450
19;Guadalajara;054;Budia;335;185;150
19;Guadalajara;055;Bujalaro;110;62;48
19;Guadalajara;057;Bustares;131;72;59
19;Guadalajara;058;Cabanillas del Campo;1068;570;498
19;Guadalajara;059;Campillo de Dueñas;165;89;76
19;Guadalajara;060;Campillo de Ranas;120;54;66
19;Guadalajara;061;Campisábalos;58;27;31
19;Guadalajara;064;Canredondo;143;74;69
19;Guadalajara;065;Cantalojas;154;86;68
19;Guadalajara;066;Cañizar;124;62;62
19;Guadalajara;067;Cardoso de la Sierra (El);126;77;49
19;Guadalajara;070;Casa de Uceda;126;62;64
19;Guadalajara;071;Casar (El);1368;706;662
19;Guadalajara;073;Casas de San Galindo;35;21;14
19;Guadalajara;074;Caspueñas;47;25;22
19;Guadalajara;075;Castejón de Henares;124;67;57
19;Guadalajara;076;Castellar de la Muela;63;35;28
19;Guadalajara;078;Castilforte;59;32;27
19;Guadalajara;079;Castilnuevo;12;4;8
19;Guadalajara;080;Cendejas de Enmedio;143;71;72
19;Guadalajara;081;Cendejas de la Torre;127;70;57
19;Guadalajara;082;Centenera;74;39;35
19;Guadalajara;103;Checa;460;238;222
19;Guadalajara;104;Chequilla;24;11;13
19;Guadalajara;106;Chillarón del Rey;141;76;65
19;Guadalajara;105;Chiloeches;1066;560;506
19;Guadalajara;086;Cifuentes;2353;1198;1155
19;Guadalajara;087;Cincovillas;40;19;21
19;Guadalajara;088;Ciruelas;55;32;23
19;Guadalajara;089;Ciruelos del Pinar;74;39;35
19;Guadalajara;090;Cobeta;154;77;77
19;Guadalajara;091;Cogollor;64;36;28
19;Guadalajara;092;Cogolludo;611;334;277
19;Guadalajara;095;Condemios de Abajo;33;19;14
19;Guadalajara;096;Condemios de Arriba;187;94;93
19;Guadalajara;097;Congostrina;55;27;28
19;Guadalajara;098;Copernal;33;18;15
19;Guadalajara;099;Corduente;500;268;232
19;Guadalajara;102;Cubillo de Uceda (El);150;75;75
19;Guadalajara;107;Driebes;370;210;160
19;Guadalajara;108;Durón;117;56;61
19;Guadalajara;109;Embid;78;45;33
19;Guadalajara;110;Escamilla;125;64;61
19;Guadalajara;111;Escariche;243;125;118
19;Guadalajara;112;Escopete;56;19;37
19;Guadalajara;113;Espinosa de Henares;517;249;268
19;Guadalajara;114;Esplegares;98;56;42
19;Guadalajara;115;Establés;54;25;29
19;Guadalajara;116;Estriégana;34;18;16
19;Guadalajara;117;Fontanar;762;394;368
19;Guadalajara;118;Fuembellida;18;9;9
19;Guadalajara;119;Fuencemillán;125;67;58
19;Guadalajara;120;Fuentelahiguera de Albatages;209;110;99
19;Guadalajara;121;Fuentelencina;193;105;88
19;Guadalajara;122;Fuentelsaz;158;75;83
19;Guadalajara;123;Fuentelviejo;76;39;37
19;Guadalajara;124;Fuentenovilla;219;125;94
19;Guadalajara;125;Gajanejos;112;62;50
19;Guadalajara;126;Galápagos;199;103;96
19;Guadalajara;127;Galve de Sorbe;153;78;75
19;Guadalajara;129;Gascueña de Bornova;39;20;19
19;Guadalajara;130;Guadalajara;63649;31480;32169
19;Guadalajara;132;Henche;30;20;10
19;Guadalajara;133;Heras de Ayuso;116;60;56
19;Guadalajara;134;Herrería;41;19;22
19;Guadalajara;135;Hiendelaencina;159;87;72
19;Guadalajara;136;Hijes;27;15;12
19;Guadalajara;138;Hita;274;150;124
19;Guadalajara;139;Hombrados;60;32;28
19;Guadalajara;142;Hontoba;142;68;74
19;Guadalajara;143;Horche;1071;549;522
19;Guadalajara;145;Hortezuela de Océn;103;55;48
19;Guadalajara;146;Huerce (La);22;12;10
19;Guadalajara;147;Huérmeces del Cerro;60;35;25
19;Guadalajara;148;Huertahernando;87;48;39
19;Guadalajara;150;Hueva;148;75;73
19;Guadalajara;151;Humanes;1193;624;569
19;Guadalajara;152;Illana;658;338;320
19;Guadalajara;153;Iniéstola;27;15;12
19;Guadalajara;154;Inviernas (Las);110;62;48
19;Guadalajara;155;Irueste;70;33;37
19;Guadalajara;156;Jadraque;1202;611;591
19;Guadalajara;157;Jirueque;62;36;26
19;Guadalajara;159;Ledanca;188;91;97
19;Guadalajara;160;Loranca de Tajuña;278;145;133
19;Guadalajara;161;Lupiana;258;140;118
19;Guadalajara;162;Luzaga;113;54;59
19;Guadalajara;163;Luzón;97;50;47
19;Guadalajara;165;Majaelrayo;60;30;30
19;Guadalajara;166;Málaga del Fresno;241;128;113
19;Guadalajara;167;Malaguilla;189;108;81
19;Guadalajara;168;Mandayona;505;238;267
19;Guadalajara;169;Mantiel;69;31;38
19;Guadalajara;170;Maranchón;225;125;100
19;Guadalajara;171;Marchamalo;"";"";""
19;Guadalajara;172;Masegoso de Tajuña;119;57;62
19;Guadalajara;173;Matarrubia;55;31;24
19;Guadalajara;174;Matillas;274;139;135
19;Guadalajara;175;Mazarete;95;48;47
19;Guadalajara;176;Mazuecos;438;227;211
19;Guadalajara;177;Medranda;148;77;71
19;Guadalajara;178;Megina;90;41;49
19;Guadalajara;179;Membrillera;102;53;49
19;Guadalajara;181;Miedes de Atienza;144;73;71
19;Guadalajara;182;Mierla (La);38;23;15
19;Guadalajara;184;Millana;107;50;57
19;Guadalajara;183;Milmarcos;100;54;46
19;Guadalajara;185;Miñosa (La);53;30;23
19;Guadalajara;186;Mirabueno;120;67;53
19;Guadalajara;187;Miralrío;114;63;51
19;Guadalajara;188;Mochales;154;77;77
19;Guadalajara;189;Mohernando;138;77;61
19;Guadalajara;190;Molina de Aragón;3628;1842;1786
19;Guadalajara;191;Monasterio;19;9;10
19;Guadalajara;192;Mondéjar;2095;1032;1063
19;Guadalajara;193;Montarrón;73;41;32
19;Guadalajara;194;Moratilla de los Meleros;129;71;58
19;Guadalajara;195;Morenilla;58;36;22
19;Guadalajara;196;Muduex;134;69;65
19;Guadalajara;197;Navas de Jadraque (Las);26;17;9
19;Guadalajara;198;Negredo;24;10;14
19;Guadalajara;199;Ocentejo;44;20;24
19;Guadalajara;200;Olivar (El);73;39;34
19;Guadalajara;201;Olmeda de Cobeta;91;36;55
19;Guadalajara;202;Olmeda de Jadraque (La);5;4;1
19;Guadalajara;203;Ordial (El);43;20;23
19;Guadalajara;204;Orea;320;169;151
19;Guadalajara;208;Pálmaces de Jadraque;77;41;36
19;Guadalajara;209;Pardos;66;33;33
19;Guadalajara;210;Paredes de Sigüenza;86;44;42
19;Guadalajara;211;Pareja;466;225;241
19;Guadalajara;212;Pastrana;1100;558;542
19;Guadalajara;213;Pedregal (El);114;59;55
19;Guadalajara;214;Peñalén;175;88;87
19;Guadalajara;215;Peñalver;306;175;131
19;Guadalajara;216;Peralejos de las Truchas;185;98;87
19;Guadalajara;217;Peralveche;70;38;32
19;Guadalajara;218;Pinilla de Jadraque;93;49;44
19;Guadalajara;219;Pinilla de Molina;25;15;10
19;Guadalajara;220;Pioz;190;103;87
19;Guadalajara;221;Piqueras;48;27;21
19;Guadalajara;222;Pobo de Dueñas (El);184;102;82
19;Guadalajara;223;Poveda de la Sierra;190;98;92
19;Guadalajara;224;Pozo de Almoguera;230;114;116
19;Guadalajara;225;Pozo de Guadalajara;336;184;152
19;Guadalajara;226;Prádena de Atienza;51;31;20
19;Guadalajara;227;Prados Redondos;100;56;44
19;Guadalajara;228;Puebla de Beleña;33;22;11
19;Guadalajara;229;Puebla de Valles;80;43;37
19;Guadalajara;230;Quer;110;53;57
19;Guadalajara;231;Rebollosa de Jadraque;40;23;17
19;Guadalajara;232;Recuenco (El);134;70;64
19;Guadalajara;233;Renera;70;33;37
19;Guadalajara;234;Retiendas;45;19;26
19;Guadalajara;235;Riba de Saelices;165;93;72
19;Guadalajara;237;Rillo de Gallo;76;42;34
19;Guadalajara;238;Riofrío del Llano;98;52;46
19;Guadalajara;239;Robledillo de Mohernando;164;88;76
19;Guadalajara;240;Robledo de Corpes;86;43;43
19;Guadalajara;241;Romanillos de Atienza;75;46;29
19;Guadalajara;242;Romanones;163;91;72
19;Guadalajara;243;Rueda de la Sierra;85;44;41
19;Guadalajara;244;Sacecorbo;165;87;78
19;Guadalajara;245;Sacedón;1633;833;800
19;Guadalajara;246;Saelices de la Sal;77;42;35
19;Guadalajara;247;Salmerón;271;142;129
19;Guadalajara;248;San Andrés del Congosto;65;38;27
19;Guadalajara;249;San Andrés del Rey;48;19;29
19;Guadalajara;250;Santiuste;24;10;14
19;Guadalajara;251;Saúca;68;33;35
19;Guadalajara;252;Sayatón;235;115;120
19;Guadalajara;254;Selas;76;38;38
19;Guadalajara;901;Semillas;31;17;14
19;Guadalajara;255;Setiles;231;125;106
19;Guadalajara;256;Sienes;108;64;44
19;Guadalajara;257;Sigüenza;4775;2368;2407
19;Guadalajara;258;Solanillos del Extremo;103;53;50
19;Guadalajara;259;Somolinos;44;20;24
19;Guadalajara;260;Sotillo (El);63;39;24
19;Guadalajara;261;Sotodosos;77;37;40
19;Guadalajara;262;Tamajón;187;96;91
19;Guadalajara;263;Taragudo;36;19;17
19;Guadalajara;264;Taravilla;79;42;37
19;Guadalajara;265;Tartanedo;244;123;121
19;Guadalajara;266;Tendilla;426;232;194
19;Guadalajara;267;Terzaga;49;29;20
19;Guadalajara;268;Tierzo;47;25;22
19;Guadalajara;269;Toba (La);113;62;51
19;Guadalajara;271;Tordellego;105;56;49
19;Guadalajara;270;Tordelrábano;17;8;9
19;Guadalajara;272;Tordesilos;176;92;84
19;Guadalajara;274;Torija;365;176;189
19;Guadalajara;279;Torre del Burgo;58;31;27
19;Guadalajara;276;Torrecilla del Ducado;"";"";""
19;Guadalajara;277;Torrecuadrada de Molina;25;15;10
19;Guadalajara;278;Torrecuadradilla;81;47;34
19;Guadalajara;280;Torrejón del Rey;437;236;201
19;Guadalajara;281;Torremocha de Jadraque;18;12;6
19;Guadalajara;282;Torremocha del Campo;409;224;185
19;Guadalajara;283;Torremocha del Pinar;85;39;46
19;Guadalajara;284;Torremochuela;10;5;5
19;Guadalajara;285;Torrubia;50;26;24
19;Guadalajara;286;Tórtola de Henares;411;205;206
19;Guadalajara;287;Tortuera;274;140;134
19;Guadalajara;288;Tortuero;38;22;16
19;Guadalajara;289;Traíd;66;35;31
19;Guadalajara;290;Trijueque;331;177;154
19;Guadalajara;291;Trillo;1378;707;671
19;Guadalajara;293;Uceda;490;246;244
19;Guadalajara;294;Ujados;48;27;21
19;Guadalajara;296;Utande;75;45;30
19;Guadalajara;297;Valdarachas;26;11;15
19;Guadalajara;298;Valdearenas;61;33;28
19;Guadalajara;299;Valdeavellano;96;51;45
19;Guadalajara;300;Valdeaveruelo;158;86;72
19;Guadalajara;301;Valdeconcha;33;16;17
19;Guadalajara;302;Valdegrudas;66;34;32
19;Guadalajara;303;Valdelcubo;65;38;27
19;Guadalajara;304;Valdenuño Fernández;139;74;65
19;Guadalajara;305;Valdepeñas de la Sierra;258;143;115
19;Guadalajara;306;Valderrebollo;52;25;27
19;Guadalajara;307;Valdesotos;43;16;27
19;Guadalajara;308;Valfermoso de Tajuña;70;40;30
19;Guadalajara;309;Valhermoso;52;28;24
19;Guadalajara;310;Valtablado del Río;19;12;7
19;Guadalajara;311;Valverde de los Arroyos;90;46;44
19;Guadalajara;314;Viana de Jadraque;59;32;27
19;Guadalajara;317;Villanueva de Alcorón;336;180;156
19;Guadalajara;318;Villanueva de Argecilla;54;31;23
19;Guadalajara;319;Villanueva de la Torre;114;56;58
19;Guadalajara;321;Villares de Jadraque;52;28;24
19;Guadalajara;322;Villaseca de Henares;62;34;28
19;Guadalajara;323;Villaseca de Uceda;65;33;32
19;Guadalajara;324;Villel de Mesa;280;132;148
19;Guadalajara;325;Viñuelas;125;67;58
19;Guadalajara;326;Yebes;71;41;30
19;Guadalajara;327;Yebra;596;297;299
19;Guadalajara;329;Yélamos de Abajo;106;49;57
19;Guadalajara;330;Yélamos de Arriba;132;70;62
19;Guadalajara;331;Yunquera de Henares;1923;976;947
19;Guadalajara;332;Yunta (La);193;93;100
19;Guadalajara;333;Zaorejas;233;125;108
19;Guadalajara;334;Zarzuela de Jadraque;31;20;11
19;Guadalajara;335;Zorita de los Canes;103;57;46
20;Guipúzcoa;001;Abaltzisketa;284;154;130
20;Guipúzcoa;002;Aduna;296;156;140
20;Guipúzcoa;016;Aia;1681;967;714
20;Guipúzcoa;003;Aizarnazabal;531;292;239
20;Guipúzcoa;004;Albiztur;303;160;143
20;Guipúzcoa;005;Alegia;1680;880;800
20;Guipúzcoa;006;Alkiza;264;151;113
20;Guipúzcoa;906;Altzaga;94;50;44
20;Guipúzcoa;007;Altzo;333;187;146
20;Guipúzcoa;008;Amezketa;1040;566;474
20;Guipúzcoa;009;Andoain;15265;7618;7647
20;Guipúzcoa;010;Anoeta;1801;904;897
20;Guipúzcoa;011;Antzuola;2062;1067;995
20;Guipúzcoa;012;Arama;143;69;74
20;Guipúzcoa;013;Aretxabaleta;6147;3132;3015
20;Guipúzcoa;055;Arrasate/Mondragón;25532;12785;12747
20;Guipúzcoa;014;Asteasu;1205;645;560
20;Guipúzcoa;903;Astigarraga;3216;1583;1633
20;Guipúzcoa;015;Ataun;1739;898;841
20;Guipúzcoa;017;Azkoitia;10512;5255;5257
20;Guipúzcoa;018;Azpeitia;13427;6787;6640
20;Guipúzcoa;904;Baliarrain;99;51;48
20;Guipúzcoa;019;Beasain;12322;6211;6111
20;Guipúzcoa;020;Beizama;175;99;76
20;Guipúzcoa;021;Belauntza;295;160;135
20;Guipúzcoa;022;Berastegi;969;544;425
20;Guipúzcoa;074;Bergara;15567;7749;7818
20;Guipúzcoa;023;Berrobi;603;334;269
20;Guipúzcoa;024;Bidegoyan;441;251;190
20;Guipúzcoa;029;Deba;5012;2563;2449
20;Guipúzcoa;069;Donostia/San Sebastián;171439;80322;91117
20;Guipúzcoa;030;Eibar;32362;15916;16446
20;Guipúzcoa;031;Elduain;233;123;110
20;Guipúzcoa;033;Elgeta;1007;509;498
20;Guipúzcoa;032;Elgoibar;11693;5887;5806
20;Guipúzcoa;067;Errenteria;41646;20644;21002
20;Guipúzcoa;066;Errezil;677;374;303
20;Guipúzcoa;034;Eskoriatza;3860;1996;1864
20;Guipúzcoa;035;Ezkio-Itsaso;545;278;267
20;Guipúzcoa;038;Gabiria;432;241;191
20;Guipúzcoa;037;Gaintza;123;72;51
20;Guipúzcoa;907;Gaztelu;"";"";""
20;Guipúzcoa;039;Getaria;2349;1182;1167
20;Guipúzcoa;040;Hernani;18489;9188;9301
20;Guipúzcoa;041;Hernialde;287;153;134
20;Guipúzcoa;036;Hondarribia;13524;6727;6797
20;Guipúzcoa;042;Ibarra;4463;2307;2156
20;Guipúzcoa;043;Idiazabal;2057;1039;1018
20;Guipúzcoa;044;Ikaztegieta;370;194;176
20;Guipúzcoa;045;Irún;53276;26110;27166
20;Guipúzcoa;046;Irura;632;313;319
20;Guipúzcoa;047;Itsasondo;640;323;317
20;Guipúzcoa;048;Larraul;143;86;57
20;Guipúzcoa;902;Lasarte-Oria;18131;9080;9051
20;Guipúzcoa;049;Lazkao;5037;2576;2461
20;Guipúzcoa;050;Leaburu;567;320;247
20;Guipúzcoa;051;Legazpi;9892;5114;4778
20;Guipúzcoa;052;Legorreta;1522;772;750
20;Guipúzcoa;068;Leintz-Gatzaga;239;135;104
20;Guipúzcoa;053;Lezo;5281;2596;2685
20;Guipúzcoa;054;Lizartza;697;371;326
20;Guipúzcoa;901;Mendaro;1453;740;713
20;Guipúzcoa;057;Mutiloa;184;91;93
20;Guipúzcoa;056;Mutriku;4578;2280;2298
20;Guipúzcoa;063;Oiartzun;8413;4186;4227
20;Guipúzcoa;058;Olaberria;1123;580;543
20;Guipúzcoa;076;Ordizia;9325;4553;4772
20;Guipúzcoa;905;Orendain;170;101;69
20;Guipúzcoa;060;Orexa;78;41;37
20;Guipúzcoa;061;Orio;4258;2157;2101
20;Guipúzcoa;062;Ormaiztegi;1235;618;617
20;Guipúzcoa;059;Oñati;10695;5365;5330
20;Guipúzcoa;064;Pasaia;18314;8953;9361
20;Guipúzcoa;070;Segura;1297;657;640
20;Guipúzcoa;065;Soraluze/Placencia de las Armas;4838;2411;2427
20;Guipúzcoa;071;Tolosa;18150;8698;9452
20;Guipúzcoa;072;Urnieta;4399;2246;2153
20;Guipúzcoa;077;Urretxu;6066;3097;2969
20;Guipúzcoa;073;Usurbil;5333;2736;2597
20;Guipúzcoa;075;Villabona;5360;2711;2649
20;Guipúzcoa;078;Zaldibia;1582;833;749
20;Guipúzcoa;079;Zarautz;18007;8915;9092
20;Guipúzcoa;025;Zegama;1399;712;687
20;Guipúzcoa;026;Zerain;227;109;118
20;Guipúzcoa;027;Zestoa;3383;1786;1597
20;Guipúzcoa;028;Zizurkil;2711;1381;1330
20;Guipúzcoa;081;Zumaia;8162;4086;4076
20;Guipúzcoa;080;Zumarraga;11097;5593;5504
21;Huelva;001;Alájar;836;424;412
21;Huelva;002;Aljaraque;6753;3382;3371
21;Huelva;003;Almendro (El);844;435;409
21;Huelva;004;Almonaster la Real;2109;1038;1071
21;Huelva;005;Almonte;16164;8121;8043
21;Huelva;006;Alosno;4777;2317;2460
21;Huelva;007;Aracena;6503;3167;3336
21;Huelva;008;Aroche;3593;1755;1838
21;Huelva;009;Arroyomolinos de León;1242;623;619
21;Huelva;010;Ayamonte;15082;7378;7704
21;Huelva;011;Beas;4072;2022;2050
21;Huelva;012;Berrocal;422;216;206
21;Huelva;013;Bollullos Par del Condado;12575;6232;6343
21;Huelva;014;Bonares;4949;2485;2464
21;Huelva;015;Cabezas Rubias;969;497;472
21;Huelva;016;Cala;1484;761;723
21;Huelva;017;Calañas;5093;2502;2591
21;Huelva;018;Campillo (El);2651;1286;1365
21;Huelva;019;Campofrío;908;459;449
21;Huelva;020;Cañaveral de León;586;283;303
21;Huelva;021;Cartaya;10357;5110;5247
21;Huelva;022;Castaño del Robledo;195;95;100
21;Huelva;023;Cerro de Andévalo (El);2864;1410;1454
21;Huelva;030;Chucena;1924;992;932
21;Huelva;024;Corteconcepción;702;353;349
21;Huelva;025;Cortegana;5243;2560;2683
21;Huelva;026;Cortelazor;314;155;159
21;Huelva;027;Cumbres de Enmedio;58;30;28
21;Huelva;028;Cumbres de San Bartolomé;668;335;333
21;Huelva;029;Cumbres Mayores;2230;1077;1153
21;Huelva;031;Encinasola;2068;1028;1040
21;Huelva;032;Escacena del Campo;2220;1095;1125
21;Huelva;033;Fuenteheridos;650;329;321
21;Huelva;034;Galaroza;1603;770;833
21;Huelva;035;Gibraleón;10018;5042;4976
21;Huelva;036;Granada de Río-Tinto (La);229;119;110
21;Huelva;037;Granado (El);696;367;329
21;Huelva;038;Higuera de la Sierra;1330;656;674
21;Huelva;039;Hinojales;463;231;232
21;Huelva;040;Hinojos;3445;1739;1706
21;Huelva;041;Huelva;142547;69112;73435
21;Huelva;042;Isla Cristina;16524;8175;8349
21;Huelva;043;Jabugo;2510;1238;1272
21;Huelva;044;Lepe;16565;8385;8180
21;Huelva;045;Linares de la Sierra;283;134;149
21;Huelva;046;Lucena del Puerto;2054;1038;1016
21;Huelva;047;Manzanilla;2562;1266;1296
21;Huelva;048;Marines (Los);352;176;176
21;Huelva;049;Minas de Riotinto;5480;2616;2864
21;Huelva;050;Moguer;11905;5998;5907
21;Huelva;051;Nava (La);350;175;175
21;Huelva;052;Nerva;6962;3389;3573
21;Huelva;053;Niebla;3822;1933;1889
21;Huelva;054;Palma del Condado (La);9429;4653;4776
21;Huelva;055;Palos de la Frontera;6750;3402;3348
21;Huelva;056;Paterna del Campo;3848;1969;1879
21;Huelva;057;Paymogo;1399;670;729
21;Huelva;058;Puebla de Guzmán;3202;1602;1600
21;Huelva;059;Puerto Moral;236;111;125
21;Huelva;060;Punta Umbría;10031;5062;4969
21;Huelva;061;Rociana del Condado;6121;3107;3014
21;Huelva;062;Rosal de la Frontera;1946;923;1023
21;Huelva;063;San Bartolomé de la Torre;2877;1453;1424
21;Huelva;064;San Juan del Puerto;5732;2880;2852
21;Huelva;066;San Silvestre de Guzmán;699;339;360
21;Huelva;065;Sanlúcar de Guadiana;409;201;208
21;Huelva;067;Santa Ana la Real;505;235;270
21;Huelva;068;Santa Bárbara de Casa;1444;719;725
21;Huelva;069;Santa Olalla del Cala;2342;1197;1145
21;Huelva;070;Trigueros;7044;3533;3511
21;Huelva;071;Valdelarco;297;143;154
21;Huelva;072;Valverde del Camino;12341;5944;6397
21;Huelva;073;Villablanca;2029;1051;978
21;Huelva;074;Villalba del Alcor;3674;1820;1854
21;Huelva;075;Villanueva de las Cruces;431;213;218
21;Huelva;076;Villanueva de los Castillejos;2613;1272;1341
21;Huelva;077;Villarrasa;2182;1114;1068
21;Huelva;078;Zalamea la Real;3768;1845;1923
21;Huelva;079;Zufre;1322;679;643
22;Huesca;001;Abiego;320;162;158
22;Huesca;002;Abizanda;129;71;58
22;Huesca;003;Adahuesca;174;89;85
22;Huesca;004;Agüero;168;87;81
22;Huesca;907;Aínsa-Sobrarbe;1427;765;662
22;Huesca;006;Aisa;321;173;148
22;Huesca;007;Albalate de Cinca;1149;597;552
22;Huesca;008;Albalatillo;279;140;139
22;Huesca;009;Albelda;1023;530;493
22;Huesca;011;Albero Alto;109;59;50
22;Huesca;012;Albero Bajo;123;67;56
22;Huesca;013;Alberuela de Tubo;439;229;210
22;Huesca;014;Alcalá de Gurrea;404;202;202
22;Huesca;015;Alcalá del Obispo;344;169;175
22;Huesca;016;Alcampell;1075;537;538
22;Huesca;017;Alcolea de Cinca;1240;626;614
22;Huesca;018;Alcubierre;514;263;251
22;Huesca;019;Alerre;155;79;76
22;Huesca;020;Alfántega;138;70;68
22;Huesca;021;Almudévar;2435;1274;1161
22;Huesca;022;Almunia de San Juan;778;389;389
22;Huesca;023;Almuniente;674;345;329
22;Huesca;024;Alquézar;263;130;133
22;Huesca;025;Altorricón;1529;807;722
22;Huesca;027;Angüés;521;283;238
22;Huesca;028;Ansó;479;240;239
22;Huesca;029;Antillón;175;87;88
22;Huesca;032;Aragüés del Puerto;123;74;49
22;Huesca;035;Arén;439;243;196
22;Huesca;036;Argavieso;117;67;50
22;Huesca;037;Arguis;58;33;25
22;Huesca;039;Ayerbe;1209;620;589
22;Huesca;040;Azanuy-Alins;239;113;126
22;Huesca;041;Azara;228;119;109
22;Huesca;042;Azlor;189;99;90
22;Huesca;043;Baélls;171;87;84
22;Huesca;044;Bailo;336;197;139
22;Huesca;045;Baldellou;170;87;83
22;Huesca;046;Ballobar;1148;575;573
22;Huesca;047;Banastás;110;53;57
22;Huesca;048;Barbastro;14778;7255;7523
22;Huesca;049;Barbués;130;65;65
22;Huesca;050;Barbuñales;123;62;61
22;Huesca;051;Bárcabo;120;67;53
22;Huesca;052;Belver de Cinca;1527;796;731
22;Huesca;053;Benabarre;1233;648;585
22;Huesca;054;Benasque;1081;545;536
22;Huesca;055;Berbegal;520;258;262
22;Huesca;057;Bielsa;439;230;209
22;Huesca;058;Bierge;198;111;87
22;Huesca;059;Biescas;1171;604;567
22;Huesca;060;Binaced;1639;840;799
22;Huesca;061;Binéfar;8001;4030;3971
22;Huesca;062;Bisaurri;229;138;91
22;Huesca;063;Biscarrués;267;142;125
22;Huesca;064;Blecua y Torres;202;103;99
22;Huesca;066;Boltaña;851;426;425
22;Huesca;067;Bonansa;70;37;33
22;Huesca;068;Borau;73;38;35
22;Huesca;069;Broto;468;239;229
22;Huesca;072;Caldearenas;283;147;136
22;Huesca;074;Campo;375;189;186
22;Huesca;075;Camporrélls;269;122;147
22;Huesca;076;Canal de Berdún;459;239;220
22;Huesca;077;Candasnos;634;322;312
22;Huesca;078;Canfranc;486;259;227
22;Huesca;079;Capdesaso;198;95;103
22;Huesca;080;Capella;456;240;216
22;Huesca;081;Casbas de Huesca;366;184;182
22;Huesca;083;Castejón de Monegros;785;388;397
22;Huesca;084;Castejón de Sos;449;234;215
22;Huesca;082;Castejón del Puente;416;206;210
22;Huesca;085;Castelflorite;170;87;83
22;Huesca;086;Castiello de Jaca;139;65;74
22;Huesca;087;Castigaleu;97;54;43
22;Huesca;088;Castillazuelo;247;124;123
22;Huesca;089;Castillonroy;445;219;226
22;Huesca;094;Chalamera;166;89;77
22;Huesca;095;Chía;127;76;51
22;Huesca;096;Chimillas;148;81;67
22;Huesca;090;Colungo;142;78;64
22;Huesca;099;Esplús;912;438;474
22;Huesca;102;Estada;193;97;96
22;Huesca;103;Estadilla;1003;505;498
22;Huesca;105;Estopiñán del Castillo;184;93;91
22;Huesca;106;Fago;44;28;16
22;Huesca;107;Fanlo;50;33;17
22;Huesca;109;Fiscal;256;136;120
22;Huesca;110;Fonz;1252;631;621
22;Huesca;111;Foradada del Toscar;272;134;138
22;Huesca;112;Fraga;11491;5773;5718
22;Huesca;113;Fueva (La);659;357;302
22;Huesca;114;Gistaín;210;118;92
22;Huesca;115;Grado (El);590;310;280
22;Huesca;116;Grañén;2162;1089;1073
22;Huesca;117;Graus;3315;1686;1629
22;Huesca;119;Gurrea de Gállego;1998;993;1005
22;Huesca;122;Hoz de Jaca;86;35;51
22;Huesca;908;Hoz y Costean;268;141;127
22;Huesca;124;Huerto;316;166;150
22;Huesca;125;Huesca;44165;21479;22686
22;Huesca;126;Ibieca;114;61;53
22;Huesca;127;Igriés;150;84;66
22;Huesca;128;Ilche;323;165;158
22;Huesca;129;Isábena;279;148;131
22;Huesca;130;Jaca;10840;5325;5515
22;Huesca;131;Jasa;112;61;51
22;Huesca;133;Labuerda;172;91;81
22;Huesca;135;Laluenga;285;149;136
22;Huesca;136;Lalueza;1389;747;642
22;Huesca;137;Lanaja;1771;923;848
22;Huesca;139;Laperdiguera;110;58;52
22;Huesca;141;Lascellas-Ponzano;188;89;99
22;Huesca;142;Lascuarre;173;88;85
22;Huesca;143;Laspaúles;318;181;137
22;Huesca;144;Laspuña;291;156;135
22;Huesca;149;Loarre;413;221;192
22;Huesca;150;Loporzano;545;268;277
22;Huesca;151;Loscorrales;132;72;60
22;Huesca;905;Lupiñén-Ortilla;404;216;188
22;Huesca;155;Monesma y Cajigar;109;53;56
22;Huesca;156;Monflorite-Lascasas;185;102;83
22;Huesca;157;Montanuy;327;184;143
22;Huesca;158;Monzón;14690;7400;7290
22;Huesca;160;Naval;303;150;153
22;Huesca;162;Novales;195;97;98
22;Huesca;163;Nueno;212;111;101
22;Huesca;164;Olvena;56;27;29
22;Huesca;165;Ontiñena;750;383;367
22;Huesca;167;Osso de Cinca;740;380;360
22;Huesca;168;Palo;33;19;14
22;Huesca;170;Panticosa;589;303;286
22;Huesca;172;Peñalba;797;393;404
22;Huesca;173;Peñas de Riglos (Las);283;153;130
22;Huesca;174;Peralta de Alcofea;760;377;383
22;Huesca;175;Peralta de Calasanz;349;184;165
22;Huesca;176;Peraltilla;175;94;81
22;Huesca;177;Perarrúa;157;76;81
22;Huesca;178;Pertusa;159;77;82
22;Huesca;181;Piracés;107;63;44
22;Huesca;182;Plan;301;164;137
22;Huesca;184;Poleñino;261;129;132
22;Huesca;186;Pozán de Vero;268;133;135
22;Huesca;187;Puebla de Castro (La);298;155;143
22;Huesca;188;Puente de Montañana;135;69;66
22;Huesca;902;Puente la Reina de Jaca;295;149;146
22;Huesca;189;Puértolas;205;116;89
22;Huesca;190;Pueyo de Araguás (El);173;106;67
22;Huesca;193;Pueyo de Santa Cruz;397;209;188
22;Huesca;195;Quicena;160;78;82
22;Huesca;197;Robres;715;364;351
22;Huesca;199;Sabiñánigo;9056;4638;4418
22;Huesca;200;Sahún;315;169;146
22;Huesca;201;Salas Altas;417;215;202
22;Huesca;202;Salas Bajas;202;98;104
22;Huesca;203;Salillas;126;69;57
22;Huesca;204;Sallent de Gállego;886;451;435
22;Huesca;205;San Esteban de Litera;689;336;353
22;Huesca;207;San Juan de Plan;170;97;73
22;Huesca;903;San Miguel del Cinca;982;513;469
22;Huesca;206;Sangarrén;307;148;159
22;Huesca;208;Santa Cilia;158;85;73
22;Huesca;209;Santa Cruz de la Serós;138;78;60
22;Huesca;906;Santa María de Dulcis;225;106;119
22;Huesca;212;Santaliestra y San Quílez;105;54;51
22;Huesca;213;Sariñena;4227;2139;2088
22;Huesca;214;Secastilla;190;87;103
22;Huesca;215;Seira;218;107;111
22;Huesca;217;Sena;671;342;329
22;Huesca;218;Senés de Alcubierre;63;30;33
22;Huesca;220;Sesa;297;151;146
22;Huesca;221;Sesué;75;44;31
22;Huesca;222;Siétamo;335;184;151
22;Huesca;223;Sopeira;144;77;67
22;Huesca;904;Sotonera (La);1262;653;609
22;Huesca;225;Tamarite de Litera;4091;2026;2065
22;Huesca;226;Tardienta;1211;619;592
22;Huesca;227;Tella-Sin;321;170;151
22;Huesca;228;Tierz;195;102;93
22;Huesca;229;Tolva;257;140;117
22;Huesca;230;Torla;363;194;169
22;Huesca;232;Torralba de Aragón;150;72;78
22;Huesca;233;Torre la Ribera;115;66;49
22;Huesca;234;Torrente de Cinca;1174;595;579
22;Huesca;235;Torres de Alcanadre;141;86;55
22;Huesca;236;Torres de Barbués;428;225;203
22;Huesca;239;Tramaced;131;76;55
22;Huesca;242;Valfarta;116;59;57
22;Huesca;243;Valle de Bardají;56;28;28
22;Huesca;901;Valle de Hecho;1055;560;495
22;Huesca;244;Valle de Lierp;61;31;30
22;Huesca;245;Velilla de Cinca;523;259;264
22;Huesca;909;Vencillón;514;274;240
22;Huesca;246;Veracruz;121;71;50
22;Huesca;247;Viacamp y Litera;41;27;14
22;Huesca;248;Vicién;111;58;53
22;Huesca;249;Villanova;94;45;49
22;Huesca;250;Villanúa;283;142;141
22;Huesca;251;Villanueva de Sigena;500;263;237
22;Huesca;252;Yebra de Basa;173;100;73
22;Huesca;253;Yésero;53;23;30
22;Huesca;254;Zaidín;1756;890;866
23;Jaén;001;Albanchez de Mágina;1664;827;837
23;Jaén;002;Alcalá la Real;21090;10495;10595
23;Jaén;003;Alcaudete;11460;5688;5772
23;Jaén;004;Aldeaquemada;576;293;283
23;Jaén;005;Andújar;36661;18147;18514
23;Jaén;006;Arjona;5492;2760;2732
23;Jaén;007;Arjonilla;3960;1980;1980
23;Jaén;008;Arquillos;1703;864;839
23;Jaén;009;Baeza;15064;7407;7657
23;Jaén;010;Bailén;16865;8517;8348
23;Jaén;011;Baños de la Encina;2740;1381;1359
23;Jaén;012;Beas de Segura;8261;4143;4118
23;Jaén;902;Bedmar y Garcíez;3480;1753;1727
23;Jaén;014;Begíjar;3091;1539;1552
23;Jaén;015;Bélmez de la Moraleda;2031;1005;1026
23;Jaén;016;Benatae;608;307;301
23;Jaén;017;Cabra del Santo Cristo;2311;1180;1131
23;Jaén;018;Cambil;3536;1847;1689
23;Jaén;019;Campillo de Arenas;2279;1145;1134
23;Jaén;020;Canena;2063;997;1066
23;Jaén;021;Carboneros;715;349;366
23;Jaén;901;Cárcheles;1622;794;828
23;Jaén;024;Carolina (La);15071;7407;7664
23;Jaén;025;Castellar;3675;1848;1827
23;Jaén;026;Castillo de Locubín;5722;2817;2905
23;Jaén;027;Cazalilla;883;452;431
23;Jaén;028;Cazorla;9046;4435;4611
23;Jaén;029;Chiclana de Segura;1687;863;824
23;Jaén;030;Chilluévar;1956;973;983
23;Jaén;031;Escañuela;1033;524;509
23;Jaén;032;Espelúy;809;387;422
23;Jaén;033;Frailes;1896;958;938
23;Jaén;034;Fuensanta de Martos;3406;1655;1751
23;Jaén;035;Fuerte del Rey;1179;588;591
23;Jaén;037;Génave;812;409;403
23;Jaén;038;Guardia de Jaén (La);1794;926;868
23;Jaén;039;Guarromán;2891;1391;1500
23;Jaén;041;Higuera de Calatrava;725;379;346
23;Jaén;042;Hinojares;617;313;304
23;Jaén;043;Hornos;800;404;396
23;Jaén;044;Huelma;5942;2970;2972
23;Jaén;045;Huesa;2606;1306;1300
23;Jaén;046;Ibros;3121;1557;1564
23;Jaén;047;Iruela (La);2101;1059;1042
23;Jaén;048;Iznatoraf;1266;605;661
23;Jaén;049;Jabalquinto;2540;1248;1292
23;Jaén;050;Jaén;103260;49890;53370
23;Jaén;051;Jamilena;3115;1590;1525
23;Jaén;052;Jimena;1669;815;854
23;Jaén;053;Jódar;11775;5835;5940
23;Jaén;040;Lahiguera;1928;949;979
23;Jaén;054;Larva;601;303;298
23;Jaén;055;Linares;59249;28967;30282
23;Jaén;056;Lopera;3948;1946;2002
23;Jaén;057;Lupión;1157;540;617
23;Jaén;058;Mancha Real;8415;4187;4228
23;Jaén;059;Marmolejo;7313;3645;3668
23;Jaén;060;Martos;20945;10286;10659
23;Jaén;061;Mengíbar;8099;4044;4055
23;Jaén;062;Montizón;2007;1007;1000
23;Jaén;063;Navas de San Juan;5388;2688;2700
23;Jaén;064;Noalejo;2392;1213;1179
23;Jaén;065;Orcera;2417;1219;1198
23;Jaén;066;Peal de Becerro;5357;2675;2682
23;Jaén;067;Pegalajar;3054;1505;1549
23;Jaén;069;Porcuna;7031;3519;3512
23;Jaén;070;Pozo Alcón;6066;3065;3001
23;Jaén;071;Puente de Génave;2064;1039;1025
23;Jaén;072;Puerta de Segura (La);2872;1436;1436
23;Jaén;073;Quesada;6564;3221;3343
23;Jaén;074;Rus;3694;1862;1832
23;Jaén;075;Sabiote;4303;2104;2199
23;Jaén;076;Santa Elena;1087;571;516
23;Jaén;077;Santiago de Calatrava;1005;515;490
23;Jaén;904;Santiago-Pontones;5075;2579;2496
23;Jaén;079;Santisteban del Puerto;5019;2554;2465
23;Jaén;080;Santo Tomé;2619;1305;1314
23;Jaén;081;Segura de la Sierra;2319;1176;1143
23;Jaén;082;Siles;2944;1506;1438
23;Jaén;084;Sorihuela del Guadalimar;1404;695;709
23;Jaén;086;Torre del Campo;11301;5568;5733
23;Jaén;085;Torreblascopedro;3021;1509;1512
23;Jaén;087;Torredonjimeno;13401;6563;6838
23;Jaén;088;Torreperogil;7580;3719;3861
23;Jaén;090;Torres;1940;986;954
23;Jaén;091;Torres de Albánchez;1126;561;565
23;Jaén;092;Úbeda;30538;14944;15594
23;Jaén;093;Valdepeñas de Jaén;4568;2292;2276
23;Jaén;094;Vilches;5055;2544;2511
23;Jaén;095;Villacarrillo;11672;5785;5887
23;Jaén;096;Villanueva de la Reina;3420;1710;1710
23;Jaén;097;Villanueva del Arzobispo;8555;4156;4399
23;Jaén;098;Villardompardo;1278;621;657
23;Jaén;099;Villares (Los);4547;2245;2302
23;Jaén;101;Villarrodrigo;737;366;371
23;Jaén;903;Villatorres;3889;1936;1953
24;León;001;Acebedo;426;221;205
24;León;002;Algadefe;406;206;200
24;León;003;Alija del Infantado;1066;537;529
24;León;004;Almanza;886;456;430
24;León;005;Antigua (La);751;395;356
24;León;006;Ardón;805;414;391
24;León;007;Arganza;1161;565;596
24;León;008;Astorga;12500;5933;6567
24;León;009;Balboa;611;319;292
24;León;010;Bañeza (La);10046;4910;5136
24;León;011;Barjas;714;379;335
24;León;012;Barrios de Luna (Los);411;203;208
24;León;014;Bembibre;10744;5350;5394
24;León;015;Benavides;3204;1659;1545
24;León;016;Benuza;817;420;397
24;León;017;Bercianos del Páramo;976;492;484
24;León;018;Bercianos del Real Camino;282;143;139
24;León;019;Berlanga del Bierzo;499;249;250
24;León;020;Boca de Huérgano;724;391;333
24;León;021;Boñar;2852;1403;1449
24;León;022;Borrenes;612;317;295
24;León;023;Brazuelo;376;187;189
24;León;024;Burgo Ranero (El);1127;589;538
24;León;025;Burón;550;285;265
24;León;026;Bustillo del Páramo;2190;1098;1092
24;León;027;Cabañas Raras;1368;713;655
24;León;028;Cabreros del Río;690;359;331
24;León;029;Cabrillanes;1294;630;664
24;León;030;Cacabelos;5061;2577;2484
24;León;031;Calzada del Coto;347;198;149
24;León;032;Campazas;216;103;113
24;León;033;Campo de Villavidel;413;212;201
24;León;034;Camponaraya;3141;1532;1609
24;León;036;Candín;611;330;281
24;León;037;Cármenes;563;266;297
24;León;038;Carracedelo;3459;1725;1734
24;León;039;Carrizo;2862;1432;1430
24;León;040;Carrocera;669;320;349
24;León;041;Carucedo;712;334;378
24;León;042;Castilfalé;132;70;62
24;León;043;Castrillo de Cabrera;324;162;162
24;León;044;Castrillo de la Valduerna;307;141;166
24;León;046;Castrocalbón;1495;761;734
24;León;047;Castrocontrigo;1478;735;743
24;León;049;Castropodame;1933;956;977
24;León;050;Castrotierra de Valmadrigal;181;93;88
24;León;051;Cea;862;447;415
24;León;052;Cebanico;298;165;133
24;León;053;Cebrones del Río;830;422;408
24;León;065;Chozas de Abajo;2258;1174;1084
24;León;054;Cimanes de la Vega;764;380;384
24;León;055;Cimanes del Tejar;1193;602;591
24;León;056;Cistierna;4916;2467;2449
24;León;057;Congosto;1974;970;1004
24;León;058;Corbillos de los Oteros;392;196;196
24;León;059;Corullón;1530;761;769
24;León;060;Crémenes;1613;785;828
24;León;061;Cuadros;1680;796;884
24;León;062;Cubillas de los Oteros;265;130;135
24;León;063;Cubillas de Rueda;765;384;381
24;León;064;Cubillos del Sil;1508;773;735
24;León;066;Destriana;1142;558;584
24;León;067;Encinedo;1098;565;533
24;León;068;Ercina (La);909;445;464
24;León;069;Escobar de Campos;101;58;43
24;León;070;Fabero;6445;3228;3217
24;León;071;Folgoso de la Ribera;1594;799;795
24;León;072;Fresnedo;"";"";""
24;León;073;Fresno de la Vega;793;397;396
24;León;074;Fuentes de Carbajal;167;90;77
24;León;076;Garrafe de Torío;1107;549;558
24;León;077;Gordaliza del Pino;457;225;232
24;León;078;Gordoncillo;709;352;357
24;León;079;Gradefes;1579;773;806
24;León;080;Grajal de Campos;359;150;209
24;León;081;Gusendos de los Oteros;276;136;140
24;León;082;Hospital de Órbigo;1199;597;602
24;León;083;Igüeña;2464;1302;1162
24;León;084;Izagre;342;163;179
24;León;086;Joarilla de las Matas;509;266;243
24;León;087;Laguna Dalga;1097;551;546
24;León;088;Laguna de Negrillos;1790;911;879
24;León;089;León;144021;68071;75950
24;León;092;Llamas de la Ribera;1399;714;685
24;León;090;Lucillo;611;312;299
24;León;091;Luyego;1057;496;561
24;León;093;Magaz de Cepeda;640;312;328
24;León;094;Mansilla de las Mulas;1735;851;884
24;León;095;Mansilla Mayor;476;239;237
24;León;096;Maraña;204;103;101
24;León;097;Matadeón de los Oteros;399;192;207
24;León;098;Matallana de Torío;2035;1002;1033
24;León;099;Matanza;417;201;216
24;León;100;Molinaseca;743;375;368
24;León;101;Murias de Paredes;895;426;469
24;León;102;Noceda del Bierzo;1038;506;532
24;León;103;Oencia;551;297;254
24;León;104;Omañas (Las);530;264;266
24;León;105;Onzonilla;1402;684;718
24;León;106;Oseja de Sajambre;383;212;171
24;León;107;Pajares de los Oteros;473;242;231
24;León;108;Palacios de la Valduerna;656;320;336
24;León;109;Palacios del Sil;1645;835;810
24;León;110;Páramo del Sil;2252;1137;1115
24;León;111;Pedrosa del Rey;"";"";""
24;León;112;Peranzanes;389;204;185
24;León;113;Pobladura de Pelayo García;741;377;364
24;León;114;Pola de Gordón (La);5965;2909;3056
24;León;115;Ponferrada;59948;29334;30614
24;León;116;Posada de Valdeón;548;284;264
24;León;117;Pozuelo del Páramo;748;394;354
24;León;118;Prado de la Guzpeña;205;109;96
24;León;119;Priaranza del Bierzo;1015;522;493
24;León;120;Prioro;574;301;273
24;León;121;Puebla de Lillo;776;402;374
24;León;122;Puente de Domingo Flórez;2045;1066;979
24;León;123;Quintana del Castillo;1380;718;662
24;León;124;Quintana del Marco;677;350;327
24;León;125;Quintana y Congosto;1005;521;484
24;León;127;Regueras de Arriba;471;253;218
24;León;129;Reyero;193;105;88
24;León;130;Riaño;556;300;256
24;León;131;Riego de la Vega;1281;625;656
24;León;132;Riello;1337;663;674
24;León;133;Rioseco de Tapia;643;339;304
24;León;134;Robla (La);5487;2765;2722
24;León;136;Roperuelos del Páramo;982;497;485
24;León;137;Sabero;2556;1274;1282
24;León;139;Sahagún;3413;1695;1718
24;León;141;San Adrián del Valle;215;101;114
24;León;142;San Andrés del Rabanedo;20504;10005;10499
24;León;144;San Cristóbal de la Polantera;1304;661;643
24;León;145;San Emiliano;1078;534;544
24;León;146;San Esteban de Nogales;553;263;290
24;León;148;San Justo de la Vega;2457;1234;1223
24;León;149;San Millán de los Caballeros;210;99;111
24;León;150;San Pedro Bercianos;412;207;205
24;León;143;Sancedo;691;350;341
24;León;151;Santa Colomba de Curueño;821;389;432
24;León;152;Santa Colomba de Somoza;528;266;262
24;León;153;Santa Cristina de Valmadrigal;449;227;222
24;León;154;Santa Elena de Jamuz;1601;812;789
24;León;155;Santa María de la Isla;813;429;384
24;León;158;Santa María de Ordás;562;281;281
24;León;156;Santa María del Monte de Cea;487;247;240
24;León;157;Santa María del Páramo;3081;1479;1602
24;León;159;Santa Marina del Rey;2816;1423;1393
24;León;160;Santas Martas;1220;626;594
24;León;161;Santiago Millas;401;200;201
24;León;162;Santovenia de la Valdoncina;1312;635;677
24;León;163;Sariegos;1688;835;853
24;León;164;Sena de Luna;630;307;323
24;León;165;Sobrado;632;317;315
24;León;166;Soto de la Vega;2258;1150;1108
24;León;167;Soto y Amío;1313;632;681
24;León;168;Toral de los Guzmanes;811;415;396
24;León;169;Toreno;5184;2712;2472
24;León;170;Torre del Bierzo;3609;1810;1799
24;León;171;Trabadelo;779;411;368
24;León;172;Truchas;1159;587;572
24;León;173;Turcia;1616;819;797
24;León;174;Urdiales del Páramo;920;465;455
24;León;185;Val de San Lorenzo;842;405;437
24;León;175;Valdefresno;1558;781;777
24;León;176;Valdefuentes del Páramo;539;278;261
24;León;177;Valdelugueros;448;230;218
24;León;178;Valdemora;142;73;69
24;León;179;Valdepiélago;472;227;245
24;León;180;Valdepolo;1774;934;840
24;León;181;Valderas;2388;1206;1182
24;León;182;Valderrey;781;388;393
24;León;183;Valderrueda;1635;819;816
24;León;184;Valdesamario;372;187;185
24;León;187;Valdevimbre;1355;697;658
24;León;188;Valencia de Don Juan;3686;1852;1834
24;León;191;Vallecillo;220;114;106
24;León;189;Valverde de la Virgen;3559;1760;1799
24;León;190;Valverde-Enrique;290;141;149
24;León;193;Vecilla (La);502;247;255
24;León;196;Vega de Espinareda;3192;1622;1570
24;León;197;Vega de Infanzones;889;450;439
24;León;198;Vega de Valcarce;1192;606;586
24;León;194;Vegacervera;414;213;201
24;León;199;Vegaquemada;661;320;341
24;León;201;Vegas del Condado;1628;816;812
24;León;202;Villablino;15825;7947;7878
24;León;203;Villabraz;212;109;103
24;León;205;Villadangos del Páramo;1029;505;524
24;León;206;Villadecanes;2495;1263;1232
24;León;207;Villademor de la Vega;542;276;266
24;León;209;Villafranca del Bierzo;4126;2064;2062
24;León;210;Villagatón;1057;537;520
24;León;211;Villamandos;533;258;275
24;León;901;Villamanín;1518;761;757
24;León;212;Villamañán;1563;782;781
24;León;213;Villamartín de Don Sancho;262;134;128
24;León;214;Villamejil;1144;582;562
24;León;215;Villamol;300;156;144
24;León;216;Villamontán de la Valduerna;1331;675;656
24;León;217;Villamoratiel de las Matas;247;135;112
24;León;218;Villanueva de las Manzanas;677;316;361
24;León;219;Villaobispo de Otero;827;422;405
24;León;902;Villaornate y Castro;618;325;293
24;León;221;Villaquejida;1176;606;570
24;León;222;Villaquilambre;5298;2616;2682
24;León;223;Villarejo de Órbigo;3654;1787;1867
24;León;224;Villares de Órbigo;1050;541;509
24;León;225;Villasabariego;1270;633;637
24;León;226;Villaselán;412;222;190
24;León;227;Villaturiel;1770;898;872
24;León;228;Villazala;1203;619;584
24;León;229;Villazanzo de Valderaduey;772;414;358
24;León;230;Zotes del Páramo;858;439;419
25;Lleida;001;Abella de la Conca;164;85;79
25;Lleida;002;Àger;592;318;274
25;Lleida;003;Agramunt;4803;2411;2392
25;Lleida;038;Aitona;2259;1112;1147
25;Lleida;004;Alamús (Els);660;342;318
25;Lleida;005;Alàs i Cerc;403;216;187
25;Lleida;006;Albagés (L');557;272;285
25;Lleida;007;Albatàrrec;1009;480;529
25;Lleida;008;Albesa;1462;726;736
25;Lleida;009;Albi (L');797;413;384
25;Lleida;010;Alcanó;289;139;150
25;Lleida;011;Alcarràs;4507;2238;2269
25;Lleida;012;Alcoletge;1517;764;753
25;Lleida;013;Alfarràs;3018;1488;1530
25;Lleida;014;Alfés;337;175;162
25;Lleida;015;Algerri;554;276;278
25;Lleida;016;Alguaire;2859;1433;1426
25;Lleida;017;Alins;307;159;148
25;Lleida;019;Almacelles;5496;2818;2678
25;Lleida;020;Almatret;553;290;263
25;Lleida;021;Almenar;3573;1820;1753
25;Lleida;022;Alòs de Balaguer;165;93;72
25;Lleida;023;Alpicat;3777;1933;1844
25;Lleida;024;Alt Àneu;351;189;162
25;Lleida;027;Anglesola;1252;615;637
25;Lleida;029;Arbeca;2332;1153;1179
25;Lleida;031;Arres;50;28;22
25;Lleida;032;Arsèguel;101;51;50
25;Lleida;033;Artesa de Lleida;1188;587;601
25;Lleida;034;Artesa de Segre;3129;1604;1525
25;Lleida;036;Aspa;253;128;125
25;Lleida;037;Avellanes i Santa Linya (Les);485;264;221
25;Lleida;039;Baix Pallars;350;194;156
25;Lleida;040;Balaguer;13037;6414;6623
25;Lleida;041;Barbens;793;406;387
25;Lleida;042;Baronia de Rialb (La);256;136;120
25;Lleida;044;Bassella;367;185;182
25;Lleida;045;Bausen;68;40;28
25;Lleida;046;Belianes;564;266;298
25;Lleida;170;Bellaguarda;387;193;194
25;Lleida;047;Bellcaire d'Urgell;1425;691;734
25;Lleida;048;Bell-lloc d'Urgell;2180;1078;1102
25;Lleida;049;Bellmunt d'Urgell;237;119;118
25;Lleida;050;Bellpuig;3916;1946;1970
25;Lleida;051;Bellver de Cerdanya;1549;804;745
25;Lleida;052;Bellvís;2254;1130;1124
25;Lleida;053;Benavent de Segrià;747;381;366
25;Lleida;055;Biosca;259;125;134
25;Lleida;057;Bòrdes (Es);193;93;100
25;Lleida;058;Borges Blanques (Les);5089;2525;2564
25;Lleida;059;Bossòst;784;381;403
25;Lleida;056;Bovera;433;220;213
25;Lleida;060;Cabanabona;109;53;56
25;Lleida;061;Cabó;142;78;64
25;Lleida;062;Camarasa;929;470;459
25;Lleida;063;Canejan;109;60;49
25;Lleida;904;Castell de Mur;143;70;73
25;Lleida;064;Castellar de la Ribera;160;79;81
25;Lleida;067;Castelldans;974;497;477
25;Lleida;068;Castellnou de Seana;748;357;391
25;Lleida;069;Castelló de Farfanya;605;304;301
25;Lleida;070;Castellserà;1161;580;581
25;Lleida;071;Cava;51;31;20
25;Lleida;072;Cervera;6951;3422;3529
25;Lleida;073;Cervià de les Garrigues;849;428;421
25;Lleida;074;Ciutadilla;230;117;113
25;Lleida;075;Clariana de Cardener;146;77;69
25;Lleida;076;Cogul (El);232;115;117
25;Lleida;077;Coll de Nargó;623;322;301
25;Lleida;163;Coma i la Pedra (La);251;150;101
25;Lleida;161;Conca de Dalt;473;252;221
25;Lleida;078;Corbins;1039;534;505
25;Lleida;079;Cubells;384;194;190
25;Lleida;081;Espluga Calba (L');450;235;215
25;Lleida;082;Espot;243;118;125
25;Lleida;088;Estamariu;134;69;65
25;Lleida;085;Estaràs;167;85;82
25;Lleida;086;Esterri d'Àneu;496;251;245
25;Lleida;087;Esterri de Cardós;66;35;31
25;Lleida;089;Farrera;88;47;41
25;Lleida;908;Fígols i Alinyà;347;195;152
25;Lleida;092;Floresta (La);198;101;97
25;Lleida;093;Fondarella;634;310;324
25;Lleida;094;Foradada;156;84;72
25;Lleida;096;Fuliola (La);1329;682;647
25;Lleida;097;Fulleda;123;62;61
25;Lleida;098;Gavet de la Conca;369;187;182
25;Lleida;912;Gimenells i el Pla de la Font;"";"";""
25;Lleida;099;Golmés;1280;632;648
25;Lleida;100;Gósol;201;107;94
25;Lleida;101;Granadella (La);844;420;424
25;Lleida;102;Granja d'Escarp (La);1142;574;568
25;Lleida;103;Granyanella;130;66;64
25;Lleida;105;Granyena de les Garrigues;182;90;92
25;Lleida;104;Granyena de Segarra;186;96;90
25;Lleida;109;Guimerà;419;206;213
25;Lleida;903;Guingueta d'Àneu (La);268;136;132
25;Lleida;110;Guissona;2642;1334;1308
25;Lleida;111;Guixers;152;85;67
25;Lleida;115;Isona i Conca Dellà;1367;716;651
25;Lleida;112;Ivars de Noguera;344;170;174
25;Lleida;113;Ivars d'Urgell;1744;854;890
25;Lleida;114;Ivorra;152;78;74
25;Lleida;910;Josa i Tuixén;145;76;69
25;Lleida;118;Juncosa;585;303;282
25;Lleida;119;Juneda;2949;1483;1466
25;Lleida;121;Les;674;333;341
25;Lleida;122;Linyola;2385;1195;1190
25;Lleida;123;Lladorre;214;117;97
25;Lleida;124;Lladurs;254;136;118
25;Lleida;125;Llardecans;683;342;341
25;Lleida;126;Llavorsí;268;140;128
25;Lleida;120;Lleida;112093;54783;57310
25;Lleida;127;Lles de Cerdanya;301;159;142
25;Lleida;128;Llimiana;124;65;59
25;Lleida;129;Llobera;251;130;121
25;Lleida;133;Maials;1083;545;538
25;Lleida;130;Maldà;325;168;157
25;Lleida;131;Massalcoreig;669;329;340
25;Lleida;132;Massoteres;159;80;79
25;Lleida;134;Menàrguens;882;439;443
25;Lleida;135;Miralcamp;1197;582;615
25;Lleida;137;Mollerussa;8966;4444;4522
25;Lleida;136;Molsosa (La);135;67;68
25;Lleida;139;Montellà i Martinet;555;291;264
25;Lleida;140;Montferrer i Castellbò;659;365;294
25;Lleida;138;Montgai;863;437;426
25;Lleida;142;Montoliu de Lleida;463;233;230
25;Lleida;141;Montoliu de Segarra;213;113;100
25;Lleida;143;Montornès de Segarra;123;53;70
25;Lleida;145;Nalec;103;46;57
25;Lleida;025;Naut Aran;1087;575;512
25;Lleida;146;Navès;285;145;140
25;Lleida;148;Odèn;302;166;136
25;Lleida;149;Oliana;2017;1032;985
25;Lleida;150;Oliola;202;107;95
25;Lleida;151;Olius;486;236;250
25;Lleida;152;Oluges (Les);214;111;103
25;Lleida;153;Omellons (Els);270;137;133
25;Lleida;154;Omells de na Gaia (Els);152;81;71
25;Lleida;155;Organyà;1049;536;513
25;Lleida;156;Os de Balaguer;764;407;357
25;Lleida;157;Ossó de Sió;237;121;116
25;Lleida;158;Palau d'Anglesola (El);1609;816;793
25;Lleida;164;Penelles;571;310;261
25;Lleida;165;Peramola;393;203;190
25;Lleida;166;Pinell de Solsonès;257;136;121
25;Lleida;167;Pinós;341;185;156
25;Lleida;911;Plans de Sió (Els);671;339;332
25;Lleida;168;Poal (El);646;335;311
25;Lleida;169;Pobla de Cérvoles (La);207;112;95
25;Lleida;171;Pobla de Segur (La);3115;1517;1598
25;Lleida;030;Pont de Bar (El);169;95;74
25;Lleida;173;Pont de Suert (El);2285;1151;1134
25;Lleida;172;Ponts;2200;1088;1112
25;Lleida;174;Portella (La);613;311;302
25;Lleida;175;Prats i Sansor;133;71;62
25;Lleida;176;Preixana;470;240;230
25;Lleida;177;Preixens;550;270;280
25;Lleida;179;Prullans;192;100;92
25;Lleida;180;Puiggròs;265;127;138
25;Lleida;181;Puigverd d'Agramunt;252;130;122
25;Lleida;182;Puigverd de Lleida;949;446;503
25;Lleida;183;Rialp;466;250;216
25;Lleida;905;Ribera d'Ondara;505;252;253
25;Lleida;185;Ribera d'Urgellet;822;424;398
25;Lleida;186;Riner;253;135;118
25;Lleida;913;Riu de Cerdanya;"";"";""
25;Lleida;189;Rosselló;1622;792;830
25;Lleida;190;Salàs de Pallars;336;170;166
25;Lleida;191;Sanaüja;468;228;240
25;Lleida;196;Sant Esteve de la Sarga;87;55;32
25;Lleida;192;Sant Guim de Freixenet;1051;528;523
25;Lleida;197;Sant Guim de la Plana;206;108;98
25;Lleida;193;Sant Llorenç de Morunys;861;447;414
25;Lleida;902;Sant Martí de Riucorb;781;401;380
25;Lleida;194;Sant Ramon;561;279;282
25;Lleida;201;Sarroca de Bellera;140;81;59
25;Lleida;200;Sarroca de Lleida;501;261;240
25;Lleida;202;Senterada;109;63;46
25;Lleida;035;Sentiu de Sió (La);464;227;237
25;Lleida;204;Seròs;1890;1002;888
25;Lleida;203;Seu d'Urgell (La);10374;5149;5225
25;Lleida;205;Sidamon;444;222;222
25;Lleida;206;Soleràs (El);449;224;225
25;Lleida;207;Solsona;6658;3330;3328
25;Lleida;208;Soriguera;290;151;139
25;Lleida;209;Sort;1571;799;772
25;Lleida;210;Soses;1516;773;743
25;Lleida;211;Sudanell;733;387;346
25;Lleida;212;Sunyer;311;156;155
25;Lleida;215;Talarn;371;184;187
25;Lleida;216;Talavera;315;155;160
25;Lleida;217;Tàrrega;11233;5474;5759
25;Lleida;218;Tarrés;101;52;49
25;Lleida;219;Tarroja de Segarra;200;97;103
25;Lleida;220;Térmens;1399;701;698
25;Lleida;221;Tírvia;107;58;49
25;Lleida;222;Tiurana;233;127;106
25;Lleida;223;Torà;1136;576;560
25;Lleida;224;Torms (Els);215;119;96
25;Lleida;225;Tornabous;884;440;444
25;Lleida;227;Torre de Cabdella (La);754;370;384
25;Lleida;226;Torrebesses;359;179;180
25;Lleida;228;Torrefarrera;1524;774;750
25;Lleida;907;Torrefeta i Florejacs;731;357;374
25;Lleida;230;Torregrossa;2200;1086;1114
25;Lleida;231;Torrelameu;603;318;285
25;Lleida;232;Torres de Segre;1826;929;897
25;Lleida;233;Torre-serona;304;154;150
25;Lleida;234;Tremp;5308;2598;2710
25;Lleida;043;Vall de Boí (La);637;349;288
25;Lleida;901;Vall de Cardós;333;170;163
25;Lleida;238;Vallbona de les Monges;289;139;150
25;Lleida;240;Vallfogona de Balaguer;1404;708;696
25;Lleida;906;Valls d'Aguilar (Les);229;124;105
25;Lleida;239;Valls de Valira (Les);818;430;388
25;Lleida;909;Vansa i Fórnols (La);167;86;81
25;Lleida;242;Verdú;960;473;487
25;Lleida;243;Vielha e Mijaran;3109;1563;1546
25;Lleida;244;Vilagrassa;429;213;216
25;Lleida;245;Vilaller;592;313;279
25;Lleida;247;Vilamòs;110;54;56
25;Lleida;248;Vilanova de Bellpuig;1197;569;628
25;Lleida;254;Vilanova de la Barca;870;436;434
25;Lleida;249;Vilanova de l'Aguda;279;144;135
25;Lleida;250;Vilanova de Meià;499;251;248
25;Lleida;251;Vilanova de Segrià;672;334;338
25;Lleida;252;Vila-sana;525;263;262
25;Lleida;253;Vilosell (El);214;94;120
25;Lleida;255;Vinaixa;727;356;371
26;Rioja (La);001;Ábalos;293;164;129
26;Rioja (La);002;Agoncillo;853;449;404
26;Rioja (La);003;Aguilar del Río Alhama;848;438;410
26;Rioja (La);004;Ajamil;75;47;28
26;Rioja (La);005;Albelda de Iregua;2154;1091;1063
26;Rioja (La);006;Alberite;1948;983;965
26;Rioja (La);007;Alcanadre;909;456;453
26;Rioja (La);008;Aldeanueva de Ebro;2551;1317;1234
26;Rioja (La);009;Alesanco;579;294;285
26;Rioja (La);010;Alesón;162;80;82
26;Rioja (La);011;Alfaro;9315;4656;4659
26;Rioja (La);012;Almarza de Cameros;37;20;17
26;Rioja (La);013;Anguciana;302;157;145
26;Rioja (La);014;Anguiano;650;355;295
26;Rioja (La);015;Arenzana de Abajo;387;208;179
26;Rioja (La);016;Arenzana de Arriba;47;26;21
26;Rioja (La);017;Arnedillo;396;195;201
26;Rioja (La);018;Arnedo;12423;6184;6239
26;Rioja (La);019;Arrúbal;397;209;188
26;Rioja (La);020;Ausejo;747;390;357
26;Rioja (La);021;Autol;3419;1729;1690
26;Rioja (La);022;Azofra;411;210;201
26;Rioja (La);023;Badarán;822;438;384
26;Rioja (La);024;Bañares;477;243;234
26;Rioja (La);026;Baños de Río Tobía;1848;938;910
26;Rioja (La);025;Baños de Rioja;127;75;52
26;Rioja (La);027;Berceo;254;145;109
26;Rioja (La);028;Bergasa;205;108;97
26;Rioja (La);029;Bergasillas Bajera;31;16;15
26;Rioja (La);030;Bezares;29;19;10
26;Rioja (La);031;Bobadilla;188;95;93
26;Rioja (La);032;Brieva de Cameros;70;38;32
26;Rioja (La);033;Briñas;191;95;96
26;Rioja (La);034;Briones;930;495;435
26;Rioja (La);035;Cabezón de Cameros;37;21;16
26;Rioja (La);036;Calahorra;18781;9088;9693
26;Rioja (La);037;Camprovín;262;137;125
26;Rioja (La);038;Canales de la Sierra;63;36;27
26;Rioja (La);039;Canillas de Río Tuerto;82;39;43
26;Rioja (La);040;Cañas;123;56;67
26;Rioja (La);041;Cárdenas;264;132;132
26;Rioja (La);042;Casalarreina;896;443;453
26;Rioja (La);043;Castañares de Rioja;535;279;256
26;Rioja (La);044;Castroviejo;47;25;22
26;Rioja (La);045;Cellorigo;18;11;7
26;Rioja (La);046;Cenicero;2200;1102;1098
26;Rioja (La);047;Cervera del Río Alhama;3483;1745;1738
26;Rioja (La);048;Cidamón;89;49;40
26;Rioja (La);049;Cihuri;185;100;85
26;Rioja (La);050;Cirueña;139;81;58
26;Rioja (La);051;Clavijo;200;102;98
26;Rioja (La);052;Cordovín;246;125;121
26;Rioja (La);053;Corera;263;128;135
26;Rioja (La);054;Cornago;712;393;319
26;Rioja (La);055;Corporales;72;37;35
26;Rioja (La);056;Cuzcurrita de Río Tirón;513;280;233
26;Rioja (La);057;Daroca de Rioja;57;35;22
26;Rioja (La);058;Enciso;188;112;76
26;Rioja (La);059;Entrena;1117;594;523
26;Rioja (La);060;Estollo;156;83;73
26;Rioja (La);061;Ezcaray;1749;926;823
26;Rioja (La);062;Foncea;157;85;72
26;Rioja (La);063;Fonzaleche;201;109;92
26;Rioja (La);064;Fuenmayor;2111;1042;1069
26;Rioja (La);065;Galbárruli;60;34;26
26;Rioja (La);066;Galilea;286;152;134
26;Rioja (La);067;Gallinero de Cameros;25;16;9
26;Rioja (La);068;Gimileo;95;48;47
26;Rioja (La);069;Grañón;487;258;229
26;Rioja (La);070;Grávalos;312;160;152
26;Rioja (La);071;Haro;8778;4288;4490
26;Rioja (La);072;Herce;380;190;190
26;Rioja (La);073;Herramélluri;196;104;92
26;Rioja (La);074;Hervías;224;116;108
26;Rioja (La);075;Hormilla;499;260;239
26;Rioja (La);076;Hormilleja;195;97;98
26;Rioja (La);077;Hornillos de Cameros;30;15;15
26;Rioja (La);078;Hornos de Moncalvillo;106;55;51
26;Rioja (La);079;Huércanos;935;478;457
26;Rioja (La);080;Igea;983;526;457
26;Rioja (La);081;Jalón de Cameros;41;24;17
26;Rioja (La);082;Laguna de Cameros;178;96;82
26;Rioja (La);083;Lagunilla del Jubera;366;190;176
26;Rioja (La);084;Lardero;3016;1496;1520
26;Rioja (La);086;Ledesma de la Cogolla;21;13;8
26;Rioja (La);087;Leiva;359;174;185
26;Rioja (La);088;Leza de Río Leza;27;18;9
26;Rioja (La);089;Logroño;122254;59043;63211
26;Rioja (La);091;Lumbreras;184;107;77
26;Rioja (La);092;Manjarrés;148;81;67
26;Rioja (La);093;Mansilla de la Sierra;49;30;19
26;Rioja (La);094;Manzanares de Rioja;147;79;68
26;Rioja (La);095;Matute;192;95;97
26;Rioja (La);096;Medrano;238;127;111
26;Rioja (La);098;Munilla;142;66;76
26;Rioja (La);099;Murillo de Río Leza;1611;801;810
26;Rioja (La);100;Muro de Aguas;70;39;31
26;Rioja (La);101;Muro en Cameros;44;31;13
26;Rioja (La);102;Nájera;6907;3433;3474
26;Rioja (La);103;Nalda;905;462;443
26;Rioja (La);104;Navajún;20;14;6
26;Rioja (La);105;Navarrete;2021;1033;988
26;Rioja (La);106;Nestares;59;31;28
26;Rioja (La);107;Nieva de Cameros;120;63;57
26;Rioja (La);109;Ochánduri;117;59;58
26;Rioja (La);108;Ocón;335;177;158
26;Rioja (La);110;Ojacastro;245;142;103
26;Rioja (La);111;Ollauri;314;172;142
26;Rioja (La);112;Ortigosa de Cameros;355;175;180
26;Rioja (La);113;Pazuengos;46;28;18
26;Rioja (La);114;Pedroso;117;62;55
26;Rioja (La);115;Pinillos;26;15;11
26;Rioja (La);117;Pradejón;2855;1440;1415
26;Rioja (La);118;Pradillo;113;60;53
26;Rioja (La);119;Préjano;220;105;115
26;Rioja (La);120;Quel;2047;1068;979
26;Rioja (La);121;Rabanera;46;24;22
26;Rioja (La);122;Rasillo de Cameros (El);125;68;57
26;Rioja (La);123;Redal (El);243;124;119
26;Rioja (La);124;Ribafrecha;1085;585;500
26;Rioja (La);125;Rincón de Soto;3329;1675;1654
26;Rioja (La);126;Robres del Castillo;27;16;11
26;Rioja (La);127;Rodezno;367;188;179
26;Rioja (La);128;Sajazarra;173;87;86
26;Rioja (La);129;San Asensio;1392;724;668
26;Rioja (La);130;San Millán de la Cogolla;299;179;120
26;Rioja (La);131;San Millán de Yécora;79;48;31
26;Rioja (La);132;San Román de Cameros;191;102;89
26;Rioja (La);139;San Torcuato;134;72;62
26;Rioja (La);142;San Vicente de la Sonsierra;1151;594;557
26;Rioja (La);134;Santa Coloma;169;101;68
26;Rioja (La);135;Santa Engracia del Jubera;193;116;77
26;Rioja (La);136;Santa Eulalia Bajera;115;63;52
26;Rioja (La);138;Santo Domingo de la Calzada;5490;2766;2724
26;Rioja (La);140;Santurde de Rioja;324;159;165
26;Rioja (La);141;Santurdejo;242;132;110
26;Rioja (La);143;Sojuela;94;55;39
26;Rioja (La);144;Sorzano;273;149;124
26;Rioja (La);145;Sotés;294;153;141
26;Rioja (La);146;Soto en Cameros;121;68;53
26;Rioja (La);147;Terroba;35;20;15
26;Rioja (La);148;Tirgo;290;147;143
26;Rioja (La);149;Tobía;70;41;29
26;Rioja (La);150;Tormantos;225;114;111
26;Rioja (La);153;Torre en Cameros;14;11;3
26;Rioja (La);151;Torrecilla en Cameros;506;262;244
26;Rioja (La);152;Torrecilla sobre Alesanco;110;56;54
26;Rioja (La);154;Torremontalbo;12;7;5
26;Rioja (La);155;Treviana;313;169;144
26;Rioja (La);157;Tricio;401;200;201
26;Rioja (La);158;Tudelilla;517;260;257
26;Rioja (La);160;Uruñuela;729;376;353
26;Rioja (La);161;Valdemadera;17;11;6
26;Rioja (La);162;Valgañón;184;98;86
26;Rioja (La);163;Ventosa;148;74;74
26;Rioja (La);164;Ventrosa;97;40;57
26;Rioja (La);165;Viguera;405;214;191
26;Rioja (La);166;Villalba de Rioja;178;100;78
26;Rioja (La);167;Villalobar de Rioja;139;80;59
26;Rioja (La);168;Villamediana de Iregua;1883;969;914
26;Rioja (La);169;Villanueva de Cameros;123;61;62
26;Rioja (La);170;Villar de Arnedo (El);777;380;397
26;Rioja (La);171;Villar de Torre;366;186;180
26;Rioja (La);172;Villarejo;48;29;19
26;Rioja (La);173;Villarroya;13;7;6
26;Rioja (La);174;Villarta-Quintana;238;121;117
26;Rioja (La);175;Villavelayo;71;43;28
26;Rioja (La);176;Villaverde de Rioja;98;56;42
26;Rioja (La);177;Villoslada de Cameros;392;221;171
26;Rioja (La);178;Viniegra de Abajo;143;71;72
26;Rioja (La);179;Viniegra de Arriba;44;25;19
26;Rioja (La);180;Zarratón;311;162;149
26;Rioja (La);181;Zarzosa;17;12;5
26;Rioja (La);183;Zorraquín;43;25;18
27;Lugo;001;Abadín;4100;1973;2127
27;Lugo;002;Alfoz;2690;1321;1369
27;Lugo;003;Antas de Ulla;3319;1609;1710
27;Lugo;004;Baleira;2185;1141;1044
27;Lugo;901;Baralla;3868;1980;1888
27;Lugo;005;Barreiros;3801;1821;1980
27;Lugo;006;Becerreá;4126;2100;2026
27;Lugo;007;Begonte;4606;2284;2322
27;Lugo;008;Bóveda;2345;1145;1200
27;Lugo;902;Burela;"";"";""
27;Lugo;009;Carballedo;4197;2088;2109
27;Lugo;010;Castro de Rei;5879;2955;2924
27;Lugo;011;Castroverde;3945;2019;1926
27;Lugo;012;Cervantes;2604;1430;1174
27;Lugo;013;Cervo;12750;6315;6435
27;Lugo;016;Chantada;10184;4955;5229
27;Lugo;014;Corgo (O);4806;2433;2373
27;Lugo;015;Cospeito;6474;3190;3284
27;Lugo;017;Folgoso do Courel;1924;987;937
27;Lugo;018;Fonsagrada (A);6986;3698;3288
27;Lugo;019;Foz;9785;4721;5064
27;Lugo;020;Friol;5152;2581;2571
27;Lugo;022;Guitiriz;6984;3474;3510
27;Lugo;023;Guntín;4005;1987;2018
27;Lugo;024;Incio (O);2920;1469;1451
27;Lugo;026;Láncara;3588;1872;1716
27;Lugo;027;Lourenzá;3148;1531;1617
27;Lugo;028;Lugo;83242;39522;43720
27;Lugo;029;Meira;1874;926;948
27;Lugo;030;Mondoñedo;5843;2723;3120
27;Lugo;031;Monforte de Lemos;20318;9760;10558
27;Lugo;032;Monterroso;4577;2302;2275
27;Lugo;033;Muras;1437;724;713
27;Lugo;034;Navia de Suarna;2303;1230;1073
27;Lugo;035;Negueira de Muñiz;339;175;164
27;Lugo;037;Nogais (As);1956;1029;927
27;Lugo;038;Ourol;1959;940;1019
27;Lugo;039;Outeiro de Rei;4213;2096;2117
27;Lugo;040;Palas de Rei;5016;2497;2519
27;Lugo;041;Pantón;4062;1965;2097
27;Lugo;042;Paradela;3226;1594;1632
27;Lugo;043;Páramo (O);2106;1084;1022
27;Lugo;044;Pastoriza (A);4492;2246;2246
27;Lugo;045;Pedrafita do Cebreiro;2144;1148;996
27;Lugo;047;Pobra do Brollón (A);3272;1612;1660
27;Lugo;046;Pol;2456;1212;1244
27;Lugo;048;Pontenova (A);3781;1839;1942
27;Lugo;049;Portomarín;2237;1123;1114
27;Lugo;050;Quiroga;5150;2529;2621
27;Lugo;056;Rábade;1751;888;863
27;Lugo;051;Ribadeo;8894;4189;4705
27;Lugo;052;Ribas de Sil;1689;823;866
27;Lugo;053;Ribeira de Piquín;1084;543;541
27;Lugo;054;Riotorto;2257;1118;1139
27;Lugo;055;Samos;2413;1282;1131
27;Lugo;057;Sarria;12611;6243;6368
27;Lugo;058;Saviñao (O);5883;2897;2986
27;Lugo;059;Sober;3789;1832;1957
27;Lugo;060;Taboada;5104;2527;2577
27;Lugo;061;Trabada;2046;986;1060
27;Lugo;062;Triacastela;1068;552;516
27;Lugo;063;Valadouro (O);2815;1397;1418
27;Lugo;064;Vicedo (O);2706;1314;1392
27;Lugo;065;Vilalba;16110;7853;8257
27;Lugo;066;Viveiro;15098;7186;7912
27;Lugo;021;Xermade;3134;1559;1575
27;Lugo;025;Xove;3539;1763;1776
28;Madrid;001;Acebeda (La);57;28;29
28;Madrid;002;Ajalvir;1309;701;608
28;Madrid;003;Alameda del Valle;153;84;69
28;Madrid;004;Álamo (El);2920;1455;1465
28;Madrid;005;Alcalá de Henares;159355;79633;79722
28;Madrid;006;Alcobendas;78725;39035;39690
28;Madrid;007;Alcorcón;139662;69466;70196
28;Madrid;008;Aldea del Fresno;1140;573;567
28;Madrid;009;Algete;10018;5120;4898
28;Madrid;010;Alpedrete;3430;1737;1693
28;Madrid;011;Ambite;287;143;144
28;Madrid;012;Anchuelo;533;288;245
28;Madrid;013;Aranjuez;36162;17580;18582
28;Madrid;014;Arganda del Rey;26113;13018;13095
28;Madrid;015;Arroyomolinos;1236;615;621
28;Madrid;016;Atazar (El);88;49;39
28;Madrid;017;Batres;351;181;170
28;Madrid;018;Becerril de la Sierra;1905;950;955
28;Madrid;019;Belmonte de Tajo;1139;580;559
28;Madrid;021;Berrueco (El);279;147;132
28;Madrid;020;Berzosa del Lozoya;74;40;34
28;Madrid;022;Boadilla del Monte;15824;7969;7855
28;Madrid;023;Boalo (El);1689;851;838
28;Madrid;024;Braojos;129;71;58
28;Madrid;025;Brea de Tajo;460;241;219
28;Madrid;026;Brunete;2482;1255;1227
28;Madrid;027;Buitrago del Lozoya;1294;631;663
28;Madrid;028;Bustarviejo;1222;623;599
28;Madrid;029;Cabanillas de la Sierra;367;190;177
28;Madrid;030;Cabrera (La);1017;521;496
28;Madrid;031;Cadalso de los Vidrios;2086;1065;1021
28;Madrid;032;Camarma de Esteruelas;1398;700;698
28;Madrid;033;Campo Real;2148;1079;1069
28;Madrid;034;Canencia;434;223;211
28;Madrid;035;Carabaña;1031;517;514
28;Madrid;036;Casarrubuelos;540;286;254
28;Madrid;037;Cenicientos;1802;885;917
28;Madrid;038;Cercedilla;3876;1898;1978
28;Madrid;039;Cervera de Buitrago;83;46;37
28;Madrid;051;Chapinería;907;477;430
28;Madrid;052;Chinchón;3947;1958;1989
28;Madrid;040;Ciempozuelos;10779;5487;5292
28;Madrid;041;Cobeña;1172;603;569
28;Madrid;046;Collado Mediano;2409;1222;1187
28;Madrid;047;Collado Villalba;26356;13101;13255
28;Madrid;043;Colmenar de Oreja;5209;2532;2677
28;Madrid;042;Colmenar del Arroyo;493;246;247
28;Madrid;045;Colmenar Viejo;39633;19642;19991
28;Madrid;044;Colmenarejo;2408;1249;1159
28;Madrid;048;Corpa;353;181;172
28;Madrid;049;Coslada;73866;36947;36919
28;Madrid;050;Cubas de la Sagra;896;431;465
28;Madrid;053;Daganzo de Arriba;1627;828;799
28;Madrid;054;Escorial (El);6916;3379;3537
28;Madrid;055;Estremera;1056;556;500
28;Madrid;056;Fresnedillas de la Oliva;458;227;231
28;Madrid;057;Fresno de Torote;227;110;117
28;Madrid;058;Fuenlabrada;144723;73237;71486
28;Madrid;059;Fuente el Saz de Jarama;2658;1367;1291
28;Madrid;060;Fuentidueña de Tajo;1310;633;677
28;Madrid;061;Galapagar;9050;4580;4470
28;Madrid;062;Garganta de los Montes;302;149;153
28;Madrid;063;Gargantilla del Lozoya y Pinilla de Buitrago;220;124;96
28;Madrid;064;Gascones;101;49;52
28;Madrid;065;Getafe;139190;69418;69772
28;Madrid;066;Griñón;2348;1209;1139
28;Madrid;067;Guadalix de la Sierra;1725;877;848
28;Madrid;068;Guadarrama;6902;3444;3458
28;Madrid;069;Hiruela (La);32;19;13
28;Madrid;070;Horcajo de la Sierra;119;62;57
28;Madrid;071;Horcajuelo de la Sierra;72;35;37
28;Madrid;072;Hoyo de Manzanares;3472;1737;1735
28;Madrid;073;Humanes de Madrid;7829;3957;3872
28;Madrid;074;Leganés;171589;85943;85646
28;Madrid;075;Loeches;2238;1141;1097
28;Madrid;076;Lozoya;393;201;192
28;Madrid;901;Lozoyuela-Navas-Sieteiglesias;616;325;291
28;Madrid;078;Madarcos;33;17;16
28;Madrid;079;Madrid;3010492;1415951;1594541
28;Madrid;080;Majadahonda;33475;16365;17110
28;Madrid;082;Manzanares el Real;2340;1196;1144
28;Madrid;083;Meco;2928;1502;1426
28;Madrid;084;Mejorada del Campo;13596;6910;6686
28;Madrid;085;Miraflores de la Sierra;2636;1294;1342
28;Madrid;086;Molar (El);2763;1456;1307
28;Madrid;087;Molinos (Los);2460;1156;1304
28;Madrid;088;Montejo de la Sierra;255;124;131
28;Madrid;089;Moraleja de Enmedio;1512;738;774
28;Madrid;090;Moralzarzal;2208;1128;1080
28;Madrid;091;Morata de Tajuña;5063;2485;2578
28;Madrid;092;Móstoles;192018;95463;96555
28;Madrid;093;Navacerrada;1588;856;732
28;Madrid;094;Navalafuente;322;176;146
28;Madrid;095;Navalagamella;627;311;316
28;Madrid;096;Navalcarnero;10126;5128;4998
28;Madrid;097;Navarredonda y San Mamés;100;50;50
28;Madrid;099;Navas del Rey;1031;517;514
28;Madrid;100;Nuevo Baztán;466;249;217
28;Madrid;101;Olmeda de las Fuentes;120;64;56
28;Madrid;102;Orusco de Tajuña;585;291;294
28;Madrid;104;Paracuellos de Jarama;4362;2252;2110
28;Madrid;106;Parla;69907;35044;34863
28;Madrid;107;Patones;338;172;166
28;Madrid;108;Pedrezuela;806;416;390
28;Madrid;109;Pelayos de la Presa;922;465;457
28;Madrid;110;Perales de Tajuña;1969;948;1021
28;Madrid;111;Pezuela de las Torres;462;244;218
28;Madrid;112;Pinilla del Valle;156;83;73
28;Madrid;113;Pinto;22251;11087;11164
28;Madrid;114;Piñuécar-Gandullas;148;73;75
28;Madrid;115;Pozuelo de Alarcón;48328;23787;24541
28;Madrid;116;Pozuelo del Rey;201;106;95
28;Madrid;117;Prádena del Rincón;103;55;48
28;Madrid;118;Puebla de la Sierra;48;25;23
28;Madrid;902;Puentes Viejas;381;200;181
28;Madrid;119;Quijorna;623;326;297
28;Madrid;120;Rascafría;1300;674;626
28;Madrid;121;Redueña;143;71;72
28;Madrid;122;Ribatejada;274;140;134
28;Madrid;123;Rivas-Vaciamadrid;14863;7466;7397
28;Madrid;124;Robledillo de la Jara;58;30;28
28;Madrid;125;Robledo de Chavela;1813;889;924
28;Madrid;126;Robregordo;89;44;45
28;Madrid;127;Rozas de Madrid (Las);35137;17278;17859
28;Madrid;128;Rozas de Puerto Real;337;168;169
28;Madrid;129;San Agustín del Guadalix;3160;1629;1531
28;Madrid;130;San Fernando de Henares;25350;12689;12661
28;Madrid;131;San Lorenzo de El Escorial;8648;4172;4476
28;Madrid;132;San Martín de la Vega;6361;3243;3118
28;Madrid;133;San Martín de Valdeiglesias;5438;2724;2714
28;Madrid;134;San Sebastián de los Reyes;53707;26948;26759
28;Madrid;135;Santa María de la Alameda;705;384;321
28;Madrid;136;Santorcaz;534;279;255
28;Madrid;137;Santos de la Humosa (Los);927;484;443
28;Madrid;138;Serna del Monte (La);93;47;46
28;Madrid;140;Serranillos del Valle;478;246;232
28;Madrid;141;Sevilla la Nueva;1348;671;677
28;Madrid;143;Somosierra;108;69;39
28;Madrid;144;Soto del Real;2689;1356;1333
28;Madrid;145;Talamanca de Jarama;1100;557;543
28;Madrid;146;Tielmes;1946;992;954
28;Madrid;147;Titulcia;872;432;440
28;Madrid;148;Torrejón de Ardoz;82238;41271;40967
28;Madrid;149;Torrejón de la Calzada;1527;777;750
28;Madrid;150;Torrejón de Velasco;1490;771;719
28;Madrid;151;Torrelaguna;2553;1231;1322
28;Madrid;152;Torrelodones;7198;3573;3625
28;Madrid;153;Torremocha de Jarama;237;120;117
28;Madrid;154;Torres de la Alameda;2953;1481;1472
28;Madrid;903;Tres Cantos;"";"";""
28;Madrid;155;Valdaracete;677;330;347
28;Madrid;156;Valdeavero;507;262;245
28;Madrid;157;Valdelaguna;544;285;259
28;Madrid;158;Valdemanco;487;257;230
28;Madrid;159;Valdemaqueda;469;229;240
28;Madrid;160;Valdemorillo;2762;1414;1348
28;Madrid;161;Valdemoro;17806;8890;8916
28;Madrid;162;Valdeolmos-Alalpardo;1094;570;524
28;Madrid;163;Valdepiélagos;327;163;164
28;Madrid;164;Valdetorres de Jarama;1258;645;613
28;Madrid;165;Valdilecha;1615;806;809
28;Madrid;166;Valverde de Alcalá;225;122;103
28;Madrid;167;Velilla de San Antonio;2344;1189;1155
28;Madrid;168;Vellón (El);900;458;442
28;Madrid;169;Venturada;332;171;161
28;Madrid;171;Villa del Prado;3290;1648;1642
28;Madrid;170;Villaconejos;2898;1499;1399
28;Madrid;172;Villalbilla;1860;959;901
28;Madrid;173;Villamanrique de Tajo;552;273;279
28;Madrid;174;Villamanta;1205;606;599
28;Madrid;175;Villamantilla;299;150;149
28;Madrid;176;Villanueva de la Cañada;4302;2179;2123
28;Madrid;178;Villanueva de Perales;340;191;149
28;Madrid;177;Villanueva del Pardillo;2120;1058;1062
28;Madrid;179;Villar del Olmo;497;253;244
28;Madrid;180;Villarejo de Salvanés;4952;2471;2481
28;Madrid;181;Villaviciosa de Odón;13030;6329;6701
28;Madrid;182;Villavieja del Lozoya;158;77;81
28;Madrid;183;Zarzalejo;863;443;420
29;Málaga;001;Alameda;4804;2405;2399
29;Málaga;002;Alcaucín;1391;699;692
29;Málaga;003;Alfarnate;1525;793;732
29;Málaga;004;Alfarnatejo;435;238;197
29;Málaga;005;Algarrobo;4528;2293;2235
29;Málaga;006;Algatocín;1019;523;496
29;Málaga;007;Alhaurín de la Torre;12874;6471;6403
29;Málaga;008;Alhaurín el Grande;17257;8523;8734
29;Málaga;009;Almáchar;2010;1023;987
29;Málaga;010;Almargen;2239;1119;1120
29;Málaga;011;Almogía;3862;1962;1900
29;Málaga;012;Álora;13168;6608;6560
29;Málaga;013;Alozaina;2579;1351;1228
29;Málaga;014;Alpandeire;337;177;160
29;Málaga;015;Antequera;38765;18923;19842
29;Málaga;016;Árchez;333;183;150
29;Málaga;017;Archidona;10204;5123;5081
29;Málaga;018;Ardales;3201;1626;1575
29;Málaga;019;Arenas;1265;673;592
29;Málaga;020;Arriate;3301;1648;1653
29;Málaga;021;Atajate;164;91;73
29;Málaga;022;Benadalid;255;134;121
29;Málaga;023;Benahavís;1333;647;686
29;Málaga;024;Benalauría;526;274;252
29;Málaga;025;Benalmádena;21994;10900;11094
29;Málaga;026;Benamargosa;1654;838;816
29;Málaga;027;Benamocarra;2789;1411;1378
29;Málaga;028;Benaoján;1642;822;820
29;Málaga;029;Benarrabá;709;352;357
29;Málaga;030;Borge (El);1066;554;512
29;Málaga;031;Burgo (El);2117;1104;1013
29;Málaga;032;Campillos;7551;3800;3751
29;Málaga;033;Canillas de Aceituno;2793;1423;1370
29;Málaga;034;Canillas de Albaida;637;333;304
29;Málaga;035;Cañete la Real;2341;1213;1128
29;Málaga;036;Carratraca;819;407;412
29;Málaga;037;Cartajima;358;187;171
29;Málaga;038;Cártama;11054;5551;5503
29;Málaga;039;Casabermeja;3098;1635;1463
29;Málaga;040;Casarabonela;2554;1326;1228
29;Málaga;041;Casares;3286;1726;1560
29;Málaga;042;Coín;14855;7408;7447
29;Málaga;043;Colmenar;3173;1544;1629
29;Málaga;044;Comares;1460;759;701
29;Málaga;045;Cómpeta;2468;1229;1239
29;Málaga;046;Cortes de la Frontera;3747;1868;1879
29;Málaga;047;Cuevas Bajas;1550;738;812
29;Málaga;049;Cuevas de San Marcos;4081;2035;2046
29;Málaga;048;Cuevas del Becerro;2018;1044;974
29;Málaga;050;Cútar;613;315;298
29;Málaga;051;Estepona;34965;17492;17473
29;Málaga;052;Faraján;314;162;152
29;Málaga;053;Frigiliana;2169;1066;1103
29;Málaga;054;Fuengirola;37742;18510;19232
29;Málaga;055;Fuente de Piedra;1931;934;997
29;Málaga;056;Gaucín;1830;950;880
29;Málaga;057;Genalguacil;662;341;321
29;Málaga;058;Guaro;2009;1026;983
29;Málaga;059;Humilladero;2338;1171;1167
29;Málaga;060;Igualeja;1055;538;517
29;Málaga;061;Istán;1322;668;654
29;Málaga;062;Iznate;743;374;369
29;Málaga;063;Jimera de Líbar;482;241;241
29;Málaga;064;Jubrique;908;467;441
29;Málaga;065;Júzcar;252;142;110
29;Málaga;066;Macharaviaya;349;182;167
29;Málaga;067;Málaga;522108;251596;270512
29;Málaga;068;Manilva;4824;2467;2357
29;Málaga;069;Marbella;80599;39949;40650
29;Málaga;070;Mijas;31680;15812;15868
29;Málaga;071;Moclinejo;1075;550;525
29;Málaga;072;Mollina;3089;1507;1582
29;Málaga;073;Monda;1672;858;814
29;Málaga;074;Montejaque;1047;507;540
29;Málaga;075;Nerja;13604;6715;6889
29;Málaga;076;Ojén;1995;1043;952
29;Málaga;077;Parauta;303;150;153
29;Málaga;079;Periana;3374;1772;1602
29;Málaga;080;Pizarra;6426;3254;3172
29;Málaga;081;Pujerra;355;201;154
29;Málaga;082;Rincón de la Victoria;12601;6244;6357
29;Málaga;083;Riogordo;2537;1297;1240
29;Málaga;084;Ronda;33900;16726;17174
29;Málaga;085;Salares;238;122;116
29;Málaga;086;Sayalonga;1062;542;520
29;Málaga;087;Sedella;470;254;216
29;Málaga;088;Sierra de Yeguas;3165;1600;1565
29;Málaga;089;Teba;4387;2225;2162
29;Málaga;090;Tolox;3108;1608;1500
29;Málaga;901;Torremolinos;27543;13477;14066
29;Málaga;091;Torrox;10519;5345;5174
29;Málaga;092;Totalán;605;315;290
29;Málaga;093;Valle de Abdalajís;2999;1522;1477
29;Málaga;094;Vélez-Málaga;50999;25454;25545
29;Málaga;095;Villanueva de Algaidas;4256;2104;2152
29;Málaga;098;Villanueva de Tapia;1575;798;777
29;Málaga;096;Villanueva del Rosario;3177;1570;1607
29;Málaga;097;Villanueva del Trabuco;4365;2227;2138
29;Málaga;099;Viñuela;1154;579;575
29;Málaga;100;Yunquera;3159;1643;1516
30;Murcia;001;Abanilla;6074;2989;3085
30;Murcia;002;Abarán;11865;5879;5986
30;Murcia;003;Águilas;24894;12441;12453
30;Murcia;004;Albudeite;1411;707;704
30;Murcia;005;Alcantarilla;30144;14628;15516
30;Murcia;902;Alcázares (Los);3683;1792;1891
30;Murcia;006;Aledo;985;512;473
30;Murcia;007;Alguazas;6931;3430;3501
30;Murcia;008;Alhama de Murcia;14175;6986;7189
30;Murcia;009;Archena;13487;6704;6783
30;Murcia;010;Beniel;7220;3591;3629
30;Murcia;011;Blanca;5768;2815;2953
30;Murcia;012;Bullas;10009;5045;4964
30;Murcia;013;Calasparra;8745;4372;4373
30;Murcia;014;Campos del Río;1949;964;985
30;Murcia;015;Caravaca de la Cruz;21296;10551;10745
30;Murcia;016;Cartagena;168023;82880;85143
30;Murcia;017;Cehegín;13614;6779;6835
30;Murcia;018;Ceutí;6411;3226;3185
30;Murcia;019;Cieza;30875;15067;15808
30;Murcia;020;Fortuna;6004;3029;2975
30;Murcia;021;Fuente Álamo de Murcia;8279;4120;4159
30;Murcia;022;Jumilla;20092;9967;10125
30;Murcia;023;Librilla;3764;1835;1929
30;Murcia;024;Lorca;65919;32477;33442
30;Murcia;025;Lorquí;5328;2625;2703
30;Murcia;026;Mazarrón;14591;7320;7271
30;Murcia;027;Molina de Segura;37806;18595;19211
30;Murcia;028;Moratalla;8976;4545;4431
30;Murcia;029;Mula;13053;6489;6564
30;Murcia;030;Murcia;328100;159454;168646
30;Murcia;031;Ojós;678;333;345
30;Murcia;032;Pliego;3327;1689;1638
30;Murcia;033;Puerto Lumbreras;9961;4844;5117
30;Murcia;034;Ricote;1689;822;867
30;Murcia;035;San Javier;14696;7304;7392
30;Murcia;036;San Pedro del Pinatar;12057;5965;6092
30;Murcia;901;Santomera;8518;4243;4275
30;Murcia;037;Torre-Pacheco;16568;8338;8230
30;Murcia;038;Torres de Cotillas (Las);14132;7098;7034
30;Murcia;039;Totana;20466;10160;10306
30;Murcia;040;Ulea;1073;542;531
30;Murcia;041;Unión (La);13940;6932;7008
30;Murcia;042;Villanueva del Río Segura;1663;838;825
30;Murcia;043;Yecla;27362;13605;13757
31;Navarra;001;Abáigar;95;50;45
31;Navarra;002;Abárzuza;497;239;258
31;Navarra;003;Abaurregaina/Abaurrea Alta;224;127;97
31;Navarra;004;Abaurrepea/Abaurrea Baja;53;36;17
31;Navarra;005;Aberin;377;193;184
31;Navarra;006;Ablitas;2264;1162;1102
31;Navarra;007;Adiós;114;58;56
31;Navarra;008;Aguilar de Codés;110;61;49
31;Navarra;009;Aibar/Oibar;965;491;474
31;Navarra;011;Allín;805;417;388
31;Navarra;012;Allo;1116;551;565
31;Navarra;010;Altsasu/Alsasua;6925;3519;3406
31;Navarra;013;Améscoa Baja;860;443;417
31;Navarra;014;Ancín;293;152;141
31;Navarra;015;Andosilla;2450;1220;1230
31;Navarra;016;Ansoáin;11196;5647;5549
31;Navarra;017;Anue;431;247;184
31;Navarra;018;Añorbe;410;227;183
31;Navarra;019;Aoiz/Agoitz;1896;930;966
31;Navarra;020;Araitz;631;368;263
31;Navarra;025;Arakil;2766;1453;1313
31;Navarra;021;Aranarache;106;51;55
31;Navarra;023;Aranguren;1608;862;746
31;Navarra;024;Arano;168;92;76
31;Navarra;022;Arantza;722;404;318
31;Navarra;026;Aras;232;118;114
31;Navarra;027;Arbizu;918;488;430
31;Navarra;028;Arce/Artzi;259;139;120
31;Navarra;029;Arcos (Los);1379;689;690
31;Navarra;030;Arellano;220;120;100
31;Navarra;031;Areso;277;149;128
31;Navarra;032;Arguedas;2278;1126;1152
31;Navarra;033;Aria;78;49;29
31;Navarra;034;Aribe;78;42;36
31;Navarra;035;Armañanzas;109;55;54
31;Navarra;036;Arróniz;1234;668;566
31;Navarra;037;Arruazu;118;63;55
31;Navarra;038;Artajona;1701;890;811
31;Navarra;039;Artazu;94;50;44
31;Navarra;040;Atez;194;117;77
31;Navarra;058;Auritz/Burguete;297;137;160
31;Navarra;041;Ayegui;745;380;365
31;Navarra;042;Azagra;3288;1631;1657
31;Navarra;043;Azuelo;72;38;34
31;Navarra;044;Bakaiku;358;201;157
31;Navarra;901;Barañain;16474;8161;8313
31;Navarra;045;Barásoain;421;216;205
31;Navarra;046;Barbarin;119;53;66
31;Navarra;047;Bargota;423;216;207
31;Navarra;048;Barillas;210;100;110
31;Navarra;049;Basaburua;733;415;318
31;Navarra;050;Baztan;7959;4006;3953
31;Navarra;137;Beintza-Labaien;321;188;133
31;Navarra;051;Beire;349;166;183
31;Navarra;052;Belascoáin;85;44;41
31;Navarra;250;Bera/Vera de Bidasoa;3502;1783;1719
31;Navarra;053;Berbinzana;736;368;368
31;Navarra;905;Beriáin;"";"";""
31;Navarra;902;Berrioplano;"";"";""
31;Navarra;903;Berriozar;"";"";""
31;Navarra;054;Bertizarana;658;324;334
31;Navarra;055;Betelu;341;189;152
31;Navarra;253;Bidaurreta;110;65;45
31;Navarra;056;Biurrun-Olcoz;169;92;77
31;Navarra;057;Buñuel;2387;1164;1223
31;Navarra;059;Burgui/Burgi;258;145;113
31;Navarra;060;Burlada/Burlata;15003;7482;7521
31;Navarra;061;Busto (El);118;56;62
31;Navarra;062;Cabanillas;1426;717;709
31;Navarra;063;Cabredo;143;75;68
31;Navarra;064;Cadreita;1867;903;964
31;Navarra;065;Caparroso;2383;1162;1221
31;Navarra;066;Cárcar;1242;611;631
31;Navarra;067;Carcastillo;2572;1301;1271
31;Navarra;068;Cascante;3487;1693;1794
31;Navarra;069;Cáseda;1124;554;570
31;Navarra;070;Castejón;3151;1596;1555
31;Navarra;071;Castillonuevo;19;12;7
31;Navarra;072;Cintruénigo;5313;2652;2661
31;Navarra;074;Cirauqui;470;260;210
31;Navarra;075;Ciriza;57;26;31
31;Navarra;076;Cizur;6504;3273;3231
31;Navarra;077;Corella;6214;3085;3129
31;Navarra;078;Cortes;3277;1650;1627
31;Navarra;079;Desojo;167;85;82
31;Navarra;080;Dicastillo;743;394;349
31;Navarra;081;Donamaria;355;178;177
31;Navarra;221;Doneztebe/Santesteban;1191;598;593
31;Navarra;083;Echarri;70;40;30
31;Navarra;086;Egüés;1125;557;568
31;Navarra;087;Elgorriaga;179;90;89
31;Navarra;089;Enériz;189;97;92
31;Navarra;090;Eratsun;195;119;76
31;Navarra;091;Ergoiena;520;291;229
31;Navarra;092;Erro;761;404;357
31;Navarra;094;Eslava;210;108;102
31;Navarra;095;Esparza de Salazar;136;72;64
31;Navarra;096;Espronceda;194;113;81
31;Navarra;097;Estella/Lizarra;12741;6182;6559
31;Navarra;098;Esteribar;1412;755;657
31;Navarra;099;Etayo;99;51;48
31;Navarra;082;Etxalar;859;442;417
31;Navarra;084;Etxarri-Aranatz;2329;1206;1123
31;Navarra;085;Etxauri;411;205;206
31;Navarra;100;Eulate;406;210;196
31;Navarra;101;Ezcabarte;946;499;447
31;Navarra;093;Ezcároz/Ezkaroze;365;194;171
31;Navarra;102;Ezkurra;268;160;108
31;Navarra;103;Ezprogui;76;38;38
31;Navarra;104;Falces;2738;1355;1383
31;Navarra;105;Fitero;2181;1086;1095
31;Navarra;106;Fontellas;543;270;273
31;Navarra;107;Funes;2150;1069;1081
31;Navarra;108;Fustiñana;2312;1176;1136
31;Navarra;109;Galar;3145;1598;1547
31;Navarra;110;Gallipienzo;181;100;81
31;Navarra;111;Gallués/Galoze;133;82;51
31;Navarra;112;Garaioa;147;79;68
31;Navarra;113;Garde;217;113;104
31;Navarra;114;Garínoain;293;154;139
31;Navarra;115;Garralda;245;130;115
31;Navarra;116;Genevilla;115;60;55
31;Navarra;117;Goizueta;1034;562;472
31;Navarra;118;Goñi;207;113;94
31;Navarra;119;Güesa/Gorza;90;50;40
31;Navarra;120;Guesálaz;453;259;194
31;Navarra;121;Guirguillano;76;42;34
31;Navarra;256;Hiriberri/Villanueva de Aezkoa;175;92;83
31;Navarra;122;Huarte/Uharte;2771;1388;1383
31;Navarra;124;Ibargoiti;214;126;88
31;Navarra;259;Igantzi;591;306;285
31;Navarra;125;Igúzquiza;353;172;181
31;Navarra;126;Imotz;432;235;197
31;Navarra;127;Irañeta;159;88;71
31;Navarra;904;Irurtzun;"";"";""
31;Navarra;128;Isaba/Izaba;586;288;298
31;Navarra;129;Ituren;482;242;240
31;Navarra;130;Iturmendi;360;186;174
31;Navarra;131;Iza;635;330;305
31;Navarra;132;Izagaondoa;189;106;83
31;Navarra;133;Izalzu/Itzaltzu;49;25;24
31;Navarra;134;Jaurrieta;321;164;157
31;Navarra;135;Javier;158;71;87
31;Navarra;136;Juslapeña;424;231;193
31;Navarra;138;Lakuntza;960;507;453
31;Navarra;139;Lana;218;121;97
31;Navarra;140;Lantz;112;66;46
31;Navarra;141;Lapoblación;171;96;75
31;Navarra;142;Larraga;1892;990;902
31;Navarra;143;Larraona;188;96;92
31;Navarra;144;Larraun;1926;1033;893
31;Navarra;145;Lazagurría;250;131;119
31;Navarra;146;Leache;65;37;28
31;Navarra;147;Legarda;73;40;33
31;Navarra;148;Legaria;176;91;85
31;Navarra;149;Leitza;3161;1644;1517
31;Navarra;908;Lekunberri;"";"";""
31;Navarra;150;Leoz;196;113;83
31;Navarra;151;Lerga;113;59;54
31;Navarra;152;Lerín;2059;1025;1034
31;Navarra;153;Lesaka;2756;1442;1314
31;Navarra;154;Lezáun;281;156;125
31;Navarra;155;Liédena;338;161;177
31;Navarra;156;Lizoáin;230;127;103
31;Navarra;157;Lodosa;4499;2254;2245
31;Navarra;158;Lónguida/Longida;316;169;147
31;Navarra;159;Lumbier;1540;818;722
31;Navarra;160;Luquin;140;76;64
31;Navarra;248;Luzaide/Valcarlos;540;269;271
31;Navarra;161;Mañeru;362;181;181
31;Navarra;162;Marañón;87;45;42
31;Navarra;163;Marcilla;2337;1162;1175
31;Navarra;164;Mélida;908;461;447
31;Navarra;165;Mendavia;3568;1798;1770
31;Navarra;166;Mendaza;439;205;234
31;Navarra;167;Mendigorría;994;519;475
31;Navarra;168;Metauten;323;167;156
31;Navarra;169;Milagro;2573;1276;1297
31;Navarra;170;Mirafuentes;53;23;30
31;Navarra;171;Miranda de Arga;1002;495;507
31;Navarra;172;Monreal;307;150;157
31;Navarra;173;Monteagudo;1186;587;599
31;Navarra;174;Morentin;135;66;69
31;Navarra;175;Mues;133;67;66
31;Navarra;176;Murchante;2884;1421;1463
31;Navarra;177;Murieta;284;160;124
31;Navarra;178;Murillo el Cuende;657;347;310
31;Navarra;179;Murillo el Fruto;837;423;414
31;Navarra;180;Muruzábal;200;103;97
31;Navarra;181;Navascués;264;161;103
31;Navarra;182;Nazar;53;30;23
31;Navarra;088;Noáin (Valle de Elorz)/Noain (Elortzibar);3702;1857;1845
31;Navarra;183;Obanos;704;341;363
31;Navarra;185;Ochagavía;676;355;321
31;Navarra;184;Oco;95;57;38
31;Navarra;186;Odieta;318;173;145
31;Navarra;187;Oitz;161;99;62
31;Navarra;188;Olaibar;170;94;76
31;Navarra;189;Olazti/Olazagutía;1713;889;824
31;Navarra;190;Olejua;66;35;31
31;Navarra;191;Olite;3042;1514;1528
31;Navarra;194;Ollo;361;205;156
31;Navarra;192;Olóriz;171;98;73
31;Navarra;193;Olza;2268;1166;1102
31;Navarra;195;Orbaitzeta;258;143;115
31;Navarra;196;Orbara;62;32;30
31;Navarra;906;Orcoyen;"";"";""
31;Navarra;197;Orísoain;102;55;47
31;Navarra;198;Oronz;57;32;25
31;Navarra;199;Oroz-Betelu;232;121;111
31;Navarra;211;Orreaga/Roncesvalles;35;20;15
31;Navarra;200;Oteiza;936;480;456
31;Navarra;201;Pamplona/Iruña;180372;86636;93736
31;Navarra;202;Peralta;4602;2260;2342
31;Navarra;203;Petilla de Aragón;51;26;25
31;Navarra;204;Piedramillera;86;47;39
31;Navarra;205;Pitillas;658;332;326
31;Navarra;206;Puente la Reina/Gares;2124;1051;1073
31;Navarra;207;Pueyo;332;170;162
31;Navarra;208;Ribaforada;3095;1570;1525
31;Navarra;209;Romanzado;158;91;67
31;Navarra;210;Roncal/Erronkari;387;194;193
31;Navarra;212;Sada;280;150;130
31;Navarra;213;Saldías;170;93;77
31;Navarra;214;Salinas de Oro;103;57;46
31;Navarra;215;San Adrián;5106;2489;2617
31;Navarra;217;San Martín de Unx;534;281;253
31;Navarra;216;Sangüesa/Zangoza;4583;2332;2251
31;Navarra;219;Sansol;150;77;73
31;Navarra;220;Santacara;1092;555;537
31;Navarra;222;Sarriés/Sartze;111;62;49
31;Navarra;223;Sartaguda;1412;709;703
31;Navarra;224;Sesma;1495;745;750
31;Navarra;225;Sorlada;64;33;31
31;Navarra;226;Sunbilla;710;369;341
31;Navarra;227;Tafalla;10172;5011;5161
31;Navarra;228;Tiebas-Muruarte de Reta;590;316;274
31;Navarra;229;Tirapu;69;37;32
31;Navarra;230;Torralba del Río;177;97;80
31;Navarra;231;Torres del Río;224;108;116
31;Navarra;232;Tudela;26461;12957;13504
31;Navarra;233;Tulebras;112;43;69
31;Navarra;234;Ucar;115;61;54
31;Navarra;123;Uharte-Arakil;853;448;405
31;Navarra;235;Ujué;294;158;136
31;Navarra;236;Ultzama;1655;853;802
31;Navarra;237;Unciti;229;107;122
31;Navarra;238;Unzué;144;75;69
31;Navarra;239;Urdazubi/Urdax;459;229;230
31;Navarra;240;Urdiain;690;358;332
31;Navarra;241;Urraul Alto;156;93;63
31;Navarra;242;Urraul Bajo;281;129;152
31;Navarra;244;Urrotz;219;126;93
31;Navarra;243;Urroz;364;187;177
31;Navarra;245;Urzainqui;120;64;56
31;Navarra;246;Uterga;142;69;73
31;Navarra;247;Uztárroz/Uztarroze;324;158;166
31;Navarra;249;Valtierra;2508;1243;1265
31;Navarra;251;Viana;3365;1697;1668
31;Navarra;252;Vidángoz/Bidankoze;111;55;56
31;Navarra;254;Villafranca;2583;1237;1346
31;Navarra;255;Villamayor de Monjardín;115;65;50
31;Navarra;257;Villatuerta;797;400;397
31;Navarra;258;Villava/Atarrabia;7528;3811;3717
31;Navarra;260;Yerri;1551;822;729
31;Navarra;261;Yesa;293;165;128
31;Navarra;262;Zabalza;140;63;77
31;Navarra;073;Ziordia;388;182;206
31;Navarra;907;Zizur Mayor/Zizur Nagusia;"";"";""
31;Navarra;263;Zubieta;326;192;134
31;Navarra;264;Zugarramurdi;267;144;123
31;Navarra;265;Zúñiga;123;66;57
32;Ourense;001;Allariz;5323;2546;2777
32;Ourense;002;Amoeiro;2329;1123;1206
32;Ourense;003;Arnoia (A);1096;517;579
32;Ourense;004;Avión;3549;1621;1928
32;Ourense;005;Baltar;1867;922;945
32;Ourense;006;Bande;2818;1339;1479
32;Ourense;007;Baños de Molgas;3169;1569;1600
32;Ourense;008;Barbadás;3851;1850;2001
32;Ourense;009;Barco de Valdeorras (O);10495;5193;5302
32;Ourense;010;Beade;885;441;444
32;Ourense;011;Beariz;1883;848;1035
32;Ourense;012;Blancos (Os);1272;629;643
32;Ourense;013;Boborás;3888;1776;2112
32;Ourense;014;Bola (A);1772;836;936
32;Ourense;015;Bolo (O);1918;967;951
32;Ourense;016;Calvos de Randín;2044;1036;1008
32;Ourense;018;Carballeda de Avia;1888;903;985
32;Ourense;017;Carballeda de Valdeorras;2697;1382;1315
32;Ourense;019;Carballiño (O);11134;5241;5893
32;Ourense;020;Cartelle;4125;2000;2125
32;Ourense;022;Castrelo de Miño;3605;1774;1831
32;Ourense;021;Castrelo do Val;1463;721;742
32;Ourense;023;Castro Caldelas;2111;1071;1040
32;Ourense;024;Celanova;5983;2838;3145
32;Ourense;025;Cenlle;1917;887;1030
32;Ourense;029;Chandrexa de Queixa;1100;581;519
32;Ourense;026;Coles;3226;1569;1657
32;Ourense;027;Cortegada;1605;770;835
32;Ourense;028;Cualedro;2658;1341;1317
32;Ourense;030;Entrimo;1696;764;932
32;Ourense;031;Esgos;1468;694;774
32;Ourense;033;Gomesende;1433;669;764
32;Ourense;034;Gudiña (A);2037;1021;1016
32;Ourense;035;Irixo (O);2547;1168;1379
32;Ourense;038;Larouco;693;327;366
32;Ourense;039;Laza;2366;1168;1198
32;Ourense;040;Leiro;2240;1075;1165
32;Ourense;041;Lobeira;1468;702;766
32;Ourense;042;Lobios;3266;1565;1701
32;Ourense;043;Maceda;3400;1627;1773
32;Ourense;044;Manzaneda;1620;826;794
32;Ourense;045;Maside;3648;1695;1953
32;Ourense;046;Melón;1784;783;1001
32;Ourense;047;Merca (A);2747;1308;1439
32;Ourense;048;Mezquita (A);1849;927;922
32;Ourense;049;Montederramo;1523;783;740
32;Ourense;050;Monterrei;3721;1858;1863
32;Ourense;051;Muíños;2332;1127;1205
32;Ourense;052;Nogueira de Ramuín;2802;1329;1473
32;Ourense;053;Oímbra;2095;1045;1050
32;Ourense;054;Ourense;102758;48649;54109
32;Ourense;055;Paderne de Allariz;1820;857;963
32;Ourense;056;Padrenda;2919;1375;1544
32;Ourense;057;Parada de Sil;1088;530;558
32;Ourense;058;Pereiro de Aguiar (O);4711;2264;2447
32;Ourense;059;Peroxa (A);2871;1372;1499
32;Ourense;060;Petín;1312;629;683
32;Ourense;061;Piñor;1854;923;931
32;Ourense;063;Pobra de Trives (A);3110;1529;1581
32;Ourense;064;Pontedeva;862;413;449
32;Ourense;062;Porqueira;1311;644;667
32;Ourense;065;Punxín;1054;487;567
32;Ourense;066;Quintela de Leirado;1047;468;579
32;Ourense;067;Rairiz de Veiga;2368;1183;1185
32;Ourense;068;Ramirás;2156;991;1165
32;Ourense;069;Ribadavia;6086;2908;3178
32;Ourense;071;Riós;2577;1299;1278
32;Ourense;072;Rúa (A);5051;2509;2542
32;Ourense;073;Rubiá;2220;1121;1099
32;Ourense;074;San Amaro;1647;798;849
32;Ourense;075;San Cibrao das Viñas;3322;1591;1731
32;Ourense;076;San Cristovo de Cea;3814;1867;1947
32;Ourense;070;San Xoán de Río;1363;666;697
32;Ourense;077;Sandiás;1944;916;1028
32;Ourense;078;Sarreaus;2684;1328;1356
32;Ourense;079;Taboadela;1871;915;956
32;Ourense;080;Teixeira (A);743;363;380
32;Ourense;081;Toén;2760;1366;1394
32;Ourense;082;Trasmiras;2306;1136;1170
32;Ourense;083;Veiga (A);1748;867;881
32;Ourense;084;Verea;1845;876;969
32;Ourense;085;Verín;11279;5468;5811
32;Ourense;086;Viana do Bolo;4672;2389;2283
32;Ourense;087;Vilamarín;2286;1107;1179
32;Ourense;088;Vilamartín de Valdeorras;2554;1276;1278
32;Ourense;089;Vilar de Barrio;2633;1320;1313
32;Ourense;090;Vilar de Santos;1495;758;737
32;Ourense;091;Vilardevós;3264;1651;1613
32;Ourense;092;Vilariño de Conso;936;517;419
32;Ourense;032;Xinzo de Limia;9170;4472;4698
32;Ourense;036;Xunqueira de Ambía;2358;1155;1203
32;Ourense;037;Xunqueira de Espadanedo;1216;578;638
33;Asturias;001;Allande;2837;1478;1359
33;Asturias;002;Aller;17538;8687;8851
33;Asturias;003;Amieva;1001;523;478
33;Asturias;004;Avilés;85351;41432;43919
33;Asturias;005;Belmonte de Miranda;2828;1444;1384
33;Asturias;006;Bimenes;2550;1195;1355
33;Asturias;007;Boal;3004;1497;1507
33;Asturias;008;Cabrales;2543;1286;1257
33;Asturias;009;Cabranes;1488;710;778
33;Asturias;010;Candamo;2947;1439;1508
33;Asturias;012;Cangas de Onís;6404;3163;3241
33;Asturias;011;Cangas del Narcea;19225;9847;9378
33;Asturias;013;Caravia;603;305;298
33;Asturias;014;Carreño;11062;5359;5703
33;Asturias;015;Caso;2104;1072;1032
33;Asturias;016;Castrillón;21235;10328;10907
33;Asturias;017;Castropol;5012;2420;2592
33;Asturias;018;Coaña;4021;1922;2099
33;Asturias;019;Colunga;5100;2489;2611
33;Asturias;020;Corvera de Asturias;17167;8545;8622
33;Asturias;021;Cudillero;6657;3296;3361
33;Asturias;022;Degaña;1696;892;804
33;Asturias;023;Franco (El);4268;2083;2185
33;Asturias;024;Gijón;259067;123485;135582
33;Asturias;025;Gozón;11570;5616;5954
33;Asturias;026;Grado;12045;5860;6185
33;Asturias;027;Grandas de Salime;1479;763;716
33;Asturias;028;Ibias;2502;1353;1149
33;Asturias;029;Illano;779;401;378
33;Asturias;030;Illas;1299;680;619
33;Asturias;031;Langreo;51710;24800;26910
33;Asturias;032;Laviana;15239;7471;7768
33;Asturias;033;Lena;14135;6940;7195
33;Asturias;035;Llanera;10457;5123;5334
33;Asturias;036;Llanes;13348;6351;6997
33;Asturias;037;Mieres;53482;25950;27532
33;Asturias;038;Morcín;3074;1538;1536
33;Asturias;039;Muros de Nalón;2622;1230;1392
33;Asturias;040;Nava;5665;2767;2898
33;Asturias;041;Navia;9116;4386;4730
33;Asturias;042;Noreña;4190;1969;2221
33;Asturias;043;Onís;1060;530;530
33;Asturias;044;Oviedo;196051;91956;104095
33;Asturias;045;Parres;5774;2841;2933
33;Asturias;046;Peñamellera Alta;896;439;457
33;Asturias;047;Peñamellera Baja;1803;889;914
33;Asturias;048;Pesoz;343;172;171
33;Asturias;049;Piloña;9672;4700;4972
33;Asturias;050;Ponga;901;499;402
33;Asturias;051;Pravia;10016;4809;5207
33;Asturias;052;Proaza;1017;497;520
33;Asturias;053;Quirós;1805;923;882
33;Asturias;054;Regueras (Las);2427;1199;1228
33;Asturias;055;Ribadedeva;2045;987;1058
33;Asturias;056;Ribadesella;6364;3026;3338
33;Asturias;057;Ribera de Arriba;2198;1082;1116
33;Asturias;058;Riosa;2836;1468;1368
33;Asturias;059;Salas;8157;4044;4113
33;Asturias;061;San Martín de Oscos;621;330;291
33;Asturias;060;San Martín del Rey Aurelio;23765;11509;12256
33;Asturias;063;San Tirso de Abres;746;381;365
33;Asturias;062;Santa Eulalia de Oscos;664;344;320
33;Asturias;064;Santo Adriano;394;190;204
33;Asturias;065;Sariego;1478;739;739
33;Asturias;066;Siero;44033;21351;22682
33;Asturias;067;Sobrescobio;824;421;403
33;Asturias;068;Somiedo;1793;928;865
33;Asturias;069;Soto del Barco;4675;2235;2440
33;Asturias;070;Tapia de Casariego;4475;2150;2325
33;Asturias;071;Taramundi;1035;503;532
33;Asturias;072;Teverga;2627;1332;1295
33;Asturias;073;Tineo;14927;7557;7370
33;Asturias;034;Valdés;16969;8325;8644
33;Asturias;074;Vegadeo;5138;2457;2681
33;Asturias;075;Villanueva de Oscos;480;248;232
33;Asturias;076;Villaviciosa;15045;7374;7671
33;Asturias;077;Villayón;2268;1165;1103
33;Asturias;078;Yernes y Tameza;195;93;102
34;Palencia;001;Abarca de Campos;44;20;24
34;Palencia;003;Abia de las Torres;239;125;114
34;Palencia;004;Aguilar de Campoo;7496;3681;3815
34;Palencia;005;Alar del Rey;1574;744;830
34;Palencia;006;Alba de Cerrato;144;70;74
34;Palencia;009;Amayuelas de Arriba;63;37;26
34;Palencia;010;Ampudia;851;441;410
34;Palencia;011;Amusco;616;334;282
34;Palencia;012;Antigüedad;426;228;198
34;Palencia;015;Arconada;110;54;56
34;Palencia;017;Astudillo;1450;752;698
34;Palencia;018;Autilla del Pino;301;157;144
34;Palencia;019;Autillo de Campos;214;97;117
34;Palencia;020;Ayuela;100;55;45
34;Palencia;022;Baltanás;1647;846;801
34;Palencia;024;Baquerín de Campos;45;27;18
34;Palencia;025;Bárcena de Campos;68;30;38
34;Palencia;027;Barruelo de Santullán;2196;1028;1168
34;Palencia;028;Báscones de Ojeda;223;113;110
34;Palencia;029;Becerril de Campos;1252;610;642
34;Palencia;031;Belmonte de Campos;64;30;34
34;Palencia;032;Berzosilla;90;45;45
34;Palencia;033;Boada de Campos;32;15;17
34;Palencia;035;Boadilla de Rioseco;215;112;103
34;Palencia;034;Boadilla del Camino;217;112;105
34;Palencia;036;Brañosera;321;164;157
34;Palencia;037;Buenavista de Valdavia;487;238;249
34;Palencia;038;Bustillo de la Vega;414;220;194
34;Palencia;039;Bustillo del Páramo de Carrión;117;62;55
34;Palencia;041;Calahorra de Boedo;166;80;86
34;Palencia;042;Calzada de los Molinos;417;225;192
34;Palencia;045;Capillas;160;75;85
34;Palencia;046;Cardeñosa de Volpejera;60;29;31
34;Palencia;047;Carrión de los Condes;2519;1192;1327
34;Palencia;048;Castil de Vela;132;64;68
34;Palencia;049;Castrejón de la Peña;772;412;360
34;Palencia;050;Castrillo de Don Juan;404;218;186
34;Palencia;051;Castrillo de Onielo;215;108;107
34;Palencia;052;Castrillo de Villavega;340;171;169
34;Palencia;053;Castromocho;306;159;147
34;Palencia;055;Cervatos de la Cueza;431;220;211
34;Palencia;056;Cervera de Pisuerga;2953;1483;1470
34;Palencia;057;Cevico de la Torre;767;373;394
34;Palencia;058;Cevico Navero;320;168;152
34;Palencia;059;Cisneros;693;338;355
34;Palencia;060;Cobos de Cerrato;263;133;130
34;Palencia;061;Collazos de Boedo;186;101;85
34;Palencia;062;Congosto de Valdavia;302;165;137
34;Palencia;063;Cordovilla la Real;143;82;61
34;Palencia;066;Cubillas de Cerrato;130;65;65
34;Palencia;067;Dehesa de Montejo;344;193;151
34;Palencia;068;Dehesa de Romanos;68;36;32
34;Palencia;069;Dueñas;3090;1601;1489
34;Palencia;070;Espinosa de Cerrato;314;158;156
34;Palencia;071;Espinosa de Villagonzalo;329;159;170
34;Palencia;072;Frechilla;292;139;153
34;Palencia;073;Fresno del Río;218;113;105
34;Palencia;074;Frómista;1070;548;522
34;Palencia;076;Fuentes de Nava;936;462;474
34;Palencia;077;Fuentes de Valdepero;247;128;119
34;Palencia;079;Grijota;810;404;406
34;Palencia;080;Guardo;9458;4814;4644
34;Palencia;081;Guaza de Campos;111;57;54
34;Palencia;082;Hérmedes de Cerrato;158;73;85
34;Palencia;083;Herrera de Pisuerga;2902;1448;1454
34;Palencia;084;Herrera de Valdecañas;207;100;107
34;Palencia;086;Hontoria de Cerrato;134;69;65
34;Palencia;087;Hornillos de Cerrato;177;85;92
34;Palencia;088;Husillos;218;117;101
34;Palencia;089;Itero de la Vega;280;149;131
34;Palencia;091;Lagartos;207;114;93
34;Palencia;092;Lantadilla;622;304;318
34;Palencia;094;Ledigos;130;65;65
34;Palencia;903;Loma de Ucieza;380;192;188
34;Palencia;096;Lomas;73;36;37
34;Palencia;098;Magaz de Pisuerga;721;369;352
34;Palencia;099;Manquillos;98;54;44
34;Palencia;100;Mantinos;221;119;102
34;Palencia;101;Marcilla de Campos;92;40;52
34;Palencia;102;Mazariegos;278;150;128
34;Palencia;103;Mazuecos de Valdeginate;158;76;82
34;Palencia;104;Melgar de Yuso;483;261;222
34;Palencia;106;Meneses de Campos;184;97;87
34;Palencia;107;Micieces de Ojeda;135;67;68
34;Palencia;108;Monzón de Campos;920;477;443
34;Palencia;109;Moratinos;106;54;52
34;Palencia;110;Mudá;178;89;89
34;Palencia;112;Nogal de las Huertas;104;59;45
34;Palencia;113;Olea de Boedo;54;24;30
34;Palencia;114;Olmos de Ojeda;470;257;213
34;Palencia;116;Osornillo;121;64;57
34;Palencia;901;Osorno la Mayor;1864;968;896
34;Palencia;120;Palencia;77863;37527;40336
34;Palencia;121;Palenzuela;403;224;179
34;Palencia;122;Páramo de Boedo;137;68;69
34;Palencia;123;Paredes de Nava;2628;1300;1328
34;Palencia;124;Payo de Ojeda;103;55;48
34;Palencia;125;Pedraza de Campos;162;87;75
34;Palencia;126;Pedrosa de la Vega;444;238;206
34;Palencia;127;Perales;165;83;82
34;Palencia;904;Pernía (La);539;288;251
34;Palencia;129;Pino del Río;290;164;126
34;Palencia;130;Piña de Campos;363;190;173
34;Palencia;131;Población de Arroyo;112;61;51
34;Palencia;132;Población de Campos;253;137;116
34;Palencia;133;Población de Cerrato;146;77;69
34;Palencia;134;Polentinos;129;66;63
34;Palencia;135;Pomar de Valdivia;650;321;329
34;Palencia;136;Poza de la Vega;317;177;140
34;Palencia;137;Pozo de Urama;50;26;24
34;Palencia;139;Prádanos de Ojeda;268;135;133
34;Palencia;140;Puebla de Valdavia (La);209;102;107
34;Palencia;141;Quintana del Puente;342;169;173
34;Palencia;143;Quintanilla de Onsoña;306;170;136
34;Palencia;146;Reinoso de Cerrato;101;56;45
34;Palencia;147;Renedo de la Vega;310;169;141
34;Palencia;149;Requena de Campos;59;30;29
34;Palencia;151;Respenda de la Peña;342;178;164
34;Palencia;152;Revenga de Campos;208;98;110
34;Palencia;154;Revilla de Collazos;117;67;50
34;Palencia;155;Ribas de Campos;239;128;111
34;Palencia;156;Riberos de la Cueza;98;53;45
34;Palencia;157;Saldaña;3173;1650;1523
34;Palencia;158;Salinas de Pisuerga;294;160;134
34;Palencia;159;San Cebrián de Campos;538;305;233
34;Palencia;160;San Cebrián de Mudá;270;134;136
34;Palencia;161;San Cristóbal de Boedo;56;32;24
34;Palencia;163;San Mamés de Campos;138;64;74
34;Palencia;165;San Román de la Cuba;147;77;70
34;Palencia;167;Santa Cecilia del Alcor;177;93;84
34;Palencia;168;Santa Cruz de Boedo;97;49;48
34;Palencia;169;Santervás de la Vega;629;344;285
34;Palencia;170;Santibáñez de Ecla;120;48;72
34;Palencia;171;Santibáñez de la Peña;1912;959;953
34;Palencia;174;Santoyo;329;160;169
34;Palencia;175;Serna (La);147;80;67
34;Palencia;177;Soto de Cerrato;246;125;121
34;Palencia;176;Sotobañado y Priorato;216;116;100
34;Palencia;178;Tabanera de Cerrato;208;105;103
34;Palencia;179;Tabanera de Valdavia;61;27;34
34;Palencia;180;Támara de Campos;104;51;53
34;Palencia;181;Tariego de Cerrato;549;279;270
34;Palencia;182;Torquemada;1367;685;682
34;Palencia;184;Torremormojón;76;34;42
34;Palencia;185;Triollo;124;69;55
34;Palencia;186;Valbuena de Pisuerga;92;52;40
34;Palencia;189;Valdeolmillos;105;49;56
34;Palencia;190;Valderrábano;125;67;58
34;Palencia;192;Valde-Ucieza;163;93;70
34;Palencia;196;Valle de Cerrato;167;89;78
34;Palencia;902;Valle del Retortillo;294;141;153
34;Palencia;199;Velilla del Río Carrión;2103;1069;1034
34;Palencia;023;Venta de Baños;7046;3494;3552
34;Palencia;201;Vertavillo;299;166;133
34;Palencia;093;Vid de Ojeda (La);164;94;70
34;Palencia;202;Villabasta de Valdavia;49;21;28
34;Palencia;204;Villacidaler;95;49;46
34;Palencia;205;Villaconancio;94;51;43
34;Palencia;206;Villada;1473;712;761
34;Palencia;208;Villaeles de Valdavia;107;60;47
34;Palencia;210;Villahán;173;98;75
34;Palencia;211;Villaherreros;339;162;177
34;Palencia;213;Villalaco;99;45;54
34;Palencia;214;Villalba de Guardo;229;124;105
34;Palencia;215;Villalcázar de Sirga;248;115;133
34;Palencia;216;Villalcón;107;54;53
34;Palencia;217;Villalobón;257;134;123
34;Palencia;218;Villaluenga de la Vega;762;430;332
34;Palencia;220;Villamartín de Campos;176;89;87
34;Palencia;221;Villamediana;281;147;134
34;Palencia;222;Villameriel;191;99;92
34;Palencia;223;Villamoronta;362;191;171
34;Palencia;224;Villamuera de la Cueza;103;58;45
34;Palencia;225;Villamuriel de Cerrato;3978;2033;1945
34;Palencia;227;Villanueva del Rebollar;119;59;60
34;Palencia;228;Villanuño de Valdavia;145;80;65
34;Palencia;229;Villaprovedo;123;72;51
34;Palencia;230;Villarmentero de Campos;23;11;12
34;Palencia;231;Villarrabé;308;157;151
34;Palencia;232;Villarramiel;1191;600;591
34;Palencia;233;Villasarracino;378;190;188
34;Palencia;234;Villasila de Valdavia;131;69;62
34;Palencia;236;Villaturde;313;158;155
34;Palencia;237;Villaumbrales;955;502;453
34;Palencia;238;Villaviudas;512;252;260
34;Palencia;240;Villerías de Campos;146;82;64
34;Palencia;241;Villodre;52;28;24
34;Palencia;242;Villodrigo;159;80;79
34;Palencia;243;Villoldo;566;291;275
34;Palencia;245;Villota del Páramo;538;308;230
34;Palencia;246;Villovieco;151;83;68
35;Palmas (Las);001;Agaete;5269;2637;2632
35;Palmas (Las);002;Agüimes;16156;8164;7992
35;Palmas (Las);003;Antigua;2320;1206;1114
35;Palmas (Las);004;Arrecife;33906;17073;16833
35;Palmas (Las);005;Artenara;1105;554;551
35;Palmas (Las);006;Arucas;26974;13542;13432
35;Palmas (Las);007;Betancuria;572;296;276
35;Palmas (Las);008;Firgas;5735;2891;2844
35;Palmas (Las);009;Gáldar;20656;10406;10250
35;Palmas (Las);010;Haría;2851;1470;1381
35;Palmas (Las);011;Ingenio;21807;11121;10686
35;Palmas (Las);016;Las Palmas de Gran Canaria;354877;174439;180438
35;Palmas (Las);012;Mogán;8688;4496;4192
35;Palmas (Las);013;Moya;8007;4043;3964
35;Palmas (Las);014;Oliva (La);5235;2700;2535
35;Palmas (Las);015;Pájara;5242;2750;2492
35;Palmas (Las);017;Puerto del Rosario;16485;8823;7662
35;Palmas (Las);018;San Bartolomé;6217;3183;3034
35;Palmas (Las);019;San Bartolomé de Tirajana;24451;12543;11908
35;Palmas (Las);020;San Nicolás de Tolentino;7751;3886;3865
35;Palmas (Las);021;Santa Brígida;12199;6054;6145
35;Palmas (Las);022;Santa Lucía de Tirajana;33059;16836;16223
35;Palmas (Las);023;Santa María de Guía de Gran Canaria;12383;6250;6133
35;Palmas (Las);024;Teguise;8189;4232;3957
35;Palmas (Las);025;Tejeda;2361;1164;1197
35;Palmas (Las);026;Telde;77356;38699;38657
35;Palmas (Las);027;Teror;10368;5183;5185
35;Palmas (Las);028;Tías;7556;3898;3658
35;Palmas (Las);029;Tinajo;3517;1777;1740
35;Palmas (Las);030;Tuineje;7054;3698;3356
35;Palmas (Las);032;Valleseco;4421;2255;2166
35;Palmas (Las);031;Valsequillo de Gran Canaria;6374;3235;3139
35;Palmas (Las);033;Vega de San Mateo;6153;3139;3014
35;Palmas (Las);034;Yaiza;2675;1402;1273
36;Pontevedra;020;Agolada;5049;2487;2562
36;Pontevedra;001;Arbo;5053;2455;2598
36;Pontevedra;003;Baiona;10122;4959;5163
36;Pontevedra;002;Barro;3633;1728;1905
36;Pontevedra;004;Bueu;12509;6162;6347
36;Pontevedra;005;Caldas de Reis;9176;4436;4740
36;Pontevedra;006;Cambados;12668;6217;6451
36;Pontevedra;007;Campo Lameiro;2662;1270;1392
36;Pontevedra;008;Cangas;22758;11259;11499
36;Pontevedra;009;Cañiza (A);8025;3821;4204
36;Pontevedra;010;Catoira;3653;1806;1847
36;Pontevedra;011;Cerdedo;3788;1707;2081
36;Pontevedra;012;Cotobade;5520;2518;3002
36;Pontevedra;013;Covelo;4440;2015;2425
36;Pontevedra;014;Crecente;4083;1931;2152
36;Pontevedra;015;Cuntis;6080;2811;3269
36;Pontevedra;016;Dozón;2800;1397;1403
36;Pontevedra;017;Estrada (A);22391;10407;11984
36;Pontevedra;018;Forcarei;5873;2775;3098
36;Pontevedra;019;Fornelos de Montes;2478;1138;1340
36;Pontevedra;021;Gondomar;10551;5154;5397
36;Pontevedra;022;Grove (O);10739;5333;5406
36;Pontevedra;023;Guarda (A);10091;4856;5235
36;Pontevedra;901;Illa de Arousa (A);"";"";""
36;Pontevedra;024;Lalín;20360;9916;10444
36;Pontevedra;025;Lama (A);3304;1453;1851
36;Pontevedra;026;Marín;24045;11731;12314
36;Pontevedra;027;Meaño;5313;2559;2754
36;Pontevedra;028;Meis;5102;2411;2691
36;Pontevedra;029;Moaña;17453;8446;9007
36;Pontevedra;030;Mondariz;6723;3193;3530
36;Pontevedra;031;Mondariz-Balneario;629;292;337
36;Pontevedra;032;Moraña;4870;2345;2525
36;Pontevedra;033;Mos;13435;6498;6937
36;Pontevedra;034;Neves (As);5371;2514;2857
36;Pontevedra;035;Nigrán;14182;6951;7231
36;Pontevedra;036;Oia;3160;1570;1590
36;Pontevedra;037;Pazos de Borbén;3500;1623;1877
36;Pontevedra;041;Poio;13035;6349;6686
36;Pontevedra;043;Ponte Caldelas;7833;3700;4133
36;Pontevedra;042;Ponteareas;15731;7456;8275
36;Pontevedra;044;Pontecesures;2794;1371;1423
36;Pontevedra;038;Pontevedra;71491;33824;37667
36;Pontevedra;039;Porriño (O);15175;7356;7819
36;Pontevedra;040;Portas;3326;1544;1782
36;Pontevedra;045;Redondela;28014;13629;14385
36;Pontevedra;046;Ribadumia;4013;1943;2070
36;Pontevedra;047;Rodeiro;4956;2549;2407
36;Pontevedra;048;Rosal (O);5777;2805;2972
36;Pontevedra;049;Salceda de Caselas;5713;2807;2906
36;Pontevedra;050;Salvaterra de Miño;8915;4240;4675
36;Pontevedra;051;Sanxenxo;15043;7436;7607
36;Pontevedra;052;Silleda;10021;4805;5216
36;Pontevedra;053;Soutomaior;4959;2383;2576
36;Pontevedra;054;Tomiño;10223;4973;5250
36;Pontevedra;055;Tui;15242;7220;8022
36;Pontevedra;056;Valga;6269;3047;3222
36;Pontevedra;057;Vigo;276109;131720;144389
36;Pontevedra;059;Vila de Cruces;7481;3638;3843
36;Pontevedra;058;Vilaboa;5806;2827;2979
36;Pontevedra;060;Vilagarcía de Arousa;32170;15536;16634
36;Pontevedra;061;Vilanova de Arousa;15162;7436;7726
37;Salamanca;001;Abusejo;319;158;161
37;Salamanca;002;Agallas;255;129;126
37;Salamanca;003;Ahigal de los Aceiteros;245;122;123
37;Salamanca;004;Ahigal de Villarino;61;30;31
37;Salamanca;005;Alameda de Gardón (La);163;74;89
37;Salamanca;006;Alamedilla (La);252;121;131
37;Salamanca;007;Alaraz;753;399;354
37;Salamanca;008;Alba de Tormes;4344;2169;2175
37;Salamanca;009;Alba de Yeltes;321;161;160
37;Salamanca;010;Alberca (La);1068;549;519
37;Salamanca;011;Alberguería de Argañán (La);212;106;106
37;Salamanca;012;Alconada;257;133;124
37;Salamanca;015;Aldea del Obispo;423;211;212
37;Salamanca;013;Aldeacipreste;337;185;152
37;Salamanca;014;Aldeadávila de la Ribera;1761;906;855
37;Salamanca;016;Aldealengua;476;233;243
37;Salamanca;017;Aldeanueva de Figueroa;393;201;192
37;Salamanca;018;Aldeanueva de la Sierra;109;59;50
37;Salamanca;019;Aldearrodrigo;232;120;112
37;Salamanca;020;Aldearrubia;506;263;243
37;Salamanca;021;Aldeaseca de Alba;153;76;77
37;Salamanca;022;Aldeaseca de la Frontera;422;218;204
37;Salamanca;023;Aldeatejada;516;253;263
37;Salamanca;024;Aldeavieja de Tormes;152;75;77
37;Salamanca;025;Aldehuela de la Bóveda;431;216;215
37;Salamanca;026;Aldehuela de Yeltes;398;199;199
37;Salamanca;027;Almenara de Tormes;251;124;127
37;Salamanca;028;Almendra;240;117;123
37;Salamanca;029;Anaya de Alba;367;194;173
37;Salamanca;030;Añover de Tormes;129;66;63
37;Salamanca;031;Arabayona de Mógica;611;323;288
37;Salamanca;032;Arapiles;488;241;247
37;Salamanca;033;Arcediano;117;59;58
37;Salamanca;034;Arco (El);100;52;48
37;Salamanca;035;Armenteros;380;181;199
37;Salamanca;037;Atalaya (La);182;100;82
37;Salamanca;038;Babilafuente;1002;528;474
37;Salamanca;039;Bañobárez;555;292;263
37;Salamanca;040;Barbadillo;574;277;297
37;Salamanca;041;Barbalos;151;77;74
37;Salamanca;042;Barceo;89;48;41
37;Salamanca;044;Barruecopardo;681;341;340
37;Salamanca;045;Bastida (La);51;24;27
37;Salamanca;046;Béjar;17125;8191;8934
37;Salamanca;047;Beleña;134;62;72
37;Salamanca;049;Bermellar;263;131;132
37;Salamanca;050;Berrocal de Huebra;149;73;76
37;Salamanca;051;Berrocal de Salvatierra;175;90;85
37;Salamanca;052;Boada;524;258;266
37;Salamanca;054;Bodón (El);427;218;209
37;Salamanca;055;Bogajo;255;132;123
37;Salamanca;056;Bouza (La);79;42;37
37;Salamanca;057;Bóveda del Río Almar;360;186;174
37;Salamanca;058;Brincones;147;70;77
37;Salamanca;059;Buenamadre;218;112;106
37;Salamanca;060;Buenavista;109;56;53
37;Salamanca;061;Cabaco (El);300;153;147
37;Salamanca;063;Cabeza de Béjar (La);146;75;71
37;Salamanca;065;Cabeza del Caballo;576;295;281
37;Salamanca;062;Cabezabellosa de la Calzada;139;77;62
37;Salamanca;067;Cabrerizos;920;451;469
37;Salamanca;068;Cabrillas;640;301;339
37;Salamanca;069;Calvarrasa de Abajo;1096;548;548
37;Salamanca;070;Calvarrasa de Arriba;620;325;295
37;Salamanca;071;Calzada de Béjar (La);125;65;60
37;Salamanca;072;Calzada de Don Diego;315;157;158
37;Salamanca;073;Calzada de Valdunciel;671;326;345
37;Salamanca;074;Campillo de Azaba;325;153;172
37;Salamanca;077;Campo de Peñaranda (El);461;238;223
37;Salamanca;078;Candelario;1177;580;597
37;Salamanca;079;Canillas de Abajo;149;82;67
37;Salamanca;080;Cantagallo;287;139;148
37;Salamanca;081;Cantalapiedra;1623;816;807
37;Salamanca;082;Cantalpino;1315;695;620
37;Salamanca;083;Cantaracillo;316;155;161
37;Salamanca;085;Carbajosa de la Sagrada;673;330;343
37;Salamanca;086;Carpio de Azaba;119;62;57
37;Salamanca;087;Carrascal de Barregas;279;140;139
37;Salamanca;088;Carrascal del Obispo;268;134;134
37;Salamanca;089;Casafranca;88;40;48
37;Salamanca;090;Casas del Conde (Las);111;52;59
37;Salamanca;091;Casillas de Flores;331;153;178
37;Salamanca;092;Castellanos de Moriscos;373;177;196
37;Salamanca;185;Castellanos de Villiquera;452;224;228
37;Salamanca;096;Castillejo de Martín Viejo;351;178;173
37;Salamanca;097;Castraz;84;47;37
37;Salamanca;098;Cepeda;598;284;314
37;Salamanca;099;Cereceda de la Sierra;128;67;61
37;Salamanca;100;Cerezal de Peñahorcada;163;84;79
37;Salamanca;101;Cerralbo;303;162;141
37;Salamanca;102;Cerro (El);631;313;318
37;Salamanca;103;Cespedosa de Tormes;749;397;352
37;Salamanca;114;Chagarcía Medianero;181;93;88
37;Salamanca;104;Cilleros de la Bastida;67;29;38
37;Salamanca;106;Cipérez;539;267;272
37;Salamanca;107;Ciudad Rodrigo;14882;7207;7675
37;Salamanca;108;Coca de Alba;203;98;105
37;Salamanca;109;Colmenar de Montemayor;317;169;148
37;Salamanca;110;Cordovilla;150;79;71
37;Salamanca;112;Cristóbal;252;138;114
37;Salamanca;113;Cubo de Don Sancho (El);678;362;316
37;Salamanca;115;Dios le Guarde;181;97;84
37;Salamanca;116;Doñinos de Ledesma;117;57;60
37;Salamanca;117;Doñinos de Salamanca;643;330;313
37;Salamanca;118;Ejeme;288;152;136
37;Salamanca;120;Encina de San Silvestre;124;62;62
37;Salamanca;119;Encina (La);274;148;126
37;Salamanca;121;Encinas de Abajo;765;392;373
37;Salamanca;122;Encinas de Arriba;294;148;146
37;Salamanca;123;Encinasola de los Comendadores;362;188;174
37;Salamanca;124;Endrinal;318;167;151
37;Salamanca;125;Escurial de la Sierra;352;166;186
37;Salamanca;126;Espadaña;70;37;33
37;Salamanca;127;Espeja;343;175;168
37;Salamanca;128;Espino de la Orbada;385;194;191
37;Salamanca;129;Florida de Liébana;201;113;88
37;Salamanca;130;Forfoleda;245;123;122
37;Salamanca;131;Frades de la Sierra;318;169;149
37;Salamanca;132;Fregeneda (La);689;332;357
37;Salamanca;133;Fresnedoso;158;73;85
37;Salamanca;134;Fresno Alhándiga;373;204;169
37;Salamanca;135;Fuente de San Esteban (La);1814;917;897
37;Salamanca;136;Fuenteguinaldo;1088;542;546
37;Salamanca;137;Fuenteliante;165;78;87
37;Salamanca;138;Fuenterroble de Salvatierra;287;148;139
37;Salamanca;139;Fuentes de Béjar;331;138;193
37;Salamanca;140;Fuentes de Oñoro;1537;750;787
37;Salamanca;141;Gajates;284;147;137
37;Salamanca;142;Galindo y Perahuy;160;79;81
37;Salamanca;143;Galinduste;628;320;308
37;Salamanca;144;Galisancho;785;414;371
37;Salamanca;145;Gallegos de Argañán;524;262;262
37;Salamanca;146;Gallegos de Solmirón;260;122;138
37;Salamanca;147;Garcibuey;348;193;155
37;Salamanca;148;Garcihernández;667;365;302
37;Salamanca;149;Garcirrey;115;58;57
37;Salamanca;150;Gejuelo del Barro;56;31;25
37;Salamanca;151;Golpejas;235;127;108
37;Salamanca;152;Gomecello;635;312;323
37;Salamanca;154;Guadramiro;267;156;111
37;Salamanca;155;Guijo de Ávila;130;71;59
37;Salamanca;156;Guijuelo;4804;2399;2405
37;Salamanca;157;Herguijuela de Ciudad Rodrigo;192;98;94
37;Salamanca;158;Herguijuela de la Sierra;409;200;209
37;Salamanca;159;Herguijuela del Campo;165;79;86
37;Salamanca;160;Hinojosa de Duero;962;463;499
37;Salamanca;161;Horcajo de Montemayor;210;109;101
37;Salamanca;162;Horcajo Medianero;461;238;223
37;Salamanca;163;Hoya (La);24;15;9
37;Salamanca;164;Huerta;282;151;131
37;Salamanca;165;Iruelos;83;38;45
37;Salamanca;166;Ituero de Azaba;351;177;174
37;Salamanca;167;Juzbado;203;106;97
37;Salamanca;168;Lagunilla;772;401;371
37;Salamanca;169;Larrodrigo;297;157;140
37;Salamanca;170;Ledesma;1986;971;1015
37;Salamanca;171;Ledrada;640;309;331
37;Salamanca;172;Linares de Riofrío;1228;633;595
37;Salamanca;173;Lumbrales;2443;1219;1224
37;Salamanca;175;Machacón;563;285;278
37;Salamanca;174;Macotera;1905;957;948
37;Salamanca;176;Madroñal;177;89;88
37;Salamanca;177;Maíllo (El);476;240;236
37;Salamanca;178;Malpartida;197;106;91
37;Salamanca;179;Mancera de Abajo;432;220;212
37;Salamanca;180;Manzano (El);120;67;53
37;Salamanca;181;Martiago;514;254;260
37;Salamanca;183;Martín de Yeltes;624;318;306
37;Salamanca;182;Martinamor;99;52;47
37;Salamanca;184;Masueco;514;256;258
37;Salamanca;186;Mata de Ledesma (La);177;83;94
37;Salamanca;187;Matilla de los Caños del Río;743;382;361
37;Salamanca;188;Maya (La);282;153;129
37;Salamanca;189;Membribe de la Sierra;121;60;61
37;Salamanca;190;Mieza;431;219;212
37;Salamanca;191;Milano (El);192;102;90
37;Salamanca;192;Miranda de Azán;125;64;61
37;Salamanca;193;Miranda del Castañar;632;338;294
37;Salamanca;194;Mogarraz;414;197;217
37;Salamanca;195;Molinillo;95;50;45
37;Salamanca;196;Monforte de la Sierra;149;78;71
37;Salamanca;197;Monleón;147;90;57
37;Salamanca;198;Monleras;303;154;149
37;Salamanca;199;Monsagro;276;155;121
37;Salamanca;200;Montejo;251;130;121
37;Salamanca;201;Montemayor del Río;386;194;192
37;Salamanca;202;Monterrubio de Armuña;125;59;66
37;Salamanca;203;Monterrubio de la Sierra;172;90;82
37;Salamanca;204;Morasverdes;521;267;254
37;Salamanca;205;Morille;194;96;98
37;Salamanca;206;Moríñigo;153;86;67
37;Salamanca;207;Moriscos;131;72;59
37;Salamanca;208;Moronta;162;80;82
37;Salamanca;209;Mozárbez;337;169;168
37;Salamanca;211;Narros de Matalayegua;381;202;179
37;Salamanca;213;Nava de Béjar;129;62;67
37;Salamanca;214;Nava de Francia;158;85;73
37;Salamanca;215;Nava de Sotrobal;239;126;113
37;Salamanca;212;Navacarros;95;50;45
37;Salamanca;216;Navales;420;237;183
37;Salamanca;217;Navalmoral de Béjar;89;42;47
37;Salamanca;218;Navamorales;214;115;99
37;Salamanca;219;Navarredonda de la Rinconada;321;158;163
37;Salamanca;221;Navasfrías;831;407;424
37;Salamanca;222;Negrilla de Palencia;101;48;53
37;Salamanca;223;Olmedo de Camaces;217;104;113
37;Salamanca;224;Orbada (La);335;165;170
37;Salamanca;225;Pajares de la Laguna;163;80;83
37;Salamanca;226;Palacios del Arzobispo;280;144;136
37;Salamanca;228;Palaciosrubios;635;326;309
37;Salamanca;229;Palencia de Negrilla;211;104;107
37;Salamanca;230;Parada de Arriba;244;121;123
37;Salamanca;231;Parada de Rubiales;403;199;204
37;Salamanca;232;Paradinas de San Juan;679;365;314
37;Salamanca;233;Pastores;80;43;37
37;Salamanca;234;Payo (El);616;293;323
37;Salamanca;235;Pedraza de Alba;311;169;142
37;Salamanca;236;Pedrosillo de Alba;333;169;164
37;Salamanca;237;Pedrosillo de los Aires;537;290;247
37;Salamanca;238;Pedrosillo el Ralo;159;83;76
37;Salamanca;239;Pedroso de la Armuña (El);363;178;185
37;Salamanca;240;Pelabravo;628;325;303
37;Salamanca;241;Pelarrodríguez;215;115;100
37;Salamanca;242;Pelayos;103;56;47
37;Salamanca;243;Peña (La);183;89;94
37;Salamanca;244;Peñacaballera;269;132;137
37;Salamanca;245;Peñaparda;543;261;282
37;Salamanca;246;Peñaranda de Bracamonte;6375;3112;3263
37;Salamanca;247;Peñarandilla;313;158;155
37;Salamanca;248;Peralejos de Abajo;252;116;136
37;Salamanca;249;Peralejos de Arriba;85;47;38
37;Salamanca;250;Pereña de la Ribera;555;290;265
37;Salamanca;251;Peromingo;164;77;87
37;Salamanca;252;Pinedas;245;121;124
37;Salamanca;253;Pino de Tormes (El);165;87;78
37;Salamanca;254;Pitiegua;290;144;146
37;Salamanca;255;Pizarral;90;42;48
37;Salamanca;256;Poveda de las Cintas;415;225;190
37;Salamanca;257;Pozos de Hinojo;109;59;50
37;Salamanca;258;Puebla de Azaba;334;171;163
37;Salamanca;259;Puebla de San Medel;78;41;37
37;Salamanca;260;Puebla de Yeltes;289;150;139
37;Salamanca;261;Puente del Congosto;421;207;214
37;Salamanca;262;Puertas;130;72;58
37;Salamanca;263;Puerto de Béjar;521;242;279
37;Salamanca;264;Puerto Seguro;127;64;63
37;Salamanca;265;Rágama;349;184;165
37;Salamanca;266;Redonda (La);138;65;73
37;Salamanca;267;Retortillo;304;147;157
37;Salamanca;268;Rinconada de la Sierra (La);191;91;100
37;Salamanca;269;Robleda;650;339;311
37;Salamanca;270;Robliza de Cojos;239;112;127
37;Salamanca;271;Rollán;643;328;315
37;Salamanca;272;Saelices el Chico;219;117;102
37;Salamanca;273;Sagrada (La);233;111;122
37;Salamanca;303;Sahugo (El);357;183;174
37;Salamanca;274;Salamanca;162888;77163;85725
37;Salamanca;275;Saldeana;227;118;109
37;Salamanca;276;Salmoral;419;216;203
37;Salamanca;277;Salvatierra de Tormes;75;40;35
37;Salamanca;278;San Cristóbal de la Cuesta;243;124;119
37;Salamanca;284;San Esteban de la Sierra;493;262;231
37;Salamanca;285;San Felices de los Gallegos;733;375;358
37;Salamanca;286;San Martín del Castañar;324;170;154
37;Salamanca;287;San Miguel de Valero;456;228;228
37;Salamanca;036;San Miguel del Robledo;109;56;53
37;Salamanca;288;San Morales;189;100;89
37;Salamanca;289;San Muñoz;426;218;208
37;Salamanca;291;San Pedro de Rozados;436;223;213
37;Salamanca;290;San Pedro del Valle;149;75;74
37;Salamanca;292;San Pelayo de Guareña;131;68;63
37;Salamanca;280;Sanchón de la Ribera;170;86;84
37;Salamanca;281;Sanchón de la Sagrada;66;35;31
37;Salamanca;282;Sanchotello;388;203;185
37;Salamanca;279;Sancti-Spíritus;1360;681;679
37;Salamanca;283;Sando;236;135;101
37;Salamanca;293;Santa María de Sando;220;123;97
37;Salamanca;294;Santa Marta de Tormes;6817;3386;3431
37;Salamanca;296;Santiago de la Puebla;685;352;333
37;Salamanca;297;Santibáñez de Béjar;757;375;382
37;Salamanca;298;Santibáñez de la Sierra;265;145;120
37;Salamanca;299;Santiz;328;175;153
37;Salamanca;300;Santos (Los);813;435;378
37;Salamanca;301;Sardón de los Frailes;123;67;56
37;Salamanca;302;Saucelle;575;287;288
37;Salamanca;304;Sepulcro-Hilario;339;173;166
37;Salamanca;305;Sequeros;271;123;148
37;Salamanca;306;Serradilla del Arroyo;536;268;268
37;Salamanca;307;Serradilla del Llano;371;183;188
37;Salamanca;309;Sierpe (La);60;32;28
37;Salamanca;310;Sieteiglesias de Tormes;178;94;84
37;Salamanca;311;Sobradillo;464;221;243
37;Salamanca;312;Sorihuela;471;232;239
37;Salamanca;313;Sotoserrano;811;418;393
37;Salamanca;314;Tabera de Abajo;117;59;58
37;Salamanca;315;Tala (La);182;94;88
37;Salamanca;316;Tamames;1144;572;572
37;Salamanca;317;Tarazona de Guareña;473;259;214
37;Salamanca;318;Tardáguila;282;149;133
37;Salamanca;319;Tejado (El);226;113;113
37;Salamanca;320;Tejeda y Segoyuela;159;79;80
37;Salamanca;321;Tenebrón;256;123;133
37;Salamanca;322;Terradillos;1743;873;870
37;Salamanca;323;Topas;769;396;373
37;Salamanca;324;Tordillos;686;346;340
37;Salamanca;325;Tornadizo (El);158;84;74
37;Salamanca;327;Torresmenudas;272;134;138
37;Salamanca;328;Trabanca;264;139;125
37;Salamanca;329;Tremedal de Tormes;69;35;34
37;Salamanca;330;Valdecarros;497;257;240
37;Salamanca;331;Valdefuentes de Sangusín;374;187;187
37;Salamanca;332;Valdehijaderos;136;76;60
37;Salamanca;333;Valdelacasa;374;195;179
37;Salamanca;334;Valdelageve;151;82;69
37;Salamanca;335;Valdelosa;485;228;257
37;Salamanca;336;Valdemierque;75;40;35
37;Salamanca;337;Valderrodrigo;221;111;110
37;Salamanca;338;Valdunciel;138;64;74
37;Salamanca;339;Valero;504;255;249
37;Salamanca;343;Vallejera de Riofrío;54;22;32
37;Salamanca;340;Valsalabroso;282;143;139
37;Salamanca;341;Valverde de Valdelacasa;84;42;42
37;Salamanca;342;Valverdón;239;127;112
37;Salamanca;344;Vecinos;336;169;167
37;Salamanca;345;Vega de Tirados;254;134;120
37;Salamanca;346;Veguillas (Las);324;153;171
37;Salamanca;347;Vellés (La);433;212;221
37;Salamanca;348;Ventosa del Río Almar;165;82;83
37;Salamanca;349;Vídola (La);227;116;111
37;Salamanca;351;Villaflores;550;276;274
37;Salamanca;352;Villagonzalo de Tormes;271;144;127
37;Salamanca;353;Villalba de los Llanos;223;123;100
37;Salamanca;354;Villamayor;1201;620;581
37;Salamanca;355;Villanueva del Conde;313;163;150
37;Salamanca;356;Villar de Argañán;132;66;66
37;Salamanca;357;Villar de Ciervo;490;260;230
37;Salamanca;358;Villar de Gallimazo;246;129;117
37;Salamanca;359;Villar de la Yegua;363;179;184
37;Salamanca;360;Villar de Peralonso;403;199;204
37;Salamanca;361;Villar de Samaniego;173;92;81
37;Salamanca;362;Villares de la Reina;1200;590;610
37;Salamanca;363;Villares de Yeltes;193;97;96
37;Salamanca;364;Villarino de los Aires;1306;645;661
37;Salamanca;365;Villarmayor;238;120;118
37;Salamanca;366;Villarmuerto;82;45;37
37;Salamanca;367;Villasbuenas;379;187;192
37;Salamanca;368;Villasdardo;29;14;15
37;Salamanca;369;Villaseco de los Gamitos;243;118;125
37;Salamanca;370;Villaseco de los Reyes;478;247;231
37;Salamanca;371;Villasrubias;447;241;206
37;Salamanca;372;Villaverde de Guareña;227;117;110
37;Salamanca;373;Villavieja de Yeltes;1211;608;603
37;Salamanca;374;Villoria;1396;690;706
37;Salamanca;375;Villoruela;1081;529;552
37;Salamanca;350;Vilvestre;711;354;357
37;Salamanca;376;Vitigudino;3101;1510;1591
37;Salamanca;377;Yecla de Yeltes;453;225;228
37;Salamanca;378;Zamarra;183;100;83
37;Salamanca;379;Zamayón;174;101;73
37;Salamanca;380;Zarapicos;78;40;38
37;Salamanca;381;Zarza de Pumareda (La);239;130;109
37;Salamanca;382;Zorita de la Frontera;335;177;158
38;Santa Cruz de Tenerife;001;Adeje;9708;4806;4902
38;Santa Cruz de Tenerife;002;Agulo;1115;564;551
38;Santa Cruz de Tenerife;003;Alajeró;1143;602;541
38;Santa Cruz de Tenerife;004;Arafo;4200;2030;2170
38;Santa Cruz de Tenerife;005;Arico;4567;2333;2234
38;Santa Cruz de Tenerife;006;Arona;22721;11385;11336
38;Santa Cruz de Tenerife;007;Barlovento;2644;1340;1304
38;Santa Cruz de Tenerife;008;Breña Alta;5432;2724;2708
38;Santa Cruz de Tenerife;009;Breña Baja;3354;1672;1682
38;Santa Cruz de Tenerife;010;Buenavista del Norte;5561;2807;2754
38;Santa Cruz de Tenerife;011;Candelaria;10688;5319;5369
38;Santa Cruz de Tenerife;012;Fasnia;2222;1106;1116
38;Santa Cruz de Tenerife;013;Frontera;3612;1811;1801
38;Santa Cruz de Tenerife;014;Fuencaliente de la Palma;1731;878;853
38;Santa Cruz de Tenerife;015;Garachico;5993;2923;3070
38;Santa Cruz de Tenerife;016;Garafía;2013;1024;989
38;Santa Cruz de Tenerife;017;Granadilla de Abona;16884;8559;8325
38;Santa Cruz de Tenerife;018;Guancha (La);5205;2605;2600
38;Santa Cruz de Tenerife;019;Guía de Isora;11915;5864;6051
38;Santa Cruz de Tenerife;020;Güímar;14429;7137;7292
38;Santa Cruz de Tenerife;021;Hermigua;2120;1094;1026
38;Santa Cruz de Tenerife;022;Icod de los Vinos;21445;10592;10853
38;Santa Cruz de Tenerife;024;Llanos de Aridane (Los);16189;7921;8268
38;Santa Cruz de Tenerife;025;Matanza de Acentejo (La);5887;3030;2857
38;Santa Cruz de Tenerife;026;Orotava (La);35142;17324;17818
38;Santa Cruz de Tenerife;027;Paso (El);7010;3469;3541
38;Santa Cruz de Tenerife;028;Puerto de la Cruz;25447;12401;13046
38;Santa Cruz de Tenerife;029;Puntagorda;1802;883;919
38;Santa Cruz de Tenerife;030;Puntallana;2249;1128;1121
38;Santa Cruz de Tenerife;031;Realejos (Los);29829;14704;15125
38;Santa Cruz de Tenerife;032;Rosario (El);8103;4090;4013
38;Santa Cruz de Tenerife;033;San Andrés y Sauces;5392;2696;2696
38;Santa Cruz de Tenerife;023;San Cristóbal de La Laguna;110895;54510;56385
38;Santa Cruz de Tenerife;034;San Juan de la Rambla;4507;2235;2272
38;Santa Cruz de Tenerife;035;San Miguel de Abona;5118;2592;2526
38;Santa Cruz de Tenerife;036;San Sebastián de la Gomera;5606;2835;2771
38;Santa Cruz de Tenerife;037;Santa Cruz de la Palma;17205;8257;8948
38;Santa Cruz de Tenerife;038;Santa Cruz de Tenerife;200172;96841;103331
38;Santa Cruz de Tenerife;039;Santa Úrsula;8599;4282;4317
38;Santa Cruz de Tenerife;040;Santiago del Teide;5914;2950;2964
38;Santa Cruz de Tenerife;041;Sauzal (El);6258;3124;3134
38;Santa Cruz de Tenerife;042;Silos (Los);5277;2611;2666
38;Santa Cruz de Tenerife;043;Tacoronte;17074;8514;8560
38;Santa Cruz de Tenerife;044;Tanque (El);3058;1545;1513
38;Santa Cruz de Tenerife;045;Tazacorte;6582;3300;3282
38;Santa Cruz de Tenerife;046;Tegueste;8027;4043;3984
38;Santa Cruz de Tenerife;047;Tijarafe;2195;1108;1087
38;Santa Cruz de Tenerife;049;Valle Gran Rey;3103;1574;1529
38;Santa Cruz de Tenerife;050;Vallehermoso;2876;1461;1415
38;Santa Cruz de Tenerife;048;Valverde;3550;1767;1783
38;Santa Cruz de Tenerife;051;Victoria de Acentejo (La);7435;3750;3685
38;Santa Cruz de Tenerife;052;Vilaflor;1543;788;755
38;Santa Cruz de Tenerife;053;Villa de Mazo;5069;2526;2543
39;Cantabria;001;Alfoz de Lloredo;2778;1434;1344
39;Cantabria;002;Ampuero;3379;1677;1702
39;Cantabria;003;Anievas;442;224;218
39;Cantabria;004;Arenas de Iguña;2292;1168;1124
39;Cantabria;005;Argoños;647;325;322
39;Cantabria;006;Arnuero;1868;936;932
39;Cantabria;007;Arredondo;743;399;344
39;Cantabria;008;Astillero (El);12571;6225;6346
39;Cantabria;009;Bárcena de Cicero;2305;1171;1134
39;Cantabria;010;Bárcena de Pie de Concha;950;446;504
39;Cantabria;011;Bareyo;1637;830;807
39;Cantabria;012;Cabezón de la Sal;6752;3301;3451
39;Cantabria;013;Cabezón de Liébana;832;435;397
39;Cantabria;014;Cabuérniga;1141;574;567
39;Cantabria;015;Camaleño;1241;635;606
39;Cantabria;016;Camargo;20451;10109;10342
39;Cantabria;027;Campoo de Enmedio;3867;1961;1906
39;Cantabria;017;Campoo de Yuso;838;415;423
39;Cantabria;018;Cartes;2157;1077;1080
39;Cantabria;019;Castañeda;1552;766;786
39;Cantabria;020;Castro-Urdiales;13376;6642;6734
39;Cantabria;021;Cieza;803;396;407
39;Cantabria;022;Cillorigo de Liébana;1105;589;516
39;Cantabria;023;Colindres;5640;2825;2815
39;Cantabria;024;Comillas;2495;1185;1310
39;Cantabria;025;Corrales de Buelna (Los);9898;4914;4984
39;Cantabria;026;Corvera de Toranzo;2203;1100;1103
39;Cantabria;028;Entrambasaguas;2558;1266;1292
39;Cantabria;029;Escalante;722;362;360
39;Cantabria;030;Guriezo;1775;913;862
39;Cantabria;031;Hazas de Cesto;1280;653;627
39;Cantabria;032;Hermandad de Campoo de Suso;1869;993;876
39;Cantabria;033;Herrerías;823;440;383
39;Cantabria;034;Lamasón;465;251;214
39;Cantabria;035;Laredo;12950;6269;6681
39;Cantabria;036;Liendo;797;396;401
39;Cantabria;037;Liérganes;2286;1146;1140
39;Cantabria;038;Limpias;1169;583;586
39;Cantabria;039;Luena;1173;599;574
39;Cantabria;040;Marina de Cudeyo;4400;2189;2211
39;Cantabria;041;Mazcuerras;1826;954;872
39;Cantabria;042;Medio Cudeyo;5724;2802;2922
39;Cantabria;043;Meruelo;926;477;449
39;Cantabria;044;Miengo;2974;1476;1498
39;Cantabria;045;Miera;650;314;336
39;Cantabria;046;Molledo;2154;1067;1087
39;Cantabria;047;Noja;1562;777;785
39;Cantabria;048;Penagos;1823;896;927
39;Cantabria;049;Peñarrubia;348;176;172
39;Cantabria;050;Pesaguero;472;259;213
39;Cantabria;051;Pesquera;110;53;57
39;Cantabria;052;Piélagos;9394;4637;4757
39;Cantabria;053;Polaciones;359;209;150
39;Cantabria;054;Polanco;3806;1869;1937
39;Cantabria;055;Potes;1508;731;777
39;Cantabria;056;Puente Viesgo;2475;1241;1234
39;Cantabria;057;Ramales de la Victoria;2490;1265;1225
39;Cantabria;058;Rasines;1069;545;524
39;Cantabria;059;Reinosa;12593;6151;6442
39;Cantabria;060;Reocín;6541;3244;3297
39;Cantabria;061;Ribamontán al Mar;2892;1479;1413
39;Cantabria;062;Ribamontán al Monte;2016;1045;971
39;Cantabria;063;Rionansa;1734;921;813
39;Cantabria;064;Riotuerto;1568;761;807
39;Cantabria;065;Rozas de Valdearroyo (Las);281;147;134
39;Cantabria;066;Ruente;963;493;470
39;Cantabria;067;Ruesga;1343;670;673
39;Cantabria;068;Ruiloba;740;368;372
39;Cantabria;069;San Felices de Buelna;2349;1155;1194
39;Cantabria;070;San Miguel de Aguayo;170;88;82
39;Cantabria;071;San Pedro del Romeral;801;418;383
39;Cantabria;072;San Roque de Riomiera;613;333;280
39;Cantabria;080;San Vicente de la Barquera;4515;2300;2215
39;Cantabria;073;Santa Cruz de Bezana;5276;2628;2648
39;Cantabria;074;Santa María de Cayón;6016;3023;2993
39;Cantabria;075;Santander;191079;90315;100764
39;Cantabria;076;Santillana del Mar;3823;1876;1947
39;Cantabria;077;Santiurde de Reinosa;396;212;184
39;Cantabria;078;Santiurde de Toranzo;1810;909;901
39;Cantabria;079;Santoña;10728;5582;5146
39;Cantabria;081;Saro;583;301;282
39;Cantabria;082;Selaya;2055;1042;1013
39;Cantabria;083;Soba;1856;976;880
39;Cantabria;084;Solórzano;1007;519;488
39;Cantabria;085;Suances;5855;2878;2977
39;Cantabria;086;Tojos (Los);424;224;200
39;Cantabria;087;Torrelavega;60023;29273;30750
39;Cantabria;088;Tresviso;78;46;32
39;Cantabria;089;Tudanca;295;175;120
39;Cantabria;090;Udías;851;429;422
39;Cantabria;095;Val de San Vicente;2561;1319;1242
39;Cantabria;091;Valdáliga;2762;1413;1349
39;Cantabria;092;Valdeolea;1787;916;871
39;Cantabria;093;Valdeprado del Río;369;186;183
39;Cantabria;094;Valderredible;1263;651;612
39;Cantabria;096;Vega de Liébana;1124;593;531
39;Cantabria;097;Vega de Pas;1101;562;539
39;Cantabria;098;Villacarriedo;2132;1058;1074
39;Cantabria;099;Villaescusa;2955;1444;1511
39;Cantabria;100;Villafufre;1150;580;570
39;Cantabria;101;Villaverde de Trucíos;394;210;184
39;Cantabria;102;Voto;2554;1325;1229
40;Segovia;001;Abades;917;456;461
40;Segovia;002;Adrada de Pirón;53;30;23
40;Segovia;003;Adrados;274;132;142
40;Segovia;004;Aguilafuente;807;392;415
40;Segovia;005;Alconada de Maderuelo;63;32;31
40;Segovia;012;Aldea Real;425;222;203
40;Segovia;006;Aldealcorvo;38;20;18
40;Segovia;007;Aldealengua de Pedraza;111;64;47
40;Segovia;008;Aldealengua de Santa María;83;46;37
40;Segovia;009;Aldeanueva de la Serrezuela;55;32;23
40;Segovia;010;Aldeanueva del Codonal;253;128;125
40;Segovia;013;Aldeasoña;167;77;90
40;Segovia;014;Aldehorno;98;54;44
40;Segovia;015;Aldehuela del Codonal;70;30;40
40;Segovia;016;Aldeonte;109;55;54
40;Segovia;017;Anaya;136;71;65
40;Segovia;018;Añe;133;72;61
40;Segovia;019;Arahuetes;56;29;27
40;Segovia;020;Arcones;288;156;132
40;Segovia;021;Arevalillo de Cega;41;22;19
40;Segovia;022;Armuña;326;166;160
40;Segovia;024;Ayllón;1271;641;630
40;Segovia;025;Barbolla;245;126;119
40;Segovia;026;Basardilla;117;59;58
40;Segovia;028;Bercial;141;66;75
40;Segovia;029;Bercimuel;81;35;46
40;Segovia;030;Bernardos;808;394;414
40;Segovia;031;Bernuy de Porreros;308;158;150
40;Segovia;032;Boceguillas;557;270;287
40;Segovia;033;Brieva;66;41;25
40;Segovia;034;Caballar;110;53;57
40;Segovia;035;Cabañas de Polendos;117;60;57
40;Segovia;036;Cabezuela;772;404;368
40;Segovia;037;Calabazas de Fuentidueña;103;50;53
40;Segovia;039;Campo de San Pedro;386;221;165
40;Segovia;040;Cantalejo;3453;1733;1720
40;Segovia;041;Cantimpalos;1332;673;659
40;Segovia;043;Carbonero el Mayor;2383;1210;1173
40;Segovia;044;Carrascal del Río;236;126;110
40;Segovia;045;Casla;150;80;70
40;Segovia;046;Castillejo de Mesleón;141;70;71
40;Segovia;047;Castro de Fuentidueña;106;61;45
40;Segovia;048;Castrojimeno;51;31;20
40;Segovia;049;Castroserna de Abajo;70;42;28
40;Segovia;051;Castroserracín;36;20;16
40;Segovia;052;Cedillo de la Torre;164;85;79
40;Segovia;053;Cerezo de Abajo;184;100;84
40;Segovia;054;Cerezo de Arriba;201;106;95
40;Segovia;065;Chañe;764;402;362
40;Segovia;055;Cilleruelo de San Mamés;73;36;37
40;Segovia;056;Cobos de Fuentidueña;92;42;50
40;Segovia;057;Coca;2031;1015;1016
40;Segovia;058;Codorniz;517;258;259
40;Segovia;059;Collado Hermoso;122;57;65
40;Segovia;060;Condado de Castilnovo;161;87;74
40;Segovia;061;Corral de Ayllón;132;72;60
40;Segovia;902;Cozuelos de Fuentidueña;249;124;125
40;Segovia;062;Cubillo;73;40;33
40;Segovia;063;Cuéllar;9097;4609;4488
40;Segovia;905;Cuevas de Provanco;254;138;116
40;Segovia;068;Domingo García;55;25;30
40;Segovia;069;Donhierro;120;70;50
40;Segovia;070;Duruelo;119;60;59
40;Segovia;071;Encinas;78;37;41
40;Segovia;072;Encinillas;79;40;39
40;Segovia;073;Escalona del Prado;630;322;308
40;Segovia;074;Escarabajosa de Cabezas;408;220;188
40;Segovia;075;Escobar de Polendos;233;114;119
40;Segovia;076;Espinar (El);5079;2581;2498
40;Segovia;077;Espirdo;180;107;73
40;Segovia;078;Fresneda de Cuéllar;274;147;127
40;Segovia;079;Fresno de Cantespino;241;126;115
40;Segovia;080;Fresno de la Fuente;106;59;47
40;Segovia;081;Frumales;272;136;136
40;Segovia;082;Fuente de Santa Cruz;231;122;109
40;Segovia;083;Fuente el Olmo de Fuentidueña;220;113;107
40;Segovia;084;Fuente el Olmo de Íscar;121;69;52
40;Segovia;086;Fuentepelayo;1032;520;512
40;Segovia;087;Fuentepiñel;202;100;102
40;Segovia;088;Fuenterrebollo;481;240;241
40;Segovia;089;Fuentesaúco de Fuentidueña;406;216;190
40;Segovia;091;Fuentesoto;179;92;87
40;Segovia;092;Fuentidueña;244;116;128
40;Segovia;093;Gallegos;100;53;47
40;Segovia;094;Garcillán;362;186;176
40;Segovia;095;Gomezserracín;660;333;327
40;Segovia;097;Grajera;77;37;40
40;Segovia;099;Honrubia de la Cuesta;107;53;54
40;Segovia;100;Hontalbilla;510;268;242
40;Segovia;101;Hontanares de Eresma;133;73;60
40;Segovia;103;Huertos (Los);148;77;71
40;Segovia;104;Ituero y Lama;62;37;25
40;Segovia;105;Juarros de Riomoros;96;52;44
40;Segovia;106;Juarros de Voltoya;293;157;136
40;Segovia;107;Labajos;169;93;76
40;Segovia;108;Laguna de Contreras;216;119;97
40;Segovia;109;Languilla;160;87;73
40;Segovia;110;Lastras de Cuéllar;609;318;291
40;Segovia;111;Lastras del Pozo;100;54;46
40;Segovia;112;Lastrilla (La);635;328;307
40;Segovia;113;Losa (La);286;147;139
40;Segovia;115;Maderuelo;170;85;85
40;Segovia;903;Marazoleja;180;100;80
40;Segovia;118;Marazuela;105;52;53
40;Segovia;119;Martín Miguel;220;110;110
40;Segovia;120;Martín Muñoz de la Dehesa;183;98;85
40;Segovia;121;Martín Muñoz de las Posadas;608;307;301
40;Segovia;122;Marugán;262;132;130
40;Segovia;124;Mata de Cuéllar;321;170;151
40;Segovia;123;Matabuena;225;113;112
40;Segovia;125;Matilla (La);138;75;63
40;Segovia;126;Melque de Cercos;143;65;78
40;Segovia;127;Membibre de la Hoz;100;50;50
40;Segovia;128;Migueláñez;202;102;100
40;Segovia;129;Montejo de Arévalo;334;180;154
40;Segovia;130;Montejo de la Vega de la Serrezuela;213;116;97
40;Segovia;131;Monterrubio;70;36;34
40;Segovia;132;Moral de Hornuez;133;71;62
40;Segovia;134;Mozoncillo;1074;549;525
40;Segovia;135;Muñopedro;420;213;207
40;Segovia;136;Muñoveros;243;129;114
40;Segovia;138;Nava de la Asunción;2682;1375;1307
40;Segovia;139;Navafría;422;224;198
40;Segovia;140;Navalilla;196;102;94
40;Segovia;141;Navalmanzano;1184;611;573
40;Segovia;142;Navares de Ayuso;79;44;35
40;Segovia;143;Navares de Enmedio;210;110;100
40;Segovia;144;Navares de las Cuevas;29;16;13
40;Segovia;145;Navas de Oro;1504;762;742
40;Segovia;904;Navas de Riofrío;237;112;125
40;Segovia;146;Navas de San Antonio;335;171;164
40;Segovia;148;Nieva;390;192;198
40;Segovia;149;Olombrada;873;459;414
40;Segovia;150;Orejana;126;64;62
40;Segovia;151;Ortigosa de Pestaño;100;51;49
40;Segovia;901;Ortigosa del Monte;306;146;160
40;Segovia;152;Otero de Herreros;826;413;413
40;Segovia;154;Pajarejos;50;23;27
40;Segovia;155;Palazuelos de Eresma;1547;768;779
40;Segovia;156;Pedraza;464;226;238
40;Segovia;157;Pelayos del Arroyo;51;27;24
40;Segovia;158;Perosillo;36;21;15
40;Segovia;159;Pinarejos;242;132;110
40;Segovia;160;Pinarnegrillo;216;113;103
40;Segovia;161;Pradales;72;42;30
40;Segovia;162;Prádena;541;281;260
40;Segovia;163;Puebla de Pedraza;103;50;53
40;Segovia;164;Rapariegos;325;179;146
40;Segovia;165;Rebollo;157;87;70
40;Segovia;166;Remondo;393;185;208
40;Segovia;168;Riaguas de San Bartolomé;79;42;37
40;Segovia;170;Riaza;1624;849;775
40;Segovia;171;Ribota;47;27;20
40;Segovia;172;Riofrío de Riaza;60;33;27
40;Segovia;173;Roda de Eresma;100;49;51
40;Segovia;174;Sacramenia;616;324;292
40;Segovia;176;Samboal;702;356;346
40;Segovia;177;San Cristóbal de Cuéllar;271;139;132
40;Segovia;178;San Cristóbal de la Vega;198;101;97
40;Segovia;906;San Cristóbal de Segovia;"";"";""
40;Segovia;181;San Ildefonso;4908;2380;2528
40;Segovia;182;San Martín y Mudrián;338;175;163
40;Segovia;183;San Miguel de Bernuy;221;115;106
40;Segovia;184;San Pedro de Gaíllos;339;178;161
40;Segovia;179;Sanchonuño;762;384;378
40;Segovia;180;Sangarcía;537;277;260
40;Segovia;185;Santa María la Real de Nieva;1644;837;807
40;Segovia;186;Santa Marta del Cerro;57;28;29
40;Segovia;188;Santiuste de Pedraza;126;71;55
40;Segovia;189;Santiuste de San Juan Bautista;877;438;439
40;Segovia;190;Santo Domingo de Pirón;51;24;27
40;Segovia;191;Santo Tomé del Puerto;370;190;180
40;Segovia;192;Sauquillo de Cabezas;280;147;133
40;Segovia;193;Sebúlcor;284;151;133
40;Segovia;194;Segovia;54375;26267;28108
40;Segovia;195;Sepúlveda;1401;717;684
40;Segovia;196;Sequera de Fresno;77;43;34
40;Segovia;198;Sotillo;66;31;35
40;Segovia;199;Sotosalbos;98;50;48
40;Segovia;200;Tabanera la Luenga;86;46;40
40;Segovia;201;Tolocirio;75;35;40
40;Segovia;206;Torre Val de San Pedro;197;101;96
40;Segovia;202;Torreadrada;153;78;75
40;Segovia;203;Torrecaballeros;287;142;145
40;Segovia;204;Torrecilla del Pinar;390;187;203
40;Segovia;205;Torreiglesias;399;213;186
40;Segovia;207;Trescasas;177;94;83
40;Segovia;208;Turégano;1143;571;572
40;Segovia;210;Urueñas;137;76;61
40;Segovia;211;Valdeprados;43;23;20
40;Segovia;212;Valdevacas de Montejo;41;24;17
40;Segovia;213;Valdevacas y Guijar;169;93;76
40;Segovia;218;Valle de Tabladillo;201;107;94
40;Segovia;219;Vallelado;893;449;444
40;Segovia;220;Valleruela de Pedraza;75;42;33
40;Segovia;221;Valleruela de Sepúlveda;85;46;39
40;Segovia;214;Valseca;329;167;162
40;Segovia;215;Valtiendas;219;115;104
40;Segovia;216;Valverde del Majano;526;270;256
40;Segovia;222;Veganzones;331;166;165
40;Segovia;223;Vegas de Matute;270;147;123
40;Segovia;224;Ventosilla y Tejadilla;26;15;11
40;Segovia;225;Villacastín;1617;837;780
40;Segovia;228;Villaverde de Íscar;781;400;381
40;Segovia;229;Villaverde de Montejo;93;46;47
40;Segovia;230;Villeguillo;139;78;61
40;Segovia;231;Yanguas de Eresma;209;98;111
40;Segovia;233;Zarzuela del Monte;540;267;273
40;Segovia;234;Zarzuela del Pinar;639;338;301
41;Sevilla;001;Aguadulce;1918;969;949
41;Sevilla;002;Alanís;2125;1079;1046
41;Sevilla;003;Albaida del Aljarafe;1670;842;828
41;Sevilla;004;Alcalá de Guadaira;52257;25890;26367
41;Sevilla;005;Alcalá del Río;9039;4608;4431
41;Sevilla;006;Alcolea del Río;3386;1661;1725
41;Sevilla;007;Algaba (La);12294;6188;6106
41;Sevilla;008;Algámitas;1416;732;684
41;Sevilla;009;Almadén de la Plata;1793;909;884
41;Sevilla;010;Almensilla;1807;893;914
41;Sevilla;011;Arahal;17717;8797;8920
41;Sevilla;012;Aznalcázar;3196;1587;1609
41;Sevilla;013;Aznalcóllar;5571;2818;2753
41;Sevilla;014;Badolatosa;3029;1564;1465
41;Sevilla;015;Benacazón;4753;2397;2356
41;Sevilla;016;Bollullos de la Mitación;6031;3009;3022
41;Sevilla;017;Bormujos;5277;2594;2683
41;Sevilla;018;Brenes;10314;5161;5153
41;Sevilla;019;Burguillos;3180;1593;1587
41;Sevilla;020;Cabezas de San Juan (Las);15113;7742;7371
41;Sevilla;021;Camas;25501;12402;13099
41;Sevilla;022;Campana (La);5191;2634;2557
41;Sevilla;023;Cantillana;8788;4419;4369
41;Sevilla;901;Cañada Rosal;2842;1437;1405
41;Sevilla;024;Carmona;23617;11865;11752
41;Sevilla;025;Carrión de los Céspedes;2373;1145;1228
41;Sevilla;026;Casariche;4947;2509;2438
41;Sevilla;027;Castilblanco de los Arroyos;4045;2039;2006
41;Sevilla;028;Castilleja de Guzmán;360;185;175
41;Sevilla;029;Castilleja de la Cuesta;15095;7416;7679
41;Sevilla;030;Castilleja del Campo;636;313;323
41;Sevilla;031;Castillo de las Guardas (El);1765;899;866
41;Sevilla;032;Cazalla de la Sierra;5147;2587;2560
41;Sevilla;033;Constantina;7315;3599;3716
41;Sevilla;034;Coria del Río;21928;10918;11010
41;Sevilla;035;Coripe;1718;881;837
41;Sevilla;036;Coronil (El);5089;2577;2512
41;Sevilla;037;Corrales (Los);3980;2037;1943
41;Sevilla;903;Cuervo de Sevilla (El);"";"";""
41;Sevilla;038;Dos Hermanas;78025;38533;39492
41;Sevilla;039;Écija;35786;17710;18076
41;Sevilla;040;Espartinas;2819;1431;1388
41;Sevilla;041;Estepa;10961;5422;5539
41;Sevilla;042;Fuentes de Andalucía;7171;3558;3613
41;Sevilla;043;Garrobo (El);741;367;374
41;Sevilla;044;Gelves;4081;1999;2082
41;Sevilla;045;Gerena;5175;2599;2576
41;Sevilla;046;Gilena;3757;1886;1871
41;Sevilla;047;Gines;6351;3116;3235
41;Sevilla;048;Guadalcanal;3144;1556;1588
41;Sevilla;049;Guillena;7710;3889;3821
41;Sevilla;050;Herrera;5700;2819;2881
41;Sevilla;051;Huévar del Aljarafe;2121;1096;1025
41;Sevilla;052;Lantejuela (La);3254;1660;1594
41;Sevilla;053;Lebrija;28738;14597;14141
41;Sevilla;054;Lora de Estepa;719;362;357
41;Sevilla;055;Lora del Río;18551;9162;9389
41;Sevilla;056;Luisiana (La);4182;2139;2043
41;Sevilla;057;Madroño (El);410;216;194
41;Sevilla;058;Mairena del Alcor;14832;7386;7446
41;Sevilla;059;Mairena del Aljarafe;24556;12275;12281
41;Sevilla;060;Marchena;17221;8524;8697
41;Sevilla;061;Marinaleda;2518;1244;1274
41;Sevilla;062;Martín de la Jara;2699;1411;1288
41;Sevilla;063;Molares (Los);2541;1274;1267
41;Sevilla;064;Montellano;7015;3572;3443
41;Sevilla;065;Morón de la Frontera;27207;13611;13596
41;Sevilla;066;Navas de la Concepción (Las);1947;975;972
41;Sevilla;067;Olivares;6647;3384;3263
41;Sevilla;068;Osuna;16791;8281;8510
41;Sevilla;069;Palacios y Villafranca (Los);29522;14986;14536
41;Sevilla;070;Palomares del Río;2494;1281;1213
41;Sevilla;071;Paradas;7127;3425;3702
41;Sevilla;072;Pedrera;4691;2360;2331
41;Sevilla;073;Pedroso (El);2395;1193;1202
41;Sevilla;074;Peñaflor;4049;2044;2005
41;Sevilla;075;Pilas;10515;5161;5354
41;Sevilla;076;Pruna;3597;1854;1743
41;Sevilla;077;Puebla de Cazalla (La);10575;5298;5277
41;Sevilla;078;Puebla de los Infantes (La);3652;1846;1806
41;Sevilla;079;Puebla del Río (La);16377;8247;8130
41;Sevilla;080;Real de la Jara (El);1748;878;870
41;Sevilla;081;Rinconada (La);21320;10721;10599
41;Sevilla;082;Roda de Andalucía (La);4033;2003;2030
41;Sevilla;083;Ronquillo (El);1369;683;686
41;Sevilla;084;Rubio (El);3651;1825;1826
41;Sevilla;085;Salteras;2554;1286;1268
41;Sevilla;086;San Juan de Aznalfarache;21790;10572;11218
41;Sevilla;088;San Nicolás del Puerto;728;386;342
41;Sevilla;087;Sanlúcar la Mayor;9434;4711;4723
41;Sevilla;089;Santiponce;6304;3151;3153
41;Sevilla;090;Saucejo (El);4047;2056;1991
41;Sevilla;091;Sevilla;683028;327628;355400
41;Sevilla;092;Tocina;8472;4193;4279
41;Sevilla;093;Tomares;13218;6540;6678
41;Sevilla;094;Umbrete;3014;1509;1505
41;Sevilla;095;Utrera;43220;21590;21630
41;Sevilla;096;Valencina de la Concepción;4410;2234;2176
41;Sevilla;902;Villafranco del Guadalquivir;"";"";""
41;Sevilla;097;Villamanrique de la Condesa;3495;1712;1783
41;Sevilla;100;Villanueva de San Juan;1682;842;840
41;Sevilla;098;Villanueva del Ariscal;4052;1926;2126
41;Sevilla;099;Villanueva del Río y Minas;6014;2889;3125
41;Sevilla;101;Villaverde del Río;6450;3289;3161
41;Sevilla;102;Viso del Alcor (El);15083;7650;7433
42;Soria;001;Abejar;381;200;181
42;Soria;003;Adradas;130;66;64
42;Soria;004;Ágreda;3687;1805;1882
42;Soria;006;Alconaba;169;92;77
42;Soria;007;Alcubilla de Avellaneda;268;140;128
42;Soria;008;Alcubilla de las Peñas;115;56;59
42;Soria;009;Aldealafuente;170;84;86
42;Soria;010;Aldealices;38;18;20
42;Soria;011;Aldealpozo;31;14;17
42;Soria;012;Aldealseñor;57;31;26
42;Soria;013;Aldehuela de Periáñez;45;22;23
42;Soria;014;Aldehuelas (Las);157;82;75
42;Soria;015;Alentisque;57;29;28
42;Soria;016;Aliud;59;29;30
42;Soria;017;Almajano;197;98;99
42;Soria;018;Almaluez;384;188;196
42;Soria;019;Almarza;658;346;312
42;Soria;020;Almazán;5960;2970;2990
42;Soria;021;Almazul;217;108;109
42;Soria;022;Almenar de Soria;473;242;231
42;Soria;023;Alpanseque;135;70;65
42;Soria;024;Arancón;124;67;57
42;Soria;025;Arcos de Jalón;2200;1090;1110
42;Soria;026;Arenillas;51;26;25
42;Soria;027;Arévalo de la Sierra;134;73;61
42;Soria;028;Ausejo de la Sierra;64;31;33
42;Soria;029;Baraona;297;145;152
42;Soria;030;Barca;176;96;80
42;Soria;031;Barcones;62;34;28
42;Soria;032;Bayubas de Abajo;323;169;154
42;Soria;033;Bayubas de Arriba;97;48;49
42;Soria;034;Beratón;42;31;11
42;Soria;035;Berlanga de Duero;1350;687;663
42;Soria;036;Blacos;76;42;34
42;Soria;037;Bliecos;71;37;34
42;Soria;038;Borjabad;74;39;35
42;Soria;039;Borobia;442;222;220
42;Soria;041;Buberos;58;24;34
42;Soria;042;Buitrago;59;30;29
42;Soria;043;Burgo de Osma-Ciudad de Osma;5009;2469;2540
42;Soria;044;Cabrejas del Campo;97;54;43
42;Soria;045;Cabrejas del Pinar;508;275;233
42;Soria;046;Calatañazor;71;39;32
42;Soria;048;Caltojar;171;88;83
42;Soria;049;Candilichera;259;135;124
42;Soria;050;Cañamaque;68;39;29
42;Soria;051;Carabantes;42;22;20
42;Soria;052;Caracena;11;6;5
42;Soria;053;Carrascosa de Abajo;50;27;23
42;Soria;054;Carrascosa de la Sierra;19;8;11
42;Soria;055;Casarejos;300;151;149
42;Soria;056;Castilfrío de la Sierra;36;19;17
42;Soria;058;Castillejo de Robledo;249;132;117
42;Soria;057;Castilruiz;390;198;192
42;Soria;059;Centenera de Andaluz;40;18;22
42;Soria;060;Cerbón;67;37;30
42;Soria;061;Cidones;362;191;171
42;Soria;062;Cigudosa;102;58;44
42;Soria;063;Cihuela;115;57;58
42;Soria;064;Ciria;101;49;52
42;Soria;065;Cirujales del Río;45;27;18
42;Soria;068;Coscurita;180;100;80
42;Soria;069;Covaleda;2090;1073;1017
42;Soria;070;Cubilla;102;53;49
42;Soria;071;Cubo de la Solana;352;178;174
42;Soria;073;Cueva de Ágreda;142;72;70
42;Soria;075;Dévanos;181;94;87
42;Soria;076;Deza;437;224;213
42;Soria;078;Duruelo de la Sierra;1503;769;734
42;Soria;079;Escobosa de Almazán;52;29;23
42;Soria;080;Espeja de San Marcelino;296;167;129
42;Soria;081;Espejón;241;127;114
42;Soria;082;Estepa de San Juan;20;10;10
42;Soria;083;Frechilla de Almazán;56;29;27
42;Soria;084;Fresno de Caracena;61;31;30
42;Soria;085;Fuentearmegil;433;232;201
42;Soria;086;Fuentecambrón;88;50;38
42;Soria;087;Fuentecantos;49;22;27
42;Soria;088;Fuentelmonge;180;91;89
42;Soria;089;Fuentelsaz de Soria;68;35;33
42;Soria;090;Fuentepinilla;185;95;90
42;Soria;092;Fuentes de Magaña;134;67;67
42;Soria;093;Fuentestrún;84;50;34
42;Soria;094;Garray;334;168;166
42;Soria;095;Golmayo;534;284;250
42;Soria;096;Gómara;643;310;333
42;Soria;097;Gormaz;31;13;18
42;Soria;098;Herrera de Soria;41;23;18
42;Soria;100;Hinojosa del Campo;67;41;26
42;Soria;103;Langa de Duero;1055;554;501
42;Soria;105;Liceras;74;37;37
42;Soria;106;Losilla (La);23;14;9
42;Soria;107;Magaña;114;60;54
42;Soria;108;Maján;23;14;9
42;Soria;110;Matalebreras;154;79;75
42;Soria;111;Matamala de Almazán;493;248;245
42;Soria;113;Medinaceli;765;390;375
42;Soria;115;Miño de Medinaceli;167;80;87
42;Soria;116;Miño de San Esteban;126;65;61
42;Soria;117;Molinos de Duero;201;100;101
42;Soria;118;Momblona;57;32;25
42;Soria;119;Monteagudo de las Vicarías;367;181;186
42;Soria;120;Montejo de Tiermes;310;167;143
42;Soria;121;Montenegro de Cameros;127;67;60
42;Soria;123;Morón de Almazán;323;157;166
42;Soria;124;Muriel de la Fuente;89;48;41
42;Soria;125;Muriel Viejo;104;51;53
42;Soria;127;Nafría de Ucero;111;55;56
42;Soria;128;Narros;60;30;30
42;Soria;129;Navaleno;934;472;462
42;Soria;130;Nepas;105;61;44
42;Soria;131;Nolay;108;59;49
42;Soria;132;Noviercas;283;138;145
42;Soria;134;Ólvega;3130;1622;1508
42;Soria;135;Oncala;134;80;54
42;Soria;139;Pinilla del Campo;33;17;16
42;Soria;140;Portillo de Soria;26;15;11
42;Soria;141;Póveda de Soria (La);143;73;70
42;Soria;142;Pozalmuro;123;54;69
42;Soria;144;Quintana Redonda;677;349;328
42;Soria;145;Quintanas de Gormaz;227;112;115
42;Soria;148;Quiñonería;24;10;14
42;Soria;149;Rábanos (Los);437;252;185
42;Soria;151;Rebollar;51;29;22
42;Soria;152;Recuerda;176;91;85
42;Soria;153;Rello;51;22;29
42;Soria;154;Renieblas;127;68;59
42;Soria;155;Retortillo de Soria;312;163;149
42;Soria;156;Reznos;71;40;31
42;Soria;157;Riba de Escalote (La);42;24;18
42;Soria;158;Rioseco de Soria;167;86;81
42;Soria;159;Rollamienta;55;28;27
42;Soria;160;Royo (El);399;186;213
42;Soria;161;Salduero;217;115;102
42;Soria;162;San Esteban de Gormaz;3567;1839;1728
42;Soria;163;San Felices;93;52;41
42;Soria;164;San Leonardo de Yagüe;2115;1074;1041
42;Soria;165;San Pedro Manrique;523;265;258
42;Soria;166;Santa Cruz de Yanguas;71;46;25
42;Soria;167;Santa María de Huerta;537;270;267
42;Soria;168;Santa María de las Hoyas;211;114;97
42;Soria;171;Serón de Nágima;360;184;176
42;Soria;172;Soliedra;48;28;20
42;Soria;173;Soria;32360;15464;16896
42;Soria;174;Sotillo del Rincón;178;82;96
42;Soria;175;Suellacabras;50;24;26
42;Soria;176;Tajahuerce;53;27;26
42;Soria;177;Tajueco;153;79;74
42;Soria;178;Talveila;241;126;115
42;Soria;181;Tardelcuende;719;349;370
42;Soria;182;Taroda;100;53;47
42;Soria;183;Tejado;266;132;134
42;Soria;184;Torlengua;145;70;75
42;Soria;185;Torreblacos;59;28;31
42;Soria;187;Torrubia de Soria;130;70;60
42;Soria;188;Trévago;86;39;47
42;Soria;189;Ucero;105;52;53
42;Soria;190;Vadillo;179;94;85
42;Soria;191;Valdeavellano de Tera;249;132;117
42;Soria;192;Valdegeña;61;32;29
42;Soria;193;Valdelagua del Cerro;46;23;23
42;Soria;194;Valdemaluque;358;184;174
42;Soria;195;Valdenebro;191;100;91
42;Soria;196;Valdeprado;24;10;14
42;Soria;197;Valderrodilla;149;70;79
42;Soria;198;Valtajeros;34;18;16
42;Soria;200;Velamazán;170;95;75
42;Soria;201;Velilla de la Sierra;21;8;13
42;Soria;202;Velilla de los Ajos;59;34;25
42;Soria;204;Viana de Duero;89;46;43
42;Soria;205;Villaciervos;96;50;46
42;Soria;206;Villanueva de Gormaz;21;11;10
42;Soria;207;Villar del Ala;39;18;21
42;Soria;208;Villar del Campo;48;24;24
42;Soria;209;Villar del Río;203;108;95
42;Soria;211;Villares de Soria (Los);126;56;70
42;Soria;212;Villasayas;126;76;50
42;Soria;213;Villaseca de Arciel;57;31;26
42;Soria;215;Vinuesa;1157;609;548
42;Soria;216;Vizmanos;47;28;19
42;Soria;217;Vozmediano;64;34;30
42;Soria;218;Yanguas;78;44;34
42;Soria;219;Yelo;96;49;47
43;Tarragona;001;Aiguamúrcia;565;292;273
43;Tarragona;002;Albinyana;777;394;383
43;Tarragona;003;Albiol (L');111;57;54
43;Tarragona;004;Alcanar;7848;3900;3948
43;Tarragona;005;Alcover;3379;1715;1664
43;Tarragona;904;Aldea (L');3558;1776;1782
43;Tarragona;006;Aldover;823;399;424
43;Tarragona;007;Aleixar (L');618;317;301
43;Tarragona;008;Alfara de Carles;391;204;187
43;Tarragona;009;Alforja;1088;518;570
43;Tarragona;010;Alió;336;173;163
43;Tarragona;011;Almoster;473;241;232
43;Tarragona;012;Altafulla;1674;843;831
43;Tarragona;013;Ametlla de Mar (L');4159;2073;2086
43;Tarragona;906;Ampolla (L');1575;766;809
43;Tarragona;014;Amposta;15321;7600;7721
43;Tarragona;016;Arboç (L');3546;1799;1747
43;Tarragona;015;Arbolí;138;71;67
43;Tarragona;017;Argentera (L');132;68;64
43;Tarragona;018;Arnes;534;278;256
43;Tarragona;019;Ascó;1708;861;847
43;Tarragona;020;Banyeres del Penedès;1483;770;713
43;Tarragona;021;Barberà de la Conca;424;219;205
43;Tarragona;022;Batea;2022;1033;989
43;Tarragona;023;Bellmunt del Priorat;313;152;161
43;Tarragona;024;Bellvei;978;511;467
43;Tarragona;025;Benifallet;934;471;463
43;Tarragona;026;Benissanet;1029;501;528
43;Tarragona;027;Bisbal de Falset (La);266;133;133
43;Tarragona;028;Bisbal del Penedès (La);1388;709;679
43;Tarragona;029;Blancafort;398;196;202
43;Tarragona;030;Bonastre;268;136;132
43;Tarragona;031;Borges del Camp (Les);1383;690;693
43;Tarragona;032;Bot;906;453;453
43;Tarragona;033;Botarell;461;226;235
43;Tarragona;034;Bràfim;580;281;299
43;Tarragona;035;Cabacés;353;184;169
43;Tarragona;036;Cabra del Camp;435;230;205
43;Tarragona;037;Calafell;7166;3582;3584
43;Tarragona;903;Camarles;2868;1434;1434
43;Tarragona;038;Cambrils;14571;7239;7332
43;Tarragona;039;Capafonts;111;54;57
43;Tarragona;040;Capçanes;415;189;226
43;Tarragona;041;Caseres;343;171;172
43;Tarragona;042;Castellvell del Camp;892;446;446
43;Tarragona;043;Catllar (El);1300;665;635
43;Tarragona;045;Colldejou;193;102;91
43;Tarragona;046;Conesa;121;54;67
43;Tarragona;047;Constantí;5353;2758;2595
43;Tarragona;048;Corbera d'Ebre;1122;578;544
43;Tarragona;049;Cornudella de Montsant;859;438;421
43;Tarragona;050;Creixell;1056;544;512
43;Tarragona;051;Cunit;2425;1234;1191
43;Tarragona;901;Deltebre;10180;5123;5057
43;Tarragona;053;Duesaigües;211;124;87
43;Tarragona;054;Espluga de Francolí (L');3605;1746;1859
43;Tarragona;055;Falset;2592;1281;1311
43;Tarragona;056;Fatarella (La);1383;696;687
43;Tarragona;057;Febró (La);55;30;25
43;Tarragona;058;Figuera (La);135;66;69
43;Tarragona;059;Figuerola del Camp;212;105;107
43;Tarragona;060;Flix;5025;2522;2503
43;Tarragona;061;Forès;60;29;31
43;Tarragona;062;Freginals;373;180;193
43;Tarragona;063;Galera (La);761;367;394
43;Tarragona;064;Gandesa;2651;1313;1338
43;Tarragona;065;Garcia;567;275;292
43;Tarragona;066;Garidells (Els);181;91;90
43;Tarragona;067;Ginestar;884;456;428
43;Tarragona;068;Godall;763;378;385
43;Tarragona;069;Gratallops;246;118;128
43;Tarragona;070;Guiamets (Els);294;147;147
43;Tarragona;071;Horta de Sant Joan;1328;688;640
43;Tarragona;072;Lloar (El);138;71;67
43;Tarragona;073;Llorac;104;51;53
43;Tarragona;074;Llorenç del Penedès;1306;633;673
43;Tarragona;076;Marçà;574;268;306
43;Tarragona;075;Margalef;148;77;71
43;Tarragona;077;Mas de Barberans;753;372;381
43;Tarragona;078;Masdenverge;925;472;453
43;Tarragona;079;Masllorenç;376;193;183
43;Tarragona;080;Masó (La);263;127;136
43;Tarragona;081;Maspujols;379;190;189
43;Tarragona;082;Masroig (El);528;250;278
43;Tarragona;083;Milà (El);168;75;93
43;Tarragona;084;Miravet;822;419;403
43;Tarragona;085;Molar (El);324;161;163
43;Tarragona;086;Montblanc;5750;2851;2899
43;Tarragona;088;Montbrió del Camp;1393;683;710
43;Tarragona;089;Montferri;153;75;78
43;Tarragona;090;Montmell (El);280;141;139
43;Tarragona;091;Mont-ral;116;59;57
43;Tarragona;092;Mont-roig del Camp;5003;2503;2500
43;Tarragona;093;Móra d'Ebre;4425;2180;2245
43;Tarragona;094;Móra la Nova;2671;1311;1360
43;Tarragona;095;Morell (El);2272;1165;1107
43;Tarragona;096;Morera de Montsant (La);187;93;94
43;Tarragona;097;Nou de Gaià (La);367;176;191
43;Tarragona;098;Nulles;338;160;178
43;Tarragona;100;Pallaresos (Els);668;363;305
43;Tarragona;099;Palma d'Ebre (La);457;215;242
43;Tarragona;101;Passanant;194;107;87
43;Tarragona;102;Paüls;728;366;362
43;Tarragona;103;Perafort;505;260;245
43;Tarragona;104;Perelló (El);2155;1104;1051
43;Tarragona;105;Piles (Les);134;76;58
43;Tarragona;106;Pinell de Brai (El);1170;606;564
43;Tarragona;107;Pira;312;145;167
43;Tarragona;108;Pla de Santa Maria (El);1579;802;777
43;Tarragona;109;Pobla de Mafumet (La);890;440;450
43;Tarragona;110;Pobla de Massaluca (La);471;241;230
43;Tarragona;111;Pobla de Montornès (La);926;496;430
43;Tarragona;112;Poboleda;367;184;183
43;Tarragona;113;Pont d'Armentera (El);594;287;307
43;Tarragona;141;Pontils;110;54;56
43;Tarragona;114;Porrera;437;225;212
43;Tarragona;115;Pradell de la Teixeta;266;134;132
43;Tarragona;116;Prades;530;277;253
43;Tarragona;117;Prat de Comte;222;103;119
43;Tarragona;118;Pratdip;439;213;226
43;Tarragona;119;Puigpelat;436;221;215
43;Tarragona;120;Querol;171;95;76
43;Tarragona;121;Rasquera;896;453;443
43;Tarragona;122;Renau;63;37;26
43;Tarragona;123;Reus;87670;43070;44600
43;Tarragona;124;Riba (La);911;464;447
43;Tarragona;125;Riba-roja d'Ebre;1607;830;777
43;Tarragona;126;Riera de Gaià (La);908;435;473
43;Tarragona;127;Riudecanyes;581;290;291
43;Tarragona;128;Riudecols;940;487;453
43;Tarragona;129;Riudoms;4780;2428;2352
43;Tarragona;130;Rocafort de Queralt;264;138;126
43;Tarragona;131;Roda de Barà;2077;1063;1014
43;Tarragona;132;Rodonyà;370;184;186
43;Tarragona;133;Roquetes;5525;2700;2825
43;Tarragona;134;Rourell (El);242;127;115
43;Tarragona;135;Salomó;439;220;219
43;Tarragona;905;Salou;7264;3615;3649
43;Tarragona;136;Sant Carles de la Ràpita;10752;5380;5372
43;Tarragona;137;Sant Jaume dels Domenys;1187;605;582
43;Tarragona;902;Sant Jaume d'Enveja;3429;1729;1700
43;Tarragona;138;Santa Bàrbara;3348;1657;1691
43;Tarragona;139;Santa Coloma de Queralt;2542;1241;1301
43;Tarragona;140;Santa Oliva;1485;769;716
43;Tarragona;142;Sarral;1361;682;679
43;Tarragona;143;Savallà del Comtat;56;28;28
43;Tarragona;144;Secuita (La);926;457;469
43;Tarragona;145;Selva del Camp (La);3499;1741;1758
43;Tarragona;146;Senan;27;18;9
43;Tarragona;044;Sénia (La);4863;2459;2404
43;Tarragona;147;Solivella;714;340;374
43;Tarragona;148;Tarragona;110153;54013;56140
43;Tarragona;149;Tivenys;1049;511;538
43;Tarragona;150;Tivissa;1786;891;895
43;Tarragona;151;Torre de Fontaubella (La);79;38;41
43;Tarragona;152;Torre de l'Espanyol (La);727;368;359
43;Tarragona;153;Torredembarra;6238;3056;3182
43;Tarragona;154;Torroja del Priorat;132;77;55
43;Tarragona;155;Tortosa;29452;14270;15182
43;Tarragona;156;Ulldecona;5171;2530;2641
43;Tarragona;157;Ulldemolins;523;263;260
43;Tarragona;158;Vallclara;100;49;51
43;Tarragona;159;Vallfogona de Riucorb;102;57;45
43;Tarragona;160;Vallmoll;1034;527;507
43;Tarragona;161;Valls;20092;9870;10222
43;Tarragona;162;Vandellòs i l'Hospitalet de l'Infant;4162;2082;2080
43;Tarragona;163;Vendrell (El);15415;7592;7823
43;Tarragona;164;Vespella de Gaià;83;46;37
43;Tarragona;165;Vilabella;844;402;442
43;Tarragona;175;Vilalba dels Arcs;793;415;378
43;Tarragona;166;Vilallonga del Camp;1191;592;599
43;Tarragona;168;Vilanova de Prades;162;82;80
43;Tarragona;167;Vilanova d'Escornalbou;445;220;225
43;Tarragona;169;Vilaplana;510;263;247
43;Tarragona;170;Vila-rodona;1017;532;485
43;Tarragona;171;Vila-seca;11528;5790;5738
43;Tarragona;172;Vilaverd;366;184;182
43;Tarragona;173;Vilella Alta (La);136;69;67
43;Tarragona;174;Vilella Baixa (La);163;88;75
43;Tarragona;176;Vimbodí;1095;565;530
43;Tarragona;177;Vinebre;451;213;238
43;Tarragona;178;Vinyols i els Arcs;831;452;379
43;Tarragona;052;Xerta;1248;609;639
44;Teruel;001;Ababuj;83;49;34
44;Teruel;002;Abejuela;65;39;26
44;Teruel;003;Aguatón;32;16;16
44;Teruel;004;Aguaviva;618;301;317
44;Teruel;005;Aguilar del Alfambra;101;50;51
44;Teruel;006;Alacón;527;273;254
44;Teruel;007;Alba;323;167;156
44;Teruel;008;Albalate del Arzobispo;2449;1204;1245
44;Teruel;009;Albarracín;1065;532;533
44;Teruel;010;Albentosa;288;143;145
44;Teruel;011;Alcaine;49;28;21
44;Teruel;012;Alcalá de la Selva;462;247;215
44;Teruel;013;Alcañiz;12642;6194;6448
44;Teruel;014;Alcorisa;3234;1633;1601
44;Teruel;016;Alfambra;777;387;390
44;Teruel;017;Aliaga;442;231;211
44;Teruel;021;Allepuz;147;80;67
44;Teruel;022;Alloza;913;441;472
44;Teruel;023;Allueva;12;7;5
44;Teruel;018;Almohaja;40;22;18
44;Teruel;019;Alobras;111;57;54
44;Teruel;020;Alpeñés;35;20;15
44;Teruel;024;Anadón;28;14;14
44;Teruel;025;Andorra;8680;4509;4171
44;Teruel;026;Arcos de las Salinas;186;100;86
44;Teruel;027;Arens de Lledó;272;126;146
44;Teruel;028;Argente;299;145;154
44;Teruel;029;Ariño;956;480;476
44;Teruel;031;Azaila;243;128;115
44;Teruel;032;Bádenas;29;13;16
44;Teruel;033;Báguena;624;308;316
44;Teruel;034;Bañón;226;120;106
44;Teruel;035;Barrachina;200;100;100
44;Teruel;036;Bea;28;17;11
44;Teruel;037;Beceite;701;365;336
44;Teruel;039;Bello;474;218;256
44;Teruel;038;Belmonte de San José;172;87;85
44;Teruel;040;Berge;260;133;127
44;Teruel;041;Bezas;76;40;36
44;Teruel;042;Blancas;243;117;126
44;Teruel;043;Blesa;165;96;69
44;Teruel;044;Bordón;142;78;64
44;Teruel;045;Bronchales;475;241;234
44;Teruel;046;Bueña;123;65;58
44;Teruel;047;Burbáguena;367;157;210
44;Teruel;048;Cabra de Mora;102;51;51
44;Teruel;049;Calaceite;1281;645;636
44;Teruel;050;Calamocha;4276;2134;2142
44;Teruel;051;Calanda;3552;1800;1752
44;Teruel;052;Calomarde;105;54;51
44;Teruel;053;Camañas;170;94;76
44;Teruel;054;Camarena de la Sierra;149;81;68
44;Teruel;055;Camarillas;132;71;61
44;Teruel;056;Caminreal;913;452;461
44;Teruel;059;Cantavieja;750;400;350
44;Teruel;060;Cañada de Benatanduz;82;51;31
44;Teruel;061;Cañada de Verich (La);112;61;51
44;Teruel;062;Cañada Vellida;74;44;30
44;Teruel;063;Cañizar del Olivar;156;79;77
44;Teruel;064;Cascante del Río;138;80;58
44;Teruel;065;Castejón de Tornos;122;58;64
44;Teruel;066;Castel de Cabra;229;118;111
44;Teruel;070;Castellar (El);103;55;48
44;Teruel;071;Castellote;927;458;469
44;Teruel;067;Castelnou;123;65;58
44;Teruel;068;Castelserás;938;494;444
44;Teruel;074;Cedrillas;557;288;269
44;Teruel;075;Celadas;488;257;231
44;Teruel;076;Cella;3066;1567;1499
44;Teruel;077;Cerollera (La);98;52;46
44;Teruel;080;Codoñera (La);363;185;178
44;Teruel;082;Corbalán;80;49;31
44;Teruel;084;Cortes de Aragón;145;70;75
44;Teruel;085;Cosa;137;74;63
44;Teruel;086;Cretas;693;354;339
44;Teruel;087;Crivillén;157;79;78
44;Teruel;088;Cuba (La);84;43;41
44;Teruel;089;Cubla;72;39;33
44;Teruel;090;Cucalón;102;53;49
44;Teruel;092;Cuervo (El);151;76;75
44;Teruel;093;Cuevas de Almudén;120;65;55
44;Teruel;094;Cuevas Labradas;216;113;103
44;Teruel;096;Ejulve;236;120;116
44;Teruel;097;Escorihuela;273;138;135
44;Teruel;099;Escucha;1212;651;561
44;Teruel;100;Estercuel;423;220;203
44;Teruel;101;Ferreruela de Huerva;100;51;49
44;Teruel;102;Fonfría;36;19;17
44;Teruel;103;Formiche Alto;217;114;103
44;Teruel;105;Fórnoles;130;60;70
44;Teruel;106;Fortanete;212;103;109
44;Teruel;107;Foz-Calanda;263;139;124
44;Teruel;108;Fresneda (La);480;250;230
44;Teruel;109;Frías de Albarracín;206;111;95
44;Teruel;110;Fuenferrada;53;28;25
44;Teruel;111;Fuentes Calientes;165;88;77
44;Teruel;112;Fuentes Claras;742;371;371
44;Teruel;113;Fuentes de Rubielos;82;41;41
44;Teruel;114;Fuentespalda;429;215;214
44;Teruel;115;Galve;138;72;66
44;Teruel;116;Gargallo;140;76;64
44;Teruel;117;Gea de Albarracín;501;256;245
44;Teruel;118;Ginebrosa (La);287;158;129
44;Teruel;119;Griegos;142;83;59
44;Teruel;120;Guadalaviar;304;154;150
44;Teruel;121;Gúdar;89;54;35
44;Teruel;122;Híjar;2102;1040;1062
44;Teruel;123;Hinojosa de Jarque;221;119;102
44;Teruel;124;Hoz de la Vieja (La);171;89;82
44;Teruel;125;Huesa del Común;155;79;76
44;Teruel;126;Iglesuela del Cid (La);519;273;246
44;Teruel;127;Jabaloyas;121;65;56
44;Teruel;128;Jarque de la Val;116;61;55
44;Teruel;129;Jatiel;76;35;41
44;Teruel;130;Jorcas;51;33;18
44;Teruel;131;Josa;45;23;22
44;Teruel;132;Lagueruela;89;49;40
44;Teruel;133;Lanzuela;41;26;15
44;Teruel;135;Libros;213;104;109
44;Teruel;136;Lidón;111;53;58
44;Teruel;137;Linares de Mora;351;196;155
44;Teruel;141;Lledó;229;118;111
44;Teruel;138;Loscos;210;114;96
44;Teruel;142;Maicas;20;8;12
44;Teruel;143;Manzanera;490;257;233
44;Teruel;144;Martín del Río;574;297;277
44;Teruel;145;Mas de las Matas;1512;757;755
44;Teruel;146;Mata de los Olmos (La);285;139;146
44;Teruel;147;Mazaleón;629;326;303
44;Teruel;148;Mezquita de Jarque;178;96;82
44;Teruel;149;Mirambel;160;84;76
44;Teruel;150;Miravete de la Sierra;49;28;21
44;Teruel;151;Molinos;397;199;198
44;Teruel;152;Monforte de Moyuela;116;61;55
44;Teruel;153;Monreal del Campo;2308;1158;1150
44;Teruel;154;Monroyo;403;205;198
44;Teruel;155;Montalbán;1789;893;896
44;Teruel;156;Monteagudo del Castillo;87;49;38
44;Teruel;157;Monterde de Albarracín;87;41;46
44;Teruel;158;Mora de Rubielos;1333;686;647
44;Teruel;159;Moscardón;73;38;35
44;Teruel;160;Mosqueruela;722;377;345
44;Teruel;161;Muniesa;808;406;402
44;Teruel;163;Noguera de Albarracín;172;86;86
44;Teruel;164;Nogueras;31;21;10
44;Teruel;165;Nogueruelas;248;126;122
44;Teruel;167;Obón;70;31;39
44;Teruel;168;Odón;311;155;156
44;Teruel;169;Ojos Negros;780;402;378
44;Teruel;171;Olba;233;116;117
44;Teruel;172;Oliete;574;288;286
44;Teruel;173;Olmos (Los);174;96;78
44;Teruel;174;Orihuela del Tremedal;627;309;318
44;Teruel;175;Orrios;223;115;108
44;Teruel;176;Palomar de Arroyos;320;174;146
44;Teruel;177;Pancrudo;228;124;104
44;Teruel;178;Parras de Castellote (Las);104;58;46
44;Teruel;179;Peñarroya de Tastavins;591;302;289
44;Teruel;180;Peracense;103;49;54
44;Teruel;181;Peralejos;111;57;54
44;Teruel;182;Perales del Alfambra;297;162;135
44;Teruel;183;Pitarque;135;65;70
44;Teruel;184;Plou;55;27;28
44;Teruel;185;Pobo (El);170;96;74
44;Teruel;187;Portellada (La);352;187;165
44;Teruel;189;Pozondón;101;51;50
44;Teruel;190;Pozuel del Campo;148;80;68
44;Teruel;191;Puebla de Híjar (La);1247;609;638
44;Teruel;192;Puebla de Valverde (La);498;266;232
44;Teruel;193;Puertomingalvo;164;87;77
44;Teruel;194;Ráfales;257;130;127
44;Teruel;195;Rillo;163;91;72
44;Teruel;196;Riodeva;267;129;138
44;Teruel;197;Ródenas;103;52;51
44;Teruel;198;Royuela;246;130;116
44;Teruel;199;Rubiales;58;30;28
44;Teruel;200;Rubielos de la Cérida;73;36;37
44;Teruel;201;Rubielos de Mora;633;321;312
44;Teruel;203;Salcedillo;9;4;5
44;Teruel;204;Saldón;53;34;19
44;Teruel;205;Samper de Calanda;1185;568;617
44;Teruel;206;San Agustín;184;97;87
44;Teruel;207;San Martín del Río;351;172;179
44;Teruel;208;Santa Cruz de Nogueras;32;20;12
44;Teruel;209;Santa Eulalia;1424;680;744
44;Teruel;210;Sarrión;1066;557;509
44;Teruel;211;Segura de los Baños;67;37;30
44;Teruel;212;Seno;58;29;29
44;Teruel;213;Singra;118;60;58
44;Teruel;215;Terriente;205;105;100
44;Teruel;216;Teruel;28487;13798;14689
44;Teruel;217;Toril y Masegoso;50;27;23
44;Teruel;218;Tormón;50;26;24
44;Teruel;219;Tornos;300;152;148
44;Teruel;220;Torralba de los Sisones;252;129;123
44;Teruel;223;Torre de Arcas;133;62;71
44;Teruel;224;Torre de las Arcas;43;24;19
44;Teruel;225;Torre del Compte;205;99;106
44;Teruel;227;Torre los Negros;102;52;50
44;Teruel;221;Torrecilla de Alcañiz;487;253;234
44;Teruel;222;Torrecilla del Rebollar;199;108;91
44;Teruel;226;Torrelacárcel;357;179;178
44;Teruel;228;Torremocha de Jiloca;202;96;106
44;Teruel;229;Torres de Albarracín;190;102;88
44;Teruel;230;Torrevelilla;207;102;105
44;Teruel;231;Torrijas;74;41;33
44;Teruel;232;Torrijo del Campo;685;342;343
44;Teruel;234;Tramacastiel;136;64;72
44;Teruel;235;Tramacastilla;144;69;75
44;Teruel;236;Tronchón;119;63;56
44;Teruel;237;Urrea de Gaén;700;340;360
44;Teruel;238;Utrillas;3743;1926;1817
44;Teruel;239;Valacloche;29;15;14
44;Teruel;240;Valbona;212;111;101
44;Teruel;241;Valdealgorfa;829;416;413
44;Teruel;243;Valdecuenca;49;30;19
44;Teruel;244;Valdelinares;131;70;61
44;Teruel;245;Valdeltormo;441;229;212
44;Teruel;246;Valderrobres;1903;951;952
44;Teruel;247;Valjunquera;474;242;232
44;Teruel;249;Vallecillo (El);25;11;14
44;Teruel;250;Veguillas de la Sierra;33;17;16
44;Teruel;251;Villafranca del Campo;403;210;193
44;Teruel;252;Villahermosa del Campo;89;50;39
44;Teruel;256;Villanueva del Rebollar de la Sierra;52;27;25
44;Teruel;257;Villar del Cobo;239;124;115
44;Teruel;258;Villar del Salz;145;76;69
44;Teruel;260;Villarluengo;243;123;120
44;Teruel;261;Villarquemado;1053;515;538
44;Teruel;262;Villarroya de los Pinares;218;110;108
44;Teruel;263;Villastar;381;196;185
44;Teruel;264;Villel;376;191;185
44;Teruel;265;Vinaceite;359;186;173
44;Teruel;266;Visiedo;273;134;139
44;Teruel;267;Vivel del Río Martín;140;74;66
44;Teruel;268;Zoma (La);51;27;24
45;Toledo;001;Ajofrín;2178;1119;1059
45;Toledo;002;Alameda de la Sagra;2737;1416;1321
45;Toledo;003;Albarreal de Tajo;571;290;281
45;Toledo;004;Alcabón;497;242;255
45;Toledo;005;Alcañizo;369;193;176
45;Toledo;006;Alcaudete de la Jara;1410;671;739
45;Toledo;007;Alcolea de Tajo;793;396;397
45;Toledo;008;Aldea en Cabo;200;100;100
45;Toledo;009;Aldeanueva de Barbarroya;924;465;459
45;Toledo;010;Aldeanueva de San Bartolomé;713;353;360
45;Toledo;011;Almendral de la Cañada;431;228;203
45;Toledo;012;Almonacid de Toledo;836;416;420
45;Toledo;013;Almorox;2182;1125;1057
45;Toledo;014;Añover de Tajo;4396;2246;2150
45;Toledo;015;Arcicóllar;468;235;233
45;Toledo;016;Argés;1855;926;929
45;Toledo;017;Azután;368;188;180
45;Toledo;018;Barcience;111;57;54
45;Toledo;019;Bargas;6112;3084;3028
45;Toledo;020;Belvís de la Jara;1901;942;959
45;Toledo;021;Borox;1955;948;1007
45;Toledo;022;Buenaventura;571;290;281
45;Toledo;023;Burguillos de Toledo;676;333;343
45;Toledo;024;Burujón;1249;653;596
45;Toledo;025;Cabañas de la Sagra;953;486;467
45;Toledo;026;Cabañas de Yepes;251;131;120
45;Toledo;027;Cabezamesada;581;295;286
45;Toledo;028;Calera y Chozas;3613;1846;1767
45;Toledo;029;Caleruela;363;183;180
45;Toledo;030;Calzada de Oropesa;732;361;371
45;Toledo;031;Camarena;1998;1013;985
45;Toledo;032;Camarenilla;538;267;271
45;Toledo;033;Campillo de la Jara (El);652;344;308
45;Toledo;034;Camuñas;1787;892;895
45;Toledo;035;Cardiel de los Montes;152;77;75
45;Toledo;036;Carmena;818;411;407
45;Toledo;037;Carpio de Tajo (El);2375;1133;1242
45;Toledo;038;Carranque;1051;535;516
45;Toledo;039;Carriches;299;143;156
45;Toledo;040;Casar de Escalona (El);883;440;443
45;Toledo;041;Casarrubios del Monte;1958;980;978
45;Toledo;042;Casasbuenas;279;138;141
45;Toledo;043;Castillo de Bayuela;1067;542;525
45;Toledo;045;Cazalegas;1124;558;566
45;Toledo;046;Cebolla;2598;1285;1313
45;Toledo;047;Cedillo del Condado;987;508;479
45;Toledo;048;Cerralbos (Los);512;256;256
45;Toledo;049;Cervera de los Montes;441;232;209
45;Toledo;056;Chozas de Canales;922;468;454
45;Toledo;057;Chueca;251;129;122
45;Toledo;050;Ciruelos;340;181;159
45;Toledo;051;Cobeja;1632;835;797
45;Toledo;052;Cobisa;323;157;166
45;Toledo;053;Consuegra;9882;4867;5015
45;Toledo;054;Corral de Almaguer;6036;3003;3033
45;Toledo;055;Cuerva;1248;622;626
45;Toledo;058;Domingo Pérez;558;275;283
45;Toledo;059;Dosbarrios;2052;1038;1014
45;Toledo;060;Erustes;194;97;97
45;Toledo;061;Escalona;1825;904;921
45;Toledo;062;Escalonilla;1467;723;744
45;Toledo;063;Espinoso del Rey;653;340;313
45;Toledo;064;Esquivias;3456;1732;1724
45;Toledo;065;Estrella (La);499;273;226
45;Toledo;066;Fuensalida;6877;3471;3406
45;Toledo;067;Gálvez;3199;1620;1579
45;Toledo;068;Garciotum;147;73;74
45;Toledo;069;Gerindote;1700;857;843
45;Toledo;070;Guadamur;1540;798;742
45;Toledo;071;Guardia (La);2441;1211;1230
45;Toledo;072;Herencias (Las);731;373;358
45;Toledo;073;Herreruela de Oropesa;445;231;214
45;Toledo;074;Hinojosa de San Vicente;510;279;231
45;Toledo;075;Hontanar;117;64;53
45;Toledo;076;Hormigos;396;207;189
45;Toledo;077;Huecas;377;193;184
45;Toledo;078;Huerta de Valdecarábanos;1717;840;877
45;Toledo;079;Iglesuela (La);486;243;243
45;Toledo;080;Illán de Vacas;"";"";""
45;Toledo;081;Illescas;7845;3924;3921
45;Toledo;082;Lagartera;1964;958;1006
45;Toledo;083;Layos;275;141;134
45;Toledo;084;Lillo;2881;1430;1451
45;Toledo;085;Lominchar;983;514;469
45;Toledo;086;Lucillos;483;232;251
45;Toledo;087;Madridejos;10354;5080;5274
45;Toledo;088;Magán;806;398;408
45;Toledo;089;Malpica de Tajo;1773;905;868
45;Toledo;090;Manzaneque;478;241;237
45;Toledo;091;Maqueda;488;248;240
45;Toledo;092;Marjaliza;346;177;169
45;Toledo;093;Marrupe;151;73;78
45;Toledo;094;Mascaraque;550;258;292
45;Toledo;095;Mata (La);1002;492;510
45;Toledo;096;Mazarambroz;1204;587;617
45;Toledo;097;Mejorada;1129;583;546
45;Toledo;098;Menasalbas;2937;1518;1419
45;Toledo;099;Méntrida;1500;770;730
45;Toledo;100;Mesegar de Tajo;235;117;118
45;Toledo;101;Miguel Esteban;4673;2319;2354
45;Toledo;102;Mocejón;3936;1983;1953
45;Toledo;103;Mohedas de la Jara;733;368;365
45;Toledo;104;Montearagón;486;247;239
45;Toledo;105;Montesclaros;484;232;252
45;Toledo;106;Mora;9302;4529;4773
45;Toledo;107;Nambroca;1849;905;944
45;Toledo;108;Nava de Ricomalillo (La);790;411;379
45;Toledo;109;Navahermosa;3742;1925;1817
45;Toledo;110;Navalcán;2559;1335;1224
45;Toledo;111;Navalmoralejo;91;44;47
45;Toledo;112;Navalmorales (Los);2753;1356;1397
45;Toledo;113;Navalucillos (Los);3027;1528;1499
45;Toledo;114;Navamorcuende;771;398;373
45;Toledo;115;Noblejas;2911;1460;1451
45;Toledo;116;Noez;974;496;478
45;Toledo;117;Nombela;907;464;443
45;Toledo;118;Novés;1521;767;754
45;Toledo;119;Numancia de la Sagra;1043;539;504
45;Toledo;120;Nuño Gómez;182;89;93
45;Toledo;121;Ocaña;5733;2822;2911
45;Toledo;122;Olías del Rey;3323;1674;1649
45;Toledo;123;Ontígola;773;398;375
45;Toledo;124;Orgaz;2620;1311;1309
45;Toledo;125;Oropesa;2930;1466;1464
45;Toledo;126;Otero;243;111;132
45;Toledo;127;Palomeque;413;211;202
45;Toledo;128;Pantoja;2037;1048;989
45;Toledo;129;Paredes de Escalona;106;49;57
45;Toledo;130;Parrillas;514;253;261
45;Toledo;131;Pelahustán;410;215;195
45;Toledo;132;Pepino;617;318;299
45;Toledo;133;Polán;3094;1559;1535
45;Toledo;134;Portillo de Toledo;1910;964;946
45;Toledo;135;Puebla de Almoradiel (La);5401;2682;2719
45;Toledo;136;Puebla de Montalbán (La);6218;3100;3118
45;Toledo;137;Pueblanueva (La);2003;1011;992
45;Toledo;138;Puente del Arzobispo (El);1581;757;824
45;Toledo;139;Puerto de San Vicente;295;141;154
45;Toledo;140;Pulgar;1160;594;566
45;Toledo;141;Quero;1462;738;724
45;Toledo;142;Quintanar de la Orden;9019;4513;4506
45;Toledo;143;Quismondo;1240;611;629
45;Toledo;144;Real de San Vicente (El);999;506;493
45;Toledo;145;Recas;2227;1150;1077
45;Toledo;146;Retamoso;196;106;90
45;Toledo;147;Rielves;422;215;207
45;Toledo;148;Robledo del Mazo;567;295;272
45;Toledo;149;Romeral (El);1002;488;514
45;Toledo;150;San Bartolomé de las Abiertas;484;249;235
45;Toledo;151;San Martín de Montalbán;784;393;391
45;Toledo;152;San Martín de Pusa;818;434;384
45;Toledo;153;San Pablo de los Montes;2025;1025;1000
45;Toledo;154;San Román de los Montes;433;220;213
45;Toledo;155;Santa Ana de Pusa;417;215;202
45;Toledo;156;Santa Cruz de la Zarza;4302;2163;2139
45;Toledo;157;Santa Cruz del Retamar;1442;724;718
45;Toledo;158;Santa Olalla;2269;1166;1103
45;Toledo;901;Santo Domingo-Caudilla;796;387;409
45;Toledo;159;Sartajada;128;76;52
45;Toledo;160;Segurilla;944;470;474
45;Toledo;161;Seseña;2781;1429;1352
45;Toledo;162;Sevilleja de la Jara;1204;623;581
45;Toledo;163;Sonseca;8562;4272;4290
45;Toledo;164;Sotillo de las Palomas;190;103;87
45;Toledo;165;Talavera de la Reina;68700;33937;34763
45;Toledo;166;Tembleque;2152;1072;1080
45;Toledo;167;Toboso (El);2199;1074;1125
45;Toledo;168;Toledo;59802;28963;30839
45;Toledo;169;Torralba de Oropesa;324;154;170
45;Toledo;171;Torre de Esteban Hambrán (La);1283;658;625
45;Toledo;170;Torrecilla de la Jara;349;189;160
45;Toledo;172;Torrico;1015;511;504
45;Toledo;173;Torrijos;9359;4608;4751
45;Toledo;174;Totanés;380;188;192
45;Toledo;175;Turleque;1098;548;550
45;Toledo;176;Ugena;463;246;217
45;Toledo;177;Urda;3115;1554;1561
45;Toledo;179;Valdeverdeja;954;440;514
45;Toledo;180;Valmojado;2164;1110;1054
45;Toledo;181;Velada;2296;1174;1122
45;Toledo;182;Ventas con Peña Aguilera (Las);1464;747;717
45;Toledo;183;Ventas de Retamosa (Las);514;268;246
45;Toledo;184;Ventas de San Julián (Las);226;106;120
45;Toledo;186;Villa de Don Fadrique (La);4206;2049;2157
45;Toledo;185;Villacañas;8799;4379;4420
45;Toledo;187;Villafranca de los Caballeros;5425;2668;2757
45;Toledo;188;Villaluenga de la Sagra;2467;1233;1234
45;Toledo;189;Villamiel de Toledo;272;132;140
45;Toledo;190;Villaminaya;692;345;347
45;Toledo;191;Villamuelas;776;395;381
45;Toledo;192;Villanueva de Alcardete;3186;1596;1590
45;Toledo;193;Villanueva de Bogas;855;421;434
45;Toledo;194;Villarejo de Montalbán;105;50;55
45;Toledo;195;Villarrubia de Santiago;2984;1487;1497
45;Toledo;196;Villaseca de la Sagra;1580;790;790
45;Toledo;197;Villasequilla;2387;1234;1153
45;Toledo;198;Villatobas;2436;1214;1222
45;Toledo;199;Viso de San Juan (El);553;284;269
45;Toledo;200;Yébenes (Los);6654;3338;3316
45;Toledo;201;Yeles;1034;534;500
45;Toledo;202;Yepes;4366;2204;2162
45;Toledo;203;Yuncler;1784;924;860
45;Toledo;204;Yunclillos;569;284;285
45;Toledo;205;Yuncos;2808;1452;1356
46;Valencia/València;001;Ademuz;1300;647;653
46;Valencia/València;002;Ador;1088;543;545
46;Valencia/València;004;Agullent;2097;1011;1086
46;Valencia/València;042;Aielo de Malferit;3823;1891;1932
46;Valencia/València;043;Aielo de Rugat;201;103;98
46;Valencia/València;005;Alaquàs;24163;11990;12173
46;Valencia/València;006;Albaida;5868;2872;2996
46;Valencia/València;007;Albal;9157;4574;4583
46;Valencia/València;008;Albalat de la Ribera;3486;1692;1794
46;Valencia/València;009;Albalat dels Sorells;3538;1723;1815
46;Valencia/València;010;Albalat dels Tarongers;567;280;287
46;Valencia/València;011;Alberic;8608;4190;4418
46;Valencia/València;012;Alborache;882;449;433
46;Valencia/València;013;Alboraya;11697;5749;5948
46;Valencia/València;014;Albuixech;2963;1458;1505
46;Valencia/València;016;Alcàntera de Xúquer;1450;726;724
46;Valencia/València;015;Alcàsser;7225;3635;3590
46;Valencia/València;018;Alcublas;860;437;423
46;Valencia/València;020;Alcúdia de Crespins (L');4091;2002;2089
46;Valencia/València;019;Alcúdia (L');10024;4915;5109
46;Valencia/València;021;Aldaia;22381;11127;11254
46;Valencia/València;022;Alfafar;20151;10010;10141
46;Valencia/València;024;Alfara de Algimia;527;259;268
46;Valencia/València;025;Alfara del Patriarca;2835;1402;1433
46;Valencia/València;026;Alfarp;1335;647;688
46;Valencia/València;027;Alfarrasí;1209;591;618
46;Valencia/València;023;Alfauir;287;145;142
46;Valencia/València;028;Algar de Palancia;393;187;206
46;Valencia/València;029;Algemesí;25375;12469;12906
46;Valencia/València;030;Algimia de Alfara;867;428;439
46;Valencia/València;031;Alginet;11645;5786;5859
46;Valencia/València;032;Almàssera;5434;2615;2819
46;Valencia/València;033;Almiserà;197;101;96
46;Valencia/València;034;Almoines;1868;933;935
46;Valencia/València;035;Almussafes;6360;3166;3194
46;Valencia/València;036;Alpuente;1191;620;571
46;Valencia/València;037;Alquería de la Condesa/Alqueria de la Comtessa (l');1547;738;809
46;Valencia/València;017;Alzira;40309;19619;20690
46;Valencia/València;038;Andilla;183;98;85
46;Valencia/València;039;Anna;2666;1325;1341
46;Valencia/València;040;Antella;1635;821;814
46;Valencia/València;041;Aras de los Olmos;428;236;192
46;Valencia/València;003;Atzeneta d'Albaida;1252;640;612
46;Valencia/València;044;Ayora;5506;2839;2667
46;Valencia/València;046;Barx;995;491;504
46;Valencia/València;045;Barxeta;1599;806;793
46;Valencia/València;047;Bèlgida;679;325;354
46;Valencia/València;048;Bellreguard;3683;1807;1876
46;Valencia/València;049;Bellús;413;202;211
46;Valencia/València;050;Benagéber;121;65;56
46;Valencia/València;051;Benaguasil;8718;4356;4362
46;Valencia/València;052;Benavites;657;317;340
46;Valencia/València;053;Beneixida;489;238;251
46;Valencia/València;054;Benetússer;14004;6929;7075
46;Valencia/València;055;Beniarjó;1104;514;590
46;Valencia/València;056;Beniatjar;257;126;131
46;Valencia/València;057;Benicolet;494;257;237
46;Valencia/València;060;Benifaió;11912;5883;6029
46;Valencia/València;059;Benifairó de la Valldigna;1652;812;840
46;Valencia/València;058;Benifairó de les Valls;1962;974;988
46;Valencia/València;061;Beniflá;153;70;83
46;Valencia/València;062;Benigánim;5326;2750;2576
46;Valencia/València;063;Benimodo;1710;884;826
46;Valencia/València;064;Benimuslem;569;274;295
46;Valencia/València;065;Beniparrell;1359;677;682
46;Valencia/València;066;Benirredrà;901;424;477
46;Valencia/València;067;Benisanó;1672;846;826
46;Valencia/València;068;Benissoda;306;169;137
46;Valencia/València;069;Benisuera;203;91;112
46;Valencia/València;070;Bétera;9775;4834;4941
46;Valencia/València;071;Bicorp;713;356;357
46;Valencia/València;072;Bocairent;4661;2273;2388
46;Valencia/València;073;Bolbaite;1395;713;682
46;Valencia/València;074;Bonrepòs i Mirambell;2346;1151;1195
46;Valencia/València;075;Bufali;214;109;105
46;Valencia/València;076;Bugarra;876;442;434
46;Valencia/València;077;Buñol;9096;4521;4575
46;Valencia/València;078;Burjassot;34138;16650;17488
46;Valencia/València;079;Calles;404;221;183
46;Valencia/València;080;Camporrobles;1492;743;749
46;Valencia/València;081;Canals;12308;6063;6245
46;Valencia/València;082;Canet d'En Berenguer;1538;753;785
46;Valencia/València;083;Carcaixent;20208;9846;10362
46;Valencia/València;084;Càrcer;2009;966;1043
46;Valencia/València;085;Carlet;14167;6944;7223
46;Valencia/València;086;Carrícola;67;30;37
46;Valencia/València;087;Casas Altas;164;83;81
46;Valencia/València;088;Casas Bajas;329;168;161
46;Valencia/València;089;Casinos;2281;1177;1104
46;Valencia/València;090;Castelló de Rugat;2045;1051;994
46;Valencia/València;091;Castellonet de la Conquesta;89;47;42
46;Valencia/València;092;Castielfabib;645;340;305
46;Valencia/València;093;Catadau;2170;1072;1098
46;Valencia/València;094;Catarroja;20217;9877;10340
46;Valencia/València;095;Caudete de las Fuentes;917;464;453
46;Valencia/València;096;Cerdà;258;129;129
46;Valencia/València;107;Chella;2510;1250;1260
46;Valencia/València;106;Chelva;2065;1048;1017
46;Valencia/València;108;Chera;623;319;304
46;Valencia/València;109;Cheste;6717;3371;3346
46;Valencia/València;111;Chiva;7481;3684;3797
46;Valencia/València;112;Chulilla;681;332;349
46;Valencia/València;097;Cofrentes;859;445;414
46;Valencia/València;098;Corbera;3141;1519;1622
46;Valencia/València;099;Cortes de Pallás;713;381;332
46;Valencia/València;100;Cotes;386;176;210
46;Valencia/València;105;Cullera;20121;9939;10182
46;Valencia/València;113;Daimús;1279;644;635
46;Valencia/València;114;Domeño;483;252;231
46;Valencia/València;115;Dos Aguas;410;225;185
46;Valencia/València;116;Eliana (L');8255;4097;4158
46;Valencia/València;117;Emperador;161;78;83
46;Valencia/València;118;Enguera;5042;2472;2570
46;Valencia/València;119;Ènova (L');1178;584;594
46;Valencia/València;120;Estivella;1075;499;576
46;Valencia/València;121;Estubeny;138;64;74
46;Valencia/València;122;Faura;2816;1392;1424
46;Valencia/València;123;Favara;1727;839;888
46;Valencia/València;126;Foios;5320;2580;2740
46;Valencia/València;128;Font de la Figuera (La);2221;1098;1123
46;Valencia/València;127;Font d'En Carròs (La);3265;1620;1645
46;Valencia/València;124;Fontanars dels Alforins;948;494;454
46;Valencia/València;125;Fortaleny;999;503;496
46;Valencia/València;129;Fuenterrobles;740;383;357
46;Valencia/València;131;Gandia;51806;25294;26512
46;Valencia/València;130;Gavarda;1250;604;646
46;Valencia/València;132;Genovés;2189;1090;1099
46;Valencia/València;133;Gestalgar;606;286;320
46;Valencia/València;134;Gilet;1199;594;605
46;Valencia/València;135;Godella;9587;4692;4895
46;Valencia/València;136;Godelleta;1943;953;990
46;Valencia/València;137;Granja de la Costera (La);371;182;189
46;Valencia/València;138;Guadasequies;404;200;204
46;Valencia/València;139;Guadassuar;5387;2690;2697
46;Valencia/València;140;Guardamar de la Safor;57;35;22
46;Valencia/València;141;Higueruelas;593;319;274
46;Valencia/València;142;Jalance;1174;604;570
46;Valencia/València;144;Jarafuel;1025;529;496
46;Valencia/València;154;Llanera de Ranes;966;484;482
46;Valencia/València;155;Llaurí;1391;681;710
46;Valencia/València;147;Llíria;13599;6682;6917
46;Valencia/València;153;Llocnou de Sant Jeroni;562;271;291
46;Valencia/València;151;Llocnou d'En Fenollet;667;321;346
46;Valencia/València;156;Llombai;2181;1076;1105
46;Valencia/València;157;Llosa de Ranes (La);3582;1837;1745
46;Valencia/València;150;Llutxent;2361;1202;1159
46;Valencia/València;148;Loriguilla;988;500;488
46;Valencia/València;149;Losa del Obispo;478;230;248
46;Valencia/València;152;Lugar Nuevo de la Corona;121;57;64
46;Valencia/València;158;Macastre;868;416;452
46;Valencia/València;159;Manises;24530;12004;12526
46;Valencia/València;160;Manuel;2421;1172;1249
46;Valencia/València;161;Marines;1169;587;582
46;Valencia/València;162;Masalavés;1500;776;724
46;Valencia/València;163;Massalfassar;1413;704;709
46;Valencia/València;164;Massamagrell;12176;6020;6156
46;Valencia/València;165;Massanassa;7666;3740;3926
46;Valencia/València;166;Meliana;9149;4459;4690
46;Valencia/València;167;Millares;756;387;369
46;Valencia/València;168;Miramar;955;466;489
46;Valencia/València;169;Mislata;38666;18904;19762
46;Valencia/València;170;Mogente/Moixent;4165;2135;2030
46;Valencia/València;171;Moncada;17898;8893;9005
46;Valencia/València;172;Monserrat;2546;1313;1233
46;Valencia/València;173;Montaverner;1658;838;820
46;Valencia/València;174;Montesa;1269;637;632
46;Valencia/València;175;Montichelvo;629;309;320
46;Valencia/València;176;Montroy;1481;758;723
46;Valencia/València;177;Museros;4106;2037;2069
46;Valencia/València;178;Náquera;1450;704;746
46;Valencia/València;179;Navarrés;2827;1408;1419
46;Valencia/València;180;Novelé/Novetlè;566;281;285
46;Valencia/València;181;Oliva;20289;9985;10304
46;Valencia/València;183;Olleria (L');6798;3464;3334
46;Valencia/València;182;Olocau;656;341;315
46;Valencia/València;184;Ontinyent;29888;14689;15199
46;Valencia/València;185;Otos;563;277;286
46;Valencia/València;186;Paiporta;15691;7718;7973
46;Valencia/València;187;Palma de Gandía;1517;753;764
46;Valencia/València;188;Palmera;486;238;248
46;Valencia/València;189;Palomar (El);502;237;265
46;Valencia/València;190;Paterna;41081;20284;20797
46;Valencia/València;191;Pedralba;2002;1013;989
46;Valencia/València;192;Petrés;712;339;373
46;Valencia/València;193;Picanya;7785;3877;3908
46;Valencia/València;194;Picassent;14553;7319;7234
46;Valencia/València;195;Piles;2108;1015;1093
46;Valencia/València;196;Pinet;249;137;112
46;Valencia/València;199;Pobla de Farnals (La);4507;2238;2269
46;Valencia/València;202;Pobla de Vallbona (La);8004;4102;3902
46;Valencia/València;200;Pobla del Duc (La);2609;1284;1325
46;Valencia/València;203;Pobla Llarga (La);4365;2116;2249
46;Valencia/València;197;Polinyà de Xúquer;3064;1513;1551
46;Valencia/València;198;Potríes;976;475;501
46;Valencia/València;205;Puçol;12514;6163;6351
46;Valencia/València;201;Puebla de San Miguel;39;22;17
46;Valencia/València;204;Puig;6428;3175;3253
46;Valencia/València;101;Quart de les Valls;1086;509;577
46;Valencia/València;102;Quart de Poblet;26694;13160;13534
46;Valencia/València;103;Quartell;1337;651;686
46;Valencia/València;104;Quatretonda;2585;1320;1265
46;Valencia/València;206;Quesa;788;390;398
46;Valencia/València;207;Rafelbuñol/Rafelbunyol;4963;2467;2496
46;Valencia/València;208;Rafelcofer;1460;683;777
46;Valencia/València;209;Rafelguaraf;2419;1185;1234
46;Valencia/València;210;Ráfol de Salem;372;167;205
46;Valencia/València;211;Real de Gandía;1902;893;1009
46;Valencia/València;212;Real de Montroi;1828;920;908
46;Valencia/València;213;Requena;17484;8772;8712
46;Valencia/València;214;Riba-roja de Túria;9778;4866;4912
46;Valencia/València;215;Riola;1652;839;813
46;Valencia/València;216;Rocafort;4074;1992;2082
46;Valencia/València;217;Rotglá y Corberá;1011;507;504
46;Valencia/València;218;Rótova;1279;648;631
46;Valencia/València;219;Rugat;200;98;102
46;Valencia/València;220;Sagunto/Sagunt;55457;27148;28309
46;Valencia/València;221;Salem;467;236;231
46;Valencia/València;222;San Juan de Énova;355;158;197
46;Valencia/València;223;Sedaví;8120;3984;4136
46;Valencia/València;224;Segart;156;72;84
46;Valencia/València;225;Sellent;490;253;237
46;Valencia/València;226;Sempere;46;21;25
46;Valencia/València;227;Senyera;825;393;432
46;Valencia/València;228;Serra;1421;704;717
46;Valencia/València;229;Siete Aguas;1076;526;550
46;Valencia/València;230;Silla;16487;8311;8176
46;Valencia/València;231;Simat de la Valldigna;3140;1585;1555
46;Valencia/València;232;Sinarcas;1327;696;631
46;Valencia/València;233;Sollana;4088;1992;2096
46;Valencia/València;234;Sot de Chera;301;150;151
46;Valencia/València;235;Sueca;22943;11213;11730
46;Valencia/València;236;Sumacàrcer;1370;699;671
46;Valencia/València;237;Tavernes Blanques;8075;3950;4125
46;Valencia/València;238;Tavernes de la Valldigna;16166;8049;8117
46;Valencia/València;239;Teresa de Cofrentes;766;391;375
46;Valencia/València;240;Terrateig;200;104;96
46;Valencia/València;241;Titaguas;618;326;292
46;Valencia/València;242;Torrebaja;487;248;239
46;Valencia/València;243;Torrella;175;88;87
46;Valencia/València;244;Torrent;56564;27991;28573
46;Valencia/València;245;Torres Torres;379;180;199
46;Valencia/València;246;Tous;1267;630;637
46;Valencia/València;247;Tuéjar;1387;730;657
46;Valencia/València;248;Turís;4174;2136;2038
46;Valencia/València;249;Utiel;11836;5887;5949
46;Valencia/València;250;Valencia;752909;358913;393996
46;Valencia/València;251;Vallada;2951;1494;1457
46;Valencia/València;252;Vallanca;248;120;128
46;Valencia/València;253;Vallés;99;52;47
46;Valencia/València;254;Venta del Moro;1755;905;850
46;Valencia/València;256;Vilamarxant;4754;2398;2356
46;Valencia/València;255;Villalonga;3565;1783;1782
46;Valencia/València;257;Villanueva de Castellón;6967;3415;3552
46;Valencia/València;258;Villar del Arzobispo;3410;1685;1725
46;Valencia/València;259;Villargordo del Cabriel;799;408;391
46;Valencia/València;260;Vinalesa;2222;1042;1180
46;Valencia/València;145;Xàtiva;24461;11873;12588
46;Valencia/València;143;Xeraco;4590;2294;2296
46;Valencia/València;146;Xeresa;2003;1013;990
46;Valencia/València;110;Xirivella;26129;12979;13150
46;Valencia/València;261;Yátova;1986;1033;953
46;Valencia/València;262;Yesa (La);306;156;150
46;Valencia/València;263;Zarra;478;246;232
47;Valladolid;001;Adalia;92;51;41
47;Valladolid;002;Aguasal;30;16;14
47;Valladolid;003;Aguilar de Campos;431;227;204
47;Valladolid;004;Alaejos;1788;919;869
47;Valladolid;005;Alcazarén;785;419;366
47;Valladolid;006;Aldea de San Miguel;231;118;113
47;Valladolid;007;Aldeamayor de San Martín;1090;542;548
47;Valladolid;008;Almenara de Adaja;36;20;16
47;Valladolid;009;Amusquillo;203;109;94
47;Valladolid;010;Arroyo de la Encomienda;1406;724;682
47;Valladolid;011;Ataquines;946;490;456
47;Valladolid;012;Bahabón;255;126;129
47;Valladolid;013;Barcial de la Loma;184;92;92
47;Valladolid;014;Barruelo del Valle;84;42;42
47;Valladolid;015;Becilla de Valderaduey;508;257;251
47;Valladolid;016;Benafarces;107;52;55
47;Valladolid;017;Bercero;291;155;136
47;Valladolid;018;Berceruelo;38;20;18
47;Valladolid;019;Berrueces;126;70;56
47;Valladolid;020;Bobadilla del Campo;446;235;211
47;Valladolid;021;Bocigas;167;80;87
47;Valladolid;022;Bocos de Duero;103;44;59
47;Valladolid;023;Boecillo;910;464;446
47;Valladolid;024;Bolaños de Campos;414;209;205
47;Valladolid;025;Brahojos de Medina;207;117;90
47;Valladolid;026;Bustillo de Chaves;119;56;63
47;Valladolid;027;Cabezón de Pisuerga;1522;765;757
47;Valladolid;028;Cabezón de Valderaduey;56;28;28
47;Valladolid;029;Cabreros del Monte;115;59;56
47;Valladolid;030;Campaspero;1698;874;824
47;Valladolid;031;Campillo (El);241;133;108
47;Valladolid;032;Camporredondo;250;136;114
47;Valladolid;033;Canalejas de Peñafiel;360;189;171
47;Valladolid;034;Canillas de Esgueva;159;83;76
47;Valladolid;035;Carpio;1315;695;620
47;Valladolid;036;Casasola de Arión;425;227;198
47;Valladolid;037;Castrejón de Trabancos;285;159;126
47;Valladolid;038;Castrillo de Duero;246;128;118
47;Valladolid;039;Castrillo-Tejeriego;322;167;155
47;Valladolid;040;Castrobol;101;47;54
47;Valladolid;041;Castrodeza;286;148;138
47;Valladolid;042;Castromembibre;99;50;49
47;Valladolid;043;Castromonte;547;289;258
47;Valladolid;044;Castronuevo de Esgueva;304;163;141
47;Valladolid;045;Castronuño;1227;646;581
47;Valladolid;046;Castroponce;206;100;106
47;Valladolid;047;Castroverde de Cerrato;313;168;145
47;Valladolid;048;Ceinos de Campos;278;151;127
47;Valladolid;049;Cervillego de la Cruz;191;98;93
47;Valladolid;050;Cigales;1687;800;887
47;Valladolid;051;Ciguñuela;368;191;177
47;Valladolid;052;Cistérniga;1666;848;818
47;Valladolid;053;Cogeces de Íscar;160;83;77
47;Valladolid;054;Cogeces del Monte;1056;558;498
47;Valladolid;055;Corcos;257;133;124
47;Valladolid;056;Corrales de Duero;169;93;76
47;Valladolid;057;Cubillas de Santa Marta;265;141;124
47;Valladolid;058;Cuenca de Campos;326;163;163
47;Valladolid;059;Curiel de Duero;178;95;83
47;Valladolid;060;Encinas de Esgueva;447;236;211
47;Valladolid;061;Esguevillas de Esgueva;464;242;222
47;Valladolid;062;Fombellida;328;172;156
47;Valladolid;063;Fompedraza;155;87;68
47;Valladolid;064;Fontihoyuelo;55;31;24
47;Valladolid;065;Fresno el Viejo;1378;695;683
47;Valladolid;066;Fuensaldaña;697;355;342
47;Valladolid;067;Fuente el Sol;346;177;169
47;Valladolid;068;Fuente-Olmedo;67;31;36
47;Valladolid;069;Gallegos de Hornija;154;77;77
47;Valladolid;070;Gatón de Campos;68;37;31
47;Valladolid;071;Geria;424;234;190
47;Valladolid;073;Herrín de Campos;240;116;124
47;Valladolid;074;Hornillos de Eresma;151;76;75
47;Valladolid;075;Íscar;5913;2983;2930
47;Valladolid;076;Laguna de Duero;11579;5833;5746
47;Valladolid;077;Langayo;531;281;250
47;Valladolid;079;Llano de Olmedo;119;56;63
47;Valladolid;078;Lomoviejo;299;149;150
47;Valladolid;080;Manzanillo;58;30;28
47;Valladolid;081;Marzales;91;44;47
47;Valladolid;082;Matapozuelos;943;480;463
47;Valladolid;083;Matilla de los Caños;91;48;43
47;Valladolid;084;Mayorga;1639;780;859
47;Valladolid;086;Medina de Rioseco;5022;2458;2564
47;Valladolid;085;Medina del Campo;19735;9698;10037
47;Valladolid;087;Megeces;484;242;242
47;Valladolid;088;Melgar de Abajo;222;109;113
47;Valladolid;089;Melgar de Arriba;334;167;167
47;Valladolid;090;Mojados;2227;1114;1113
47;Valladolid;091;Monasterio de Vega;110;51;59
47;Valladolid;092;Montealegre de Campos;179;99;80
47;Valladolid;093;Montemayor de Pililla;1111;589;522
47;Valladolid;094;Moral de la Reina;267;139;128
47;Valladolid;095;Moraleja de las Panaderas;19;10;9
47;Valladolid;096;Morales de Campos;222;119;103
47;Valladolid;097;Mota del Marqués;501;240;261
47;Valladolid;098;Mucientes;648;334;314
47;Valladolid;099;Mudarra (La);307;167;140
47;Valladolid;100;Muriel;281;137;144
47;Valladolid;101;Nava del Rey;2355;1148;1207
47;Valladolid;102;Nueva Villa de las Torres;433;227;206
47;Valladolid;103;Olivares de Duero;328;176;152
47;Valladolid;104;Olmedo;3559;1739;1820
47;Valladolid;105;Olmos de Esgueva;186;99;87
47;Valladolid;106;Olmos de Peñafiel;90;49;41
47;Valladolid;109;Palazuelo de Vedija;259;132;127
47;Valladolid;110;Parrilla (La);645;315;330
47;Valladolid;111;Pedraja de Portillo (La);1036;510;526
47;Valladolid;112;Pedrajas de San Esteban;3123;1595;1528
47;Valladolid;113;Pedrosa del Rey;278;142;136
47;Valladolid;114;Peñafiel;5062;2577;2485
47;Valladolid;115;Peñaflor de Hornija;497;263;234
47;Valladolid;116;Pesquera de Duero;569;298;271
47;Valladolid;117;Piña de Esgueva;434;230;204
47;Valladolid;118;Piñel de Abajo;267;146;121
47;Valladolid;119;Piñel de Arriba;189;98;91
47;Valladolid;121;Pollos;909;464;445
47;Valladolid;122;Portillo;2552;1299;1253
47;Valladolid;123;Pozal de Gallinas;499;258;241
47;Valladolid;124;Pozaldez;594;288;306
47;Valladolid;125;Pozuelo de la Orden;102;53;49
47;Valladolid;126;Puras;72;37;35
47;Valladolid;127;Quintanilla de Arriba;254;136;118
47;Valladolid;129;Quintanilla de Onésimo;1115;600;515
47;Valladolid;130;Quintanilla de Trigueros;98;48;50
47;Valladolid;128;Quintanilla del Molar;88;37;51
47;Valladolid;131;Rábano;266;138;128
47;Valladolid;132;Ramiro;82;40;42
47;Valladolid;133;Renedo de Esgueva;814;430;384
47;Valladolid;134;Roales de Campos;307;165;142
47;Valladolid;135;Robladillo;105;54;51
47;Valladolid;137;Roturas;22;12;10
47;Valladolid;138;Rubí de Bracamonte;369;198;171
47;Valladolid;139;Rueda;1575;811;764
47;Valladolid;140;Saelices de Mayorga;226;121;105
47;Valladolid;141;Salvador de Zapardiel;223;115;108
47;Valladolid;142;San Cebrián de Mazote;264;142;122
47;Valladolid;143;San Llorente;239;124;115
47;Valladolid;144;San Martín de Valvení;121;67;54
47;Valladolid;145;San Miguel del Arroyo;855;445;410
47;Valladolid;146;San Miguel del Pino;218;119;99
47;Valladolid;147;San Pablo de la Moraleja;195;103;92
47;Valladolid;148;San Pedro de Latarce;729;400;329
47;Valladolid;149;San Pelayo;49;22;27
47;Valladolid;150;San Román de Hornija;543;269;274
47;Valladolid;151;San Salvador;53;27;26
47;Valladolid;156;San Vicente del Palacio;307;157;150
47;Valladolid;152;Santa Eufemia del Arroyo;147;75;72
47;Valladolid;153;Santervás de Campos;199;106;93
47;Valladolid;154;Santibáñez de Valcorba;227;116;111
47;Valladolid;155;Santovenia de Pisuerga;1078;553;525
47;Valladolid;157;Sardón de Duero;665;337;328
47;Valladolid;158;Seca (La);1067;567;500
47;Valladolid;159;Serrada;1042;538;504
47;Valladolid;160;Siete Iglesias de Trabancos;719;366;353
47;Valladolid;161;Simancas;1996;1016;980
47;Valladolid;162;Tamariz de Campos;114;59;55
47;Valladolid;163;Tiedra;456;224;232
47;Valladolid;164;Tordehumos;606;312;294
47;Valladolid;165;Tordesillas;7548;3787;3761
47;Valladolid;169;Torre de Esgueva;131;63;68
47;Valladolid;170;Torre de Peñafiel;54;29;25
47;Valladolid;166;Torrecilla de la Abadesa;405;214;191
47;Valladolid;167;Torrecilla de la Orden;425;204;221
47;Valladolid;168;Torrecilla de la Torre;47;27;20
47;Valladolid;171;Torrelobatón;657;325;332
47;Valladolid;172;Torrescárcela;198;97;101
47;Valladolid;173;Traspinedo;785;397;388
47;Valladolid;174;Trigueros del Valle;279;143;136
47;Valladolid;175;Tudela de Duero;4889;2489;2400
47;Valladolid;176;Unión de Campos (La);381;179;202
47;Valladolid;177;Urones de Castroponce;207;118;89
47;Valladolid;178;Urueña;230;114;116
47;Valladolid;179;Valbuena de Duero;547;283;264
47;Valladolid;180;Valdearcos de la Vega;170;87;83
47;Valladolid;181;Valdenebro de los Valles;276;146;130
47;Valladolid;182;Valdestillas;1431;732;699
47;Valladolid;183;Valdunquillo;293;144;149
47;Valladolid;186;Valladolid;330700;160216;170484
47;Valladolid;184;Valoria la Buena;698;364;334
47;Valladolid;185;Valverde de Campos;121;64;57
47;Valladolid;187;Vega de Ruiponce;196;91;105
47;Valladolid;188;Vega de Valdetronco;212;116;96
47;Valladolid;189;Velascálvaro;203;106;97
47;Valladolid;190;Velilla;151;82;69
47;Valladolid;191;Velliza;165;91;74
47;Valladolid;192;Ventosa de la Cuesta;170;87;83
47;Valladolid;193;Viana de Cega;1056;538;518
47;Valladolid;195;Villabáñez;456;238;218
47;Valladolid;196;Villabaruz de Campos;57;25;32
47;Valladolid;197;Villabrágima;1293;669;624
47;Valladolid;198;Villacarralón;143;74;69
47;Valladolid;199;Villacid de Campos;132;73;59
47;Valladolid;200;Villaco;173;99;74
47;Valladolid;203;Villafrades de Campos;160;75;85
47;Valladolid;204;Villafranca de Duero;437;219;218
47;Valladolid;205;Villafrechós;577;289;288
47;Valladolid;206;Villafuerte;180;82;98
47;Valladolid;207;Villagarcía de Campos;475;257;218
47;Valladolid;208;Villagómez la Nueva;115;52;63
47;Valladolid;209;Villalán de Campos;60;30;30
47;Valladolid;210;Villalar de los Comuneros;508;258;250
47;Valladolid;211;Villalba de la Loma;61;33;28
47;Valladolid;212;Villalba de los Alcores;631;329;302
47;Valladolid;213;Villalbarba;181;94;87
47;Valladolid;214;Villalón de Campos;2193;1071;1122
47;Valladolid;215;Villamuriel de Campos;94;47;47
47;Valladolid;216;Villán de Tordesillas;175;87;88
47;Valladolid;217;Villanubla;936;483;453
47;Valladolid;218;Villanueva de Duero;839;432;407
47;Valladolid;219;Villanueva de la Condesa;54;31;23
47;Valladolid;220;Villanueva de los Caballeros;326;157;169
47;Valladolid;221;Villanueva de los Infantes;161;86;75
47;Valladolid;222;Villanueva de San Mancio;97;48;49
47;Valladolid;223;Villardefrades;272;145;127
47;Valladolid;224;Villarmentero de Esgueva;138;71;67
47;Valladolid;225;Villasexmir;144;79;65
47;Valladolid;226;Villavaquerín;221;118;103
47;Valladolid;227;Villavellid;75;42;33
47;Valladolid;228;Villaverde de Medina;656;350;306
47;Valladolid;229;Villavicencio de los Caballeros;386;180;206
47;Valladolid;194;Viloria;411;222;189
47;Valladolid;230;Wamba;382;198;184
47;Valladolid;231;Zaratán;1145;579;566
47;Valladolid;232;Zarza (La);186;95;91
48;Vizcaya;001;Abadiño;7070;3573;3497
48;Vizcaya;002;Abanto y Ciérvana-Abanto Zierbena;9351;4640;4711
48;Vizcaya;911;Ajangiz;361;187;174
48;Vizcaya;912;Alonsotegi;3075;1500;1575
48;Vizcaya;003;Amorebieta-Etxano;15818;7960;7858
48;Vizcaya;004;Amoroto;391;209;182
48;Vizcaya;005;Arakaldo;101;57;44
48;Vizcaya;006;Arantzazu;284;135;149
48;Vizcaya;093;Areatza;1152;532;620
48;Vizcaya;009;Arrankudiaga;732;355;377
48;Vizcaya;914;Arratzu;"";"";""
48;Vizcaya;010;Arrieta;422;217;205
48;Vizcaya;011;Arrigorriaga;9913;4888;5025
48;Vizcaya;023;Artea;621;305;316
48;Vizcaya;008;Artzentales;676;373;303
48;Vizcaya;091;Atxondo;1525;765;760
48;Vizcaya;070;Aulesti;697;372;325
48;Vizcaya;012;Bakio;1238;621;617
48;Vizcaya;090;Balmaseda;7333;3555;3778
48;Vizcaya;013;Barakaldo;105088;51931;53157
48;Vizcaya;014;Barrika;877;411;466
48;Vizcaya;015;Basauri;50224;25104;25120
48;Vizcaya;092;Bedia;1036;504;532
48;Vizcaya;016;Berango;4102;2032;2070
48;Vizcaya;017;Bermeo;17923;8916;9007
48;Vizcaya;018;Berriatua;1020;536;484
48;Vizcaya;019;Berriz;4216;2127;2089
48;Vizcaya;020;Bilbao;369839;176927;192912
48;Vizcaya;021;Busturia;1729;869;860
48;Vizcaya;901;Derio;4871;2442;2429
48;Vizcaya;026;Dima;1038;547;491
48;Vizcaya;027;Durango;22627;11172;11455
48;Vizcaya;028;Ea;802;391;411
48;Vizcaya;031;Elantxobe;550;253;297
48;Vizcaya;032;Elorrio;7432;3752;3680
48;Vizcaya;902;Erandio;25055;12382;12673
48;Vizcaya;033;Ereño;277;136;141
48;Vizcaya;034;Ermua;17981;9204;8777
48;Vizcaya;079;Errigoiti;440;240;200
48;Vizcaya;029;Etxebarri, Anteiglesia de San Esteban-Etxebarri Doneztebeko Elizatea;6458;3252;3206
48;Vizcaya;030;Etxebarria;786;410;376
48;Vizcaya;906;Forua;949;487;462
48;Vizcaya;035;Fruiz;318;166;152
48;Vizcaya;036;Galdakao;28569;14263;14306
48;Vizcaya;037;Galdames;799;420;379
48;Vizcaya;038;Gamiz-Fika;891;469;422
48;Vizcaya;039;Garay;256;137;119
48;Vizcaya;040;Gatika;931;464;467
48;Vizcaya;041;Gautegiz Arteaga;752;365;387
48;Vizcaya;046;Gernika-Lumo;16042;7880;8162
48;Vizcaya;044;Getxo;79954;38511;41443
48;Vizcaya;047;Gizaburuaga;128;68;60
48;Vizcaya;042;Gordexola;1524;760;764
48;Vizcaya;043;Gorliz;2917;1405;1512
48;Vizcaya;045;Güeñes;5878;2888;2990
48;Vizcaya;048;Ibarrangelu;521;231;290
48;Vizcaya;094;Igorre;3884;1939;1945
48;Vizcaya;049;Ispaster;618;326;292
48;Vizcaya;910;Iurreta;4901;2406;2495
48;Vizcaya;050;Izurtza;269;136;133
48;Vizcaya;022;Karrantza Harana/Valle de Carranza;3173;1657;1516
48;Vizcaya;907;Kortezubi;383;204;179
48;Vizcaya;051;Lanestosa;312;160;152
48;Vizcaya;052;Larrabetzu;1472;727;745
48;Vizcaya;053;Laukiz;979;498;481
48;Vizcaya;054;Leioa;24815;12285;12530
48;Vizcaya;057;Lekeitio;7394;3605;3789
48;Vizcaya;055;Lemoa;2740;1390;1350
48;Vizcaya;056;Lemoiz;783;405;378
48;Vizcaya;081;Lezama;2020;1025;995
48;Vizcaya;903;Loiu;1694;869;825
48;Vizcaya;058;Mallabia;1133;598;535
48;Vizcaya;059;Mañaria;504;269;235
48;Vizcaya;060;Markina-Xemein;4904;2431;2473
48;Vizcaya;061;Maruri-Jatabe;529;261;268
48;Vizcaya;062;Mendata;348;185;163
48;Vizcaya;063;Mendexa;347;179;168
48;Vizcaya;064;Meñaka;440;231;209
48;Vizcaya;066;Morga;347;181;166
48;Vizcaya;068;Mundaka;1641;748;893
48;Vizcaya;069;Mungia;11900;5841;6059
48;Vizcaya;007;Munitibar-Arbatzegi Gerrikaitz;455;244;211
48;Vizcaya;908;Murueta;201;100;101
48;Vizcaya;071;Muskiz;6358;3140;3218
48;Vizcaya;067;Muxika;1443;750;693
48;Vizcaya;909;Nabarniz;251;126;125
48;Vizcaya;073;Ondarroa;10561;5268;5293
48;Vizcaya;075;Orozko;1922;967;955
48;Vizcaya;083;Ortuella;8976;4412;4564
48;Vizcaya;072;Otxandio;1112;584;528
48;Vizcaya;077;Plentzia;2542;1232;1310
48;Vizcaya;078;Portugalete;55823;27538;28285
48;Vizcaya;082;Santurtzi;50466;24963;25503
48;Vizcaya;084;Sestao;35948;17546;18402
48;Vizcaya;904;Sondika;3345;1614;1731
48;Vizcaya;085;Sopelana;8135;4073;4062
48;Vizcaya;086;Sopuerta;2160;1112;1048
48;Vizcaya;076;Sukarrieta;280;134;146
48;Vizcaya;087;Trucios-Turtzioz;518;250;268
48;Vizcaya;088;Ubide;165;85;80
48;Vizcaya;065;Ugao-Miraballes;4107;2045;2062
48;Vizcaya;089;Urduliz;2580;1292;1288
48;Vizcaya;074;Urduña-Orduña;4038;2064;1974
48;Vizcaya;080;Valle de Trápaga-Trapagaran;13239;6521;6718
48;Vizcaya;095;Zaldibar;3152;1492;1660
48;Vizcaya;096;Zalla;7307;3629;3678
48;Vizcaya;905;Zamudio;3179;1595;1584
48;Vizcaya;097;Zaratamo;1634;814;820
48;Vizcaya;024;Zeanuri;1161;607;554
48;Vizcaya;025;Zeberio;958;497;461
48;Vizcaya;913;Zierbena;"";"";""
49;Zamora;002;Abezames;124;60;64
49;Zamora;003;Alcañices;1245;647;598
49;Zamora;004;Alcubilla de Nogales;262;126;136
49;Zamora;005;Alfaraz de Sayago;259;141;118
49;Zamora;006;Algodre;242;131;111
49;Zamora;007;Almaraz de Duero;501;245;256
49;Zamora;008;Almeida de Sayago;754;393;361
49;Zamora;009;Andavías;539;260;279
49;Zamora;010;Arcenillas;248;125;123
49;Zamora;011;Arcos de la Polvorosa;324;175;149
49;Zamora;012;Argañín;137;64;73
49;Zamora;013;Argujillo;447;237;210
49;Zamora;014;Arquillinos;193;98;95
49;Zamora;015;Arrabalde;474;232;242
49;Zamora;016;Aspariegos;442;203;239
49;Zamora;017;Asturianos;427;203;224
49;Zamora;018;Ayoó de Vidriales;579;287;292
49;Zamora;019;Barcial del Barco;348;188;160
49;Zamora;020;Belver de los Montes;582;303;279
49;Zamora;021;Benavente;14424;6989;7435
49;Zamora;022;Benegiles;452;244;208
49;Zamora;023;Bermillo de Sayago;1730;886;844
49;Zamora;024;Bóveda de Toro (La);1090;567;523
49;Zamora;025;Bretó;305;155;150
49;Zamora;026;Bretocino;351;193;158
49;Zamora;027;Brime de Sog;297;134;163
49;Zamora;028;Brime de Urz;194;106;88
49;Zamora;029;Burganes de Valverde;907;462;445
49;Zamora;030;Bustillo del Oro;190;94;96
49;Zamora;031;Cabañas de Sayago;262;134;128
49;Zamora;032;Calzadilla de Tera;635;301;334
49;Zamora;033;Camarzana de Tera;1174;582;592
49;Zamora;034;Cañizal;691;355;336
49;Zamora;035;Cañizo;411;201;210
49;Zamora;036;Carbajales de Alba;757;375;382
49;Zamora;037;Carbellino;280;149;131
49;Zamora;038;Casaseca de Campeán;188;100;88
49;Zamora;039;Casaseca de las Chanas;406;199;207
49;Zamora;040;Castrillo de la Guareña;182;93;89
49;Zamora;041;Castrogonzalo;593;297;296
49;Zamora;042;Castronuevo;397;206;191
49;Zamora;043;Castroverde de Campos;478;234;244
49;Zamora;044;Cazurra;118;64;54
49;Zamora;046;Cerecinos de Campos;478;248;230
49;Zamora;047;Cerecinos del Carrizal;189;100;89
49;Zamora;048;Cernadilla;193;90;103
49;Zamora;050;Cobreros;847;412;435
49;Zamora;052;Coomonte;395;196;199
49;Zamora;053;Coreses;1337;686;651
49;Zamora;054;Corrales;1371;672;699
49;Zamora;055;Cotanes del Monte;204;107;97
49;Zamora;056;Cubillos;453;236;217
49;Zamora;057;Cubo de Benavente;253;134;119
49;Zamora;058;Cubo de Tierra del Vino (El);493;254;239
49;Zamora;059;Cuelgamures;160;90;70
49;Zamora;061;Entrala;160;79;81
49;Zamora;062;Espadañedo;262;129;133
49;Zamora;063;Faramontanos de Tábara;581;291;290
49;Zamora;064;Fariza;820;411;409
49;Zamora;065;Fermoselle;1981;950;1031
49;Zamora;066;Ferreras de Abajo;669;338;331
49;Zamora;067;Ferreras de Arriba;575;293;282
49;Zamora;068;Ferreruela;749;393;356
49;Zamora;069;Figueruela de Arriba;644;318;326
49;Zamora;071;Fonfría;1282;646;636
49;Zamora;075;Fresno de la Polvorosa;270;134;136
49;Zamora;076;Fresno de la Ribera;441;239;202
49;Zamora;077;Fresno de Sayago;362;191;171
49;Zamora;078;Friera de Valverde;336;172;164
49;Zamora;079;Fuente Encalada;196;102;94
49;Zamora;080;Fuentelapeña;1108;549;559
49;Zamora;082;Fuentes de Ropel;732;376;356
49;Zamora;081;Fuentesaúco;1994;974;1020
49;Zamora;083;Fuentesecas;106;54;52
49;Zamora;084;Fuentespreadas;460;241;219
49;Zamora;085;Galende;1315;649;666
49;Zamora;086;Gallegos del Pan;209;101;108
49;Zamora;087;Gallegos del Río;1042;542;500
49;Zamora;088;Gamones;116;65;51
49;Zamora;090;Gema;335;163;172
49;Zamora;091;Granja de Moreruela;399;191;208
49;Zamora;092;Granucillo;331;163;168
49;Zamora;093;Guarrate;443;239;204
49;Zamora;094;Hermisende;530;266;264
49;Zamora;095;Hiniesta (La);438;215;223
49;Zamora;096;Jambrina;319;160;159
49;Zamora;097;Justel;258;133;125
49;Zamora;098;Losacino;394;205;189
49;Zamora;099;Losacio;191;105;86
49;Zamora;100;Lubián;441;213;228
49;Zamora;101;Luelmo;298;158;140
49;Zamora;102;Maderal (El);321;164;157
49;Zamora;103;Madridanos;602;314;288
49;Zamora;104;Mahide;651;336;315
49;Zamora;105;Maire de Castroponce;307;154;153
49;Zamora;107;Malva;292;137;155
49;Zamora;108;Manganeses de la Lampreana;940;471;469
49;Zamora;109;Manganeses de la Polvorosa;1007;482;525
49;Zamora;110;Manzanal de Arriba;573;289;284
49;Zamora;112;Manzanal de los Infantes;227;110;117
49;Zamora;111;Manzanal del Barco;237;123;114
49;Zamora;113;Matilla de Arzón;327;174;153
49;Zamora;114;Matilla la Seca;93;49;44
49;Zamora;115;Mayalde;293;152;141
49;Zamora;116;Melgar de Tera;662;329;333
49;Zamora;117;Micereces de Tera;671;342;329
49;Zamora;118;Milles de la Polvorosa;304;147;157
49;Zamora;119;Molacillos;339;178;161
49;Zamora;120;Molezuelas de la Carballeda;178;90;88
49;Zamora;121;Mombuey;528;266;262
49;Zamora;122;Monfarracinos;554;292;262
49;Zamora;123;Montamarta;772;360;412
49;Zamora;124;Moral de Sayago;418;222;196
49;Zamora;126;Moraleja de Sayago;322;175;147
49;Zamora;125;Moraleja del Vino;1202;631;571
49;Zamora;128;Morales de Rey;828;408;420
49;Zamora;129;Morales de Toro;1156;570;586
49;Zamora;130;Morales de Valverde;370;182;188
49;Zamora;127;Morales del Vino;1192;621;571
49;Zamora;131;Moralina;410;219;191
49;Zamora;132;Moreruela de los Infanzones;532;282;250
49;Zamora;133;Moreruela de Tábara;649;337;312
49;Zamora;134;Muelas de los Caballeros;287;146;141
49;Zamora;135;Muelas del Pan;940;458;482
49;Zamora;136;Muga de Sayago;561;270;291
49;Zamora;137;Navianos de Valverde;292;161;131
49;Zamora;138;Olmillos de Castro;516;257;259
49;Zamora;139;Otero de Bodas;310;159;151
49;Zamora;141;Pajares de la Lampreana;556;278;278
49;Zamora;143;Palacios de Sanabria;337;162;175
49;Zamora;142;Palacios del Pan;285;134;151
49;Zamora;145;Pedralba de la Pradería;450;231;219
49;Zamora;146;Pego (El);502;261;241
49;Zamora;147;Peleagonzalo;522;264;258
49;Zamora;148;Peleas de Abajo;229;117;112
49;Zamora;149;Peñausende;637;325;312
49;Zamora;150;Peque;228;111;117
49;Zamora;151;Perdigón (El);905;454;451
49;Zamora;152;Pereruela;877;435;442
49;Zamora;153;Perilla de Castro;286;138;148
49;Zamora;154;Pías;303;157;146
49;Zamora;155;Piedrahita de Castro;177;108;69
49;Zamora;156;Pinilla de Toro;474;237;237
49;Zamora;157;Pino del Oro;280;154;126
49;Zamora;158;Piñero (El);343;193;150
49;Zamora;160;Pobladura de Valderaduey;96;45;51
49;Zamora;159;Pobladura del Valle;396;194;202
49;Zamora;162;Porto;437;212;225
49;Zamora;163;Pozoantiguo;430;216;214
49;Zamora;164;Pozuelo de Tábara;286;139;147
49;Zamora;165;Prado;130;62;68
49;Zamora;166;Puebla de Sanabria;1668;794;874
49;Zamora;167;Pueblica de Valverde;390;195;195
49;Zamora;170;Quintanilla de Urz;152;85;67
49;Zamora;168;Quintanilla del Monte;176;86;90
49;Zamora;169;Quintanilla del Olmo;74;34;40
49;Zamora;171;Quiruelas de Vidriales;1088;528;560
49;Zamora;172;Rabanales;1005;511;494
49;Zamora;173;Rábano de Aliste;565;279;286
49;Zamora;174;Requejo;264;136;128
49;Zamora;175;Revellinos;395;198;197
49;Zamora;176;Riofrío de Aliste;1160;618;542
49;Zamora;177;Rionegro del Puente;444;219;225
49;Zamora;178;Roales;328;165;163
49;Zamora;179;Robleda-Cervantes;488;235;253
49;Zamora;180;Roelos de Sayago;187;94;93
49;Zamora;181;Rosinos de la Requejada;643;309;334
49;Zamora;183;Salce;172;90;82
49;Zamora;184;Samir de los Caños;288;151;137
49;Zamora;185;San Agustín del Pozo;225;123;102
49;Zamora;186;San Cebrián de Castro;483;230;253
49;Zamora;187;San Cristóbal de Entreviñas;1677;856;821
49;Zamora;188;San Esteban del Molar;241;131;110
49;Zamora;189;San Justo;366;185;181
49;Zamora;190;San Martín de Valderaduey;103;46;57
49;Zamora;191;San Miguel de la Ribera;473;237;236
49;Zamora;192;San Miguel del Valle;300;144;156
49;Zamora;193;San Pedro de Ceque;734;367;367
49;Zamora;194;San Pedro de la Nave-Almendra;549;272;277
49;Zamora;208;San Vicente de la Cabeza;738;382;356
49;Zamora;209;San Vitero;814;422;392
49;Zamora;197;Santa Clara de Avedillo;306;152;154
49;Zamora;199;Santa Colomba de las Monjas;358;184;174
49;Zamora;200;Santa Cristina de la Polvorosa;1348;685;663
49;Zamora;201;Santa Croya de Tera;573;284;289
49;Zamora;202;Santa Eufemia del Barco;338;184;154
49;Zamora;203;Santa María de la Vega;566;296;270
49;Zamora;204;Santa María de Valverde;136;75;61
49;Zamora;205;Santibáñez de Tera;683;352;331
49;Zamora;206;Santibáñez de Vidriales;1581;768;813
49;Zamora;207;Santovenia;528;266;262
49;Zamora;210;Sanzoles;798;410;388
49;Zamora;214;Tábara;1010;512;498
49;Zamora;216;Tapioles;270;146;124
49;Zamora;219;Toro;9254;4513;4741
49;Zamora;220;Torre del Valle (La);224;120;104
49;Zamora;221;Torregamones;388;186;202
49;Zamora;222;Torres del Carrizal;566;291;275
49;Zamora;223;Trabazos;1102;561;541
49;Zamora;224;Trefacio;258;123;135
49;Zamora;225;Uña de Quintana;286;140;146
49;Zamora;226;Vadillo de la Guareña;397;200;197
49;Zamora;227;Valcabado;333;170;163
49;Zamora;228;Valdefinjas;115;61;54
49;Zamora;229;Valdescorriel;214;100;114
49;Zamora;230;Vallesa de la Guareña;211;116;95
49;Zamora;231;Vega de Tera;629;300;329
49;Zamora;232;Vega de Villalobos;204;99;105
49;Zamora;233;Vegalatrave;202;98;104
49;Zamora;234;Venialbo;547;282;265
49;Zamora;235;Vezdemarbán;784;375;409
49;Zamora;236;Vidayanes;142;71;71
49;Zamora;237;Videmala;255;125;130
49;Zamora;238;Villabrázaro;468;235;233
49;Zamora;239;Villabuena del Puente;1126;591;535
49;Zamora;240;Villadepera;306;151;155
49;Zamora;241;Villaescusa;465;238;227
49;Zamora;242;Villafáfila;706;342;364
49;Zamora;243;Villaferrueña;188;98;90
49;Zamora;244;Villageriz;77;40;37
49;Zamora;245;Villalazán;429;218;211
49;Zamora;246;Villalba de la Lampreana;369;188;181
49;Zamora;247;Villalcampo;796;383;413
49;Zamora;248;Villalobos;392;189;203
49;Zamora;249;Villalonso;167;77;90
49;Zamora;250;Villalpando;1880;906;974
49;Zamora;251;Villalube;386;194;192
49;Zamora;252;Villamayor de Campos;668;336;332
49;Zamora;255;Villamor de los Escuderos;661;331;330
49;Zamora;256;Villanázar;422;204;218
49;Zamora;257;Villanueva de Azoague;461;229;232
49;Zamora;258;Villanueva de Campeán;219;109;110
49;Zamora;259;Villanueva de las Peras;253;124;129
49;Zamora;260;Villanueva del Campo;1231;612;619
49;Zamora;263;Villar de Fallaves;124;69;55
49;Zamora;264;Villar del Buey;990;530;460
49;Zamora;261;Villaralbo;1533;770;763
49;Zamora;262;Villardeciervos;600;271;329
49;Zamora;265;Villardiegua de la Ribera;198;92;106
49;Zamora;266;Villárdiga;130;64;66
49;Zamora;267;Villardondiego;163;86;77
49;Zamora;268;Villarrín de Campos;681;344;337
49;Zamora;269;Villaseco del Pan;390;194;196
49;Zamora;270;Villavendimio;250;138;112
49;Zamora;272;Villaveza de Valverde;176;90;86
49;Zamora;271;Villaveza del Agua;315;164;151
49;Zamora;273;Viñas;348;187;161
49;Zamora;275;Zamora;64476;30668;33808
50;Zaragoza;001;Abanto;221;114;107
50;Zaragoza;002;Acered;325;171;154
50;Zaragoza;003;Agón;229;120;109
50;Zaragoza;004;Aguarón;759;374;385
50;Zaragoza;005;Aguilón;267;129;138
50;Zaragoza;006;Ainzón;1226;615;611
50;Zaragoza;007;Aladrén;44;20;24
50;Zaragoza;008;Alagón;5522;2719;2803
50;Zaragoza;009;Alarba;173;99;74
50;Zaragoza;010;Alberite de San Juan;116;59;57
50;Zaragoza;011;Albeta;140;66;74
50;Zaragoza;012;Alborge;123;59;64
50;Zaragoza;013;Alcalá de Ebro;348;175;173
50;Zaragoza;014;Alcalá de Moncayo;166;92;74
50;Zaragoza;015;Alconchel de Ariza;188;106;82
50;Zaragoza;016;Aldehuela de Liestos;81;41;40
50;Zaragoza;017;Alfajarín;1458;747;711
50;Zaragoza;018;Alfamén;1299;684;615
50;Zaragoza;019;Alforque;91;48;43
50;Zaragoza;020;Alhama de Aragón;1206;586;620
50;Zaragoza;021;Almochuel;53;30;23
50;Zaragoza;022;Almolda (La);764;374;390
50;Zaragoza;023;Almonacid de la Cuba;381;197;184
50;Zaragoza;024;Almonacid de la Sierra;839;430;409
50;Zaragoza;025;Almunia de Doña Godina (La);5061;2566;2495
50;Zaragoza;026;Alpartir;633;342;291
50;Zaragoza;027;Ambel;421;202;219
50;Zaragoza;028;Anento;104;55;49
50;Zaragoza;029;Aniñón;946;496;450
50;Zaragoza;030;Añón de Moncayo;345;200;145
50;Zaragoza;031;Aranda de Moncayo;266;147;119
50;Zaragoza;032;Arándiga;577;282;295
50;Zaragoza;033;Ardisa;79;37;42
50;Zaragoza;034;Ariza;1375;690;685
50;Zaragoza;035;Artieda;105;56;49
50;Zaragoza;036;Asín;115;59;56
50;Zaragoza;037;Atea;277;151;126
50;Zaragoza;038;Ateca;2145;1039;1106
50;Zaragoza;039;Azuara;830;442;388
50;Zaragoza;040;Badules;120;60;60
50;Zaragoza;041;Bagüés;16;8;8
50;Zaragoza;042;Balconchán;34;19;15
50;Zaragoza;043;Bárboles;355;183;172
50;Zaragoza;044;Bardallur;333;161;172
50;Zaragoza;045;Belchite;1680;840;840
50;Zaragoza;046;Belmonte de Gracián;354;193;161
50;Zaragoza;047;Berdejo;37;18;19
50;Zaragoza;048;Berrueco;43;25;18
50;Zaragoza;901;Biel;226;121;105
50;Zaragoza;050;Bijuesca;138;72;66
50;Zaragoza;051;Biota;1306;682;624
50;Zaragoza;052;Bisimbre;146;68;78
50;Zaragoza;053;Boquiñeni;1063;544;519
50;Zaragoza;054;Bordalba;108;60;48
50;Zaragoza;055;Borja;4060;1986;2074
50;Zaragoza;056;Botorrita;465;248;217
50;Zaragoza;057;Brea de Aragón;2044;1018;1026
50;Zaragoza;058;Bubierca;123;59;64
50;Zaragoza;059;Bujaraloz;1074;558;516
50;Zaragoza;060;Bulbuente;274;147;127
50;Zaragoza;061;Bureta;342;175;167
50;Zaragoza;062;Burgo de Ebro (El);1223;601;622
50;Zaragoza;063;Buste (El);137;69;68
50;Zaragoza;064;Cabañas de Ebro;561;281;280
50;Zaragoza;065;Cabolafuente;101;57;44
50;Zaragoza;066;Cadrete;917;472;445
50;Zaragoza;067;Calatayud;17432;8377;9055
50;Zaragoza;068;Calatorao;2626;1348;1278
50;Zaragoza;069;Calcena;105;55;50
50;Zaragoza;070;Calmarza;132;66;66
50;Zaragoza;071;Campillo de Aragón;223;123;100
50;Zaragoza;072;Carenas;247;123;124
50;Zaragoza;073;Cariñena;2877;1447;1430
50;Zaragoza;074;Caspe;8029;3969;4060
50;Zaragoza;075;Castejón de Alarba;141;78;63
50;Zaragoza;076;Castejón de las Armas;155;84;71
50;Zaragoza;077;Castejón de Valdejasa;397;215;182
50;Zaragoza;078;Castiliscar;469;233;236
50;Zaragoza;079;Cervera de la Cañada;375;183;192
50;Zaragoza;080;Cerveruela;4;2;2
50;Zaragoza;081;Cetina;807;403;404
50;Zaragoza;092;Chiprana;430;216;214
50;Zaragoza;093;Chodes;151;70;81
50;Zaragoza;082;Cimballa;143;69;74
50;Zaragoza;083;Cinco Olivas;157;78;79
50;Zaragoza;084;Clarés de Ribota;123;67;56
50;Zaragoza;085;Codo;325;165;160
50;Zaragoza;086;Codos;329;186;143
50;Zaragoza;087;Contamina;64;34;30
50;Zaragoza;088;Cosuenda;449;228;221
50;Zaragoza;089;Cuarte de Huerva;1353;698;655
50;Zaragoza;090;Cubel;267;131;136
50;Zaragoza;091;Cuerlas (Las);104;55;49
50;Zaragoza;094;Daroca;2351;1156;1195
50;Zaragoza;095;Ejea de los Caballeros;15337;7829;7508
50;Zaragoza;096;Embid de Ariza;81;44;37
50;Zaragoza;098;Encinacorba;336;179;157
50;Zaragoza;099;Épila;3816;1920;1896
50;Zaragoza;100;Erla;547;263;284
50;Zaragoza;101;Escatrón;1366;675;691
50;Zaragoza;102;Fabara;1344;713;631
50;Zaragoza;104;Farlete;496;254;242
50;Zaragoza;105;Fayón;439;220;219
50;Zaragoza;106;Fayos (Los);174;87;87
50;Zaragoza;107;Figueruelas;870;428;442
50;Zaragoza;108;Fombuena;13;10;3
50;Zaragoza;109;Frago (El);123;72;51
50;Zaragoza;110;Frasno (El);657;342;315
50;Zaragoza;111;Fréscano;275;137;138
50;Zaragoza;113;Fuendejalón;985;497;488
50;Zaragoza;114;Fuendetodos;166;92;74
50;Zaragoza;115;Fuentes de Ebro;3801;1958;1843
50;Zaragoza;116;Fuentes de Jiloca;413;215;198
50;Zaragoza;117;Gallocanta;192;99;93
50;Zaragoza;118;Gallur;3066;1536;1530
50;Zaragoza;119;Gelsa;1366;693;673
50;Zaragoza;120;Godojos;83;47;36
50;Zaragoza;121;Gotor;390;213;177
50;Zaragoza;122;Grisel;59;29;30
50;Zaragoza;123;Grisén;485;241;244
50;Zaragoza;124;Herrera de los Navarros;710;366;344
50;Zaragoza;125;Ibdes;583;306;277
50;Zaragoza;126;Illueca;3149;1582;1567
50;Zaragoza;128;Isuerre;63;33;30
50;Zaragoza;129;Jaraba;334;166;168
50;Zaragoza;130;Jarque;616;326;290
50;Zaragoza;131;Jaulín;303;150;153
50;Zaragoza;132;Joyosa (La);345;172;173
50;Zaragoza;133;Lagata;159;87;72
50;Zaragoza;134;Langa del Castillo;200;88;112
50;Zaragoza;135;Layana;192;96;96
50;Zaragoza;136;Lécera;1009;494;515
50;Zaragoza;138;Lechón;63;36;27
50;Zaragoza;137;Leciñena;1476;741;735
50;Zaragoza;139;Letux;486;255;231
50;Zaragoza;140;Litago;189;106;83
50;Zaragoza;141;Lituénigo;125;63;62
50;Zaragoza;142;Lobera de Onsella;62;40;22
50;Zaragoza;143;Longares;865;434;431
50;Zaragoza;144;Longás;35;24;11
50;Zaragoza;146;Lucena de Jalón;306;154;152
50;Zaragoza;147;Luceni;1089;538;551
50;Zaragoza;148;Luesia;462;244;218
50;Zaragoza;149;Luesma;29;15;14
50;Zaragoza;150;Lumpiaque;1004;526;478
50;Zaragoza;151;Luna;1002;514;488
50;Zaragoza;152;Maella;2180;1098;1082
50;Zaragoza;153;Magallón;1365;704;661
50;Zaragoza;154;Mainar;184;100;84
50;Zaragoza;155;Malanquilla;136;68;68
50;Zaragoza;156;Maleján;313;162;151
50;Zaragoza;160;Mallén;3018;1522;1496
50;Zaragoza;157;Malón;532;268;264
50;Zaragoza;159;Maluenda;1072;530;542
50;Zaragoza;161;Manchones;168;85;83
50;Zaragoza;162;Mara;245;129;116
50;Zaragoza;163;María de Huerva;810;384;426
50;Zaragoza;902;Marracos;"";"";""
50;Zaragoza;164;Mediana de Aragón;549;274;275
50;Zaragoza;165;Mequinenza;2757;1392;1365
50;Zaragoza;166;Mesones de Isuela;440;219;221
50;Zaragoza;167;Mezalocha;341;181;160
50;Zaragoza;168;Mianos;41;22;19
50;Zaragoza;169;Miedes de Aragón;579;296;283
50;Zaragoza;170;Monegrillo;567;305;262
50;Zaragoza;171;Moneva;110;52;58
50;Zaragoza;172;Monreal de Ariza;347;179;168
50;Zaragoza;173;Monterde;202;99;103
50;Zaragoza;174;Montón;166;78;88
50;Zaragoza;175;Morata de Jalón;1744;865;879
50;Zaragoza;176;Morata de Jiloca;373;199;174
50;Zaragoza;177;Morés;543;279;264
50;Zaragoza;178;Moros;626;325;301
50;Zaragoza;179;Moyuela;424;214;210
50;Zaragoza;180;Mozota;124;58;66
50;Zaragoza;181;Muel;1196;589;607
50;Zaragoza;182;Muela (La);1006;531;475
50;Zaragoza;183;Munébrega;524;276;248
50;Zaragoza;184;Murero;169;92;77
50;Zaragoza;185;Murillo de Gállego;150;80;70
50;Zaragoza;186;Navardún;89;46;43
50;Zaragoza;187;Nigüella;138;68;70
50;Zaragoza;188;Nombrevilla;33;15;18
50;Zaragoza;189;Nonaspe;1132;571;561
50;Zaragoza;190;Novallas;793;391;402
50;Zaragoza;191;Novillas;737;375;362
50;Zaragoza;192;Nuévalos;287;159;128
50;Zaragoza;193;Nuez de Ebro;526;271;255
50;Zaragoza;194;Olvés;196;107;89
50;Zaragoza;195;Orcajo;53;26;27
50;Zaragoza;196;Orera;178;89;89
50;Zaragoza;197;Orés;135;72;63
50;Zaragoza;198;Oseja;30;12;18
50;Zaragoza;199;Osera de Ebro;346;167;179
50;Zaragoza;200;Paniza;770;386;384
50;Zaragoza;201;Paracuellos de Jiloca;559;268;291
50;Zaragoza;202;Paracuellos de la Ribera;351;168;183
50;Zaragoza;203;Pastriz;752;368;384
50;Zaragoza;204;Pedrola;2460;1264;1196
50;Zaragoza;205;Pedrosas (Las);114;56;58
50;Zaragoza;206;Perdiguera;480;253;227
50;Zaragoza;207;Piedratajada;231;117;114
50;Zaragoza;208;Pina de Ebro;2188;1106;1082
50;Zaragoza;209;Pinseque;1363;693;670
50;Zaragoza;210;Pintanos (Los);83;46;37
50;Zaragoza;211;Plasencia de Jalón;385;199;186
50;Zaragoza;212;Pleitas;81;43;38
50;Zaragoza;213;Plenas;185;92;93
50;Zaragoza;214;Pomer;25;10;15
50;Zaragoza;215;Pozuel de Ariza;32;20;12
50;Zaragoza;216;Pozuelo de Aragón;374;201;173
50;Zaragoza;217;Pradilla de Ebro;699;364;335
50;Zaragoza;218;Puebla de Albortón;155;79;76
50;Zaragoza;219;Puebla de Alfindén (La);1463;752;711
50;Zaragoza;220;Puendeluna;65;35;30
50;Zaragoza;221;Purujosa;35;19;16
50;Zaragoza;222;Quinto;2196;1110;1086
50;Zaragoza;223;Remolinos;1281;651;630
50;Zaragoza;224;Retascón;80;44;36
50;Zaragoza;225;Ricla;2056;1067;989
50;Zaragoza;227;Romanos;157;89;68
50;Zaragoza;228;Rueda de Jalón;369;198;171
50;Zaragoza;229;Ruesca;87;44;43
50;Zaragoza;241;Sabiñán;1056;505;551
50;Zaragoza;230;Sádaba;1881;957;924
50;Zaragoza;231;Salillas de Jalón;406;209;197
50;Zaragoza;232;Salvatierra de Esca;324;175;149
50;Zaragoza;233;Samper del Salz;107;53;54
50;Zaragoza;234;San Martín de la Virgen de Moncayo;314;167;147
50;Zaragoza;235;San Mateo de Gállego;1845;958;887
50;Zaragoza;236;Santa Cruz de Grío;238;132;106
50;Zaragoza;237;Santa Cruz de Moncayo;102;55;47
50;Zaragoza;238;Santa Eulalia de Gállego;126;63;63
50;Zaragoza;239;Santed;84;39;45
50;Zaragoza;240;Sástago;1674;843;831
50;Zaragoza;242;Sediles;105;54;51
50;Zaragoza;243;Sestrica;559;284;275
50;Zaragoza;244;Sierra de Luna;332;171;161
50;Zaragoza;245;Sigüés;196;102;94
50;Zaragoza;246;Sisamón;106;63;43
50;Zaragoza;247;Sobradiel;598;281;317
50;Zaragoza;248;Sos del Rey Católico;940;481;459
50;Zaragoza;249;Tabuenca;547;287;260
50;Zaragoza;250;Talamantes;64;33;31
50;Zaragoza;251;Tarazona;10557;5088;5469
50;Zaragoza;252;Tauste;7035;3523;3512
50;Zaragoza;253;Terrer;726;354;372
50;Zaragoza;254;Tierga;292;155;137
50;Zaragoza;255;Tobed;303;154;149
50;Zaragoza;256;Torralba de los Frailes;131;65;66
50;Zaragoza;257;Torralba de Ribota;251;139;112
50;Zaragoza;258;Torralbilla;80;42;38
50;Zaragoza;259;Torrehermosa;131;72;59
50;Zaragoza;260;Torrelapaja;58;31;27
50;Zaragoza;261;Torrellas;347;173;174
50;Zaragoza;262;Torres de Berrellén;1436;725;711
50;Zaragoza;263;Torrijo de la Cañada;488;260;228
50;Zaragoza;264;Tosos;258;134;124
50;Zaragoza;265;Trasmoz;80;40;40
50;Zaragoza;266;Trasobares;297;159;138
50;Zaragoza;267;Uncastillo;961;476;485
50;Zaragoza;268;Undués de Lerda;47;22;25
50;Zaragoza;269;Urrea de Jalón;381;187;194
50;Zaragoza;270;Urriés;78;43;35
50;Zaragoza;271;Used;453;230;223
50;Zaragoza;272;Utebo;7671;3858;3813
50;Zaragoza;274;Val de San Martín;70;30;40
50;Zaragoza;273;Valdehorna;82;42;40
50;Zaragoza;275;Valmadrid;77;42;35
50;Zaragoza;276;Valpalmas;234;120;114
50;Zaragoza;277;Valtorres;126;62;64
50;Zaragoza;278;Velilla de Ebro;290;147;143
50;Zaragoza;279;Velilla de Jiloca;153;78;75
50;Zaragoza;280;Vera de Moncayo;498;253;245
50;Zaragoza;281;Vierlas;102;49;53
50;Zaragoza;283;Villadoz;95;50;45
50;Zaragoza;284;Villafeliche;259;123;136
50;Zaragoza;285;Villafranca de Ebro;670;326;344
50;Zaragoza;286;Villalba de Perejil;104;52;52
50;Zaragoza;287;Villalengua;500;267;233
50;Zaragoza;288;Villanueva de Gállego;2483;1245;1238
50;Zaragoza;290;Villanueva de Huerva;678;335;343
50;Zaragoza;289;Villanueva de Jiloca;115;60;55
50;Zaragoza;291;Villar de los Navarros;199;101;98
50;Zaragoza;292;Villarreal de Huerva;214;120;94
50;Zaragoza;293;Villarroya de la Sierra;816;415;401
50;Zaragoza;294;Villarroya del Campo;76;39;37
50;Zaragoza;282;Vilueña (La);117;55;62
50;Zaragoza;295;Vistabella;34;15;19
50;Zaragoza;296;Zaida (La);653;327;326
50;Zaragoza;297;Zaragoza;594394;287237;307157
50;Zaragoza;298;Zuera;5294;2685;2609
51;Ceuta;001;Ceuta;67615;33193;34422
52;Melilla;001;Melilla;56600;27953;28647
