01;Álava;001;Alegría-Dulantzi;1018;515;503
01;Álava;002;Amurrio;9457;4745;4712
01;Álava;049;Añana;194;97;97
01;Álava;003;Aramaio;1342;709;633
01;Álava;006;Armiñón;159;84;75
01;Álava;037;Arraia-Maeztu;833;441;392
01;Álava;008;Arrazua-Ubarrundia;602;324;278
01;Álava;004;Artziniega;1159;575;584
01;Álava;009;Asparrena;1557;781;776
01;Álava;010;Ayala/Aiara;2143;1045;1098
01;Álava;011;Baños de Ebro/Mañueta;353;184;169
01;Álava;013;Barrundia;610;343;267
01;Álava;014;Berantevilla;432;218;214
01;Álava;016;Bernedo;606;341;265
01;Álava;017;Campezo/Kanpezu;1214;631;583
01;Álava;021;Elburgo/Burgelu;196;107;89
01;Álava;022;Elciego;919;466;453
01;Álava;023;Elvillar/Bilar;382;199;183
01;Álava;056;Harana/Valle de Arana;436;235;201
01;Álava;901;Iruña Oka/Iruña de Oca;1577;833;744
01;Álava;027;Iruraiz-Gauna;470;256;214
01;Álava;019;Kripan;202;106;96
01;Álava;020;Kuartango;336;184;152
01;Álava;028;Labastida;1007;538;469
01;Álava;030;Lagrán;209;113;96
01;Álava;031;Laguardia;1518;787;731
01;Álava;032;Lanciego/Lantziego;606;322;284
01;Álava;902;Lantarón;857;442;415
01;Álava;033;Lapuebla de Labarca;834;418;416
01;Álava;058;Legutiano;1312;720;592
01;Álava;034;Leza;205;107;98
01;Álava;036;Llodio;21183;10789;10394
01;Álava;039;Moreda de Álava;287;153;134
01;Álava;041;Navaridas;222;118;104
01;Álava;042;Okondo;789;417;372
01;Álava;043;Oyón/Oion;2335;1166;1169
01;Álava;044;Peñacerrada-Urizaharra;235;134;101
01;Álava;046;Ribera Alta;535;313;222
01;Álava;047;Ribera Baja/Erribera Beitia;397;207;190
01;Álava;051;Salvatierra/Agurain;3614;1817;1797
01;Álava;052;Samaniego;307;156;151
01;Álava;053;San Millán/Donemiliaga;781;417;364
01;Álava;054;Urkabustaiz;876;448;428
01;Álava;055;Valdegovía;898;503;395
01;Álava;057;Villabuena de Álava/Eskuernaga;354;184;170
01;Álava;059;Vitoria-Gasteiz;199449;98869;100580
01;Álava;060;Yécora/Lekora;257;130;127
01;Álava;061;Zalduondo;123;67;56
01;Álava;062;Zambrana;352;183;169
01;Álava;018;Zigoitia;729;394;335
01;Álava;063;Zuia;1260;612;648
02;Albacete;001;Abengibre;1130;567;563
02;Albacete;002;Alatoz;811;427;384
02;Albacete;003;Albacete;126110;62223;63887
02;Albacete;004;Albatana;955;477;478
02;Albacete;005;Alborea;941;475;466
02;Albacete;006;Alcadozo;929;473;456
02;Albacete;007;Alcalá del Júcar;1844;941;903
02;Albacete;008;Alcaraz;2147;1051;1096
02;Albacete;009;Almansa;21512;10519;10993
02;Albacete;010;Alpera;2383;1225;1158
02;Albacete;011;Ayna;1503;759;744
02;Albacete;012;Balazote;2201;1105;1096
02;Albacete;014;Ballestero (El);787;391;396
02;Albacete;013;Balsa de Ves;328;162;166
02;Albacete;015;Barrax;2066;1023;1043
02;Albacete;016;Bienservida;1241;648;593
02;Albacete;017;Bogarra;1833;968;865
02;Albacete;018;Bonete;1285;648;637
02;Albacete;019;Bonillo (El);3458;1722;1736
02;Albacete;020;Carcelén;904;452;452
02;Albacete;021;Casas de Juan Núñez;1344;690;654
02;Albacete;022;Casas de Lázaro;553;290;263
02;Albacete;023;Casas de Ves;1364;695;669
02;Albacete;024;Casas-Ibáñez;3899;1960;1939
02;Albacete;025;Caudete;8091;4019;4072
02;Albacete;026;Cenizate;1097;565;532
02;Albacete;029;Chinchilla de Monte-Aragón;3534;1819;1715
02;Albacete;027;Corral-Rubio;577;296;281
02;Albacete;028;Cotillas;325;172;153
02;Albacete;030;Elche de la Sierra;4174;2038;2136
02;Albacete;032;Fuensanta;477;227;250
02;Albacete;033;Fuente-Álamo;2615;1341;1274
02;Albacete;034;Fuentealbilla;1921;987;934
02;Albacete;031;Férez;1018;509;509
02;Albacete;035;Gineta (La);2362;1138;1224
02;Albacete;036;Golosalvo;165;81;84
02;Albacete;037;Hellín;24090;11883;12207
02;Albacete;038;Herrera (La);463;249;214
02;Albacete;039;Higueruela;1431;714;717
02;Albacete;040;Hoya-Gonzalo;750;383;367
02;Albacete;041;Jorquera;813;429;384
02;Albacete;042;Letur;1789;921;868
02;Albacete;043;Lezuza;2218;1120;1098
02;Albacete;044;Liétor;2028;1050;978
02;Albacete;045;Madrigueras;4483;2246;2237
02;Albacete;046;Mahora;1482;733;749
02;Albacete;047;Masegoso;332;185;147
02;Albacete;048;Minaya;2116;1061;1055
02;Albacete;049;Molinicos;2012;1026;986
02;Albacete;050;Montalvos;174;91;83
02;Albacete;051;Montealegre del Castillo;2287;1136;1151
02;Albacete;052;Motilleja;563;274;289
02;Albacete;053;Munera;4296;2208;2088
02;Albacete;054;Navas de Jorquera;612;316;296
02;Albacete;055;Nerpio;2440;1270;1170
02;Albacete;056;Ontur;2826;1367;1459
02;Albacete;057;Ossa de Montiel;2827;1457;1370
02;Albacete;058;Paterna del Madera;722;383;339
02;Albacete;060;Peñas de San Pedro;1527;797;730
02;Albacete;059;Peñascosa;566;301;265
02;Albacete;061;Pétrola;1245;627;618
02;Albacete;062;Povedilla;821;429;392
02;Albacete;064;Pozo-Lorente;551;271;280
02;Albacete;063;Pozohondo;2166;1105;1061
02;Albacete;065;Pozuelo;744;376;368
02;Albacete;066;Recueja (La);475;247;228
02;Albacete;067;Riópar;1464;743;721
02;Albacete;068;Robledo;534;285;249
02;Albacete;069;Roda (La);12601;6294;6307
02;Albacete;070;Salobre;754;395;359
02;Albacete;071;San Pedro;1455;739;716
02;Albacete;072;Socovos;2423;1233;1190
02;Albacete;073;Tarazona de la Mancha;5924;2987;2937
02;Albacete;074;Tobarra;7407;3687;3720
02;Albacete;075;Valdeganga;2354;1176;1178
02;Albacete;076;Vianos;568;295;273
02;Albacete;077;Villa de Ves;49;25;24
02;Albacete;078;Villalgordo del Júcar;1340;662;678
02;Albacete;079;Villamalea;3426;1799;1627
02;Albacete;080;Villapalacios;1136;561;575
02;Albacete;081;Villarrobledo;20703;10203;10500
02;Albacete;082;Villatoya;240;134;106
02;Albacete;083;Villavaliente;371;188;183
02;Albacete;084;Villaverde de Guadalimar;747;417;330
02;Albacete;085;Viveros;688;356;332
02;Albacete;086;Yeste;5300;2744;2556
03;Alicante/Alacant;001;Adsubia;558;282;276
03;Alicante/Alacant;002;Agost;3809;1928;1881
03;Alicante/Alacant;003;Agres;723;374;349
03;Alicante/Alacant;004;Aigües;329;156;173
03;Alicante/Alacant;005;Albatera;8632;4345;4287
03;Alicante/Alacant;006;Alcalalí;649;328;321
03;Alicante/Alacant;007;Alcocer de Planes;123;57;66
03;Alicante/Alacant;008;Alcoleja;337;154;183
03;Alicante/Alacant;009;Alcoy/Alcoi;66244;31884;34360
03;Alicante/Alacant;010;Alfafara;409;201;208
03;Alicante/Alacant;011;Alfàs del Pi (L');6580;3228;3352
03;Alicante/Alacant;012;Algorfa;1090;539;551
03;Alicante/Alacant;013;Algueña;1576;772;804
03;Alicante/Alacant;014;Alicante/Alacant;258112;124622;133490
03;Alicante/Alacant;015;Almoradí;13962;7006;6956
03;Alicante/Alacant;016;Almudaina;146;68;78
03;Alicante/Alacant;017;Alquería d'Asnar (L');420;208;212
03;Alicante/Alacant;018;Altea;11911;5876;6035
03;Alicante/Alacant;019;Aspe;15459;7655;7804
03;Alicante/Alacant;020;Balones;175;78;97
03;Alicante/Alacant;021;Banyeres de Mariola;6915;3422;3493
03;Alicante/Alacant;022;Benasau;226;108;118
03;Alicante/Alacant;023;Beneixama;1870;919;951
03;Alicante/Alacant;024;Benejúzar;4431;2217;2214
03;Alicante/Alacant;025;Benferri;969;484;485
03;Alicante/Alacant;026;Beniarbeig;1165;581;584
03;Alicante/Alacant;027;Beniardá;260;126;134
03;Alicante/Alacant;028;Beniarrés;1602;798;804
03;Alicante/Alacant;030;Benidoleig;774;365;409
03;Alicante/Alacant;031;Benidorm;33842;16770;17072
03;Alicante/Alacant;032;Benifallim;202;100;102
03;Alicante/Alacant;033;Benifato;126;63;63
03;Alicante/Alacant;029;Benigembla;395;194;201
03;Alicante/Alacant;034;Benijófar;1365;629;736
03;Alicante/Alacant;035;Benilloba;967;494;473
03;Alicante/Alacant;036;Benillup;74;39;35
03;Alicante/Alacant;037;Benimantell;432;211;221
03;Alicante/Alacant;038;Benimarfull;406;195;211
03;Alicante/Alacant;039;Benimassot;109;53;56
03;Alicante/Alacant;040;Benimeli;349;171;178
03;Alicante/Alacant;041;Benissa;7171;3577;3594
03;Alicante/Alacant;042;Benitachell/Poble Nou de Benitatxell (el);1613;810;803
03;Alicante/Alacant;043;Biar;3312;1604;1708
03;Alicante/Alacant;044;Bigastro;4301;2188;2113
03;Alicante/Alacant;045;Bolulla;270;135;135
03;Alicante/Alacant;046;Busot;739;359;380
03;Alicante/Alacant;048;Callosa d'En Sarrià;7719;3806;3913
03;Alicante/Alacant;049;Callosa de Segura;15236;7585;7651
03;Alicante/Alacant;047;Calpe/Calp;10032;4990;5042
03;Alicante/Alacant;050;Campello (El);9085;4502;4583
03;Alicante/Alacant;051;Campo de Mirra/Camp de Mirra (el);382;190;192
03;Alicante/Alacant;053;Castalla;7045;3491;3554
03;Alicante/Alacant;054;Castell de Castells;598;296;302
03;Alicante/Alacant;055;Catral;4399;2203;2196
03;Alicante/Alacant;052;Cañada;1071;524;547
03;Alicante/Alacant;056;Cocentaina;10409;5096;5313
03;Alicante/Alacant;057;Confrides;348;186;162
03;Alicante/Alacant;058;Cox;5167;2632;2535
03;Alicante/Alacant;059;Crevillent;21553;10903;10650
03;Alicante/Alacant;061;Daya Nueva;1197;596;601
03;Alicante/Alacant;062;Daya Vieja;247;123;124
03;Alicante/Alacant;064;Dolores;5655;2808;2847
03;Alicante/Alacant;063;Dénia;22636;11103;11533
03;Alicante/Alacant;065;Elche/Elx;175649;87054;88595
03;Alicante/Alacant;066;Elda;55994;27357;28637
03;Alicante/Alacant;067;Facheca;152;81;71
03;Alicante/Alacant;068;Famorca;79;34;45
03;Alicante/Alacant;069;Finestrat;1063;531;532
03;Alicante/Alacant;070;Formentera del Segura;1904;948;956
03;Alicante/Alacant;072;Gaianes;333;159;174
03;Alicante/Alacant;071;Gata de Gorgos;5175;2582;2593
03;Alicante/Alacant;073;Gorga;302;151;151
03;Alicante/Alacant;074;Granja de Rocamora;1859;939;920
03;Alicante/Alacant;075;Guadalest;167;86;81
03;Alicante/Alacant;076;Guardamar del Segura;6279;3052;3227
03;Alicante/Alacant;077;Hondón de las Nieves;1489;740;749
03;Alicante/Alacant;078;Hondón de los Frailes;548;274;274
03;Alicante/Alacant;079;Ibi;20248;10009;10239
03;Alicante/Alacant;080;Jacarilla;1413;705;708
03;Alicante/Alacant;081;Jalón/Xaló;1757;865;892
03;Alicante/Alacant;083;Jijona/Xixona;7337;3481;3856
03;Alicante/Alacant;082;Jávea/Xàbia;12647;6219;6428
03;Alicante/Alacant;085;Llíber;423;209;214
03;Alicante/Alacant;084;Lorcha/Orxa (L');916;460;456
03;Alicante/Alacant;086;Millena;134;64;70
03;Alicante/Alacant;088;Monforte del Cid;4757;2446;2311
03;Alicante/Alacant;903;Montesinos (Los);"";"";""
03;Alicante/Alacant;089;Monóvar/Monòver;11755;5729;6026
03;Alicante/Alacant;091;Murla;367;156;211
03;Alicante/Alacant;092;Muro de Alcoy;6284;3127;3157
03;Alicante/Alacant;090;Mutxamel;8466;4247;4219
03;Alicante/Alacant;093;Novelda;21143;10410;10733
03;Alicante/Alacant;094;Nucia (la);5237;2587;2650
03;Alicante/Alacant;095;Ondara;4632;2262;2370
03;Alicante/Alacant;096;Onil;6470;3238;3232
03;Alicante/Alacant;097;Orba;1558;735;823
03;Alicante/Alacant;099;Orihuela;52195;25621;26574
03;Alicante/Alacant;098;Orxeta;463;228;235
03;Alicante/Alacant;100;Parcent;653;330;323
03;Alicante/Alacant;101;Pedreguer;5684;2745;2939
03;Alicante/Alacant;102;Pego;9415;4660;4755
03;Alicante/Alacant;103;Penàguila;383;193;190
03;Alicante/Alacant;104;Petrer;21902;10904;10998
03;Alicante/Alacant;902;Pilar de la Horadada;"";"";""
03;Alicante/Alacant;105;Pinoso;5549;2744;2805
03;Alicante/Alacant;106;Planes;843;424;419
03;Alicante/Alacant;901;Poblets (Els);1005;485;520
03;Alicante/Alacant;107;Polop;1829;891;938
03;Alicante/Alacant;060;Quatretondeta;228;111;117
03;Alicante/Alacant;109;Rafal;2497;1236;1261
03;Alicante/Alacant;111;Redován;4815;2438;2377
03;Alicante/Alacant;112;Relleu;866;440;426
03;Alicante/Alacant;113;Rojales;5009;2508;2501
03;Alicante/Alacant;114;Romana (La);2008;1031;977
03;Alicante/Alacant;110;Ràfol d'Almúnia (El);377;186;191
03;Alicante/Alacant;115;Sagra;404;189;215
03;Alicante/Alacant;116;Salinas;1056;558;498
03;Alicante/Alacant;118;San Fulgencio;1565;781;784
03;Alicante/Alacant;904;San Isidro;"";"";""
03;Alicante/Alacant;120;San Miguel de Salinas;2438;1255;1183
03;Alicante/Alacant;122;San Vicente del Raspeig/Sant Vicent del Raspeig;25408;12584;12824
03;Alicante/Alacant;117;Sanet y Negrals;554;254;300
03;Alicante/Alacant;119;Sant Joan d'Alacant;11342;5566;5776
03;Alicante/Alacant;121;Santa Pola;13208;6564;6644
03;Alicante/Alacant;123;Sax;7866;3921;3945
03;Alicante/Alacant;124;Sella;621;317;304
03;Alicante/Alacant;125;Senija;438;224;214
03;Alicante/Alacant;128;Teulada;4310;2109;2201
03;Alicante/Alacant;129;Tibi;1012;501;511
03;Alicante/Alacant;130;Tollos;46;29;17
03;Alicante/Alacant;131;Tormos;255;133;122
03;Alicante/Alacant;132;Torremanzanas/Torre de les Maçanes (la);741;351;390
03;Alicante/Alacant;133;Torrevieja;17169;8346;8823
03;Alicante/Alacant;127;Tárbena;718;368;350
03;Alicante/Alacant;134;Vall d'Alcalà (La);167;82;85
03;Alicante/Alacant;135;Vall de Ebo;380;188;192
03;Alicante/Alacant;136;Vall de Gallinera;809;403;406
03;Alicante/Alacant;137;Vall de Laguar (La);1022;508;514
03;Alicante/Alacant;138;Verger (El);3636;1751;1885
03;Alicante/Alacant;139;Villajoyosa/Vila Joiosa (La);21671;10604;11067
03;Alicante/Alacant;140;Villena;30277;14982;15295
04;Almería;001;Abla;1731;840;891
04;Almería;002;Abrucena;1594;801;793
04;Almería;003;Adra;19358;9671;9687
04;Almería;004;Albánchez;865;418;447
04;Almería;005;Alboloduy;1033;484;549
04;Almería;006;Albox;10321;5229;5092
04;Almería;007;Alcolea;871;432;439
04;Almería;008;Alcóntar;698;355;343
04;Almería;009;Alcudia de Monteagud;218;96;122
04;Almería;010;Alhabia;885;441;444
04;Almería;011;Alhama de Almería;3068;1525;1543
04;Almería;012;Alicún;243;110;133
04;Almería;013;Almería;153592;74477;79115
04;Almería;014;Almócita;217;107;110
04;Almería;015;Alsodux;125;51;74
04;Almería;016;Antas;2541;1272;1269
04;Almería;017;Arboleas;1513;743;770
04;Almería;018;Armuña de Almanzora;343;160;183
04;Almería;019;Bacares;342;178;164
04;Almería;020;Bayárcal;447;237;210
04;Almería;021;Bayarque;254;126;128
04;Almería;022;Bédar;587;304;283
04;Almería;023;Beires;171;81;90
04;Almería;024;Benahadux;2016;968;1048
04;Almería;026;Benitagla;125;61;64
04;Almería;027;Benizalón;448;234;214
04;Almería;028;Bentarique;348;175;173
04;Almería;029;Berja;11533;5688;5845
04;Almería;030;Canjáyar;2205;1096;1109
04;Almería;031;Cantoria;3406;1712;1694
04;Almería;032;Carboneras;5602;2924;2678
04;Almería;033;Castro de Filabres;160;76;84
04;Almería;036;Chercos;369;177;192
04;Almería;037;Chirivel;2056;1040;1016
04;Almería;034;Cóbdar;305;160;145
04;Almería;035;Cuevas del Almanzora;9070;4493;4577
04;Almería;038;Dalías;3625;1794;1831
04;Almería;039;Darrical;388;193;195
04;Almería;902;Ejido (El);36335;18391;17944
04;Almería;041;Enix;240;112;128
04;Almería;043;Felix;685;310;375
04;Almería;044;Fines;1549;775;774
04;Almería;045;Fiñana;2792;1354;1438
04;Almería;046;Fondón;1031;526;505
04;Almería;047;Gádor;2531;1230;1301
04;Almería;048;Gallardos (Los);1663;849;814
04;Almería;049;Garrucha;3756;1918;1838
04;Almería;050;Gérgal;1257;616;641
04;Almería;051;Huécija;601;296;305
04;Almería;052;Huércal de Almería;3686;1814;1872
04;Almería;053;Huércal-Overa;12745;6304;6441
04;Almería;054;Illar;554;253;301
04;Almería;055;Instinción;676;333;343
04;Almería;056;Laroya;172;89;83
04;Almería;057;Láujar de Andarax;1892;932;960
04;Almería;058;Líjar;560;282;278
04;Almería;059;Lubrín;2199;1075;1124
04;Almería;060;Lucainena de las Torres;702;343;359
04;Almería;061;Lúcar;802;399;403
04;Almería;062;Macael;5554;2791;2763
04;Almería;063;María;1903;991;912
04;Almería;064;Mojácar;2839;1430;1409
04;Almería;903;Mojonera (La);5057;2581;2476
04;Almería;065;Nacimiento;603;308;295
04;Almería;066;Níjar;12102;6128;5974
04;Almería;067;Ohanes;995;501;494
04;Almería;068;Olula de Castro;250;134;116
04;Almería;069;Olula del Río;5212;2624;2588
04;Almería;070;Oria;2651;1330;1321
04;Almería;071;Padules;614;317;297
04;Almería;072;Partaloa;490;245;245
04;Almería;073;Paterna del Río;457;230;227
04;Almería;074;Pechina;2090;1013;1077
04;Almería;075;Pulpí;4161;2079;2082
04;Almería;076;Purchena;1857;939;918
04;Almería;077;Rágol;498;240;258
04;Almería;078;Rioja;1172;575;597
04;Almería;079;Roquetas de Mar;22122;11102;11020
04;Almería;080;Santa Cruz de Marchena;273;123;150
04;Almería;081;Santa Fe de Mondújar;454;220;234
04;Almería;082;Senés;528;274;254
04;Almería;083;Serón;3217;1596;1621
04;Almería;084;Sierro;724;378;346
04;Almería;085;Somontín;566;288;278
04;Almería;086;Sorbas;2829;1423;1406
04;Almería;087;Suflí;256;133;123
04;Almería;088;Tabernas;3274;1631;1643
04;Almería;089;Taberno;1034;513;521
04;Almería;090;Tahal;627;316;311
04;Almería;091;Terque;526;254;272
04;Almería;092;Tíjola;3722;1892;1830
04;Almería;901;Tres Villas (Las);751;402;349
04;Almería;093;Turre;2072;1008;1064
04;Almería;094;Turrillas;298;156;142
04;Almería;095;Uleila del Campo;1095;549;546
04;Almería;096;Urrácal;397;194;203
04;Almería;097;Velefique;428;212;216
04;Almería;098;Vélez-Blanco;2612;1330;1282
04;Almería;099;Vélez-Rubio;6594;3206;3388
04;Almería;100;Vera;5442;2647;2795
04;Almería;101;Viator;2647;1301;1346
04;Almería;102;Vícar;10006;5131;4875
04;Almería;103;Zurgena;2224;1099;1125
05;Ávila;001;Adanero;419;228;191
05;Ávila;002;Adrada (La);1832;948;884
05;Ávila;005;Albornos;326;175;151
05;Ávila;007;Aldeanueva de Santa Cruz;237;127;110
05;Ávila;008;Aldeaseca;446;223;223
05;Ávila;010;Aldehuela (La);328;168;160
05;Ávila;012;Amavida;233;116;117
05;Ávila;013;Arenal (El);1207;612;595
05;Ávila;014;Arenas de San Pedro;6899;3476;3423
05;Ávila;015;Arevalillo;224;105;119
05;Ávila;016;Arévalo;7005;3408;3597
05;Ávila;017;Aveinte;178;88;90
05;Ávila;018;Avellaneda;82;38;44
05;Ávila;019;Ávila;43603;21057;22546
05;Ávila;021;Barco de Ávila (El);2702;1339;1363
05;Ávila;022;Barraco (El);2171;1114;1057
05;Ávila;023;Barromán;358;188;170
05;Ávila;024;Becedas;690;343;347
05;Ávila;025;Becedillas;233;126;107
05;Ávila;026;Bercial de Zapardiel;398;195;203
05;Ávila;027;Berlanas (Las);401;201;200
05;Ávila;029;Bernuy-Zapardiel;326;169;157
05;Ávila;030;Berrocalejo de Aragona;42;21;21
05;Ávila;033;Blascomillán;426;209;217
05;Ávila;034;Blasconuño de Matacabras;38;19;19
05;Ávila;035;Blascosancho;207;107;100
05;Ávila;036;Bohodón (El);253;138;115
05;Ávila;037;Bohoyo;663;365;298
05;Ávila;038;Bonilla de la Sierra;291;156;135
05;Ávila;039;Brabos;93;49;44
05;Ávila;040;Bularros;159;86;73
05;Ávila;041;Burgohondo;1525;773;752
05;Ávila;042;Cabezas de Alambre;316;163;153
05;Ávila;043;Cabezas del Pozo;266;133;133
05;Ávila;044;Cabezas del Villar;692;377;315
05;Ávila;045;Cabizuela;165;86;79
05;Ávila;046;Canales;97;49;48
05;Ávila;047;Candeleda;5471;2767;2704
05;Ávila;048;Cantiveros;277;139;138
05;Ávila;049;Cardeñosa;650;344;306
05;Ávila;051;Carrera (La);377;194;183
05;Ávila;052;Casas del Puerto de Villatoro;147;83;64
05;Ávila;053;Casasola;262;139;123
05;Ávila;054;Casavieja;1744;893;851
05;Ávila;055;Casillas;1050;533;517
05;Ávila;056;Castellanos de Zapardiel;200;115;85
05;Ávila;057;Cebreros;3421;1717;1704
05;Ávila;058;Cepeda la Mora;207;111;96
05;Ávila;067;Chamartín;141;74;67
05;Ávila;059;Cillán;187;92;95
05;Ávila;060;Cisla;258;126;132
05;Ávila;061;Colilla (La);244;122;122
05;Ávila;062;Collado de Contreras;351;190;161
05;Ávila;063;Collado del Mirón;139;71;68
05;Ávila;064;Constanzana;238;131;107
05;Ávila;065;Crespos;833;433;400
05;Ávila;066;Cuevas del Valle;717;384;333
05;Ávila;903;Diego del Carpio;467;247;220
05;Ávila;069;Donjimeno;155;81;74
05;Ávila;070;Donvidas;104;51;53
05;Ávila;072;Espinosa de los Caballeros;143;79;64
05;Ávila;073;Flores de Ávila;567;298;269
05;Ávila;074;Fontíveros;1175;595;580
05;Ávila;075;Fresnedilla;170;80;90
05;Ávila;076;Fresno (El);454;231;223
05;Ávila;077;Fuente el Saúz;406;197;209
05;Ávila;078;Fuentes de Año;309;154;155
05;Ávila;079;Gallegos de Altamiros;153;83;70
05;Ávila;080;Gallegos de Sobrinos;148;72;76
05;Ávila;081;Garganta del Villar;117;65;52
05;Ávila;082;Gavilanes;852;450;402
05;Ávila;083;Gemuño;297;150;147
05;Ávila;085;Gil García;108;54;54
05;Ávila;084;Gilbuena;228;125;103
05;Ávila;086;Gimialcón;165;87;78
05;Ávila;087;Gotarrendura;233;83;150
05;Ávila;088;Grandes y San Martín;91;43;48
05;Ávila;089;Guisando;841;431;410
05;Ávila;090;Gutierre-Muñoz;162;79;83
05;Ávila;092;Hernansancho;273;136;137
05;Ávila;093;Herradón de Pinares;515;264;251
05;Ávila;094;Herreros de Suso;406;201;205
05;Ávila;095;Higuera de las Dueñas;332;177;155
05;Ávila;096;Hija de Dios (La);179;98;81
05;Ávila;097;Horcajada (La);1134;567;567
05;Ávila;099;Horcajo de las Torres;1035;561;474
05;Ávila;100;Hornillo (El);584;295;289
05;Ávila;102;Hoyo de Pinares (El);2680;1372;1308
05;Ávila;101;Hoyocasero;555;289;266
05;Ávila;103;Hoyorredondo;197;91;106
05;Ávila;106;Hoyos de Miguel Muñoz;83;46;37
05;Ávila;104;Hoyos del Collado;67;41;26
05;Ávila;105;Hoyos del Espino;421;218;203
05;Ávila;107;Hurtumpascual;198;101;97
05;Ávila;108;Junciana;125;61;64
05;Ávila;109;Langa;636;340;296
05;Ávila;110;Lanzahíta;944;498;446
05;Ávila;113;Llanos de Tormes (Los);204;104;100
05;Ávila;112;Losar del Barco (El);228;127;101
05;Ávila;114;Madrigal de las Altas Torres;2355;1212;1143
05;Ávila;115;Maello;713;363;350
05;Ávila;116;Malpartida de Corneja;329;163;166
05;Ávila;117;Mamblas;339;180;159
05;Ávila;118;Mancera de Arriba;232;123;109
05;Ávila;119;Manjabálago;126;66;60
05;Ávila;120;Marlín;56;29;27
05;Ávila;121;Martiherrero;215;110;105
05;Ávila;122;Martínez;323;167;156
05;Ávila;123;Mediana de Voltoya;128;72;56
05;Ávila;124;Medinilla;359;181;178
05;Ávila;125;Mengamuñoz;89;46;43
05;Ávila;126;Mesegar de Corneja;161;76;85
05;Ávila;127;Mijares;1167;599;568
05;Ávila;128;Mingorría;613;312;301
05;Ávila;129;Mirón (El);411;219;192
05;Ávila;130;Mironcillo;156;88;68
05;Ávila;131;Mirueña de los Infanzones;318;159;159
05;Ávila;132;Mombeltrán;1366;726;640
05;Ávila;133;Monsalupe;153;78;75
05;Ávila;134;Moraleja de Matacabras;99;50;49
05;Ávila;135;Muñana;654;347;307
05;Ávila;136;Muñico;227;124;103
05;Ávila;138;Muñogalindo;518;280;238
05;Ávila;139;Muñogrande;124;67;57
05;Ávila;140;Muñomer del Peco;134;81;53
05;Ávila;141;Muñopepe;125;63;62
05;Ávila;142;Muñosancho;229;106;123
05;Ávila;143;Muñotello;181;102;79
05;Ávila;144;Narrillos del Álamo;222;118;104
05;Ávila;145;Narrillos del Rebollar;120;61;59
05;Ávila;149;Narros de Saldueña;279;138;141
05;Ávila;147;Narros del Castillo;352;190;162
05;Ávila;148;Narros del Puerto;68;40;28
05;Ávila;152;Nava de Arévalo;1227;645;582
05;Ávila;153;Nava del Barco;292;143;149
05;Ávila;151;Navacepedilla de Corneja;196;99;97
05;Ávila;154;Navadijos;102;52;50
05;Ávila;155;Navaescurial;138;78;60
05;Ávila;156;Navahondilla;145;57;88
05;Ávila;157;Navalacruz;428;216;212
05;Ávila;158;Navalmoral;762;385;377
05;Ávila;159;Navalonguilla;624;311;313
05;Ávila;160;Navalosa;624;313;311
05;Ávila;161;Navalperal de Pinares;994;490;504
05;Ávila;162;Navalperal de Tormes;214;102;112
05;Ávila;163;Navaluenga;2179;1115;1064
05;Ávila;164;Navaquesera;129;66;63
05;Ávila;165;Navarredonda de Gredos;577;296;281
05;Ávila;166;Navarredondilla;363;178;185
05;Ávila;167;Navarrevisca;449;242;207
05;Ávila;168;Navas del Marqués (Las);4147;2087;2060
05;Ávila;169;Navatalgordo;1229;633;596
05;Ávila;170;Navatejares;210;98;112
05;Ávila;171;Neila de San Miguel;180;95;85
05;Ávila;172;Niharra;251;127;124
05;Ávila;173;Ojos-Albos;42;20;22
05;Ávila;174;Orbita;128;71;57
05;Ávila;175;Oso (El);279;148;131
05;Ávila;176;Padiernos;335;183;152
05;Ávila;177;Pajares de Adaja;241;125;116
05;Ávila;178;Palacios de Goda;636;305;331
05;Ávila;179;Papatrigo;425;205;220
05;Ávila;180;Parral (El);207;99;108
05;Ávila;181;Pascualcobo;87;45;42
05;Ávila;182;Pedro Bernardo;2044;1066;978
05;Ávila;183;Pedro-Rodríguez;272;128;144
05;Ávila;184;Peguerinos;462;240;222
05;Ávila;185;Peñalba de Ávila;187;101;86
05;Ávila;186;Piedrahíta;2446;1188;1258
05;Ávila;187;Piedralaves;2216;1114;1102
05;Ávila;188;Poveda;122;62;60
05;Ávila;189;Poyales del Hoyo;898;444;454
05;Ávila;190;Pozanco;82;45;37
05;Ávila;191;Pradosegar;229;119;110
05;Ávila;192;Puerto Castilla;222;110;112
05;Ávila;193;Rasueros;493;262;231
05;Ávila;194;Riocabado;266;148;118
05;Ávila;195;Riofrío;417;224;193
05;Ávila;196;Rivilla de Barajas;121;64;57
05;Ávila;197;Salobral;139;67;72
05;Ávila;198;Salvadiós;147;80;67
05;Ávila;199;San Bartolomé de Béjar;140;62;78
05;Ávila;200;San Bartolomé de Corneja;191;100;91
05;Ávila;201;San Bartolomé de Pinares;893;475;418
05;Ávila;206;San Esteban de los Patos;66;36;30
05;Ávila;208;San Esteban de Zapardiel;140;68;72
05;Ávila;207;San Esteban del Valle;1135;581;554
05;Ávila;209;San García de Ingelmos;254;130;124
05;Ávila;901;San Juan de Gredos;568;288;280
05;Ávila;210;San Juan de la Encinilla;200;91;109
05;Ávila;211;San Juan de la Nava;791;410;381
05;Ávila;212;San Juan del Molinillo;459;244;215
05;Ávila;213;San Juan del Olmo;259;138;121
05;Ávila;214;San Lorenzo de Tormes;97;48;49
05;Ávila;215;San Martín de la Vega del Alberche;389;214;175
05;Ávila;216;San Martín del Pimpollar;317;167;150
05;Ávila;217;San Miguel de Corneja;148;80;68
05;Ávila;218;San Miguel de Serrezuela;293;154;139
05;Ávila;219;San Pascual;86;46;40
05;Ávila;220;San Pedro del Arroyo;567;293;274
05;Ávila;231;San Vicente de Arévalo;275;140;135
05;Ávila;204;Sanchidrián;860;422;438
05;Ávila;205;Sanchorreja;170;88;82
05;Ávila;222;Santa Cruz de Pinares;288;164;124
05;Ávila;221;Santa Cruz del Valle;740;366;374
05;Ávila;226;Santa María de los Caballeros;256;130;126
05;Ávila;224;Santa María del Arroyo;178;86;92
05;Ávila;225;Santa María del Berrocal;801;399;402
05;Ávila;902;Santa María del Cubillo;482;268;214
05;Ávila;227;Santa María del Tiétar;370;183;187
05;Ávila;228;Santiago del Collado;392;229;163
05;Ávila;904;Santiago del Tormes;488;255;233
05;Ávila;229;Santo Domingo de las Posadas;128;66;62
05;Ávila;230;Santo Tomé de Zabarcos;154;82;72
05;Ávila;232;Serrada (La);185;96;89
05;Ávila;233;Serranillos;587;301;286
05;Ávila;234;Sigeres;96;44;52
05;Ávila;235;Sinlabajos;315;166;149
05;Ávila;236;Solana de Ávila;367;192;175
05;Ávila;237;Solana de Rioalmar;399;209;190
05;Ávila;238;Solosancho;1413;739;674
05;Ávila;239;Sotalbo;309;165;144
05;Ávila;240;Sotillo de la Adrada;3261;1643;1618
05;Ávila;241;Tiemblo (El);3887;1944;1943
05;Ávila;242;Tiñosillos;768;411;357
05;Ávila;243;Tolbaños;202;97;105
05;Ávila;244;Tormellas;169;87;82
05;Ávila;245;Tornadizos de Ávila;360;177;183
05;Ávila;247;Torre (La);605;326;279
05;Ávila;246;Tórtoles;194;103;91
05;Ávila;249;Umbrías;232;117;115
05;Ávila;251;Vadillo de la Sierra;225;132;93
05;Ávila;252;Valdecasa;160;84;76
05;Ávila;253;Vega de Santa María;156;84;72
05;Ávila;254;Velayos;354;180;174
05;Ávila;256;Villaflor;231;115;116
05;Ávila;257;Villafranca de la Sierra;312;167;145
05;Ávila;905;Villanueva de Ávila;"";"";""
05;Ávila;258;Villanueva de Gómez;225;109;116
05;Ávila;259;Villanueva del Aceral;269;125;144
05;Ávila;260;Villanueva del Campillo;274;142;132
05;Ávila;261;Villar de Corneja;133;63;70
05;Ávila;262;Villarejo del Valle;519;268;251
05;Ávila;263;Villatoro;293;157;136
05;Ávila;264;Viñegra de Moraña;105;59;46
05;Ávila;265;Vita;152;86;66
05;Ávila;266;Zapardiel de la Cañada;284;142;142
05;Ávila;267;Zapardiel de la Ribera;171;88;83
06;Badajoz;001;Acedera;1059;560;499
06;Badajoz;002;Aceuchal;5101;2552;2549
06;Badajoz;003;Ahillones;1402;688;714
06;Badajoz;004;Alange;1979;1028;951
06;Badajoz;005;Albuera (La);1767;889;878
06;Badajoz;006;Alburquerque;5612;2845;2767
06;Badajoz;007;Alconchel;2759;1369;1390
06;Badajoz;008;Alconera;862;439;423
06;Badajoz;009;Aljucén;223;121;102
06;Badajoz;010;Almendral;1588;780;808
06;Badajoz;011;Almendralejo;24966;12122;12844
06;Badajoz;012;Arroyo de San Serván;3697;1876;1821
06;Badajoz;013;Atalaya;384;190;194
06;Badajoz;014;Azuaga;10177;5012;5165
06;Badajoz;015;Badajoz;118852;57533;61319
06;Badajoz;016;Barcarrota;4383;2195;2188
06;Badajoz;017;Baterno;492;250;242
06;Badajoz;018;Benquerencia de la Serena;1456;730;726
06;Badajoz;019;Berlanga;2976;1487;1489
06;Badajoz;020;Bienvenida;2764;1388;1376
06;Badajoz;021;Bodonal de la Sierra;1576;792;784
06;Badajoz;022;Burguillos del Cerro;3403;1699;1704
06;Badajoz;023;Cabeza del Buey;6690;3297;3393
06;Badajoz;024;Cabeza la Vaca;1941;954;987
06;Badajoz;025;Calamonte;5354;2658;2696
06;Badajoz;026;Calera de León;1225;627;598
06;Badajoz;027;Calzadilla de los Barros;867;431;436
06;Badajoz;028;Campanario;6022;2877;3145
06;Badajoz;029;Campillo de Llerena;1953;955;998
06;Badajoz;030;Capilla;275;132;143
06;Badajoz;031;Carmonita;759;409;350
06;Badajoz;032;Carrascalejo (El);29;14;15
06;Badajoz;033;Casas de Don Pedro;1969;964;1005
06;Badajoz;034;Casas de Reina;344;156;188
06;Badajoz;035;Castilblanco;2013;1008;1005
06;Badajoz;036;Castuera;8362;4142;4220
06;Badajoz;042;Cheles;1426;718;708
06;Badajoz;037;Codosera (La);2653;1370;1283
06;Badajoz;038;Cordobilla de Lácara;1153;598;555
06;Badajoz;039;Coronada (La);2648;1319;1329
06;Badajoz;040;Corte de Peleas;1308;666;642
06;Badajoz;041;Cristina;548;289;259
06;Badajoz;043;Don Álvaro;605;308;297
06;Badajoz;044;Don Benito;28703;14419;14284
06;Badajoz;045;Entrín Bajo;713;351;362
06;Badajoz;046;Esparragalejo;1364;701;663
06;Badajoz;047;Esparragosa de la Serena;1223;604;619
06;Badajoz;048;Esparragosa de Lares;1439;701;738
06;Badajoz;049;Feria;1792;893;899
06;Badajoz;050;Fregenal de la Sierra;6017;2912;3105
06;Badajoz;051;Fuenlabrada de los Montes;2471;1237;1234
06;Badajoz;052;Fuente de Cantos;5145;2573;2572
06;Badajoz;053;Fuente del Arco;998;513;485
06;Badajoz;054;Fuente del Maestre;7007;3494;3513
06;Badajoz;055;Fuentes de León;3064;1448;1616
06;Badajoz;056;Garbayuela;656;346;310
06;Badajoz;057;Garlitos;958;474;484
06;Badajoz;058;Garrovilla (La);2663;1380;1283
06;Badajoz;059;Granja de Torrehermosa;3014;1477;1537
06;Badajoz;060;Guareña;7787;3896;3891
06;Badajoz;061;Haba (La);1868;904;964
06;Badajoz;062;Helechosa de los Montes;944;495;449
06;Badajoz;063;Herrera del Duque;4264;2129;2135
06;Badajoz;064;Higuera de la Serena;1459;734;725
06;Badajoz;065;Higuera de Llerena;637;303;334
06;Badajoz;066;Higuera de Vargas;3114;1549;1565
06;Badajoz;067;Higuera la Real;2954;1483;1471
06;Badajoz;068;Hinojosa del Valle;750;404;346
06;Badajoz;069;Hornachos;4101;2083;2018
06;Badajoz;070;Jerez de los Caballeros;9224;4595;4629
06;Badajoz;071;Lapa (La);384;193;191
06;Badajoz;073;Llera;1213;614;599
06;Badajoz;074;Llerena;5858;2815;3043
06;Badajoz;072;Lobón;2706;1407;1299
06;Badajoz;075;Magacela;1006;518;488
06;Badajoz;076;Maguilla;1411;706;705
06;Badajoz;077;Malcocinado;739;383;356
06;Badajoz;078;Malpartida de la Serena;1069;526;543
06;Badajoz;079;Manchita;783;414;369
06;Badajoz;080;Medellín;2589;1296;1293
06;Badajoz;081;Medina de las Torres;2006;1004;1002
06;Badajoz;082;Mengabril;545;281;264
06;Badajoz;083;Mérida;51641;25109;26532
06;Badajoz;084;Mirandilla;1347;671;676
06;Badajoz;085;Monesterio;5259;2629;2630
06;Badajoz;086;Montemolín;2035;1017;1018
06;Badajoz;087;Monterrubio de la Serena;3719;1841;1878
06;Badajoz;088;Montijo;14531;7171;7360
06;Badajoz;089;Morera (La);805;411;394
06;Badajoz;090;Nava de Santiago (La);1243;620;623
06;Badajoz;091;Navalvillar de Pela;5368;2702;2666
06;Badajoz;092;Nogales;789;412;377
06;Badajoz;093;Oliva de la Frontera;7011;3435;3576
06;Badajoz;094;Oliva de Mérida;2334;1171;1163
06;Badajoz;095;Olivenza;10429;5143;5286
06;Badajoz;096;Orellana de la Sierra;542;266;276
06;Badajoz;097;Orellana la Vieja;4488;2261;2227
06;Badajoz;098;Palomas;721;364;357
06;Badajoz;099;Parra (La);1449;742;707
06;Badajoz;100;Peñalsordo;2064;984;1080
06;Badajoz;101;Peraleda del Zaucejo;849;412;437
06;Badajoz;102;Puebla de Alcocer;1907;962;945
06;Badajoz;103;Puebla de la Calzada;5627;2814;2813
06;Badajoz;104;Puebla de la Reina;930;477;453
06;Badajoz;107;Puebla de Obando;2180;1105;1075
06;Badajoz;108;Puebla de Sancho Pérez;3061;1504;1557
06;Badajoz;105;Puebla del Maestre;1279;615;664
06;Badajoz;106;Puebla del Prior;643;341;302
06;Badajoz;109;Quintana de la Serena;5047;2509;2538
06;Badajoz;110;Reina;295;151;144
06;Badajoz;111;Rena;672;353;319
06;Badajoz;112;Retamal de Llerena;747;379;368
06;Badajoz;113;Ribera del Fresno;3634;1752;1882
06;Badajoz;114;Risco;279;142;137
06;Badajoz;115;Roca de la Sierra (La);1759;887;872
06;Badajoz;116;Salvaleón;2591;1344;1247
06;Badajoz;117;Salvatierra de los Barros;2063;1038;1025
06;Badajoz;119;San Pedro de Mérida;799;411;388
06;Badajoz;123;San Vicente de Alcántara;6252;3102;3150
06;Badajoz;118;Sancti-Spíritus;422;206;216
06;Badajoz;120;Santa Amalia;4134;2083;2051
06;Badajoz;121;Santa Marta;4070;2042;2028
06;Badajoz;122;Santos de Maimona (Los);7490;3737;3753
06;Badajoz;124;Segura de León;2620;1311;1309
06;Badajoz;125;Siruela;2800;1365;1435
06;Badajoz;126;Solana de los Barros;2837;1460;1377
06;Badajoz;127;Talarrubias;4225;2063;2162
06;Badajoz;128;Talavera la Real;5271;2675;2596
06;Badajoz;129;Táliga;820;435;385
06;Badajoz;130;Tamurejo;357;172;185
06;Badajoz;131;Torre de Miguel Sesmero;1354;663;691
06;Badajoz;132;Torremayor;1135;572;563
06;Badajoz;133;Torremejía;1906;959;947
06;Badajoz;134;Trasierra;733;391;342
06;Badajoz;135;Trujillanos;1003;516;487
06;Badajoz;136;Usagre;2255;1148;1107
06;Badajoz;137;Valdecaballeros;1906;968;938
06;Badajoz;901;Valdelacalzada;"";"";""
06;Badajoz;138;Valdetorres;1471;751;720
06;Badajoz;139;Valencia de las Torres;1019;516;503
06;Badajoz;140;Valencia del Mombuey;1062;519;543
06;Badajoz;141;Valencia del Ventoso;2693;1347;1346
06;Badajoz;146;Valle de la Serena;2032;992;1040
06;Badajoz;147;Valle de Matamoros;700;343;357
06;Badajoz;148;Valle de Santa Ana;1429;730;699
06;Badajoz;142;Valverde de Burguillos;428;214;214
06;Badajoz;143;Valverde de Leganés;3571;1807;1764
06;Badajoz;144;Valverde de Llerena;1004;488;516
06;Badajoz;145;Valverde de Mérida;1165;596;569
06;Badajoz;149;Villafranca de los Barros;12564;6174;6390
06;Badajoz;150;Villagarcía de la Torre;1213;621;592
06;Badajoz;151;Villagonzalo;1638;781;857
06;Badajoz;152;Villalba de los Barros;1742;850;892
06;Badajoz;153;Villanueva de la Serena;23712;11670;12042
06;Badajoz;154;Villanueva del Fresno;3983;1966;2017
06;Badajoz;156;Villar de Rena;2020;1068;952
06;Badajoz;155;Villar del Rey;2473;1269;1204
06;Badajoz;157;Villarta de los Montes;984;472;512
06;Badajoz;158;Zafra;13697;6548;7149
06;Badajoz;159;Zahínos;3180;1581;1599
06;Badajoz;160;Zalamea de la Serena;5911;2901;3010
06;Badajoz;162;Zarza (La);3603;1823;1780
06;Badajoz;161;Zarza-Capilla;772;377;395
07;Balears (Illes);002;Alaior;5922;2922;3000
07;Balears (Illes);001;Alaró;3502;1675;1827
07;Balears (Illes);003;Alcúdia;6632;3257;3375
07;Balears (Illes);004;Algaida;3027;1511;1516
07;Balears (Illes);005;Andratx;6466;3161;3305
07;Balears (Illes);901;Ariany;916;447;469
07;Balears (Illes);006;Artà;5729;2800;2929
07;Balears (Illes);007;Banyalbufar;427;209;218
07;Balears (Illes);008;Binissalem;4680;2255;2425
07;Balears (Illes);009;Búger;1016;501;515
07;Balears (Illes);010;Bunyola;3541;1741;1800
07;Balears (Illes);011;Calvià;13640;6982;6658
07;Balears (Illes);012;Campanet;2199;1100;1099
07;Balears (Illes);013;Campos;6406;3190;3216
07;Balears (Illes);014;Capdepera;5387;2700;2687
07;Balears (Illes);064;Castell (Es);4467;2251;2216
07;Balears (Illes);015;Ciutadella de Menorca;18905;9399;9506
07;Balears (Illes);016;Consell;2003;989;1014
07;Balears (Illes);017;Costitx;742;354;388
07;Balears (Illes);018;Deyá;528;257;271
07;Balears (Illes);026;Eivissa;27384;13862;13522
07;Balears (Illes);019;Escorca;233;142;91
07;Balears (Illes);020;Esporles;2823;1392;1431
07;Balears (Illes);021;Estellencs;311;155;156
07;Balears (Illes);022;Felanitx;13592;6725;6867
07;Balears (Illes);023;Ferreries;3295;1761;1534
07;Balears (Illes);024;Formentera;4734;2431;2303
07;Balears (Illes);025;Fornalutx;511;248;263
07;Balears (Illes);027;Inca;21701;10625;11076
07;Balears (Illes);028;Lloret de Vistalegre;816;397;419
07;Balears (Illes);029;Lloseta;4455;2213;2242
07;Balears (Illes);030;Llubí;1982;982;1000
07;Balears (Illes);031;Llucmajor;15505;7676;7829
07;Balears (Illes);032;Mahón;21627;10569;11058
07;Balears (Illes);033;Manacor;24345;11965;12380
07;Balears (Illes);034;Mancor de la Vall;878;429;449
07;Balears (Illes);035;Maria de la Salut;1866;914;952
07;Balears (Illes);036;Marratxí;10104;5082;5022
07;Balears (Illes);037;Mercadal (Es);3008;1523;1485
07;Balears (Illes);902;Migjorn Gran (Es);"";"";""
07;Balears (Illes);038;Montuïri;2168;1035;1133
07;Balears (Illes);039;Muro;5778;2872;2906
07;Balears (Illes);040;Palma de Mallorca;295136;143577;151559
07;Balears (Illes);041;Petra;2648;1276;1372
07;Balears (Illes);044;Pobla (Sa);10204;5058;5146
07;Balears (Illes);042;Pollença;11509;5722;5787
07;Balears (Illes);043;Porreres;4501;2223;2278
07;Balears (Illes);045;Puigpunyent;1094;546;548
07;Balears (Illes);059;Salines (Ses);2872;1462;1410
07;Balears (Illes);046;Sant Antoni de Portmany;11689;5820;5869
07;Balears (Illes);049;Sant Joan;1808;890;918
07;Balears (Illes);050;Sant Joan de Labritja;3479;1718;1761
07;Balears (Illes);048;Sant Josep de sa Talaia;8403;4301;4102
07;Balears (Illes);051;Sant Llorenç des Cardassar;4290;2149;2141
07;Balears (Illes);052;Sant Lluís;2832;1417;1415
07;Balears (Illes);053;Santa Eugènia;914;455;459
07;Balears (Illes);054;Santa Eulalia del Río;14059;7074;6985
07;Balears (Illes);055;Santa Margalida;5051;2511;2540
07;Balears (Illes);056;Santa María del Camí;3983;1975;2008
07;Balears (Illes);057;Santanyí;6582;3335;3247
07;Balears (Illes);058;Selva;3004;1485;1519
07;Balears (Illes);047;Sencelles;1553;743;810
07;Balears (Illes);060;Sineu;2617;1295;1322
07;Balears (Illes);061;Sóller;10145;4915;5230
07;Balears (Illes);062;Son Servera;5867;2965;2902
07;Balears (Illes);063;Valldemossa;1262;584;678
07;Balears (Illes);065;Vilafranca de Bonany;2180;1070;1110
08;Barcelona;001;Abrera;4404;2236;2168
08;Barcelona;002;Aguilar de Segarra;216;109;107
08;Barcelona;014;Aiguafreda;2019;992;1027
08;Barcelona;003;Alella;5287;2564;2723
08;Barcelona;004;Alpens;252;131;121
08;Barcelona;005;Ametlla del Vallès (L');2554;1230;1324
08;Barcelona;006;Arenys de Mar;10269;4910;5359
08;Barcelona;007;Arenys de Munt;4654;2282;2372
08;Barcelona;008;Argençola;192;102;90
08;Barcelona;009;Argentona;7183;3564;3619
08;Barcelona;010;Artés;4037;1963;2074
08;Barcelona;011;Avià;1803;915;888
08;Barcelona;012;Avinyó;2000;980;1020
08;Barcelona;013;Avinyonet del Penedès;1187;606;581
08;Barcelona;015;Badalona;225016;112252;112764
08;Barcelona;904;Badia del Vallès;"";"";""
08;Barcelona;016;Bagà;2154;1087;1067
08;Barcelona;017;Balenyà;3166;1625;1541
08;Barcelona;018;Balsareny;3511;1718;1793
08;Barcelona;252;Barberà del Vallès;29917;15584;14333
08;Barcelona;019;Barcelona;1701812;806632;895180
08;Barcelona;020;Begues;1534;740;794
08;Barcelona;021;Bellprat;93;49;44
08;Barcelona;022;Berga;13766;6695;7071
08;Barcelona;023;Bigues i Riells;1983;1008;975
08;Barcelona;024;Borredà;445;212;233
08;Barcelona;025;Bruc (El);707;361;346
08;Barcelona;026;Brull (El);182;95;87
08;Barcelona;027;Cabanyes (Les);359;189;170
08;Barcelona;029;Cabrera de Mar;1985;990;995
08;Barcelona;028;Cabrera d'Igualada;251;138;113
08;Barcelona;030;Cabrils;2100;994;1106
08;Barcelona;031;Calaf;3205;1572;1633
08;Barcelona;034;Calders;482;257;225
08;Barcelona;033;Caldes de Montbui;10407;5129;5278
08;Barcelona;032;Caldes d'Estrac;1315;639;676
08;Barcelona;035;Calella;11320;5300;6020
08;Barcelona;037;Calldetenes;1408;705;703
08;Barcelona;038;Callús;1499;721;778
08;Barcelona;036;Calonge de Segarra;195;104;91
08;Barcelona;039;Campins;187;90;97
08;Barcelona;040;Canet de Mar;8667;4231;4436
08;Barcelona;041;Canovelles;12557;6325;6232
08;Barcelona;042;Cànoves i Samalús;738;369;369
08;Barcelona;043;Canyelles;597;327;270
08;Barcelona;044;Capellades;4917;2404;2513
08;Barcelona;045;Capolat;107;57;50
08;Barcelona;046;Cardedeu;8052;3995;4057
08;Barcelona;047;Cardona;6723;3297;3426
08;Barcelona;048;Carme;697;363;334
08;Barcelona;049;Casserres;1783;872;911
08;Barcelona;057;Castell de l'Areny;34;20;14
08;Barcelona;052;Castellar de n'Hug;176;93;83
08;Barcelona;050;Castellar del Riu;54;30;24
08;Barcelona;051;Castellar del Vallès;11637;5793;5844
08;Barcelona;053;Castellbell i el Vilar;3316;1625;1691
08;Barcelona;054;Castellbisbal;4057;2075;1982
08;Barcelona;055;Castellcir;211;112;99
08;Barcelona;056;Castelldefels;27932;13982;13950
08;Barcelona;058;Castellet i la Gornal;1064;541;523
08;Barcelona;060;Castellfollit de Riubregós;275;134;141
08;Barcelona;059;Castellfollit del Boix;317;153;164
08;Barcelona;061;Castellgalí;705;355;350
08;Barcelona;062;Castellnou de Bages;107;55;52
08;Barcelona;063;Castellolí;440;212;228
08;Barcelona;064;Castellterçol;1982;953;1029
08;Barcelona;065;Castellví de la Marca;1362;687;675
08;Barcelona;066;Castellví de Rosanes;442;222;220
08;Barcelona;067;Centelles;5632;2756;2876
08;Barcelona;268;Cercs;1827;917;910
08;Barcelona;266;Cerdanyola del Vallès;53537;26792;26745
08;Barcelona;068;Cervelló;4072;2033;2039
08;Barcelona;069;Collbató;728;355;373
08;Barcelona;070;Collsuspina;220;115;105
08;Barcelona;071;Copons;309;153;156
08;Barcelona;072;Corbera de Llobregat;3593;1830;1763
08;Barcelona;073;Cornellà de Llobregat;86928;43140;43788
08;Barcelona;074;Cubelles;2458;1246;1212
08;Barcelona;075;Dosrius;848;446;402
08;Barcelona;076;Esparreguera;11335;5715;5620
08;Barcelona;077;Esplugues de Llobregat;47670;23705;23965
08;Barcelona;078;Espunyola (L');300;159;141
08;Barcelona;079;Estany (L');386;179;207
08;Barcelona;134;Figaró-Montmany;632;327;305
08;Barcelona;080;Fígols;38;21;17
08;Barcelona;082;Fogars de la Selva;293;150;143
08;Barcelona;081;Fogars de Montclús;278;145;133
08;Barcelona;083;Folgueroles;1066;527;539
08;Barcelona;084;Fonollosa;641;328;313
08;Barcelona;085;Font-rubí;1134;585;549
08;Barcelona;086;Franqueses del Vallès (Les);9403;4732;4671
08;Barcelona;090;Gaià;149;77;72
08;Barcelona;087;Gallifa;80;41;39
08;Barcelona;088;Garriga (La);8714;4210;4504
08;Barcelona;089;Gavà;32351;16140;16211
08;Barcelona;091;Gelida;3810;1898;1912
08;Barcelona;092;Gironella;5360;2583;2777
08;Barcelona;093;Gisclareny;27;14;13
08;Barcelona;094;Granada (La);1192;589;603
08;Barcelona;095;Granera;51;31;20
08;Barcelona;096;Granollers;47967;23596;24371
08;Barcelona;097;Gualba;587;298;289
08;Barcelona;099;Guardiola de Berguedà;1312;634;678
08;Barcelona;100;Gurb;1625;837;788
08;Barcelona;101;Hospitalet de Llobregat (L');279779;138405;141374
08;Barcelona;162;Hostalets de Pierola (Els);838;427;411
08;Barcelona;102;Igualada;30878;15016;15862
08;Barcelona;103;Jorba;498;248;250
08;Barcelona;104;Llacuna (La);740;382;358
08;Barcelona;105;Llagosta (La);12189;6059;6130
08;Barcelona;107;Lliçà d'Amunt;3775;1916;1859
08;Barcelona;108;Lliçà de Vall;2041;1052;989
08;Barcelona;106;Llinars del Vallès;5029;2544;2485
08;Barcelona;109;Lluçà;299;165;134
08;Barcelona;110;Malgrat de Mar;10799;5338;5461
08;Barcelona;111;Malla;257;121;136
08;Barcelona;112;Manlleu;16190;7975;8215
08;Barcelona;113;Manresa;65274;31511;33763
08;Barcelona;242;Marganell;217;81;136
08;Barcelona;114;Martorell;16170;8058;8112
08;Barcelona;115;Martorelles;4523;2257;2266
08;Barcelona;116;Masies de Roda (Les);612;299;313
08;Barcelona;117;Masies de Voltregà (Les);2455;1207;1248
08;Barcelona;118;Masnou (El);15169;7298;7871
08;Barcelona;119;Masquefa;2483;1234;1249
08;Barcelona;120;Matadepera;3495;1768;1727
08;Barcelona;121;Mataró;100021;49125;50896
08;Barcelona;122;Mediona;993;510;483
08;Barcelona;138;Moià;3164;1526;1638
08;Barcelona;123;Molins de Rei;18160;8974;9186
08;Barcelona;124;Mollet del Vallès;38407;19153;19254
08;Barcelona;128;Monistrol de Calders;617;310;307
08;Barcelona;127;Monistrol de Montserrat;2625;1289;1336
08;Barcelona;125;Montcada i Reixac;25499;12639;12860
08;Barcelona;130;Montclar;258;112;146
08;Barcelona;131;Montesquiu;932;449;483
08;Barcelona;126;Montgat;7276;3596;3680
08;Barcelona;132;Montmajor;690;348;342
08;Barcelona;133;Montmaneu;282;162;120
08;Barcelona;135;Montmeló;6965;3481;3484
08;Barcelona;136;Montornès del Vallès;10427;5204;5223
08;Barcelona;137;Montseny;276;143;133
08;Barcelona;129;Muntanyola;163;95;68
08;Barcelona;139;Mura;163;88;75
08;Barcelona;140;Navarcles;5010;2481;2529
08;Barcelona;141;Navàs;5244;2558;2686
08;Barcelona;142;Nou de Berguedà (La);139;77;62
08;Barcelona;143;Òdena;2581;1318;1263
08;Barcelona;145;Olèrdola;1578;821;757
08;Barcelona;146;Olesa de Bonesvalls;329;168;161
08;Barcelona;147;Olesa de Montserrat;14456;7186;7270
08;Barcelona;148;Olivella;200;99;101
08;Barcelona;149;Olost;948;469;479
08;Barcelona;144;Olvan;1100;530;570
08;Barcelona;150;Orís;229;119;110
08;Barcelona;151;Oristà;912;454;458
08;Barcelona;152;Orpí;151;77;74
08;Barcelona;153;Òrrius;319;175;144
08;Barcelona;154;Pacs del Penedès;397;209;188
08;Barcelona;155;Palafolls;2878;1424;1454
08;Barcelona;156;Palau-solità i Plegamans;4724;2422;2302
08;Barcelona;157;Pallejà;5919;2911;3008
08;Barcelona;905;Palma de Cervelló (La);"";"";""
08;Barcelona;158;Papiol (El);3080;1505;1575
08;Barcelona;159;Parets del Vallès;9869;4963;4906
08;Barcelona;160;Perafita;362;172;190
08;Barcelona;161;Piera;5215;2631;2584
08;Barcelona;163;Pineda de Mar;13951;6978;6973
08;Barcelona;164;Pla del Penedès (El);1002;511;491
08;Barcelona;165;Pobla de Claramunt (La);1685;848;837
08;Barcelona;166;Pobla de Lillet (La);1915;952;963
08;Barcelona;167;Polinyà;2738;1382;1356
08;Barcelona;182;Pont de Vilomara i Rocafort (El);2203;1084;1119
08;Barcelona;168;Pontons;217;119;98
08;Barcelona;169;Prat de Llobregat (El);63052;31783;31269
08;Barcelona;171;Prats de Lluçanès;2470;1229;1241
08;Barcelona;170;Prats de Rei (Els);584;289;295
08;Barcelona;230;Premià de Dalt;5273;2635;2638
08;Barcelona;172;Premià de Mar;20068;10072;9996
08;Barcelona;174;Puigdàlber;307;153;154
08;Barcelona;175;Puig-reig;5084;2507;2577
08;Barcelona;176;Pujalt;182;93;89
08;Barcelona;177;Quar (La);39;19;20
08;Barcelona;178;Rajadell;286;145;141
08;Barcelona;179;Rellinars;178;88;90
08;Barcelona;180;Ripollet;25833;12906;12927
08;Barcelona;181;Roca del Vallès (La);5144;2582;2562
08;Barcelona;183;Roda de Ter;4702;2266;2436
08;Barcelona;184;Rubí;46360;23315;23045
08;Barcelona;185;Rubió;136;70;66
08;Barcelona;901;Rupit i Pruit;370;185;185
08;Barcelona;187;Sabadell;186115;91082;95033
08;Barcelona;188;Sagàs;255;133;122
08;Barcelona;190;Saldes;339;191;148
08;Barcelona;191;Sallent;7856;3795;4061
08;Barcelona;194;Sant Adrià de Besòs;34735;17265;17470
08;Barcelona;195;Sant Agustí de Lluçanès;130;69;61
08;Barcelona;196;Sant Andreu de la Barca;14298;7182;7116
08;Barcelona;197;Sant Andreu de Llavaneres;3432;1691;1741
08;Barcelona;198;Sant Antoni de Vilamajor;1821;910;911
08;Barcelona;199;Sant Bartomeu del Grau;1081;565;516
08;Barcelona;200;Sant Boi de Llobregat;75789;38021;37768
08;Barcelona;201;Sant Boi de Lluçanès;522;261;261
08;Barcelona;203;Sant Cebrià de Vallalta;706;375;331
08;Barcelona;202;Sant Celoni;12275;6091;6184
08;Barcelona;204;Sant Climent de Llobregat;2111;1053;1058
08;Barcelona;205;Sant Cugat del Vallès;35302;17432;17870
08;Barcelona;206;Sant Cugat Sesgarrigues;744;376;368
08;Barcelona;207;Sant Esteve de Palautordera;1047;537;510
08;Barcelona;208;Sant Esteve Sesrovires;1708;877;831
08;Barcelona;210;Sant Feliu de Codines;3360;1631;1729
08;Barcelona;211;Sant Feliu de Llobregat;37394;18598;18796
08;Barcelona;212;Sant Feliu Sasserra;633;314;319
08;Barcelona;209;Sant Fost de Campsentelles;3820;1922;1898
08;Barcelona;213;Sant Fruitós de Bages;4631;2313;2318
08;Barcelona;215;Sant Hipòlit de Voltregà;3022;1448;1574
08;Barcelona;193;Sant Iscle de Vallalta;492;256;236
08;Barcelona;216;Sant Jaume de Frontanyà;23;14;9
08;Barcelona;218;Sant Joan de Vilatorrada;7620;3825;3795
08;Barcelona;217;Sant Joan Despí;23867;11943;11924
08;Barcelona;903;Sant Julià de Cerdanyola;"";"";""
08;Barcelona;220;Sant Julià de Vilatorta;1721;840;881
08;Barcelona;221;Sant Just Desvern;11379;5498;5881
08;Barcelona;222;Sant Llorenç d'Hortons;962;488;474
08;Barcelona;223;Sant Llorenç Savall;1873;873;1000
08;Barcelona;225;Sant Martí d'Albars;139;76;63
08;Barcelona;224;Sant Martí de Centelles;715;362;353
08;Barcelona;226;Sant Martí de Tous;1002;499;503
08;Barcelona;227;Sant Martí Sarroca;2326;1166;1160
08;Barcelona;228;Sant Martí Sesgueioles;399;196;203
08;Barcelona;229;Sant Mateu de Bages;581;296;285
08;Barcelona;231;Sant Pere de Ribes;11695;5873;5822
08;Barcelona;232;Sant Pere de Riudebitlles;2184;1067;1117
08;Barcelona;233;Sant Pere de Torelló;2089;978;1111
08;Barcelona;234;Sant Pere de Vilamajor;849;452;397
08;Barcelona;189;Sant Pere Sallavinera;194;99;95
08;Barcelona;235;Sant Pol de Mar;2401;1191;1210
08;Barcelona;236;Sant Quintí de Mediona;1569;783;786
08;Barcelona;237;Sant Quirze de Besora;2017;961;1056
08;Barcelona;238;Sant Quirze del Vallès;6470;3170;3300
08;Barcelona;239;Sant Quirze Safaja;252;119;133
08;Barcelona;240;Sant Sadurní d'Anoia;8805;4413;4392
08;Barcelona;241;Sant Sadurní d'Osormort;79;39;40
08;Barcelona;098;Sant Salvador de Guardiola;882;450;432
08;Barcelona;262;Sant Vicenç de Castellet;7625;3659;3966
08;Barcelona;264;Sant Vicenç de Montalt;1516;772;744
08;Barcelona;265;Sant Vicenç de Torelló;1783;850;933
08;Barcelona;263;Sant Vicenç dels Horts;20397;10187;10210
08;Barcelona;243;Santa Cecilia de Voltregà;188;107;81
08;Barcelona;244;Santa Coloma de Cervelló;2662;1327;1335
08;Barcelona;245;Santa Coloma de Gramenet;135258;67653;67605
08;Barcelona;246;Santa Eugènia de Berga;1313;678;635
08;Barcelona;247;Santa Eulàlia de Riuprimer;809;408;401
08;Barcelona;248;Santa Eulàlia de Ronçana;2494;1266;1228
08;Barcelona;249;Santa Fe del Penedès;192;88;104
08;Barcelona;250;Santa Margarida de Montbui;9088;4540;4548
08;Barcelona;251;Santa Margarida i els Monjos;3605;1861;1744
08;Barcelona;253;Santa Maria de Besora;200;98;102
08;Barcelona;254;Santa Maria de Corcó;1961;952;1009
08;Barcelona;256;Santa Maria de Martorelles;387;191;196
08;Barcelona;255;Santa Maria de Merlès;264;134;130
08;Barcelona;257;Santa Maria de Miralles;98;50;48
08;Barcelona;259;Santa Maria de Palautordera;4468;2267;2201
08;Barcelona;258;Santa Maria d'Oló;1050;530;520
08;Barcelona;260;Santa Perpètua de Mogoda;15051;7625;7426
08;Barcelona;261;Santa Susanna;652;320;332
08;Barcelona;192;Santpedor;3909;1892;2017
08;Barcelona;267;Sentmenat;3964;1970;1994
08;Barcelona;269;Seva;1610;805;805
08;Barcelona;270;Sitges;11889;5779;6110
08;Barcelona;271;Sobremunt;77;39;38
08;Barcelona;272;Sora;228;127;101
08;Barcelona;273;Subirats;2164;1103;1061
08;Barcelona;274;Súria;6684;3316;3368
08;Barcelona;276;Tagamanent;135;68;67
08;Barcelona;277;Talamanca;58;31;27
08;Barcelona;278;Taradell;4259;2129;2130
08;Barcelona;275;Tavèrnoles;214;108;106
08;Barcelona;280;Tavertet;114;62;52
08;Barcelona;281;Teià;2873;1438;1435
08;Barcelona;279;Terrassa;160105;78433;81672
08;Barcelona;282;Tiana;3911;1961;1950
08;Barcelona;283;Tona;5289;2628;2661
08;Barcelona;284;Tordera;7747;3882;3865
08;Barcelona;285;Torelló;11132;5444;5688
08;Barcelona;286;Torre de Claramunt (La);1424;732;692
08;Barcelona;287;Torrelavit;1188;599;589
08;Barcelona;288;Torrelles de Foix;1137;604;533
08;Barcelona;289;Torrelles de Llobregat;1827;935;892
08;Barcelona;290;Ullastrell;865;431;434
08;Barcelona;291;Vacarisses;594;294;300
08;Barcelona;292;Vallbona d'Anoia;1054;531;523
08;Barcelona;293;Vallcebre;357;194;163
08;Barcelona;294;Vallgorguina;647;322;325
08;Barcelona;295;Vallirana;5025;2526;2499
08;Barcelona;296;Vallromanes;439;220;219
08;Barcelona;297;Veciana;192;102;90
08;Barcelona;298;Vic;28583;13604;14979
08;Barcelona;299;Vilada;603;305;298
08;Barcelona;301;Viladecans;45071;22775;22296
08;Barcelona;300;Viladecavalls;2392;1189;1203
08;Barcelona;305;Vilafranca del Penedès;26433;12798;13635
08;Barcelona;306;Vilalba Sasserra;292;156;136
08;Barcelona;303;Vilanova de Sau;312;147;165
08;Barcelona;302;Vilanova del Camí;8609;4278;4331
08;Barcelona;902;Vilanova del Vallès;1211;591;620
08;Barcelona;307;Vilanova i la Geltrú;44977;22224;22753
08;Barcelona;214;Vilassar de Dalt;6246;3050;3196
08;Barcelona;219;Vilassar de Mar;10144;4991;5153
08;Barcelona;304;Vilobí del Penedès;765;382;383
08;Barcelona;308;Viver i Serrateix;238;130;108
09;Burgos;001;Abajas;55;28;27
09;Burgos;003;Adrada de Haza;343;184;159
09;Burgos;006;Aguas Cándidas;137;77;60
09;Burgos;007;Aguilar de Bureba;136;77;59
09;Burgos;009;Albillos;172;99;73
09;Burgos;010;Alcocero de Mola;69;42;27
09;Burgos;011;Alfoz de Bricia;176;84;92
09;Burgos;907;Alfoz de Quintanadueñas;471;240;231
09;Burgos;012;Alfoz de Santa Gadea;174;91;83
09;Burgos;013;Altable;80;46;34
09;Burgos;014;Altos (Los);336;192;144
09;Burgos;016;Ameyugo;73;47;26
09;Burgos;017;Anguix;217;112;105
09;Burgos;018;Aranda de Duero;28552;14387;14165
09;Burgos;019;Arandilla;235;143;92
09;Burgos;020;Arauzo de Miel;487;268;219
09;Burgos;021;Arauzo de Salce;103;60;43
09;Burgos;022;Arauzo de Torre;141;79;62
09;Burgos;023;Arcos;278;152;126
09;Burgos;024;Arenillas de Riopisuerga;248;138;110
09;Burgos;025;Arija;337;155;182
09;Burgos;026;Arlanzón;454;233;221
09;Burgos;027;Arraya de Oca;50;26;24
09;Burgos;029;Atapuerca;186;88;98
09;Burgos;030;Ausines (Los);153;83;70
09;Burgos;032;Avellanosa de Muñó;244;131;113
09;Burgos;033;Bahabón de Esgueva;207;119;88
09;Burgos;034;Balbases (Los);433;231;202
09;Burgos;035;Baños de Valdearados;626;353;273
09;Burgos;036;Bañuelos de Bureba;64;41;23
09;Burgos;037;Barbadillo de Herreros;160;78;82
09;Burgos;038;Barbadillo del Mercado;240;121;119
09;Burgos;039;Barbadillo del Pez;132;73;59
09;Burgos;041;Barrio de Muñó;46;25;21
09;Burgos;043;Barrios de Bureba (Los);381;189;192
09;Burgos;044;Barrios de Colina;83;47;36
09;Burgos;045;Basconcillos del Tozo;517;270;247
09;Burgos;046;Bascuñana;102;56;46
09;Burgos;047;Belbimbre;91;46;45
09;Burgos;048;Belorado;2128;1079;1049
09;Burgos;050;Berberana;111;58;53
09;Burgos;051;Berlangas de Roa;389;190;199
09;Burgos;052;Berzosa de Bureba;62;35;27
09;Burgos;054;Bozoó;98;51;47
09;Burgos;055;Brazacorta;114;59;55
09;Burgos;056;Briviesca;5145;2578;2567
09;Burgos;057;Bugedo;119;86;33
09;Burgos;058;Buniel;173;90;83
09;Burgos;059;Burgos;158331;77203;81128
09;Burgos;060;Busto de Bureba;402;211;191
09;Burgos;061;Cabañes de Esgueva;348;170;178
09;Burgos;062;Cabezón de la Sierra;56;24;32
09;Burgos;063;Cabia;238;137;101
09;Burgos;064;Caleruega;492;271;221
09;Burgos;065;Campillo de Aranda;229;119;110
09;Burgos;066;Campolara;113;61;52
09;Burgos;067;Canicosa de la Sierra;793;409;384
09;Burgos;068;Cantabrana;81;44;37
09;Burgos;070;Carazo;51;26;25
09;Burgos;071;Carcedo de Bureba;51;28;23
09;Burgos;072;Carcedo de Burgos;114;66;48
09;Burgos;073;Cardeñadijo;357;195;162
09;Burgos;074;Cardeñajimeno;301;163;138
09;Burgos;075;Cardeñuela Riopico;60;33;27
09;Burgos;076;Carrias;71;44;27
09;Burgos;077;Cascajares de Bureba;81;47;34
09;Burgos;078;Cascajares de la Sierra;36;19;17
09;Burgos;079;Castellanos de Castro;84;49;35
09;Burgos;083;Castil de Peones;62;32;30
09;Burgos;082;Castildelgado;102;53;49
09;Burgos;084;Castrillo de la Reina;397;233;164
09;Burgos;085;Castrillo de la Vega;710;364;346
09;Burgos;088;Castrillo de Riopisuerga;127;71;56
09;Burgos;086;Castrillo del Val;139;85;54
09;Burgos;090;Castrillo Matajudíos;88;48;40
09;Burgos;091;Castrojeriz;1169;579;590
09;Burgos;093;Cayuela;131;77;54
09;Burgos;094;Cebrecos;89;47;42
09;Burgos;095;Celada del Camino;104;48;56
09;Burgos;098;Cerezo de Río Tirón;984;518;466
09;Burgos;100;Cerratón de Juarros;75;41;34
09;Burgos;101;Ciadoncha;155;82;73
09;Burgos;102;Cillaperlata;112;59;53
09;Burgos;103;Cilleruelo de Abajo;417;228;189
09;Burgos;104;Cilleruelo de Arriba;110;61;49
09;Burgos;105;Ciruelos de Cervera;213;111;102
09;Burgos;108;Cogollos;220;121;99
09;Burgos;109;Condado de Treviño;1109;607;502
09;Burgos;110;Contreras;109;65;44
09;Burgos;112;Coruña del Conde;207;116;91
09;Burgos;113;Covarrubias;743;385;358
09;Burgos;114;Cubillo del Campo;82;46;36
09;Burgos;115;Cubo de Bureba;179;89;90
09;Burgos;117;Cueva de Roa (La);160;93;67
09;Burgos;119;Cuevas de San Clemente;100;45;55
09;Burgos;120;Encío;58;33;25
09;Burgos;122;Espinosa de Cervera;125;76;49
09;Burgos;124;Espinosa de los Monteros;2495;1289;1206
09;Burgos;123;Espinosa del Camino;62;32;30
09;Burgos;125;Estépar;1039;549;490
09;Burgos;127;Fontioso;122;66;56
09;Burgos;128;Frandovínez;99;52;47
09;Burgos;129;Fresneda de la Sierra Tirón;135;66;69
09;Burgos;130;Fresneña;170;93;77
09;Burgos;131;Fresnillo de las Dueñas;355;185;170
09;Burgos;132;Fresno de Río Tirón;330;190;140
09;Burgos;133;Fresno de Rodilla;29;16;13
09;Burgos;134;Frías;327;169;158
09;Burgos;135;Fuentebureba;146;68;78
09;Burgos;136;Fuentecén;382;214;168
09;Burgos;137;Fuentelcésped;296;141;155
09;Burgos;138;Fuentelisendo;164;88;76
09;Burgos;139;Fuentemolinos;167;89;78
09;Burgos;140;Fuentenebro;251;140;111
09;Burgos;141;Fuentespina;597;322;275
09;Burgos;143;Galbarros;28;19;9
09;Burgos;144;Gallega (La);115;61;54
09;Burgos;148;Grijalba;184;89;95
09;Burgos;149;Grisaleña;85;51;34
09;Burgos;151;Gumiel de Izán;764;413;351
09;Burgos;152;Gumiel de Mercado;568;300;268
09;Burgos;154;Hacinas;245;132;113
09;Burgos;155;Haza;48;26;22
09;Burgos;159;Hontanas;101;58;43
09;Burgos;160;Hontangas;197;107;90
09;Burgos;162;Hontoria de la Cantera;168;79;89
09;Burgos;164;Hontoria de Valdearados;318;184;134
09;Burgos;163;Hontoria del Pinar;1116;605;511
09;Burgos;166;Hormazas (Las);195;99;96
09;Burgos;167;Hornillos del Camino;109;55;54
09;Burgos;168;Horra (La);579;300;279
09;Burgos;169;Hortigüela;124;74;50
09;Burgos;170;Hoyales de Roa;411;198;213
09;Burgos;172;Huérmeces;176;97;79
09;Burgos;173;Huerta de Arriba;246;124;122
09;Burgos;174;Huerta de Rey;1317;695;622
09;Burgos;175;Humada;355;206;149
09;Burgos;176;Hurones;72;43;29
09;Burgos;177;Ibeas de Juarros;865;453;412
09;Burgos;178;Ibrillos;138;75;63
09;Burgos;179;Iglesiarrubia;79;43;36
09;Burgos;180;Iglesias;239;122;117
09;Burgos;181;Isar;506;242;264
09;Burgos;182;Itero del Castillo;153;74;79
09;Burgos;183;Jaramillo de la Fuente;42;20;22
09;Burgos;184;Jaramillo Quemado;24;13;11
09;Burgos;189;Junta de Traslaloma;261;143;118
09;Burgos;190;Junta de Villalba de Losa;107;60;47
09;Burgos;191;Jurisdicción de Lara;70;37;33
09;Burgos;192;Jurisdicción de San Zadornil;91;50;41
09;Burgos;194;Lerma;2638;1314;1324
09;Burgos;195;Llano de Bureba;82;45;37
09;Burgos;196;Madrigal del Monte;214;105;109
09;Burgos;197;Madrigalejo del Monte;175;98;77
09;Burgos;198;Mahamud;207;102;105
09;Burgos;199;Mambrilla de Castrejón;185;96;89
09;Burgos;200;Mambrillas de Lara;91;47;44
09;Burgos;201;Mamolar;112;62;50
09;Burgos;202;Manciles;53;28;25
09;Burgos;206;Mazuela;100;50;50
09;Burgos;208;Mecerreyes;382;183;199
09;Burgos;209;Medina de Pomar;5173;2566;2607
09;Burgos;211;Melgar de Fernamental;2380;1190;1190
09;Burgos;213;Merindad de Cuesta-Urria;666;364;302
09;Burgos;214;Merindad de Montija;1089;581;508
09;Burgos;431;Villafranca Montes de Oca;247;131;116
09;Burgos;432;Villafruela;384;199;185
09;Burgos;433;Villagalijo;84;46;38
09;Burgos;434;Villagonzalo Pedernales;495;252;243
09;Burgos;437;Villahoz;494;239;255
09;Burgos;438;Villalba de Duero;568;305;263
09;Burgos;439;Villalbilla de Burgos;488;273;215
09;Burgos;440;Villalbilla de Gumiel;175;94;81
09;Burgos;441;Villaldemiro;99;46;53
09;Burgos;442;Villalmanzo;484;265;219
09;Burgos;443;Villamayor de los Montes;335;170;165
09;Burgos;444;Villamayor de Treviño;136;77;59
09;Burgos;445;Villambistia;111;60;51
09;Burgos;446;Villamedianilla;38;19;19
09;Burgos;447;Villamiel de la Sierra;43;26;17
09;Burgos;448;Villangómez;436;225;211
09;Burgos;449;Villanueva de Argaño;120;69;51
09;Burgos;450;Villanueva de Carazo;29;19;10
09;Burgos;451;Villanueva de Gumiel;347;187;160
09;Burgos;454;Villanueva de Teba;99;53;46
09;Burgos;455;Villaquirán de la Puebla;77;43;34
09;Burgos;456;Villaquirán de los Infantes;227;116;111
09;Burgos;903;Villarcayo de Merindad de Castilla la Vieja;4480;2219;2261
09;Burgos;458;Villariezo;141;74;67
09;Burgos;460;Villasandino;367;190;177
09;Burgos;463;Villasur de Herreros;320;164;156
09;Burgos;464;Villatuelda;97;54;43
09;Burgos;466;Villaverde del Monte;261;143;118
09;Burgos;467;Villaverde-Mogina;159;89;70
09;Burgos;471;Villayerno Morquillas;134;63;71
09;Burgos;472;Villazopeque;104;55;49
09;Burgos;473;Villegas;155;80;75
09;Burgos;476;Villoruebo;31;20;11
09;Burgos;424;Viloria de Rioja;90;48;42
09;Burgos;425;Vilviestre del Pinar;922;461;461
09;Burgos;478;Vizcaínos;69;36;33
09;Burgos;480;Zael;177;84;93
09;Burgos;482;Zarzosa de Río Pisuerga;81;41;40
09;Burgos;483;Zazuar;365;193;172
09;Burgos;485;Zuñeda;128;70;58
09;Burgos;906;Merindad de Río Ubierna;1062;565;497
09;Burgos;215;Merindad de Sotoscueva;776;402;374
09;Burgos;216;Merindad de Valdeporres;600;321;279
09;Burgos;217;Merindad de Valdivielso;714;360;354
09;Burgos;218;Milagros;464;231;233
09;Burgos;219;Miranda de Ebro;35927;17971;17956
09;Burgos;220;Miraveche;162;85;77
09;Burgos;221;Modúbar de la Emparedada;206;114;92
09;Burgos;223;Monasterio de la Sierra;34;17;17
09;Burgos;224;Monasterio de Rodilla;230;116;114
09;Burgos;225;Moncalvillo;172;96;76
09;Burgos;226;Monterrubio de la Demanda;114;65;49
09;Burgos;227;Montorio;194;95;99
09;Burgos;228;Moradillo de Roa;245;129;116
09;Burgos;229;Nava de Roa;372;186;186
09;Burgos;230;Navas de Bureba;59;30;29
09;Burgos;231;Nebreda;160;99;61
09;Burgos;232;Neila;266;136;130
09;Burgos;235;Olmedillo de Roa;347;174;173
09;Burgos;236;Olmillos de Muñó;61;31;30
09;Burgos;238;Oña;1825;935;890
09;Burgos;239;Oquillas;72;40;32
09;Burgos;241;Orbaneja Riopico;118;65;53
09;Burgos;242;Padilla de Abajo;150;85;65
09;Burgos;243;Padilla de Arriba;165;86;79
09;Burgos;244;Padrones de Bureba;114;59;55
09;Burgos;246;Palacios de la Sierra;1004;513;491
09;Burgos;247;Palacios de Riopisuerga;60;29;31
09;Burgos;248;Palazuelos de la Sierra;76;42;34
09;Burgos;249;Palazuelos de Muñó;86;48;38
09;Burgos;250;Pampliega;476;248;228
09;Burgos;251;Pancorbo;619;307;312
09;Burgos;253;Pardilla;127;62;65
09;Burgos;255;Partido de la Sierra en Tobalina;87;52;35
09;Burgos;256;Pedrosa de Duero;719;380;339
09;Burgos;259;Pedrosa de Río Úrbel;332;177;155
09;Burgos;257;Pedrosa del Páramo;124;68;56
09;Burgos;258;Pedrosa del Príncipe;344;183;161
09;Burgos;261;Peñaranda de Duero;747;390;357
09;Burgos;262;Peral de Arlanza;291;156;135
09;Burgos;265;Piérnigas;52;33;19
09;Burgos;266;Pineda de la Sierra;122;69;53
09;Burgos;267;Pineda Trasmonte;251;128;123
09;Burgos;268;Pinilla de los Barruecos;222;113;109
09;Burgos;269;Pinilla de los Moros;60;37;23
09;Burgos;270;Pinilla Trasmonte;328;166;162
09;Burgos;272;Poza de la Sal;562;265;297
09;Burgos;273;Prádanos de Bureba;98;59;39
09;Burgos;274;Pradoluengo;1780;867;913
09;Burgos;275;Presencio;320;171;149
09;Burgos;276;Puebla de Arganzón (La);329;172;157
09;Burgos;277;Puentedura;170;90;80
09;Burgos;279;Quemada;302;166;136
09;Burgos;281;Quintana del Pidio;242;130;112
09;Burgos;280;Quintanabureba;71;44;27
09;Burgos;283;Quintanaélez;153;83;70
09;Burgos;287;Quintanaortuño;130;65;65
09;Burgos;288;Quintanapalla;169;92;77
09;Burgos;289;Quintanar de la Sierra;2987;1533;1454
09;Burgos;292;Quintanavides;96;44;52
09;Burgos;294;Quintanilla de la Mata;194;110;84
09;Burgos;901;Quintanilla del Agua y Tordueles;734;373;361
09;Burgos;295;Quintanilla del Coco;146;81;65
09;Burgos;298;Quintanilla San García;177;95;82
09;Burgos;301;Quintanilla Vivar;284;133;151
09;Burgos;297;Quintanillas (Las);361;188;173
09;Burgos;302;Rabanera del Pinar;245;108;137
09;Burgos;303;Rábanos;65;37;28
09;Burgos;304;Rabé de las Calzadas;163;93;70
09;Burgos;306;Rebolledo de la Torre;224;112;112
09;Burgos;307;Redecilla del Camino;156;89;67
09;Burgos;308;Redecilla del Campo;123;66;57
09;Burgos;309;Regumiel de la Sierra;574;296;278
09;Burgos;310;Reinoso;35;22;13
09;Burgos;311;Retuerta;81;43;38
09;Burgos;314;Revilla del Campo;160;82;78
09;Burgos;316;Revilla Vallejera;190;108;82
09;Burgos;312;Revilla y Ahedo (La);140;72;68
09;Burgos;315;Revillarruz;183;94;89
09;Burgos;317;Rezmondo;29;15;14
09;Burgos;318;Riocavado de la Sierra;75;42;33
09;Burgos;321;Roa;2561;1315;1246
09;Burgos;323;Rojas;103;55;48
09;Burgos;325;Royuela de Río Franco;459;254;205
09;Burgos;326;Rubena;177;90;87
09;Burgos;327;Rublacedo de Abajo;45;22;23
09;Burgos;328;Rucandio;128;65;63
09;Burgos;329;Salas de Bureba;226;124;102
09;Burgos;330;Salas de los Infantes;2193;1133;1060
09;Burgos;332;Saldaña de Burgos;80;40;40
09;Burgos;334;Salinillas de Bureba;78;49;29
09;Burgos;335;San Adrián de Juarros;43;20;23
09;Burgos;337;San Juan del Monte;254;129;125
09;Burgos;338;San Mamés de Burgos;140;78;62
09;Burgos;339;San Martín de Rubiales;428;227;201
09;Burgos;340;San Millán de Lara;123;68;55
09;Burgos;360;San Vicente del Valle;38;20;18
09;Burgos;343;Santa Cecilia;141;74;67
09;Burgos;345;Santa Cruz de la Salceda;233;114;119
09;Burgos;346;Santa Cruz del Valle Urbión;166;101;65
09;Burgos;347;Santa Gadea del Cid;214;111;103
09;Burgos;348;Santa Inés;267;144;123
09;Burgos;350;Santa María del Campo;807;427;380
09;Burgos;351;Santa María del Invierno;76;44;32
09;Burgos;352;Santa María del Mercadillo;255;145;110
09;Burgos;353;Santa María Rivarredonda;181;95;86
09;Burgos;354;Santa Olalla de Bureba;50;21;29
09;Burgos;355;Santibáñez de Esgueva;221;111;110
09;Burgos;356;Santibáñez del Val;90;50;40
09;Burgos;358;Santo Domingo de Silos;367;238;129
09;Burgos;361;Sargentes de la Lora;228;118;110
09;Burgos;362;Sarracín;157;78;79
09;Burgos;363;Sasamón;1790;945;845
09;Burgos;365;Sequera de Haza (La);85;50;35
09;Burgos;366;Solarana;153;78;75
09;Burgos;368;Sordillos;48;27;21
09;Burgos;369;Sotillo de la Ribera;597;333;264
09;Burgos;372;Sotragero;136;80;56
09;Burgos;373;Sotresgudo;951;517;434
09;Burgos;374;Susinos del Páramo;84;40;44
09;Burgos;375;Tamarón;60;31;29
09;Burgos;377;Tardajos;695;364;331
09;Burgos;378;Tejada;62;32;30
09;Burgos;380;Terradillos de Esgueva;143;74;69
09;Burgos;381;Tinieblas de la Sierra;31;17;14
09;Burgos;382;Tobar;63;34;29
09;Burgos;384;Tordómar;464;256;208
09;Burgos;386;Torrecilla del Monte;94;48;46
09;Burgos;387;Torregalindo;207;114;93
09;Burgos;388;Torrelara;17;9;8
09;Burgos;389;Torrepadre;236;126;110
09;Burgos;390;Torresandino;948;504;444
09;Burgos;391;Tórtoles de Esgueva;705;375;330
09;Burgos;392;Tosantos;95;48;47
09;Burgos;394;Trespaderne;1238;664;574
09;Burgos;395;Tubilla del Agua;172;95;77
09;Burgos;396;Tubilla del Lago;255;125;130
09;Burgos;398;Úrbel del Castillo;146;76;70
09;Burgos;400;Vadocondes;573;292;281
09;Burgos;403;Valdeande;233;119;114
09;Burgos;405;Valdezate;267;143;124
09;Burgos;406;Valdorros;112;60;52
09;Burgos;408;Vallarta de Bureba;113;63;50
09;Burgos;904;Valle de las Navas;679;381;298
09;Burgos;908;Valle de Losa;822;447;375
09;Burgos;409;Valle de Manzanedo;150;78;72
09;Burgos;410;Valle de Mena;5002;2539;2463
09;Burgos;411;Valle de Oca;230;117;113
09;Burgos;902;Valle de Santibáñez;754;401;353
09;Burgos;905;Valle de Sedano;469;242;227
09;Burgos;412;Valle de Tobalina;1147;620;527
09;Burgos;413;Valle de Valdebezana;1034;533;501
09;Burgos;414;Valle de Valdelaguna;318;161;157
09;Burgos;415;Valle de Valdelucio;481;255;226
09;Burgos;416;Valle de Zamanzas;50;26;24
09;Burgos;417;Vallejera;71;38;33
09;Burgos;418;Valles de Palenzuela;123;67;56
09;Burgos;419;Valluércanes;174;102;72
09;Burgos;407;Valmala;45;22;23
09;Burgos;422;Vid de Bureba (La);57;30;27
09;Burgos;421;Vid y Barrios (La);436;248;188
09;Burgos;423;Vileña;48;27;21
09;Burgos;427;Villadiego;2724;1424;1300
09;Burgos;428;Villaescusa de Roa;219;119;100
09;Burgos;429;Villaescusa la Sombría;79;43;36
09;Burgos;430;Villaespasa;45;27;18
10;Cáceres;001;Abadía;343;192;151
10;Cáceres;002;Abertura;563;285;278
10;Cáceres;003;Acebo;935;475;460
10;Cáceres;004;Acehúche;1072;527;545
10;Cáceres;005;Aceituna;819;427;392
10;Cáceres;006;Ahigal;2070;1067;1003
10;Cáceres;007;Albalá del Caudillo;1136;558;578
10;Cáceres;008;Alcántara;2271;1128;1143
10;Cáceres;009;Alcollarín;407;202;205
10;Cáceres;010;Alcuéscar;3437;1856;1581
10;Cáceres;012;Aldea del Cano;862;416;446
10;Cáceres;013;Aldea del Obispo (La);533;263;270
10;Cáceres;011;Aldeacentenera;1129;549;580
10;Cáceres;014;Aldeanueva de la Vera;2861;1434;1427
10;Cáceres;015;Aldeanueva del Camino;1091;522;569
10;Cáceres;016;Aldehuela de Jerte;456;251;205
10;Cáceres;017;Alía;2057;1007;1050
10;Cáceres;018;Aliseda;2629;1309;1320
10;Cáceres;019;Almaraz;1325;687;638
10;Cáceres;020;Almoharín;2244;1122;1122
10;Cáceres;021;Arroyo de la Luz;6675;3305;3370
10;Cáceres;023;Arroyomolinos;1252;638;614
10;Cáceres;022;Arroyomolinos de la Vera;768;389;379
10;Cáceres;024;Baños de Montemayor;841;391;450
10;Cáceres;025;Barrado;647;314;333
10;Cáceres;026;Belvís de Monroy;535;266;269
10;Cáceres;027;Benquerencia;128;69;59
10;Cáceres;028;Berrocalejo;147;66;81
10;Cáceres;029;Berzocana;814;423;391
10;Cáceres;030;Bohonal de Ibor;808;446;362
10;Cáceres;031;Botija;239;115;124
10;Cáceres;032;Brozas;2660;1307;1353
10;Cáceres;033;Cabañas del Castillo;776;405;371
10;Cáceres;034;Cabezabellosa;681;346;335
10;Cáceres;035;Cabezuela del Valle;2603;1323;1280
10;Cáceres;036;Cabrero;571;317;254
10;Cáceres;037;Cáceres;69193;33023;36170
10;Cáceres;038;Cachorrilla;144;63;81
10;Cáceres;039;Cadalso;732;371;361
10;Cáceres;040;Calzadilla;710;330;380
10;Cáceres;041;Caminomorisco;1526;799;727
10;Cáceres;042;Campillo de Deleitosa;190;96;94
10;Cáceres;043;Campo Lugar;1423;715;708
10;Cáceres;044;Cañamero;2258;1158;1100
10;Cáceres;045;Cañaveral;1892;890;1002
10;Cáceres;046;Carbajo;297;154;143
10;Cáceres;047;Carcaboso;1382;732;650
10;Cáceres;048;Carrascalejo;546;271;275
10;Cáceres;049;Casar de Cáceres;4038;2056;1982
10;Cáceres;050;Casar de Palomero;1742;869;873
10;Cáceres;051;Casares de las Hurdes;1109;586;523
10;Cáceres;052;Casas de Don Antonio;268;121;147
10;Cáceres;053;Casas de Don Gómez;509;254;255
10;Cáceres;056;Casas de Millán;919;467;452
10;Cáceres;057;Casas de Miravete;202;106;96
10;Cáceres;054;Casas del Castañar;787;385;402
10;Cáceres;055;Casas del Monte;1030;535;495
10;Cáceres;058;Casatejada;1457;707;750
10;Cáceres;059;Casillas de Coria;796;385;411
10;Cáceres;060;Castañar de Ibor;1624;819;805
10;Cáceres;061;Ceclavín;2593;1318;1275
10;Cáceres;062;Cedillo;662;329;333
10;Cáceres;063;Cerezo;287;134;153
10;Cáceres;064;Cilleros;2541;1263;1278
10;Cáceres;065;Collado;543;292;251
10;Cáceres;066;Conquista de la Sierra;212;106;106
10;Cáceres;067;Coria;11091;5544;5547
10;Cáceres;068;Cuacos de Yuste;1056;542;514
10;Cáceres;069;Cumbre (La);1393;697;696
10;Cáceres;070;Deleitosa;1186;581;605
10;Cáceres;071;Descargamaría;333;177;156
10;Cáceres;072;Eljas;1633;830;803
10;Cáceres;073;Escurial;1018;503;515
10;Cáceres;075;Fresnedoso de Ibor;556;292;264
10;Cáceres;076;Galisteo;2335;1201;1134
10;Cáceres;077;Garciaz;1235;623;612
10;Cáceres;078;Garganta (La);736;380;356
10;Cáceres;079;Garganta la Olla;1341;689;652
10;Cáceres;080;Gargantilla;614;316;298
10;Cáceres;081;Gargüera;295;150;145
10;Cáceres;082;Garrovillas de Alconétar;2741;1307;1434
10;Cáceres;083;Garvín;165;92;73
10;Cáceres;084;Gata;2298;1139;1159
10;Cáceres;085;Gordo (El);349;171;178
10;Cáceres;086;Granja (La);511;268;243
10;Cáceres;087;Guadalupe;2817;1390;1427
10;Cáceres;088;Guijo de Coria;412;210;202
10;Cáceres;089;Guijo de Galisteo;1931;1003;928
10;Cáceres;090;Guijo de Granadilla;890;438;452
10;Cáceres;091;Guijo de Santa Bárbara;691;350;341
10;Cáceres;092;Herguijuela;574;278;296
10;Cáceres;093;Hernán-Pérez;535;280;255
10;Cáceres;094;Herrera de Alcántara;488;246;242
10;Cáceres;095;Herreruela;605;303;302
10;Cáceres;096;Hervás;3764;1851;1913
10;Cáceres;097;Higuera;147;71;76
10;Cáceres;098;Hinojal;499;245;254
10;Cáceres;099;Holguera;963;478;485
10;Cáceres;100;Hoyos;1067;526;541
10;Cáceres;101;Huélaga;219;109;110
10;Cáceres;102;Ibahernando;935;469;466
10;Cáceres;103;Jaraicejo;873;435;438
10;Cáceres;104;Jaraíz de la Vera;7562;3753;3809
10;Cáceres;105;Jarandilla de la Vera;3256;1646;1610
10;Cáceres;106;Jarilla;234;110;124
10;Cáceres;107;Jerte;1457;757;700
10;Cáceres;108;Ladrillar;694;358;336
10;Cáceres;109;Logrosán;3334;1630;1704
10;Cáceres;110;Losar de la Vera;3183;1591;1592
10;Cáceres;111;Madrigal de la Vera;1841;960;881
10;Cáceres;112;Madrigalejo;2854;1418;1436
10;Cáceres;113;Madroñera;3463;1715;1748
10;Cáceres;114;Majadas;1163;586;577
10;Cáceres;115;Malpartida de Cáceres;3577;1756;1821
10;Cáceres;116;Malpartida de Plasencia;4409;2191;2218
10;Cáceres;117;Marchagaz;470;230;240
10;Cáceres;118;Mata de Alcántara;465;228;237
10;Cáceres;119;Membrío;1035;494;541
10;Cáceres;120;Mesas de Ibor;245;134;111
10;Cáceres;121;Miajadas;9274;4622;4652
10;Cáceres;122;Millanes;255;135;120
10;Cáceres;123;Mirabel;1012;522;490
10;Cáceres;124;Mohedas de Granadilla;1358;710;648
10;Cáceres;125;Monroy;1363;683;680
10;Cáceres;126;Montánchez;2738;1357;1381
10;Cáceres;127;Montehermoso;5326;2681;2645
10;Cáceres;128;Moraleja;8241;4183;4058
10;Cáceres;129;Morcillo;541;248;293
10;Cáceres;130;Navaconcejo;2264;1156;1108
10;Cáceres;131;Navalmoral de la Mata;13585;6717;6868
10;Cáceres;132;Navalvillar de Ibor;660;342;318
10;Cáceres;133;Navas del Madroño;1763;893;870
10;Cáceres;134;Navezuelas;884;480;404
10;Cáceres;135;Nuñomoral;2334;1259;1075
10;Cáceres;136;Oliva de Plasencia;442;219;223
10;Cáceres;137;Palomero;643;332;311
10;Cáceres;138;Pasarón de la Vera;813;405;408
10;Cáceres;139;Pedroso de Acim;211;114;97
10;Cáceres;140;Peraleda de la Mata;1593;791;802
10;Cáceres;141;Peraleda de San Román;525;270;255
10;Cáceres;142;Perales del Puerto;1042;510;532
10;Cáceres;143;Pescueza;297;147;150
10;Cáceres;144;Pesga (La);1543;789;754
10;Cáceres;145;Piedras Albas;292;133;159
10;Cáceres;146;Pinofranqueado;2034;1053;981
10;Cáceres;147;Piornal;1701;864;837
10;Cáceres;148;Plasencia;32430;15858;16572
10;Cáceres;149;Plasenzuela;542;264;278
10;Cáceres;150;Portaje;522;260;262
10;Cáceres;151;Portezuelo;372;183;189
10;Cáceres;152;Pozuelo de Zarzón;744;359;385
10;Cáceres;153;Puerto de Santa Cruz;483;239;244
10;Cáceres;154;Rebollar;289;154;135
10;Cáceres;155;Riolobos;1870;985;885
10;Cáceres;156;Robledillo de Gata;244;125;119
10;Cáceres;157;Robledillo de la Vera;515;268;247
10;Cáceres;158;Robledillo de Trujillo;634;315;319
10;Cáceres;159;Robledollano;562;298;264
10;Cáceres;160;Romangordo;218;107;111
10;Cáceres;901;Rosalejo;"";"";""
10;Cáceres;161;Ruanes;114;60;54
10;Cáceres;162;Salorino;1077;512;565
10;Cáceres;163;Salvatierra de Santiago;563;292;271
10;Cáceres;164;San Martín de Trevejo;981;495;486
10;Cáceres;165;Santa Ana;464;233;231
10;Cáceres;166;Santa Cruz de la Sierra;424;217;207
10;Cáceres;167;Santa Cruz de Paniagua;595;311;284
10;Cáceres;168;Santa Marta de Magasca;453;231;222
10;Cáceres;169;Santiago de Alcántara;1106;563;543
10;Cáceres;170;Santiago del Campo;391;211;180
10;Cáceres;171;Santibáñez el Alto;735;381;354
10;Cáceres;172;Santibáñez el Bajo;1183;626;557
10;Cáceres;173;Saucedilla;485;258;227
10;Cáceres;174;Segura de Toro;234;123;111
10;Cáceres;175;Serradilla;2454;1216;1238
10;Cáceres;176;Serrejón;551;283;268
10;Cáceres;177;Sierra de Fuentes;1558;759;799
10;Cáceres;178;Talaván;1049;506;543
10;Cáceres;179;Talaveruela de la Vera;585;274;311
10;Cáceres;180;Talayuela;7452;3821;3631
10;Cáceres;181;Tejeda de Tiétar;1213;643;570
10;Cáceres;182;Toril;404;201;203
10;Cáceres;183;Tornavacas;1566;807;759
10;Cáceres;184;Torno (El);1242;642;600
10;Cáceres;187;Torre de Don Miguel;842;420;422
10;Cáceres;188;Torre de Santa María;881;448;433
10;Cáceres;185;Torrecilla de los Ángeles;773;404;369
10;Cáceres;186;Torrecillas de la Tiesa;1379;689;690
10;Cáceres;190;Torrejón el Rubio;865;448;417
10;Cáceres;189;Torrejoncillo;3968;1930;2038
10;Cáceres;191;Torremenga;554;283;271
10;Cáceres;192;Torremocha;1464;717;747
10;Cáceres;193;Torreorgaz;1448;734;714
10;Cáceres;194;Torrequemada;682;331;351
10;Cáceres;195;Trujillo;9239;4407;4832
10;Cáceres;196;Valdastillas;478;239;239
10;Cáceres;197;Valdecañas de Tajo;245;137;108
10;Cáceres;198;Valdefuentes;1680;822;858
10;Cáceres;199;Valdehúncar;189;94;95
10;Cáceres;200;Valdelacasa de Tajo;1062;504;558
10;Cáceres;201;Valdemorales;297;159;138
10;Cáceres;202;Valdeobispo;956;486;470
10;Cáceres;203;Valencia de Alcántara;7458;3716;3742
10;Cáceres;204;Valverde de la Vera;830;403;427
10;Cáceres;205;Valverde del Fresno;2852;1441;1411
10;Cáceres;206;Viandar de la Vera;509;254;255
10;Cáceres;207;Villa del Campo;816;401;415
10;Cáceres;208;Villa del Rey;220;113;107
10;Cáceres;209;Villamesías;535;255;280
10;Cáceres;210;Villamiel;922;460;462
10;Cáceres;211;Villanueva de la Sierra;903;442;461
10;Cáceres;212;Villanueva de la Vera;2164;1093;1071
10;Cáceres;214;Villar de Plasencia;404;198;206
10;Cáceres;213;Villar del Pedroso;1118;560;558
10;Cáceres;215;Villasbuenas de Gata;600;304;296
10;Cáceres;216;Zarza de Granadilla;1942;1005;937
10;Cáceres;217;Zarza de Montánchez;866;439;427
10;Cáceres;218;Zarza la Mayor;1939;947;992
10;Cáceres;219;Zorita;2714;1335;1379
11;Cádiz;001;Alcalá de los Gazules;5632;2941;2691
11;Cádiz;002;Alcalá del Valle;5250;2673;2577
11;Cádiz;003;Algar;2145;1135;1010
11;Cádiz;004;Algeciras;96882;47789;49093
11;Cádiz;005;Algodonales;5975;3126;2849
11;Cádiz;006;Arcos de la Frontera;26781;13433;13348
11;Cádiz;007;Barbate;22047;11092;10955
11;Cádiz;008;Barrios (Los);12148;6201;5947
11;Cádiz;901;Benalup-Casas Viejas;"";"";""
11;Cádiz;009;Benaocaz;503;247;256
11;Cádiz;010;Bornos;7848;3965;3883
11;Cádiz;011;Bosque (El);1795;918;877
11;Cádiz;013;Castellar de la Frontera;2121;1099;1022
11;Cádiz;015;Chiclana de la Frontera;41677;21210;20467
11;Cádiz;016;Chipiona;13474;6902;6572
11;Cádiz;014;Conil de la Frontera;14362;7435;6927
11;Cádiz;012;Cádiz;155299;75010;80289
11;Cádiz;017;Espera;4195;2199;1996
11;Cádiz;018;Gastor (El);2292;1220;1072
11;Cádiz;019;Grazalema;2288;1191;1097
11;Cádiz;020;Jerez de la Frontera;179191;88237;90954
11;Cádiz;021;Jimena de la Frontera;8539;4438;4101
11;Cádiz;022;Línea de la Concepción (La);58779;28699;30080
11;Cádiz;023;Medina-Sidonia;15786;8202;7584
11;Cádiz;024;Olvera;9229;4694;4535
11;Cádiz;025;Paterna de Rivera;4666;2429;2237
11;Cádiz;026;Prado del Rey;5383;2720;2663
11;Cádiz;028;Puerto Real;26915;13654;13261
11;Cádiz;029;Puerto Serrano;6156;3118;3038
11;Cádiz;027;Puerto de Santa María (El);60638;30329;30309
11;Cádiz;030;Rota;21285;10768;10517
11;Cádiz;031;San Fernando;80057;39576;40481
11;Cádiz;902;San José del Valle;"";"";""
11;Cádiz;033;San Roque;21459;10774;10685
11;Cádiz;032;Sanlúcar de Barrameda;53017;26593;26424
11;Cádiz;034;Setenil de las Bodegas;3338;1699;1639
11;Cádiz;035;Tarifa;14548;7356;7192
11;Cádiz;036;Torre Alháquime;1058;534;524
11;Cádiz;037;Trebujena;6774;3458;3316
11;Cádiz;038;Ubrique;17747;8815;8932
11;Cádiz;039;Vejer de la Frontera;12969;6638;6331
11;Cádiz;040;Villaluenga del Rosario;507;260;247
11;Cádiz;041;Villamartín;12050;5959;6091
11;Cádiz;042;Zahara;1688;868;820
12;Castellón/Castelló;002;Aín;142;71;71
12;Castellón/Castelló;003;Albocàsser;1575;764;811
12;Castellón/Castelló;004;Alcalà de Xivert;4655;2337;2318
12;Castellón/Castelló;005;Alcora (L');8217;4154;4063
12;Castellón/Castelló;006;Alcudia de Veo;201;97;104
12;Castellón/Castelló;007;Alfondeguilla;922;464;458
12;Castellón/Castelló;008;Algimia de Almonacid;399;211;188
12;Castellón/Castelló;009;Almazora/Almassora;15392;7641;7751
12;Castellón/Castelló;010;Almedíjar;310;152;158
12;Castellón/Castelló;011;Almenara;5042;2522;2520
12;Castellón/Castelló;901;Alquerías del Niño Perdido;3667;1802;1865
12;Castellón/Castelló;012;Altura;3040;1503;1537
12;Castellón/Castelló;013;Arañuel;144;69;75
12;Castellón/Castelló;014;Ares del Maestre;384;197;187
12;Castellón/Castelló;015;Argelita;101;51;50
12;Castellón/Castelló;016;Artana;2004;1002;1002
12;Castellón/Castelló;001;Atzeneta del Maestrat;1740;879;861
12;Castellón/Castelló;017;Ayódar;238;119;119
12;Castellón/Castelló;018;Azuébar;412;197;215
12;Castellón/Castelló;020;Barracas;207;111;96
12;Castellón/Castelló;022;Bejís;516;266;250
12;Castellón/Castelló;024;Benafer;130;70;60
12;Castellón/Castelló;025;Benafigos;306;165;141
12;Castellón/Castelló;026;Benasal;1528;746;782
12;Castellón/Castelló;027;Benicarló;17072;8313;8759
12;Castellón/Castelló;028;Benicasim/Benicàssim;5110;2564;2546
12;Castellón/Castelló;029;Benlloch;1018;524;494
12;Castellón/Castelló;021;Betxí;5060;2559;2501
12;Castellón/Castelló;031;Borriol;2432;1229;1203
12;Castellón/Castelló;032;Burriana;25178;12312;12866
12;Castellón/Castelló;033;Cabanes;2657;1293;1364
12;Castellón/Castelló;034;Càlig;1783;872;911
12;Castellón/Castelló;036;Canet lo Roig;1127;558;569
12;Castellón/Castelló;037;Castell de Cabres;31;14;17
12;Castellón/Castelló;038;Castellfort;306;160;146
12;Castellón/Castelló;039;Castellnovo;1108;576;532
12;Castellón/Castelló;040;Castellón de la Plana/Castelló de la Plana;127440;62476;64964
12;Castellón/Castelló;041;Castillo de Villamalefa;177;91;86
12;Castellón/Castelló;042;Catí;1016;517;499
12;Castellón/Castelló;043;Caudiel;742;374;368
12;Castellón/Castelló;044;Cervera del Maestre;863;425;438
12;Castellón/Castelló;052;Chert/Xert;1152;567;585
12;Castellón/Castelló;053;Chilches/Xilxes;2150;1083;1067
12;Castellón/Castelló;055;Chodos/Xodos;171;91;80
12;Castellón/Castelló;056;Chóvar;428;219;209
12;Castellón/Castelló;045;Cinctorres;657;305;352
12;Castellón/Castelló;046;Cirat;397;194;203
12;Castellón/Castelló;048;Cortes de Arenoso;434;235;199
12;Castellón/Castelló;049;Costur;485;246;239
12;Castellón/Castelló;050;Coves de Vinromà (les);2121;1054;1067
12;Castellón/Castelló;051;Culla;1097;547;550
12;Castellón/Castelló;057;Eslida;866;427;439
12;Castellón/Castelló;058;Espadilla;54;22;32
12;Castellón/Castelló;059;Fanzara;297;147;150
12;Castellón/Castelló;060;Figueroles;589;298;291
12;Castellón/Castelló;061;Forcall;662;314;348
12;Castellón/Castelló;063;Fuente la Reina;32;18;14
12;Castellón/Castelló;064;Fuentes de Ayódar;92;52;40
12;Castellón/Castelló;065;Gaibiel;286;146;140
12;Castellón/Castelló;066;Gatova;577;279;298
12;Castellón/Castelló;067;Geldo;768;390;378
12;Castellón/Castelló;068;Herbés;144;79;65
12;Castellón/Castelló;069;Higueras;44;23;21
12;Castellón/Castelló;070;Jana (La);993;498;495
12;Castellón/Castelló;071;Jérica;1756;892;864
12;Castellón/Castelló;074;Llosa (La);944;472;472
12;Castellón/Castelló;072;Lucena del Cid;1781;869;912
12;Castellón/Castelló;073;Ludiente;282;142;140
12;Castellón/Castelló;075;Mata de Morella (La);222;108;114
12;Castellón/Castelló;076;Matet;163;88;75
12;Castellón/Castelló;077;Moncofa;3460;1704;1756
12;Castellón/Castelló;078;Montán;423;216;207
12;Castellón/Castelló;079;Montanejos;498;260;238
12;Castellón/Castelló;080;Morella;3109;1508;1601
12;Castellón/Castelló;081;Navajas;535;258;277
12;Castellón/Castelló;082;Nules;11233;5539;5694
12;Castellón/Castelló;083;Olocau del Rey;173;95;78
12;Castellón/Castelló;084;Onda;17939;8942;8997
12;Castellón/Castelló;085;Oropesa del Mar/Orpesa;1940;990;950
12;Castellón/Castelló;087;Palanques;25;15;10
12;Castellón/Castelló;088;Pavías;71;39;32
12;Castellón/Castelló;089;Peñíscola;3261;1627;1634
12;Castellón/Castelló;090;Pina de Montalgrao;226;125;101
12;Castellón/Castelló;093;Pobla de Benifassà (La);259;124;135
12;Castellón/Castelló;094;Pobla Tornesa (La);496;247;249
12;Castellón/Castelló;091;Portell de Morella;331;170;161
12;Castellón/Castelló;092;Puebla de Arenoso;233;114;119
12;Castellón/Castelló;095;Ribesalbes;1393;685;708
12;Castellón/Castelló;096;Rossell;1284;652;632
12;Castellón/Castelló;097;Sacañet;67;30;37
12;Castellón/Castelló;098;Salzadella (La);927;456;471
12;Castellón/Castelló;101;San Rafael del Río;526;262;264
12;Castellón/Castelló;902;Sant Joan de Moró;"";"";""
12;Castellón/Castelló;099;Sant Jordi/San Jorge;590;284;306
12;Castellón/Castelló;100;Sant Mateu;1929;923;1006
12;Castellón/Castelló;102;Santa Magdalena de Pulpis;745;372;373
12;Castellón/Castelló;103;Sarratella;139;70;69
12;Castellón/Castelló;104;Segorbe;7628;3727;3901
12;Castellón/Castelló;105;Sierra Engarcerán;1172;609;563
12;Castellón/Castelló;106;Soneja;1539;776;763
12;Castellón/Castelló;107;Sot de Ferrer;425;214;211
12;Castellón/Castelló;108;Sueras/Suera;618;316;302
12;Castellón/Castelló;109;Tales;801;378;423
12;Castellón/Castelló;110;Teresa;472;240;232
12;Castellón/Castelló;111;Tírig;722;355;367
12;Castellón/Castelló;112;Todolella;167;84;83
12;Castellón/Castelló;113;Toga;122;53;69
12;Castellón/Castelló;114;Torás;334;176;158
12;Castellón/Castelló;115;Toro (El);330;175;155
12;Castellón/Castelló;116;Torralba del Pinar;71;36;35
12;Castellón/Castelló;119;Torre d'En Besora (La);273;143;130
12;Castellón/Castelló;120;Torre Endoménech;326;162;164
12;Castellón/Castelló;117;Torreblanca;4612;2332;2280
12;Castellón/Castelló;118;Torrechiva;56;30;26
12;Castellón/Castelló;121;Traiguera;1741;884;857
12;Castellón/Castelló;122;Useras/Useres (Les);1258;643;615
12;Castellón/Castelló;124;Vall d'Alba;2041;1033;1008
12;Castellón/Castelló;125;Vall de Almonacid;286;141;145
12;Castellón/Castelló;126;Vall d'Uixó (La);27384;13664;13720
12;Castellón/Castelló;123;Vallat;35;17;18
12;Castellón/Castelló;127;Vallibona;140;64;76
12;Castellón/Castelló;128;Vilafamés;3028;1568;1460
12;Castellón/Castelló;132;Vilanova d'Alcolea;849;421;428
12;Castellón/Castelló;134;Vilar de Canes;230;118;112
12;Castellón/Castelló;129;Villafranca del Cid;2926;1383;1543
12;Castellón/Castelló;130;Villahermosa del Río;546;286;260
12;Castellón/Castelló;131;Villamalur;176;95;81
12;Castellón/Castelló;133;Villanueva de Viver;148;78;70
12;Castellón/Castelló;135;Villarreal/Vila-real;36802;18148;18654
12;Castellón/Castelló;136;Villavieja;3468;1715;1753
12;Castellón/Castelló;137;Villores;103;53;50
12;Castellón/Castelló;138;Vinaròs;17633;8565;9068
12;Castellón/Castelló;139;Vistabella del Maestrazgo;631;310;321
12;Castellón/Castelló;140;Viver;1242;626;616
12;Castellón/Castelló;141;Zorita del Maestrazgo;154;71;83
12;Castellón/Castelló;142;Zucaina;251;137;114
13;Ciudad Real;001;Abenójar;2150;1097;1053
13;Ciudad Real;002;Agudo;2409;1216;1193
13;Ciudad Real;003;Alamillo;802;411;391
13;Ciudad Real;004;Albaladejo;2050;988;1062
13;Ciudad Real;005;Alcázar de San Juan;26219;12806;13413
13;Ciudad Real;006;Alcoba;929;470;459
13;Ciudad Real;007;Alcolea de Calatrava;1627;809;818
13;Ciudad Real;008;Alcubillas;905;440;465
13;Ciudad Real;009;Aldea del Rey;2518;1213;1305
13;Ciudad Real;010;Alhambra;1479;738;741
13;Ciudad Real;011;Almadén;9140;4428;4712
13;Ciudad Real;012;Almadenejos;790;417;373
13;Ciudad Real;013;Almagro;8362;4024;4338
13;Ciudad Real;014;Almedina;1003;482;521
13;Ciudad Real;015;Almodóvar del Campo;8663;4364;4299
13;Ciudad Real;016;Almuradiel;852;420;432
13;Ciudad Real;017;Anchuras;564;295;269
13;Ciudad Real;903;Arenales de San Gregorio;"";"";""
13;Ciudad Real;018;Arenas de San Juan;1091;567;524
13;Ciudad Real;019;Argamasilla de Alba;7202;3582;3620
13;Ciudad Real;020;Argamasilla de Calatrava;5819;2886;2933
13;Ciudad Real;021;Arroba de los Montes;757;392;365
13;Ciudad Real;022;Ballesteros de Calatrava;741;368;373
13;Ciudad Real;023;Bolaños de Calatrava;10086;4981;5105
13;Ciudad Real;024;Brazatortas;1502;755;747
13;Ciudad Real;025;Cabezarados;435;221;214
13;Ciudad Real;026;Cabezarrubias del Puerto;815;413;402
13;Ciudad Real;027;Calzada de Calatrava;5284;2595;2689
13;Ciudad Real;028;Campo de Criptana;13682;6688;6994
13;Ciudad Real;029;Cañada de Calatrava;103;57;46
13;Ciudad Real;030;Caracuel de Calatrava;205;104;101
13;Ciudad Real;031;Carrión de Calatrava;2467;1190;1277
13;Ciudad Real;032;Carrizosa;1785;889;896
13;Ciudad Real;033;Castellar de Santiago;2590;1264;1326
13;Ciudad Real;038;Chillón;2818;1371;1447
13;Ciudad Real;034;Ciudad Real;54409;25873;28536
13;Ciudad Real;035;Corral de Calatrava;1435;699;736
13;Ciudad Real;036;Cortijos (Los);1250;629;621
13;Ciudad Real;037;Cózar;1650;801;849
13;Ciudad Real;039;Daimiel;17105;8312;8793
13;Ciudad Real;040;Fernán Caballero;1135;539;596
13;Ciudad Real;041;Fontanarejo;530;271;259
13;Ciudad Real;042;Fuencaliente;1474;780;694
13;Ciudad Real;043;Fuenllana;380;162;218
13;Ciudad Real;044;Fuente el Fresno;3711;1815;1896
13;Ciudad Real;045;Granátula de Calatrava;1232;593;639
13;Ciudad Real;046;Guadalmez;1210;637;573
13;Ciudad Real;047;Herencia;7116;3515;3601
13;Ciudad Real;048;Hinojosas de Calatrava;1095;526;569
13;Ciudad Real;049;Horcajo de los Montes;1263;647;616
13;Ciudad Real;050;Labores (Las);686;344;342
13;Ciudad Real;904;Llanos del Caudillo;"";"";""
13;Ciudad Real;051;Luciana;540;282;258
13;Ciudad Real;052;Malagón;8128;4006;4122
13;Ciudad Real;053;Manzanares;17718;8601;9117
13;Ciudad Real;054;Membrilla;6691;3347;3344
13;Ciudad Real;055;Mestanza;1250;606;644
13;Ciudad Real;056;Miguelturra;7230;3570;3660
13;Ciudad Real;057;Montiel;1778;889;889
13;Ciudad Real;058;Moral de Calatrava;5316;2563;2753
13;Ciudad Real;059;Navalpino;392;199;193
13;Ciudad Real;060;Navas de Estena;517;281;236
13;Ciudad Real;061;Pedro Muñoz;7257;3619;3638
13;Ciudad Real;062;Picón;599;321;278
13;Ciudad Real;063;Piedrabuena;5129;2556;2573
13;Ciudad Real;064;Poblete;673;344;329
13;Ciudad Real;065;Porzuna;4100;2077;2023
13;Ciudad Real;066;Pozuelo de Calatrava;2350;1138;1212
13;Ciudad Real;067;Pozuelos de Calatrava (Los);687;366;321
13;Ciudad Real;068;Puebla de Don Rodrigo;1434;758;676
13;Ciudad Real;069;Puebla del Príncipe;1171;594;577
13;Ciudad Real;070;Puerto Lápice;1056;525;531
13;Ciudad Real;071;Puertollano;51414;25218;26196
13;Ciudad Real;072;Retuerta del Bullaque;1136;591;545
13;Ciudad Real;901;Robledo (El);1308;684;624
13;Ciudad Real;902;Ruidera;"";"";""
13;Ciudad Real;073;Saceruela;875;454;421
13;Ciudad Real;074;San Carlos del Valle;1292;647;645
13;Ciudad Real;075;San Lorenzo de Calatrava;432;231;201
13;Ciudad Real;076;Santa Cruz de los Cáñamos;731;371;360
13;Ciudad Real;077;Santa Cruz de Mudela;5080;2453;2627
13;Ciudad Real;078;Socuéllamos;11867;5816;6051
13;Ciudad Real;080;Solana del Pino;817;410;407
13;Ciudad Real;079;Solana (La);14193;7028;7165
13;Ciudad Real;081;Terrinches;1221;604;617
13;Ciudad Real;082;Tomelloso;28156;13772;14384
13;Ciudad Real;083;Torralba de Calatrava;3161;1519;1642
13;Ciudad Real;084;Torre de Juan Abad;2043;1002;1041
13;Ciudad Real;085;Torrenueva;3390;1663;1727
13;Ciudad Real;086;Valdemanco del Esteras;365;187;178
13;Ciudad Real;087;Valdepeñas;25337;12245;13092
13;Ciudad Real;088;Valenzuela de Calatrava;880;419;461
13;Ciudad Real;089;Villahermosa;3379;1596;1783
13;Ciudad Real;090;Villamanrique;2008;998;1010
13;Ciudad Real;091;Villamayor de Calatrava;864;433;431
13;Ciudad Real;092;Villanueva de la Fuente;3228;1619;1609
13;Ciudad Real;093;Villanueva de los Infantes;6316;3023;3293
13;Ciudad Real;094;Villanueva de San Carlos;620;302;318
13;Ciudad Real;095;Villar del Pozo;101;48;53
13;Ciudad Real;096;Villarrubia de los Ojos;9446;4735;4711
13;Ciudad Real;097;Villarta de San Juan;2977;1462;1515
13;Ciudad Real;098;Viso del Marqués;3456;1697;1759
14;Córdoba;001;Adamuz;4580;2309;2271
14;Córdoba;002;Aguilar de la Frontera;12743;6256;6487
14;Córdoba;003;Alcaracejos;1518;764;754
14;Córdoba;004;Almedinilla;2812;1395;1417
14;Córdoba;005;Almodóvar del Río;6837;3436;3401
14;Córdoba;006;Añora;1834;882;952
14;Córdoba;007;Baena;18701;9266;9435
14;Córdoba;008;Belalcázar;4138;1995;2143
14;Córdoba;009;Belmez;4647;2240;2407
14;Córdoba;010;Benamejí;4614;2270;2344
14;Córdoba;011;Blázquez (Los);805;408;397
14;Córdoba;012;Bujalance;8864;4381;4483
14;Córdoba;013;Cabra;20134;9850;10284
14;Córdoba;015;Carcabuey;3070;1503;1567
14;Córdoba;016;Cardeña;2210;1110;1100
14;Córdoba;017;Carlota (La);8775;4393;4382
14;Córdoba;018;Carpio (El);4847;2384;2463
14;Córdoba;019;Castro del Río;7858;3836;4022
14;Córdoba;014;Cañete de las Torres;3472;1748;1724
14;Córdoba;020;Conquista;588;289;299
14;Córdoba;021;Córdoba;295290;142514;152776
14;Córdoba;023;Dos Torres;2496;1219;1277
14;Córdoba;022;Doña Mencía;5162;2554;2608
14;Córdoba;024;Encinas Reales;2209;1082;1127
14;Córdoba;025;Espejo;5173;2533;2640
14;Córdoba;026;Espiel;2873;1418;1455
14;Córdoba;027;Fernán-Núñez;9123;4533;4590
14;Córdoba;029;Fuente Obejuna;7018;3564;3454
14;Córdoba;030;Fuente Palmera;8964;4561;4403
14;Córdoba;028;Fuente la Lancha;528;259;269
14;Córdoba;031;Fuente-Tójar;926;452;474
14;Córdoba;032;Granjuela (La);560;288;272
14;Córdoba;033;Guadalcázar;1236;632;604
14;Córdoba;034;Guijo (El);527;274;253
14;Córdoba;035;Hinojosa del Duque;8227;3920;4307
14;Córdoba;036;Hornachuelos;5258;2672;2586
14;Córdoba;037;Iznájar;6282;3175;3107
14;Córdoba;038;Lucena;31035;15480;15555
14;Córdoba;039;Luque;3443;1702;1741
14;Córdoba;040;Montalbán de Córdoba;4371;2191;2180
14;Córdoba;041;Montemayor;3686;1863;1823
14;Córdoba;042;Montilla;22069;10916;11153
14;Córdoba;043;Montoro;10020;4917;5103
14;Córdoba;044;Monturque;2003;1019;984
14;Córdoba;045;Moriles;3665;1828;1837
14;Córdoba;046;Nueva Carteya;5808;2928;2880
14;Córdoba;047;Obejo;1505;745;760
14;Córdoba;048;Palenciana;1764;875;889
14;Córdoba;049;Palma del Río;18561;9267;9294
14;Córdoba;050;Pedro Abad;3032;1484;1548
14;Córdoba;051;Pedroche;1942;968;974
14;Córdoba;052;Peñarroya-Pueblonuevo;13779;6574;7205
14;Córdoba;053;Posadas;7041;3540;3501
14;Córdoba;054;Pozoblanco;14513;6927;7586
14;Córdoba;055;Priego de Córdoba;20624;10084;10540
14;Córdoba;056;Puente Genil;26588;12942;13646
14;Córdoba;057;Rambla (La);7056;3505;3551
14;Córdoba;058;Rute;10145;4925;5220
14;Córdoba;059;San Sebastián de los Ballesteros;816;417;399
14;Córdoba;061;Santa Eufemia;1389;690;699
14;Córdoba;060;Santaella;5728;2883;2845
14;Córdoba;062;Torrecampo;1686;813;873
14;Córdoba;063;Valenzuela;1695;806;889
14;Córdoba;064;Valsequillo;648;326;322
14;Córdoba;065;Victoria (La);1732;856;876
14;Córdoba;066;Villa del Río;7092;3587;3505
14;Córdoba;067;Villafranca de Córdoba;3540;1790;1750
14;Córdoba;068;Villaharta;675;323;352
14;Córdoba;069;Villanueva de Córdoba;10443;5057;5386
14;Córdoba;070;Villanueva del Duque;2177;1008;1169
14;Córdoba;071;Villanueva del Rey;1415;729;686
14;Córdoba;072;Villaralto;1887;899;988
14;Córdoba;073;Villaviciosa de Córdoba;4319;2202;2117
14;Córdoba;074;Viso (El);3653;1796;1857
14;Córdoba;075;Zuheros;1061;524;537
15;Coruña (A);001;Abegondo;6165;3050;3115
15;Coruña (A);002;Ames;9550;4568;4982
15;Coruña (A);003;Aranga;2676;1323;1353
15;Coruña (A);004;Ares;4804;2341;2463
15;Coruña (A);005;Arteixo;16904;8545;8359
15;Coruña (A);006;Arzúa;7364;3705;3659
15;Coruña (A);007;Baña (A);7489;3669;3820
15;Coruña (A);008;Bergondo;5568;2682;2886
15;Coruña (A);009;Betanzos;11667;5445;6222
15;Coruña (A);010;Boimorto;3291;1667;1624
15;Coruña (A);011;Boiro;17748;8568;9180
15;Coruña (A);012;Boqueixón;5023;2498;2525
15;Coruña (A);013;Brión;7044;3400;3644
15;Coruña (A);014;Cabana de Bergantiños;7167;3622;3545
15;Coruña (A);015;Cabanas;3281;1584;1697
15;Coruña (A);016;Camariñas;7444;3713;3731
15;Coruña (A);017;Cambre;10685;5201;5484
15;Coruña (A);018;Capela (A);1839;919;920
15;Coruña (A);019;Carballo;26962;13403;13559
15;Coruña (A);901;Cariño;"";"";""
15;Coruña (A);020;Carnota;7199;3484;3715
15;Coruña (A);021;Carral;5623;2804;2819
15;Coruña (A);022;Cedeira;7856;3828;4028
15;Coruña (A);023;Cee;7746;3795;3951
15;Coruña (A);024;Cerceda;7440;3662;3778
15;Coruña (A);025;Cerdido;2140;1038;1102
15;Coruña (A);026;Cesuras;3333;1668;1665
15;Coruña (A);027;Coirós;1628;816;812
15;Coruña (A);028;Corcubión;2098;1020;1078
15;Coruña (A);029;Coristanco;10271;5202;5069
15;Coruña (A);030;A Coruña;239150;112553;126597
15;Coruña (A);031;Culleredo;13348;6485;6863
15;Coruña (A);032;Curtis;5118;2535;2583
15;Coruña (A);033;Dodro;3661;1765;1896
15;Coruña (A);034;Dumbría;5092;2522;2570
15;Coruña (A);035;Fene;15757;7758;7999
15;Coruña (A);036;Ferrol;86154;40774;45380
15;Coruña (A);037;Fisterra;5516;2768;2748
15;Coruña (A);038;Frades;3609;1827;1782
15;Coruña (A);039;Irixoa;2041;990;1051
15;Coruña (A);041;Laracha (A);12007;6019;5988
15;Coruña (A);040;Laxe;3786;1892;1894
15;Coruña (A);042;Lousame;5028;2447;2581
15;Coruña (A);043;Malpica de Bergantiños;8560;4221;4339
15;Coruña (A);045;Mazaricos;7287;3528;3759
15;Coruña (A);044;Mañón;2515;1208;1307
15;Coruña (A);046;Melide;8260;4103;4157
15;Coruña (A);047;Mesía;4252;2134;2118
15;Coruña (A);048;Miño;5266;2525;2741
15;Coruña (A);049;Moeche;1907;916;991
15;Coruña (A);050;Monfero;3327;1697;1630
15;Coruña (A);051;Mugardos;6958;3383;3575
15;Coruña (A);053;Muros;12036;5815;6221
15;Coruña (A);052;Muxía;7044;3448;3596
15;Coruña (A);054;Narón;30060;14605;15455
15;Coruña (A);055;Neda;6809;3259;3550
15;Coruña (A);056;Negreira;7210;3447;3763
15;Coruña (A);057;Noia;14200;6912;7288
15;Coruña (A);058;Oleiros;16280;7903;8377
15;Coruña (A);059;Ordes;11842;5818;6024
15;Coruña (A);060;Oroso;4056;2010;2046
15;Coruña (A);061;Ortigueira;16249;7784;8465
15;Coruña (A);062;Outes;10115;4818;5297
15;Coruña (A);063;Oza dos Ríos;3473;1705;1768
15;Coruña (A);064;Paderne;3075;1479;1596
15;Coruña (A);065;Padrón;10161;4941;5220
15;Coruña (A);066;Pino (O);5691;2852;2839
15;Coruña (A);067;Pobra do Caramiñal (A);10320;4927;5393
15;Coruña (A);068;Ponteceso;8607;4333;4274
15;Coruña (A);069;Pontedeume;8608;4158;4450
15;Coruña (A);070;Pontes de García Rodríguez (As);13371;6787;6584
15;Coruña (A);071;Porto do Son;11176;5475;5701
15;Coruña (A);072;Rianxo;13195;6506;6689
15;Coruña (A);073;Ribeira;25132;12331;12801
15;Coruña (A);074;Rois;6096;2986;3110
15;Coruña (A);075;Sada;8207;3918;4289
15;Coruña (A);076;San Sadurniño;4075;1979;2096
15;Coruña (A);077;Santa Comba;12107;5936;6171
15;Coruña (A);078;Santiago de Compostela;86250;41065;45185
15;Coruña (A);079;Santiso;2805;1469;1336
15;Coruña (A);080;Sobrado;3127;1599;1528
15;Coruña (A);081;Somozas (As);1827;899;928
15;Coruña (A);082;Teo;11234;5468;5766
15;Coruña (A);083;Toques;2194;1134;1060
15;Coruña (A);084;Tordoia;6096;2936;3160
15;Coruña (A);085;Touro;5589;2778;2811
15;Coruña (A);086;Trazo;5021;2529;2492
15;Coruña (A);088;Val do Dubra;6229;3075;3154
15;Coruña (A);087;Valdoviño;7146;3569;3577
15;Coruña (A);089;Vedra;5704;2745;2959
15;Coruña (A);091;Vilarmaior;1612;779;833
15;Coruña (A);090;Vilasantar;2403;1214;1189
15;Coruña (A);092;Vimianzo;9668;4790;4878
15;Coruña (A);093;Zas;7084;3472;3612
16;Cuenca;001;Abia de la Obispalía;120;67;53
16;Cuenca;002;Acebrón (El);345;169;176
16;Cuenca;003;Alarcón;250;133;117
16;Cuenca;004;Albaladejo del Cuende;521;279;242
16;Cuenca;005;Albalate de las Nogueras;477;259;218
16;Cuenca;006;Albendea;252;128;124
16;Cuenca;007;Alberca de Záncara (La);2040;1007;1033
16;Cuenca;008;Alcalá de la Vega;235;121;114
16;Cuenca;009;Alcantud;185;94;91
16;Cuenca;011;Alcohujate;93;49;44
16;Cuenca;012;Alconchel de la Estrella;247;118;129
16;Cuenca;010;Alcázar del Rey;306;152;154
16;Cuenca;013;Algarra;36;19;17
16;Cuenca;014;Aliaguilla;1002;503;499
16;Cuenca;015;Almarcha (La);779;382;397
16;Cuenca;016;Almendros;476;241;235
16;Cuenca;017;Almodóvar del Pinar;613;321;292
16;Cuenca;018;Almonacid del Marquesado;630;324;306
16;Cuenca;019;Altarejos;520;263;257
16;Cuenca;020;Arandilla del Arroyo;66;35;31
16;Cuenca;905;Arcas del Villar;382;189;193
16;Cuenca;022;Arcos de la Sierra;151;81;70
16;Cuenca;024;Arguisuelas;249;129;120
16;Cuenca;025;Arrancacepas;53;27;26
16;Cuenca;026;Atalaya del Cañavate;160;79;81
16;Cuenca;027;Barajas de Melo;786;390;396
16;Cuenca;029;Barchín del Hoyo;184;101;83
16;Cuenca;030;Bascuñana de San Pedro;38;18;20
16;Cuenca;031;Beamud;103;59;44
16;Cuenca;032;Belinchón;354;180;174
16;Cuenca;033;Belmonte;2797;1305;1492
16;Cuenca;034;Belmontejo;339;177;162
16;Cuenca;035;Beteta;463;231;232
16;Cuenca;036;Boniches;267;134;133
16;Cuenca;038;Buciegas;119;62;57
16;Cuenca;039;Buenache de Alarcón;731;369;362
16;Cuenca;040;Buenache de la Sierra;116;69;47
16;Cuenca;041;Buendía;476;237;239
16;Cuenca;042;Campillo de Altobuey;1831;925;906
16;Cuenca;043;Campillos-Paravientos;178;95;83
16;Cuenca;044;Campillos-Sierra;103;57;46
16;Cuenca;901;Campos del Paraíso;1577;728;849
16;Cuenca;045;Canalejas del Arroyo;473;244;229
16;Cuenca;055;Carboneras de Guadazaón;1113;593;520
16;Cuenca;056;Cardenete;811;415;396
16;Cuenca;057;Carrascosa;181;99;82
16;Cuenca;058;Carrascosa de Haro;203;98;105
16;Cuenca;060;Casas de Benítez;1283;635;648
16;Cuenca;061;Casas de Fernando Alonso;1523;743;780
16;Cuenca;062;Casas de Garcimolina;40;17;23
16;Cuenca;063;Casas de Guijarro;220;109;111
16;Cuenca;064;Casas de Haro;978;482;496
16;Cuenca;065;Casas de los Pinos;640;322;318
16;Cuenca;066;Casasimarro;3138;1555;1583
16;Cuenca;067;Castejón;302;158;144
16;Cuenca;068;Castillejo de Iniesta;204;116;88
16;Cuenca;070;Castillejo-Sierra;63;29;34
16;Cuenca;072;Castillo de Garcimuñoz;345;176;169
16;Cuenca;071;Castillo-Albaráñez;41;20;21
16;Cuenca;047;Cañada Juncosa;447;231;216
16;Cuenca;046;Cañada del Hoyo;447;228;219
16;Cuenca;048;Cañamares;617;332;285
16;Cuenca;049;Cañavate (El);348;178;170
16;Cuenca;050;Cañaveras;509;256;253
16;Cuenca;051;Cañaveruelas;290;148;142
16;Cuenca;052;Cañete;981;486;495
16;Cuenca;053;Cañizares;736;404;332
16;Cuenca;073;Cervera del Llano;418;214;204
16;Cuenca;023;Chillarón de Cuenca;300;150;150
16;Cuenca;081;Chumillas;82;44;38
16;Cuenca;074;Cierva (La);66;37;29
16;Cuenca;078;Cuenca;41034;19858;21176
16;Cuenca;079;Cueva del Hierro;63;37;26
16;Cuenca;082;Enguídanos;754;391;363
16;Cuenca;083;Fresneda de Altarejos;115;65;50
16;Cuenca;084;Fresneda de la Sierra;111;51;60
16;Cuenca;085;Frontera (La);292;152;140
16;Cuenca;086;Fuente de Pedro Naharro;1363;680;683
16;Cuenca;087;Fuentelespino de Haro;458;244;214
16;Cuenca;088;Fuentelespino de Moya;202;98;104
16;Cuenca;904;Fuentenava de Jábaga;292;153;139
16;Cuenca;089;Fuentes;605;308;297
16;Cuenca;091;Fuertescusa;131;62;69
16;Cuenca;092;Gabaldón;219;124;95
16;Cuenca;093;Garaballa;236;125;111
16;Cuenca;094;Gascueña;236;117;119
16;Cuenca;095;Graja de Campalbo;179;99;80
16;Cuenca;096;Graja de Iniesta;397;209;188
16;Cuenca;097;Henarejos;410;202;208
16;Cuenca;098;Herrumblar (El);797;410;387
16;Cuenca;099;Hinojosa (La);427;207;220
16;Cuenca;100;Hinojosos (Los);1438;719;719
16;Cuenca;101;Hito (El);297;148;149
16;Cuenca;102;Honrubia;1729;876;853
16;Cuenca;103;Hontanaya;659;328;331
16;Cuenca;104;Hontecillas;117;56;61
16;Cuenca;106;Horcajo de Santiago;3656;1830;1826
16;Cuenca;108;Huelves;90;44;46
16;Cuenca;110;Huerta de la Obispalía;208;118;90
16;Cuenca;111;Huerta del Marquesado;202;107;95
16;Cuenca;112;Huete;2604;1313;1291
16;Cuenca;107;Huélamo;136;72;64
16;Cuenca;109;Huérguina;102;54;48
16;Cuenca;113;Iniesta;3657;1801;1856
16;Cuenca;115;Laguna del Marquesado;85;48;37
16;Cuenca;116;Lagunaseca;120;57;63
16;Cuenca;117;Landete;1744;865;879
16;Cuenca;118;Ledaña;2231;1131;1100
16;Cuenca;119;Leganiel;350;171;179
16;Cuenca;121;Majadas (Las);435;227;208
16;Cuenca;122;Mariana;331;162;169
16;Cuenca;123;Masegosa;168;81;87
16;Cuenca;124;Mesas (Las);2724;1396;1328
16;Cuenca;125;Minglanilla;2394;1198;1196
16;Cuenca;126;Mira;1262;627;635
16;Cuenca;128;Monreal del Llano;107;54;53
16;Cuenca;129;Montalbanejo;259;128;131
16;Cuenca;130;Montalbo;932;490;442
16;Cuenca;131;Monteagudo de las Salinas;136;74;62
16;Cuenca;132;Mota de Altarejos;87;45;42
16;Cuenca;133;Mota del Cuervo;5555;2758;2797
16;Cuenca;134;Motilla del Palancar;4733;2367;2366
16;Cuenca;135;Moya;393;203;190
16;Cuenca;137;Narboneta;134;69;65
16;Cuenca;139;Olivares de Júcar;795;393;402
16;Cuenca;140;Olmeda de la Cuesta;76;39;37
16;Cuenca;141;Olmeda del Rey;301;143;158
16;Cuenca;142;Olmedilla de Alarcón;276;144;132
16;Cuenca;143;Olmedilla de Eliz;40;23;17
16;Cuenca;145;Osa de la Vega;774;389;385
16;Cuenca;147;Pajaroncillo;125;66;59
16;Cuenca;146;Pajarón;167;91;76
16;Cuenca;148;Palomares del Campo;1074;536;538
16;Cuenca;149;Palomera;146;72;74
16;Cuenca;150;Paracuellos;242;125;117
16;Cuenca;151;Paredes;94;48;46
16;Cuenca;152;Parra de las Vegas (La);80;37;43
16;Cuenca;153;Pedernoso (El);1453;712;741
16;Cuenca;154;Pedroñeras (Las);6607;3334;3273
16;Cuenca;155;Peral (El);799;404;395
16;Cuenca;156;Peraleja (La);274;139;135
16;Cuenca;157;Pesquera (La);366;193;173
16;Cuenca;158;Picazo (El);788;381;407
16;Cuenca;159;Pinarejo;648;333;315
16;Cuenca;160;Pineda de Gigüela;248;124;124
16;Cuenca;161;Piqueras del Castillo;112;64;48
16;Cuenca;162;Portalrubio de Guadamejud;152;75;77
16;Cuenca;163;Portilla;124;61;63
16;Cuenca;165;Poyatos;139;74;65
16;Cuenca;166;Pozoamargo;437;216;221
16;Cuenca;908;Pozorrubielos de la Mancha;353;174;179
16;Cuenca;167;Pozorrubio;578;285;293
16;Cuenca;169;Pozuelo (El);112;56;56
16;Cuenca;170;Priego;1228;629;599
16;Cuenca;171;Provencio (El);3005;1475;1530
16;Cuenca;172;Puebla de Almenara;769;385;384
16;Cuenca;173;Puebla de Don Francisco;550;284;266
16;Cuenca;174;Puebla del Salvador;372;206;166
16;Cuenca;175;Quintanar del Rey;5632;2877;2755
16;Cuenca;176;Rada de Haro;76;38;38
16;Cuenca;177;Reíllo;169;80;89
16;Cuenca;181;Rozalén del Monte;191;91;100
16;Cuenca;185;Saceda-Trasierra;66;33;33
16;Cuenca;186;Saelices;911;466;445
16;Cuenca;187;Salinas del Manzano;175;96;79
16;Cuenca;188;Salmeroncillos;230;122;108
16;Cuenca;189;Salvacañete;389;212;177
16;Cuenca;190;San Clemente;6458;3192;3266
16;Cuenca;191;San Lorenzo de la Parrilla;1845;937;908
16;Cuenca;192;San Martín de Boniches;112;56;56
16;Cuenca;193;San Pedro Palmiches;139;82;57
16;Cuenca;194;Santa Cruz de Moya;516;267;249
16;Cuenca;196;Santa María de los Llanos;937;470;467
16;Cuenca;195;Santa María del Campo Rus;1177;586;591
16;Cuenca;197;Santa María del Val;157;82;75
16;Cuenca;198;Sisante;2006;1021;985
16;Cuenca;199;Solera de Gabaldón;62;35;27
16;Cuenca;909;Sotorribas;1133;588;545
16;Cuenca;202;Talayuelas;1322;679;643
16;Cuenca;203;Tarancón;10214;5056;5158
16;Cuenca;205;Tejadillos;208;104;104
16;Cuenca;206;Tinajas;485;252;233
16;Cuenca;209;Torralba;268;137;131
16;Cuenca;211;Torrejoncillo del Rey;989;491;498
16;Cuenca;212;Torrubia del Campo;422;209;213
16;Cuenca;213;Torrubia del Castillo;62;30;32
16;Cuenca;215;Tragacete;446;242;204
16;Cuenca;216;Tresjuncos;690;350;340
16;Cuenca;217;Tribaldos;202;107;95
16;Cuenca;204;Tébar;544;287;257
16;Cuenca;218;Uclés;373;177;196
16;Cuenca;219;Uña;161;78;83
16;Cuenca;906;Valdecolmenas (Los);188;90;98
16;Cuenca;224;Valdemeca;104;60;44
16;Cuenca;225;Valdemorillo de la Sierra;105;51;54
16;Cuenca;227;Valdemoro-Sierra;213;117;96
16;Cuenca;228;Valdeolivas;348;176;172
16;Cuenca;902;Valdetórtola;221;121;100
16;Cuenca;903;Valeras (Las);1567;784;783
16;Cuenca;231;Valhermoso de la Fuente;80;37;43
16;Cuenca;234;Valsalobre;69;34;35
16;Cuenca;236;Valverde de Júcar;1574;775;799
16;Cuenca;237;Valverdejo;180;93;87
16;Cuenca;238;Vara de Rey;1033;514;519
16;Cuenca;239;Vega del Codorno;303;146;157
16;Cuenca;240;Vellisca;272;127;145
16;Cuenca;242;Villaconejos de Trabaque;572;293;279
16;Cuenca;243;Villaescusa de Haro;654;336;318
16;Cuenca;244;Villagarcía del Llano;1021;521;500
16;Cuenca;245;Villalba de la Sierra;538;281;257
16;Cuenca;246;Villalba del Rey;956;497;459
16;Cuenca;247;Villalgordo del Marquesado;220;109;111
16;Cuenca;248;Villalpardo;1157;599;558
16;Cuenca;249;Villamayor de Santiago;3004;1485;1519
16;Cuenca;250;Villanueva de Guadamejud;171;80;91
16;Cuenca;251;Villanueva de la Jara;2567;1280;1287
16;Cuenca;253;Villar de Cañas;577;292;285
16;Cuenca;254;Villar de Domingo García;301;153;148
16;Cuenca;263;Villar de Olalla;819;419;400
16;Cuenca;255;Villar de la Encina;288;139;149
16;Cuenca;258;Villar del Humo;517;263;254
16;Cuenca;259;Villar del Infantado;67;39;28
16;Cuenca;910;Villar y Velasco;191;101;90
16;Cuenca;264;Villarejo de Fuentes;1008;495;513
16;Cuenca;265;Villarejo de la Peñuela;46;25;21
16;Cuenca;266;Villarejo-Periesteban;600;308;292
16;Cuenca;269;Villares del Saz;1019;501;518
16;Cuenca;270;Villarrubio;299;139;160
16;Cuenca;271;Villarta;846;446;400
16;Cuenca;272;Villas de la Ventosa;566;301;265
16;Cuenca;273;Villaverde y Pasaconsol;511;252;259
16;Cuenca;275;Vindel;33;17;16
16;Cuenca;274;Víllora;323;157;166
16;Cuenca;276;Yémeda;61;31;30
16;Cuenca;277;Zafra de Záncara;337;173;164
16;Cuenca;278;Zafrilla;180;92;88
16;Cuenca;279;Zarza de Tajo;367;168;199
16;Cuenca;280;Zarzuela;370;183;187
17;Girona;001;Agullana;647;335;312
17;Girona;002;Aiguaviva;358;177;181
17;Girona;003;Albanyà;111;62;49
17;Girona;004;Albons;474;240;234
17;Girona;006;Alp;894;463;431
17;Girona;007;Amer;2410;1178;1232
17;Girona;008;Anglès;5132;2567;2565
17;Girona;009;Arbúcies;4172;2084;2088
17;Girona;010;Argelaguer;336;166;170
17;Girona;011;Armentera (L');745;347;398
17;Girona;012;Avinyonet de Puigventós;342;172;170
17;Girona;015;Banyoles;12854;6227;6627
17;Girona;016;Bàscara;756;390;366
17;Girona;013;Begur;2527;1267;1260
17;Girona;018;Bellcaire d'Empordà;480;236;244
17;Girona;019;Besalú;2137;1037;1100
17;Girona;020;Bescanó;2783;1385;1398
17;Girona;021;Beuda;112;65;47
17;Girona;022;Bisbal d'Empordà (La);7626;3784;3842
17;Girona;234;Biure;284;141;143
17;Girona;023;Blanes;22472;11209;11263
17;Girona;029;Boadella d'Empordà;221;116;105
17;Girona;024;Bolvir;218;105;113
17;Girona;025;Bordils;1242;613;629
17;Girona;026;Borrassà;497;253;244
17;Girona;027;Breda;3170;1621;1549
17;Girona;028;Brunyola;405;204;201
17;Girona;031;Cabanelles;267;140;127
17;Girona;030;Cabanes;833;427;406
17;Girona;032;Cadaqués;1641;804;837
17;Girona;033;Caldes de Malavella;2776;1340;1436
17;Girona;034;Calonge;4052;2026;2026
17;Girona;035;Camós;618;328;290
17;Girona;036;Campdevànol;3565;1765;1800
17;Girona;037;Campelles;156;85;71
17;Girona;038;Campllong;267;145;122
17;Girona;039;Camprodon;2289;1121;1168
17;Girona;040;Canet d'Adri;453;239;214
17;Girona;041;Cantallops;259;123;136
17;Girona;042;Capmany;429;228;201
17;Girona;044;Cassà de la Selva;7100;3467;3633
17;Girona;046;Castellfollit de la Roca;1088;517;571
17;Girona;047;Castelló d'Empúries;3354;1662;1692
17;Girona;048;Castell-Platja d'Aro;4243;2127;2116
17;Girona;189;Cellera de Ter (La);2005;959;1046
17;Girona;049;Celrà;2268;1124;1144
17;Girona;050;Cervià de Ter;628;303;325
17;Girona;051;Cistella;211;103;108
17;Girona;054;Colera;441;223;218
17;Girona;055;Colomers;214;109;105
17;Girona;057;Corçà;1134;575;559
17;Girona;056;Cornellà del Terri;1760;901;859
17;Girona;058;Crespià;228;122;106
17;Girona;901;Cruïlles, Monells i Sant Sadurní de l'Heura;1025;513;512
17;Girona;060;Darnius;479;253;226
17;Girona;061;Das;138;72;66
17;Girona;062;Escala (L');4721;2408;2313
17;Girona;063;Espinelves;239;129;110
17;Girona;064;Espolla;404;212;192
17;Girona;065;Esponellà;368;178;190
17;Girona;005;Far d'Empordà (El);434;226;208
17;Girona;066;Figueres;31942;15651;16291
17;Girona;067;Flaçà;960;470;490
17;Girona;068;Foixà;323;162;161
17;Girona;069;Fontanals de Cerdanya;353;187;166
17;Girona;070;Fontanilles;128;71;57
17;Girona;071;Fontcoberta;739;383;356
17;Girona;902;Forallac;1467;725;742
17;Girona;073;Fornells de la Selva;995;474;521
17;Girona;074;Fortià;476;232;244
17;Girona;075;Garrigàs;315;167;148
17;Girona;076;Garrigoles;158;86;72
17;Girona;077;Garriguella;611;321;290
17;Girona;078;Ger;251;127;124
17;Girona;079;Girona;67009;32414;34595
17;Girona;080;Gombrèn;258;131;127
17;Girona;081;Gualta;290;145;145
17;Girona;082;Guils de Cerdanya;258;137;121
17;Girona;083;Hostalric;2685;1337;1348
17;Girona;084;Isòvol;200;94;106
17;Girona;085;Jafre;353;182;171
17;Girona;086;Jonquera (La);2582;1335;1247
17;Girona;087;Juià;274;141;133
17;Girona;088;Lladó;493;253;240
17;Girona;089;Llagostera;5119;2571;2548
17;Girona;090;Llambilles;428;212;216
17;Girona;091;Llanars;386;203;183
17;Girona;092;Llançà;3271;1666;1605
17;Girona;093;Llers;677;349;328
17;Girona;094;Llívia;930;467;463
17;Girona;095;Lloret de Mar;14567;7284;7283
17;Girona;096;Llosses (Les);402;210;192
17;Girona;102;Maçanet de Cabrenys;744;364;380
17;Girona;103;Maçanet de la Selva;2479;1257;1222
17;Girona;097;Madremanya;203;92;111
17;Girona;098;Maià de Montcal;375;186;189
17;Girona;100;Masarac;263;128;135
17;Girona;101;Massanes;466;252;214
17;Girona;099;Meranges;64;37;27
17;Girona;105;Mieres;359;183;176
17;Girona;106;Mollet de Peralada;179;98;81
17;Girona;107;Molló;388;201;187
17;Girona;109;Montagut i Oix;818;421;397
17;Girona;110;Mont-ras;1109;573;536
17;Girona;111;Navata;624;300;324
17;Girona;112;Ogassa;285;154;131
17;Girona;114;Olot;25554;12308;13246
17;Girona;115;Ordis;303;159;144
17;Girona;116;Osor;517;273;244
17;Girona;117;Palafrugell;16064;7949;8115
17;Girona;118;Palamós;12198;6011;6187
17;Girona;119;Palau de Santa Eulàlia;84;43;41
17;Girona;121;Palau-sator;321;168;153
17;Girona;120;Palau-saverdera;663;330;333
17;Girona;122;Palmerola;20;12;8
17;Girona;123;Palol de Revardit;370;192;178
17;Girona;124;Pals;1683;846;837
17;Girona;125;Pardines;118;62;56
17;Girona;126;Parlavà;348;187;161
17;Girona;128;Pau;317;154;163
17;Girona;129;Pedret i Marzà;148;67;81
17;Girona;130;Pera (La);371;187;184
17;Girona;132;Peralada;1259;644;615
17;Girona;133;Planes d'Hostoles (Les);1845;892;953
17;Girona;134;Planoles;295;151;144
17;Girona;135;Pont de Molins;378;192;186
17;Girona;136;Pontós;204;115;89
17;Girona;137;Porqueres;2796;1384;1412
17;Girona;140;Port de la Selva (El);768;370;398
17;Girona;138;Portbou;2021;1000;1021
17;Girona;139;Preses (Les);1351;668;683
17;Girona;141;Puigcerdà;6016;3016;3000
17;Girona;142;Quart;1644;823;821
17;Girona;043;Queralbs;200;108;92
17;Girona;143;Rabós;147;76;71
17;Girona;144;Regencós;259;147;112
17;Girona;145;Ribes de Freser;2627;1258;1369
17;Girona;146;Riells i Viabrea;742;374;368
17;Girona;147;Ripoll;11670;5684;5986
17;Girona;148;Riudarenes;1143;572;571
17;Girona;149;Riudaura;386;186;200
17;Girona;150;Riudellots de la Selva;1174;608;566
17;Girona;151;Riumors;205;93;112
17;Girona;152;Roses;9219;4754;4465
17;Girona;153;Rupià;218;104;114
17;Girona;154;Sales de Llierca;54;34;20
17;Girona;155;Salt;21081;10471;10610
17;Girona;157;Sant Andreu Salou;157;82;75
17;Girona;183;Sant Aniol de Finestres;273;140;133
17;Girona;158;Sant Climent Sescebes;461;240;221
17;Girona;159;Sant Feliu de Buixalleu;615;319;296
17;Girona;160;Sant Feliu de Guíxols;15546;7503;8043
17;Girona;161;Sant Feliu de Pallerols;1068;511;557
17;Girona;162;Sant Ferriol;180;103;77
17;Girona;163;Sant Gregori;1735;896;839
17;Girona;164;Sant Hilari Sacalm;4505;2281;2224
17;Girona;165;Sant Jaume de Llierca;775;394;381
17;Girona;167;Sant Joan de les Abadesses;4072;1958;2114
17;Girona;168;Sant Joan de Mollet;313;154;159
17;Girona;185;Sant Joan les Fonts;2933;1462;1471
17;Girona;166;Sant Jordi Desvalls;590;290;300
17;Girona;169;Sant Julià de Ramis;1605;798;807
17;Girona;903;Sant Julià del Llor i Bonmatí;869;418;451
17;Girona;171;Sant Llorenç de la Muga;152;72;80
17;Girona;172;Sant Martí de Llémena;324;180;144
17;Girona;173;Sant Martí Vell;192;98;94
17;Girona;174;Sant Miquel de Campmajor;224;130;94
17;Girona;175;Sant Miquel de Fluvià;552;281;271
17;Girona;176;Sant Mori;131;64;67
17;Girona;177;Sant Pau de Segúries;609;303;306
17;Girona;178;Sant Pere Pescador;1159;588;571
17;Girona;180;Santa Coloma de Farners;7582;3818;3764
17;Girona;181;Santa Cristina d'Aro;1448;764;684
17;Girona;182;Santa Llogaia d'Àlguema;309;158;151
17;Girona;184;Santa Pau;1316;666;650
17;Girona;186;Sarrià de Ter;3533;1766;1767
17;Girona;187;Saus;718;371;347
17;Girona;188;Selva de Mar (La);154;83;71
17;Girona;190;Serinyà;702;341;361
17;Girona;191;Serra de Daró;189;99;90
17;Girona;192;Setcases;161;82;79
17;Girona;193;Sils;2058;1031;1027
17;Girona;052;Siurana;171;77;94
17;Girona;194;Susqueda;125;65;60
17;Girona;195;Tallada d'Empordà (La);365;180;185
17;Girona;196;Terrades;191;93;98
17;Girona;197;Torrent;206;106;100
17;Girona;198;Torroella de Fluvià;282;151;131
17;Girona;199;Torroella de Montgrí;6294;3141;3153
17;Girona;200;Tortellà;751;367;384
17;Girona;201;Toses;126;74;52
17;Girona;202;Tossa de Mar;3361;1691;1670
17;Girona;204;Ullà;742;369;373
17;Girona;205;Ullastret;276;134;142
17;Girona;203;Ultramort;214;108;106
17;Girona;206;Urús;99;47;52
17;Girona;014;Vajol (La);60;33;27
17;Girona;208;Vall de Bianya (La);1060;535;525
17;Girona;207;Vall d'en Bas (La);2597;1320;1277
17;Girona;170;Vallfogona de Ripollès;250;123;127
17;Girona;209;Vall-llobrega;230;119;111
17;Girona;210;Ventalló;508;271;237
17;Girona;211;Verges;1157;566;591
17;Girona;212;Vidrà;178;88;90
17;Girona;213;Vidreres;3591;1805;1786
17;Girona;214;Vilabertran;789;397;392
17;Girona;215;Vilablareix;901;451;450
17;Girona;217;Viladamat;358;189;169
17;Girona;216;Viladasens;188;97;91
17;Girona;218;Vilademuls;757;394;363
17;Girona;220;Viladrau;802;403;399
17;Girona;221;Vilafant;2114;1049;1065
17;Girona;223;Vilajuïga;670;329;341
17;Girona;224;Vilallonga de Ter;437;222;215
17;Girona;225;Vilamacolum;253;122;131
17;Girona;226;Vilamalla;492;241;251
17;Girona;227;Vilamaniscle;118;53;65
17;Girona;228;Vilanant;284;144;140
17;Girona;230;Vila-sacra;398;197;201
17;Girona;222;Vilaür;105;49;56
17;Girona;233;Vilobí d'Onyar;1924;993;931
17;Girona;232;Vilopriu;179;87;92
18;Granada;001;Agrón;484;243;241
18;Granada;002;Alamedilla;1143;573;570
18;Granada;003;Albolote;8087;3998;4089
18;Granada;004;Albondón;1478;758;720
18;Granada;005;Albuñán;547;278;269
18;Granada;006;Albuñol;5529;2747;2782
18;Granada;007;Albuñuelas;1421;728;693
18;Granada;010;Aldeire;987;491;496
18;Granada;011;Alfacar;3056;1553;1503
18;Granada;012;Algarinejo;5188;2657;2531
18;Granada;013;Alhama de Granada;6141;3139;3002
18;Granada;014;Alhendín;3361;1702;1659
18;Granada;015;Alicún de Ortega;806;418;388
18;Granada;016;Almegíjar;552;279;273
18;Granada;017;Almuñécar;17149;8565;8584
18;Granada;904;Alpujarra de la Sierra;1484;760;724
18;Granada;018;Alquife;1390;686;704
18;Granada;020;Arenas del Rey;2167;1120;1047
18;Granada;021;Armilla;11743;5766;5977
18;Granada;022;Atarfe;9713;4759;4954
18;Granada;023;Baza;20768;10088;10680
18;Granada;024;Beas de Granada;834;417;417
18;Granada;025;Beas de Guadix;481;250;231
18;Granada;027;Benalúa;3586;1827;1759
18;Granada;028;Benalúa de las Villas;1383;687;696
18;Granada;029;Benamaurel;2741;1413;1328
18;Granada;030;Bérchules;1014;516;498
18;Granada;032;Bubión;327;173;154
18;Granada;033;Busquístar;434;227;207
18;Granada;034;Cacín;965;501;464
18;Granada;035;Cádiar;2159;1109;1050
18;Granada;036;Cájar;1623;729;894
18;Granada;114;Calahorra (La);1084;529;555
18;Granada;037;Calicasas;589;283;306
18;Granada;038;Campotéjar;1461;715;746
18;Granada;039;Caniles;6109;2990;3119
18;Granada;040;Cáñar;398;191;207
18;Granada;042;Capileira;598;297;301
18;Granada;043;Carataunas;175;88;87
18;Granada;044;Cástaras;366;190;176
18;Granada;045;Castilléjar;2431;1215;1216
18;Granada;046;Castril;3645;1885;1760
18;Granada;047;Cenes de la Vega;1398;722;676
18;Granada;059;Chauchina;4009;1981;2028
18;Granada;061;Chimeneas;1633;824;809
18;Granada;062;Churriana de la Vega;4749;2360;2389
18;Granada;048;Cijuela;1177;574;603
18;Granada;049;Cogollos de Guadix;858;459;399
18;Granada;050;Cogollos de la Vega;1852;931;921
18;Granada;051;Colomera;2030;1039;991
18;Granada;053;Cortes de Baza;3320;1691;1629
18;Granada;054;Cortes y Graena;1009;525;484
18;Granada;912;Cuevas del Campo;2588;1290;1298
18;Granada;056;Cúllar;5859;2892;2967
18;Granada;057;Cúllar Vega;1420;721;699
18;Granada;063;Darro;1625;805;820
18;Granada;064;Dehesas de Guadix;1013;510;503
18;Granada;066;Deifontes;2452;1272;1180
18;Granada;067;Diezma;1125;592;533
18;Granada;068;Dílar;1299;640;659
18;Granada;069;Dólar;779;386;393
18;Granada;070;Dúdar;279;144;135
18;Granada;071;Dúrcal;5485;2744;2741
18;Granada;072;Escúzar;1143;574;569
18;Granada;074;Ferreira;453;216;237
18;Granada;076;Fonelas;1601;827;774
18;Granada;078;Freila;1424;719;705
18;Granada;079;Fuente Vaqueros;3715;1865;1850
18;Granada;905;Gabias (Las);5373;2681;2692
18;Granada;082;Galera;1937;956;981
18;Granada;083;Gobernador;446;213;233
18;Granada;084;Gójar;1969;992;977
18;Granada;085;Gor;1572;783;789
18;Granada;086;Gorafe;761;392;369
18;Granada;087;Granada;256073;121262;134811
18;Granada;088;Guadahortuna;2530;1297;1233
18;Granada;089;Guadix;20155;9887;10268
18;Granada;906;Guajares (Los);1630;834;796
18;Granada;093;Gualchos;2962;1474;1488
18;Granada;094;Güejar Sierra;2576;1317;1259
18;Granada;095;Güevéjar;1124;551;573
18;Granada;096;Huélago;764;399;365
18;Granada;097;Huéneja;1631;812;819
18;Granada;098;Huéscar;10333;5131;5202
18;Granada;099;Huétor de Santillán;1359;706;653
18;Granada;100;Huétor Tájar;7469;3754;3715
18;Granada;101;Huétor Vega;5675;2847;2828
18;Granada;102;Illora;10278;5229;5049
18;Granada;103;Itrabo;1200;607;593
18;Granada;105;Iznalloz;6912;3535;3377
18;Granada;107;Jayena;1506;788;718
18;Granada;108;Jerez del Marquesado;1329;676;653
18;Granada;109;Jete;721;352;369
18;Granada;111;Jun;846;424;422
18;Granada;112;Juviles;203;101;102
18;Granada;115;Láchar;2100;1084;1016
18;Granada;116;Lanjarón;4231;2089;2142
18;Granada;117;Lanteira;787;403;384
18;Granada;119;Lecrín;2616;1286;1330
18;Granada;120;Lentegí;373;183;190
18;Granada;121;Lobras;257;125;132
18;Granada;122;Loja;20279;10190;10089
18;Granada;123;Lugros;623;333;290
18;Granada;124;Lújar;695;359;336
18;Granada;126;Malahá (La);1654;846;808
18;Granada;127;Maracena;11095;5504;5591
18;Granada;128;Marchal;534;256;278
18;Granada;132;Moclín;5037;2554;2483
18;Granada;133;Molvízar;2427;1218;1209
18;Granada;134;Monachil;3725;1884;1841
18;Granada;135;Montefrío;8359;4268;4091
18;Granada;136;Montejícar;3005;1524;1481
18;Granada;137;Montillana;1415;733;682
18;Granada;138;Moraleda de Zafayona;2547;1291;1256
18;Granada;909;Morelábor;1161;577;584
18;Granada;140;Motril;44482;22122;22360
18;Granada;141;Murtas;1225;611;614
18;Granada;903;Nevada;1599;828;771
18;Granada;143;Nigüelas;1217;619;598
18;Granada;144;Nívar;487;251;236
18;Granada;145;Ogíjares;2921;1470;1451
18;Granada;146;Orce;1626;815;811
18;Granada;147;Órgiva;5155;2578;2577
18;Granada;148;Otívar;1213;616;597
18;Granada;149;Otura;2209;1080;1129
18;Granada;150;Padul;6056;3012;3044
18;Granada;151;Pampaneira;358;184;174
18;Granada;152;Pedro Martínez;2017;999;1018
18;Granada;153;Peligros;5275;2639;2636
18;Granada;154;Peza (La);1740;893;847
18;Granada;910;Pinar (El);1478;740;738
18;Granada;157;Pinos Genil;910;464;446
18;Granada;158;Pinos Puente;13370;6606;6764
18;Granada;159;Píñar;1549;808;741
18;Granada;161;Polícar;274;147;127
18;Granada;162;Polopos;1387;727;660
18;Granada;163;Pórtugos;438;224;214
18;Granada;164;Puebla de Don Fadrique;2894;1438;1456
18;Granada;165;Pulianas;2291;1128;1163
18;Granada;167;Purullena;2757;1385;1372
18;Granada;168;Quéntar;1253;638;615
18;Granada;170;Rubite;554;293;261
18;Granada;171;Salar;2867;1428;1439
18;Granada;173;Salobreña;8926;4406;4520
18;Granada;174;Santa Cruz del Comercio;627;333;294
18;Granada;175;Santa Fe;11695;5703;5992
18;Granada;176;Soportújar;274;147;127
18;Granada;177;Sorvilán;1025;518;507
18;Granada;901;Taha (La);920;469;451
18;Granada;178;Torre-Cardela;1500;750;750
18;Granada;179;Torvizcón;1309;651;658
18;Granada;180;Trevélez;877;459;418
18;Granada;181;Turón;515;286;229
18;Granada;182;Ugíjar;3149;1536;1613
18;Granada;907;Valle del Zalabí;2657;1334;1323
18;Granada;902;Valle (El);1644;840;804
18;Granada;183;Válor;1202;607;595
18;Granada;911;Vegas del Genil;2595;1302;1293
18;Granada;184;Vélez de Benaudalla;2630;1324;1306
18;Granada;185;Ventas de Huelma;777;393;384
18;Granada;908;Villamena;1168;550;618
18;Granada;187;Villanueva de las Torres;1118;594;524
18;Granada;188;Villanueva Mesía;1814;901;913
18;Granada;189;Víznar;683;343;340
18;Granada;192;Zafarraya;2244;1134;1110
18;Granada;913;Zagra;1501;760;741
18;Granada;193;Zubia (La);7120;3535;3585
18;Granada;194;Zújar;3547;1803;1744
19;Guadalajara;001;Abánades;133;76;57
19;Guadalajara;002;Ablanque;167;90;77
19;Guadalajara;003;Adobes;33;15;18
19;Guadalajara;004;Alaminos;127;60;67
19;Guadalajara;005;Alarilla;109;58;51
19;Guadalajara;006;Albalate de Zorita;1074;565;509
19;Guadalajara;007;Albares;559;282;277
19;Guadalajara;008;Albendiego;74;40;34
19;Guadalajara;009;Alcocer;364;176;188
19;Guadalajara;010;Alcolea de las Peñas;47;28;19
19;Guadalajara;011;Alcolea del Pinar;561;287;274
19;Guadalajara;013;Alcoroches;188;103;85
19;Guadalajara;015;Aldeanueva de Guadalajara;126;65;61
19;Guadalajara;016;Algar de Mesa;105;53;52
19;Guadalajara;017;Algora;125;76;49
19;Guadalajara;018;Alhóndiga;310;169;141
19;Guadalajara;019;Alique;21;9;12
19;Guadalajara;020;Almadrones;133;83;50
19;Guadalajara;021;Almoguera;798;402;396
19;Guadalajara;022;Almonacid de Zorita;1017;545;472
19;Guadalajara;023;Alocén;133;65;68
19;Guadalajara;024;Alovera;1372;691;681
19;Guadalajara;027;Alustante;348;179;169
19;Guadalajara;031;Angón;36;21;15
19;Guadalajara;032;Anguita;412;211;201
19;Guadalajara;033;Anquela del Ducado;105;55;50
19;Guadalajara;034;Anquela del Pedregal;41;21;20
19;Guadalajara;036;Aranzueque;364;181;183
19;Guadalajara;037;Arbancón;236;133;103
19;Guadalajara;038;Arbeteta;55;32;23
19;Guadalajara;039;Argecilla;137;82;55
19;Guadalajara;040;Armallones;105;57;48
19;Guadalajara;041;Armuña de Tajuña;111;60;51
19;Guadalajara;042;Arroyo de las Fraguas;21;12;9
19;Guadalajara;043;Atanzón;126;69;57
19;Guadalajara;044;Atienza;539;285;254
19;Guadalajara;045;Auñón;284;151;133
19;Guadalajara;046;Azuqueca de Henares;10821;5469;5352
19;Guadalajara;047;Baides;92;50;42
19;Guadalajara;048;Baños de Tajo;37;25;12
19;Guadalajara;049;Bañuelos;48;25;23
19;Guadalajara;050;Barriopedro;27;11;16
19;Guadalajara;051;Berninches;131;80;51
19;Guadalajara;052;Bodera (La);60;35;25
19;Guadalajara;053;Brihuega;3521;1862;1659
19;Guadalajara;054;Budia;385;198;187
19;Guadalajara;055;Bujalaro;162;90;72
19;Guadalajara;057;Bustares;166;91;75
19;Guadalajara;058;Cabanillas del Campo;936;492;444
19;Guadalajara;059;Campillo de Dueñas;181;103;78
19;Guadalajara;060;Campillo de Ranas;90;43;47
19;Guadalajara;061;Campisábalos;81;40;41
19;Guadalajara;064;Canredondo;136;74;62
19;Guadalajara;065;Cantalojas;193;108;85
19;Guadalajara;066;Cañizar;131;70;61
19;Guadalajara;067;Cardoso de la Sierra (El);121;75;46
19;Guadalajara;070;Casa de Uceda;156;77;79
19;Guadalajara;071;Casar (El);1288;663;625
19;Guadalajara;073;Casas de San Galindo;39;21;18
19;Guadalajara;074;Caspueñas;57;29;28
19;Guadalajara;075;Castejón de Henares;145;77;68
19;Guadalajara;076;Castellar de la Muela;73;41;32
19;Guadalajara;078;Castilforte;47;24;23
19;Guadalajara;079;Castilnuevo;16;4;12
19;Guadalajara;080;Cendejas de Enmedio;174;85;89
19;Guadalajara;081;Cendejas de la Torre;166;97;69
19;Guadalajara;082;Centenera;103;56;47
19;Guadalajara;103;Checa;504;256;248
19;Guadalajara;104;Chequilla;34;18;16
19;Guadalajara;106;Chillarón del Rey;143;77;66
19;Guadalajara;105;Chiloeches;1043;540;503
19;Guadalajara;086;Cifuentes;2472;1296;1176
19;Guadalajara;087;Cincovillas;47;23;24
19;Guadalajara;088;Ciruelas;79;41;38
19;Guadalajara;089;Ciruelos del Pinar;101;52;49
19;Guadalajara;090;Cobeta;151;80;71
19;Guadalajara;091;Cogollor;77;41;36
19;Guadalajara;092;Cogolludo;702;374;328
19;Guadalajara;095;Condemios de Abajo;36;20;16
19;Guadalajara;096;Condemios de Arriba;232;124;108
19;Guadalajara;097;Congostrina;48;22;26
19;Guadalajara;098;Copernal;33;18;15
19;Guadalajara;099;Corduente;564;303;261
19;Guadalajara;102;Cubillo de Uceda (El);161;81;80
19;Guadalajara;107;Driebes;427;234;193
19;Guadalajara;108;Durón;104;59;45
19;Guadalajara;109;Embid;84;48;36
19;Guadalajara;110;Escamilla;180;97;83
19;Guadalajara;111;Escariche;260;128;132
19;Guadalajara;112;Escopete;65;28;37
19;Guadalajara;113;Espinosa de Henares;520;250;270
19;Guadalajara;114;Esplegares;87;48;39
19;Guadalajara;115;Establés;77;39;38
19;Guadalajara;116;Estriégana;38;18;20
19;Guadalajara;117;Fontanar;702;355;347
19;Guadalajara;118;Fuembellida;26;14;12
19;Guadalajara;119;Fuencemillán;145;75;70
19;Guadalajara;120;Fuentelahiguera de Albatages;252;122;130
19;Guadalajara;121;Fuentelencina;225;118;107
19;Guadalajara;122;Fuentelsaz;179;89;90
19;Guadalajara;123;Fuentelviejo;101;51;50
19;Guadalajara;124;Fuentenovilla;260;143;117
19;Guadalajara;125;Gajanejos;115;67;48
19;Guadalajara;126;Galápagos;209;115;94
19;Guadalajara;127;Galve de Sorbe;203;103;100
19;Guadalajara;129;Gascueña de Bornova;42;23;19
19;Guadalajara;130;Guadalajara;59080;29353;29727
19;Guadalajara;132;Henche;26;17;9
19;Guadalajara;133;Heras de Ayuso;137;72;65
19;Guadalajara;134;Herrería;47;22;25
19;Guadalajara;135;Hiendelaencina;205;115;90
19;Guadalajara;136;Hijes;31;18;13
19;Guadalajara;138;Hita;275;152;123
19;Guadalajara;139;Hombrados;76;40;36
19;Guadalajara;142;Hontoba;148;73;75
19;Guadalajara;143;Horche;1143;600;543
19;Guadalajara;145;Hortezuela de Océn;116;64;52
19;Guadalajara;146;Huerce (La);33;19;14
19;Guadalajara;147;Huérmeces del Cerro;66;39;27
19;Guadalajara;148;Huertahernando;80;47;33
19;Guadalajara;150;Hueva;162;89;73
19;Guadalajara;151;Humanes;1303;672;631
19;Guadalajara;152;Illana;739;376;363
19;Guadalajara;153;Iniéstola;28;16;12
19;Guadalajara;154;Inviernas (Las);122;70;52
19;Guadalajara;155;Irueste;91;46;45
19;Guadalajara;156;Jadraque;1258;632;626
19;Guadalajara;157;Jirueque;70;40;30
19;Guadalajara;159;Ledanca;218;112;106
19;Guadalajara;160;Loranca de Tajuña;312;165;147
19;Guadalajara;161;Lupiana;273;139;134
19;Guadalajara;162;Luzaga;154;69;85
19;Guadalajara;163;Luzón;118;61;57
19;Guadalajara;165;Majaelrayo;69;34;35
19;Guadalajara;166;Málaga del Fresno;256;137;119
19;Guadalajara;167;Malaguilla;219;121;98
19;Guadalajara;168;Mandayona;583;273;310
19;Guadalajara;169;Mantiel;24;11;13
19;Guadalajara;170;Maranchón;279;138;141
19;Guadalajara;171;Marchamalo;"";"";""
19;Guadalajara;172;Masegoso de Tajuña;140;71;69
19;Guadalajara;173;Matarrubia;50;31;19
19;Guadalajara;174;Matillas;317;157;160
19;Guadalajara;175;Mazarete;112;56;56
19;Guadalajara;176;Mazuecos;482;248;234
19;Guadalajara;177;Medranda;165;92;73
19;Guadalajara;178;Megina;92;43;49
19;Guadalajara;179;Membrillera;105;60;45
19;Guadalajara;181;Miedes de Atienza;183;93;90
19;Guadalajara;182;Mierla (La);37;22;15
19;Guadalajara;184;Millana;114;54;60
19;Guadalajara;183;Milmarcos;126;62;64
19;Guadalajara;185;Miñosa (La);79;43;36
19;Guadalajara;186;Mirabueno;140;77;63
19;Guadalajara;187;Miralrío;132;70;62
19;Guadalajara;188;Mochales;188;91;97
19;Guadalajara;189;Mohernando;145;87;58
19;Guadalajara;190;Molina de Aragón;3995;2045;1950
19;Guadalajara;191;Monasterio;18;9;9
19;Guadalajara;192;Mondéjar;2253;1113;1140
19;Guadalajara;193;Montarrón;90;48;42
19;Guadalajara;194;Moratilla de los Meleros;122;68;54
19;Guadalajara;195;Morenilla;74;45;29
19;Guadalajara;196;Muduex;143;77;66
19;Guadalajara;197;Navas de Jadraque (Las);32;17;15
19;Guadalajara;198;Negredo;27;11;16
19;Guadalajara;199;Ocentejo;55;24;31
19;Guadalajara;200;Olivar (El);51;28;23
19;Guadalajara;201;Olmeda de Cobeta;92;36;56
19;Guadalajara;202;Olmeda de Jadraque (La);13;8;5
19;Guadalajara;203;Ordial (El);62;23;39
19;Guadalajara;204;Orea;358;188;170
19;Guadalajara;208;Pálmaces de Jadraque;72;40;32
19;Guadalajara;209;Pardos;66;34;32
19;Guadalajara;210;Paredes de Sigüenza;89;45;44
19;Guadalajara;211;Pareja;522;261;261
19;Guadalajara;212;Pastrana;1304;656;648
19;Guadalajara;213;Pedregal (El);130;68;62
19;Guadalajara;214;Peñalén;194;95;99
19;Guadalajara;215;Peñalver;349;199;150
19;Guadalajara;216;Peralejos de las Truchas;191;102;89
19;Guadalajara;217;Peralveche;69;37;32
19;Guadalajara;218;Pinilla de Jadraque;100;53;47
19;Guadalajara;219;Pinilla de Molina;36;18;18
19;Guadalajara;220;Pioz;175;98;77
19;Guadalajara;221;Piqueras;32;20;12
19;Guadalajara;222;Pobo de Dueñas (El);209;112;97
19;Guadalajara;223;Poveda de la Sierra;193;96;97
19;Guadalajara;224;Pozo de Almoguera;249;127;122
19;Guadalajara;225;Pozo de Guadalajara;342;188;154
19;Guadalajara;226;Prádena de Atienza;57;33;24
19;Guadalajara;227;Prados Redondos;132;75;57
19;Guadalajara;228;Puebla de Beleña;40;23;17
19;Guadalajara;229;Puebla de Valles;76;44;32
19;Guadalajara;230;Quer;117;60;57
19;Guadalajara;231;Rebollosa de Jadraque;44;23;21
19;Guadalajara;232;Recuenco (El);161;82;79
19;Guadalajara;233;Renera;58;27;31
19;Guadalajara;234;Retiendas;44;24;20
19;Guadalajara;235;Riba de Saelices;197;110;87
19;Guadalajara;237;Rillo de Gallo;103;51;52
19;Guadalajara;238;Riofrío del Llano;114;62;52
19;Guadalajara;239;Robledillo de Mohernando;190;99;91
19;Guadalajara;240;Robledo de Corpes;109;52;57
19;Guadalajara;241;Romanillos de Atienza;93;53;40
19;Guadalajara;242;Romanones;197;109;88
19;Guadalajara;243;Rueda de la Sierra;102;52;50
19;Guadalajara;244;Sacecorbo;161;85;76
19;Guadalajara;245;Sacedón;1894;964;930
19;Guadalajara;246;Saelices de la Sal;85;41;44
19;Guadalajara;247;Salmerón;322;166;156
19;Guadalajara;248;San Andrés del Congosto;81;45;36
19;Guadalajara;249;San Andrés del Rey;52;25;27
19;Guadalajara;250;Santiuste;21;10;11
19;Guadalajara;251;Saúca;66;35;31
19;Guadalajara;252;Sayatón;212;107;105
19;Guadalajara;254;Selas;79;38;41
19;Guadalajara;901;Semillas;35;20;15
19;Guadalajara;255;Setiles;277;141;136
19;Guadalajara;256;Sienes;111;65;46
19;Guadalajara;257;Sigüenza;5238;2614;2624
19;Guadalajara;258;Solanillos del Extremo;130;65;65
19;Guadalajara;259;Somolinos;57;27;30
19;Guadalajara;260;Sotillo (El);56;36;20
19;Guadalajara;261;Sotodosos;89;44;45
19;Guadalajara;262;Tamajón;213;114;99
19;Guadalajara;263;Taragudo;33;18;15
19;Guadalajara;264;Taravilla;80;38;42
19;Guadalajara;265;Tartanedo;277;141;136
19;Guadalajara;266;Tendilla;439;236;203
19;Guadalajara;267;Terzaga;55;31;24
19;Guadalajara;268;Tierzo;52;26;26
19;Guadalajara;269;Toba (La);144;79;65
19;Guadalajara;271;Tordellego;120;58;62
19;Guadalajara;270;Tordelrábano;25;10;15
19;Guadalajara;272;Tordesilos;179;92;87
19;Guadalajara;274;Torija;394;201;193
19;Guadalajara;279;Torre del Burgo;58;30;28
19;Guadalajara;276;Torrecilla del Ducado;11;6;5
19;Guadalajara;277;Torrecuadrada de Molina;25;15;10
19;Guadalajara;278;Torrecuadradilla;98;56;42
19;Guadalajara;280;Torrejón del Rey;386;209;177
19;Guadalajara;281;Torremocha de Jadraque;19;13;6
19;Guadalajara;282;Torremocha del Campo;430;235;195
19;Guadalajara;283;Torremocha del Pinar;123;61;62
19;Guadalajara;284;Torremochuela;10;5;5
19;Guadalajara;285;Torrubia;60;30;30
19;Guadalajara;286;Tórtola de Henares;445;228;217
19;Guadalajara;287;Tortuera;324;163;161
19;Guadalajara;288;Tortuero;31;18;13
19;Guadalajara;289;Traíd;58;30;28
19;Guadalajara;290;Trijueque;308;159;149
19;Guadalajara;291;Trillo;1421;746;675
19;Guadalajara;293;Uceda;426;221;205
19;Guadalajara;294;Ujados;57;31;26
19;Guadalajara;296;Utande;92;53;39
19;Guadalajara;297;Valdarachas;30;14;16
19;Guadalajara;298;Valdearenas;78;39;39
19;Guadalajara;299;Valdeavellano;101;49;52
19;Guadalajara;300;Valdeaveruelo;118;63;55
19;Guadalajara;301;Valdeconcha;58;25;33
19;Guadalajara;302;Valdegrudas;80;41;39
19;Guadalajara;303;Valdelcubo;80;44;36
19;Guadalajara;304;Valdenuño Fernández;158;85;73
19;Guadalajara;305;Valdepeñas de la Sierra;324;174;150
19;Guadalajara;306;Valderrebollo;39;25;14
19;Guadalajara;307;Valdesotos;58;27;31
19;Guadalajara;308;Valfermoso de Tajuña;88;51;37
19;Guadalajara;309;Valhermoso;60;31;29
19;Guadalajara;310;Valtablado del Río;22;14;8
19;Guadalajara;311;Valverde de los Arroyos;84;43;41
19;Guadalajara;314;Viana de Jadraque;80;42;38
19;Guadalajara;317;Villanueva de Alcorón;390;210;180
19;Guadalajara;318;Villanueva de Argecilla;55;29;26
19;Guadalajara;319;Villanueva de la Torre;116;51;65
19;Guadalajara;321;Villares de Jadraque;48;24;24
19;Guadalajara;322;Villaseca de Henares;103;53;50
19;Guadalajara;323;Villaseca de Uceda;63;31;32
19;Guadalajara;324;Villel de Mesa;309;154;155
19;Guadalajara;325;Viñuelas;166;88;78
19;Guadalajara;326;Yebes;63;33;30
19;Guadalajara;327;Yebra;663;336;327
19;Guadalajara;329;Yélamos de Abajo;121;61;60
19;Guadalajara;330;Yélamos de Arriba;174;92;82
19;Guadalajara;331;Yunquera de Henares;1897;970;927
19;Guadalajara;332;Yunta (La);210;104;106
19;Guadalajara;333;Zaorejas;272;141;131
19;Guadalajara;334;Zarzuela de Jadraque;43;27;16
19;Guadalajara;335;Zorita de los Canes;105;52;53
20;Guipúzcoa;001;Abaltzisketa;290;156;134
20;Guipúzcoa;002;Aduna;351;186;165
20;Guipúzcoa;016;Aia;1771;1011;760
20;Guipúzcoa;003;Aizarnazabal;540;296;244
20;Guipúzcoa;004;Albiztur;316;172;144
20;Guipúzcoa;005;Alegia;1677;890;787
20;Guipúzcoa;006;Alkiza;266;151;115
20;Guipúzcoa;906;Altzaga;"";"";""
20;Guipúzcoa;007;Altzo;338;190;148
20;Guipúzcoa;008;Amezketa;1110;613;497
20;Guipúzcoa;009;Andoain;15961;7958;8003
20;Guipúzcoa;010;Anoeta;1899;944;955
20;Guipúzcoa;011;Antzuola;2130;1111;1019
20;Guipúzcoa;012;Arama;160;82;78
20;Guipúzcoa;013;Aretxabaleta;6005;3064;2941
20;Guipúzcoa;055;Arrasate/Mondragón;26367;13206;13161
20;Guipúzcoa;014;Asteasu;1284;705;579
20;Guipúzcoa;903;Astigarraga;"";"";""
20;Guipúzcoa;015;Ataun;1841;948;893
20;Guipúzcoa;017;Azkoitia;10704;5364;5340
20;Guipúzcoa;018;Azpeitia;13205;6674;6531
20;Guipúzcoa;904;Baliarrain;"";"";""
20;Guipúzcoa;019;Beasain;12408;6289;6119
20;Guipúzcoa;020;Beizama;175;93;82
20;Guipúzcoa;021;Belauntza;312;165;147
20;Guipúzcoa;022;Berastegi;958;537;421
20;Guipúzcoa;074;Bergara;15718;7831;7887
20;Guipúzcoa;023;Berrobi;594;327;267
20;Guipúzcoa;024;Bidegoyan;498;283;215
20;Guipúzcoa;029;Deba;4829;2485;2344
20;Guipúzcoa;069;Donostia/San Sebastián;175138;82266;92872
20;Guipúzcoa;030;Eibar;34537;17025;17512
20;Guipúzcoa;031;Elduain;263;148;115
20;Guipúzcoa;033;Elgeta;1041;533;508
20;Guipúzcoa;032;Elgoibar;12346;6281;6065
20;Guipúzcoa;067;Errenteria;43676;21784;21892
20;Guipúzcoa;066;Errezil;746;414;332
20;Guipúzcoa;034;Eskoriatza;4004;2090;1914
20;Guipúzcoa;035;Ezkio-Itsaso;590;303;287
20;Guipúzcoa;038;Gabiria;463;257;206
20;Guipúzcoa;037;Gaintza;126;74;52
20;Guipúzcoa;907;Gaztelu;"";"";""
20;Guipúzcoa;039;Getaria;2335;1171;1164
20;Guipúzcoa;040;Hernani;19096;9520;9576
20;Guipúzcoa;041;Hernialde;286;156;130
20;Guipúzcoa;036;Hondarribia;13042;6501;6541
20;Guipúzcoa;042;Ibarra;4570;2354;2216
20;Guipúzcoa;043;Idiazabal;2075;1051;1024
20;Guipúzcoa;044;Ikaztegieta;658;348;310
20;Guipúzcoa;045;Irún;54043;26507;27536
20;Guipúzcoa;046;Irura;655;321;334
20;Guipúzcoa;047;Itsasondo;783;395;388
20;Guipúzcoa;048;Larraul;164;101;63
20;Guipúzcoa;902;Lasarte-Oria;18589;9292;9297
20;Guipúzcoa;049;Lazkao;5250;2693;2557
20;Guipúzcoa;050;Leaburu;591;320;271
20;Guipúzcoa;051;Legazpi;10301;5337;4964
20;Guipúzcoa;052;Legorreta;1610;804;806
20;Guipúzcoa;068;Leintz-Gatzaga;207;111;96
20;Guipúzcoa;053;Lezo;5659;2785;2874
20;Guipúzcoa;054;Lizartza;732;392;340
20;Guipúzcoa;901;Mendaro;1584;801;783
20;Guipúzcoa;057;Mutiloa;196;98;98
20;Guipúzcoa;056;Mutriku;4628;2317;2311
20;Guipúzcoa;063;Oiartzun;8042;4006;4036
20;Guipúzcoa;058;Olaberria;1267;646;621
20;Guipúzcoa;076;Ordizia;9448;4638;4810
20;Guipúzcoa;905;Orendain;"";"";""
20;Guipúzcoa;060;Orexa;83;43;40
20;Guipúzcoa;061;Orio;4290;2182;2108
20;Guipúzcoa;062;Ormaiztegi;1292;639;653
20;Guipúzcoa;059;Oñati;10884;5460;5424
20;Guipúzcoa;064;Pasaia;19552;9594;9958
20;Guipúzcoa;070;Segura;1391;702;689
20;Guipúzcoa;065;Soraluze/Placencia de las Armas;5277;2643;2634
20;Guipúzcoa;071;Tolosa;18399;8885;9514
20;Guipúzcoa;072;Urnieta;4440;2277;2163
20;Guipúzcoa;077;Urretxu;6450;3323;3127
20;Guipúzcoa;073;Usurbil;5606;2874;2732
20;Guipúzcoa;075;Villabona;5310;2695;2615
20;Guipúzcoa;078;Zaldibia;1705;898;807
20;Guipúzcoa;079;Zarautz;16404;8173;8231
20;Guipúzcoa;025;Zegama;1464;744;720
20;Guipúzcoa;026;Zerain;233;112;121
20;Guipúzcoa;027;Zestoa;3592;1881;1711
20;Guipúzcoa;028;Zizurkil;2751;1393;1358
20;Guipúzcoa;081;Zumaia;8064;4039;4025
20;Guipúzcoa;080;Zumarraga;11587;5851;5736
21;Huelva;001;Alájar;908;450;458
21;Huelva;002;Aljaraque;5390;2678;2712
21;Huelva;003;Almendro (El);889;460;429
21;Huelva;004;Almonaster la Real;2377;1166;1211
21;Huelva;005;Almonte;14604;7339;7265
21;Huelva;006;Alosno;5045;2446;2599
21;Huelva;007;Aracena;6331;3057;3274
21;Huelva;008;Aroche;3845;1884;1961
21;Huelva;009;Arroyomolinos de León;1320;651;669
21;Huelva;010;Ayamonte;16745;8308;8437
21;Huelva;011;Beas;4010;1995;2015
21;Huelva;012;Berrocal;446;229;217
21;Huelva;013;Bollullos Par del Condado;12304;6121;6183
21;Huelva;014;Bonares;4872;2456;2416
21;Huelva;015;Cabezas Rubias;960;496;464
21;Huelva;016;Cala;1558;780;778
21;Huelva;017;Calañas;5371;2632;2739
21;Huelva;018;Campillo (El);2912;1422;1490
21;Huelva;019;Campofrío;923;471;452
21;Huelva;020;Cañaveral de León;603;287;316
21;Huelva;021;Cartaya;9867;4934;4933
21;Huelva;022;Castaño del Robledo;211;109;102
21;Huelva;023;Cerro de Andévalo (El);3082;1523;1559
21;Huelva;030;Chucena;1914;980;934
21;Huelva;024;Corteconcepción;724;373;351
21;Huelva;025;Cortegana;5474;2673;2801
21;Huelva;026;Cortelazor;378;186;192
21;Huelva;027;Cumbres de Enmedio;61;29;32
21;Huelva;028;Cumbres de San Bartolomé;763;386;377
21;Huelva;029;Cumbres Mayores;2491;1194;1297
21;Huelva;031;Encinasola;2431;1180;1251
21;Huelva;032;Escacena del Campo;2229;1106;1123
21;Huelva;033;Fuenteheridos;645;317;328
21;Huelva;034;Galaroza;1694;816;878
21;Huelva;035;Gibraleón;9733;4887;4846
21;Huelva;036;Granada de Río-Tinto (La);225;123;102
21;Huelva;037;Granado (El);717;373;344
21;Huelva;038;Higuera de la Sierra;1439;707;732
21;Huelva;039;Hinojales;499;251;248
21;Huelva;040;Hinojos;3421;1747;1674
21;Huelva;041;Huelva;135210;65443;69767
21;Huelva;042;Isla Cristina;15535;7727;7808
21;Huelva;043;Jabugo;2544;1241;1303
21;Huelva;044;Lepe;15223;7719;7504
21;Huelva;045;Linares de la Sierra;281;137;144
21;Huelva;046;Lucena del Puerto;1988;996;992
21;Huelva;047;Manzanilla;2471;1234;1237
21;Huelva;048;Marines (Los);373;185;188
21;Huelva;049;Minas de Riotinto;6220;2954;3266
21;Huelva;050;Moguer;11009;5570;5439
21;Huelva;051;Nava (La);387;189;198
21;Huelva;052;Nerva;7336;3570;3766
21;Huelva;053;Niebla;3941;2004;1937
21;Huelva;054;Palma del Condado (La);9252;4597;4655
21;Huelva;055;Palos de la Frontera;6406;3232;3174
21;Huelva;056;Paterna del Campo;3790;2001;1789
21;Huelva;057;Paymogo;1538;736;802
21;Huelva;058;Puebla de Guzmán;3383;1706;1677
21;Huelva;059;Puerto Moral;239;111;128
21;Huelva;060;Punta Umbría;9526;4791;4735
21;Huelva;061;Rociana del Condado;6153;3150;3003
21;Huelva;062;Rosal de la Frontera;2073;997;1076
21;Huelva;063;San Bartolomé de la Torre;2745;1401;1344
21;Huelva;064;San Juan del Puerto;5419;2709;2710
21;Huelva;066;San Silvestre de Guzmán;774;380;394
21;Huelva;065;Sanlúcar de Guadiana;445;215;230
21;Huelva;067;Santa Ana la Real;578;274;304
21;Huelva;068;Santa Bárbara de Casa;1580;781;799
21;Huelva;069;Santa Olalla del Cala;2425;1208;1217
21;Huelva;070;Trigueros;6962;3481;3481
21;Huelva;071;Valdelarco;340;157;183
21;Huelva;072;Valverde del Camino;11911;5728;6183
21;Huelva;073;Villablanca;1927;990;937
21;Huelva;074;Villalba del Alcor;3770;1875;1895
21;Huelva;075;Villanueva de las Cruces;484;237;247
21;Huelva;076;Villanueva de los Castillejos;2686;1335;1351
21;Huelva;077;Villarrasa;2246;1148;1098
21;Huelva;078;Zalamea la Real;3913;1921;1992
21;Huelva;079;Zufre;1501;782;719
22;Huesca;001;Abiego;349;182;167
22;Huesca;002;Abizanda;117;67;50
22;Huesca;003;Adahuesca;191;99;92
22;Huesca;004;Agüero;191;104;87
22;Huesca;907;Aínsa-Sobrarbe;1338;697;641
22;Huesca;006;Aisa;294;150;144
22;Huesca;007;Albalate de Cinca;1265;653;612
22;Huesca;008;Albalatillo;299;150;149
22;Huesca;009;Albelda;1121;577;544
22;Huesca;011;Albero Alto;120;58;62
22;Huesca;012;Albero Bajo;145;75;70
22;Huesca;013;Alberuela de Tubo;469;242;227
22;Huesca;014;Alcalá de Gurrea;465;234;231
22;Huesca;015;Alcalá del Obispo;447;220;227
22;Huesca;016;Alcampell;1228;627;601
22;Huesca;017;Alcolea de Cinca;1219;615;604
22;Huesca;018;Alcubierre;550;283;267
22;Huesca;019;Alerre;137;67;70
22;Huesca;020;Alfántega;139;75;64
22;Huesca;021;Almudévar;2550;1337;1213
22;Huesca;022;Almunia de San Juan;802;396;406
22;Huesca;023;Almuniente;718;364;354
22;Huesca;024;Alquézar;283;141;142
22;Huesca;025;Altorricón;1608;855;753
22;Huesca;027;Angüés;554;298;256
22;Huesca;028;Ansó;547;281;266
22;Huesca;029;Antillón;182;87;95
22;Huesca;032;Aragüés del Puerto;126;83;43
22;Huesca;035;Arén;457;245;212
22;Huesca;036;Argavieso;129;74;55
22;Huesca;037;Arguis;55;29;26
22;Huesca;039;Ayerbe;1328;668;660
22;Huesca;040;Azanuy-Alins;292;143;149
22;Huesca;041;Azara;237;121;116
22;Huesca;042;Azlor;214;114;100
22;Huesca;043;Baélls;209;110;99
22;Huesca;044;Bailo;387;221;166
22;Huesca;045;Baldellou;214;113;101
22;Huesca;046;Ballobar;1232;609;623
22;Huesca;047;Banastás;102;47;55
22;Huesca;048;Barbastro;14970;7354;7616
22;Huesca;049;Barbués;130;61;69
22;Huesca;050;Barbuñales;124;67;57
22;Huesca;051;Bárcabo;116;68;48
22;Huesca;052;Belver de Cinca;1619;844;775
22;Huesca;053;Benabarre;1277;684;593
22;Huesca;054;Benasque;863;456;407
22;Huesca;055;Berbegal;552;266;286
22;Huesca;057;Bielsa;465;237;228
22;Huesca;058;Bierge;222;119;103
22;Huesca;059;Biescas;1252;655;597
22;Huesca;060;Binaced;1706;867;839
22;Huesca;061;Binéfar;8004;4040;3964
22;Huesca;062;Bisaurri;285;169;116
22;Huesca;063;Biscarrués;263;137;126
22;Huesca;064;Blecua y Torres;232;117;115
22;Huesca;066;Boltaña;904;443;461
22;Huesca;067;Bonansa;65;37;28
22;Huesca;068;Borau;76;42;34
22;Huesca;069;Broto;490;248;242
22;Huesca;072;Caldearenas;344;178;166
22;Huesca;074;Campo;424;200;224
22;Huesca;075;Camporrélls;340;154;186
22;Huesca;076;Canal de Berdún;504;259;245
22;Huesca;077;Candasnos;699;363;336
22;Huesca;078;Canfranc;560;298;262
22;Huesca;079;Capdesaso;217;110;107
22;Huesca;080;Capella;481;246;235
22;Huesca;081;Casbas de Huesca;359;187;172
22;Huesca;083;Castejón de Monegros;866;432;434
22;Huesca;084;Castejón de Sos;437;219;218
22;Huesca;082;Castejón del Puente;430;208;222
22;Huesca;085;Castelflorite;180;92;88
22;Huesca;086;Castiello de Jaca;171;80;91
22;Huesca;087;Castigaleu;96;53;43
22;Huesca;088;Castillazuelo;276;147;129
22;Huesca;089;Castillonroy;471;236;235
22;Huesca;094;Chalamera;182;102;80
22;Huesca;095;Chía;139;78;61
22;Huesca;096;Chimillas;150;81;69
22;Huesca;090;Colungo;161;80;81
22;Huesca;099;Esplús;1515;747;768
22;Huesca;102;Estada;236;120;116
22;Huesca;103;Estadilla;1060;543;517
22;Huesca;105;Estopiñán del Castillo;209;106;103
22;Huesca;106;Fago;52;32;20
22;Huesca;107;Fanlo;43;29;14
22;Huesca;109;Fiscal;315;172;143
22;Huesca;110;Fonz;1349;672;677
22;Huesca;111;Foradada del Toscar;289;149;140
22;Huesca;112;Fraga;11431;5743;5688
22;Huesca;113;Fueva (La);711;395;316
22;Huesca;114;Gistaín;"";"";""
22;Huesca;115;Grado (El);608;313;295
22;Huesca;116;Grañén;2408;1223;1185
22;Huesca;117;Graus;3494;1773;1721
22;Huesca;119;Gurrea de Gállego;2117;1071;1046
22;Huesca;122;Hoz de Jaca;85;35;50
22;Huesca;908;Hoz y Costean;306;168;138
22;Huesca;124;Huerto;352;189;163
22;Huesca;125;Huesca;40736;19799;20937
22;Huesca;126;Ibieca;130;68;62
22;Huesca;127;Igriés;161;93;68
22;Huesca;128;Ilche;325;167;158
22;Huesca;129;Isábena;317;173;144
22;Huesca;130;Jaca;10623;5269;5354
22;Huesca;131;Jasa;118;64;54
22;Huesca;133;Labuerda;185;95;90
22;Huesca;135;Laluenga;339;180;159
22;Huesca;136;Lalueza;1469;803;666
22;Huesca;137;Lanaja;1941;996;945
22;Huesca;139;Laperdiguera;109;59;50
22;Huesca;141;Lascellas-Ponzano;210;104;106
22;Huesca;142;Lascuarre;180;89;91
22;Huesca;143;Laspaúles;334;192;142
22;Huesca;144;Laspuña;290;157;133
22;Huesca;149;Loarre;441;235;206
22;Huesca;150;Loporzano;456;232;224
22;Huesca;151;Loscorrales;144;77;67
22;Huesca;905;Lupiñén-Ortilla;413;222;191
22;Huesca;155;Monesma y Cajigar;113;53;60
22;Huesca;156;Monflorite-Lascasas;193;101;92
22;Huesca;157;Montanuy;380;221;159
22;Huesca;158;Monzón;14645;7417;7228
22;Huesca;160;Naval;288;143;145
22;Huesca;162;Novales;220;102;118
22;Huesca;163;Nueno;217;117;100
22;Huesca;164;Olvena;62;33;29
22;Huesca;165;Ontiñena;752;382;370
22;Huesca;167;Osso de Cinca;766;398;368
22;Huesca;168;Palo;41;24;17
22;Huesca;170;Panticosa;547;295;252
22;Huesca;172;Peñalba;817;396;421
22;Huesca;173;Peñas de Riglos (Las);345;191;154
22;Huesca;174;Peralta de Alcofea;844;409;435
22;Huesca;175;Peralta de Calasanz;441;236;205
22;Huesca;176;Peraltilla;180;96;84
22;Huesca;177;Perarrúa;170;85;85
22;Huesca;178;Pertusa;156;78;78
22;Huesca;181;Piracés;114;67;47
22;Huesca;182;Plan;544;301;243
22;Huesca;184;Poleñino;293;148;145
22;Huesca;186;Pozán de Vero;294;150;144
22;Huesca;187;Puebla de Castro (La);300;144;156
22;Huesca;188;Puente de Montañana;165;89;76
22;Huesca;902;Puente la Reina de Jaca;305;156;149
22;Huesca;189;Puértolas;202;114;88
22;Huesca;190;Pueyo de Araguás (El);169;100;69
22;Huesca;193;Pueyo de Santa Cruz;418;217;201
22;Huesca;195;Quicena;120;57;63
22;Huesca;197;Robres;795;399;396
22;Huesca;199;Sabiñánigo;9000;4647;4353
22;Huesca;200;Sahún;327;175;152
22;Huesca;201;Salas Altas;449;232;217
22;Huesca;202;Salas Bajas;235;113;122
22;Huesca;203;Salillas;151;76;75
22;Huesca;204;Sallent de Gállego;911;460;451
22;Huesca;205;San Esteban de Litera;817;395;422
22;Huesca;207;San Juan de Plan;171;100;71
22;Huesca;903;San Miguel del Cinca;968;513;455
22;Huesca;206;Sangarrén;322;161;161
22;Huesca;208;Santa Cilia;220;119;101
22;Huesca;209;Santa Cruz de la Serós;144;85;59
22;Huesca;906;Santa María de Dulcis;254;123;131
22;Huesca;212;Santaliestra y San Quílez;120;60;60
22;Huesca;213;Sariñena;4455;2240;2215
22;Huesca;214;Secastilla;216;95;121
22;Huesca;215;Seira;220;105;115
22;Huesca;217;Sena;725;372;353
22;Huesca;218;Senés de Alcubierre;74;35;39
22;Huesca;220;Sesa;329;167;162
22;Huesca;221;Sesué;77;43;34
22;Huesca;222;Siétamo;382;202;180
22;Huesca;223;Sopeira;157;86;71
22;Huesca;904;Sotonera (La);1421;735;686
22;Huesca;225;Tamarite de Litera;4138;2065;2073
22;Huesca;226;Tardienta;1326;678;648
22;Huesca;227;Tella-Sin;381;199;182
22;Huesca;228;Tierz;208;106;102
22;Huesca;229;Tolva;283;150;133
22;Huesca;230;Torla;349;194;155
22;Huesca;232;Torralba de Aragón;172;78;94
22;Huesca;233;Torre la Ribera;125;73;52
22;Huesca;234;Torrente de Cinca;1240;630;610
22;Huesca;235;Torres de Alcanadre;158;95;63
22;Huesca;236;Torres de Barbués;467;249;218
22;Huesca;239;Tramaced;147;85;62
22;Huesca;242;Valfarta;114;58;56
22;Huesca;243;Valle de Bardají;73;37;36
22;Huesca;901;Valle de Hecho;1061;565;496
22;Huesca;244;Valle de Lierp;69;37;32
22;Huesca;245;Velilla de Cinca;556;274;282
22;Huesca;909;Vencillón;"";"";""
22;Huesca;246;Veracruz;131;72;59
22;Huesca;247;Viacamp y Litera;52;31;21
22;Huesca;248;Vicién;135;77;58
22;Huesca;249;Villanova;106;53;53
22;Huesca;250;Villanúa;199;108;91
22;Huesca;251;Villanueva de Sigena;521;273;248
22;Huesca;252;Yebra de Basa;206;109;97
22;Huesca;253;Yésero;58;27;31
22;Huesca;254;Zaidín;1865;934;931
23;Jaén;001;Albanchez de Mágina;1851;906;945
23;Jaén;002;Alcalá la Real;20289;10109;10180
23;Jaén;003;Alcaudete;11902;5919;5983
23;Jaén;004;Aldeaquemada;658;335;323
23;Jaén;005;Andújar;35479;17566;17913
23;Jaén;006;Arjona;6038;3039;2999
23;Jaén;007;Arjonilla;3944;1984;1960
23;Jaén;008;Arquillos;1872;963;909
23;Jaén;009;Baeza;14630;7118;7512
23;Jaén;010;Bailén;16019;8077;7942
23;Jaén;011;Baños de la Encina;2787;1408;1379
23;Jaén;012;Beas de Segura;8716;4390;4326
23;Jaén;902;Bedmar y Garcíez;4045;2031;2014
23;Jaén;014;Begíjar;3135;1565;1570
23;Jaén;015;Bélmez de la Moraleda;2100;1043;1057
23;Jaén;016;Benatae;767;379;388
23;Jaén;017;Cabra del Santo Cristo;2644;1371;1273
23;Jaén;018;Cambil;4019;2064;1955
23;Jaén;019;Campillo de Arenas;2415;1234;1181
23;Jaén;020;Canena;2109;1013;1096
23;Jaén;021;Carboneros;766;376;390
23;Jaén;901;Cárcheles;1678;812;866
23;Jaén;024;Carolina (La);15006;7326;7680
23;Jaén;025;Castellar;3655;1820;1835
23;Jaén;026;Castillo de Locubín;6080;3021;3059
23;Jaén;027;Cazalilla;962;496;466
23;Jaén;028;Cazorla;9253;4553;4700
23;Jaén;029;Chiclana de Segura;2215;1108;1107
23;Jaén;030;Chilluévar;2098;1052;1046
23;Jaén;031;Escañuela;1062;546;516
23;Jaén;032;Espelúy;859;421;438
23;Jaén;033;Frailes;2012;1008;1004
23;Jaén;034;Fuensanta de Martos;3650;1794;1856
23;Jaén;035;Fuerte del Rey;1176;582;594
23;Jaén;037;Génave;873;431;442
23;Jaén;038;Guardia de Jaén (La);1824;936;888
23;Jaén;039;Guarromán;3157;1562;1595
23;Jaén;041;Higuera de Calatrava;817;430;387
23;Jaén;042;Hinojares;762;386;376
23;Jaén;043;Hornos;871;457;414
23;Jaén;044;Huelma;6009;2989;3020
23;Jaén;045;Huesa;2899;1446;1453
23;Jaén;046;Ibros;3252;1621;1631
23;Jaén;047;Iruela (La);2374;1197;1177
23;Jaén;048;Iznatoraf;1422;687;735
23;Jaén;049;Jabalquinto;2765;1377;1388
23;Jaén;050;Jaén;102933;49715;53218
23;Jaén;051;Jamilena;3079;1563;1516
23;Jaén;052;Jimena;1891;940;951
23;Jaén;053;Jódar;12048;6039;6009
23;Jaén;040;Lahiguera;1956;969;987
23;Jaén;054;Larva;803;416;387
23;Jaén;055;Linares;57401;28141;29260
23;Jaén;056;Lopera;3921;1940;1981
23;Jaén;057;Lupión;1259;596;663
23;Jaén;058;Mancha Real;8090;3994;4096
23;Jaén;059;Marmolejo;7305;3666;3639
23;Jaén;060;Martos;21893;10734;11159
23;Jaén;061;Mengíbar;8149;4063;4086
23;Jaén;062;Montizón;2129;1070;1059
23;Jaén;063;Navas de San Juan;5424;2671;2753
23;Jaén;064;Noalejo;2438;1247;1191
23;Jaén;065;Orcera;2540;1303;1237
23;Jaén;066;Peal de Becerro;5499;2748;2751
23;Jaén;067;Pegalajar;3294;1607;1687
23;Jaén;069;Porcuna;7335;3650;3685
23;Jaén;070;Pozo Alcón;6093;3069;3024
23;Jaén;071;Puente de Génave;2153;1090;1063
23;Jaén;072;Puerta de Segura (La);3129;1573;1556
23;Jaén;073;Quesada;7389;3710;3679
23;Jaén;074;Rus;3624;1810;1814
23;Jaén;075;Sabiote;4532;2230;2302
23;Jaén;076;Santa Elena;1077;547;530
23;Jaén;077;Santiago de Calatrava;1120;564;556
23;Jaén;904;Santiago-Pontones;5532;2835;2697
23;Jaén;079;Santisteban del Puerto;5099;2563;2536
23;Jaén;080;Santo Tomé;2944;1477;1467
23;Jaén;081;Segura de la Sierra;2681;1398;1283
23;Jaén;082;Siles;2888;1437;1451
23;Jaén;084;Sorihuela del Guadalimar;1512;773;739
23;Jaén;086;Torre del Campo;11028;5424;5604
23;Jaén;085;Torreblascopedro;3328;1675;1653
23;Jaén;087;Torredonjimeno;13330;6519;6811
23;Jaén;088;Torreperogil;7763;3789;3974
23;Jaén;090;Torres;2176;1097;1079
23;Jaén;091;Torres de Albánchez;1237;625;612
23;Jaén;092;Úbeda;30451;14933;15518
23;Jaén;093;Valdepeñas de Jaén;5046;2559;2487
23;Jaén;094;Vilches;5358;2686;2672
23;Jaén;095;Villacarrillo;12120;6033;6087
23;Jaén;096;Villanueva de la Reina;3578;1783;1795
23;Jaén;097;Villanueva del Arzobispo;8915;4395;4520
23;Jaén;098;Villardompardo;1310;638;672
23;Jaén;099;Villares (Los);4276;2104;2172
23;Jaén;101;Villarrodrigo;940;485;455
23;Jaén;903;Villatorres;3917;1973;1944
24;León;001;Acebedo;425;215;210
24;León;002;Algadefe;462;238;224
24;León;003;Alija del Infantado;1308;663;645
24;León;004;Almanza;974;485;489
24;León;005;Antigua (La);907;468;439
24;León;006;Ardón;846;441;405
24;León;007;Arganza;1241;602;639
24;León;008;Astorga;12524;5987;6537
24;León;009;Balboa;805;394;411
24;León;010;Bañeza (La);9083;4384;4699
24;León;011;Barjas;789;428;361
24;León;012;Barrios de Luna (Los);453;225;228
24;León;014;Bembibre;10241;5187;5054
24;León;015;Benavides;3429;1796;1633
24;León;016;Benuza;1005;527;478
24;León;017;Bercianos del Páramo;1125;559;566
24;León;018;Bercianos del Real Camino;325;171;154
24;León;019;Berlanga del Bierzo;524;252;272
24;León;020;Boca de Huérgano;829;437;392
24;León;021;Boñar;3141;1557;1584
24;León;022;Borrenes;723;368;355
24;León;023;Brazuelo;368;188;180
24;León;024;Burgo Ranero (El);1296;660;636
24;León;025;Burón;643;338;305
24;León;026;Bustillo del Páramo;2395;1222;1173
24;León;027;Cabañas Raras;1194;623;571
24;León;028;Cabreros del Río;764;389;375
24;León;029;Cabrillanes;1495;748;747
24;León;030;Cacabelos;4655;2369;2286
24;León;031;Calzada del Coto;396;220;176
24;León;032;Campazas;196;96;100
24;León;033;Campo de Villavidel;492;255;237
24;León;034;Camponaraya;3052;1508;1544
24;León;036;Candín;604;326;278
24;León;037;Cármenes;627;286;341
24;León;038;Carracedelo;3509;1787;1722
24;León;039;Carrizo;2815;1452;1363
24;León;040;Carrocera;806;394;412
24;León;041;Carucedo;826;389;437
24;León;042;Castilfalé;146;75;71
24;León;043;Castrillo de Cabrera;461;237;224
24;León;044;Castrillo de la Valduerna;356;173;183
24;León;046;Castrocalbón;1571;775;796
24;León;047;Castrocontrigo;1500;758;742
24;León;049;Castropodame;2026;1006;1020
24;León;050;Castrotierra de Valmadrigal;201;107;94
24;León;051;Cea;985;510;475
24;León;052;Cebanico;373;202;171
24;León;053;Cebrones del Río;969;493;476
24;León;065;Chozas de Abajo;2369;1231;1138
24;León;054;Cimanes de la Vega;816;395;421
24;León;055;Cimanes del Tejar;1323;672;651
24;León;056;Cistierna;5333;2677;2656
24;León;057;Congosto;2156;1053;1103
24;León;058;Corbillos de los Oteros;452;217;235
24;León;059;Corullón;1807;902;905
24;León;060;Crémenes;1720;841;879
24;León;061;Cuadros;1890;885;1005
24;León;062;Cubillas de los Oteros;278;129;149
24;León;063;Cubillas de Rueda;851;425;426
24;León;064;Cubillos del Sil;1145;597;548
24;León;066;Destriana;1206;573;633
24;León;067;Encinedo;1241;660;581
24;León;068;Ercina (La);1044;510;534
24;León;069;Escobar de Campos;113;65;48
24;León;070;Fabero;7031;3534;3497
24;León;071;Folgoso de la Ribera;1791;905;886
24;León;072;Fresnedo;572;288;284
24;León;073;Fresno de la Vega;853;410;443
24;León;074;Fuentes de Carbajal;193;107;86
24;León;076;Garrafe de Torío;1178;578;600
24;León;077;Gordaliza del Pino;487;242;245
24;León;078;Gordoncillo;780;380;400
24;León;079;Gradefes;1690;824;866
24;León;080;Grajal de Campos;440;196;244
24;León;081;Gusendos de los Oteros;323;160;163
24;León;082;Hospital de Órbigo;1201;601;600
24;León;083;Igüeña;2774;1495;1279
24;León;084;Izagre;480;227;253
24;León;086;Joarilla de las Matas;550;291;259
24;León;087;Laguna Dalga;1179;587;592
24;León;088;Laguna de Negrillos;2034;1036;998
24;León;089;León;134641;63991;70650
24;León;092;Llamas de la Ribera;1584;805;779
24;León;090;Lucillo;628;330;298
24;León;091;Luyego;1109;532;577
24;León;093;Magaz de Cepeda;753;362;391
24;León;094;Mansilla de las Mulas;1816;906;910
24;León;095;Mansilla Mayor;531;260;271
24;León;096;Maraña;256;132;124
24;León;097;Matadeón de los Oteros;386;204;182
24;León;098;Matallana de Torío;2130;1044;1086
24;León;099;Matanza;479;235;244
24;León;100;Molinaseca;751;385;366
24;León;101;Murias de Paredes;1029;486;543
24;León;102;Noceda del Bierzo;1181;580;601
24;León;103;Oencia;628;332;296
24;León;104;Omañas (Las);558;271;287
24;León;105;Onzonilla;1341;662;679
24;León;106;Oseja de Sajambre;453;232;221
24;León;107;Pajares de los Oteros;527;276;251
24;León;108;Palacios de la Valduerna;710;363;347
24;León;109;Palacios del Sil;2044;1044;1000
24;León;110;Páramo del Sil;2542;1282;1260
24;León;111;Pedrosa del Rey;170;89;81
24;León;112;Peranzanes;517;268;249
24;León;113;Pobladura de Pelayo García;857;429;428
24;León;114;Pola de Gordón (La);6824;3346;3478
24;León;115;Ponferrada;59258;29232;30026
24;León;116;Posada de Valdeón;635;328;307
24;León;117;Pozuelo del Páramo;854;446;408
24;León;118;Prado de la Guzpeña;234;126;108
24;León;119;Priaranza del Bierzo;1144;598;546
24;León;120;Prioro;639;328;311
24;León;121;Puebla de Lillo;832;432;400
24;León;122;Puente de Domingo Flórez;2117;1126;991
24;León;123;Quintana del Castillo;1498;765;733
24;León;124;Quintana del Marco;772;402;370
24;León;125;Quintana y Congosto;1092;560;532
24;León;127;Regueras de Arriba;509;281;228
24;León;129;Reyero;240;128;112
24;León;130;Riaño;918;470;448
24;León;131;Riego de la Vega;1421;705;716
24;León;132;Riello;1407;684;723
24;León;133;Rioseco de Tapia;705;375;330
24;León;134;Robla (La);5526;2790;2736
24;León;136;Roperuelos del Páramo;1074;547;527
24;León;137;Sabero;2901;1469;1432
24;León;139;Sahagún;3499;1738;1761
24;León;141;San Adrián del Valle;253;120;133
24;León;142;San Andrés del Rabanedo;15803;7682;8121
24;León;144;San Cristóbal de la Polantera;1491;756;735
24;León;145;San Emiliano;1201;587;614
24;León;146;San Esteban de Nogales;572;267;305
24;León;148;San Justo de la Vega;2617;1314;1303
24;León;149;San Millán de los Caballeros;242;120;122
24;León;150;San Pedro Bercianos;462;238;224
24;León;143;Sancedo;705;361;344
24;León;151;Santa Colomba de Curueño;811;400;411
24;León;152;Santa Colomba de Somoza;657;328;329
24;León;153;Santa Cristina de Valmadrigal;499;260;239
24;León;154;Santa Elena de Jamuz;1601;811;790
24;León;155;Santa María de la Isla;884;467;417
24;León;158;Santa María de Ordás;609;304;305
24;León;156;Santa María del Monte de Cea;581;289;292
24;León;157;Santa María del Páramo;3026;1473;1553
24;León;159;Santa Marina del Rey;3070;1539;1531
24;León;160;Santas Martas;1362;691;671
24;León;161;Santiago Millas;431;212;219
24;León;162;Santovenia de la Valdoncina;1268;602;666
24;León;163;Sariegos;1599;793;806
24;León;164;Sena de Luna;680;325;355
24;León;165;Sobrado;725;368;357
24;León;166;Soto de la Vega;2291;1165;1126
24;León;167;Soto y Amío;1301;626;675
24;León;168;Toral de los Guzmanes;855;442;413
24;León;169;Toreno;5542;2898;2644
24;León;170;Torre del Bierzo;4161;2123;2038
24;León;171;Trabadelo;835;436;399
24;León;172;Truchas;1459;719;740
24;León;173;Turcia;1818;936;882
24;León;174;Urdiales del Páramo;1087;546;541
24;León;185;Val de San Lorenzo;909;441;468
24;León;175;Valdefresno;1617;801;816
24;León;176;Valdefuentes del Páramo;571;303;268
24;León;177;Valdelugueros;537;274;263
24;León;178;Valdemora;166;86;80
24;León;179;Valdepiélago;526;259;267
24;León;180;Valdepolo;1984;1063;921
24;León;181;Valderas;2616;1308;1308
24;León;182;Valderrey;902;439;463
24;León;183;Valderrueda;1829;907;922
24;León;184;Valdesamario;402;200;202
24;León;187;Valdevimbre;1487;758;729
24;León;188;Valencia de Don Juan;3770;1890;1880
24;León;191;Vallecillo;247;130;117
24;León;189;Valverde de la Virgen;3396;1741;1655
24;León;190;Valverde-Enrique;324;157;167
24;León;193;Vecilla (La);552;274;278
24;León;196;Vega de Espinareda;3649;1856;1793
24;León;197;Vega de Infanzones;1000;501;499
24;León;198;Vega de Valcarce;1411;717;694
24;León;194;Vegacervera;374;195;179
24;León;199;Vegaquemada;747;366;381
24;León;201;Vegas del Condado;1807;901;906
24;León;202;Villablino;15491;7863;7628
24;León;203;Villabraz;240;127;113
24;León;205;Villadangos del Páramo;1058;519;539
24;León;206;Villadecanes;2634;1305;1329
24;León;207;Villademor de la Vega;598;308;290
24;León;209;Villafranca del Bierzo;5354;2691;2663
24;León;210;Villagatón;1328;691;637
24;León;211;Villamandos;635;308;327
24;León;901;Villamanín;1879;957;922
24;León;212;Villamañán;1662;832;830
24;León;213;Villamartín de Don Sancho;275;140;135
24;León;214;Villamejil;1271;662;609
24;León;215;Villamol;350;170;180
24;León;216;Villamontán de la Valduerna;1556;800;756
24;León;217;Villamoratiel de las Matas;301;161;140
24;León;218;Villanueva de las Manzanas;804;378;426
24;León;219;Villaobispo de Otero;866;450;416
24;León;902;Villaornate y Castro;666;334;332
24;León;221;Villaquejida;1258;641;617
24;León;222;Villaquilambre;4391;2163;2228
24;León;223;Villarejo de Órbigo;3764;1851;1913
24;León;224;Villares de Órbigo;1213;618;595
24;León;225;Villasabariego;1424;703;721
24;León;226;Villaselán;464;249;215
24;León;227;Villaturiel;1879;965;914
24;León;228;Villazala;1416;721;695
24;León;229;Villazanzo de Valderaduey;965;507;458
24;León;230;Zotes del Páramo;1020;533;487
25;Lleida;001;Abella de la Conca;161;82;79
25;Lleida;002;Àger;622;318;304
25;Lleida;003;Agramunt;4818;2423;2395
25;Lleida;038;Aitona;2349;1175;1174
25;Lleida;004;Alamús (Els);671;337;334
25;Lleida;005;Alàs i Cerc;424;225;199
25;Lleida;006;Albagés (L');595;291;304
25;Lleida;007;Albatàrrec;1020;499;521
25;Lleida;008;Albesa;1457;738;719
25;Lleida;009;Albi (L');847;435;412
25;Lleida;010;Alcanó;285;139;146
25;Lleida;011;Alcarràs;4402;2220;2182
25;Lleida;012;Alcoletge;1431;719;712
25;Lleida;013;Alfarràs;3141;1550;1591
25;Lleida;014;Alfés;345;181;164
25;Lleida;015;Algerri;601;288;313
25;Lleida;016;Alguaire;2874;1447;1427
25;Lleida;017;Alins;294;153;141
25;Lleida;019;Almacelles;5431;2766;2665
25;Lleida;020;Almatret;583;296;287
25;Lleida;021;Almenar;3631;1864;1767
25;Lleida;022;Alòs de Balaguer;187;107;80
25;Lleida;023;Alpicat;3439;1795;1644
25;Lleida;024;Alt Àneu;333;183;150
25;Lleida;027;Anglesola;1337;662;675
25;Lleida;029;Arbeca;2385;1183;1202
25;Lleida;031;Arres;49;30;19
25;Lleida;032;Arsèguel;83;43;40
25;Lleida;033;Artesa de Lleida;1182;579;603
25;Lleida;034;Artesa de Segre;3250;1672;1578
25;Lleida;036;Aspa;274;141;133
25;Lleida;037;Avellanes i Santa Linya (Les);549;289;260
25;Lleida;039;Baix Pallars;413;229;184
25;Lleida;040;Balaguer;13096;6467;6629
25;Lleida;041;Barbens;825;423;402
25;Lleida;042;Baronia de Rialb (La);275;148;127
25;Lleida;044;Bassella;393;203;190
25;Lleida;045;Bausen;63;41;22
25;Lleida;046;Belianes;606;294;312
25;Lleida;170;Bellaguarda;399;204;195
25;Lleida;047;Bellcaire d'Urgell;1475;734;741
25;Lleida;048;Bell-lloc d'Urgell;2208;1104;1104
25;Lleida;049;Bellmunt d'Urgell;239;123;116
25;Lleida;050;Bellpuig;3777;1879;1898
25;Lleida;051;Bellver de Cerdanya;1599;825;774
25;Lleida;052;Bellvís;2341;1169;1172
25;Lleida;053;Benavent de Segrià;732;380;352
25;Lleida;055;Biosca;283;141;142
25;Lleida;057;Bòrdes (Es);192;94;98
25;Lleida;058;Borges Blanques (Les);5209;2567;2642
25;Lleida;059;Bossòst;784;388;396
25;Lleida;056;Bovera;504;254;250
25;Lleida;060;Cabanabona;129;63;66
25;Lleida;061;Cabó;159;91;68
25;Lleida;062;Camarasa;1004;511;493
25;Lleida;063;Canejan;122;67;55
25;Lleida;904;Castell de Mur;146;72;74
25;Lleida;064;Castellar de la Ribera;169;84;85
25;Lleida;067;Castelldans;1016;516;500
25;Lleida;068;Castellnou de Seana;790;389;401
25;Lleida;069;Castelló de Farfanya;631;320;311
25;Lleida;070;Castellserà;1221;596;625
25;Lleida;071;Cava;50;31;19
25;Lleida;072;Cervera;6545;3189;3356
25;Lleida;073;Cervià de les Garrigues;920;463;457
25;Lleida;074;Ciutadilla;259;132;127
25;Lleida;075;Clariana de Cardener;157;78;79
25;Lleida;076;Cogul (El);246;120;126
25;Lleida;077;Coll de Nargó;684;349;335
25;Lleida;163;Coma i la Pedra (La);254;144;110
25;Lleida;161;Conca de Dalt;481;257;224
25;Lleida;078;Corbins;1034;534;500
25;Lleida;079;Cubells;420;222;198
25;Lleida;081;Espluga Calba (L');449;234;215
25;Lleida;082;Espot;224;118;106
25;Lleida;088;Estamariu;140;74;66
25;Lleida;085;Estaràs;201;100;101
25;Lleida;086;Esterri d'Àneu;586;295;291
25;Lleida;087;Esterri de Cardós;64;29;35
25;Lleida;089;Farrera;89;48;41
25;Lleida;908;Fígols i Alinyà;377;213;164
25;Lleida;092;Floresta (La);191;97;94
25;Lleida;093;Fondarella;547;269;278
25;Lleida;094;Foradada;161;88;73
25;Lleida;096;Fuliola (La);1334;683;651
25;Lleida;097;Fulleda;122;60;62
25;Lleida;098;Gavet de la Conca;389;195;194
25;Lleida;912;Gimenells i el Pla de la Font;"";"";""
25;Lleida;099;Golmés;1243;613;630
25;Lleida;100;Gósol;187;100;87
25;Lleida;101;Granadella (La);948;481;467
25;Lleida;102;Granja d'Escarp (La);1165;587;578
25;Lleida;103;Granyanella;119;60;59
25;Lleida;105;Granyena de les Garrigues;200;97;103
25;Lleida;104;Granyena de Segarra;206;110;96
25;Lleida;109;Guimerà;488;235;253
25;Lleida;903;Guingueta d'Àneu (La);261;133;128
25;Lleida;110;Guissona;2685;1345;1340
25;Lleida;111;Guixers;160;92;68
25;Lleida;115;Isona i Conca Dellà;1502;759;743
25;Lleida;112;Ivars de Noguera;365;180;185
25;Lleida;113;Ivars d'Urgell;1802;887;915
25;Lleida;114;Ivorra;190;95;95
25;Lleida;910;Josa i Tuixén;134;69;65
25;Lleida;118;Juncosa;604;311;293
25;Lleida;119;Juneda;3035;1531;1504
25;Lleida;121;Les;622;316;306
25;Lleida;122;Linyola;2383;1216;1167
25;Lleida;123;Lladorre;217;118;99
25;Lleida;124;Lladurs;259;138;121
25;Lleida;125;Llardecans;725;368;357
25;Lleida;126;Llavorsí;279;145;134
25;Lleida;120;Lleida;107749;52816;54933
25;Lleida;127;Lles de Cerdanya;313;170;143
25;Lleida;128;Llimiana;135;74;61
25;Lleida;129;Llobera;247;130;117
25;Lleida;133;Maials;1188;593;595
25;Lleida;130;Maldà;342;173;169
25;Lleida;131;Massalcoreig;710;350;360
25;Lleida;132;Massoteres;159;85;74
25;Lleida;134;Menàrguens;915;457;458
25;Lleida;135;Miralcamp;1203;583;620
25;Lleida;137;Mollerussa;8462;4193;4269
25;Lleida;136;Molsosa (La);135;66;69
25;Lleida;139;Montellà i Martinet;562;301;261
25;Lleida;140;Montferrer i Castellbò;631;342;289
25;Lleida;138;Montgai;908;457;451
25;Lleida;142;Montoliu de Lleida;447;216;231
25;Lleida;141;Montoliu de Segarra;213;112;101
25;Lleida;143;Montornès de Segarra;132;57;75
25;Lleida;145;Nalec;107;48;59
25;Lleida;025;Naut Aran;1146;620;526
25;Lleida;146;Navès;301;152;149
25;Lleida;148;Odèn;329;180;149
25;Lleida;149;Oliana;2075;1062;1013
25;Lleida;150;Oliola;255;143;112
25;Lleida;151;Olius;473;245;228
25;Lleida;152;Oluges (Les);241;121;120
25;Lleida;153;Omellons (Els);285;146;139
25;Lleida;154;Omells de na Gaia (Els);164;88;76
25;Lleida;155;Organyà;1079;553;526
25;Lleida;156;Os de Balaguer;869;502;367
25;Lleida;157;Ossó de Sió;272;131;141
25;Lleida;158;Palau d'Anglesola (El);1635;837;798
25;Lleida;164;Penelles;620;311;309
25;Lleida;165;Peramola;408;218;190
25;Lleida;166;Pinell de Solsonès;273;143;130
25;Lleida;167;Pinós;396;213;183
25;Lleida;911;Plans de Sió (Els);742;373;369
25;Lleida;168;Poal (El);689;353;336
25;Lleida;169;Pobla de Cérvoles (La);194;99;95
25;Lleida;171;Pobla de Segur (La);3345;1624;1721
25;Lleida;030;Pont de Bar (El);171;94;77
25;Lleida;173;Pont de Suert (El);2448;1237;1211
25;Lleida;172;Ponts;2288;1150;1138
25;Lleida;174;Portella (La);634;337;297
25;Lleida;175;Prats i Sansor;110;60;50
25;Lleida;176;Preixana;473;236;237
25;Lleida;177;Preixens;599;261;338
25;Lleida;179;Prullans;195;96;99
25;Lleida;180;Puiggròs;287;139;148
25;Lleida;181;Puigverd d'Agramunt;258;133;125
25;Lleida;182;Puigverd de Lleida;941;443;498
25;Lleida;183;Rialp;437;238;199
25;Lleida;905;Ribera d'Ondara;508;265;243
25;Lleida;185;Ribera d'Urgellet;817;444;373
25;Lleida;186;Riner;281;155;126
25;Lleida;913;Riu de Cerdanya;"";"";""
25;Lleida;189;Rosselló;1556;769;787
25;Lleida;190;Salàs de Pallars;403;194;209
25;Lleida;191;Sanaüja;475;235;240
25;Lleida;196;Sant Esteve de la Sarga;138;82;56
25;Lleida;192;Sant Guim de Freixenet;1085;547;538
25;Lleida;197;Sant Guim de la Plana;214;110;104
25;Lleida;193;Sant Llorenç de Morunys;885;463;422
25;Lleida;902;Sant Martí de Riucorb;825;424;401
25;Lleida;194;Sant Ramon;616;298;318
25;Lleida;201;Sarroca de Bellera;125;73;52
25;Lleida;200;Sarroca de Lleida;523;267;256
25;Lleida;202;Senterada;126;77;49
25;Lleida;035;Sentiu de Sió (La);509;250;259
25;Lleida;204;Seròs;1939;1030;909
25;Lleida;203;Seu d'Urgell (La);10101;5057;5044
25;Lleida;205;Sidamon;458;227;231
25;Lleida;206;Soleràs (El);510;259;251
25;Lleida;207;Solsona;6477;3247;3230
25;Lleida;208;Soriguera;291;154;137
25;Lleida;209;Sort;1543;789;754
25;Lleida;210;Soses;1529;781;748
25;Lleida;211;Sudanell;816;427;389
25;Lleida;212;Sunyer;322;161;161
25;Lleida;215;Talarn;385;205;180
25;Lleida;216;Talavera;312;149;163
25;Lleida;217;Tàrrega;11105;5402;5703
25;Lleida;218;Tarrés;93;47;46
25;Lleida;219;Tarroja de Segarra;205;108;97
25;Lleida;220;Térmens;1425;705;720
25;Lleida;221;Tírvia;109;55;54
25;Lleida;222;Tiurana;213;115;98
25;Lleida;223;Torà;1229;632;597
25;Lleida;224;Torms (Els);225;121;104
25;Lleida;225;Tornabous;943;468;475
25;Lleida;227;Torre de Cabdella (La);754;372;382
25;Lleida;226;Torrebesses;369;190;179
25;Lleida;228;Torrefarrera;1481;765;716
25;Lleida;907;Torrefeta i Florejacs;744;359;385
25;Lleida;230;Torregrossa;2270;1131;1139
25;Lleida;231;Torrelameu;599;320;279
25;Lleida;232;Torres de Segre;1891;971;920
25;Lleida;233;Torre-serona;308;156;152
25;Lleida;234;Tremp;5727;2845;2882
25;Lleida;043;Vall de Boí (La);550;305;245
25;Lleida;901;Vall de Cardós;324;173;151
25;Lleida;238;Vallbona de les Monges;293;132;161
25;Lleida;240;Vallfogona de Balaguer;1368;693;675
25;Lleida;906;Valls d'Aguilar (Les);234;126;108
25;Lleida;239;Valls de Valira (Les);745;395;350
25;Lleida;909;Vansa i Fórnols (La);160;86;74
25;Lleida;242;Verdú;934;464;470
25;Lleida;243;Vielha e Mijaran;2969;1508;1461
25;Lleida;244;Vilagrassa;408;206;202
25;Lleida;245;Vilaller;628;335;293
25;Lleida;247;Vilamòs;87;48;39
25;Lleida;248;Vilanova de Bellpuig;1276;623;653
25;Lleida;254;Vilanova de la Barca;871;436;435
25;Lleida;249;Vilanova de l'Aguda;295;156;139
25;Lleida;250;Vilanova de Meià;523;269;254
25;Lleida;251;Vilanova de Segrià;689;340;349
25;Lleida;252;Vila-sana;543;269;274
25;Lleida;253;Vilosell (El);219;102;117
25;Lleida;255;Vinaixa;731;363;368
26;Rioja (La);001;Ábalos;311;175;136
26;Rioja (La);002;Agoncillo;875;460;415
26;Rioja (La);003;Aguilar del Río Alhama;941;478;463
26;Rioja (La);004;Ajamil;71;42;29
26;Rioja (La);005;Albelda de Iregua;2306;1193;1113
26;Rioja (La);006;Alberite;1912;969;943
26;Rioja (La);007;Alcanadre;1003;509;494
26;Rioja (La);008;Aldeanueva de Ebro;2695;1385;1310
26;Rioja (La);009;Alesanco;579;299;280
26;Rioja (La);010;Alesón;170;88;82
26;Rioja (La);011;Alfaro;9132;4544;4588
26;Rioja (La);012;Almarza de Cameros;32;19;13
26;Rioja (La);013;Anguciana;375;189;186
26;Rioja (La);014;Anguiano;783;431;352
26;Rioja (La);015;Arenzana de Abajo;430;228;202
26;Rioja (La);016;Arenzana de Arriba;48;25;23
26;Rioja (La);017;Arnedillo;415;208;207
26;Rioja (La);018;Arnedo;12267;6172;6095
26;Rioja (La);019;Arrúbal;412;220;192
26;Rioja (La);020;Ausejo;746;382;364
26;Rioja (La);021;Autol;3474;1749;1725
26;Rioja (La);022;Azofra;449;239;210
26;Rioja (La);023;Badarán;918;488;430
26;Rioja (La);024;Bañares;556;282;274
26;Rioja (La);026;Baños de Río Tobía;1819;905;914
26;Rioja (La);025;Baños de Rioja;149;86;63
26;Rioja (La);027;Berceo;265;145;120
26;Rioja (La);028;Bergasa;231;124;107
26;Rioja (La);029;Bergasillas Bajera;29;16;13
26;Rioja (La);030;Bezares;25;14;11
26;Rioja (La);031;Bobadilla;204;96;108
26;Rioja (La);032;Brieva de Cameros;78;38;40
26;Rioja (La);033;Briñas;203;99;104
26;Rioja (La);034;Briones;979;529;450
26;Rioja (La);035;Cabezón de Cameros;43;24;19
26;Rioja (La);036;Calahorra;18179;8782;9397
26;Rioja (La);037;Camprovín;289;146;143
26;Rioja (La);038;Canales de la Sierra;92;50;42
26;Rioja (La);039;Canillas de Río Tuerto;93;48;45
26;Rioja (La);040;Cañas;127;62;65
26;Rioja (La);041;Cárdenas;300;144;156
26;Rioja (La);042;Casalarreina;920;471;449
26;Rioja (La);043;Castañares de Rioja;579;299;280
26;Rioja (La);044;Castroviejo;53;27;26
26;Rioja (La);045;Cellorigo;24;13;11
26;Rioja (La);046;Cenicero;2221;1131;1090
26;Rioja (La);047;Cervera del Río Alhama;3868;1907;1961
26;Rioja (La);048;Cidamón;103;60;43
26;Rioja (La);049;Cihuri;210;108;102
26;Rioja (La);050;Cirueña;146;85;61
26;Rioja (La);051;Clavijo;181;95;86
26;Rioja (La);052;Cordovín;280;132;148
26;Rioja (La);053;Corera;284;143;141
26;Rioja (La);054;Cornago;826;441;385
26;Rioja (La);055;Corporales;88;47;41
26;Rioja (La);056;Cuzcurrita de Río Tirón;593;313;280
26;Rioja (La);057;Daroca de Rioja;57;34;23
26;Rioja (La);058;Enciso;172;94;78
26;Rioja (La);059;Entrena;1112;596;516
26;Rioja (La);060;Estollo;155;78;77
26;Rioja (La);061;Ezcaray;1768;927;841
26;Rioja (La);062;Foncea;163;92;71
26;Rioja (La);063;Fonzaleche;230;118;112
26;Rioja (La);064;Fuenmayor;2081;1033;1048
26;Rioja (La);065;Galbárruli;58;34;24
26;Rioja (La);066;Galilea;273;152;121
26;Rioja (La);067;Gallinero de Cameros;21;13;8
26;Rioja (La);068;Gimileo;97;50;47
26;Rioja (La);069;Grañón;577;305;272
26;Rioja (La);070;Grávalos;361;184;177
26;Rioja (La);071;Haro;9112;4435;4677
26;Rioja (La);072;Herce;398;199;199
26;Rioja (La);073;Herramélluri;203;108;95
26;Rioja (La);074;Hervías;262;138;124
26;Rioja (La);075;Hormilla;540;281;259
26;Rioja (La);076;Hormilleja;222;114;108
26;Rioja (La);077;Hornillos de Cameros;28;15;13
26;Rioja (La);078;Hornos de Moncalvillo;96;49;47
26;Rioja (La);079;Huércanos;977;502;475
26;Rioja (La);080;Igea;1058;570;488
26;Rioja (La);081;Jalón de Cameros;40;23;17
26;Rioja (La);082;Laguna de Cameros;205;110;95
26;Rioja (La);083;Lagunilla del Jubera;415;206;209
26;Rioja (La);084;Lardero;2826;1410;1416
26;Rioja (La);086;Ledesma de la Cogolla;27;17;10
26;Rioja (La);087;Leiva;390;192;198
26;Rioja (La);088;Leza de Río Leza;25;18;7
26;Rioja (La);089;Logroño;115622;55989;59633
26;Rioja (La);091;Lumbreras;178;106;72
26;Rioja (La);092;Manjarrés;154;83;71
26;Rioja (La);093;Mansilla de la Sierra;57;36;21
26;Rioja (La);094;Manzanares de Rioja;175;94;81
26;Rioja (La);095;Matute;227;112;115
26;Rioja (La);096;Medrano;291;150;141
26;Rioja (La);098;Munilla;102;49;53
26;Rioja (La);099;Murillo de Río Leza;1722;854;868
26;Rioja (La);100;Muro de Aguas;54;32;22
26;Rioja (La);101;Muro en Cameros;45;30;15
26;Rioja (La);102;Nájera;6594;3303;3291
26;Rioja (La);103;Nalda;978;514;464
26;Rioja (La);104;Navajún;22;14;8
26;Rioja (La);105;Navarrete;2061;1076;985
26;Rioja (La);106;Nestares;53;26;27
26;Rioja (La);107;Nieva de Cameros;137;73;64
26;Rioja (La);109;Ochánduri;124;61;63
26;Rioja (La);108;Ocón;357;195;162
26;Rioja (La);110;Ojacastro;283;166;117
26;Rioja (La);111;Ollauri;319;166;153
26;Rioja (La);112;Ortigosa de Cameros;355;178;177
26;Rioja (La);113;Pazuengos;41;24;17
26;Rioja (La);114;Pedroso;115;60;55
26;Rioja (La);115;Pinillos;28;16;12
26;Rioja (La);117;Pradejón;2821;1428;1393
26;Rioja (La);118;Pradillo;111;56;55
26;Rioja (La);119;Préjano;262;131;131
26;Rioja (La);120;Quel;2069;1074;995
26;Rioja (La);121;Rabanera;46;23;23
26;Rioja (La);122;Rasillo de Cameros (El);114;57;57
26;Rioja (La);123;Redal (El);261;130;131
26;Rioja (La);124;Ribafrecha;1130;598;532
26;Rioja (La);125;Rincón de Soto;3429;1734;1695
26;Rioja (La);126;Robres del Castillo;31;18;13
26;Rioja (La);127;Rodezno;407;205;202
26;Rioja (La);128;Sajazarra;200;102;98
26;Rioja (La);129;San Asensio;1500;771;729
26;Rioja (La);130;San Millán de la Cogolla;319;185;134
26;Rioja (La);131;San Millán de Yécora;95;56;39
26;Rioja (La);132;San Román de Cameros;182;97;85
26;Rioja (La);139;San Torcuato;163;87;76
26;Rioja (La);142;San Vicente de la Sonsierra;1200;614;586
26;Rioja (La);134;Santa Coloma;191;107;84
26;Rioja (La);135;Santa Engracia del Jubera;226;130;96
26;Rioja (La);136;Santa Eulalia Bajera;126;68;58
26;Rioja (La);138;Santo Domingo de la Calzada;5807;2917;2890
26;Rioja (La);140;Santurde de Rioja;355;175;180
26;Rioja (La);141;Santurdejo;252;137;115
26;Rioja (La);143;Sojuela;107;60;47
26;Rioja (La);144;Sorzano;279;151;128
26;Rioja (La);145;Sotés;305;157;148
26;Rioja (La);146;Soto en Cameros;110;62;48
26;Rioja (La);147;Terroba;36;17;19
26;Rioja (La);148;Tirgo;305;156;149
26;Rioja (La);149;Tobía;70;40;30
26;Rioja (La);150;Tormantos;253;138;115
26;Rioja (La);153;Torre en Cameros;14;10;4
26;Rioja (La);151;Torrecilla en Cameros;576;293;283
26;Rioja (La);152;Torrecilla sobre Alesanco;115;57;58
26;Rioja (La);154;Torremontalbo;14;8;6
26;Rioja (La);155;Treviana;363;195;168
26;Rioja (La);157;Tricio;427;212;215
26;Rioja (La);158;Tudelilla;562;285;277
26;Rioja (La);160;Uruñuela;740;386;354
26;Rioja (La);161;Valdemadera;22;13;9
26;Rioja (La);162;Valgañón;195;104;91
26;Rioja (La);163;Ventosa;164;86;78
26;Rioja (La);164;Ventrosa;101;44;57
26;Rioja (La);165;Viguera;422;227;195
26;Rioja (La);166;Villalba de Rioja;197;108;89
26;Rioja (La);167;Villalobar de Rioja;152;89;63
26;Rioja (La);168;Villamediana de Iregua;1939;1000;939
26;Rioja (La);169;Villanueva de Cameros;125;63;62
26;Rioja (La);170;Villar de Arnedo (El);819;402;417
26;Rioja (La);171;Villar de Torre;389;203;186
26;Rioja (La);172;Villarejo;49;27;22
26;Rioja (La);173;Villarroya;14;7;7
26;Rioja (La);174;Villarta-Quintana;259;134;125
26;Rioja (La);175;Villavelayo;83;48;35
26;Rioja (La);176;Villaverde de Rioja;104;61;43
26;Rioja (La);177;Villoslada de Cameros;406;222;184
26;Rioja (La);178;Viniegra de Abajo;148;74;74
26;Rioja (La);179;Viniegra de Arriba;49;28;21
26;Rioja (La);180;Zarratón;321;163;158
26;Rioja (La);181;Zarzosa;23;14;9
26;Rioja (La);183;Zorraquín;46;27;19
27;Lugo;001;Abadín;4799;2335;2464
27;Lugo;002;Alfoz;2835;1386;1449
27;Lugo;003;Antas de Ulla;4178;2075;2103
27;Lugo;004;Baleira;2533;1331;1202
27;Lugo;901;Baralla;4347;2253;2094
27;Lugo;005;Barreiros;4076;1993;2083
27;Lugo;006;Becerreá;4740;2434;2306
27;Lugo;007;Begonte;4757;2371;2386
27;Lugo;008;Bóveda;2547;1262;1285
27;Lugo;902;Burela;"";"";""
27;Lugo;009;Carballedo;5116;2554;2562
27;Lugo;010;Castro de Rei;6207;3142;3065
27;Lugo;011;Castroverde;4310;2188;2122
27;Lugo;012;Cervantes;3262;1770;1492
27;Lugo;013;Cervo;11141;5539;5602
27;Lugo;016;Chantada;11186;5448;5738
27;Lugo;014;Corgo (O);5261;2654;2607
27;Lugo;015;Cospeito;7038;3484;3554
27;Lugo;017;Folgoso do Courel;2667;1394;1273
27;Lugo;018;Fonsagrada (A);8366;4402;3964
27;Lugo;019;Foz;9741;4675;5066
27;Lugo;020;Friol;5587;2818;2769
27;Lugo;022;Guitiriz;7432;3695;3737
27;Lugo;023;Guntín;4465;2186;2279
27;Lugo;024;Incio (O);3657;1889;1768
27;Lugo;026;Láncara;4185;2164;2021
27;Lugo;027;Lourenzá;3288;1610;1678
27;Lugo;028;Lugo;75623;35960;39663
27;Lugo;029;Meira;2015;987;1028
27;Lugo;030;Mondoñedo;6481;3059;3422
27;Lugo;031;Monforte de Lemos;20506;9885;10621
27;Lugo;032;Monterroso;5050;2685;2365
27;Lugo;033;Muras;2016;1005;1011
27;Lugo;034;Navia de Suarna;3397;1792;1605
27;Lugo;035;Negueira de Muñiz;390;214;176
27;Lugo;037;Nogais (As);2174;1163;1011
27;Lugo;038;Ourol;2332;1082;1250
27;Lugo;039;Outeiro de Rei;4526;2238;2288
27;Lugo;040;Palas de Rei;6226;3086;3140
27;Lugo;041;Pantón;5788;2796;2992
27;Lugo;042;Paradela;3386;1672;1714
27;Lugo;043;Páramo (O);2239;1154;1085
27;Lugo;044;Pastoriza (A);4923;2472;2451
27;Lugo;045;Pedrafita do Cebreiro;2425;1301;1124
27;Lugo;047;Pobra do Brollón (A);3540;1741;1799
27;Lugo;046;Pol;2720;1352;1368
27;Lugo;048;Pontenova (A);4127;2023;2104
27;Lugo;049;Portomarín;2475;1263;1212
27;Lugo;050;Quiroga;5754;2858;2896
27;Lugo;056;Rábade;1978;1005;973
27;Lugo;051;Ribadeo;8973;4224;4749
27;Lugo;052;Ribas de Sil;2026;1009;1017
27;Lugo;053;Ribeira de Piquín;1247;625;622
27;Lugo;054;Riotorto;2519;1255;1264
27;Lugo;055;Samos;3118;1669;1449
27;Lugo;057;Sarria;12808;6361;6447
27;Lugo;058;Saviñao (O);7250;3596;3654
27;Lugo;059;Sober;5018;2471;2547
27;Lugo;060;Taboada;6082;3020;3062
27;Lugo;061;Trabada;2237;1095;1142
27;Lugo;062;Triacastela;1177;619;558
27;Lugo;063;Valadouro (O);3097;1530;1567
27;Lugo;064;Vicedo (O);3012;1467;1545
27;Lugo;065;Vilalba;16319;7953;8366
27;Lugo;066;Viveiro;14954;7158;7796
27;Lugo;021;Xermade;3437;1683;1754
27;Lugo;025;Xove;3802;1912;1890
28;Madrid;001;Acebeda (La);63;36;27
28;Madrid;002;Ajalvir;1061;571;490
28;Madrid;003;Alameda del Valle;145;79;66
28;Madrid;004;Álamo (El);1972;1026;946
28;Madrid;005;Alcalá de Henares;144268;72418;71850
28;Madrid;006;Alcobendas;70227;34882;35345
28;Madrid;007;Alcorcón;137884;68552;69332
28;Madrid;008;Aldea del Fresno;988;501;487
28;Madrid;009;Algete;7441;3845;3596
28;Madrid;010;Alpedrete;2750;1387;1363
28;Madrid;011;Ambite;320;157;163
28;Madrid;012;Anchuelo;505;272;233
28;Madrid;013;Aranjuez;36687;17847;18840
28;Madrid;014;Arganda del Rey;23872;11870;12002
28;Madrid;015;Arroyomolinos;290;147;143
28;Madrid;016;Atazar (El);92;49;43
28;Madrid;017;Batres;259;130;129
28;Madrid;018;Becerril de la Sierra;1642;820;822
28;Madrid;019;Belmonte de Tajo;1107;556;551
28;Madrid;021;Berrueco (El);232;124;108
28;Madrid;020;Berzosa del Lozoya;65;37;28
28;Madrid;022;Boadilla del Monte;8332;4190;4142
28;Madrid;023;Boalo (El);1482;755;727
28;Madrid;024;Braojos;128;71;57
28;Madrid;025;Brea de Tajo;510;269;241
28;Madrid;026;Brunete;1610;803;807
28;Madrid;027;Buitrago del Lozoya;1246;663;583
28;Madrid;028;Bustarviejo;1135;569;566
28;Madrid;029;Cabanillas de la Sierra;327;161;166
28;Madrid;030;Cabrera (La);808;409;399
28;Madrid;031;Cadalso de los Vidrios;2039;1054;985
28;Madrid;032;Camarma de Esteruelas;1313;669;644
28;Madrid;033;Campo Real;2031;1037;994
28;Madrid;034;Canencia;461;241;220
28;Madrid;035;Carabaña;1030;523;507
28;Madrid;036;Casarrubuelos;530;291;239
28;Madrid;037;Cenicientos;2153;1081;1072
28;Madrid;038;Cercedilla;3819;1877;1942
28;Madrid;039;Cervera de Buitrago;95;48;47
28;Madrid;051;Chapinería;758;399;359
28;Madrid;052;Chinchón;4049;2035;2014
28;Madrid;040;Ciempozuelos;10076;5111;4965
28;Madrid;041;Cobeña;832;426;406
28;Madrid;046;Collado Mediano;1698;834;864
28;Madrid;047;Collado Villalba;20396;10098;10298
28;Madrid;043;Colmenar de Oreja;5181;2520;2661
28;Madrid;042;Colmenar del Arroyo;410;206;204
28;Madrid;045;Colmenar Viejo;29495;14552;14943
28;Madrid;044;Colmenarejo;1680;867;813
28;Madrid;048;Corpa;358;185;173
28;Madrid;049;Coslada;64826;32570;32256
28;Madrid;050;Cubas de la Sagra;830;393;437
28;Madrid;053;Daganzo de Arriba;1166;595;571
28;Madrid;054;Escorial (El);6138;3038;3100
28;Madrid;055;Estremera;1097;571;526
28;Madrid;056;Fresnedillas de la Oliva;412;207;205
28;Madrid;057;Fresno de Torote;160;81;79
28;Madrid;058;Fuenlabrada;119848;60544;59304
28;Madrid;059;Fuente el Saz de Jarama;1827;939;888
28;Madrid;060;Fuentidueña de Tajo;1243;623;620
28;Madrid;061;Galapagar;7015;3579;3436
28;Madrid;062;Garganta de los Montes;306;154;152
28;Madrid;063;Gargantilla del Lozoya y Pinilla de Buitrago;227;128;99
28;Madrid;064;Gascones;91;47;44
28;Madrid;065;Getafe;131840;65702;66138
28;Madrid;066;Griñón;1558;818;740
28;Madrid;067;Guadalix de la Sierra;1509;772;737
28;Madrid;068;Guadarrama;5958;2947;3011
28;Madrid;069;Hiruela (La);40;25;15
28;Madrid;070;Horcajo de la Sierra;135;69;66
28;Madrid;071;Horcajuelo de la Sierra;71;36;35
28;Madrid;072;Hoyo de Manzanares;2507;1279;1228
28;Madrid;073;Humanes de Madrid;5842;2936;2906
28;Madrid;074;Leganés;167783;84376;83407
28;Madrid;075;Loeches;2076;1055;1021
28;Madrid;076;Lozoya;442;225;217
28;Madrid;901;Lozoyuela-Navas-Sieteiglesias;622;335;287
28;Madrid;078;Madarcos;34;16;18
28;Madrid;079;Madrid;3058182;1439575;1618607
28;Madrid;080;Majadahonda;28974;14296;14678
28;Madrid;082;Manzanares el Real;1745;898;847
28;Madrid;083;Meco;1509;773;736
28;Madrid;084;Mejorada del Campo;11550;5826;5724
28;Madrid;085;Miraflores de la Sierra;2464;1224;1240
28;Madrid;086;Molar (El);2621;1366;1255
28;Madrid;087;Molinos (Los);2345;1084;1261
28;Madrid;088;Montejo de la Sierra;232;127;105
28;Madrid;089;Moraleja de Enmedio;1181;581;600
28;Madrid;090;Moralzarzal;1650;818;832
28;Madrid;091;Morata de Tajuña;4672;2304;2368
28;Madrid;092;Móstoles;175133;87398;87735
28;Madrid;093;Navacerrada;1539;850;689
28;Madrid;094;Navalafuente;278;150;128
28;Madrid;095;Navalagamella;525;258;267
28;Madrid;096;Navalcarnero;8977;4523;4454
28;Madrid;097;Navarredonda y San Mamés;126;68;58
28;Madrid;099;Navas del Rey;979;491;488
28;Madrid;100;Nuevo Baztán;510;284;226
28;Madrid;101;Olmeda de las Fuentes;131;72;59
28;Madrid;102;Orusco de Tajuña;584;287;297
28;Madrid;104;Paracuellos de Jarama;3713;1892;1821
28;Madrid;106;Parla;63963;32256;31707
28;Madrid;107;Patones;345;171;174
28;Madrid;108;Pedrezuela;728;375;353
28;Madrid;109;Pelayos de la Presa;749;384;365
28;Madrid;110;Perales de Tajuña;1881;911;970
28;Madrid;111;Pezuela de las Torres;502;266;236
28;Madrid;112;Pinilla del Valle;141;75;66
28;Madrid;113;Pinto;20117;10057;10060
28;Madrid;114;Piñuécar-Gandullas;164;78;86
28;Madrid;115;Pozuelo de Alarcón;35988;17643;18345
28;Madrid;116;Pozuelo del Rey;207;110;97
28;Madrid;117;Prádena del Rincón;103;57;46
28;Madrid;118;Puebla de la Sierra;57;28;29
28;Madrid;902;Puentes Viejas;410;212;198
28;Madrid;119;Quijorna;559;299;260
28;Madrid;120;Rascafría;1260;653;607
28;Madrid;121;Redueña;119;59;60
28;Madrid;122;Ribatejada;236;122;114
28;Madrid;123;Rivas-Vaciamadrid;5972;3001;2971
28;Madrid;124;Robledillo de la Jara;67;31;36
28;Madrid;125;Robledo de Chavela;1673;842;831
28;Madrid;126;Robregordo;102;53;49
28;Madrid;127;Rozas de Madrid (Las);20818;10268;10550
28;Madrid;128;Rozas de Puerto Real;396;202;194
28;Madrid;129;San Agustín del Guadalix;2476;1262;1214
28;Madrid;130;San Fernando de Henares;23020;11585;11435
28;Madrid;131;San Lorenzo de El Escorial;8979;4373;4606
28;Madrid;132;San Martín de la Vega;5583;2862;2721
28;Madrid;133;San Martín de Valdeiglesias;5048;2546;2502
28;Madrid;134;San Sebastián de los Reyes;50027;25123;24904
28;Madrid;135;Santa María de la Alameda;753;405;348
28;Madrid;136;Santorcaz;522;268;254
28;Madrid;137;Santos de la Humosa (Los);875;445;430
28;Madrid;138;Serna del Monte (La);80;41;39
28;Madrid;140;Serranillos del Valle;436;232;204
28;Madrid;141;Sevilla la Nueva;663;345;318
28;Madrid;143;Somosierra;108;65;43
28;Madrid;144;Soto del Real;1715;867;848
28;Madrid;145;Talamanca de Jarama;959;486;473
28;Madrid;146;Tielmes;1852;971;881
28;Madrid;147;Titulcia;843;413;430
28;Madrid;148;Torrejón de Ardoz;80066;40374;39692
28;Madrid;149;Torrejón de la Calzada;1035;537;498
28;Madrid;150;Torrejón de Velasco;1293;667;626
28;Madrid;151;Torrelaguna;2547;1242;1305
28;Madrid;152;Torrelodones;5018;2459;2559
28;Madrid;153;Torremocha de Jarama;197;100;97
28;Madrid;154;Torres de la Alameda;2618;1321;1297
28;Madrid;903;Tres Cantos;"";"";""
28;Madrid;155;Valdaracete;747;360;387
28;Madrid;156;Valdeavero;491;251;240
28;Madrid;157;Valdelaguna;585;305;280
28;Madrid;158;Valdemanco;430;226;204
28;Madrid;159;Valdemaqueda;451;226;225
28;Madrid;160;Valdemorillo;2354;1200;1154
28;Madrid;161;Valdemoro;16496;8535;7961
28;Madrid;162;Valdeolmos-Alalpardo;616;342;274
28;Madrid;163;Valdepiélagos;314;157;157
28;Madrid;164;Valdetorres de Jarama;1066;541;525
28;Madrid;165;Valdilecha;1515;764;751
28;Madrid;166;Valverde de Alcalá;213;116;97
28;Madrid;167;Velilla de San Antonio;1830;926;904
28;Madrid;168;Vellón (El);894;458;436
28;Madrid;169;Venturada;264;134;130
28;Madrid;171;Villa del Prado;3118;1561;1557
28;Madrid;170;Villaconejos;2901;1485;1416
28;Madrid;172;Villalbilla;1445;749;696
28;Madrid;173;Villamanrique de Tajo;555;281;274
28;Madrid;174;Villamanta;1061;546;515
28;Madrid;175;Villamantilla;292;149;143
28;Madrid;176;Villanueva de la Cañada;2791;1424;1367
28;Madrid;178;Villanueva de Perales;356;191;165
28;Madrid;177;Villanueva del Pardillo;1497;761;736
28;Madrid;179;Villar del Olmo;426;221;205
28;Madrid;180;Villarejo de Salvanés;4530;2264;2266
28;Madrid;181;Villaviciosa de Odón;8029;3817;4212
28;Madrid;182;Villavieja del Lozoya;157;72;85
28;Madrid;183;Zarzalejo;803;420;383
29;Málaga;001;Alameda;4721;2355;2366
29;Málaga;002;Alcaucín;1504;762;742
29;Málaga;003;Alfarnate;1589;820;769
29;Málaga;004;Alfarnatejo;432;235;197
29;Málaga;005;Algarrobo;4668;2380;2288
29;Málaga;006;Algatocín;1082;564;518
29;Málaga;007;Alhaurín de la Torre;10213;5174;5039
29;Málaga;008;Alhaurín el Grande;16142;8044;8098
29;Málaga;009;Almáchar;2056;1063;993
29;Málaga;010;Almargen;2418;1201;1217
29;Málaga;011;Almogía;4149;2096;2053
29;Málaga;012;Álora;13673;6835;6838
29;Málaga;013;Alozaina;2949;1540;1409
29;Málaga;014;Alpandeire;382;204;178
29;Málaga;015;Antequera;40732;19994;20738
29;Málaga;016;Árchez;389;213;176
29;Málaga;017;Archidona;10147;5140;5007
29;Málaga;018;Ardales;3126;1594;1532
29;Málaga;019;Arenas;1326;713;613
29;Málaga;020;Arriate;3288;1668;1620
29;Málaga;021;Atajate;151;85;66
29;Málaga;022;Benadalid;279;152;127
29;Málaga;023;Benahavís;2006;1003;1003
29;Málaga;024;Benalauría;602;311;291
29;Málaga;025;Benalmádena;19727;9962;9765
29;Málaga;026;Benamargosa;1700;864;836
29;Málaga;027;Benamocarra;2720;1367;1353
29;Málaga;028;Benaoján;1817;905;912
29;Málaga;029;Benarrabá;765;392;373
29;Málaga;030;Borge (El);1116;575;541
29;Málaga;031;Burgo (El);2150;1126;1024
29;Málaga;032;Campillos;7402;3769;3633
29;Málaga;033;Canillas de Aceituno;2715;1388;1327
29;Málaga;034;Canillas de Albaida;642;340;302
29;Málaga;035;Cañete la Real;2361;1243;1118
29;Málaga;036;Carratraca;1008;504;504
29;Málaga;037;Cartajima;423;216;207
29;Málaga;038;Cártama;11452;5761;5691
29;Málaga;039;Casabermeja;3025;1584;1441
29;Málaga;040;Casarabonela;2840;1481;1359
29;Málaga;041;Casares;3133;1595;1538
29;Málaga;042;Coín;20054;10233;9821
29;Málaga;043;Colmenar;3334;1643;1691
29;Málaga;044;Comares;1733;890;843
29;Málaga;045;Cómpeta;2261;1120;1141
29;Málaga;046;Cortes de la Frontera;4112;2065;2047
29;Málaga;047;Cuevas Bajas;1646;791;855
29;Málaga;049;Cuevas de San Marcos;4205;2094;2111
29;Málaga;048;Cuevas del Becerro;2087;1072;1015
29;Málaga;050;Cútar;644;315;329
29;Málaga;051;Estepona;28016;14011;14005
29;Málaga;052;Faraján;367;192;175
29;Málaga;053;Frigiliana;2108;1047;1061
29;Málaga;054;Fuengirola;34008;16817;17191
29;Málaga;055;Fuente de Piedra;2159;1090;1069
29;Málaga;056;Gaucín;2026;1062;964
29;Málaga;057;Genalguacil;782;406;376
29;Málaga;058;Guaro;2122;1074;1048
29;Málaga;059;Humilladero;2292;1156;1136
29;Málaga;060;Igualeja;1110;567;543
29;Málaga;061;Istán;1605;809;796
29;Málaga;062;Iznate;739;373;366
29;Málaga;063;Jimera de Líbar;557;287;270
29;Málaga;064;Jubrique;1067;545;522
29;Málaga;065;Júzcar;299;170;129
29;Málaga;066;Macharaviaya;350;172;178
29;Málaga;067;Málaga;563332;272659;290673
29;Málaga;068;Manilva;4340;2240;2100
29;Málaga;069;Marbella;74807;37195;37612
29;Málaga;070;Mijas;24065;12111;11954
29;Málaga;071;Moclinejo;1151;589;562
29;Málaga;072;Mollina;3169;1561;1608
29;Málaga;073;Monda;1744;887;857
29;Málaga;074;Montejaque;1401;697;704
29;Málaga;075;Nerja;12018;5981;6037
29;Málaga;076;Ojén;2132;1120;1012
29;Málaga;077;Parauta;402;201;201
29;Málaga;079;Periana;3642;1903;1739
29;Málaga;080;Pizarra;6259;3160;3099
29;Málaga;081;Pujerra;337;191;146
29;Málaga;082;Rincón de la Victoria;9160;4536;4624
29;Málaga;083;Riogordo;2818;1441;1377
29;Málaga;084;Ronda;31971;15788;16183
29;Málaga;085;Salares;307;156;151
29;Málaga;086;Sayalonga;1135;580;555
29;Málaga;087;Sedella;601;313;288
29;Málaga;088;Sierra de Yeguas;3251;1608;1643
29;Málaga;089;Teba;4455;2307;2148
29;Málaga;090;Tolox;3100;1618;1482
29;Málaga;901;Torremolinos;"";"";""
29;Málaga;091;Torrox;10073;5152;4921
29;Málaga;092;Totalán;616;316;300
29;Málaga;093;Valle de Abdalajís;3160;1611;1549
29;Málaga;094;Vélez-Málaga;50438;25292;25146
29;Málaga;095;Villanueva de Algaidas;4440;2202;2238
29;Málaga;098;Villanueva de Tapia;1568;795;773
29;Málaga;096;Villanueva del Rosario;3131;1551;1580
29;Málaga;097;Villanueva del Trabuco;4408;2249;2159
29;Málaga;099;Viñuela;1187;609;578
29;Málaga;100;Yunquera;3113;1598;1515
30;Murcia;001;Abanilla;6968;3415;3553
30;Murcia;002;Abarán;11572;5695;5877
30;Murcia;003;Águilas;22926;11455;11471
30;Murcia;004;Albudeite;1522;753;769
30;Murcia;005;Alcantarilla;26991;13079;13912
30;Murcia;902;Alcázares (Los);2847;1364;1483
30;Murcia;006;Aledo;1050;527;523
30;Murcia;007;Alguazas;6451;3176;3275
30;Murcia;008;Alhama de Murcia;13807;6757;7050
30;Murcia;009;Archena;12994;6432;6562
30;Murcia;010;Beniel;6390;3193;3197
30;Murcia;011;Blanca;6055;2921;3134
30;Murcia;012;Bullas;10080;5081;4999
30;Murcia;013;Calasparra;8887;4451;4436
30;Murcia;014;Campos del Río;2044;1012;1032
30;Murcia;015;Caravaca de la Cruz;22622;11189;11433
30;Murcia;016;Cartagena;168596;83112;85484
30;Murcia;017;Cehegín;15047;7509;7538
30;Murcia;018;Ceutí;5916;3003;2913
30;Murcia;019;Cieza;30166;14697;15469
30;Murcia;020;Fortuna;6089;3068;3021
30;Murcia;021;Fuente Álamo de Murcia;8778;4410;4368
30;Murcia;022;Jumilla;20743;10339;10404
30;Murcia;023;Librilla;3716;1826;1890
30;Murcia;024;Lorca;65458;32201;33257
30;Murcia;025;Lorquí;5249;2614;2635
30;Murcia;026;Mazarrón;13160;6596;6564
30;Murcia;027;Molina de Segura;34917;17286;17631
30;Murcia;028;Moratalla;10103;5120;4983
30;Murcia;029;Mula;13026;6464;6562
30;Murcia;030;Murcia;303257;147678;155579
30;Murcia;031;Ojós;651;316;335
30;Murcia;032;Pliego;3424;1711;1713
30;Murcia;033;Puerto Lumbreras;9406;4575;4831
30;Murcia;034;Ricote;1754;841;913
30;Murcia;035;San Javier;13482;6774;6708
30;Murcia;036;San Pedro del Pinatar;10902;5384;5518
30;Murcia;901;Santomera;7788;3901;3887
30;Murcia;037;Torre-Pacheco;15549;7869;7680
30;Murcia;038;Torres de Cotillas (Las);12844;6455;6389
30;Murcia;039;Totana;19653;9759;9894
30;Murcia;040;Ulea;1120;563;557
30;Murcia;041;Unión (La);14637;7261;7376
30;Murcia;042;Villanueva del Río Segura;1728;860;868
30;Murcia;043;Yecla;26423;13087;13336
31;Navarra;001;Abáigar;96;56;40
31;Navarra;002;Abárzuza;496;239;257
31;Navarra;003;Abaurregaina/Abaurrea Alta;227;126;101
31;Navarra;004;Abaurrepea/Abaurrea Baja;51;32;19
31;Navarra;005;Aberin;371;181;190
31;Navarra;006;Ablitas;2356;1201;1155
31;Navarra;007;Adiós;128;64;64
31;Navarra;008;Aguilar de Codés;168;82;86
31;Navarra;009;Aibar/Oibar;1004;503;501
31;Navarra;011;Allín;842;446;396
31;Navarra;012;Allo;1214;600;614
31;Navarra;010;Altsasu/Alsasua;7071;3601;3470
31;Navarra;013;Améscoa Baja;959;497;462
31;Navarra;014;Ancín;302;155;147
31;Navarra;015;Andosilla;2504;1258;1246
31;Navarra;016;Ansoáin;11025;5595;5430
31;Navarra;017;Anue;449;250;199
31;Navarra;018;Añorbe;408;225;183
31;Navarra;019;Aoiz/Agoitz;1889;936;953
31;Navarra;020;Araitz;695;398;297
31;Navarra;025;Arakil;2865;1494;1371
31;Navarra;021;Aranarache;110;55;55
31;Navarra;023;Aranguren;1245;689;556
31;Navarra;024;Arano;195;104;91
31;Navarra;022;Arantza;730;399;331
31;Navarra;026;Aras;253;129;124
31;Navarra;027;Arbizu;914;492;422
31;Navarra;028;Arce/Artzi;292;159;133
31;Navarra;029;Arcos (Los);1409;703;706
31;Navarra;030;Arellano;224;119;105
31;Navarra;031;Areso;318;168;150
31;Navarra;032;Arguedas;2439;1217;1222
31;Navarra;033;Aria;72;46;26
31;Navarra;034;Aribe;79;38;41
31;Navarra;035;Armañanzas;128;61;67
31;Navarra;036;Arróniz;1306;679;627
31;Navarra;037;Arruazu;124;68;56
31;Navarra;038;Artajona;1767;926;841
31;Navarra;039;Artazu;113;60;53
31;Navarra;040;Atez;188;110;78
31;Navarra;058;Auritz/Burguete;340;156;184
31;Navarra;041;Ayegui;622;316;306
31;Navarra;042;Azagra;3251;1597;1654
31;Navarra;043;Azuelo;92;47;45
31;Navarra;044;Bakaiku;376;206;170
31;Navarra;901;Barañain;13969;6899;7070
31;Navarra;045;Barásoain;432;226;206
31;Navarra;046;Barbarin;131;59;72
31;Navarra;047;Bargota;421;215;206
31;Navarra;048;Barillas;209;99;110
31;Navarra;049;Basaburua;814;451;363
31;Navarra;050;Baztan;8243;4216;4027
31;Navarra;137;Beintza-Labaien;336;194;142
31;Navarra;051;Beire;355;166;189
31;Navarra;052;Belascoáin;82;44;38
31;Navarra;250;Bera/Vera de Bidasoa;3583;1832;1751
31;Navarra;053;Berbinzana;794;388;406
31;Navarra;905;Beriáin;"";"";""
31;Navarra;902;Berrioplano;"";"";""
31;Navarra;903;Berriozar;"";"";""
31;Navarra;054;Bertizarana;648;326;322
31;Navarra;055;Betelu;349;190;159
31;Navarra;253;Bidaurreta;121;65;56
31;Navarra;056;Biurrun-Olcoz;196;110;86
31;Navarra;057;Buñuel;2525;1239;1286
31;Navarra;059;Burgui/Burgi;278;153;125
31;Navarra;060;Burlada/Burlata;13949;6900;7049
31;Navarra;061;Busto (El);137;71;66
31;Navarra;062;Cabanillas;1451;734;717
31;Navarra;063;Cabredo;148;74;74
31;Navarra;064;Cadreita;1909;919;990
31;Navarra;065;Caparroso;2411;1171;1240
31;Navarra;066;Cárcar;1263;611;652
31;Navarra;067;Carcastillo;2690;1372;1318
31;Navarra;068;Cascante;3554;1729;1825
31;Navarra;069;Cáseda;1165;578;587
31;Navarra;070;Castejón;3332;1655;1677
31;Navarra;071;Castillonuevo;19;12;7
31;Navarra;072;Cintruénigo;5451;2717;2734
31;Navarra;074;Cirauqui;489;270;219
31;Navarra;075;Ciriza;53;27;26
31;Navarra;076;Cizur;4880;2431;2449
31;Navarra;077;Corella;6325;3148;3177
31;Navarra;078;Cortes;3295;1695;1600
31;Navarra;079;Desojo;173;95;78
31;Navarra;080;Dicastillo;811;422;389
31;Navarra;081;Donamaria;391;198;193
31;Navarra;221;Doneztebe/Santesteban;1167;579;588
31;Navarra;083;Echarri;56;32;24
31;Navarra;086;Egüés;979;461;518
31;Navarra;087;Elgorriaga;181;91;90
31;Navarra;089;Enériz;191;98;93
31;Navarra;090;Eratsun;239;143;96
31;Navarra;091;Ergoiena;566;312;254
31;Navarra;092;Erro;855;448;407
31;Navarra;094;Eslava;237;117;120
31;Navarra;095;Esparza de Salazar;159;88;71
31;Navarra;096;Espronceda;221;124;97
31;Navarra;097;Estella/Lizarra;12603;6136;6467
31;Navarra;098;Esteribar;1453;769;684
31;Navarra;099;Etayo;112;58;54
31;Navarra;082;Etxalar;851;437;414
31;Navarra;084;Etxarri-Aranatz;2312;1210;1102
31;Navarra;085;Etxauri;381;198;183
31;Navarra;100;Eulate;437;223;214
31;Navarra;101;Ezcabarte;950;501;449
31;Navarra;093;Ezcároz/Ezkaroze;400;215;185
31;Navarra;102;Ezkurra;298;173;125
31;Navarra;103;Ezprogui;83;42;41
31;Navarra;104;Falces;2878;1419;1459
31;Navarra;105;Fitero;2180;1093;1087
31;Navarra;106;Fontellas;490;243;247
31;Navarra;107;Funes;2145;1072;1073
31;Navarra;108;Fustiñana;2379;1224;1155
31;Navarra;109;Galar;3280;1647;1633
31;Navarra;110;Gallipienzo;199;104;95
31;Navarra;111;Gallués/Galoze;142;85;57
31;Navarra;112;Garaioa;168;89;79
31;Navarra;113;Garde;229;121;108
31;Navarra;114;Garínoain;294;154;140
31;Navarra;115;Garralda;282;146;136
31;Navarra;116;Genevilla;167;89;78
31;Navarra;117;Goizueta;1093;593;500
31;Navarra;118;Goñi;219;120;99
31;Navarra;119;Güesa/Gorza;106;60;46
31;Navarra;120;Guesálaz;453;258;195
31;Navarra;121;Guirguillano;93;51;42
31;Navarra;256;Hiriberri/Villanueva de Aezkoa;190;100;90
31;Navarra;122;Huarte/Uharte;2782;1394;1388
31;Navarra;124;Ibargoiti;183;107;76
31;Navarra;259;Igantzi;594;316;278
31;Navarra;125;Igúzquiza;374;184;190
31;Navarra;126;Imotz;444;245;199
31;Navarra;127;Irañeta;177;103;74
31;Navarra;904;Irurtzun;"";"";""
31;Navarra;128;Isaba/Izaba;605;295;310
31;Navarra;129;Ituren;487;244;243
31;Navarra;130;Iturmendi;388;198;190
31;Navarra;131;Iza;517;286;231
31;Navarra;132;Izagaondoa;149;87;62
31;Navarra;133;Izalzu/Itzaltzu;52;24;28
31;Navarra;134;Jaurrieta;359;190;169
31;Navarra;135;Javier;172;80;92
31;Navarra;136;Juslapeña;412;226;186
31;Navarra;138;Lakuntza;1007;515;492
31;Navarra;139;Lana;252;143;109
31;Navarra;140;Lantz;146;87;59
31;Navarra;141;Lapoblación;214;117;97
31;Navarra;142;Larraga;1902;972;930
31;Navarra;143;Larraona;206;109;97
31;Navarra;144;Larraun;2095;1129;966
31;Navarra;145;Lazagurría;248;133;115
31;Navarra;146;Leache;74;43;31
31;Navarra;147;Legarda;78;38;40
31;Navarra;148;Legaria;180;90;90
31;Navarra;149;Leitza;3176;1629;1547
31;Navarra;908;Lekunberri;"";"";""
31;Navarra;150;Leoz;144;89;55
31;Navarra;151;Lerga;133;71;62
31;Navarra;152;Lerín;2168;1092;1076
31;Navarra;153;Lesaka;2962;1523;1439
31;Navarra;154;Lezáun;301;164;137
31;Navarra;155;Liédena;363;177;186
31;Navarra;156;Lizoáin;233;126;107
31;Navarra;157;Lodosa;4606;2329;2277
31;Navarra;158;Lónguida/Longida;348;188;160
31;Navarra;159;Lumbier;1491;769;722
31;Navarra;160;Luquin;158;85;73
31;Navarra;248;Luzaide/Valcarlos;571;291;280
31;Navarra;161;Mañeru;403;209;194
31;Navarra;162;Marañón;106;58;48
31;Navarra;163;Marcilla;2420;1241;1179
31;Navarra;164;Mélida;957;485;472
31;Navarra;165;Mendavia;3549;1788;1761
31;Navarra;166;Mendaza;503;233;270
31;Navarra;167;Mendigorría;981;507;474
31;Navarra;168;Metauten;386;204;182
31;Navarra;169;Milagro;2446;1225;1221
31;Navarra;170;Mirafuentes;62;29;33
31;Navarra;171;Miranda de Arga;1036;517;519
31;Navarra;172;Monreal;283;152;131
31;Navarra;173;Monteagudo;1185;585;600
31;Navarra;174;Morentin;137;65;72
31;Navarra;175;Mues;158;76;82
31;Navarra;176;Murchante;2947;1456;1491
31;Navarra;177;Murieta;275;157;118
31;Navarra;178;Murillo el Cuende;534;282;252
31;Navarra;179;Murillo el Fruto;889;453;436
31;Navarra;180;Muruzábal;201;104;97
31;Navarra;181;Navascués;302;185;117
31;Navarra;182;Nazar;55;32;23
31;Navarra;088;Noáin (Valle de Elorz)/Noain (Elortzibar);3324;1658;1666
31;Navarra;183;Obanos;696;331;365
31;Navarra;185;Ochagavía;721;371;350
31;Navarra;184;Oco;104;62;42
31;Navarra;186;Odieta;353;195;158
31;Navarra;187;Oitz;172;107;65
31;Navarra;188;Olaibar;184;99;85
31;Navarra;189;Olazti/Olazagutía;1852;959;893
31;Navarra;190;Olejua;76;38;38
31;Navarra;191;Olite;3046;1502;1544
31;Navarra;194;Ollo;365;204;161
31;Navarra;192;Olóriz;177;96;81
31;Navarra;193;Olza;2167;1106;1061
31;Navarra;195;Orbaitzeta;259;143;116
31;Navarra;196;Orbara;71;36;35
31;Navarra;906;Orcoyen;"";"";""
31;Navarra;197;Orísoain;103;55;48
31;Navarra;198;Oronz;70;39;31
31;Navarra;199;Oroz-Betelu;285;149;136
31;Navarra;211;Orreaga/Roncesvalles;31;17;14
31;Navarra;200;Oteiza;972;490;482
31;Navarra;201;Pamplona/Iruña;178439;86125;92314
31;Navarra;202;Peralta;4516;2214;2302
31;Navarra;203;Petilla de Aragón;67;33;34
31;Navarra;204;Piedramillera;112;58;54
31;Navarra;205;Pitillas;683;341;342
31;Navarra;206;Puente la Reina/Gares;2081;1048;1033
31;Navarra;207;Pueyo;331;169;162
31;Navarra;208;Ribaforada;3087;1582;1505
31;Navarra;209;Romanzado;159;93;66
31;Navarra;210;Roncal/Erronkari;415;210;205
31;Navarra;212;Sada;308;162;146
31;Navarra;213;Saldías;182;94;88
31;Navarra;214;Salinas de Oro;112;60;52
31;Navarra;215;San Adrián;4701;2292;2409
31;Navarra;217;San Martín de Unx;629;331;298
31;Navarra;216;Sangüesa/Zangoza;4623;2351;2272
31;Navarra;219;Sansol;173;87;86
31;Navarra;220;Santacara;1147;574;573
31;Navarra;222;Sarriés/Sartze;106;60;46
31;Navarra;223;Sartaguda;1438;722;716
31;Navarra;224;Sesma;1646;818;828
31;Navarra;225;Sorlada;80;41;39
31;Navarra;226;Sunbilla;747;395;352
31;Navarra;227;Tafalla;10256;5050;5206
31;Navarra;228;Tiebas-Muruarte de Reta;614;321;293
31;Navarra;229;Tirapu;72;38;34
31;Navarra;230;Torralba del Río;188;101;87
31;Navarra;231;Torres del Río;247;120;127
31;Navarra;232;Tudela;26041;12724;13317
31;Navarra;233;Tulebras;105;34;71
31;Navarra;234;Ucar;117;62;55
31;Navarra;123;Uharte-Arakil;876;461;415
31;Navarra;235;Ujué;332;171;161
31;Navarra;236;Ultzama;1606;836;770
31;Navarra;237;Unciti;205;115;90
31;Navarra;238;Unzué;130;64;66
31;Navarra;239;Urdazubi/Urdax;524;265;259
31;Navarra;240;Urdiain;743;390;353
31;Navarra;241;Urraul Alto;160;89;71
31;Navarra;242;Urraul Bajo;290;131;159
31;Navarra;244;Urrotz;243;142;101
31;Navarra;243;Urroz;373;189;184
31;Navarra;245;Urzainqui;129;69;60
31;Navarra;246;Uterga;141;68;73
31;Navarra;247;Uztárroz/Uztarroze;340;169;171
31;Navarra;249;Valtierra;2553;1274;1279
31;Navarra;251;Viana;3495;1787;1708
31;Navarra;252;Vidángoz/Bidankoze;120;58;62
31;Navarra;254;Villafranca;2657;1290;1367
31;Navarra;255;Villamayor de Monjardín;113;66;47
31;Navarra;257;Villatuerta;791;405;386
31;Navarra;258;Villava/Atarrabia;7003;3528;3475
31;Navarra;260;Yerri;1613;842;771
31;Navarra;261;Yesa;309;177;132
31;Navarra;262;Zabalza;150;66;84
31;Navarra;073;Ziordia;397;187;210
31;Navarra;907;Zizur Mayor/Zizur Nagusia;"";"";""
31;Navarra;263;Zubieta;357;212;145
31;Navarra;264;Zugarramurdi;288;154;134
31;Navarra;265;Zúñiga;139;80;59
32;Ourense;001;Allariz;6173;2978;3195
32;Ourense;002;Amoeiro;2660;1280;1380
32;Ourense;003;Arnoia (A);1302;621;681
32;Ourense;004;Avión;4574;2166;2408
32;Ourense;005;Baltar;3064;1527;1537
32;Ourense;006;Bande;4235;2051;2184
32;Ourense;007;Baños de Molgas;4421;2226;2195
32;Ourense;008;Barbadás;4184;2002;2182
32;Ourense;009;Barco de Valdeorras (O);10172;5010;5162
32;Ourense;010;Beade;1230;597;633
32;Ourense;011;Beariz;2017;885;1132
32;Ourense;012;Blancos (Os);2234;1143;1091
32;Ourense;013;Boborás;5175;2460;2715
32;Ourense;014;Bola (A);2307;1119;1188
32;Ourense;015;Bolo (O);3089;1546;1543
32;Ourense;016;Calvos de Randín;2246;1129;1117
32;Ourense;018;Carballeda de Avia;2485;1206;1279
32;Ourense;017;Carballeda de Valdeorras;3333;1722;1611
32;Ourense;019;Carballiño (O);11551;5517;6034
32;Ourense;020;Cartelle;5746;2832;2914
32;Ourense;022;Castrelo de Miño;5327;2677;2650
32;Ourense;021;Castrelo do Val;1996;1010;986
32;Ourense;023;Castro Caldelas;3209;1597;1612
32;Ourense;024;Celanova;7330;3525;3805
32;Ourense;025;Cenlle;2277;1064;1213
32;Ourense;029;Chandrexa de Queixa;1317;700;617
32;Ourense;026;Coles;3492;1724;1768
32;Ourense;027;Cortegada;2177;1062;1115
32;Ourense;028;Cualedro;5849;3006;2843
32;Ourense;030;Entrimo;2657;1253;1404
32;Ourense;031;Esgos;2649;1302;1347
32;Ourense;033;Gomesende;2241;1073;1168
32;Ourense;034;Gudiña (A);2606;1333;1273
32;Ourense;035;Irixo (O);3938;1938;2000
32;Ourense;038;Larouco;898;431;467
32;Ourense;039;Laza;2830;1399;1431
32;Ourense;040;Leiro;2556;1216;1340
32;Ourense;041;Lobeira;3122;1504;1618
32;Ourense;042;Lobios;5029;2431;2598
32;Ourense;043;Maceda;4862;2355;2507
32;Ourense;044;Manzaneda;1943;984;959
32;Ourense;045;Maside;5117;2473;2644
32;Ourense;046;Melón;2195;996;1199
32;Ourense;047;Merca (A);4235;2080;2155
32;Ourense;048;Mezquita (A);2006;1019;987
32;Ourense;049;Montederramo;1810;918;892
32;Ourense;050;Monterrei;5013;2533;2480
32;Ourense;051;Muíños;4201;2053;2148
32;Ourense;052;Nogueira de Ramuín;3464;1646;1818
32;Ourense;053;Oímbra;2165;1103;1062
32;Ourense;054;Ourense;100143;47284;52859
32;Ourense;055;Paderne de Allariz;2259;1065;1194
32;Ourense;056;Padrenda;5049;2483;2566
32;Ourense;057;Parada de Sil;2078;1000;1078
32;Ourense;058;Pereiro de Aguiar (O);6364;3111;3253
32;Ourense;059;Peroxa (A);3498;1662;1836
32;Ourense;060;Petín;1495;744;751
32;Ourense;061;Piñor;2226;1111;1115
32;Ourense;063;Pobra de Trives (A);4034;2009;2025
32;Ourense;064;Pontedeva;904;435;469
32;Ourense;062;Porqueira;1977;981;996
32;Ourense;065;Punxín;1278;610;668
32;Ourense;066;Quintela de Leirado;1466;710;756
32;Ourense;067;Rairiz de Veiga;4329;2147;2182
32;Ourense;068;Ramirás;3439;1687;1752
32;Ourense;069;Ribadavia;6836;3309;3527
32;Ourense;071;Riós;5093;2555;2538
32;Ourense;072;Rúa (A);5179;2573;2606
32;Ourense;073;Rubiá;3031;1517;1514
32;Ourense;074;San Amaro;2607;1282;1325
32;Ourense;075;San Cibrao das Viñas;3570;1709;1861
32;Ourense;076;San Cristovo de Cea;5244;2567;2677
32;Ourense;070;San Xoán de Río;1726;862;864
32;Ourense;077;Sandiás;2631;1284;1347
32;Ourense;078;Sarreaus;4083;2039;2044
32;Ourense;079;Taboadela;3156;1532;1624
32;Ourense;080;Teixeira (A);2026;1017;1009
32;Ourense;081;Toén;3416;1686;1730
32;Ourense;082;Trasmiras;4064;2077;1987
32;Ourense;083;Veiga (A);3305;1631;1674
32;Ourense;084;Verea;2890;1410;1480
32;Ourense;085;Verín;11044;5375;5669
32;Ourense;086;Viana do Bolo;6193;3158;3035
32;Ourense;087;Vilamarín;2388;1158;1230
32;Ourense;088;Vilamartín de Valdeorras;3095;1592;1503
32;Ourense;089;Vilar de Barrio;4330;2210;2120
32;Ourense;090;Vilar de Santos;1912;965;947
32;Ourense;091;Vilardevós;3699;1924;1775
32;Ourense;092;Vilariño de Conso;1258;685;573
32;Ourense;032;Xinzo de Limia;10459;5157;5302
32;Ourense;036;Xunqueira de Ambía;3404;1688;1716
32;Ourense;037;Xunqueira de Espadanedo;1495;724;771
33;Asturias;001;Allande;3259;1697;1562
33;Asturias;002;Aller;20057;9993;10064
33;Asturias;003;Amieva;1117;580;537
33;Asturias;004;Avilés;86141;42175;43966
33;Asturias;005;Belmonte de Miranda;3520;1827;1693
33;Asturias;006;Bimenes;2741;1285;1456
33;Asturias;007;Boal;3417;1710;1707
33;Asturias;008;Cabrales;2629;1322;1307
33;Asturias;009;Cabranes;1649;781;868
33;Asturias;010;Candamo;3282;1591;1691
33;Asturias;012;Cangas de Onís;6414;3239;3175
33;Asturias;011;Cangas del Narcea;20009;10354;9655
33;Asturias;013;Caravia;640;319;321
33;Asturias;014;Carreño;11507;5646;5861
33;Asturias;015;Caso;2275;1164;1111
33;Asturias;016;Castrillón;21929;10744;11185
33;Asturias;017;Castropol;5112;2477;2635
33;Asturias;018;Coaña;4177;2004;2173
33;Asturias;019;Colunga;5213;2518;2695
33;Asturias;020;Corvera de Asturias;18161;9108;9053
33;Asturias;021;Cudillero;7165;3574;3591
33;Asturias;022;Degaña;1851;994;857
33;Asturias;023;Franco (El);4371;2133;2238
33;Asturias;024;Gijón;258291;123549;134742
33;Asturias;025;Gozón;12283;6002;6281
33;Asturias;026;Grado;12684;6216;6468
33;Asturias;027;Grandas de Salime;1638;854;784
33;Asturias;028;Ibias;2886;1541;1345
33;Asturias;029;Illano;902;468;434
33;Asturias;030;Illas;1469;761;708
33;Asturias;031;Langreo;53987;26136;27851
33;Asturias;032;Laviana;15502;7666;7836
33;Asturias;033;Lena;14688;7250;7438
33;Asturias;035;Llanera;10335;5107;5228
33;Asturias;036;Llanes;13766;6556;7210
33;Asturias;037;Mieres;57025;27744;29281
33;Asturias;038;Morcín;3342;1659;1683
33;Asturias;039;Muros de Nalón;2865;1348;1517
33;Asturias;040;Nava;5755;2802;2953
33;Asturias;041;Navia;9066;4389;4677
33;Asturias;042;Noreña;4206;1981;2225
33;Asturias;043;Onís;1362;702;660
33;Asturias;044;Oviedo;185864;87751;98113
33;Asturias;045;Parres;6023;2953;3070
33;Asturias;046;Peñamellera Alta;972;487;485
33;Asturias;047;Peñamellera Baja;1928;952;976
33;Asturias;048;Pesoz;369;184;185
33;Asturias;049;Piloña;10252;4967;5285
33;Asturias;050;Ponga;978;547;431
33;Asturias;051;Pravia;10268;4920;5348
33;Asturias;052;Proaza;1113;541;572
33;Asturias;053;Quirós;1878;962;916
33;Asturias;054;Regueras (Las);2597;1299;1298
33;Asturias;055;Ribadedeva;2330;1101;1229
33;Asturias;056;Ribadesella;6593;3146;3447
33;Asturias;057;Ribera de Arriba;2320;1153;1167
33;Asturias;058;Riosa;2952;1547;1405
33;Asturias;059;Salas;8844;4407;4437
33;Asturias;061;San Martín de Oscos;705;365;340
33;Asturias;060;San Martín del Rey Aurelio;25186;12332;12854
33;Asturias;063;San Tirso de Abres;801;401;400
33;Asturias;062;Santa Eulalia de Oscos;755;402;353
33;Asturias;064;Santo Adriano;417;201;216
33;Asturias;065;Sariego;1710;832;878
33;Asturias;066;Siero;42108;20396;21712
33;Asturias;067;Sobrescobio;866;435;431
33;Asturias;068;Somiedo;2023;1038;985
33;Asturias;069;Soto del Barco;5006;2384;2622
33;Asturias;070;Tapia de Casariego;4619;2227;2392
33;Asturias;071;Taramundi;1157;566;591
33;Asturias;072;Teverga;3016;1521;1495
33;Asturias;073;Tineo;17697;8960;8737
33;Asturias;034;Valdés;18154;8925;9229
33;Asturias;074;Vegadeo;5196;2488;2708
33;Asturias;075;Villanueva de Oscos;540;282;258
33;Asturias;076;Villaviciosa;15624;7677;7947
33;Asturias;077;Villayón;2405;1244;1161
33;Asturias;078;Yernes y Tameza;232;114;118
34;Palencia;001;Abarca de Campos;53;28;25
34;Palencia;003;Abia de las Torres;253;129;124
34;Palencia;004;Aguilar de Campoo;7316;3597;3719
34;Palencia;005;Alar del Rey;1705;833;872
34;Palencia;006;Alba de Cerrato;155;79;76
34;Palencia;009;Amayuelas de Arriba;79;44;35
34;Palencia;010;Ampudia;871;432;439
34;Palencia;011;Amusco;726;386;340
34;Palencia;012;Antigüedad;493;267;226
34;Palencia;015;Arconada;119;62;57
34;Palencia;017;Astudillo;1583;827;756
34;Palencia;018;Autilla del Pino;361;184;177
34;Palencia;019;Autillo de Campos;230;109;121
34;Palencia;020;Ayuela;130;72;58
34;Palencia;022;Baltanás;1751;910;841
34;Palencia;024;Baquerín de Campos;43;27;16
34;Palencia;025;Bárcena de Campos;79;34;45
34;Palencia;027;Barruelo de Santullán;2487;1191;1296
34;Palencia;028;Báscones de Ojeda;263;134;129
34;Palencia;029;Becerril de Campos;1326;647;679
34;Palencia;031;Belmonte de Campos;75;34;41
34;Palencia;032;Berzosilla;103;51;52
34;Palencia;033;Boada de Campos;31;16;15
34;Palencia;035;Boadilla de Rioseco;236;117;119
34;Palencia;034;Boadilla del Camino;265;135;130
34;Palencia;036;Brañosera;359;181;178
34;Palencia;037;Buenavista de Valdavia;558;271;287
34;Palencia;038;Bustillo de la Vega;449;241;208
34;Palencia;039;Bustillo del Páramo de Carrión;139;73;66
34;Palencia;041;Calahorra de Boedo;178;87;91
34;Palencia;042;Calzada de los Molinos;473;253;220
34;Palencia;045;Capillas;162;81;81
34;Palencia;046;Cardeñosa de Volpejera;67;30;37
34;Palencia;047;Carrión de los Condes;2652;1249;1403
34;Palencia;048;Castil de Vela;148;71;77
34;Palencia;049;Castrejón de la Peña;845;451;394
34;Palencia;050;Castrillo de Don Juan;501;271;230
34;Palencia;051;Castrillo de Onielo;224;111;113
34;Palencia;052;Castrillo de Villavega;390;196;194
34;Palencia;053;Castromocho;311;158;153
34;Palencia;055;Cervatos de la Cueza;451;225;226
34;Palencia;056;Cervera de Pisuerga;3117;1578;1539
34;Palencia;057;Cevico de la Torre;812;403;409
34;Palencia;058;Cevico Navero;394;203;191
34;Palencia;059;Cisneros;705;355;350
34;Palencia;060;Cobos de Cerrato;287;144;143
34;Palencia;061;Collazos de Boedo;190;108;82
34;Palencia;062;Congosto de Valdavia;361;189;172
34;Palencia;063;Cordovilla la Real;189;106;83
34;Palencia;066;Cubillas de Cerrato;146;72;74
34;Palencia;067;Dehesa de Montejo;388;217;171
34;Palencia;068;Dehesa de Romanos;83;45;38
34;Palencia;069;Dueñas;3117;1604;1513
34;Palencia;070;Espinosa de Cerrato;382;197;185
34;Palencia;071;Espinosa de Villagonzalo;360;173;187
34;Palencia;072;Frechilla;335;159;176
34;Palencia;073;Fresno del Río;242;122;120
34;Palencia;074;Frómista;1134;582;552
34;Palencia;076;Fuentes de Nava;1011;488;523
34;Palencia;077;Fuentes de Valdepero;250;132;118
34;Palencia;079;Grijota;833;418;415
34;Palencia;080;Guardo;9823;5022;4801
34;Palencia;081;Guaza de Campos;110;57;53
34;Palencia;082;Hérmedes de Cerrato;204;99;105
34;Palencia;083;Herrera de Pisuerga;3037;1547;1490
34;Palencia;084;Herrera de Valdecañas;214;107;107
34;Palencia;086;Hontoria de Cerrato;138;71;67
34;Palencia;087;Hornillos de Cerrato;200;96;104
34;Palencia;088;Husillos;223;120;103
34;Palencia;089;Itero de la Vega;308;171;137
34;Palencia;091;Lagartos;238;131;107
34;Palencia;092;Lantadilla;665;330;335
34;Palencia;094;Ledigos;147;75;72
34;Palencia;903;Loma de Ucieza;464;244;220
34;Palencia;096;Lomas;83;40;43
34;Palencia;098;Magaz de Pisuerga;577;304;273
34;Palencia;099;Manquillos;100;54;46
34;Palencia;100;Mantinos;267;143;124
34;Palencia;101;Marcilla de Campos;110;47;63
34;Palencia;102;Mazariegos;285;151;134
34;Palencia;103;Mazuecos de Valdeginate;172;79;93
34;Palencia;104;Melgar de Yuso;501;264;237
34;Palencia;106;Meneses de Campos;213;113;100
34;Palencia;107;Micieces de Ojeda;159;79;80
34;Palencia;108;Monzón de Campos;1001;518;483
34;Palencia;109;Moratinos;121;60;61
34;Palencia;110;Mudá;218;107;111
34;Palencia;112;Nogal de las Huertas;119;64;55
34;Palencia;113;Olea de Boedo;55;25;30
34;Palencia;114;Olmos de Ojeda;521;285;236
34;Palencia;116;Osornillo;125;64;61
34;Palencia;901;Osorno la Mayor;2063;1065;998
34;Palencia;120;Palencia;75403;36355;39048
34;Palencia;121;Palenzuela;434;232;202
34;Palencia;122;Páramo de Boedo;146;75;71
34;Palencia;123;Paredes de Nava;2814;1393;1421
34;Palencia;124;Payo de Ojeda;120;65;55
34;Palencia;125;Pedraza de Campos;197;106;91
34;Palencia;126;Pedrosa de la Vega;443;237;206
34;Palencia;127;Perales;185;95;90
34;Palencia;904;Pernía (La);608;320;288
34;Palencia;129;Pino del Río;336;186;150
34;Palencia;130;Piña de Campos;429;234;195
34;Palencia;131;Población de Arroyo;120;65;55
34;Palencia;132;Población de Campos;272;146;126
34;Palencia;133;Población de Cerrato;165;85;80
34;Palencia;134;Polentinos;162;76;86
34;Palencia;135;Pomar de Valdivia;740;367;373
34;Palencia;136;Poza de la Vega;325;183;142
34;Palencia;137;Pozo de Urama;56;30;26
34;Palencia;139;Prádanos de Ojeda;282;145;137
34;Palencia;140;Puebla de Valdavia (La);247;120;127
34;Palencia;141;Quintana del Puente;459;220;239
34;Palencia;143;Quintanilla de Onsoña;338;188;150
34;Palencia;146;Reinoso de Cerrato;107;52;55
34;Palencia;147;Renedo de la Vega;346;180;166
34;Palencia;149;Requena de Campos;70;36;34
34;Palencia;151;Respenda de la Peña;402;216;186
34;Palencia;152;Revenga de Campos;235;117;118
34;Palencia;154;Revilla de Collazos;122;67;55
34;Palencia;155;Ribas de Campos;283;149;134
34;Palencia;156;Riberos de la Cueza;119;65;54
34;Palencia;157;Saldaña;3136;1631;1505
34;Palencia;158;Salinas de Pisuerga;307;165;142
34;Palencia;159;San Cebrián de Campos;632;363;269
34;Palencia;160;San Cebrián de Mudá;308;156;152
34;Palencia;161;San Cristóbal de Boedo;71;36;35
34;Palencia;163;San Mamés de Campos;163;77;86
34;Palencia;165;San Román de la Cuba;164;88;76
34;Palencia;167;Santa Cecilia del Alcor;190;104;86
34;Palencia;168;Santa Cruz de Boedo;90;44;46
34;Palencia;169;Santervás de la Vega;653;378;275
34;Palencia;170;Santibáñez de Ecla;137;52;85
34;Palencia;171;Santibáñez de la Peña;2184;1094;1090
34;Palencia;174;Santoyo;356;173;183
34;Palencia;175;Serna (La);155;83;72
34;Palencia;177;Soto de Cerrato;292;142;150
34;Palencia;176;Sotobañado y Priorato;251;128;123
34;Palencia;178;Tabanera de Cerrato;239;115;124
34;Palencia;179;Tabanera de Valdavia;76;43;33
34;Palencia;180;Támara de Campos;116;60;56
34;Palencia;181;Tariego de Cerrato;563;290;273
34;Palencia;182;Torquemada;1365;702;663
34;Palencia;184;Torremormojón;114;49;65
34;Palencia;185;Triollo;139;75;64
34;Palencia;186;Valbuena de Pisuerga;94;56;38
34;Palencia;189;Valdeolmillos;115;56;59
34;Palencia;190;Valderrábano;136;72;64
34;Palencia;192;Valde-Ucieza;193;112;81
34;Palencia;196;Valle de Cerrato;182;98;84
34;Palencia;902;Valle del Retortillo;339;163;176
34;Palencia;199;Velilla del Río Carrión;2266;1154;1112
34;Palencia;023;Venta de Baños;6991;3467;3524
34;Palencia;201;Vertavillo;343;181;162
34;Palencia;093;Vid de Ojeda (La);193;107;86
34;Palencia;202;Villabasta de Valdavia;49;22;27
34;Palencia;204;Villacidaler;129;63;66
34;Palencia;205;Villaconancio;113;57;56
34;Palencia;206;Villada;1499;726;773
34;Palencia;208;Villaeles de Valdavia;130;70;60
34;Palencia;210;Villahán;202;112;90
34;Palencia;211;Villaherreros;369;181;188
34;Palencia;213;Villalaco;95;42;53
34;Palencia;214;Villalba de Guardo;257;136;121
34;Palencia;215;Villalcázar de Sirga;272;122;150
34;Palencia;216;Villalcón;131;62;69
34;Palencia;217;Villalobón;258;135;123
34;Palencia;218;Villaluenga de la Vega;893;493;400
34;Palencia;220;Villamartín de Campos;193;96;97
34;Palencia;221;Villamediana;307;165;142
34;Palencia;222;Villameriel;216;110;106
34;Palencia;223;Villamoronta;368;191;177
34;Palencia;224;Villamuera de la Cueza;106;61;45
34;Palencia;225;Villamuriel de Cerrato;3549;1812;1737
34;Palencia;227;Villanueva del Rebollar;113;58;55
34;Palencia;228;Villanuño de Valdavia;171;95;76
34;Palencia;229;Villaprovedo;143;81;62
34;Palencia;230;Villarmentero de Campos;35;14;21
34;Palencia;231;Villarrabé;335;171;164
34;Palencia;232;Villarramiel;1263;634;629
34;Palencia;233;Villasarracino;422;206;216
34;Palencia;234;Villasila de Valdavia;143;80;63
34;Palencia;236;Villaturde;375;190;185
34;Palencia;237;Villaumbrales;1001;516;485
34;Palencia;238;Villaviudas;558;284;274
34;Palencia;240;Villerías de Campos;155;86;69
34;Palencia;241;Villodre;64;35;29
34;Palencia;242;Villodrigo;159;82;77
34;Palencia;243;Villoldo;620;318;302
34;Palencia;245;Villota del Páramo;626;351;275
34;Palencia;246;Villovieco;159;85;74
35;Palmas (Las);001;Agaete;5153;2588;2565
35;Palmas (Las);002;Agüimes;14622;7422;7200
35;Palmas (Las);003;Antigua;2214;1159;1055
35;Palmas (Las);004;Arrecife;31387;15808;15579
35;Palmas (Las);005;Artenara;1120;585;535
35;Palmas (Las);006;Arucas;27054;13730;13324
35;Palmas (Las);007;Betancuria;601;314;287
35;Palmas (Las);008;Firgas;5655;2842;2813
35;Palmas (Las);009;Gáldar;20802;10522;10280
35;Palmas (Las);010;Haría;2760;1428;1332
35;Palmas (Las);011;Ingenio;21377;10869;10508
35;Palmas (Las);016;Las Palmas de Gran Canaria;356911;176405;180506
35;Palmas (Las);012;Mogán;7932;4158;3774
35;Palmas (Las);013;Moya;7869;4009;3860
35;Palmas (Las);014;Oliva (La);4133;2161;1972
35;Palmas (Las);015;Pájara;4166;2171;1995
35;Palmas (Las);017;Puerto del Rosario;14586;7919;6667
35;Palmas (Las);018;San Bartolomé;5270;2728;2542
35;Palmas (Las);019;San Bartolomé de Tirajana;26274;13620;12654
35;Palmas (Las);020;San Nicolás de Tolentino;7729;3891;3838
35;Palmas (Las);021;Santa Brígida;12638;6306;6332
35;Palmas (Las);022;Santa Lucía de Tirajana;30528;15594;14934
35;Palmas (Las);023;Santa María de Guía de Gran Canaria;12714;6442;6272
35;Palmas (Las);024;Teguise;6498;3374;3124
35;Palmas (Las);025;Tejeda;2146;1033;1113
35;Palmas (Las);026;Telde;73913;37175;36738
35;Palmas (Las);027;Teror;10583;5281;5302
35;Palmas (Las);028;Tías;5758;3008;2750
35;Palmas (Las);029;Tinajo;3234;1640;1594
35;Palmas (Las);030;Tuineje;6192;3264;2928
35;Palmas (Las);032;Valleseco;4218;2173;2045
35;Palmas (Las);031;Valsequillo de Gran Canaria;6036;3092;2944
35;Palmas (Las);033;Vega de San Mateo;7202;3695;3507
35;Palmas (Las);034;Yaiza;1994;1045;949
36;Pontevedra;020;Agolada;5012;2454;2558
36;Pontevedra;001;Arbo;5308;2550;2758
36;Pontevedra;003;Baiona;10332;5066;5266
36;Pontevedra;002;Barro;3938;1865;2073
36;Pontevedra;004;Bueu;12371;6119;6252
36;Pontevedra;005;Caldas de Reis;9254;4427;4827
36;Pontevedra;006;Cambados;13165;6477;6688
36;Pontevedra;007;Campo Lameiro;2777;1304;1473
36;Pontevedra;008;Cangas;22297;10979;11318
36;Pontevedra;009;Cañiza (A);8536;4077;4459
36;Pontevedra;010;Catoira;3688;1824;1864
36;Pontevedra;011;Cerdedo;4483;2026;2457
36;Pontevedra;012;Cotobade;6047;2777;3270
36;Pontevedra;013;Covelo;5757;2649;3108
36;Pontevedra;014;Crecente;4408;2080;2328
36;Pontevedra;015;Cuntis;6686;3107;3579
36;Pontevedra;016;Dozón;2820;1421;1399
36;Pontevedra;017;Estrada (A);25914;12157;13757
36;Pontevedra;018;Forcarei;8079;3922;4157
36;Pontevedra;019;Fornelos de Montes;2638;1235;1403
36;Pontevedra;021;Gondomar;10275;5050;5225
36;Pontevedra;022;Grove (O);10592;5282;5310
36;Pontevedra;023;Guarda (A);10057;4858;5199
36;Pontevedra;901;Illa de Arousa (A);"";"";""
36;Pontevedra;024;Lalín;20193;9933;10260
36;Pontevedra;025;Lama (A);4392;1980;2412
36;Pontevedra;026;Marín;23387;11357;12030
36;Pontevedra;027;Meaño;5962;2909;3053
36;Pontevedra;028;Meis;5437;2600;2837
36;Pontevedra;029;Moaña;18035;8764;9271
36;Pontevedra;030;Mondariz;7236;3466;3770
36;Pontevedra;031;Mondariz-Balneario;631;296;335
36;Pontevedra;032;Moraña;5219;2480;2739
36;Pontevedra;033;Mos;13629;6668;6961
36;Pontevedra;034;Neves (As);6551;3108;3443
36;Pontevedra;035;Nigrán;14009;6886;7123
36;Pontevedra;036;Oia;3272;1617;1655
36;Pontevedra;037;Pazos de Borbén;3743;1740;2003
36;Pontevedra;041;Poio;12953;6365;6588
36;Pontevedra;043;Ponte Caldelas;8447;3982;4465
36;Pontevedra;042;Ponteareas;17083;8238;8845
36;Pontevedra;044;Pontecesures;2772;1341;1431
36;Pontevedra;038;Pontevedra;67289;31814;35475
36;Pontevedra;039;Porriño (O);14730;7172;7558
36;Pontevedra;040;Portas;3755;1789;1966
36;Pontevedra;045;Redondela;27609;13437;14172
36;Pontevedra;046;Ribadumia;4200;2011;2189
36;Pontevedra;047;Rodeiro;4774;2477;2297
36;Pontevedra;048;Rosal (O);5937;2922;3015
36;Pontevedra;049;Salceda de Caselas;5882;2871;3011
36;Pontevedra;050;Salvaterra de Miño;9590;4575;5015
36;Pontevedra;051;Sanxenxo;15387;7606;7781
36;Pontevedra;052;Silleda;10459;4991;5468
36;Pontevedra;053;Soutomaior;5356;2546;2810
36;Pontevedra;054;Tomiño;11056;5439;5617
36;Pontevedra;055;Tui;16189;7776;8413
36;Pontevedra;056;Valga;6529;3214;3315
36;Pontevedra;057;Vigo;261878;125123;136755
36;Pontevedra;059;Vila de Cruces;8560;4211;4349
36;Pontevedra;058;Vilaboa;6226;3030;3196
36;Pontevedra;060;Vilagarcía de Arousa;31886;15520;16366
36;Pontevedra;061;Vilanova de Arousa;15737;7724;8013
37;Salamanca;001;Abusejo;378;198;180
37;Salamanca;002;Agallas;320;174;146
37;Salamanca;003;Ahigal de los Aceiteros;252;127;125
37;Salamanca;004;Ahigal de Villarino;63;37;26
37;Salamanca;005;Alameda de Gardón (La);270;132;138
37;Salamanca;006;Alamedilla (La);304;152;152
37;Salamanca;007;Alaraz;777;414;363
37;Salamanca;008;Alba de Tormes;4195;2100;2095
37;Salamanca;009;Alba de Yeltes;407;208;199
37;Salamanca;010;Alberca (La);1127;582;545
37;Salamanca;011;Alberguería de Argañán (La);340;173;167
37;Salamanca;012;Alconada;290;152;138
37;Salamanca;015;Aldea del Obispo;514;260;254
37;Salamanca;013;Aldeacipreste;409;222;187
37;Salamanca;014;Aldeadávila de la Ribera;1954;1028;926
37;Salamanca;016;Aldealengua;359;181;178
37;Salamanca;017;Aldeanueva de Figueroa;474;238;236
37;Salamanca;018;Aldeanueva de la Sierra;127;74;53
37;Salamanca;019;Aldearrodrigo;240;127;113
37;Salamanca;020;Aldearrubia;537;274;263
37;Salamanca;021;Aldeaseca de Alba;199;102;97
37;Salamanca;022;Aldeaseca de la Frontera;438;223;215
37;Salamanca;023;Aldeatejada;575;285;290
37;Salamanca;024;Aldeavieja de Tormes;166;87;79
37;Salamanca;025;Aldehuela de la Bóveda;423;213;210
37;Salamanca;026;Aldehuela de Yeltes;446;215;231
37;Salamanca;027;Almenara de Tormes;250;119;131
37;Salamanca;028;Almendra;260;136;124
37;Salamanca;029;Anaya de Alba;430;219;211
37;Salamanca;030;Añover de Tormes;134;64;70
37;Salamanca;031;Arabayona de Mógica;661;357;304
37;Salamanca;032;Arapiles;492;250;242
37;Salamanca;033;Arcediano;151;74;77
37;Salamanca;034;Arco (El);110;61;49
37;Salamanca;035;Armenteros;422;194;228
37;Salamanca;037;Atalaya (La);225;121;104
37;Salamanca;038;Babilafuente;1055;549;506
37;Salamanca;039;Bañobárez;623;326;297
37;Salamanca;040;Barbadillo;661;323;338
37;Salamanca;041;Barbalos;180;87;93
37;Salamanca;042;Barceo;120;64;56
37;Salamanca;044;Barruecopardo;763;384;379
37;Salamanca;045;Bastida (La);54;25;29
37;Salamanca;046;Béjar;17432;8349;9083
37;Salamanca;047;Beleña;125;56;69
37;Salamanca;049;Bermellar;261;131;130
37;Salamanca;050;Berrocal de Huebra;188;97;91
37;Salamanca;051;Berrocal de Salvatierra;192;96;96
37;Salamanca;052;Boada;502;250;252
37;Salamanca;054;Bodón (El);455;233;222
37;Salamanca;055;Bogajo;285;140;145
37;Salamanca;056;Bouza (La);72;37;35
37;Salamanca;057;Bóveda del Río Almar;371;190;181
37;Salamanca;058;Brincones;158;75;83
37;Salamanca;059;Buenamadre;255;128;127
37;Salamanca;060;Buenavista;126;63;63
37;Salamanca;061;Cabaco (El);350;180;170
37;Salamanca;063;Cabeza de Béjar (La);162;77;85
37;Salamanca;065;Cabeza del Caballo;623;325;298
37;Salamanca;062;Cabezabellosa de la Calzada;180;103;77
37;Salamanca;067;Cabrerizos;667;333;334
37;Salamanca;068;Cabrillas;696;330;366
37;Salamanca;069;Calvarrasa de Abajo;1097;546;551
37;Salamanca;070;Calvarrasa de Arriba;628;331;297
37;Salamanca;071;Calzada de Béjar (La);141;73;68
37;Salamanca;072;Calzada de Don Diego;329;163;166
37;Salamanca;073;Calzada de Valdunciel;721;348;373
37;Salamanca;074;Campillo de Azaba;413;199;214
37;Salamanca;077;Campo de Peñaranda (El);495;255;240
37;Salamanca;078;Candelario;1245;594;651
37;Salamanca;079;Canillas de Abajo;183;99;84
37;Salamanca;080;Cantagallo;323;161;162
37;Salamanca;081;Cantalapiedra;1734;865;869
37;Salamanca;082;Cantalpino;1449;762;687
37;Salamanca;083;Cantaracillo;321;156;165
37;Salamanca;085;Carbajosa de la Sagrada;527;264;263
37;Salamanca;086;Carpio de Azaba;127;70;57
37;Salamanca;087;Carrascal de Barregas;348;184;164
37;Salamanca;088;Carrascal del Obispo;338;167;171
37;Salamanca;089;Casafranca;101;46;55
37;Salamanca;090;Casas del Conde (Las);164;73;91
37;Salamanca;091;Casillas de Flores;352;164;188
37;Salamanca;092;Castellanos de Moriscos;331;145;186
37;Salamanca;185;Castellanos de Villiquera;441;224;217
37;Salamanca;096;Castillejo de Martín Viejo;436;228;208
37;Salamanca;097;Castraz;126;65;61
37;Salamanca;098;Cepeda;642;314;328
37;Salamanca;099;Cereceda de la Sierra;146;80;66
37;Salamanca;100;Cerezal de Peñahorcada;189;96;93
37;Salamanca;101;Cerralbo;353;192;161
37;Salamanca;102;Cerro (El);693;347;346
37;Salamanca;103;Cespedosa de Tormes;804;431;373
37;Salamanca;114;Chagarcía Medianero;209;110;99
37;Salamanca;104;Cilleros de la Bastida;67;29;38
37;Salamanca;106;Cipérez;638;327;311
37;Salamanca;107;Ciudad Rodrigo;15557;7495;8062
37;Salamanca;108;Coca de Alba;224;109;115
37;Salamanca;109;Colmenar de Montemayor;410;204;206
37;Salamanca;110;Cordovilla;163;85;78
37;Salamanca;112;Cristóbal;272;145;127
37;Salamanca;113;Cubo de Don Sancho (El);736;384;352
37;Salamanca;115;Dios le Guarde;214;111;103
37;Salamanca;116;Doñinos de Ledesma;130;64;66
37;Salamanca;117;Doñinos de Salamanca;651;328;323
37;Salamanca;118;Ejeme;285;153;132
37;Salamanca;120;Encina de San Silvestre;132;66;66
37;Salamanca;119;Encina (La);345;184;161
37;Salamanca;121;Encinas de Abajo;759;405;354
37;Salamanca;122;Encinas de Arriba;308;156;152
37;Salamanca;123;Encinasola de los Comendadores;403;209;194
37;Salamanca;124;Endrinal;377;204;173
37;Salamanca;125;Escurial de la Sierra;374;177;197
37;Salamanca;126;Espadaña;79;41;38
37;Salamanca;127;Espeja;413;211;202
37;Salamanca;128;Espino de la Orbada;465;239;226
37;Salamanca;129;Florida de Liébana;248;140;108
37;Salamanca;130;Forfoleda;292;136;156
37;Salamanca;131;Frades de la Sierra;350;185;165
37;Salamanca;132;Fregeneda (La);698;336;362
37;Salamanca;133;Fresnedoso;196;98;98
37;Salamanca;134;Fresno Alhándiga;429;226;203
37;Salamanca;135;Fuente de San Esteban (La);1890;950;940
37;Salamanca;136;Fuenteguinaldo;1251;618;633
37;Salamanca;137;Fuenteliante;167;86;81
37;Salamanca;138;Fuenterroble de Salvatierra;317;161;156
37;Salamanca;139;Fuentes de Béjar;354;145;209
37;Salamanca;140;Fuentes de Oñoro;1532;751;781
37;Salamanca;141;Gajates;310;159;151
37;Salamanca;142;Galindo y Perahuy;168;86;82
37;Salamanca;143;Galinduste;712;367;345
37;Salamanca;144;Galisancho;800;415;385
37;Salamanca;145;Gallegos de Argañán;616;308;308
37;Salamanca;146;Gallegos de Solmirón;376;182;194
37;Salamanca;147;Garcibuey;370;203;167
37;Salamanca;148;Garcihernández;735;389;346
37;Salamanca;149;Garcirrey;137;67;70
37;Salamanca;150;Gejuelo del Barro;62;32;30
37;Salamanca;151;Golpejas;256;138;118
37;Salamanca;152;Gomecello;686;334;352
37;Salamanca;154;Guadramiro;293;166;127
37;Salamanca;155;Guijo de Ávila;129;72;57
37;Salamanca;156;Guijuelo;4508;2254;2254
37;Salamanca;157;Herguijuela de Ciudad Rodrigo;222;108;114
37;Salamanca;158;Herguijuela de la Sierra;496;237;259
37;Salamanca;159;Herguijuela del Campo;192;102;90
37;Salamanca;160;Hinojosa de Duero;984;476;508
37;Salamanca;161;Horcajo de Montemayor;234;124;110
37;Salamanca;162;Horcajo Medianero;566;295;271
37;Salamanca;163;Hoya (La);38;23;15
37;Salamanca;164;Huerta;310;166;144
37;Salamanca;165;Iruelos;86;43;43
37;Salamanca;166;Ituero de Azaba;445;228;217
37;Salamanca;167;Juzbado;259;132;127
37;Salamanca;168;Lagunilla;893;472;421
37;Salamanca;169;Larrodrigo;367;186;181
37;Salamanca;170;Ledesma;2062;1015;1047
37;Salamanca;171;Ledrada;664;322;342
37;Salamanca;172;Linares de Riofrío;1239;619;620
37;Salamanca;173;Lumbrales;2624;1283;1341
37;Salamanca;175;Machacón;614;319;295
37;Salamanca;174;Macotera;2105;1053;1052
37;Salamanca;176;Madroñal;172;89;83
37;Salamanca;177;Maíllo (El);490;245;245
37;Salamanca;178;Malpartida;249;133;116
37;Salamanca;179;Mancera de Abajo;475;245;230
37;Salamanca;180;Manzano (El);142;81;61
37;Salamanca;181;Martiago;577;285;292
37;Salamanca;183;Martín de Yeltes;771;394;377
37;Salamanca;182;Martinamor;124;65;59
37;Salamanca;184;Masueco;612;308;304
37;Salamanca;186;Mata de Ledesma (La);210;96;114
37;Salamanca;187;Matilla de los Caños del Río;782;400;382
37;Salamanca;188;Maya (La);333;178;155
37;Salamanca;189;Membribe de la Sierra;116;64;52
37;Salamanca;190;Mieza;503;261;242
37;Salamanca;191;Milano (El);237;129;108
37;Salamanca;192;Miranda de Azán;126;61;65
37;Salamanca;193;Miranda del Castañar;837;428;409
37;Salamanca;194;Mogarraz;480;230;250
37;Salamanca;195;Molinillo;93;48;45
37;Salamanca;196;Monforte de la Sierra;171;88;83
37;Salamanca;197;Monleón;179;97;82
37;Salamanca;198;Monleras;319;165;154
37;Salamanca;199;Monsagro;300;164;136
37;Salamanca;200;Montejo;257;133;124
37;Salamanca;201;Montemayor del Río;491;250;241
37;Salamanca;202;Monterrubio de Armuña;106;57;49
37;Salamanca;203;Monterrubio de la Sierra;203;106;97
37;Salamanca;204;Morasverdes;528;273;255
37;Salamanca;205;Morille;216;111;105
37;Salamanca;206;Moríñigo;177;95;82
37;Salamanca;207;Moriscos;142;78;64
37;Salamanca;208;Moronta;185;91;94
37;Salamanca;209;Mozárbez;377;189;188
37;Salamanca;211;Narros de Matalayegua;412;219;193
37;Salamanca;213;Nava de Béjar;153;73;80
37;Salamanca;214;Nava de Francia;188;102;86
37;Salamanca;215;Nava de Sotrobal;304;159;145
37;Salamanca;212;Navacarros;111;59;52
37;Salamanca;216;Navales;441;245;196
37;Salamanca;217;Navalmoral de Béjar;107;55;52
37;Salamanca;218;Navamorales;270;143;127
37;Salamanca;219;Navarredonda de la Rinconada;428;215;213
37;Salamanca;221;Navasfrías;964;476;488
37;Salamanca;222;Negrilla de Palencia;137;66;71
37;Salamanca;223;Olmedo de Camaces;224;113;111
37;Salamanca;224;Orbada (La);342;169;173
37;Salamanca;225;Pajares de la Laguna;161;81;80
37;Salamanca;226;Palacios del Arzobispo;314;164;150
37;Salamanca;228;Palaciosrubios;716;374;342
37;Salamanca;229;Palencia de Negrilla;274;137;137
37;Salamanca;230;Parada de Arriba;257;134;123
37;Salamanca;231;Parada de Rubiales;442;225;217
37;Salamanca;232;Paradinas de San Juan;730;400;330
37;Salamanca;233;Pastores;116;59;57
37;Salamanca;234;Payo (El);730;346;384
37;Salamanca;235;Pedraza de Alba;309;168;141
37;Salamanca;236;Pedrosillo de Alba;371;190;181
37;Salamanca;237;Pedrosillo de los Aires;585;317;268
37;Salamanca;238;Pedrosillo el Ralo;162;79;83
37;Salamanca;239;Pedroso de la Armuña (El);431;204;227
37;Salamanca;240;Pelabravo;591;298;293
37;Salamanca;241;Pelarrodríguez;256;138;118
37;Salamanca;242;Pelayos;108;57;51
37;Salamanca;243;Peña (La);249;126;123
37;Salamanca;244;Peñacaballera;276;138;138
37;Salamanca;245;Peñaparda;622;289;333
37;Salamanca;246;Peñaranda de Bracamonte;6357;3135;3222
37;Salamanca;247;Peñarandilla;352;178;174
37;Salamanca;248;Peralejos de Abajo;284;132;152
37;Salamanca;249;Peralejos de Arriba;102;54;48
37;Salamanca;250;Pereña de la Ribera;579;302;277
37;Salamanca;251;Peromingo;154;74;80
37;Salamanca;252;Pinedas;308;158;150
37;Salamanca;253;Pino de Tormes (El);194;104;90
37;Salamanca;254;Pitiegua;341;176;165
37;Salamanca;255;Pizarral;117;55;62
37;Salamanca;256;Poveda de las Cintas;454;245;209
37;Salamanca;257;Pozos de Hinojo;140;72;68
37;Salamanca;258;Puebla de Azaba;486;254;232
37;Salamanca;259;Puebla de San Medel;81;41;40
37;Salamanca;260;Puebla de Yeltes;316;174;142
37;Salamanca;261;Puente del Congosto;479;239;240
37;Salamanca;262;Puertas;164;86;78
37;Salamanca;263;Puerto de Béjar;615;297;318
37;Salamanca;264;Puerto Seguro;144;78;66
37;Salamanca;265;Rágama;401;213;188
37;Salamanca;266;Redonda (La);136;66;70
37;Salamanca;267;Retortillo;349;174;175
37;Salamanca;268;Rinconada de la Sierra (La);238;114;124
37;Salamanca;269;Robleda;719;364;355
37;Salamanca;270;Robliza de Cojos;273;125;148
37;Salamanca;271;Rollán;629;329;300
37;Salamanca;272;Saelices el Chico;240;130;110
37;Salamanca;273;Sagrada (La);237;120;117
37;Salamanca;303;Sahugo (El);396;204;192
37;Salamanca;274;Salamanca;152833;72805;80028
37;Salamanca;275;Saldeana;266;143;123
37;Salamanca;276;Salmoral;517;262;255
37;Salamanca;277;Salvatierra de Tormes;99;46;53
37;Salamanca;278;San Cristóbal de la Cuesta;252;128;124
37;Salamanca;284;San Esteban de la Sierra;543;284;259
37;Salamanca;285;San Felices de los Gallegos;819;413;406
37;Salamanca;286;San Martín del Castañar;439;221;218
37;Salamanca;287;San Miguel de Valero;535;255;280
37;Salamanca;036;San Miguel del Robledo;140;74;66
37;Salamanca;288;San Morales;183;97;86
37;Salamanca;289;San Muñoz;456;237;219
37;Salamanca;291;San Pedro de Rozados;518;256;262
37;Salamanca;290;San Pedro del Valle;312;158;154
37;Salamanca;292;San Pelayo de Guareña;143;72;71
37;Salamanca;280;Sanchón de la Ribera;204;104;100
37;Salamanca;281;Sanchón de la Sagrada;73;35;38
37;Salamanca;282;Sanchotello;419;219;200
37;Salamanca;279;Sancti-Spíritus;1556;780;776
37;Salamanca;283;Sando;286;161;125
37;Salamanca;293;Santa María de Sando;256;143;113
37;Salamanca;294;Santa Marta de Tormes;4485;2204;2281
37;Salamanca;296;Santiago de la Puebla;890;473;417
37;Salamanca;297;Santibáñez de Béjar;861;416;445
37;Salamanca;298;Santibáñez de la Sierra;327;180;147
37;Salamanca;299;Santiz;337;179;158
37;Salamanca;300;Santos (Los);902;479;423
37;Salamanca;301;Sardón de los Frailes;116;66;50
37;Salamanca;302;Saucelle;666;354;312
37;Salamanca;304;Sepulcro-Hilario;368;185;183
37;Salamanca;305;Sequeros;311;150;161
37;Salamanca;306;Serradilla del Arroyo;632;317;315
37;Salamanca;307;Serradilla del Llano;414;220;194
37;Salamanca;309;Sierpe (La);62;30;32
37;Salamanca;310;Sieteiglesias de Tormes;209;107;102
37;Salamanca;311;Sobradillo;466;225;241
37;Salamanca;312;Sorihuela;530;259;271
37;Salamanca;313;Sotoserrano;857;456;401
37;Salamanca;314;Tabera de Abajo;171;85;86
37;Salamanca;315;Tala (La);229;120;109
37;Salamanca;316;Tamames;1200;602;598
37;Salamanca;317;Tarazona de Guareña;528;285;243
37;Salamanca;318;Tardáguila;313;169;144
37;Salamanca;319;Tejado (El);240;114;126
37;Salamanca;320;Tejeda y Segoyuela;193;95;98
37;Salamanca;321;Tenebrón;275;132;143
37;Salamanca;322;Terradillos;985;494;491
37;Salamanca;323;Topas;811;425;386
37;Salamanca;324;Tordillos;738;364;374
37;Salamanca;325;Tornadizo (El);173;88;85
37;Salamanca;327;Torresmenudas;284;139;145
37;Salamanca;328;Trabanca;305;164;141
37;Salamanca;329;Tremedal de Tormes;81;42;39
37;Salamanca;330;Valdecarros;555;279;276
37;Salamanca;331;Valdefuentes de Sangusín;387;204;183
37;Salamanca;332;Valdehijaderos;164;89;75
37;Salamanca;333;Valdelacasa;372;189;183
37;Salamanca;334;Valdelageve;170;95;75
37;Salamanca;335;Valdelosa;584;289;295
37;Salamanca;336;Valdemierque;79;42;37
37;Salamanca;337;Valderrodrigo;242;119;123
37;Salamanca;338;Valdunciel;145;70;75
37;Salamanca;339;Valero;578;289;289
37;Salamanca;343;Vallejera de Riofrío;69;26;43
37;Salamanca;340;Valsalabroso;304;154;150
37;Salamanca;341;Valverde de Valdelacasa;94;47;47
37;Salamanca;342;Valverdón;271;148;123
37;Salamanca;344;Vecinos;335;171;164
37;Salamanca;345;Vega de Tirados;254;130;124
37;Salamanca;346;Veguillas (Las);386;186;200
37;Salamanca;347;Vellés (La);528;270;258
37;Salamanca;348;Ventosa del Río Almar;187;93;94
37;Salamanca;349;Vídola (La);274;141;133
37;Salamanca;351;Villaflores;609;305;304
37;Salamanca;352;Villagonzalo de Tormes;274;150;124
37;Salamanca;353;Villalba de los Llanos;232;117;115
37;Salamanca;354;Villamayor;1043;537;506
37;Salamanca;355;Villanueva del Conde;371;185;186
37;Salamanca;356;Villar de Argañán;180;96;84
37;Salamanca;357;Villar de Ciervo;546;287;259
37;Salamanca;358;Villar de Gallimazo;360;186;174
37;Salamanca;359;Villar de la Yegua;499;253;246
37;Salamanca;360;Villar de Peralonso;472;233;239
37;Salamanca;361;Villar de Samaniego;191;103;88
37;Salamanca;362;Villares de la Reina;962;476;486
37;Salamanca;363;Villares de Yeltes;213;111;102
37;Salamanca;364;Villarino de los Aires;1501;746;755
37;Salamanca;365;Villarmayor;250;126;124
37;Salamanca;366;Villarmuerto;105;53;52
37;Salamanca;367;Villasbuenas;421;209;212
37;Salamanca;368;Villasdardo;43;21;22
37;Salamanca;369;Villaseco de los Gamitos;222;111;111
37;Salamanca;370;Villaseco de los Reyes;525;260;265
37;Salamanca;371;Villasrubias;450;227;223
37;Salamanca;372;Villaverde de Guareña;241;122;119
37;Salamanca;373;Villavieja de Yeltes;1672;822;850
37;Salamanca;374;Villoria;1487;748;739
37;Salamanca;375;Villoruela;1092;535;557
37;Salamanca;350;Vilvestre;748;372;376
37;Salamanca;376;Vitigudino;3103;1507;1596
37;Salamanca;377;Yecla de Yeltes;475;239;236
37;Salamanca;378;Zamarra;230;115;115
37;Salamanca;379;Zamayón;214;121;93
37;Salamanca;380;Zarapicos;76;32;44
37;Salamanca;381;Zarza de Pumareda (La);281;153;128
37;Salamanca;382;Zorita de la Frontera;400;210;190
38;Santa Cruz de Tenerife;001;Adeje;7014;3496;3518
38;Santa Cruz de Tenerife;002;Agulo;1464;741;723
38;Santa Cruz de Tenerife;003;Alajeró;1112;581;531
38;Santa Cruz de Tenerife;004;Arafo;3882;1899;1983
38;Santa Cruz de Tenerife;005;Arico;4243;2221;2022
38;Santa Cruz de Tenerife;006;Arona;19124;9621;9503
38;Santa Cruz de Tenerife;007;Barlovento;2608;1303;1305
38;Santa Cruz de Tenerife;008;Breña Alta;5190;2599;2591
38;Santa Cruz de Tenerife;009;Breña Baja;3252;1612;1640
38;Santa Cruz de Tenerife;010;Buenavista del Norte;5389;2740;2649
38;Santa Cruz de Tenerife;011;Candelaria;8278;4135;4143
38;Santa Cruz de Tenerife;012;Fasnia;2258;1123;1135
38;Santa Cruz de Tenerife;013;Frontera;3601;1790;1811
38;Santa Cruz de Tenerife;014;Fuencaliente de la Palma;1829;915;914
38;Santa Cruz de Tenerife;015;Garachico;5996;2959;3037
38;Santa Cruz de Tenerife;016;Garafía;2062;1040;1022
38;Santa Cruz de Tenerife;017;Granadilla de Abona;14726;7461;7265
38;Santa Cruz de Tenerife;018;Guancha (La);5135;2563;2572
38;Santa Cruz de Tenerife;019;Guía de Isora;11515;5636;5879
38;Santa Cruz de Tenerife;020;Güímar;14276;7116;7160
38;Santa Cruz de Tenerife;021;Hermigua;2724;1351;1373
38;Santa Cruz de Tenerife;022;Icod de los Vinos;21760;10767;10993
38;Santa Cruz de Tenerife;024;Llanos de Aridane (Los);15973;7888;8085
38;Santa Cruz de Tenerife;025;Matanza de Acentejo (La);5645;2901;2744
38;Santa Cruz de Tenerife;026;Orotava (La);35362;17528;17834
38;Santa Cruz de Tenerife;027;Paso (El);6794;3349;3445
38;Santa Cruz de Tenerife;028;Puerto de la Cruz;24990;12286;12704
38;Santa Cruz de Tenerife;029;Puntagorda;1692;867;825
38;Santa Cruz de Tenerife;030;Puntallana;2282;1161;1121
38;Santa Cruz de Tenerife;031;Realejos (Los);28040;13848;14192
38;Santa Cruz de Tenerife;032;Rosario (El);6118;3032;3086
38;Santa Cruz de Tenerife;033;San Andrés y Sauces;5524;2753;2771
38;Santa Cruz de Tenerife;023;San Cristóbal de La Laguna;107593;53109;54484
38;Santa Cruz de Tenerife;034;San Juan de la Rambla;4661;2326;2335
38;Santa Cruz de Tenerife;035;San Miguel de Abona;4419;2256;2163
38;Santa Cruz de Tenerife;036;San Sebastián de la Gomera;5586;2812;2774
38;Santa Cruz de Tenerife;037;Santa Cruz de la Palma;17706;8501;9205
38;Santa Cruz de Tenerife;038;Santa Cruz de Tenerife;211209;102589;108620
38;Santa Cruz de Tenerife;039;Santa Úrsula;8264;4127;4137
38;Santa Cruz de Tenerife;040;Santiago del Teide;4337;2170;2167
38;Santa Cruz de Tenerife;041;Sauzal (El);5691;2836;2855
38;Santa Cruz de Tenerife;042;Silos (Los);5445;2672;2773
38;Santa Cruz de Tenerife;043;Tacoronte;16846;8428;8418
38;Santa Cruz de Tenerife;044;Tanque (El);2751;1370;1381
38;Santa Cruz de Tenerife;045;Tazacorte;7020;3519;3501
38;Santa Cruz de Tenerife;046;Tegueste;7138;3577;3561
38;Santa Cruz de Tenerife;047;Tijarafe;2725;1386;1339
38;Santa Cruz de Tenerife;049;Valle Gran Rey;2968;1537;1431
38;Santa Cruz de Tenerife;050;Vallehermoso;3385;1676;1709
38;Santa Cruz de Tenerife;048;Valverde;3590;1789;1801
38;Santa Cruz de Tenerife;051;Victoria de Acentejo (La);7322;3716;3606
38;Santa Cruz de Tenerife;052;Vilaflor;1536;777;759
38;Santa Cruz de Tenerife;053;Villa de Mazo;5072;2540;2532
39;Cantabria;001;Alfoz de Lloredo;2915;1501;1414
39;Cantabria;002;Ampuero;3340;1658;1682
39;Cantabria;003;Anievas;489;246;243
39;Cantabria;004;Arenas de Iguña;2479;1257;1222
39;Cantabria;005;Argoños;636;317;319
39;Cantabria;006;Arnuero;1825;908;917
39;Cantabria;007;Arredondo;803;418;385
39;Cantabria;008;Astillero (El);12327;6123;6204
39;Cantabria;009;Bárcena de Cicero;2347;1170;1177
39;Cantabria;010;Bárcena de Pie de Concha;958;459;499
39;Cantabria;011;Bareyo;1627;839;788
39;Cantabria;012;Cabezón de la Sal;6436;3149;3287
39;Cantabria;013;Cabezón de Liébana;953;494;459
39;Cantabria;014;Cabuérniga;1189;592;597
39;Cantabria;015;Camaleño;1349;693;656
39;Cantabria;016;Camargo;19105;9406;9699
39;Cantabria;027;Campoo de Enmedio;4271;2181;2090
39;Cantabria;017;Campoo de Yuso;932;484;448
39;Cantabria;018;Cartes;2199;1075;1124
39;Cantabria;019;Castañeda;1630;803;827
39;Cantabria;020;Castro-Urdiales;12969;6477;6492
39;Cantabria;021;Cieza;828;415;413
39;Cantabria;022;Cillorigo de Liébana;1296;683;613
39;Cantabria;023;Colindres;5363;2680;2683
39;Cantabria;024;Comillas;2498;1195;1303
39;Cantabria;025;Corrales de Buelna (Los);9742;4824;4918
39;Cantabria;026;Corvera de Toranzo;2292;1143;1149
39;Cantabria;028;Entrambasaguas;2646;1306;1340
39;Cantabria;029;Escalante;766;381;385
39;Cantabria;030;Guriezo;1876;947;929
39;Cantabria;031;Hazas de Cesto;1382;699;683
39;Cantabria;032;Hermandad de Campoo de Suso;1967;1024;943
39;Cantabria;033;Herrerías;956;509;447
39;Cantabria;034;Lamasón;512;277;235
39;Cantabria;035;Laredo;12921;6347;6574
39;Cantabria;036;Liendo;817;431;386
39;Cantabria;037;Liérganes;2395;1178;1217
39;Cantabria;038;Limpias;1193;602;591
39;Cantabria;039;Luena;1287;663;624
39;Cantabria;040;Marina de Cudeyo;4607;2293;2314
39;Cantabria;041;Mazcuerras;1851;946;905
39;Cantabria;042;Medio Cudeyo;5538;2700;2838
39;Cantabria;043;Meruelo;853;434;419
39;Cantabria;044;Miengo;3059;1529;1530
39;Cantabria;045;Miera;798;386;412
39;Cantabria;046;Molledo;2292;1111;1181
39;Cantabria;047;Noja;1497;766;731
39;Cantabria;048;Penagos;1847;916;931
39;Cantabria;049;Peñarrubia;394;193;201
39;Cantabria;050;Pesaguero;520;280;240
39;Cantabria;051;Pesquera;119;51;68
39;Cantabria;052;Piélagos;9130;4519;4611
39;Cantabria;053;Polaciones;402;222;180
39;Cantabria;054;Polanco;3753;1821;1932
39;Cantabria;055;Potes;1480;726;754
39;Cantabria;056;Puente Viesgo;2502;1246;1256
39;Cantabria;057;Ramales de la Victoria;2504;1249;1255
39;Cantabria;058;Rasines;1111;571;540
39;Cantabria;059;Reinosa;13116;6432;6684
39;Cantabria;060;Reocín;6447;3225;3222
39;Cantabria;061;Ribamontán al Mar;2700;1384;1316
39;Cantabria;062;Ribamontán al Monte;2184;1110;1074
39;Cantabria;063;Rionansa;1838;968;870
39;Cantabria;064;Riotuerto;1660;807;853
39;Cantabria;065;Rozas de Valdearroyo (Las);289;152;137
39;Cantabria;066;Ruente;1031;524;507
39;Cantabria;067;Ruesga;1468;731;737
39;Cantabria;068;Ruiloba;791;393;398
39;Cantabria;069;San Felices de Buelna;2431;1218;1213
39;Cantabria;070;San Miguel de Aguayo;191;105;86
39;Cantabria;071;San Pedro del Romeral;1009;517;492
39;Cantabria;072;San Roque de Riomiera;646;343;303
39;Cantabria;080;San Vicente de la Barquera;4448;2296;2152
39;Cantabria;073;Santa Cruz de Bezana;4003;1993;2010
39;Cantabria;074;Santa María de Cayón;5906;2962;2944
39;Cantabria;075;Santander;186145;88320;97825
39;Cantabria;076;Santillana del Mar;3903;1915;1988
39;Cantabria;077;Santiurde de Reinosa;474;244;230
39;Cantabria;078;Santiurde de Toranzo;1874;958;916
39;Cantabria;079;Santoña;11001;5393;5608
39;Cantabria;081;Saro;618;326;292
39;Cantabria;082;Selaya;2020;1025;995
39;Cantabria;083;Soba;2014;1058;956
39;Cantabria;084;Solórzano;1097;556;541
39;Cantabria;085;Suances;5680;2814;2866
39;Cantabria;086;Tojos (Los);447;227;220
39;Cantabria;087;Torrelavega;58539;28647;29892
39;Cantabria;088;Tresviso;91;52;39
39;Cantabria;089;Tudanca;389;215;174
39;Cantabria;090;Udías;878;432;446
39;Cantabria;095;Val de San Vicente;2619;1335;1284
39;Cantabria;091;Valdáliga;2851;1459;1392
39;Cantabria;092;Valdeolea;2181;1126;1055
39;Cantabria;093;Valdeprado del Río;459;235;224
39;Cantabria;094;Valderredible;1456;745;711
39;Cantabria;096;Vega de Liébana;1203;623;580
39;Cantabria;097;Vega de Pas;1286;664;622
39;Cantabria;098;Villacarriedo;2159;1092;1067
39;Cantabria;099;Villaescusa;2966;1445;1521
39;Cantabria;100;Villafufre;1213;618;595
39;Cantabria;101;Villaverde de Trucíos;457;241;216
39;Cantabria;102;Voto;2713;1409;1304
40;Segovia;001;Abades;955;486;469
40;Segovia;002;Adrada de Pirón;49;26;23
40;Segovia;003;Adrados;335;153;182
40;Segovia;004;Aguilafuente;821;406;415
40;Segovia;005;Alconada de Maderuelo;70;35;35
40;Segovia;012;Aldea Real;461;244;217
40;Segovia;006;Aldealcorvo;48;23;25
40;Segovia;007;Aldealengua de Pedraza;115;63;52
40;Segovia;008;Aldealengua de Santa María;118;70;48
40;Segovia;009;Aldeanueva de la Serrezuela;56;33;23
40;Segovia;010;Aldeanueva del Codonal;291;144;147
40;Segovia;013;Aldeasoña;189;89;100
40;Segovia;014;Aldehorno;114;64;50
40;Segovia;015;Aldehuela del Codonal;68;26;42
40;Segovia;016;Aldeonte;128;66;62
40;Segovia;017;Anaya;138;75;63
40;Segovia;018;Añe;144;77;67
40;Segovia;019;Arahuetes;59;30;29
40;Segovia;020;Arcones;309;163;146
40;Segovia;021;Arevalillo de Cega;40;20;20
40;Segovia;022;Armuña;367;181;186
40;Segovia;024;Ayllón;1335;665;670
40;Segovia;025;Barbolla;260;133;127
40;Segovia;026;Basardilla;102;51;51
40;Segovia;028;Bercial;189;97;92
40;Segovia;029;Bercimuel;102;42;60
40;Segovia;030;Bernardos;851;410;441
40;Segovia;031;Bernuy de Porreros;367;189;178
40;Segovia;032;Boceguillas;602;294;308
40;Segovia;033;Brieva;57;35;22
40;Segovia;034;Caballar;126;63;63
40;Segovia;035;Cabañas de Polendos;128;63;65
40;Segovia;036;Cabezuela;790;413;377
40;Segovia;037;Calabazas de Fuentidueña;135;66;69
40;Segovia;039;Campo de San Pedro;441;246;195
40;Segovia;040;Cantalejo;3620;1803;1817
40;Segovia;041;Cantimpalos;1388;702;686
40;Segovia;043;Carbonero el Mayor;2485;1246;1239
40;Segovia;044;Carrascal del Río;254;130;124
40;Segovia;045;Casla;142;70;72
40;Segovia;046;Castillejo de Mesleón;149;77;72
40;Segovia;047;Castro de Fuentidueña;125;71;54
40;Segovia;048;Castrojimeno;71;40;31
40;Segovia;049;Castroserna de Abajo;92;52;40
40;Segovia;051;Castroserracín;53;31;22
40;Segovia;052;Cedillo de la Torre;172;87;85
40;Segovia;053;Cerezo de Abajo;184;89;95
40;Segovia;054;Cerezo de Arriba;214;112;102
40;Segovia;065;Chañe;803;419;384
40;Segovia;055;Cilleruelo de San Mamés;76;41;35
40;Segovia;056;Cobos de Fuentidueña;109;49;60
40;Segovia;057;Coca;2121;1046;1075
40;Segovia;058;Codorniz;570;282;288
40;Segovia;059;Collado Hermoso;112;53;59
40;Segovia;060;Condado de Castilnovo;189;103;86
40;Segovia;061;Corral de Ayllón;149;87;62
40;Segovia;902;Cozuelos de Fuentidueña;283;140;143
40;Segovia;062;Cubillo;76;42;34
40;Segovia;063;Cuéllar;9279;4698;4581
40;Segovia;905;Cuevas de Provanco;"";"";""
40;Segovia;068;Domingo García;43;19;24
40;Segovia;069;Donhierro;123;74;49
40;Segovia;070;Duruelo;106;55;51
40;Segovia;071;Encinas;88;44;44
40;Segovia;072;Encinillas;96;46;50
40;Segovia;073;Escalona del Prado;675;332;343
40;Segovia;074;Escarabajosa de Cabezas;429;230;199
40;Segovia;075;Escobar de Polendos;277;137;140
40;Segovia;076;Espinar (El);5030;2525;2505
40;Segovia;077;Espirdo;214;127;87
40;Segovia;078;Fresneda de Cuéllar;300;157;143
40;Segovia;079;Fresno de Cantespino;244;127;117
40;Segovia;080;Fresno de la Fuente;105;56;49
40;Segovia;081;Frumales;300;148;152
40;Segovia;082;Fuente de Santa Cruz;233;120;113
40;Segovia;083;Fuente el Olmo de Fuentidueña;233;115;118
40;Segovia;084;Fuente el Olmo de Íscar;140;77;63
40;Segovia;086;Fuentepelayo;1089;563;526
40;Segovia;087;Fuentepiñel;220;108;112
40;Segovia;088;Fuenterrebollo;544;270;274
40;Segovia;089;Fuentesaúco de Fuentidueña;425;216;209
40;Segovia;091;Fuentesoto;222;112;110
40;Segovia;092;Fuentidueña;257;124;133
40;Segovia;093;Gallegos;119;60;59
40;Segovia;094;Garcillán;360;194;166
40;Segovia;095;Gomezserracín;671;346;325
40;Segovia;097;Grajera;78;41;37
40;Segovia;099;Honrubia de la Cuesta;117;61;56
40;Segovia;100;Hontalbilla;612;323;289
40;Segovia;101;Hontanares de Eresma;139;75;64
40;Segovia;103;Huertos (Los);175;88;87
40;Segovia;104;Ituero y Lama;54;29;25
40;Segovia;105;Juarros de Riomoros;104;52;52
40;Segovia;106;Juarros de Voltoya;340;186;154
40;Segovia;107;Labajos;196;104;92
40;Segovia;108;Laguna de Contreras;258;133;125
40;Segovia;109;Languilla;188;95;93
40;Segovia;110;Lastras de Cuéllar;696;364;332
40;Segovia;111;Lastras del Pozo;126;64;62
40;Segovia;112;Lastrilla (La);466;228;238
40;Segovia;113;Losa (La);273;137;136
40;Segovia;115;Maderuelo;190;92;98
40;Segovia;903;Marazoleja;204;111;93
40;Segovia;118;Marazuela;106;56;50
40;Segovia;119;Martín Miguel;230;110;120
40;Segovia;120;Martín Muñoz de la Dehesa;180;97;83
40;Segovia;121;Martín Muñoz de las Posadas;698;354;344
40;Segovia;122;Marugán;233;125;108
40;Segovia;124;Mata de Cuéllar;356;189;167
40;Segovia;123;Matabuena;232;116;116
40;Segovia;125;Matilla (La);138;72;66
40;Segovia;126;Melque de Cercos;195;97;98
40;Segovia;127;Membibre de la Hoz;115;59;56
40;Segovia;128;Migueláñez;208;104;104
40;Segovia;129;Montejo de Arévalo;369;208;161
40;Segovia;130;Montejo de la Vega de la Serrezuela;240;123;117
40;Segovia;131;Monterrubio;88;40;48
40;Segovia;132;Moral de Hornuez;169;84;85
40;Segovia;134;Mozoncillo;1108;571;537
40;Segovia;135;Muñopedro;504;257;247
40;Segovia;136;Muñoveros;261;135;126
40;Segovia;138;Nava de la Asunción;2673;1374;1299
40;Segovia;139;Navafría;448;238;210
40;Segovia;140;Navalilla;236;119;117
40;Segovia;141;Navalmanzano;1242;639;603
40;Segovia;142;Navares de Ayuso;92;49;43
40;Segovia;143;Navares de Enmedio;218;107;111
40;Segovia;144;Navares de las Cuevas;37;19;18
40;Segovia;145;Navas de Oro;1614;805;809
40;Segovia;904;Navas de Riofrío;193;88;105
40;Segovia;146;Navas de San Antonio;366;197;169
40;Segovia;148;Nieva;410;205;205
40;Segovia;149;Olombrada;1002;538;464
40;Segovia;150;Orejana;136;74;62
40;Segovia;151;Ortigosa de Pestaño;113;61;52
40;Segovia;901;Ortigosa del Monte;286;146;140
40;Segovia;152;Otero de Herreros;852;430;422
40;Segovia;154;Pajarejos;52;23;29
40;Segovia;155;Palazuelos de Eresma;1060;549;511
40;Segovia;156;Pedraza;467;225;242
40;Segovia;157;Pelayos del Arroyo;64;34;30
40;Segovia;158;Perosillo;35;21;14
40;Segovia;159;Pinarejos;271;146;125
40;Segovia;160;Pinarnegrillo;231;116;115
40;Segovia;161;Pradales;70;38;32
40;Segovia;162;Prádena;591;294;297
40;Segovia;163;Puebla de Pedraza;118;60;58
40;Segovia;164;Rapariegos;331;175;156
40;Segovia;165;Rebollo;165;92;73
40;Segovia;166;Remondo;410;202;208
40;Segovia;168;Riaguas de San Bartolomé;102;56;46
40;Segovia;170;Riaza;1511;796;715
40;Segovia;171;Ribota;59;28;31
40;Segovia;172;Riofrío de Riaza;65;36;29
40;Segovia;173;Roda de Eresma;104;48;56
40;Segovia;174;Sacramenia;982;516;466
40;Segovia;176;Samboal;805;415;390
40;Segovia;177;San Cristóbal de Cuéllar;309;152;157
40;Segovia;178;San Cristóbal de la Vega;210;103;107
40;Segovia;906;San Cristóbal de Segovia;"";"";""
40;Segovia;181;San Ildefonso;4878;2387;2491
40;Segovia;182;San Martín y Mudrián;404;205;199
40;Segovia;183;San Miguel de Bernuy;250;129;121
40;Segovia;184;San Pedro de Gaíllos;333;174;159
40;Segovia;179;Sanchonuño;767;380;387
40;Segovia;180;Sangarcía;596;307;289
40;Segovia;185;Santa María la Real de Nieva;1786;896;890
40;Segovia;186;Santa Marta del Cerro;67;33;34
40;Segovia;188;Santiuste de Pedraza;155;81;74
40;Segovia;189;Santiuste de San Juan Bautista;923;466;457
40;Segovia;190;Santo Domingo de Pirón;59;29;30
40;Segovia;191;Santo Tomé del Puerto;417;210;207
40;Segovia;192;Sauquillo de Cabezas;291;154;137
40;Segovia;193;Sebúlcor;271;145;126
40;Segovia;194;Segovia;53397;25727;27670
40;Segovia;195;Sepúlveda;1528;777;751
40;Segovia;196;Sequera de Fresno;86;48;38
40;Segovia;198;Sotillo;80;38;42
40;Segovia;199;Sotosalbos;111;55;56
40;Segovia;200;Tabanera la Luenga;103;55;48
40;Segovia;201;Tolocirio;85;42;43
40;Segovia;206;Torre Val de San Pedro;179;93;86
40;Segovia;202;Torreadrada;200;101;99
40;Segovia;203;Torrecaballeros;238;114;124
40;Segovia;204;Torrecilla del Pinar;433;205;228
40;Segovia;205;Torreiglesias;463;248;215
40;Segovia;207;Trescasas;170;94;76
40;Segovia;208;Turégano;1202;594;608
40;Segovia;210;Urueñas;187;102;85
40;Segovia;211;Valdeprados;56;25;31
40;Segovia;212;Valdevacas de Montejo;51;29;22
40;Segovia;213;Valdevacas y Guijar;183;99;84
40;Segovia;218;Valle de Tabladillo;250;131;119
40;Segovia;219;Vallelado;931;474;457
40;Segovia;220;Valleruela de Pedraza;79;44;35
40;Segovia;221;Valleruela de Sepúlveda;97;50;47
40;Segovia;214;Valseca;357;182;175
40;Segovia;215;Valtiendas;296;158;138
40;Segovia;216;Valverde del Majano;543;274;269
40;Segovia;222;Veganzones;370;182;188
40;Segovia;223;Vegas de Matute;307;164;143
40;Segovia;224;Ventosilla y Tejadilla;32;17;15
40;Segovia;225;Villacastín;1658;859;799
40;Segovia;228;Villaverde de Íscar;812;419;393
40;Segovia;229;Villaverde de Montejo;105;54;51
40;Segovia;230;Villeguillo;159;88;71
40;Segovia;231;Yanguas de Eresma;236;107;129
40;Segovia;233;Zarzuela del Monte;558;285;273
40;Segovia;234;Zarzuela del Pinar;700;368;332
41;Sevilla;001;Aguadulce;1940;968;972
41;Sevilla;002;Alanís;2235;1129;1106
41;Sevilla;003;Albaida del Aljarafe;1677;851;826
41;Sevilla;004;Alcalá de Guadaira;50181;25014;25167
41;Sevilla;005;Alcalá del Río;8828;4517;4311
41;Sevilla;006;Alcolea del Río;3468;1698;1770
41;Sevilla;007;Algaba (La);12080;6061;6019
41;Sevilla;008;Algámitas;1569;809;760
41;Sevilla;009;Almadén de la Plata;1905;975;930
41;Sevilla;010;Almensilla;1635;810;825
41;Sevilla;011;Arahal;17011;8452;8559
41;Sevilla;012;Aznalcázar;3070;1547;1523
41;Sevilla;013;Aznalcóllar;5332;2707;2625
41;Sevilla;014;Badolatosa;3109;1569;1540
41;Sevilla;015;Benacazón;4597;2317;2280
41;Sevilla;016;Bollullos de la Mitación;4290;2129;2161
41;Sevilla;017;Bormujos;4890;2395;2495
41;Sevilla;018;Brenes;9861;4972;4889
41;Sevilla;019;Burguillos;3109;1578;1531
41;Sevilla;020;Cabezas de San Juan (Las);14286;7340;6946
41;Sevilla;021;Camas;25161;12396;12765
41;Sevilla;022;Campana (La);5359;2726;2633
41;Sevilla;023;Cantillana;8786;4400;4386
41;Sevilla;901;Cañada Rosal;"";"";""
41;Sevilla;024;Carmona;23773;11932;11841
41;Sevilla;025;Carrión de los Céspedes;2471;1189;1282
41;Sevilla;026;Casariche;4842;2477;2365
41;Sevilla;027;Castilblanco de los Arroyos;3735;1895;1840
41;Sevilla;028;Castilleja de Guzmán;216;105;111
41;Sevilla;029;Castilleja de la Cuesta;13527;6692;6835
41;Sevilla;030;Castilleja del Campo;612;306;306
41;Sevilla;031;Castillo de las Guardas (El);1834;943;891
41;Sevilla;032;Cazalla de la Sierra;5357;2698;2659
41;Sevilla;033;Constantina;7825;3863;3962
41;Sevilla;034;Coria del Río;21364;10663;10701
41;Sevilla;035;Coripe;1848;959;889
41;Sevilla;036;Coronil (El);5205;2688;2517
41;Sevilla;037;Corrales (Los);3849;1981;1868
41;Sevilla;903;Cuervo de Sevilla (El);"";"";""
41;Sevilla;038;Dos Hermanas;66819;32956;33863
41;Sevilla;039;Écija;35161;17381;17780
41;Sevilla;040;Espartinas;2273;1172;1101
41;Sevilla;041;Estepa;10459;5139;5320
41;Sevilla;042;Fuentes de Andalucía;7605;3793;3812
41;Sevilla;043;Garrobo (El);745;369;376
41;Sevilla;044;Gelves;3703;1779;1924
41;Sevilla;045;Gerena;5039;2520;2519
41;Sevilla;046;Gilena;3698;1851;1847
41;Sevilla;047;Gines;4755;2338;2417
41;Sevilla;048;Guadalcanal;3287;1622;1665
41;Sevilla;049;Guillena;7573;3850;3723
41;Sevilla;050;Herrera;5454;2704;2750
41;Sevilla;051;Huévar del Aljarafe;2071;1077;994
41;Sevilla;052;Lantejuela (La);3201;1657;1544
41;Sevilla;053;Lebrija;27913;14156;13757
41;Sevilla;054;Lora de Estepa;664;336;328
41;Sevilla;055;Lora del Río;18914;9348;9566
41;Sevilla;056;Luisiana (La);6665;3391;3274
41;Sevilla;057;Madroño (El);467;248;219
41;Sevilla;058;Mairena del Alcor;13730;6855;6875
41;Sevilla;059;Mairena del Aljarafe;16502;8283;8219
41;Sevilla;060;Marchena;17297;8487;8810
41;Sevilla;061;Marinaleda;2380;1175;1205
41;Sevilla;062;Martín de la Jara;2696;1429;1267
41;Sevilla;063;Molares (Los);2641;1348;1293
41;Sevilla;064;Montellano;7037;3557;3480
41;Sevilla;065;Morón de la Frontera;28439;14200;14239
41;Sevilla;066;Navas de la Concepción (Las);2129;1053;1076
41;Sevilla;067;Olivares;6191;3189;3002
41;Sevilla;068;Osuna;16732;8267;8465
41;Sevilla;069;Palacios y Villafranca (Los);27853;14140;13713
41;Sevilla;070;Palomares del Río;1697;869;828
41;Sevilla;071;Paradas;7154;3593;3561
41;Sevilla;072;Pedrera;4656;2354;2302
41;Sevilla;073;Pedroso (El);2474;1219;1255
41;Sevilla;074;Peñaflor;4016;2043;1973
41;Sevilla;075;Pilas;10173;4927;5246
41;Sevilla;076;Pruna;3944;2032;1912
41;Sevilla;077;Puebla de Cazalla (La);10466;5310;5156
41;Sevilla;078;Puebla de los Infantes (La);3936;1989;1947
41;Sevilla;079;Puebla del Río (La);15247;7704;7543
41;Sevilla;080;Real de la Jara (El);1828;926;902
41;Sevilla;081;Rinconada (La);20106;10218;9888
41;Sevilla;082;Roda de Andalucía (La);4012;2002;2010
41;Sevilla;083;Ronquillo (El);1414;712;702
41;Sevilla;084;Rubio (El);3810;1921;1889
41;Sevilla;085;Salteras;2304;1153;1151
41;Sevilla;086;San Juan de Aznalfarache;20808;10254;10554
41;Sevilla;088;San Nicolás del Puerto;748;392;356
41;Sevilla;087;Sanlúcar la Mayor;8666;4317;4349
41;Sevilla;089;Santiponce;6123;3040;3083
41;Sevilla;090;Saucejo (El);4060;2066;1994
41;Sevilla;091;Sevilla;651084;311251;339833
41;Sevilla;092;Tocina;8240;4080;4160
41;Sevilla;093;Tomares;8875;4390;4485
41;Sevilla;094;Umbrete;4020;2020;2000
41;Sevilla;095;Utrera;40736;20432;20304
41;Sevilla;096;Valencina de la Concepción;3826;1944;1882
41;Sevilla;902;Villafranco del Guadalquivir;"";"";""
41;Sevilla;097;Villamanrique de la Condesa;3423;1696;1727
41;Sevilla;100;Villanueva de San Juan;1842;928;914
41;Sevilla;098;Villanueva del Ariscal;3687;1744;1943
41;Sevilla;099;Villanueva del Río y Minas;5813;2830;2983
41;Sevilla;101;Villaverde del Río;6116;3133;2983
41;Sevilla;102;Viso del Alcor (El);14673;7448;7225
42;Soria;001;Abejar;376;194;182
42;Soria;003;Adradas;140;73;67
42;Soria;004;Ágreda;3740;1811;1929
42;Soria;006;Alconaba;163;92;71
42;Soria;007;Alcubilla de Avellaneda;308;161;147
42;Soria;008;Alcubilla de las Peñas;135;67;68
42;Soria;009;Aldealafuente;181;86;95
42;Soria;010;Aldealices;41;20;21
42;Soria;011;Aldealpozo;30;14;16
42;Soria;012;Aldealseñor;60;32;28
42;Soria;013;Aldehuela de Periáñez;52;27;25
42;Soria;014;Aldehuelas (Las);182;94;88
42;Soria;015;Alentisque;70;38;32
42;Soria;016;Aliud;66;30;36
42;Soria;017;Almajano;205;99;106
42;Soria;018;Almaluez;456;230;226
42;Soria;019;Almarza;653;344;309
42;Soria;020;Almazán;5772;2898;2874
42;Soria;021;Almazul;252;124;128
42;Soria;022;Almenar de Soria;509;262;247
42;Soria;023;Alpanseque;176;96;80
42;Soria;024;Arancón;121;66;55
42;Soria;025;Arcos de Jalón;2469;1244;1225
42;Soria;026;Arenillas;57;29;28
42;Soria;027;Arévalo de la Sierra;163;89;74
42;Soria;028;Ausejo de la Sierra;70;38;32
42;Soria;029;Baraona;368;187;181
42;Soria;030;Barca;203;110;93
42;Soria;031;Barcones;73;42;31
42;Soria;032;Bayubas de Abajo;352;189;163
42;Soria;033;Bayubas de Arriba;107;55;52
42;Soria;034;Beratón;54;33;21
42;Soria;035;Berlanga de Duero;1511;758;753
42;Soria;036;Blacos;95;54;41
42;Soria;037;Bliecos;76;40;36
42;Soria;038;Borjabad;81;42;39
42;Soria;039;Borobia;511;255;256
42;Soria;041;Buberos;65;31;34
42;Soria;042;Buitrago;55;31;24
42;Soria;043;Burgo de Osma-Ciudad de Osma;5059;2483;2576
42;Soria;044;Cabrejas del Campo;102;56;46
42;Soria;045;Cabrejas del Pinar;532;284;248
42;Soria;046;Calatañazor;80;43;37
42;Soria;048;Caltojar;207;105;102
42;Soria;049;Candilichera;277;143;134
42;Soria;050;Cañamaque;80;41;39
42;Soria;051;Carabantes;55;29;26
42;Soria;052;Caracena;12;7;5
42;Soria;053;Carrascosa de Abajo;56;30;26
42;Soria;054;Carrascosa de la Sierra;27;12;15
42;Soria;055;Casarejos;330;166;164
42;Soria;056;Castilfrío de la Sierra;42;21;21
42;Soria;058;Castillejo de Robledo;283;158;125
42;Soria;057;Castilruiz;461;238;223
42;Soria;059;Centenera de Andaluz;50;24;26
42;Soria;060;Cerbón;96;53;43
42;Soria;061;Cidones;349;178;171
42;Soria;062;Cigudosa;115;64;51
42;Soria;063;Cihuela;138;70;68
42;Soria;064;Ciria;109;53;56
42;Soria;065;Cirujales del Río;44;23;21
42;Soria;068;Coscurita;205;117;88
42;Soria;069;Covaleda;2214;1149;1065
42;Soria;070;Cubilla;120;67;53
42;Soria;071;Cubo de la Solana;412;210;202
42;Soria;073;Cueva de Ágreda;162;84;78
42;Soria;075;Dévanos;194;100;94
42;Soria;076;Deza;565;294;271
42;Soria;078;Duruelo de la Sierra;1550;796;754
42;Soria;079;Escobosa de Almazán;58;30;28
42;Soria;080;Espeja de San Marcelino;359;194;165
42;Soria;081;Espejón;262;136;126
42;Soria;082;Estepa de San Juan;20;9;11
42;Soria;083;Frechilla de Almazán;69;36;33
42;Soria;084;Fresno de Caracena;70;38;32
42;Soria;085;Fuentearmegil;508;261;247
42;Soria;086;Fuentecambrón;100;56;44
42;Soria;087;Fuentecantos;56;25;31
42;Soria;088;Fuentelmonge;207;103;104
42;Soria;089;Fuentelsaz de Soria;78;40;38
42;Soria;090;Fuentepinilla;220;112;108
42;Soria;092;Fuentes de Magaña;168;81;87
42;Soria;093;Fuentestrún;112;62;50
42;Soria;094;Garray;324;164;160
42;Soria;095;Golmayo;551;294;257
42;Soria;096;Gómara;694;339;355
42;Soria;097;Gormaz;38;16;22
42;Soria;098;Herrera de Soria;48;26;22
42;Soria;100;Hinojosa del Campo;72;42;30
42;Soria;103;Langa de Duero;1185;615;570
42;Soria;105;Liceras;89;42;47
42;Soria;106;Losilla (La);29;17;12
42;Soria;107;Magaña;140;75;65
42;Soria;108;Maján;40;20;20
42;Soria;110;Matalebreras;174;92;82
42;Soria;111;Matamala de Almazán;546;287;259
42;Soria;113;Medinaceli;943;479;464
42;Soria;115;Miño de Medinaceli;190;91;99
42;Soria;116;Miño de San Esteban;149;82;67
42;Soria;117;Molinos de Duero;215;104;111
42;Soria;118;Momblona;62;35;27
42;Soria;119;Monteagudo de las Vicarías;407;201;206
42;Soria;120;Montejo de Tiermes;337;180;157
42;Soria;121;Montenegro de Cameros;143;76;67
42;Soria;123;Morón de Almazán;405;191;214
42;Soria;124;Muriel de la Fuente;109;59;50
42;Soria;125;Muriel Viejo;121;65;56
42;Soria;127;Nafría de Ucero;122;60;62
42;Soria;128;Narros;65;35;30
42;Soria;129;Navaleno;926;457;469
42;Soria;130;Nepas;121;70;51
42;Soria;131;Nolay;121;66;55
42;Soria;132;Noviercas;333;157;176
42;Soria;134;Ólvega;3290;1693;1597
42;Soria;135;Oncala;144;85;59
42;Soria;139;Pinilla del Campo;35;19;16
42;Soria;140;Portillo de Soria;25;15;10
42;Soria;141;Póveda de Soria (La);187;94;93
42;Soria;142;Pozalmuro;144;70;74
42;Soria;144;Quintana Redonda;785;407;378
42;Soria;145;Quintanas de Gormaz;245;118;127
42;Soria;148;Quiñonería;28;12;16
42;Soria;149;Rábanos (Los);501;282;219
42;Soria;151;Rebollar;53;30;23
42;Soria;152;Recuerda;219;112;107
42;Soria;153;Rello;67;27;40
42;Soria;154;Renieblas;135;73;62
42;Soria;155;Retortillo de Soria;319;177;142
42;Soria;156;Reznos;64;33;31
42;Soria;157;Riba de Escalote (La);45;27;18
42;Soria;158;Rioseco de Soria;177;94;83
42;Soria;159;Rollamienta;51;27;24
42;Soria;160;Royo (El);417;198;219
42;Soria;161;Salduero;239;129;110
42;Soria;162;San Esteban de Gormaz;3755;1926;1829
42;Soria;163;San Felices;119;65;54
42;Soria;164;San Leonardo de Yagüe;2136;1074;1062
42;Soria;165;San Pedro Manrique;555;275;280
42;Soria;166;Santa Cruz de Yanguas;71;44;27
42;Soria;167;Santa María de Huerta;579;281;298
42;Soria;168;Santa María de las Hoyas;262;137;125
42;Soria;171;Serón de Nágima;351;171;180
42;Soria;172;Soliedra;47;27;20
42;Soria;173;Soria;31144;14877;16267
42;Soria;174;Sotillo del Rincón;193;98;95
42;Soria;175;Suellacabras;60;26;34
42;Soria;176;Tajahuerce;56;29;27
42;Soria;177;Tajueco;173;94;79
42;Soria;178;Talveila;265;138;127
42;Soria;181;Tardelcuende;769;369;400
42;Soria;182;Taroda;123;63;60
42;Soria;183;Tejado;295;152;143
42;Soria;184;Torlengua;163;76;87
42;Soria;185;Torreblacos;64;27;37
42;Soria;187;Torrubia de Soria;121;69;52
42;Soria;188;Trévago;104;53;51
42;Soria;189;Ucero;101;51;50
42;Soria;190;Vadillo;192;100;92
42;Soria;191;Valdeavellano de Tera;254;127;127
42;Soria;192;Valdegeña;69;36;33
42;Soria;193;Valdelagua del Cerro;61;29;32
42;Soria;194;Valdemaluque;397;200;197
42;Soria;195;Valdenebro;220;114;106
42;Soria;196;Valdeprado;35;14;21
42;Soria;197;Valderrodilla;167;81;86
42;Soria;198;Valtajeros;46;24;22
42;Soria;200;Velamazán;205;111;94
42;Soria;201;Velilla de la Sierra;16;8;8
42;Soria;202;Velilla de los Ajos;77;39;38
42;Soria;204;Viana de Duero;115;61;54
42;Soria;205;Villaciervos;114;57;57
42;Soria;206;Villanueva de Gormaz;21;12;9
42;Soria;207;Villar del Ala;47;20;27
42;Soria;208;Villar del Campo;59;30;29
42;Soria;209;Villar del Río;226;116;110
42;Soria;211;Villares de Soria (Los);123;61;62
42;Soria;212;Villasayas;141;80;61
42;Soria;213;Villaseca de Arciel;62;31;31
42;Soria;215;Vinuesa;1171;612;559
42;Soria;216;Vizmanos;51;32;19
42;Soria;217;Vozmediano;69;37;32
42;Soria;218;Yanguas;102;52;50
42;Soria;219;Yelo;108;52;56
43;Tarragona;001;Aiguamúrcia;611;324;287
43;Tarragona;002;Albinyana;636;331;305
43;Tarragona;003;Albiol (L');69;35;34
43;Tarragona;004;Alcanar;8023;3928;4095
43;Tarragona;005;Alcover;3465;1732;1733
43;Tarragona;904;Aldea (L');3402;1818;1584
43;Tarragona;006;Aldover;837;399;438
43;Tarragona;007;Aleixar (L');637;315;322
43;Tarragona;008;Alfara de Carles;436;221;215
43;Tarragona;009;Alforja;1086;534;552
43;Tarragona;010;Alió;351;181;170
43;Tarragona;011;Almoster;386;192;194
43;Tarragona;012;Altafulla;1427;725;702
43;Tarragona;013;Ametlla de Mar (L');4143;2072;2071
43;Tarragona;906;Ampolla (L');"";"";""
43;Tarragona;014;Amposta;15306;7624;7682
43;Tarragona;016;Arboç (L');3728;1882;1846
43;Tarragona;015;Arbolí;130;64;66
43;Tarragona;017;Argentera (L');153;71;82
43;Tarragona;018;Arnes;557;281;276
43;Tarragona;019;Ascó;1847;931;916
43;Tarragona;020;Banyeres del Penedès;1583;828;755
43;Tarragona;021;Barberà de la Conca;440;221;219
43;Tarragona;022;Batea;2082;1055;1027
43;Tarragona;023;Bellmunt del Priorat;340;168;172
43;Tarragona;024;Bellvei;914;469;445
43;Tarragona;025;Benifallet;1013;502;511
43;Tarragona;026;Benissanet;1070;516;554
43;Tarragona;027;Bisbal de Falset (La);311;158;153
43;Tarragona;028;Bisbal del Penedès (La);1296;660;636
43;Tarragona;029;Blancafort;422;210;212
43;Tarragona;030;Bonastre;275;133;142
43;Tarragona;031;Borges del Camp (Les);1376;685;691
43;Tarragona;032;Bot;987;499;488
43;Tarragona;033;Botarell;435;217;218
43;Tarragona;034;Bràfim;592;276;316
43;Tarragona;035;Cabacés;367;184;183
43;Tarragona;036;Cabra del Camp;421;217;204
43;Tarragona;037;Calafell;5859;2928;2931
43;Tarragona;903;Camarles;2914;1479;1435
43;Tarragona;038;Cambrils;13752;6885;6867
43;Tarragona;039;Capafonts;104;52;52
43;Tarragona;040;Capçanes;438;202;236
43;Tarragona;041;Caseres;343;171;172
43;Tarragona;042;Castellvell del Camp;699;349;350
43;Tarragona;043;Catllar (El);890;446;444
43;Tarragona;045;Colldejou;205;103;102
43;Tarragona;046;Conesa;137;64;73
43;Tarragona;047;Constantí;5690;2944;2746
43;Tarragona;048;Corbera d'Ebre;1141;589;552
43;Tarragona;049;Cornudella de Montsant;951;484;467
43;Tarragona;050;Creixell;632;319;313
43;Tarragona;051;Cunit;1237;645;592
43;Tarragona;901;Deltebre;10209;5177;5032
43;Tarragona;053;Duesaigües;217;116;101
43;Tarragona;054;Espluga de Francolí (L');3699;1787;1912
43;Tarragona;055;Falset;2603;1260;1343
43;Tarragona;056;Fatarella (La);1432;732;700
43;Tarragona;057;Febró (La);43;22;21
43;Tarragona;058;Figuera (La);141;70;71
43;Tarragona;059;Figuerola del Camp;226;116;110
43;Tarragona;060;Flix;5003;2531;2472
43;Tarragona;061;Forès;64;31;33
43;Tarragona;062;Freginals;407;199;208
43;Tarragona;063;Galera (La);786;381;405
43;Tarragona;064;Gandesa;2736;1375;1361
43;Tarragona;065;Garcia;604;294;310
43;Tarragona;066;Garidells (Els);182;90;92
43;Tarragona;067;Ginestar;938;470;468
43;Tarragona;068;Godall;807;381;426
43;Tarragona;069;Gratallops;270;132;138
43;Tarragona;070;Guiamets (Els);305;160;145
43;Tarragona;071;Horta de Sant Joan;1395;696;699
43;Tarragona;072;Lloar (El);169;83;86
43;Tarragona;073;Llorac;104;47;57
43;Tarragona;074;Llorenç del Penedès;1228;597;631
43;Tarragona;076;Marçà;610;292;318
43;Tarragona;075;Margalef;165;85;80
43;Tarragona;077;Mas de Barberans;784;387;397
43;Tarragona;078;Masdenverge;916;470;446
43;Tarragona;079;Masllorenç;392;192;200
43;Tarragona;080;Masó (La);288;140;148
43;Tarragona;081;Maspujols;375;194;181
43;Tarragona;082;Masroig (El);600;293;307
43;Tarragona;083;Milà (El);154;67;87
43;Tarragona;084;Miravet;844;438;406
43;Tarragona;085;Molar (El);348;173;175
43;Tarragona;086;Montblanc;5643;2807;2836
43;Tarragona;088;Montbrió del Camp;1429;716;713
43;Tarragona;089;Montferri;158;76;82
43;Tarragona;090;Montmell (El);232;120;112
43;Tarragona;091;Mont-ral;171;83;88
43;Tarragona;092;Mont-roig del Camp;4738;2402;2336
43;Tarragona;093;Móra d'Ebre;4253;2067;2186
43;Tarragona;094;Móra la Nova;2870;1434;1436
43;Tarragona;095;Morell (El);2248;1134;1114
43;Tarragona;096;Morera de Montsant (La);188;90;98
43;Tarragona;097;Nou de Gaià (La);370;199;171
43;Tarragona;098;Nulles;371;176;195
43;Tarragona;100;Pallaresos (Els);475;254;221
43;Tarragona;099;Palma d'Ebre (La);481;227;254
43;Tarragona;101;Passanant;213;112;101
43;Tarragona;102;Paüls;748;371;377
43;Tarragona;103;Perafort;498;261;237
43;Tarragona;104;Perelló (El);3713;1878;1835
43;Tarragona;105;Piles (Les);132;73;59
43;Tarragona;106;Pinell de Brai (El);1244;640;604
43;Tarragona;107;Pira;347;170;177
43;Tarragona;108;Pla de Santa Maria (El);1498;755;743
43;Tarragona;109;Pobla de Mafumet (La);816;405;411
43;Tarragona;110;Pobla de Massaluca (La);492;257;235
43;Tarragona;111;Pobla de Montornès (La);809;411;398
43;Tarragona;112;Poboleda;385;192;193
43;Tarragona;113;Pont d'Armentera (El);592;281;311
43;Tarragona;141;Pontils;123;59;64
43;Tarragona;114;Porrera;474;241;233
43;Tarragona;115;Pradell de la Teixeta;279;144;135
43;Tarragona;116;Prades;546;282;264
43;Tarragona;117;Prat de Comte;232;107;125
43;Tarragona;118;Pratdip;482;230;252
43;Tarragona;119;Puigpelat;442;217;225
43;Tarragona;120;Querol;209;108;101
43;Tarragona;121;Rasquera;906;477;429
43;Tarragona;122;Renau;47;27;20
43;Tarragona;123;Reus;81145;39726;41419
43;Tarragona;124;Riba (La);996;492;504
43;Tarragona;125;Riba-roja d'Ebre;1789;928;861
43;Tarragona;126;Riera de Gaià (La);947;445;502
43;Tarragona;127;Riudecanyes;577;288;289
43;Tarragona;128;Riudecols;919;478;441
43;Tarragona;129;Riudoms;4763;2372;2391
43;Tarragona;130;Rocafort de Queralt;277;150;127
43;Tarragona;131;Roda de Barà;1765;887;878
43;Tarragona;132;Rodonyà;371;194;177
43;Tarragona;133;Roquetes;5825;2872;2953
43;Tarragona;134;Rourell (El);288;156;132
43;Tarragona;135;Salomó;454;226;228
43;Tarragona;905;Salou;"";"";""
43;Tarragona;136;Sant Carles de la Ràpita;10306;5131;5175
43;Tarragona;137;Sant Jaume dels Domenys;1122;574;548
43;Tarragona;902;Sant Jaume d'Enveja;3487;1771;1716
43;Tarragona;138;Santa Bàrbara;3337;1636;1701
43;Tarragona;139;Santa Coloma de Queralt;2622;1267;1355
43;Tarragona;140;Santa Oliva;1261;653;608
43;Tarragona;142;Sarral;1409;705;704
43;Tarragona;143;Savallà del Comtat;62;29;33
43;Tarragona;144;Secuita (La);941;466;475
43;Tarragona;145;Selva del Camp (La);3349;1646;1703
43;Tarragona;146;Senan;28;19;9
43;Tarragona;044;Sénia (La);4638;2335;2303
43;Tarragona;147;Solivella;748;347;401
43;Tarragona;148;Tarragona;106495;52262;54233
43;Tarragona;149;Tivenys;1110;551;559
43;Tarragona;150;Tivissa;1815;893;922
43;Tarragona;151;Torre de Fontaubella (La);77;35;42
43;Tarragona;152;Torre de l'Espanyol (La);744;370;374
43;Tarragona;153;Torredembarra;5838;2903;2935
43;Tarragona;154;Torroja del Priorat;139;69;70
43;Tarragona;155;Tortosa;28815;13902;14913
43;Tarragona;156;Ulldecona;5230;2546;2684
43;Tarragona;157;Ulldemolins;557;290;267
43;Tarragona;158;Vallclara;109;55;54
43;Tarragona;159;Vallfogona de Riucorb;113;58;55
43;Tarragona;160;Vallmoll;997;509;488
43;Tarragona;161;Valls;19577;9660;9917
43;Tarragona;162;Vandellòs i l'Hospitalet de l'Infant;4338;2209;2129
43;Tarragona;163;Vendrell (El);13448;6643;6805
43;Tarragona;164;Vespella de Gaià;69;36;33
43;Tarragona;165;Vilabella;816;390;426
43;Tarragona;175;Vilalba dels Arcs;808;429;379
43;Tarragona;166;Vilallonga del Camp;1173;576;597
43;Tarragona;168;Vilanova de Prades;163;80;83
43;Tarragona;167;Vilanova d'Escornalbou;453;221;232
43;Tarragona;169;Vilaplana;513;263;250
43;Tarragona;170;Vila-rodona;1028;531;497
43;Tarragona;171;Vila-seca;17506;8803;8703
43;Tarragona;172;Vilaverd;387;193;194
43;Tarragona;173;Vilella Alta (La);140;72;68
43;Tarragona;174;Vilella Baixa (La);194;99;95
43;Tarragona;176;Vimbodí;1162;594;568
43;Tarragona;177;Vinebre;486;235;251
43;Tarragona;178;Vinyols i els Arcs;826;441;385
43;Tarragona;052;Xerta;1287;619;668
44;Teruel;001;Ababuj;97;58;39
44;Teruel;002;Abejuela;93;49;44
44;Teruel;003;Aguatón;40;21;19
44;Teruel;004;Aguaviva;657;333;324
44;Teruel;005;Aguilar del Alfambra;116;55;61
44;Teruel;006;Alacón;525;267;258
44;Teruel;007;Alba;369;189;180
44;Teruel;008;Albalate del Arzobispo;2677;1297;1380
44;Teruel;009;Albarracín;1129;565;564
44;Teruel;010;Albentosa;305;148;157
44;Teruel;011;Alcaine;33;20;13
44;Teruel;012;Alcalá de la Selva;513;270;243
44;Teruel;013;Alcañiz;11820;5795;6025
44;Teruel;014;Alcorisa;3192;1617;1575
44;Teruel;016;Alfambra;883;441;442
44;Teruel;017;Aliaga;513;265;248
44;Teruel;021;Allepuz;199;107;92
44;Teruel;022;Alloza;989;486;503
44;Teruel;023;Allueva;10;6;4
44;Teruel;018;Almohaja;34;18;16
44;Teruel;019;Alobras;138;72;66
44;Teruel;020;Alpeñés;35;23;12
44;Teruel;024;Anadón;36;17;19
44;Teruel;025;Andorra;8866;4592;4274
44;Teruel;026;Arcos de las Salinas;182;100;82
44;Teruel;027;Arens de Lledó;290;137;153
44;Teruel;028;Argente;344;166;178
44;Teruel;029;Ariño;943;483;460
44;Teruel;031;Azaila;287;155;132
44;Teruel;032;Bádenas;34;17;17
44;Teruel;033;Báguena;688;335;353
44;Teruel;034;Bañón;252;129;123
44;Teruel;035;Barrachina;226;118;108
44;Teruel;036;Bea;29;17;12
44;Teruel;037;Beceite;724;379;345
44;Teruel;039;Bello;546;255;291
44;Teruel;038;Belmonte de San José;205;102;103
44;Teruel;040;Berge;272;138;134
44;Teruel;041;Bezas;72;39;33
44;Teruel;042;Blancas;277;134;143
44;Teruel;043;Blesa;193;101;92
44;Teruel;044;Bordón;161;87;74
44;Teruel;045;Bronchales;465;234;231
44;Teruel;046;Bueña;167;87;80
44;Teruel;047;Burbáguena;404;189;215
44;Teruel;048;Cabra de Mora;112;60;52
44;Teruel;049;Calaceite;1354;689;665
44;Teruel;050;Calamocha;4475;2245;2230
44;Teruel;051;Calanda;3576;1804;1772
44;Teruel;052;Calomarde;100;52;48
44;Teruel;053;Camañas;186;103;83
44;Teruel;054;Camarena de la Sierra;156;80;76
44;Teruel;055;Camarillas;148;83;65
44;Teruel;056;Caminreal;1007;501;506
44;Teruel;059;Cantavieja;806;435;371
44;Teruel;060;Cañada de Benatanduz;90;51;39
44;Teruel;061;Cañada de Verich (La);129;67;62
44;Teruel;062;Cañada Vellida;88;52;36
44;Teruel;063;Cañizar del Olivar;166;88;78
44;Teruel;064;Cascante del Río;168;97;71
44;Teruel;065;Castejón de Tornos;144;72;72
44;Teruel;066;Castel de Cabra;289;145;144
44;Teruel;070;Castellar (El);121;68;53
44;Teruel;071;Castellote;1013;514;499
44;Teruel;067;Castelnou;133;71;62
44;Teruel;068;Castelserás;979;516;463
44;Teruel;074;Cedrillas;584;306;278
44;Teruel;075;Celadas;512;268;244
44;Teruel;076;Cella;3169;1600;1569
44;Teruel;077;Cerollera (La);110;57;53
44;Teruel;080;Codoñera (La);393;200;193
44;Teruel;082;Corbalán;95;52;43
44;Teruel;084;Cortes de Aragón;160;79;81
44;Teruel;085;Cosa;137;76;61
44;Teruel;086;Cretas;778;388;390
44;Teruel;087;Crivillén;169;92;77
44;Teruel;088;Cuba (La);102;49;53
44;Teruel;089;Cubla;81;41;40
44;Teruel;090;Cucalón;120;63;57
44;Teruel;092;Cuervo (El);165;79;86
44;Teruel;093;Cuevas de Almudén;133;72;61
44;Teruel;094;Cuevas Labradas;233;115;118
44;Teruel;096;Ejulve;263;144;119
44;Teruel;097;Escorihuela;297;152;145
44;Teruel;099;Escucha;1330;716;614
44;Teruel;100;Estercuel;437;231;206
44;Teruel;101;Ferreruela de Huerva;127;62;65
44;Teruel;102;Fonfría;40;20;20
44;Teruel;103;Formiche Alto;233;121;112
44;Teruel;105;Fórnoles;139;59;80
44;Teruel;106;Fortanete;269;136;133
44;Teruel;107;Foz-Calanda;279;149;130
44;Teruel;108;Fresneda (La);532;269;263
44;Teruel;109;Frías de Albarracín;220;119;101
44;Teruel;110;Fuenferrada;62;32;30
44;Teruel;111;Fuentes Calientes;195;104;91
44;Teruel;112;Fuentes Claras;813;413;400
44;Teruel;113;Fuentes de Rubielos;82;47;35
44;Teruel;114;Fuentespalda;454;239;215
44;Teruel;115;Galve;167;90;77
44;Teruel;116;Gargallo;145;80;65
44;Teruel;117;Gea de Albarracín;537;264;273
44;Teruel;118;Ginebrosa (La);317;172;145
44;Teruel;119;Griegos;185;107;78
44;Teruel;120;Guadalaviar;318;161;157
44;Teruel;121;Gúdar;101;59;42
44;Teruel;122;Híjar;2164;1069;1095
44;Teruel;123;Hinojosa de Jarque;245;134;111
44;Teruel;124;Hoz de la Vieja (La);207;112;95
44;Teruel;125;Huesa del Común;217;110;107
44;Teruel;126;Iglesuela del Cid (La);553;282;271
44;Teruel;127;Jabaloyas;133;61;72
44;Teruel;128;Jarque de la Val;122;69;53
44;Teruel;129;Jatiel;64;28;36
44;Teruel;130;Jorcas;84;48;36
44;Teruel;131;Josa;62;34;28
44;Teruel;132;Lagueruela;90;48;42
44;Teruel;133;Lanzuela;49;27;22
44;Teruel;135;Libros;240;117;123
44;Teruel;136;Lidón;121;60;61
44;Teruel;137;Linares de Mora;381;214;167
44;Teruel;141;Lledó;258;132;126
44;Teruel;138;Loscos;271;141;130
44;Teruel;142;Maicas;21;8;13
44;Teruel;143;Manzanera;559;304;255
44;Teruel;144;Martín del Río;591;301;290
44;Teruel;145;Mas de las Matas;1544;769;775
44;Teruel;146;Mata de los Olmos (La);304;149;155
44;Teruel;147;Mazaleón;696;353;343
44;Teruel;148;Mezquita de Jarque;194;104;90
44;Teruel;149;Mirambel;158;80;78
44;Teruel;150;Miravete de la Sierra;56;30;26
44;Teruel;151;Molinos;412;199;213
44;Teruel;152;Monforte de Moyuela;124;67;57
44;Teruel;153;Monreal del Campo;2383;1189;1194
44;Teruel;154;Monroyo;414;205;209
44;Teruel;155;Montalbán;2060;1045;1015
44;Teruel;156;Monteagudo del Castillo;97;56;41
44;Teruel;157;Monterde de Albarracín;87;41;46
44;Teruel;158;Mora de Rubielos;1380;713;667
44;Teruel;159;Moscardón;84;41;43
44;Teruel;160;Mosqueruela;782;406;376
44;Teruel;161;Muniesa;939;476;463
44;Teruel;163;Noguera de Albarracín;195;98;97
44;Teruel;164;Nogueras;35;22;13
44;Teruel;165;Nogueruelas;271;137;134
44;Teruel;167;Obón;78;40;38
44;Teruel;168;Odón;328;162;166
44;Teruel;169;Ojos Negros;926;472;454
44;Teruel;171;Olba;263;134;129
44;Teruel;172;Oliete;619;312;307
44;Teruel;173;Olmos (Los);195;105;90
44;Teruel;174;Orihuela del Tremedal;722;339;383
44;Teruel;175;Orrios;221;116;105
44;Teruel;176;Palomar de Arroyos;351;186;165
44;Teruel;177;Pancrudo;279;155;124
44;Teruel;178;Parras de Castellote (Las);127;66;61
44;Teruel;179;Peñarroya de Tastavins;617;309;308
44;Teruel;180;Peracense;109;51;58
44;Teruel;181;Peralejos;124;60;64
44;Teruel;182;Perales del Alfambra;346;192;154
44;Teruel;183;Pitarque;131;65;66
44;Teruel;184;Plou;65;31;34
44;Teruel;185;Pobo (El);200;107;93
44;Teruel;187;Portellada (La);394;207;187
44;Teruel;189;Pozondón;116;60;56
44;Teruel;190;Pozuel del Campo;160;86;74
44;Teruel;191;Puebla de Híjar (La);1367;655;712
44;Teruel;192;Puebla de Valverde (La);520;268;252
44;Teruel;193;Puertomingalvo;200;99;101
44;Teruel;194;Ráfales;294;153;141
44;Teruel;195;Rillo;224;121;103
44;Teruel;196;Riodeva;307;152;155
44;Teruel;197;Ródenas;117;59;58
44;Teruel;198;Royuela;244;141;103
44;Teruel;199;Rubiales;37;17;20
44;Teruel;200;Rubielos de la Cérida;79;41;38
44;Teruel;201;Rubielos de Mora;647;313;334
44;Teruel;203;Salcedillo;8;4;4
44;Teruel;204;Saldón;63;41;22
44;Teruel;205;Samper de Calanda;1273;619;654
44;Teruel;206;San Agustín;218;114;104
44;Teruel;207;San Martín del Río;418;202;216
44;Teruel;208;Santa Cruz de Nogueras;36;21;15
44;Teruel;209;Santa Eulalia;1610;780;830
44;Teruel;210;Sarrión;1143;595;548
44;Teruel;211;Segura de los Baños;88;50;38
44;Teruel;212;Seno;71;37;34
44;Teruel;213;Singra;140;73;67
44;Teruel;215;Terriente;221;120;101
44;Teruel;216;Teruel;27226;13255;13971
44;Teruel;217;Toril y Masegoso;51;29;22
44;Teruel;218;Tormón;65;34;31
44;Teruel;219;Tornos;331;168;163
44;Teruel;220;Torralba de los Sisones;276;140;136
44;Teruel;223;Torre de Arcas;140;64;76
44;Teruel;224;Torre de las Arcas;45;27;18
44;Teruel;225;Torre del Compte;238;110;128
44;Teruel;227;Torre los Negros;122;58;64
44;Teruel;221;Torrecilla de Alcañiz;508;262;246
44;Teruel;222;Torrecilla del Rebollar;221;117;104
44;Teruel;226;Torrelacárcel;383;195;188
44;Teruel;228;Torremocha de Jiloca;232;110;122
44;Teruel;229;Torres de Albarracín;217;113;104
44;Teruel;230;Torrevelilla;233;113;120
44;Teruel;231;Torrijas;88;49;39
44;Teruel;232;Torrijo del Campo;718;367;351
44;Teruel;234;Tramacastiel;153;71;82
44;Teruel;235;Tramacastilla;162;82;80
44;Teruel;236;Tronchón;135;68;67
44;Teruel;237;Urrea de Gaén;750;356;394
44;Teruel;238;Utrillas;4362;2253;2109
44;Teruel;239;Valacloche;39;21;18
44;Teruel;240;Valbona;224;120;104
44;Teruel;241;Valdealgorfa;871;437;434
44;Teruel;243;Valdecuenca;41;23;18
44;Teruel;244;Valdelinares;139;73;66
44;Teruel;245;Valdeltormo;491;252;239
44;Teruel;246;Valderrobres;1847;918;929
44;Teruel;247;Valjunquera;521;259;262
44;Teruel;249;Vallecillo (El);18;10;8
44;Teruel;250;Veguillas de la Sierra;38;19;19
44;Teruel;251;Villafranca del Campo;495;256;239
44;Teruel;252;Villahermosa del Campo;106;55;51
44;Teruel;256;Villanueva del Rebollar de la Sierra;64;31;33
44;Teruel;257;Villar del Cobo;263;134;129
44;Teruel;258;Villar del Salz;165;86;79
44;Teruel;260;Villarluengo;264;132;132
44;Teruel;261;Villarquemado;1108;556;552
44;Teruel;262;Villarroya de los Pinares;227;116;111
44;Teruel;263;Villastar;393;201;192
44;Teruel;264;Villel;427;210;217
44;Teruel;265;Vinaceite;404;211;193
44;Teruel;266;Visiedo;306;160;146
44;Teruel;267;Vivel del Río Martín;176;90;86
44;Teruel;268;Zoma (La);44;23;21
45;Toledo;001;Ajofrín;2091;1077;1014
45;Toledo;002;Alameda de la Sagra;2615;1359;1256
45;Toledo;003;Albarreal de Tajo;577;280;297
45;Toledo;004;Alcabón;513;252;261
45;Toledo;005;Alcañizo;439;223;216
45;Toledo;006;Alcaudete de la Jara;1612;773;839
45;Toledo;007;Alcolea de Tajo;893;434;459
45;Toledo;008;Aldea en Cabo;235;125;110
45;Toledo;009;Aldeanueva de Barbarroya;1051;523;528
45;Toledo;010;Aldeanueva de San Bartolomé;910;455;455
45;Toledo;011;Almendral de la Cañada;477;249;228
45;Toledo;012;Almonacid de Toledo;928;448;480
45;Toledo;013;Almorox;2187;1132;1055
45;Toledo;014;Añover de Tajo;4302;2194;2108
45;Toledo;015;Arcicóllar;452;230;222
45;Toledo;016;Argés;1620;825;795
45;Toledo;017;Azután;389;203;186
45;Toledo;018;Barcience;126;63;63
45;Toledo;019;Bargas;5476;2766;2710
45;Toledo;020;Belvís de la Jara;2122;1039;1083
45;Toledo;021;Borox;1917;954;963
45;Toledo;022;Buenaventura;520;264;256
45;Toledo;023;Burguillos de Toledo;601;307;294
45;Toledo;024;Burujón;1252;658;594
45;Toledo;025;Cabañas de la Sagra;906;473;433
45;Toledo;026;Cabañas de Yepes;284;149;135
45;Toledo;027;Cabezamesada;652;329;323
45;Toledo;028;Calera y Chozas;3688;1885;1803
45;Toledo;029;Caleruela;417;202;215
45;Toledo;030;Calzada de Oropesa;713;338;375
45;Toledo;031;Camarena;1890;964;926
45;Toledo;032;Camarenilla;569;286;283
45;Toledo;033;Campillo de la Jara (El);754;384;370
45;Toledo;034;Camuñas;1819;914;905
45;Toledo;035;Cardiel de los Montes;152;70;82
45;Toledo;036;Carmena;852;421;431
45;Toledo;037;Carpio de Tajo (El);2475;1166;1309
45;Toledo;038;Carranque;895;438;457
45;Toledo;039;Carriches;326;156;170
45;Toledo;040;Casar de Escalona (El);948;487;461
45;Toledo;041;Casarrubios del Monte;1619;809;810
45;Toledo;042;Casasbuenas;282;141;141
45;Toledo;043;Castillo de Bayuela;1086;570;516
45;Toledo;045;Cazalegas;1162;585;577
45;Toledo;046;Cebolla;2552;1282;1270
45;Toledo;047;Cedillo del Condado;980;505;475
45;Toledo;048;Cerralbos (Los);530;265;265
45;Toledo;049;Cervera de los Montes;493;254;239
45;Toledo;056;Chozas de Canales;921;466;455
45;Toledo;057;Chueca;258;127;131
45;Toledo;050;Ciruelos;346;170;176
45;Toledo;051;Cobeja;1605;802;803
45;Toledo;052;Cobisa;189;93;96
45;Toledo;053;Consuegra;9956;4870;5086
45;Toledo;054;Corral de Almaguer;6300;3117;3183
45;Toledo;055;Cuerva;1260;624;636
45;Toledo;058;Domingo Pérez;605;310;295
45;Toledo;059;Dosbarrios;2073;1074;999
45;Toledo;060;Erustes;220;111;109
45;Toledo;061;Escalona;1674;825;849
45;Toledo;062;Escalonilla;1507;746;761
45;Toledo;063;Espinoso del Rey;744;376;368
45;Toledo;064;Esquivias;3208;1610;1598
45;Toledo;065;Estrella (La);699;364;335
45;Toledo;066;Fuensalida;6246;3147;3099
45;Toledo;067;Gálvez;3258;1659;1599
45;Toledo;068;Garciotum;183;88;95
45;Toledo;069;Gerindote;1627;827;800
45;Toledo;070;Guadamur;1519;776;743
45;Toledo;071;Guardia (La);2527;1230;1297
45;Toledo;072;Herencias (Las);892;452;440
45;Toledo;073;Herreruela de Oropesa;529;265;264
45;Toledo;074;Hinojosa de San Vicente;584;316;268
45;Toledo;075;Hontanar;114;60;54
45;Toledo;076;Hormigos;398;209;189
45;Toledo;077;Huecas;361;190;171
45;Toledo;078;Huerta de Valdecarábanos;1778;864;914
45;Toledo;079;Iglesuela (La);518;271;247
45;Toledo;080;Illán de Vacas;10;7;3
45;Toledo;081;Illescas;7026;3563;3463
45;Toledo;082;Lagartera;2036;982;1054
45;Toledo;083;Layos;263;131;132
45;Toledo;084;Lillo;3064;1495;1569
45;Toledo;085;Lominchar;1010;530;480
45;Toledo;086;Lucillos;558;268;290
45;Toledo;087;Madridejos;10235;4957;5278
45;Toledo;088;Magán;755;386;369
45;Toledo;089;Malpica de Tajo;1838;930;908
45;Toledo;090;Manzaneque;520;258;262
45;Toledo;091;Maqueda;481;249;232
45;Toledo;092;Marjaliza;373;181;192
45;Toledo;093;Marrupe;153;78;75
45;Toledo;094;Mascaraque;540;255;285
45;Toledo;095;Mata (La);1090;533;557
45;Toledo;096;Mazarambroz;1242;626;616
45;Toledo;097;Mejorada;1227;629;598
45;Toledo;098;Menasalbas;3047;1566;1481
45;Toledo;099;Méntrida;1484;761;723
45;Toledo;100;Mesegar de Tajo;276;139;137
45;Toledo;101;Miguel Esteban;4657;2292;2365
45;Toledo;102;Mocejón;3691;1864;1827
45;Toledo;103;Mohedas de la Jara;843;425;418
45;Toledo;104;Montearagón;512;259;253
45;Toledo;105;Montesclaros;528;251;277
45;Toledo;106;Mora;9406;4571;4835
45;Toledo;107;Nambroca;1712;846;866
45;Toledo;108;Nava de Ricomalillo (La);829;434;395
45;Toledo;109;Navahermosa;3754;1930;1824
45;Toledo;110;Navalcán;2663;1365;1298
45;Toledo;111;Navalmoralejo;145;68;77
45;Toledo;112;Navalmorales (Los);3006;1475;1531
45;Toledo;113;Navalucillos (Los);3329;1692;1637
45;Toledo;114;Navamorcuende;872;461;411
45;Toledo;115;Noblejas;2880;1447;1433
45;Toledo;116;Noez;935;473;462
45;Toledo;117;Nombela;916;474;442
45;Toledo;118;Novés;1434;726;708
45;Toledo;119;Numancia de la Sagra;938;477;461
45;Toledo;120;Nuño Gómez;191;96;95
45;Toledo;121;Ocaña;5444;2699;2745
45;Toledo;122;Olías del Rey;2377;1213;1164
45;Toledo;123;Ontígola;635;317;318
45;Toledo;124;Orgaz;2751;1377;1374
45;Toledo;125;Oropesa;3257;1612;1645
45;Toledo;126;Otero;230;103;127
45;Toledo;127;Palomeque;369;189;180
45;Toledo;128;Pantoja;1957;1008;949
45;Toledo;129;Paredes de Escalona;107;54;53
45;Toledo;130;Parrillas;611;302;309
45;Toledo;131;Pelahustán;499;252;247
45;Toledo;132;Pepino;575;301;274
45;Toledo;133;Polán;2934;1487;1447
45;Toledo;134;Portillo de Toledo;1840;945;895
45;Toledo;135;Puebla de Almoradiel (La);5553;2773;2780
45;Toledo;136;Puebla de Montalbán (La);6466;3238;3228
45;Toledo;137;Pueblanueva (La);2048;1047;1001
45;Toledo;138;Puente del Arzobispo (El);1565;754;811
45;Toledo;139;Puerto de San Vicente;404;201;203
45;Toledo;140;Pulgar;1177;577;600
45;Toledo;141;Quero;1596;784;812
45;Toledo;142;Quintanar de la Orden;8892;4405;4487
45;Toledo;143;Quismondo;1303;646;657
45;Toledo;144;Real de San Vicente (El);988;503;485
45;Toledo;145;Recas;2133;1102;1031
45;Toledo;146;Retamoso;195;106;89
45;Toledo;147;Rielves;445;220;225
45;Toledo;148;Robledo del Mazo;717;372;345
45;Toledo;149;Romeral (El);1145;551;594
45;Toledo;150;San Bartolomé de las Abiertas;573;283;290
45;Toledo;151;San Martín de Montalbán;862;425;437
45;Toledo;152;San Martín de Pusa;831;440;391
45;Toledo;153;San Pablo de los Montes;1962;994;968
45;Toledo;154;San Román de los Montes;410;200;210
45;Toledo;155;Santa Ana de Pusa;455;240;215
45;Toledo;156;Santa Cruz de la Zarza;4262;2141;2121
45;Toledo;157;Santa Cruz del Retamar;1392;703;689
45;Toledo;158;Santa Olalla;2158;1064;1094
45;Toledo;901;Santo Domingo-Caudilla;845;406;439
45;Toledo;159;Sartajada;154;83;71
45;Toledo;160;Segurilla;1050;518;532
45;Toledo;161;Seseña;2638;1355;1283
45;Toledo;162;Sevilleja de la Jara;1395;716;679
45;Toledo;163;Sonseca;8150;4054;4096
45;Toledo;164;Sotillo de las Palomas;208;110;98
45;Toledo;165;Talavera de la Reina;67311;33128;34183
45;Toledo;166;Tembleque;2237;1094;1143
45;Toledo;167;Toboso (El);2370;1160;1210
45;Toledo;168;Toledo;58198;28415;29783
45;Toledo;169;Torralba de Oropesa;333;157;176
45;Toledo;171;Torre de Esteban Hambrán (La);1363;708;655
45;Toledo;170;Torrecilla de la Jara;354;192;162
45;Toledo;172;Torrico;1057;537;520
45;Toledo;173;Torrijos;8829;4368;4461
45;Toledo;174;Totanés;375;192;183
45;Toledo;175;Turleque;1248;618;630
45;Toledo;176;Ugena;365;192;173
45;Toledo;177;Urda;3288;1620;1668
45;Toledo;179;Valdeverdeja;1056;498;558
45;Toledo;180;Valmojado;2202;1123;1079
45;Toledo;181;Velada;2262;1154;1108
45;Toledo;182;Ventas con Peña Aguilera (Las);1462;734;728
45;Toledo;183;Ventas de Retamosa (Las);522;271;251
45;Toledo;184;Ventas de San Julián (Las);248;123;125
45;Toledo;186;Villa de Don Fadrique (La);4312;2091;2221
45;Toledo;185;Villacañas;8497;4237;4260
45;Toledo;187;Villafranca de los Caballeros;5521;2691;2830
45;Toledo;188;Villaluenga de la Sagra;2564;1283;1281
45;Toledo;189;Villamiel de Toledo;258;128;130
45;Toledo;190;Villaminaya;751;370;381
45;Toledo;191;Villamuelas;761;402;359
45;Toledo;192;Villanueva de Alcardete;3355;1679;1676
45;Toledo;193;Villanueva de Bogas;908;464;444
45;Toledo;194;Villarejo de Montalbán;118;53;65
45;Toledo;195;Villarrubia de Santiago;3079;1514;1565
45;Toledo;196;Villaseca de la Sagra;1563;778;785
45;Toledo;197;Villasequilla;2362;1202;1160
45;Toledo;198;Villatobas;2542;1268;1274
45;Toledo;199;Viso de San Juan (El);432;212;220
45;Toledo;200;Yébenes (Los);6422;3256;3166
45;Toledo;201;Yeles;914;469;445
45;Toledo;202;Yepes;4424;2198;2226
45;Toledo;203;Yuncler;1721;879;842
45;Toledo;204;Yunclillos;559;288;271
45;Toledo;205;Yuncos;2576;1310;1266
46;Valencia/València;001;Ademuz;1438;728;710
46;Valencia/València;002;Ador;1162;585;577
46;Valencia/València;004;Agullent;2026;982;1044
46;Valencia/València;042;Aielo de Malferit;3835;1890;1945
46;Valencia/València;043;Aielo de Rugat;204;105;99
46;Valencia/València;005;Alaquàs;24199;11998;12201
46;Valencia/València;006;Albaida;5858;2911;2947
46;Valencia/València;007;Albal;8665;4351;4314
46;Valencia/València;008;Albalat de la Ribera;3637;1781;1856
46;Valencia/València;009;Albalat dels Sorells;3626;1782;1844
46;Valencia/València;010;Albalat dels Tarongers;547;267;280
46;Valencia/València;011;Alberic;8668;4258;4410
46;Valencia/València;012;Alborache;895;451;444
46;Valencia/València;013;Alboraya;11267;5474;5793
46;Valencia/València;014;Albuixech;2931;1456;1475
46;Valencia/València;016;Alcàntera de Xúquer;1499;746;753
46;Valencia/València;015;Alcàsser;7104;3571;3533
46;Valencia/València;018;Alcublas;930;490;440
46;Valencia/València;020;Alcúdia de Crespins (L');4274;2120;2154
46;Valencia/València;019;Alcúdia (L');10135;4975;5160
46;Valencia/València;021;Aldaia;21488;10741;10747
46;Valencia/València;022;Alfafar;20255;10138;10117
46;Valencia/València;024;Alfara de Algimia;558;276;282
46;Valencia/València;025;Alfara del Patriarca;2811;1390;1421
46;Valencia/València;026;Alfarp;1301;628;673
46;Valencia/València;027;Alfarrasí;1258;630;628
46;Valencia/València;023;Alfauir;311;154;157
46;Valencia/València;028;Algar de Palancia;421;197;224
46;Valencia/València;029;Algemesí;25222;12374;12848
46;Valencia/València;030;Algimia de Alfara;918;452;466
46;Valencia/València;031;Alginet;11369;5682;5687
46;Valencia/València;032;Almàssera;5516;2690;2826
46;Valencia/València;033;Almiserà;222;108;114
46;Valencia/València;034;Almoines;1895;944;951
46;Valencia/València;035;Almussafes;5719;2868;2851
46;Valencia/València;036;Alpuente;1295;682;613
46;Valencia/València;037;Alquería de la Condesa/Alqueria de la Comtessa (l');1652;790;862
46;Valencia/València;017;Alzira;40099;19568;20531
46;Valencia/València;038;Andilla;154;82;72
46;Valencia/València;039;Anna;2563;1286;1277
46;Valencia/València;040;Antella;1640;816;824
46;Valencia/València;041;Aras de los Olmos;502;274;228
46;Valencia/València;003;Atzeneta d'Albaida;1253;633;620
46;Valencia/València;044;Ayora;5591;2893;2698
46;Valencia/València;046;Barx;945;470;475
46;Valencia/València;045;Barxeta;1619;807;812
46;Valencia/València;047;Bèlgida;702;331;371
46;Valencia/València;048;Bellreguard;3828;1884;1944
46;Valencia/València;049;Bellús;411;203;208
46;Valencia/València;050;Benagéber;124;63;61
46;Valencia/València;051;Benaguasil;9012;4512;4500
46;Valencia/València;052;Benavites;668;323;345
46;Valencia/València;053;Beneixida;618;298;320
46;Valencia/València;054;Benetússer;13920;6888;7032
46;Valencia/València;055;Beniarjó;1256;599;657
46;Valencia/València;056;Beniatjar;272;136;136
46;Valencia/València;057;Benicolet;496;258;238
46;Valencia/València;060;Benifaió;12171;6015;6156
46;Valencia/València;059;Benifairó de la Valldigna;1643;814;829
46;Valencia/València;058;Benifairó de les Valls;1981;992;989
46;Valencia/València;061;Beniflá;155;71;84
46;Valencia/València;062;Benigánim;5245;2655;2590
46;Valencia/València;063;Benimodo;1732;886;846
46;Valencia/València;064;Benimuslem;571;276;295
46;Valencia/València;065;Beniparrell;1372;676;696
46;Valencia/València;066;Benirredrà;845;398;447
46;Valencia/València;067;Benisanó;1680;850;830
46;Valencia/València;068;Benissoda;294;161;133
46;Valencia/València;069;Benisuera;214;100;114
46;Valencia/València;070;Bétera;8845;4419;4426
46;Valencia/València;071;Bicorp;765;388;377
46;Valencia/València;072;Bocairent;5013;2451;2562
46;Valencia/València;073;Bolbaite;1390;713;677
46;Valencia/València;074;Bonrepòs i Mirambell;2298;1123;1175
46;Valencia/València;075;Bufali;227;121;106
46;Valencia/València;076;Bugarra;915;455;460
46;Valencia/València;077;Buñol;9686;4831;4855
46;Valencia/València;078;Burjassot;35478;17311;18167
46;Valencia/València;079;Calles;471;249;222
46;Valencia/València;080;Camporrobles;1592;786;806
46;Valencia/València;081;Canals;11876;5852;6024
46;Valencia/València;082;Canet d'En Berenguer;1415;692;723
46;Valencia/València;083;Carcaixent;20617;9976;10641
46;Valencia/València;084;Càrcer;2050;995;1055
46;Valencia/València;085;Carlet;13959;6861;7098
46;Valencia/València;086;Carrícola;68;30;38
46;Valencia/València;087;Casas Altas;216;105;111
46;Valencia/València;088;Casas Bajas;431;214;217
46;Valencia/València;089;Casinos;2214;1124;1090
46;Valencia/València;090;Castelló de Rugat;2107;1082;1025
46;Valencia/València;091;Castellonet de la Conquesta;95;51;44
46;Valencia/València;092;Castielfabib;741;389;352
46;Valencia/València;093;Catadau;2183;1106;1077
46;Valencia/València;094;Catarroja;20896;10255;10641
46;Valencia/València;095;Caudete de las Fuentes;1033;522;511
46;Valencia/València;096;Cerdà;247;128;119
46;Valencia/València;107;Chella;2599;1306;1293
46;Valencia/València;106;Chelva;2183;1115;1068
46;Valencia/València;108;Chera;628;320;308
46;Valencia/València;109;Cheste;7015;3529;3486
46;Valencia/València;111;Chiva;7490;3734;3756
46;Valencia/València;112;Chulilla;702;352;350
46;Valencia/València;097;Cofrentes;933;489;444
46;Valencia/València;098;Corbera;3205;1571;1634
46;Valencia/València;099;Cortes de Pallás;925;478;447
46;Valencia/València;100;Cotes;386;184;202
46;Valencia/València;105;Cullera;20161;9934;10227
46;Valencia/València;113;Daimús;1221;606;615
46;Valencia/València;114;Domeño;366;187;179
46;Valencia/València;115;Dos Aguas;502;278;224
46;Valencia/València;116;Eliana (L');6491;3253;3238
46;Valencia/València;117;Emperador;171;79;92
46;Valencia/València;118;Enguera;5088;2517;2571
46;Valencia/València;119;Ènova (L');1216;596;620
46;Valencia/València;120;Estivella;1127;522;605
46;Valencia/València;121;Estubeny;171;78;93
46;Valencia/València;122;Faura;2739;1374;1365
46;Valencia/València;123;Favara;1702;832;870
46;Valencia/València;126;Foios;5382;2602;2780
46;Valencia/València;128;Font de la Figuera (La);2241;1100;1141
46;Valencia/València;127;Font d'En Carròs (La);3313;1645;1668
46;Valencia/València;124;Fontanars dels Alforins;1001;536;465
46;Valencia/València;125;Fortaleny;1044;520;524
46;Valencia/València;129;Fuenterrobles;809;409;400
46;Valencia/València;131;Gandia;51028;24993;26035
46;Valencia/València;130;Gavarda;1274;648;626
46;Valencia/València;132;Genovés;2147;1074;1073
46;Valencia/València;133;Gestalgar;627;312;315
46;Valencia/València;134;Gilet;1095;535;560
46;Valencia/València;135;Godella;8300;4057;4243
46;Valencia/València;136;Godelleta;1916;944;972
46;Valencia/València;137;Granja de la Costera (La);420;204;216
46;Valencia/València;138;Guadasequies;350;176;174
46;Valencia/València;139;Guadassuar;5474;2768;2706
46;Valencia/València;140;Guardamar de la Safor;61;33;28
46;Valencia/València;141;Higueruelas;606;316;290
46;Valencia/València;142;Jalance;1344;684;660
46;Valencia/València;144;Jarafuel;1178;614;564
46;Valencia/València;154;Llanera de Ranes;960;486;474
46;Valencia/València;155;Llaurí;1512;742;770
46;Valencia/València;147;Llíria;13384;6597;6787
46;Valencia/València;153;Llocnou de Sant Jeroni;587;283;304
46;Valencia/València;151;Llocnou d'En Fenollet;648;311;337
46;Valencia/València;156;Llombai;2158;1087;1071
46;Valencia/València;157;Llosa de Ranes (La);3562;1819;1743
46;Valencia/València;150;Llutxent;2409;1233;1176
46;Valencia/València;148;Loriguilla;1166;598;568
46;Valencia/València;149;Losa del Obispo;500;239;261
46;Valencia/València;152;Lugar Nuevo de la Corona;114;60;54
46;Valencia/València;158;Macastre;897;443;454
46;Valencia/València;159;Manises;24871;12247;12624
46;Valencia/València;160;Manuel;2475;1203;1272
46;Valencia/València;161;Marines;1202;605;597
46;Valencia/València;162;Masalavés;1541;771;770
46;Valencia/València;163;Massalfassar;1483;735;748
46;Valencia/València;164;Massamagrell;12055;6022;6033
46;Valencia/València;165;Massanassa;7491;3664;3827
46;Valencia/València;166;Meliana;9087;4508;4579
46;Valencia/València;167;Millares;840;415;425
46;Valencia/València;168;Miramar;926;454;472
46;Valencia/València;169;Mislata;35259;17345;17914
46;Valencia/València;170;Mogente/Moixent;4117;2120;1997
46;Valencia/València;171;Moncada;17733;8787;8946
46;Valencia/València;172;Monserrat;2472;1255;1217
46;Valencia/València;173;Montaverner;1720;884;836
46;Valencia/València;174;Montesa;1241;625;616
46;Valencia/València;175;Montichelvo;673;338;335
46;Valencia/València;176;Montroy;1471;745;726
46;Valencia/València;177;Museros;3976;1971;2005
46;Valencia/València;178;Náquera;1548;776;772
46;Valencia/València;179;Navarrés;2743;1372;1371
46;Valencia/València;180;Novelé/Novetlè;594;290;304
46;Valencia/València;181;Oliva;20178;10026;10152
46;Valencia/València;183;Olleria (L');6832;3445;3387
46;Valencia/València;182;Olocau;575;296;279
46;Valencia/València;184;Ontinyent;28864;14253;14611
46;Valencia/València;185;Otos;547;271;276
46;Valencia/València;186;Paiporta;15051;7453;7598
46;Valencia/València;187;Palma de Gandía;1528;751;777
46;Valencia/València;188;Palmera;489;229;260
46;Valencia/València;189;Palomar (El);488;237;251
46;Valencia/València;190;Paterna;34373;17074;17299
46;Valencia/València;191;Pedralba;2068;1047;1021
46;Valencia/València;192;Petrés;580;276;304
46;Valencia/València;193;Picanya;7346;3679;3667
46;Valencia/València;194;Picassent;14476;7273;7203
46;Valencia/València;195;Piles;1956;932;1024
46;Valencia/València;196;Pinet;273;152;121
46;Valencia/València;199;Pobla de Farnals (La);4111;2023;2088
46;Valencia/València;202;Pobla de Vallbona (La);7550;3906;3644
46;Valencia/València;200;Pobla del Duc (La);2644;1309;1335
46;Valencia/València;203;Pobla Llarga (La);4497;2195;2302
46;Valencia/València;197;Polinyà de Xúquer;3032;1499;1533
46;Valencia/València;198;Potríes;960;474;486
46;Valencia/València;205;Puçol;12116;5993;6123
46;Valencia/València;201;Puebla de San Miguel;45;23;22
46;Valencia/València;204;Puig;5618;2768;2850
46;Valencia/València;101;Quart de les Valls;1131;534;597
46;Valencia/València;102;Quart de Poblet;27367;13568;13799
46;Valencia/València;103;Quartell;1359;679;680
46;Valencia/València;104;Quatretonda;2607;1328;1279
46;Valencia/València;206;Quesa;876;440;436
46;Valencia/València;207;Rafelbuñol/Rafelbunyol;4811;2394;2417
46;Valencia/València;208;Rafelcofer;1453;685;768
46;Valencia/València;209;Rafelguaraf;2397;1190;1207
46;Valencia/València;210;Ráfol de Salem;420;192;228
46;Valencia/València;211;Real de Gandía;1944;886;1058
46;Valencia/València;212;Real de Montroi;1820;939;881
46;Valencia/València;213;Requena;18017;9064;8953
46;Valencia/València;214;Riba-roja de Túria;9338;4614;4724
46;Valencia/València;215;Riola;1741;879;862
46;Valencia/València;216;Rocafort;3260;1615;1645
46;Valencia/València;217;Rotglá y Corberá;1067;533;534
46;Valencia/València;218;Rótova;1403;706;697
46;Valencia/València;219;Rugat;201;103;98
46;Valencia/València;220;Sagunto/Sagunt;55862;27566;28296
46;Valencia/València;221;Salem;490;239;251
46;Valencia/València;222;San Juan de Énova;392;187;205
46;Valencia/València;223;Sedaví;8473;4164;4309
46;Valencia/València;224;Segart;162;75;87
46;Valencia/València;225;Sellent;502;259;243
46;Valencia/València;226;Sempere;48;21;27
46;Valencia/València;227;Senyera;806;391;415
46;Valencia/València;228;Serra;1346;664;682
46;Valencia/València;229;Siete Aguas;1236;580;656
46;Valencia/València;230;Silla;16206;8228;7978
46;Valencia/València;231;Simat de la Valldigna;3249;1642;1607
46;Valencia/València;232;Sinarcas;1378;722;656
46;Valencia/València;233;Sollana;4369;2193;2176
46;Valencia/València;234;Sot de Chera;315;163;152
46;Valencia/València;235;Sueca;24321;11944;12377
46;Valencia/València;236;Sumacàrcer;1432;718;714
46;Valencia/València;237;Tavernes Blanques;7813;3846;3967
46;Valencia/València;238;Tavernes de la Valldigna;16166;8043;8123
46;Valencia/València;239;Teresa de Cofrentes;886;468;418
46;Valencia/València;240;Terrateig;244;123;121
46;Valencia/València;241;Titaguas;644;338;306
46;Valencia/València;242;Torrebaja;459;242;217
46;Valencia/València;243;Torrella;177;87;90
46;Valencia/València;244;Torrent;54544;27149;27395
46;Valencia/València;245;Torres Torres;392;186;206
46;Valencia/València;246;Tous;1246;626;620
46;Valencia/València;247;Tuéjar;1476;773;703
46;Valencia/València;248;Turís;3967;2037;1930
46;Valencia/València;249;Utiel;12084;6106;5978
46;Valencia/València;250;Valencia;729419;347643;381776
46;Valencia/València;251;Vallada;2831;1417;1414
46;Valencia/València;252;Vallanca;300;143;157
46;Valencia/València;253;Vallés;124;69;55
46;Valencia/València;254;Venta del Moro;2003;1011;992
46;Valencia/València;256;Vilamarxant;4824;2451;2373
46;Valencia/València;255;Villalonga;3695;1851;1844
46;Valencia/València;257;Villanueva de Castellón;7055;3427;3628
46;Valencia/València;258;Villar del Arzobispo;3428;1704;1724
46;Valencia/València;259;Villargordo del Cabriel;932;482;450
46;Valencia/València;260;Vinalesa;2342;1105;1237
46;Valencia/València;145;Xàtiva;24095;11686;12409
46;Valencia/València;143;Xeraco;4493;2239;2254
46;Valencia/València;146;Xeresa;2044;1022;1022
46;Valencia/València;110;Xirivella;24476;12167;12309
46;Valencia/València;261;Yátova;2190;1138;1052
46;Valencia/València;262;Yesa (La);339;171;168
46;Valencia/València;263;Zarra;570;289;281
47;Valladolid;001;Adalia;104;56;48
47;Valladolid;002;Aguasal;30;17;13
47;Valladolid;003;Aguilar de Campos;478;244;234
47;Valladolid;004;Alaejos;2018;1031;987
47;Valladolid;005;Alcazarén;798;430;368
47;Valladolid;006;Aldea de San Miguel;263;131;132
47;Valladolid;007;Aldeamayor de San Martín;1059;537;522
47;Valladolid;008;Almenara de Adaja;44;23;21
47;Valladolid;009;Amusquillo;235;128;107
47;Valladolid;010;Arroyo de la Encomienda;1225;617;608
47;Valladolid;011;Ataquines;1039;533;506
47;Valladolid;012;Bahabón;288;145;143
47;Valladolid;013;Barcial de la Loma;198;99;99
47;Valladolid;014;Barruelo del Valle;88;41;47
47;Valladolid;015;Becilla de Valderaduey;541;266;275
47;Valladolid;016;Benafarces;110;52;58
47;Valladolid;017;Bercero;319;161;158
47;Valladolid;018;Berceruelo;38;22;16
47;Valladolid;019;Berrueces;151;83;68
47;Valladolid;020;Bobadilla del Campo;494;257;237
47;Valladolid;021;Bocigas;130;70;60
47;Valladolid;022;Bocos de Duero;96;40;56
47;Valladolid;023;Boecillo;696;346;350
47;Valladolid;024;Bolaños de Campos;477;241;236
47;Valladolid;025;Brahojos de Medina;229;134;95
47;Valladolid;026;Bustillo de Chaves;133;64;69
47;Valladolid;027;Cabezón de Pisuerga;1508;764;744
47;Valladolid;028;Cabezón de Valderaduey;63;30;33
47;Valladolid;029;Cabreros del Monte;156;74;82
47;Valladolid;030;Campaspero;1819;941;878
47;Valladolid;031;Campillo (El);281;159;122
47;Valladolid;032;Camporredondo;260;138;122
47;Valladolid;033;Canalejas de Peñafiel;380;198;182
47;Valladolid;034;Canillas de Esgueva;175;92;83
47;Valladolid;035;Carpio;1353;709;644
47;Valladolid;036;Casasola de Arión;461;236;225
47;Valladolid;037;Castrejón de Trabancos;322;178;144
47;Valladolid;038;Castrillo de Duero;291;152;139
47;Valladolid;039;Castrillo-Tejeriego;355;186;169
47;Valladolid;040;Castrobol;135;55;80
47;Valladolid;041;Castrodeza;298;149;149
47;Valladolid;042;Castromembibre;113;56;57
47;Valladolid;043;Castromonte;565;297;268
47;Valladolid;044;Castronuevo de Esgueva;302;160;142
47;Valladolid;045;Castronuño;1352;686;666
47;Valladolid;046;Castroponce;260;135;125
47;Valladolid;047;Castroverde de Cerrato;366;192;174
47;Valladolid;048;Ceinos de Campos;329;175;154
47;Valladolid;049;Cervillego de la Cruz;216;104;112
47;Valladolid;050;Cigales;1658;800;858
47;Valladolid;051;Ciguñuela;343;174;169
47;Valladolid;052;Cistérniga;1123;566;557
47;Valladolid;053;Cogeces de Íscar;166;86;80
47;Valladolid;054;Cogeces del Monte;1086;573;513
47;Valladolid;055;Corcos;278;147;131
47;Valladolid;056;Corrales de Duero;177;97;80
47;Valladolid;057;Cubillas de Santa Marta;309;152;157
47;Valladolid;058;Cuenca de Campos;362;176;186
47;Valladolid;059;Curiel de Duero;195;108;87
47;Valladolid;060;Encinas de Esgueva;477;242;235
47;Valladolid;061;Esguevillas de Esgueva;502;261;241
47;Valladolid;062;Fombellida;342;183;159
47;Valladolid;063;Fompedraza;159;91;68
47;Valladolid;064;Fontihoyuelo;69;35;34
47;Valladolid;065;Fresno el Viejo;1536;779;757
47;Valladolid;066;Fuensaldaña;633;316;317
47;Valladolid;067;Fuente el Sol;400;209;191
47;Valladolid;068;Fuente-Olmedo;93;45;48
47;Valladolid;069;Gallegos de Hornija;162;79;83
47;Valladolid;070;Gatón de Campos;71;37;34
47;Valladolid;071;Geria;429;235;194
47;Valladolid;073;Herrín de Campos;266;131;135
47;Valladolid;074;Hornillos de Eresma;180;96;84
47;Valladolid;075;Íscar;5753;2891;2862
47;Valladolid;076;Laguna de Duero;8829;4448;4381
47;Valladolid;077;Langayo;563;293;270
47;Valladolid;079;Llano de Olmedo;119;59;60
47;Valladolid;078;Lomoviejo;316;163;153
47;Valladolid;080;Manzanillo;71;37;34
47;Valladolid;081;Marzales;77;39;38
47;Valladolid;082;Matapozuelos;974;504;470
47;Valladolid;083;Matilla de los Caños;101;54;47
47;Valladolid;084;Mayorga;1715;803;912
47;Valladolid;086;Medina de Rioseco;5025;2494;2531
47;Valladolid;085;Medina del Campo;19340;9530;9810
47;Valladolid;087;Megeces;489;251;238
47;Valladolid;088;Melgar de Abajo;284;133;151
47;Valladolid;089;Melgar de Arriba;366;179;187
47;Valladolid;090;Mojados;2010;1018;992
47;Valladolid;091;Monasterio de Vega;148;67;81
47;Valladolid;092;Montealegre de Campos;195;102;93
47;Valladolid;093;Montemayor de Pililla;1195;631;564
47;Valladolid;094;Moral de la Reina;293;153;140
47;Valladolid;095;Moraleja de las Panaderas;29;19;10
47;Valladolid;096;Morales de Campos;235;114;121
47;Valladolid;097;Mota del Marqués;554;270;284
47;Valladolid;098;Mucientes;695;346;349
47;Valladolid;099;Mudarra (La);336;179;157
47;Valladolid;100;Muriel;323;152;171
47;Valladolid;101;Nava del Rey;2467;1197;1270
47;Valladolid;102;Nueva Villa de las Torres;465;244;221
47;Valladolid;103;Olivares de Duero;366;196;170
47;Valladolid;104;Olmedo;3669;1785;1884
47;Valladolid;105;Olmos de Esgueva;207;112;95
47;Valladolid;106;Olmos de Peñafiel;111;60;51
47;Valladolid;109;Palazuelo de Vedija;300;148;152
47;Valladolid;110;Parrilla (La);628;310;318
47;Valladolid;111;Pedraja de Portillo (La);973;475;498
47;Valladolid;112;Pedrajas de San Esteban;3065;1571;1494
47;Valladolid;113;Pedrosa del Rey;330;160;170
47;Valladolid;114;Peñafiel;5272;2674;2598
47;Valladolid;115;Peñaflor de Hornija;555;292;263
47;Valladolid;116;Pesquera de Duero;660;343;317
47;Valladolid;117;Piña de Esgueva;448;240;208
47;Valladolid;118;Piñel de Abajo;329;177;152
47;Valladolid;119;Piñel de Arriba;203;101;102
47;Valladolid;121;Pollos;951;506;445
47;Valladolid;122;Portillo;2590;1326;1264
47;Valladolid;123;Pozal de Gallinas;504;250;254
47;Valladolid;124;Pozaldez;640;309;331
47;Valladolid;125;Pozuelo de la Orden;125;64;61
47;Valladolid;126;Puras;78;40;38
47;Valladolid;127;Quintanilla de Arriba;295;153;142
47;Valladolid;129;Quintanilla de Onésimo;1160;620;540
47;Valladolid;130;Quintanilla de Trigueros;104;55;49
47;Valladolid;128;Quintanilla del Molar;104;50;54
47;Valladolid;131;Rábano;317;169;148
47;Valladolid;132;Ramiro;121;63;58
47;Valladolid;133;Renedo de Esgueva;779;416;363
47;Valladolid;134;Roales de Campos;334;177;157
47;Valladolid;135;Robladillo;113;58;55
47;Valladolid;137;Roturas;41;23;18
47;Valladolid;138;Rubí de Bracamonte;432;225;207
47;Valladolid;139;Rueda;1669;850;819
47;Valladolid;140;Saelices de Mayorga;291;150;141
47;Valladolid;141;Salvador de Zapardiel;259;129;130
47;Valladolid;142;San Cebrián de Mazote;296;160;136
47;Valladolid;143;San Llorente;243;120;123
47;Valladolid;144;San Martín de Valvení;124;67;57
47;Valladolid;145;San Miguel del Arroyo;952;492;460
47;Valladolid;146;San Miguel del Pino;245;129;116
47;Valladolid;147;San Pablo de la Moraleja;225;122;103
47;Valladolid;148;San Pedro de Latarce;772;414;358
47;Valladolid;149;San Pelayo;49;21;28
47;Valladolid;150;San Román de Hornija;618;312;306
47;Valladolid;151;San Salvador;54;29;25
47;Valladolid;156;San Vicente del Palacio;335;173;162
47;Valladolid;152;Santa Eufemia del Arroyo;151;77;74
47;Valladolid;153;Santervás de Campos;228;125;103
47;Valladolid;154;Santibáñez de Valcorba;220;110;110
47;Valladolid;155;Santovenia de Pisuerga;971;496;475
47;Valladolid;157;Sardón de Duero;642;317;325
47;Valladolid;158;Seca (La);1081;568;513
47;Valladolid;159;Serrada;1029;542;487
47;Valladolid;160;Siete Iglesias de Trabancos;745;384;361
47;Valladolid;161;Simancas;1731;886;845
47;Valladolid;162;Tamariz de Campos;105;52;53
47;Valladolid;163;Tiedra;460;225;235
47;Valladolid;164;Tordehumos;628;328;300
47;Valladolid;165;Tordesillas;7236;3657;3579
47;Valladolid;169;Torre de Esgueva;152;79;73
47;Valladolid;170;Torre de Peñafiel;72;38;34
47;Valladolid;166;Torrecilla de la Abadesa;411;220;191
47;Valladolid;167;Torrecilla de la Orden;468;234;234
47;Valladolid;168;Torrecilla de la Torre;51;31;20
47;Valladolid;171;Torrelobatón;699;345;354
47;Valladolid;172;Torrescárcela;219;113;106
47;Valladolid;173;Traspinedo;793;407;386
47;Valladolid;174;Trigueros del Valle;298;150;148
47;Valladolid;175;Tudela de Duero;4692;2367;2325
47;Valladolid;176;Unión de Campos (La);436;208;228
47;Valladolid;177;Urones de Castroponce;240;130;110
47;Valladolid;178;Urueña;259;133;126
47;Valladolid;179;Valbuena de Duero;593;317;276
47;Valladolid;180;Valdearcos de la Vega;170;84;86
47;Valladolid;181;Valdenebro de los Valles;266;143;123
47;Valladolid;182;Valdestillas;1347;689;658
47;Valladolid;183;Valdunquillo;328;161;167
47;Valladolid;186;Valladolid;327452;158906;168546
47;Valladolid;184;Valoria la Buena;681;366;315
47;Valladolid;185;Valverde de Campos;133;73;60
47;Valladolid;187;Vega de Ruiponce;228;111;117
47;Valladolid;188;Vega de Valdetronco;221;119;102
47;Valladolid;189;Velascálvaro;220;115;105
47;Valladolid;190;Velilla;165;88;77
47;Valladolid;191;Velliza;211;111;100
47;Valladolid;192;Ventosa de la Cuesta;196;105;91
47;Valladolid;193;Viana de Cega;926;469;457
47;Valladolid;195;Villabáñez;443;223;220
47;Valladolid;196;Villabaruz de Campos;65;30;35
47;Valladolid;197;Villabrágima;1348;692;656
47;Valladolid;198;Villacarralón;173;89;84
47;Valladolid;199;Villacid de Campos;147;83;64
47;Valladolid;200;Villaco;179;103;76
47;Valladolid;203;Villafrades de Campos;179;81;98
47;Valladolid;204;Villafranca de Duero;497;257;240
47;Valladolid;205;Villafrechós;613;312;301
47;Valladolid;206;Villafuerte;192;92;100
47;Valladolid;207;Villagarcía de Campos;501;267;234
47;Valladolid;208;Villagómez la Nueva;122;57;65
47;Valladolid;209;Villalán de Campos;68;36;32
47;Valladolid;210;Villalar de los Comuneros;522;263;259
47;Valladolid;211;Villalba de la Loma;58;31;27
47;Valladolid;212;Villalba de los Alcores;699;368;331
47;Valladolid;213;Villalbarba;196;96;100
47;Valladolid;214;Villalón de Campos;2238;1104;1134
47;Valladolid;215;Villamuriel de Campos;116;56;60
47;Valladolid;216;Villán de Tordesillas;180;91;89
47;Valladolid;217;Villanubla;983;508;475
47;Valladolid;218;Villanueva de Duero;834;436;398
47;Valladolid;219;Villanueva de la Condesa;58;32;26
47;Valladolid;220;Villanueva de los Caballeros;348;175;173
47;Valladolid;221;Villanueva de los Infantes;160;78;82
47;Valladolid;222;Villanueva de San Mancio;112;53;59
47;Valladolid;223;Villardefrades;334;171;163
47;Valladolid;224;Villarmentero de Esgueva;134;62;72
47;Valladolid;225;Villasexmir;150;80;70
47;Valladolid;226;Villavaquerín;259;141;118
47;Valladolid;227;Villavellid;113;53;60
47;Valladolid;228;Villaverde de Medina;698;368;330
47;Valladolid;229;Villavicencio de los Caballeros;441;207;234
47;Valladolid;194;Viloria;437;238;199
47;Valladolid;230;Wamba;433;224;209
47;Valladolid;231;Zaratán;1151;589;562
47;Valladolid;232;Zarza (La);198;103;95
48;Vizcaya;001;Abadiño;7136;3629;3507
48;Vizcaya;002;Abanto y Ciérvana-Abanto Zierbena;9346;4679;4667
48;Vizcaya;911;Ajangiz;"";"";""
48;Vizcaya;912;Alonsotegi;"";"";""
48;Vizcaya;003;Amorebieta-Etxano;15809;8013;7796
48;Vizcaya;004;Amoroto;410;219;191
48;Vizcaya;005;Arakaldo;91;55;36
48;Vizcaya;006;Arantzazu;322;163;159
48;Vizcaya;093;Areatza;1190;562;628
48;Vizcaya;009;Arrankudiaga;759;385;374
48;Vizcaya;914;Arratzu;"";"";""
48;Vizcaya;010;Arrieta;431;228;203
48;Vizcaya;011;Arrigorriaga;9469;4641;4828
48;Vizcaya;023;Artea;631;305;326
48;Vizcaya;008;Artzentales;669;373;296
48;Vizcaya;091;Atxondo;1504;776;728
48;Vizcaya;070;Aulesti;703;395;308
48;Vizcaya;012;Bakio;1224;620;604
48;Vizcaya;090;Balmaseda;7673;3771;3902
48;Vizcaya;013;Barakaldo;114094;56620;57474
48;Vizcaya;014;Barrika;767;366;401
48;Vizcaya;015;Basauri;51931;25965;25966
48;Vizcaya;092;Bedia;1153;565;588
48;Vizcaya;016;Berango;3931;1945;1986
48;Vizcaya;017;Bermeo;18333;9141;9192
48;Vizcaya;018;Berriatua;1068;562;506
48;Vizcaya;019;Berriz;4197;2104;2093
48;Vizcaya;020;Bilbao;381506;183353;198153
48;Vizcaya;021;Busturia;1829;918;911
48;Vizcaya;901;Derio;5062;2552;2510
48;Vizcaya;026;Dima;1040;545;495
48;Vizcaya;027;Durango;27152;13502;13650
48;Vizcaya;028;Ea;827;404;423
48;Vizcaya;031;Elantxobe;574;263;311
48;Vizcaya;032;Elorrio;7768;3923;3845
48;Vizcaya;902;Erandio;25134;12451;12683
48;Vizcaya;033;Ereño;296;155;141
48;Vizcaya;034;Ermua;18604;9570;9034
48;Vizcaya;079;Errigoiti;483;261;222
48;Vizcaya;029;Etxebarri, Anteiglesia de San Esteban-Etxebarri Doneztebeko Elizatea;6431;3260;3171
48;Vizcaya;030;Etxebarria;792;419;373
48;Vizcaya;906;Forua;"";"";""
48;Vizcaya;035;Fruiz;296;152;144
48;Vizcaya;036;Galdakao;27232;13644;13588
48;Vizcaya;037;Galdames;824;428;396
48;Vizcaya;038;Gamiz-Fika;867;460;407
48;Vizcaya;039;Garay;245;126;119
48;Vizcaya;040;Gatika;859;433;426
48;Vizcaya;041;Gautegiz Arteaga;802;387;415
48;Vizcaya;046;Gernika-Lumo;18150;8985;9165
48;Vizcaya;044;Getxo;77856;37731;40125
48;Vizcaya;047;Gizaburuaga;136;68;68
48;Vizcaya;042;Gordexola;1594;803;791
48;Vizcaya;043;Gorliz;2665;1274;1391
48;Vizcaya;045;Güeñes;6181;3056;3125
48;Vizcaya;048;Ibarrangelu;551;245;306
48;Vizcaya;094;Igorre;3842;1939;1903
48;Vizcaya;049;Ispaster;635;337;298
48;Vizcaya;910;Iurreta;"";"";""
48;Vizcaya;050;Izurtza;276;134;142
48;Vizcaya;022;Karrantza Harana/Valle de Carranza;3473;1828;1645
48;Vizcaya;907;Kortezubi;"";"";""
48;Vizcaya;051;Lanestosa;314;158;156
48;Vizcaya;052;Larrabetzu;1547;765;782
48;Vizcaya;053;Laukiz;1059;539;520
48;Vizcaya;054;Leioa;24107;11908;12199
48;Vizcaya;057;Lekeitio;7579;3719;3860
48;Vizcaya;055;Lemoa;3010;1533;1477
48;Vizcaya;056;Lemoiz;793;399;394
48;Vizcaya;081;Lezama;1901;960;941
48;Vizcaya;903;Loiu;1685;869;816
48;Vizcaya;058;Mallabia;1125;584;541
48;Vizcaya;059;Mañaria;525;278;247
48;Vizcaya;060;Markina-Xemein;5056;2572;2484
48;Vizcaya;061;Maruri-Jatabe;505;251;254
48;Vizcaya;062;Mendata;378;211;167
48;Vizcaya;063;Mendexa;342;176;166
48;Vizcaya;064;Meñaka;371;195;176
48;Vizcaya;066;Morga;356;191;165
48;Vizcaya;068;Mundaka;1657;772;885
48;Vizcaya;069;Mungia;11206;5541;5665
48;Vizcaya;007;Munitibar-Arbatzegi Gerrikaitz;498;263;235
48;Vizcaya;908;Murueta;"";"";""
48;Vizcaya;071;Muskiz;6224;3122;3102
48;Vizcaya;067;Muxika;1555;815;740
48;Vizcaya;909;Nabarniz;"";"";""
48;Vizcaya;073;Ondarroa;11177;5625;5552
48;Vizcaya;075;Orozko;2003;986;1017
48;Vizcaya;083;Ortuella;9200;4567;4633
48;Vizcaya;072;Otxandio;1200;632;568
48;Vizcaya;077;Plentzia;2770;1334;1436
48;Vizcaya;078;Portugalete;57794;28659;29135
48;Vizcaya;082;Santurtzi;52502;26016;26486
48;Vizcaya;084;Sestao;38148;18775;19373
48;Vizcaya;904;Sondika;3606;1771;1835
48;Vizcaya;085;Sopelana;7051;3568;3483
48;Vizcaya;086;Sopuerta;2192;1137;1055
48;Vizcaya;076;Sukarrieta;286;139;147
48;Vizcaya;087;Trucios-Turtzioz;529;254;275
48;Vizcaya;088;Ubide;157;76;81
48;Vizcaya;065;Ugao-Miraballes;4161;2120;2041
48;Vizcaya;089;Urduliz;2507;1274;1233
48;Vizcaya;074;Urduña-Orduña;4221;2132;2089
48;Vizcaya;080;Valle de Trápaga-Trapagaran;13406;6632;6774
48;Vizcaya;095;Zaldibar;3308;1556;1752
48;Vizcaya;096;Zalla;7253;3641;3612
48;Vizcaya;905;Zamudio;3228;1641;1587
48;Vizcaya;097;Zaratamo;1609;813;796
48;Vizcaya;024;Zeanuri;1244;647;597
48;Vizcaya;025;Zeberio;982;509;473
48;Vizcaya;913;Zierbena;"";"";""
49;Zamora;002;Abezames;150;73;77
49;Zamora;003;Alcañices;1276;657;619
49;Zamora;004;Alcubilla de Nogales;284;131;153
49;Zamora;005;Alfaraz de Sayago;310;157;153
49;Zamora;006;Algodre;284;148;136
49;Zamora;007;Almaraz de Duero;546;276;270
49;Zamora;008;Almeida de Sayago;851;433;418
49;Zamora;009;Andavías;581;281;300
49;Zamora;010;Arcenillas;264;134;130
49;Zamora;011;Arcos de la Polvorosa;342;182;160
49;Zamora;012;Argañín;147;68;79
49;Zamora;013;Argujillo;479;248;231
49;Zamora;014;Arquillinos;230;118;112
49;Zamora;015;Arrabalde;522;256;266
49;Zamora;016;Aspariegos;499;241;258
49;Zamora;017;Asturianos;472;230;242
49;Zamora;018;Ayoó de Vidriales;672;333;339
49;Zamora;019;Barcial del Barco;376;204;172
49;Zamora;020;Belver de los Montes;611;320;291
49;Zamora;021;Benavente;13663;6588;7075
49;Zamora;022;Benegiles;517;271;246
49;Zamora;023;Bermillo de Sayago;1870;947;923
49;Zamora;024;Bóveda de Toro (La);1179;598;581
49;Zamora;025;Bretó;324;156;168
49;Zamora;026;Bretocino;369;197;172
49;Zamora;027;Brime de Sog;336;146;190
49;Zamora;028;Brime de Urz;203;101;102
49;Zamora;029;Burganes de Valverde;972;504;468
49;Zamora;030;Bustillo del Oro;235;109;126
49;Zamora;031;Cabañas de Sayago;267;141;126
49;Zamora;032;Calzadilla de Tera;667;323;344
49;Zamora;033;Camarzana de Tera;1337;677;660
49;Zamora;034;Cañizal;752;384;368
49;Zamora;035;Cañizo;432;210;222
49;Zamora;036;Carbajales de Alba;787;384;403
49;Zamora;037;Carbellino;306;162;144
49;Zamora;038;Casaseca de Campeán;241;123;118
49;Zamora;039;Casaseca de las Chanas;443;222;221
49;Zamora;040;Castrillo de la Guareña;218;112;106
49;Zamora;041;Castrogonzalo;639;316;323
49;Zamora;042;Castronuevo;477;249;228
49;Zamora;043;Castroverde de Campos;572;280;292
49;Zamora;044;Cazurra;128;69;59
49;Zamora;046;Cerecinos de Campos;574;296;278
49;Zamora;047;Cerecinos del Carrizal;238;126;112
49;Zamora;048;Cernadilla;241;111;130
49;Zamora;050;Cobreros;1023;494;529
49;Zamora;052;Coomonte;409;201;208
49;Zamora;053;Coreses;1373;718;655
49;Zamora;054;Corrales;1565;774;791
49;Zamora;055;Cotanes del Monte;232;119;113
49;Zamora;056;Cubillos;496;265;231
49;Zamora;057;Cubo de Benavente;281;147;134
49;Zamora;058;Cubo de Tierra del Vino (El);503;271;232
49;Zamora;059;Cuelgamures;175;100;75
49;Zamora;061;Entrala;174;87;87
49;Zamora;062;Espadañedo;260;125;135
49;Zamora;063;Faramontanos de Tábara;642;322;320
49;Zamora;064;Fariza;892;439;453
49;Zamora;065;Fermoselle;2225;1107;1118
49;Zamora;066;Ferreras de Abajo;750;393;357
49;Zamora;067;Ferreras de Arriba;741;373;368
49;Zamora;068;Ferreruela;851;452;399
49;Zamora;069;Figueruela de Arriba;759;372;387
49;Zamora;071;Fonfría;1504;755;749
49;Zamora;075;Fresno de la Polvorosa;292;144;148
49;Zamora;076;Fresno de la Ribera;495;276;219
49;Zamora;077;Fresno de Sayago;410;205;205
49;Zamora;078;Friera de Valverde;374;187;187
49;Zamora;079;Fuente Encalada;228;118;110
49;Zamora;080;Fuentelapeña;1171;574;597
49;Zamora;082;Fuentes de Ropel;795;409;386
49;Zamora;081;Fuentesaúco;2077;1022;1055
49;Zamora;083;Fuentesecas;136;65;71
49;Zamora;084;Fuentespreadas;502;272;230
49;Zamora;085;Galende;1604;786;818
49;Zamora;086;Gallegos del Pan;236;117;119
49;Zamora;087;Gallegos del Río;1154;592;562
49;Zamora;088;Gamones;147;79;68
49;Zamora;090;Gema;382;187;195
49;Zamora;091;Granja de Moreruela;477;226;251
49;Zamora;092;Granucillo;377;192;185
49;Zamora;093;Guarrate;479;261;218
49;Zamora;094;Hermisende;626;303;323
49;Zamora;095;Hiniesta (La);432;219;213
49;Zamora;096;Jambrina;325;165;160
49;Zamora;097;Justel;277;145;132
49;Zamora;098;Losacino;457;236;221
49;Zamora;099;Losacio;202;104;98
49;Zamora;100;Lubián;553;268;285
49;Zamora;101;Luelmo;344;175;169
49;Zamora;102;Maderal (El);355;182;173
49;Zamora;103;Madridanos;658;355;303
49;Zamora;104;Mahide;726;362;364
49;Zamora;105;Maire de Castroponce;336;173;163
49;Zamora;107;Malva;336;161;175
49;Zamora;108;Manganeses de la Lampreana;1136;564;572
49;Zamora;109;Manganeses de la Polvorosa;1023;501;522
49;Zamora;110;Manzanal de Arriba;690;333;357
49;Zamora;112;Manzanal de los Infantes;253;123;130
49;Zamora;111;Manzanal del Barco;275;143;132
49;Zamora;113;Matilla de Arzón;398;208;190
49;Zamora;114;Matilla la Seca;108;55;53
49;Zamora;115;Mayalde;336;176;160
49;Zamora;116;Melgar de Tera;710;352;358
49;Zamora;117;Micereces de Tera;788;397;391
49;Zamora;118;Milles de la Polvorosa;335;168;167
49;Zamora;119;Molacillos;387;200;187
49;Zamora;120;Molezuelas de la Carballeda;205;103;102
49;Zamora;121;Mombuey;531;268;263
49;Zamora;122;Monfarracinos;597;312;285
49;Zamora;123;Montamarta;857;400;457
49;Zamora;124;Moral de Sayago;454;239;215
49;Zamora;126;Moraleja de Sayago;345;187;158
49;Zamora;125;Moraleja del Vino;1228;655;573
49;Zamora;128;Morales de Rey;866;434;432
49;Zamora;129;Morales de Toro;1230;603;627
49;Zamora;130;Morales de Valverde;429;209;220
49;Zamora;127;Morales del Vino;1075;564;511
49;Zamora;131;Moralina;420;212;208
49;Zamora;132;Moreruela de los Infanzones;548;292;256
49;Zamora;133;Moreruela de Tábara;670;339;331
49;Zamora;134;Muelas de los Caballeros;312;162;150
49;Zamora;135;Muelas del Pan;1026;516;510
49;Zamora;136;Muga de Sayago;554;266;288
49;Zamora;137;Navianos de Valverde;332;179;153
49;Zamora;138;Olmillos de Castro;667;346;321
49;Zamora;139;Otero de Bodas;363;185;178
49;Zamora;141;Pajares de la Lampreana;629;314;315
49;Zamora;143;Palacios de Sanabria;463;215;248
49;Zamora;142;Palacios del Pan;311;148;163
49;Zamora;145;Pedralba de la Pradería;555;281;274
49;Zamora;146;Pego (El);582;302;280
49;Zamora;147;Peleagonzalo;588;299;289
49;Zamora;148;Peleas de Abajo;224;115;109
49;Zamora;149;Peñausende;667;343;324
49;Zamora;150;Peque;300;139;161
49;Zamora;151;Perdigón (El);934;476;458
49;Zamora;152;Pereruela;975;486;489
49;Zamora;153;Perilla de Castro;416;210;206
49;Zamora;154;Pías;365;188;177
49;Zamora;155;Piedrahita de Castro;196;101;95
49;Zamora;156;Pinilla de Toro;510;236;274
49;Zamora;157;Pino del Oro;302;161;141
49;Zamora;158;Piñero (El);355;176;179
49;Zamora;160;Pobladura de Valderaduey;106;47;59
49;Zamora;159;Pobladura del Valle;437;209;228
49;Zamora;162;Porto;474;239;235
49;Zamora;163;Pozoantiguo;471;243;228
49;Zamora;164;Pozuelo de Tábara;330;165;165
49;Zamora;165;Prado;132;61;71
49;Zamora;166;Puebla de Sanabria;1819;874;945
49;Zamora;167;Pueblica de Valverde;442;224;218
49;Zamora;170;Quintanilla de Urz;178;97;81
49;Zamora;168;Quintanilla del Monte;195;100;95
49;Zamora;169;Quintanilla del Olmo;75;36;39
49;Zamora;171;Quiruelas de Vidriales;1165;581;584
49;Zamora;172;Rabanales;1138;583;555
49;Zamora;173;Rábano de Aliste;696;345;351
49;Zamora;174;Requejo;316;166;150
49;Zamora;175;Revellinos;424;218;206
49;Zamora;176;Riofrío de Aliste;1363;706;657
49;Zamora;177;Rionegro del Puente;518;243;275
49;Zamora;178;Roales;332;163;169
49;Zamora;179;Robleda-Cervantes;524;258;266
49;Zamora;180;Roelos de Sayago;224;110;114
49;Zamora;181;Rosinos de la Requejada;712;352;360
49;Zamora;183;Salce;191;96;95
49;Zamora;184;Samir de los Caños;302;154;148
49;Zamora;185;San Agustín del Pozo;247;134;113
49;Zamora;186;San Cebrián de Castro;501;248;253
49;Zamora;187;San Cristóbal de Entreviñas;1744;902;842
49;Zamora;188;San Esteban del Molar;276;140;136
49;Zamora;189;San Justo;490;236;254
49;Zamora;190;San Martín de Valderaduey;139;69;70
49;Zamora;191;San Miguel de la Ribera;517;264;253
49;Zamora;192;San Miguel del Valle;344;160;184
49;Zamora;193;San Pedro de Ceque;766;384;382
49;Zamora;194;San Pedro de la Nave-Almendra;605;306;299
49;Zamora;208;San Vicente de la Cabeza;859;439;420
49;Zamora;209;San Vitero;878;448;430
49;Zamora;197;Santa Clara de Avedillo;362;176;186
49;Zamora;199;Santa Colomba de las Monjas;388;197;191
49;Zamora;200;Santa Cristina de la Polvorosa;1366;691;675
49;Zamora;201;Santa Croya de Tera;615;306;309
49;Zamora;202;Santa Eufemia del Barco;415;219;196
49;Zamora;203;Santa María de la Vega;612;315;297
49;Zamora;204;Santa María de Valverde;150;84;66
49;Zamora;205;Santibáñez de Tera;759;390;369
49;Zamora;206;Santibáñez de Vidriales;1792;865;927
49;Zamora;207;Santovenia;606;308;298
49;Zamora;210;Sanzoles;849;424;425
49;Zamora;214;Tábara;1078;558;520
49;Zamora;216;Tapioles;288;156;132
49;Zamora;219;Toro;9666;4707;4959
49;Zamora;220;Torre del Valle (La);260;135;125
49;Zamora;221;Torregamones;437;217;220
49;Zamora;222;Torres del Carrizal;595;301;294
49;Zamora;223;Trabazos;1193;609;584
49;Zamora;224;Trefacio;278;131;147
49;Zamora;225;Uña de Quintana;338;171;167
49;Zamora;226;Vadillo de la Guareña;403;199;204
49;Zamora;227;Valcabado;319;163;156
49;Zamora;228;Valdefinjas;129;68;61
49;Zamora;229;Valdescorriel;234;112;122
49;Zamora;230;Vallesa de la Guareña;270;145;125
49;Zamora;231;Vega de Tera;711;339;372
49;Zamora;232;Vega de Villalobos;235;119;116
49;Zamora;233;Vegalatrave;208;110;98
49;Zamora;234;Venialbo;637;334;303
49;Zamora;235;Vezdemarbán;929;445;484
49;Zamora;236;Vidayanes;160;76;84
49;Zamora;237;Videmala;330;161;169
49;Zamora;238;Villabrázaro;539;275;264
49;Zamora;239;Villabuena del Puente;1208;618;590
49;Zamora;240;Villadepera;317;153;164
49;Zamora;241;Villaescusa;491;255;236
49;Zamora;242;Villafáfila;767;388;379
49;Zamora;243;Villaferrueña;230;114;116
49;Zamora;244;Villageriz;89;45;44
49;Zamora;245;Villalazán;434;224;210
49;Zamora;246;Villalba de la Lampreana;391;205;186
49;Zamora;247;Villalcampo;884;436;448
49;Zamora;248;Villalobos;418;194;224
49;Zamora;249;Villalonso;183;83;100
49;Zamora;250;Villalpando;1933;948;985
49;Zamora;251;Villalube;422;216;206
49;Zamora;252;Villamayor de Campos;821;398;423
49;Zamora;255;Villamor de los Escuderos;669;335;334
49;Zamora;256;Villanázar;467;224;243
49;Zamora;257;Villanueva de Azoague;466;234;232
49;Zamora;258;Villanueva de Campeán;219;107;112
49;Zamora;259;Villanueva de las Peras;277;135;142
49;Zamora;260;Villanueva del Campo;1344;654;690
49;Zamora;263;Villar de Fallaves;153;78;75
49;Zamora;264;Villar del Buey;1083;573;510
49;Zamora;261;Villaralbo;1477;746;731
49;Zamora;262;Villardeciervos;652;305;347
49;Zamora;265;Villardiegua de la Ribera;222;107;115
49;Zamora;266;Villárdiga;159;82;77
49;Zamora;267;Villardondiego;184;96;88
49;Zamora;268;Villarrín de Campos;769;369;400
49;Zamora;269;Villaseco del Pan;437;209;228
49;Zamora;270;Villavendimio;290;152;138
49;Zamora;272;Villaveza de Valverde;197;97;100
49;Zamora;271;Villaveza del Agua;330;177;153
49;Zamora;273;Viñas;357;180;177
49;Zamora;275;Zamora;60364;28866;31498
50;Zaragoza;001;Abanto;273;142;131
50;Zaragoza;002;Acered;382;197;185
50;Zaragoza;003;Agón;247;130;117
50;Zaragoza;004;Aguarón;792;394;398
50;Zaragoza;005;Aguilón;314;156;158
50;Zaragoza;006;Ainzón;1304;650;654
50;Zaragoza;007;Aladrén;53;23;30
50;Zaragoza;008;Alagón;5443;2707;2736
50;Zaragoza;009;Alarba;173;100;73
50;Zaragoza;010;Alberite de San Juan;117;61;56
50;Zaragoza;011;Albeta;148;72;76
50;Zaragoza;012;Alborge;131;58;73
50;Zaragoza;013;Alcalá de Ebro;370;184;186
50;Zaragoza;014;Alcalá de Moncayo;183;102;81
50;Zaragoza;015;Alconchel de Ariza;266;135;131
50;Zaragoza;016;Aldehuela de Liestos;86;46;40
50;Zaragoza;017;Alfajarín;1374;715;659
50;Zaragoza;018;Alfamén;1337;697;640
50;Zaragoza;019;Alforque;99;49;50
50;Zaragoza;020;Alhama de Aragón;1354;664;690
50;Zaragoza;021;Almochuel;68;36;32
50;Zaragoza;022;Almolda (La);782;384;398
50;Zaragoza;023;Almonacid de la Cuba;400;206;194
50;Zaragoza;024;Almonacid de la Sierra;911;469;442
50;Zaragoza;025;Almunia de Doña Godina (La);5030;2562;2468
50;Zaragoza;026;Alpartir;641;347;294
50;Zaragoza;027;Ambel;447;213;234
50;Zaragoza;028;Anento;29;19;10
50;Zaragoza;029;Aniñón;1028;546;482
50;Zaragoza;030;Añón de Moncayo;363;209;154
50;Zaragoza;031;Aranda de Moncayo;285;155;130
50;Zaragoza;032;Arándiga;632;314;318
50;Zaragoza;033;Ardisa;92;44;48
50;Zaragoza;034;Ariza;1574;754;820
50;Zaragoza;035;Artieda;111;59;52
50;Zaragoza;036;Asín;116;59;57
50;Zaragoza;037;Atea;315;175;140
50;Zaragoza;038;Ateca;2202;1072;1130
50;Zaragoza;039;Azuara;887;465;422
50;Zaragoza;040;Badules;132;71;61
50;Zaragoza;041;Bagüés;13;5;8
50;Zaragoza;042;Balconchán;38;21;17
50;Zaragoza;043;Bárboles;406;218;188
50;Zaragoza;044;Bardallur;372;185;187
50;Zaragoza;045;Belchite;1685;844;841
50;Zaragoza;046;Belmonte de Gracián;389;214;175
50;Zaragoza;047;Berdejo;37;18;19
50;Zaragoza;048;Berrueco;39;23;16
50;Zaragoza;901;Biel;250;132;118
50;Zaragoza;050;Bijuesca;138;72;66
50;Zaragoza;051;Biota;1456;752;704
50;Zaragoza;052;Bisimbre;166;79;87
50;Zaragoza;053;Boquiñeni;1135;588;547
50;Zaragoza;054;Bordalba;129;71;58
50;Zaragoza;055;Borja;4186;2068;2118
50;Zaragoza;056;Botorrita;402;220;182
50;Zaragoza;057;Brea de Aragón;2105;1033;1072
50;Zaragoza;058;Bubierca;144;68;76
50;Zaragoza;059;Bujaraloz;1147;598;549
50;Zaragoza;060;Bulbuente;308;157;151
50;Zaragoza;061;Bureta;375;193;182
50;Zaragoza;062;Burgo de Ebro (El);1117;550;567
50;Zaragoza;063;Buste (El);157;80;77
50;Zaragoza;064;Cabañas de Ebro;588;295;293
50;Zaragoza;065;Cabolafuente;131;73;58
50;Zaragoza;066;Cadrete;818;413;405
50;Zaragoza;067;Calatayud;17824;8517;9307
50;Zaragoza;068;Calatorao;2861;1454;1407
50;Zaragoza;069;Calcena;110;58;52
50;Zaragoza;070;Calmarza;152;76;76
50;Zaragoza;071;Campillo de Aragón;246;133;113
50;Zaragoza;072;Carenas;289;145;144
50;Zaragoza;073;Cariñena;3015;1519;1496
50;Zaragoza;074;Caspe;8328;4128;4200
50;Zaragoza;075;Castejón de Alarba;161;93;68
50;Zaragoza;076;Castejón de las Armas;179;91;88
50;Zaragoza;077;Castejón de Valdejasa;433;232;201
50;Zaragoza;078;Castiliscar;489;249;240
50;Zaragoza;079;Cervera de la Cañada;402;200;202
50;Zaragoza;080;Cerveruela;4;2;2
50;Zaragoza;081;Cetina;883;451;432
50;Zaragoza;092;Chiprana;474;239;235
50;Zaragoza;093;Chodes;186;88;98
50;Zaragoza;082;Cimballa;155;78;77
50;Zaragoza;083;Cinco Olivas;159;80;79
50;Zaragoza;084;Clarés de Ribota;136;69;67
50;Zaragoza;085;Codo;388;195;193
50;Zaragoza;086;Codos;361;208;153
50;Zaragoza;087;Contamina;84;39;45
50;Zaragoza;088;Cosuenda;487;241;246
50;Zaragoza;089;Cuarte de Huerva;1229;644;585
50;Zaragoza;090;Cubel;304;156;148
50;Zaragoza;091;Cuerlas (Las);93;51;42
50;Zaragoza;094;Daroca;2551;1271;1280
50;Zaragoza;095;Ejea de los Caballeros;15055;7661;7394
50;Zaragoza;096;Embid de Ariza;115;64;51
50;Zaragoza;098;Encinacorba;357;191;166
50;Zaragoza;099;Épila;3789;1902;1887
50;Zaragoza;100;Erla;602;290;312
50;Zaragoza;101;Escatrón;1430;716;714
50;Zaragoza;102;Fabara;1455;767;688
50;Zaragoza;104;Farlete;494;244;250
50;Zaragoza;105;Fayón;465;233;232
50;Zaragoza;106;Fayos (Los);212;111;101
50;Zaragoza;107;Figueruelas;774;390;384
50;Zaragoza;108;Fombuena;11;8;3
50;Zaragoza;109;Frago (El);122;70;52
50;Zaragoza;110;Frasno (El);719;378;341
50;Zaragoza;111;Fréscano;313;152;161
50;Zaragoza;113;Fuendejalón;1013;510;503
50;Zaragoza;114;Fuendetodos;172;94;78
50;Zaragoza;115;Fuentes de Ebro;3773;1959;1814
50;Zaragoza;116;Fuentes de Jiloca;459;239;220
50;Zaragoza;117;Gallocanta;200;103;97
50;Zaragoza;118;Gallur;3305;1655;1650
50;Zaragoza;119;Gelsa;1433;718;715
50;Zaragoza;120;Godojos;98;51;47
50;Zaragoza;121;Gotor;409;214;195
50;Zaragoza;122;Grisel;55;27;28
50;Zaragoza;123;Grisén;492;243;249
50;Zaragoza;124;Herrera de los Navarros;810;417;393
50;Zaragoza;125;Ibdes;683;356;327
50;Zaragoza;126;Illueca;3154;1558;1596
50;Zaragoza;128;Isuerre;67;36;31
50;Zaragoza;129;Jaraba;331;158;173
50;Zaragoza;130;Jarque;653;346;307
50;Zaragoza;131;Jaulín;307;153;154
50;Zaragoza;132;Joyosa (La);340;176;164
50;Zaragoza;133;Lagata;171;88;83
50;Zaragoza;134;Langa del Castillo;241;109;132
50;Zaragoza;135;Layana;211;108;103
50;Zaragoza;136;Lécera;1071;524;547
50;Zaragoza;138;Lechón;71;40;31
50;Zaragoza;137;Leciñena;1534;768;766
50;Zaragoza;139;Letux;530;273;257
50;Zaragoza;140;Litago;218;126;92
50;Zaragoza;141;Lituénigo;141;73;68
50;Zaragoza;142;Lobera de Onsella;83;51;32
50;Zaragoza;143;Longares;939;459;480
50;Zaragoza;144;Longás;22;16;6
50;Zaragoza;146;Lucena de Jalón;313;156;157
50;Zaragoza;147;Luceni;1182;588;594
50;Zaragoza;148;Luesia;544;295;249
50;Zaragoza;149;Luesma;28;13;15
50;Zaragoza;150;Lumpiaque;1105;564;541
50;Zaragoza;151;Luna;1073;552;521
50;Zaragoza;152;Maella;2272;1144;1128
50;Zaragoza;153;Magallón;1394;712;682
50;Zaragoza;154;Mainar;199;103;96
50;Zaragoza;155;Malanquilla;133;68;65
50;Zaragoza;156;Maleján;331;169;162
50;Zaragoza;160;Mallén;3010;1530;1480
50;Zaragoza;157;Malón;555;280;275
50;Zaragoza;159;Maluenda;1175;589;586
50;Zaragoza;161;Manchones;177;88;89
50;Zaragoza;162;Mara;283;144;139
50;Zaragoza;163;María de Huerva;716;361;355
50;Zaragoza;902;Marracos;"";"";""
50;Zaragoza;164;Mediana de Aragón;563;278;285
50;Zaragoza;165;Mequinenza;2796;1412;1384
50;Zaragoza;166;Mesones de Isuela;480;244;236
50;Zaragoza;167;Mezalocha;339;181;158
50;Zaragoza;168;Mianos;55;28;27
50;Zaragoza;169;Miedes de Aragón;640;323;317
50;Zaragoza;170;Monegrillo;594;330;264
50;Zaragoza;171;Moneva;91;42;49
50;Zaragoza;172;Monreal de Ariza;398;209;189
50;Zaragoza;173;Monterde;243;122;121
50;Zaragoza;174;Montón;183;91;92
50;Zaragoza;175;Morata de Jalón;1865;924;941
50;Zaragoza;176;Morata de Jiloca;442;228;214
50;Zaragoza;177;Morés;611;310;301
50;Zaragoza;178;Moros;696;362;334
50;Zaragoza;179;Moyuela;480;246;234
50;Zaragoza;180;Mozota;148;66;82
50;Zaragoza;181;Muel;1268;631;637
50;Zaragoza;182;Muela (La);924;482;442
50;Zaragoza;183;Munébrega;612;313;299
50;Zaragoza;184;Murero;183;100;83
50;Zaragoza;185;Murillo de Gállego;162;86;76
50;Zaragoza;186;Navardún;98;53;45
50;Zaragoza;187;Nigüella;151;76;75
50;Zaragoza;188;Nombrevilla;38;18;20
50;Zaragoza;189;Nonaspe;1210;621;589
50;Zaragoza;190;Novallas;880;427;453
50;Zaragoza;191;Novillas;790;408;382
50;Zaragoza;192;Nuévalos;311;169;142
50;Zaragoza;193;Nuez de Ebro;465;246;219
50;Zaragoza;194;Olvés;229;118;111
50;Zaragoza;195;Orcajo;50;23;27
50;Zaragoza;196;Orera;178;94;84
50;Zaragoza;197;Orés;154;87;67
50;Zaragoza;198;Oseja;19;10;9
50;Zaragoza;199;Osera de Ebro;337;153;184
50;Zaragoza;200;Paniza;806;399;407
50;Zaragoza;201;Paracuellos de Jiloca;567;264;303
50;Zaragoza;202;Paracuellos de la Ribera;413;201;212
50;Zaragoza;203;Pastriz;739;360;379
50;Zaragoza;204;Pedrola;2320;1170;1150
50;Zaragoza;205;Pedrosas (Las);109;52;57
50;Zaragoza;206;Perdiguera;536;276;260
50;Zaragoza;207;Piedratajada;279;135;144
50;Zaragoza;208;Pina de Ebro;2162;1075;1087
50;Zaragoza;209;Pinseque;1346;665;681
50;Zaragoza;210;Pintanos (Los);79;47;32
50;Zaragoza;211;Plasencia de Jalón;419;213;206
50;Zaragoza;212;Pleitas;91;46;45
50;Zaragoza;213;Plenas;189;94;95
50;Zaragoza;214;Pomer;31;14;17
50;Zaragoza;215;Pozuel de Ariza;40;24;16
50;Zaragoza;216;Pozuelo de Aragón;431;226;205
50;Zaragoza;217;Pradilla de Ebro;752;398;354
50;Zaragoza;218;Puebla de Albortón;185;93;92
50;Zaragoza;219;Puebla de Alfindén (La);1425;727;698
50;Zaragoza;220;Puendeluna;64;32;32
50;Zaragoza;221;Purujosa;7;5;2
50;Zaragoza;222;Quinto;2296;1154;1142
50;Zaragoza;223;Remolinos;1389;708;681
50;Zaragoza;224;Retascón;86;46;40
50;Zaragoza;225;Ricla;2290;1196;1094
50;Zaragoza;227;Romanos;181;99;82
50;Zaragoza;228;Rueda de Jalón;401;211;190
50;Zaragoza;229;Ruesca;106;55;51
50;Zaragoza;241;Sabiñán;1198;581;617
50;Zaragoza;230;Sádaba;2012;1013;999
50;Zaragoza;231;Salillas de Jalón;453;228;225
50;Zaragoza;232;Salvatierra de Esca;364;198;166
50;Zaragoza;233;Samper del Salz;85;39;46
50;Zaragoza;234;San Martín de la Virgen de Moncayo;333;177;156
50;Zaragoza;235;San Mateo de Gállego;1864;963;901
50;Zaragoza;236;Santa Cruz de Grío;264;146;118
50;Zaragoza;237;Santa Cruz de Moncayo;103;55;48
50;Zaragoza;238;Santa Eulalia de Gállego;136;73;63
50;Zaragoza;239;Santed;93;44;49
50;Zaragoza;240;Sástago;1740;874;866
50;Zaragoza;242;Sediles;121;64;57
50;Zaragoza;243;Sestrica;598;306;292
50;Zaragoza;244;Sierra de Luna;340;176;164
50;Zaragoza;245;Sigüés;211;112;99
50;Zaragoza;246;Sisamón;131;75;56
50;Zaragoza;247;Sobradiel;585;273;312
50;Zaragoza;248;Sos del Rey Católico;1033;530;503
50;Zaragoza;249;Tabuenca;546;278;268
50;Zaragoza;250;Talamantes;56;28;28
50;Zaragoza;251;Tarazona;11038;5301;5737
50;Zaragoza;252;Tauste;7224;3621;3603
50;Zaragoza;253;Terrer;827;388;439
50;Zaragoza;254;Tierga;323;171;152
50;Zaragoza;255;Tobed;354;175;179
50;Zaragoza;256;Torralba de los Frailes;141;72;69
50;Zaragoza;257;Torralba de Ribota;290;159;131
50;Zaragoza;258;Torralbilla;84;45;39
50;Zaragoza;259;Torrehermosa;144;74;70
50;Zaragoza;260;Torrelapaja;82;42;40
50;Zaragoza;261;Torrellas;389;193;196
50;Zaragoza;262;Torres de Berrellén;1465;744;721
50;Zaragoza;263;Torrijo de la Cañada;562;305;257
50;Zaragoza;264;Tosos;287;156;131
50;Zaragoza;265;Trasmoz;85;43;42
50;Zaragoza;266;Trasobares;318;172;146
50;Zaragoza;267;Uncastillo;938;471;467
50;Zaragoza;268;Undués de Lerda;49;25;24
50;Zaragoza;269;Urrea de Jalón;427;205;222
50;Zaragoza;270;Urriés;89;48;41
50;Zaragoza;271;Used;506;253;253
50;Zaragoza;272;Utebo;6675;3337;3338
50;Zaragoza;274;Val de San Martín;88;39;49
50;Zaragoza;273;Valdehorna;93;49;44
50;Zaragoza;275;Valmadrid;85;45;40
50;Zaragoza;276;Valpalmas;266;138;128
50;Zaragoza;277;Valtorres;152;76;76
50;Zaragoza;278;Velilla de Ebro;330;166;164
50;Zaragoza;279;Velilla de Jiloca;169;88;81
50;Zaragoza;280;Vera de Moncayo;567;287;280
50;Zaragoza;281;Vierlas;122;63;59
50;Zaragoza;283;Villadoz;118;63;55
50;Zaragoza;284;Villafeliche;288;144;144
50;Zaragoza;285;Villafranca de Ebro;682;333;349
50;Zaragoza;286;Villalba de Perejil;111;53;58
50;Zaragoza;287;Villalengua;542;286;256
50;Zaragoza;288;Villanueva de Gállego;2438;1229;1209
50;Zaragoza;290;Villanueva de Huerva;735;363;372
50;Zaragoza;289;Villanueva de Jiloca;159;86;73
50;Zaragoza;291;Villar de los Navarros;249;123;126
50;Zaragoza;292;Villarreal de Huerva;207;123;84
50;Zaragoza;293;Villarroya de la Sierra;912;449;463
50;Zaragoza;294;Villarroya del Campo;87;50;37
50;Zaragoza;282;Vilueña (La);139;66;73
50;Zaragoza;295;Vistabella;45;21;24
50;Zaragoza;296;Zaida (La);721;361;360
50;Zaragoza;297;Zaragoza;573662;277369;296293
50;Zaragoza;298;Zuera;5232;2660;2572
51;Ceuta;001;Ceuta;65151;32010;33141
52;Melilla;001;Melilla;52388;26026;26362
