01;Álava;001;Alegría-Dulantzi;1002;513;489
01;Álava;002;Amurrio;9886;4924;4962
01;Álava;049;Añana;190;101;89
01;Álava;003;Aramaio;1308;669;639
01;Álava;006;Armiñón;128;68;60
01;Álava;037;Arraia-Maeztu;702;366;336
01;Álava;008;Arrazua-Ubarrundia;667;357;310
01;Álava;004;Artziniega;1271;625;646
01;Álava;009;Asparrena;1528;764;764
01;Álava;010;Ayala/Aiara;2057;1019;1038
01;Álava;011;Baños de Ebro/Mañueta;335;181;154
01;Álava;013;Barrundia;576;324;252
01;Álava;014;Berantevilla;420;210;210
01;Álava;016;Bernedo;539;305;234
01;Álava;017;Campezo/Kanpezu;1164;611;553
01;Álava;021;Elburgo/Burgelu;205;110;95
01;Álava;022;Elciego;914;447;467
01;Álava;023;Elvillar/Bilar;372;193;179
01;Álava;056;Harana/Valle de Arana;384;210;174
01;Álava;901;Iruña Oka/Iruña de Oca;1575;809;766
01;Álava;027;Iruraiz-Gauna;423;229;194
01;Álava;019;Kripan;200;103;97
01;Álava;020;Kuartango;345;190;155
01;Álava;028;Labastida;999;544;455
01;Álava;030;Lagrán;194;105;89
01;Álava;031;Laguardia;1471;759;712
01;Álava;032;Lanciego/Lantziego;635;345;290
01;Álava;902;Lantarón;816;427;389
01;Álava;033;Lapuebla de Labarca;814;409;405
01;Álava;058;Legutiano;1260;691;569
01;Álava;034;Leza;196;107;89
01;Álava;036;Llodio;20341;10247;10094
01;Álava;039;Moreda de Álava;284;155;129
01;Álava;041;Navaridas;216;115;101
01;Álava;042;Okondo;722;365;357
01;Álava;043;Oyón/Oion;2133;1077;1056
01;Álava;044;Peñacerrada-Urizaharra;226;124;102
01;Álava;046;Ribera Alta;507;296;211
01;Álava;047;Ribera Baja/Erribera Beitia;423;235;188
01;Álava;051;Salvatierra/Agurain;3791;1891;1900
01;Álava;052;Samaniego;278;140;138
01;Álava;053;San Millán/Donemiliaga;714;393;321
01;Álava;054;Urkabustaiz;843;443;400
01;Álava;055;Valdegovía;848;479;369
01;Álava;057;Villabuena de Álava/Eskuernaga;363;180;183
01;Álava;059;Vitoria-Gasteiz;212632;104915;107717
01;Álava;060;Yécora/Lekora;238;117;121
01;Álava;061;Zalduondo;131;73;58
01;Álava;062;Zambrana;330;180;150
01;Álava;018;Zigoitia;826;448;378
01;Álava;063;Zuia;1280;653;627
02;Albacete;001;Abengibre;1030;521;509
02;Albacete;002;Alatoz;761;395;366
02;Albacete;003;Albacete;136549;66838;69711
02;Albacete;004;Albatana;934;484;450
02;Albacete;005;Alborea;798;415;383
02;Albacete;006;Alcadozo;823;422;401
02;Albacete;007;Alcalá del Júcar;1654;839;815
02;Albacete;008;Alcaraz;1992;962;1030
02;Albacete;009;Almansa;23187;11414;11773
02;Albacete;010;Alpera;2343;1203;1140
02;Albacete;011;Ayna;1145;583;562
02;Albacete;012;Balazote;2270;1138;1132
02;Albacete;014;Ballestero (El);668;335;333
02;Albacete;013;Balsa de Ves;262;145;117
02;Albacete;015;Barrax;2016;1005;1011
02;Albacete;016;Bienservida;934;485;449
02;Albacete;017;Bogarra;1521;800;721
02;Albacete;018;Bonete;1281;652;629
02;Albacete;019;Bonillo (El);3332;1697;1635
02;Albacete;020;Carcelén;774;400;374
02;Albacete;021;Casas de Juan Núñez;1308;675;633
02;Albacete;022;Casas de Lázaro;508;257;251
02;Albacete;023;Casas de Ves;1012;523;489
02;Albacete;024;Casas-Ibáñez;4009;2022;1987
02;Albacete;025;Caudete;8485;4215;4270
02;Albacete;026;Cenizate;1086;557;529
02;Albacete;029;Chinchilla de Monte-Aragón;3272;1672;1600
02;Albacete;027;Corral-Rubio;471;242;229
02;Albacete;028;Cotillas;270;133;137
02;Albacete;030;Elche de la Sierra;3968;1960;2008
02;Albacete;032;Fuensanta;418;201;217
02;Albacete;033;Fuente-Álamo;2479;1260;1219
02;Albacete;034;Fuentealbilla;1895;943;952
02;Albacete;031;Férez;880;438;442
02;Albacete;035;Gineta (La);2101;1030;1071
02;Albacete;036;Golosalvo;137;70;67
02;Albacete;037;Hellín;25859;12743;13116
02;Albacete;038;Herrera (La);446;234;212
02;Albacete;039;Higueruela;1307;644;663
02;Albacete;040;Hoya-Gonzalo;764;389;375
02;Albacete;041;Jorquera;685;365;320
02;Albacete;042;Letur;1425;720;705
02;Albacete;043;Lezuza;2028;1041;987
02;Albacete;044;Liétor;1876;955;921
02;Albacete;045;Madrigueras;4510;2258;2252
02;Albacete;046;Mahora;1374;671;703
02;Albacete;047;Masegoso;198;110;88
02;Albacete;048;Minaya;1962;999;963
02;Albacete;049;Molinicos;1652;856;796
02;Albacete;050;Montalvos;156;74;82
02;Albacete;051;Montealegre del Castillo;2151;1077;1074
02;Albacete;052;Motilleja;559;283;276
02;Albacete;053;Munera;4075;2050;2025
02;Albacete;054;Navas de Jorquera;594;306;288
02;Albacete;055;Nerpio;2050;1084;966
02;Albacete;056;Ontur;2545;1267;1278
02;Albacete;057;Ossa de Montiel;2894;1442;1452
02;Albacete;058;Paterna del Madera;668;357;311
02;Albacete;060;Peñas de San Pedro;1350;702;648
02;Albacete;059;Peñascosa;471;246;225
02;Albacete;061;Pétrola;1050;529;521
02;Albacete;062;Povedilla;772;401;371
02;Albacete;064;Pozo-Lorente;540;262;278
02;Albacete;063;Pozohondo;2012;1038;974
02;Albacete;065;Pozuelo;693;344;349
02;Albacete;066;Recueja (La);387;197;190
02;Albacete;067;Riópar;1384;719;665
02;Albacete;068;Robledo;506;259;247
02;Albacete;069;Roda (La);13391;6709;6682
02;Albacete;070;Salobre;669;346;323
02;Albacete;071;San Pedro;1342;684;658
02;Albacete;072;Socovos;2157;1114;1043
02;Albacete;073;Tarazona de la Mancha;5910;2967;2943
02;Albacete;074;Tobarra;7429;3696;3733
02;Albacete;075;Valdeganga;2179;1110;1069
02;Albacete;076;Vianos;531;268;263
02;Albacete;077;Villa de Ves;61;32;29
02;Albacete;078;Villalgordo del Júcar;1312;648;664
02;Albacete;079;Villamalea;3387;1756;1631
02;Albacete;080;Villapalacios;1014;518;496
02;Albacete;081;Villarrobledo;21951;10785;11166
02;Albacete;082;Villatoya;213;118;95
02;Albacete;083;Villavaliente;311;165;146
02;Albacete;084;Villaverde de Guadalimar;638;341;297
02;Albacete;085;Viveros;633;330;303
02;Albacete;086;Yeste;4873;2505;2368
03;Alicante/Alacant;001;Adsubia;541;266;275
03;Alicante/Alacant;002;Agost;3993;2016;1977
03;Alicante/Alacant;003;Agres;664;345;319
03;Alicante/Alacant;004;Aigües;406;208;198
03;Alicante/Alacant;005;Albatera;9201;4621;4580
03;Alicante/Alacant;006;Alcalalí;824;410;414
03;Alicante/Alacant;007;Alcocer de Planes;132;59;73
03;Alicante/Alacant;008;Alcoleja;299;137;162
03;Alicante/Alacant;009;Alcoy/Alcoi;64820;31178;33642
03;Alicante/Alacant;010;Alfafara;386;183;203
03;Alicante/Alacant;011;Alfàs del Pi (L');9897;4841;5056
03;Alicante/Alacant;012;Algorfa;1077;545;532
03;Alicante/Alacant;013;Algueña;1469;717;752
03;Alicante/Alacant;014;Alicante/Alacant;271218;130745;140473
03;Alicante/Alacant;015;Almoradí;12909;6406;6503
03;Alicante/Alacant;016;Almudaina;140;68;72
03;Alicante/Alacant;017;Alquería d'Asnar (L');412;197;215
03;Alicante/Alacant;018;Altea;13082;6458;6624
03;Alicante/Alacant;019;Aspe;16194;8042;8152
03;Alicante/Alacant;020;Balones;155;67;88
03;Alicante/Alacant;021;Banyeres de Mariola;7072;3511;3561
03;Alicante/Alacant;022;Benasau;215;103;112
03;Alicante/Alacant;023;Beneixama;1849;909;940
03;Alicante/Alacant;024;Benejúzar;4755;2396;2359
03;Alicante/Alacant;025;Benferri;986;495;491
03;Alicante/Alacant;026;Beniarbeig;1187;590;597
03;Alicante/Alacant;027;Beniardá;231;110;121
03;Alicante/Alacant;028;Beniarrés;1474;746;728
03;Alicante/Alacant;030;Benidoleig;780;388;392
03;Alicante/Alacant;031;Benidorm;44812;22075;22737
03;Alicante/Alacant;032;Benifallim;172;90;82
03;Alicante/Alacant;033;Benifato;124;63;61
03;Alicante/Alacant;029;Benigembla;351;175;176
03;Alicante/Alacant;034;Benijófar;1530;728;802
03;Alicante/Alacant;035;Benilloba;972;493;479
03;Alicante/Alacant;036;Benillup;78;43;35
03;Alicante/Alacant;037;Benimantell;448;208;240
03;Alicante/Alacant;038;Benimarfull;414;183;231
03;Alicante/Alacant;039;Benimassot;115;58;57
03;Alicante/Alacant;040;Benimeli;323;160;163
03;Alicante/Alacant;041;Benissa;8100;4025;4075
03;Alicante/Alacant;042;Benitachell/Poble Nou de Benitatxell (el);1696;861;835
03;Alicante/Alacant;043;Biar;3569;1735;1834
03;Alicante/Alacant;044;Bigastro;4577;2348;2229
03;Alicante/Alacant;045;Bolulla;270;136;134
03;Alicante/Alacant;046;Busot;1080;536;544
03;Alicante/Alacant;048;Callosa d'En Sarrià;7646;3802;3844
03;Alicante/Alacant;049;Callosa de Segura;15688;7818;7870
03;Alicante/Alacant;047;Calpe/Calp;11185;5663;5522
03;Alicante/Alacant;050;Campello (El);11928;5911;6017
03;Alicante/Alacant;051;Campo de Mirra/Camp de Mirra (el);379;183;196
03;Alicante/Alacant;053;Castalla;7471;3690;3781
03;Alicante/Alacant;054;Castell de Castells;516;255;261
03;Alicante/Alacant;055;Catral;4575;2280;2295
03;Alicante/Alacant;052;Cañada;1091;531;560
03;Alicante/Alacant;056;Cocentaina;10642;5202;5440
03;Alicante/Alacant;057;Confrides;293;163;130
03;Alicante/Alacant;058;Cox;5877;2957;2920
03;Alicante/Alacant;059;Crevillent;23260;11720;11540
03;Alicante/Alacant;061;Daya Nueva;1189;600;589
03;Alicante/Alacant;062;Daya Vieja;202;101;101
03;Alicante/Alacant;064;Dolores;6081;3043;3038
03;Alicante/Alacant;063;Dénia;26167;12751;13416
03;Alicante/Alacant;065;Elche/Elx;189845;94116;95729
03;Alicante/Alacant;066;Elda;55280;26997;28283
03;Alicante/Alacant;067;Facheca;139;79;60
03;Alicante/Alacant;068;Famorca;67;32;35
03;Alicante/Alacant;069;Finestrat;1379;672;707
03;Alicante/Alacant;070;Formentera del Segura;2019;1001;1018
03;Alicante/Alacant;072;Gaianes;333;161;172
03;Alicante/Alacant;071;Gata de Gorgos;5030;2499;2531
03;Alicante/Alacant;073;Gorga;291;144;147
03;Alicante/Alacant;074;Granja de Rocamora;1975;1010;965
03;Alicante/Alacant;075;Guadalest;159;83;76
03;Alicante/Alacant;076;Guardamar del Segura;7265;3594;3671
03;Alicante/Alacant;077;Hondón de las Nieves;1426;712;714
03;Alicante/Alacant;078;Hondón de los Frailes;549;267;282
03;Alicante/Alacant;079;Ibi;20968;10422;10546
03;Alicante/Alacant;080;Jacarilla;1467;741;726
03;Alicante/Alacant;081;Jalón/Xaló;1939;953;986
03;Alicante/Alacant;083;Jijona/Xixona;7866;3713;4153
03;Alicante/Alacant;082;Jávea/Xàbia;16471;8208;8263
03;Alicante/Alacant;085;Llíber;491;238;253
03;Alicante/Alacant;084;Lorcha/Orxa (L');811;415;396
03;Alicante/Alacant;086;Millena;130;61;69
03;Alicante/Alacant;088;Monforte del Cid;5146;2657;2489
03;Alicante/Alacant;903;Montesinos (Los);2346;1195;1151
03;Alicante/Alacant;089;Monóvar/Monòver;12109;5892;6217
03;Alicante/Alacant;091;Murla;333;143;190
03;Alicante/Alacant;092;Muro de Alcoy;6671;3306;3365
03;Alicante/Alacant;090;Mutxamel;11039;5538;5501
03;Alicante/Alacant;093;Novelda;22684;11104;11580
03;Alicante/Alacant;094;Nucia (la);6390;3192;3198
03;Alicante/Alacant;095;Ondara;4978;2469;2509
03;Alicante/Alacant;096;Onil;6712;3337;3375
03;Alicante/Alacant;097;Orba;1579;761;818
03;Alicante/Alacant;099;Orihuela;49475;24266;25209
03;Alicante/Alacant;098;Orxeta;524;261;263
03;Alicante/Alacant;100;Parcent;724;349;375
03;Alicante/Alacant;101;Pedreguer;5723;2782;2941
03;Alicante/Alacant;102;Pego;9418;4674;4744
03;Alicante/Alacant;103;Penàguila;349;173;176
03;Alicante/Alacant;104;Petrer;25351;12612;12739
03;Alicante/Alacant;902;Pilar de la Horadada;8295;4185;4110
03;Alicante/Alacant;105;Pinoso;5792;2884;2908
03;Alicante/Alacant;106;Planes;800;394;406
03;Alicante/Alacant;901;Poblets (Els);1054;507;547
03;Alicante/Alacant;107;Polop;1856;918;938
03;Alicante/Alacant;060;Quatretondeta;192;94;98
03;Alicante/Alacant;109;Rafal;2774;1384;1390
03;Alicante/Alacant;111;Redován;5122;2614;2508
03;Alicante/Alacant;112;Relleu;831;412;419
03;Alicante/Alacant;113;Rojales;5486;2747;2739
03;Alicante/Alacant;114;Romana (La);1932;980;952
03;Alicante/Alacant;110;Ràfol d'Almúnia (El);371;179;192
03;Alicante/Alacant;115;Sagra;369;183;186
03;Alicante/Alacant;116;Salinas;1119;573;546
03;Alicante/Alacant;118;San Fulgencio;1995;1019;976
03;Alicante/Alacant;904;San Isidro;"";"";""
03;Alicante/Alacant;120;San Miguel de Salinas;3082;1586;1496
03;Alicante/Alacant;122;San Vicente del Raspeig/Sant Vicent del Raspeig;32014;15890;16124
03;Alicante/Alacant;117;Sanet y Negrals;543;240;303
03;Alicante/Alacant;119;Sant Joan d'Alacant;14625;7234;7391
03;Alicante/Alacant;121;Santa Pola;16177;8056;8121
03;Alicante/Alacant;123;Sax;8522;4273;4249
03;Alicante/Alacant;124;Sella;584;305;279
03;Alicante/Alacant;125;Senija;478;245;233
03;Alicante/Alacant;128;Teulada;5696;2806;2890
03;Alicante/Alacant;129;Tibi;1076;542;534
03;Alicante/Alacant;130;Tollos;38;23;15
03;Alicante/Alacant;131;Tormos;279;139;140
03;Alicante/Alacant;132;Torremanzanas/Torre de les Maçanes (la);740;353;387
03;Alicante/Alacant;133;Torrevieja;28037;13764;14273
03;Alicante/Alacant;127;Tárbena;710;365;345
03;Alicante/Alacant;134;Vall d'Alcalà (La);179;84;95
03;Alicante/Alacant;135;Vall de Ebo;343;173;170
03;Alicante/Alacant;136;Vall de Gallinera;738;376;362
03;Alicante/Alacant;137;Vall de Laguar (La);968;474;494
03;Alicante/Alacant;138;Verger (El);3662;1770;1892
03;Alicante/Alacant;139;Villajoyosa/Vila Joiosa (La);23176;11484;11692
03;Alicante/Alacant;140;Villena;31297;15440;15857
04;Almería;001;Abla;1621;788;833
04;Almería;002;Abrucena;1441;688;753
04;Almería;003;Adra;20847;10408;10439
04;Almería;004;Albánchez;684;340;344
04;Almería;005;Alboloduy;872;398;474
04;Almería;006;Albox;10271;5105;5166
04;Almería;007;Alcolea;833;418;415
04;Almería;008;Alcóntar;658;343;315
04;Almería;009;Alcudia de Monteagud;207;96;111
04;Almería;010;Alhabia;737;367;370
04;Almería;011;Alhama de Almería;3089;1539;1550
04;Almería;012;Alicún;240;112;128
04;Almería;013;Almería;162316;78669;83647
04;Almería;014;Almócita;184;96;88
04;Almería;015;Alsodux;127;56;71
04;Almería;016;Antas;2555;1257;1298
04;Almería;017;Arboleas;1525;776;749
04;Almería;018;Armuña de Almanzora;367;173;194
04;Almería;019;Bacares;303;167;136
04;Almería;020;Bayárcal;384;209;175
04;Almería;021;Bayarque;230;109;121
04;Almería;022;Bédar;512;278;234
04;Almería;023;Beires;137;63;74
04;Almería;024;Benahadux;2394;1160;1234
04;Almería;026;Benitagla;105;56;49
04;Almería;027;Benizalón;326;171;155
04;Almería;028;Bentarique;355;181;174
04;Almería;029;Berja;12570;6251;6319
04;Almería;030;Canjáyar;1801;903;898
04;Almería;031;Cantoria;3352;1695;1657
04;Almería;032;Carboneras;5978;3085;2893
04;Almería;033;Castro de Filabres;152;72;80
04;Almería;036;Chercos;308;153;155
04;Almería;037;Chirivel;2002;999;1003
04;Almería;034;Cóbdar;278;141;137
04;Almería;035;Cuevas del Almanzora;9251;4609;4642
04;Almería;038;Dalías;3583;1765;1818
04;Almería;039;Darrical;360;182;178
04;Almería;902;Ejido (El);43466;22069;21397
04;Almería;041;Enix;239;113;126
04;Almería;043;Felix;601;297;304
04;Almería;044;Fines;1676;860;816
04;Almería;045;Fiñana;2705;1332;1373
04;Almería;046;Fondón;929;476;453
04;Almería;047;Gádor;2555;1249;1306
04;Almería;048;Gallardos (Los);1680;844;836
04;Almería;049;Garrucha;4562;2337;2225
04;Almería;050;Gérgal;1104;535;569
04;Almería;051;Huécija;560;277;283
04;Almería;052;Huércal de Almería;3972;1974;1998
04;Almería;053;Huércal-Overa;13673;6753;6920
04;Almería;054;Illar;482;231;251
04;Almería;055;Instinción;613;290;323
04;Almería;056;Laroya;127;66;61
04;Almería;057;Láujar de Andarax;1850;918;932
04;Almería;058;Líjar;531;270;261
04;Almería;059;Lubrín;1973;940;1033
04;Almería;060;Lucainena de las Torres;565;274;291
04;Almería;061;Lúcar;754;374;380
04;Almería;062;Macael;6072;3072;3000
04;Almería;063;María;1743;892;851
04;Almería;064;Mojácar;3690;1799;1891
04;Almería;903;Mojonera (La);5684;2891;2793
04;Almería;065;Nacimiento;483;238;245
04;Almería;066;Níjar;13754;7035;6719
04;Almería;067;Ohanes;847;431;416
04;Almería;068;Olula de Castro;234;118;116
04;Almería;069;Olula del Río;5804;2918;2886
04;Almería;070;Oria;2420;1221;1199
04;Almería;071;Padules;514;268;246
04;Almería;072;Partaloa;393;192;201
04;Almería;073;Paterna del Río;343;171;172
04;Almería;074;Pechina;2381;1172;1209
04;Almería;075;Pulpí;4707;2387;2320
04;Almería;076;Purchena;1756;870;886
04;Almería;077;Rágol;427;202;225
04;Almería;078;Rioja;1162;574;588
04;Almería;079;Roquetas de Mar;30629;15388;15241
04;Almería;080;Santa Cruz de Marchena;197;95;102
04;Almería;081;Santa Fe de Mondújar;418;203;215
04;Almería;082;Senés;366;189;177
04;Almería;083;Serón;2987;1496;1491
04;Almería;084;Sierro;563;294;269
04;Almería;085;Somontín;489;242;247
04;Almería;086;Sorbas;2797;1408;1389
04;Almería;087;Suflí;258;128;130
04;Almería;088;Tabernas;3141;1584;1557
04;Almería;089;Taberno;1045;518;527
04;Almería;090;Tahal;504;246;258
04;Almería;091;Terque;447;221;226
04;Almería;092;Tíjola;3703;1876;1827
04;Almería;901;Tres Villas (Las);703;368;335
04;Almería;093;Turre;2183;1069;1114
04;Almería;094;Turrillas;282;151;131
04;Almería;095;Uleila del Campo;1012;509;503
04;Almería;096;Urrácal;324;161;163
04;Almería;097;Velefique;353;186;167
04;Almería;098;Vélez-Blanco;2331;1180;1151
04;Almería;099;Vélez-Rubio;6467;3133;3334
04;Almería;100;Vera;6357;3140;3217
04;Almería;101;Viator;2863;1396;1467
04;Almería;102;Vícar;12460;6396;6064
04;Almería;103;Zurgena;2197;1089;1108
05;Ávila;001;Adanero;362;188;174
05;Ávila;002;Adrada (La);1964;1017;947
05;Ávila;005;Albornos;296;155;141
05;Ávila;007;Aldeanueva de Santa Cruz;210;113;97
05;Ávila;008;Aldeaseca;407;199;208
05;Ávila;010;Aldehuela (La);310;157;153
05;Ávila;012;Amavida;215;106;109
05;Ávila;013;Arenal (El);1135;562;573
05;Ávila;014;Arenas de San Pedro;6570;3291;3279
05;Ávila;015;Arevalillo;175;89;86
05;Ávila;016;Arévalo;7448;3569;3879
05;Ávila;017;Aveinte;157;79;78
05;Ávila;018;Avellaneda;55;24;31
05;Ávila;019;Ávila;48531;23548;24983
05;Ávila;021;Barco de Ávila (El);2595;1299;1296
05;Ávila;022;Barraco (El);2057;1030;1027
05;Ávila;023;Barromán;287;160;127
05;Ávila;024;Becedas;547;288;259
05;Ávila;025;Becedillas;179;98;81
05;Ávila;026;Bercial de Zapardiel;370;179;191
05;Ávila;027;Berlanas (Las);406;201;205
05;Ávila;029;Bernuy-Zapardiel;292;159;133
05;Ávila;030;Berrocalejo de Aragona;43;21;22
05;Ávila;033;Blascomillán;358;172;186
05;Ávila;034;Blasconuño de Matacabras;33;19;14
05;Ávila;035;Blascosancho;169;87;82
05;Ávila;036;Bohodón (El);208;106;102
05;Ávila;037;Bohoyo;542;283;259
05;Ávila;038;Bonilla de la Sierra;218;119;99
05;Ávila;039;Brabos;82;45;37
05;Ávila;040;Bularros;143;78;65
05;Ávila;041;Burgohondo;1368;695;673
05;Ávila;042;Cabezas de Alambre;292;151;141
05;Ávila;043;Cabezas del Pozo;215;108;107
05;Ávila;044;Cabezas del Villar;554;302;252
05;Ávila;045;Cabizuela;166;81;85
05;Ávila;046;Canales;89;44;45
05;Ávila;047;Candeleda;5391;2736;2655
05;Ávila;048;Cantiveros;214;110;104
05;Ávila;049;Cardeñosa;585;305;280
05;Ávila;051;Carrera (La);354;174;180
05;Ávila;052;Casas del Puerto de Villatoro;127;66;61
05;Ávila;053;Casasola;192;98;94
05;Ávila;054;Casavieja;1646;870;776
05;Ávila;055;Casillas;994;514;480
05;Ávila;056;Castellanos de Zapardiel;157;88;69
05;Ávila;057;Cebreros;3631;1819;1812
05;Ávila;058;Cepeda la Mora;172;93;79
05;Ávila;067;Chamartín;129;70;59
05;Ávila;059;Cillán;169;85;84
05;Ávila;060;Cisla;237;113;124
05;Ávila;061;Colilla (La);208;104;104
05;Ávila;062;Collado de Contreras;291;154;137
05;Ávila;063;Collado del Mirón;120;62;58
05;Ávila;064;Constanzana;218;116;102
05;Ávila;065;Crespos;818;439;379
05;Ávila;066;Cuevas del Valle;666;359;307
05;Ávila;903;Diego del Carpio;394;212;182
05;Ávila;069;Donjimeno;156;80;76
05;Ávila;070;Donvidas;81;37;44
05;Ávila;072;Espinosa de los Caballeros;119;65;54
05;Ávila;073;Flores de Ávila;490;256;234
05;Ávila;074;Fontíveros;1140;580;560
05;Ávila;075;Fresnedilla;140;66;74
05;Ávila;076;Fresno (El);448;233;215
05;Ávila;077;Fuente el Saúz;368;181;187
05;Ávila;078;Fuentes de Año;256;134;122
05;Ávila;079;Gallegos de Altamiros;122;68;54
05;Ávila;080;Gallegos de Sobrinos;127;57;70
05;Ávila;081;Garganta del Villar;98;58;40
05;Ávila;082;Gavilanes;785;427;358
05;Ávila;083;Gemuño;276;134;142
05;Ávila;085;Gil García;88;44;44
05;Ávila;084;Gilbuena;178;99;79
05;Ávila;086;Gimialcón;147;79;68
05;Ávila;087;Gotarrendura;204;69;135
05;Ávila;088;Grandes y San Martín;65;31;34
05;Ávila;089;Guisando;743;382;361
05;Ávila;090;Gutierre-Muñoz;148;72;76
05;Ávila;092;Hernansancho;246;125;121
05;Ávila;093;Herradón de Pinares;507;263;244
05;Ávila;094;Herreros de Suso;264;129;135
05;Ávila;095;Higuera de las Dueñas;325;172;153
05;Ávila;096;Hija de Dios (La);149;83;66
05;Ávila;097;Horcajada (La);952;465;487
05;Ávila;099;Horcajo de las Torres;926;497;429
05;Ávila;100;Hornillo (El);539;267;272
05;Ávila;102;Hoyo de Pinares (El);2602;1318;1284
05;Ávila;101;Hoyocasero;469;249;220
05;Ávila;103;Hoyorredondo;150;78;72
05;Ávila;106;Hoyos de Miguel Muñoz;69;37;32
05;Ávila;104;Hoyos del Collado;53;36;17
05;Ávila;105;Hoyos del Espino;388;212;176
05;Ávila;107;Hurtumpascual;157;81;76
05;Ávila;108;Junciana;106;52;54
05;Ávila;109;Langa;622;322;300
05;Ávila;110;Lanzahíta;957;486;471
05;Ávila;113;Llanos de Tormes (Los);160;83;77
05;Ávila;112;Losar del Barco (El);186;100;86
05;Ávila;114;Madrigal de las Altas Torres;2118;1085;1033
05;Ávila;115;Maello;668;331;337
05;Ávila;116;Malpartida de Corneja;275;135;140
05;Ávila;117;Mamblas;325;172;153
05;Ávila;118;Mancera de Arriba;187;96;91
05;Ávila;119;Manjabálago;94;51;43
05;Ávila;120;Marlín;39;21;18
05;Ávila;121;Martiherrero;224;109;115
05;Ávila;122;Martínez;289;152;137
05;Ávila;123;Mediana de Voltoya;118;65;53
05;Ávila;124;Medinilla;280;148;132
05;Ávila;125;Mengamuñoz;75;33;42
05;Ávila;126;Mesegar de Corneja;138;67;71
05;Ávila;127;Mijares;1051;540;511
05;Ávila;128;Mingorría;580;294;286
05;Ávila;129;Mirón (El);334;183;151
05;Ávila;130;Mironcillo;138;79;59
05;Ávila;131;Mirueña de los Infanzones;266;134;132
05;Ávila;132;Mombeltrán;1214;648;566
05;Ávila;133;Monsalupe;109;55;54
05;Ávila;134;Moraleja de Matacabras;78;37;41
05;Ávila;135;Muñana;618;321;297
05;Ávila;136;Muñico;167;87;80
05;Ávila;138;Muñogalindo;480;266;214
05;Ávila;139;Muñogrande;125;66;59
05;Ávila;140;Muñomer del Peco;140;76;64
05;Ávila;141;Muñopepe;113;60;53
05;Ávila;142;Muñosancho;188;86;102
05;Ávila;143;Muñotello;152;82;70
05;Ávila;144;Narrillos del Álamo;185;96;89
05;Ávila;145;Narrillos del Rebollar;98;52;46
05;Ávila;149;Narros de Saldueña;252;131;121
05;Ávila;147;Narros del Castillo;307;166;141
05;Ávila;148;Narros del Puerto;56;32;24
05;Ávila;152;Nava de Arévalo;1119;579;540
05;Ávila;153;Nava del Barco;235;108;127
05;Ávila;151;Navacepedilla de Corneja;157;84;73
05;Ávila;154;Navadijos;86;49;37
05;Ávila;155;Navaescurial;120;70;50
05;Ávila;156;Navahondilla;157;66;91
05;Ávila;157;Navalacruz;347;169;178
05;Ávila;158;Navalmoral;669;345;324
05;Ávila;159;Navalonguilla;559;277;282
05;Ávila;160;Navalosa;600;314;286
05;Ávila;161;Navalperal de Pinares;945;452;493
05;Ávila;162;Navalperal de Tormes;167;86;81
05;Ávila;163;Navaluenga;2080;1049;1031
05;Ávila;164;Navaquesera;118;60;58
05;Ávila;165;Navarredonda de Gredos;507;259;248
05;Ávila;166;Navarredondilla;315;155;160
05;Ávila;167;Navarrevisca;419;222;197
05;Ávila;168;Navas del Marqués (Las);4205;2110;2095
05;Ávila;169;Navatalgordo;534;275;259
05;Ávila;170;Navatejares;120;56;64
05;Ávila;171;Neila de San Miguel;152;76;76
05;Ávila;172;Niharra;216;105;111
05;Ávila;173;Ojos-Albos;44;19;25
05;Ávila;174;Orbita;105;55;50
05;Ávila;175;Oso (El);258;139;119
05;Ávila;176;Padiernos;279;149;130
05;Ávila;177;Pajares de Adaja;211;111;100
05;Ávila;178;Palacios de Goda;585;279;306
05;Ávila;179;Papatrigo;370;192;178
05;Ávila;180;Parral (El);126;67;59
05;Ávila;181;Pascualcobo;50;28;22
05;Ávila;182;Pedro Bernardo;1563;795;768
05;Ávila;183;Pedro-Rodríguez;252;118;134
05;Ávila;184;Peguerinos;387;200;187
05;Ávila;185;Peñalba de Ávila;148;82;66
05;Ávila;186;Piedrahíta;2297;1120;1177
05;Ávila;187;Piedralaves;2174;1093;1081
05;Ávila;188;Poveda;99;55;44
05;Ávila;189;Poyales del Hoyo;851;429;422
05;Ávila;190;Pozanco;68;37;31
05;Ávila;191;Pradosegar;198;105;93
05;Ávila;192;Puerto Castilla;159;76;83
05;Ávila;193;Rasueros;415;224;191
05;Ávila;194;Riocabado;225;125;100
05;Ávila;195;Riofrío;357;197;160
05;Ávila;196;Rivilla de Barajas;102;57;45
05;Ávila;197;Salobral;130;64;66
05;Ávila;198;Salvadiós;150;79;71
05;Ávila;199;San Bartolomé de Béjar;104;49;55
05;Ávila;200;San Bartolomé de Corneja;137;71;66
05;Ávila;201;San Bartolomé de Pinares;813;441;372
05;Ávila;206;San Esteban de los Patos;45;23;22
05;Ávila;208;San Esteban de Zapardiel;93;42;51
05;Ávila;207;San Esteban del Valle;1011;512;499
05;Ávila;209;San García de Ingelmos;204;104;100
05;Ávila;901;San Juan de Gredos;491;247;244
05;Ávila;210;San Juan de la Encinilla;162;73;89
05;Ávila;211;San Juan de la Nava;743;381;362
05;Ávila;212;San Juan del Molinillo;370;208;162
05;Ávila;213;San Juan del Olmo;212;114;98
05;Ávila;214;San Lorenzo de Tormes;93;45;48
05;Ávila;215;San Martín de la Vega del Alberche;342;197;145
05;Ávila;216;San Martín del Pimpollar;341;184;157
05;Ávila;217;San Miguel de Corneja;130;66;64
05;Ávila;218;San Miguel de Serrezuela;254;132;122
05;Ávila;219;San Pascual;72;38;34
05;Ávila;220;San Pedro del Arroyo;529;277;252
05;Ávila;231;San Vicente de Arévalo;253;125;128
05;Ávila;204;Sanchidrián;779;377;402
05;Ávila;205;Sanchorreja;142;76;66
05;Ávila;222;Santa Cruz de Pinares;246;137;109
05;Ávila;221;Santa Cruz del Valle;663;331;332
05;Ávila;226;Santa María de los Caballeros;200;103;97
05;Ávila;224;Santa María del Arroyo;162;83;79
05;Ávila;225;Santa María del Berrocal;694;335;359
05;Ávila;902;Santa María del Cubillo;441;241;200
05;Ávila;227;Santa María del Tiétar;367;185;182
05;Ávila;228;Santiago del Collado;331;202;129
05;Ávila;904;Santiago del Tormes;382;194;188
05;Ávila;229;Santo Domingo de las Posadas;102;51;51
05;Ávila;230;Santo Tomé de Zabarcos;139;78;61
05;Ávila;232;Serrada (La);153;77;76
05;Ávila;233;Serranillos;523;269;254
05;Ávila;234;Sigeres;96;44;52
05;Ávila;235;Sinlabajos;280;145;135
05;Ávila;236;Solana de Ávila;279;145;134
05;Ávila;237;Solana de Rioalmar;350;179;171
05;Ávila;238;Solosancho;1181;628;553
05;Ávila;239;Sotalbo;275;143;132
05;Ávila;240;Sotillo de la Adrada;3460;1729;1731
05;Ávila;241;Tiemblo (El);3744;1875;1869
05;Ávila;242;Tiñosillos;761;410;351
05;Ávila;243;Tolbaños;167;84;83
05;Ávila;244;Tormellas;146;73;73
05;Ávila;245;Tornadizos de Ávila;355;175;180
05;Ávila;247;Torre (La);503;272;231
05;Ávila;246;Tórtoles;136;72;64
05;Ávila;249;Umbrías;179;90;89
05;Ávila;251;Vadillo de la Sierra;204;116;88
05;Ávila;252;Valdecasa;132;70;62
05;Ávila;253;Vega de Santa María;149;81;68
05;Ávila;254;Velayos;311;156;155
05;Ávila;256;Villaflor;192;101;91
05;Ávila;257;Villafranca de la Sierra;276;142;134
05;Ávila;905;Villanueva de Ávila;663;341;322
05;Ávila;258;Villanueva de Gómez;171;79;92
05;Ávila;259;Villanueva del Aceral;249;118;131
05;Ávila;260;Villanueva del Campillo;253;128;125
05;Ávila;261;Villar de Corneja;107;52;55
05;Ávila;262;Villarejo del Valle;480;251;229
05;Ávila;263;Villatoro;262;141;121
05;Ávila;264;Viñegra de Moraña;88;49;39
05;Ávila;265;Vita;124;74;50
05;Ávila;266;Zapardiel de la Cañada;221;110;111
05;Ávila;267;Zapardiel de la Ribera;163;82;81
06;Badajoz;001;Acedera;1043;558;485
06;Badajoz;002;Aceuchal;5089;2509;2580
06;Badajoz;003;Ahillones;1288;642;646
06;Badajoz;004;Alange;2032;1057;975
06;Badajoz;005;Albuera (La);1829;931;898
06;Badajoz;006;Alburquerque;5845;2973;2872
06;Badajoz;007;Alconchel;2334;1155;1179
06;Badajoz;008;Alconera;814;408;406
06;Badajoz;009;Aljucén;229;125;104
06;Badajoz;010;Almendral;1525;754;771
06;Badajoz;011;Almendralejo;25596;12472;13124
06;Badajoz;012;Arroyo de San Serván;4026;2040;1986
06;Badajoz;013;Atalaya;378;186;192
06;Badajoz;014;Azuaga;9924;4860;5064
06;Badajoz;015;Badajoz;129451;62702;66749
06;Badajoz;016;Barcarrota;4225;2107;2118
06;Badajoz;017;Baterno;420;210;210
06;Badajoz;018;Benquerencia de la Serena;1170;588;582
06;Badajoz;019;Berlanga;2750;1359;1391
06;Badajoz;020;Bienvenida;2448;1231;1217
06;Badajoz;021;Bodonal de la Sierra;1411;716;695
06;Badajoz;022;Burguillos del Cerro;3362;1644;1718
06;Badajoz;023;Cabeza del Buey;6394;3130;3264
06;Badajoz;024;Cabeza la Vaca;1709;857;852
06;Badajoz;025;Calamonte;5667;2804;2863
06;Badajoz;026;Calera de León;1204;612;592
06;Badajoz;027;Calzadilla de los Barros;826;414;412
06;Badajoz;028;Campanario;6028;2899;3129
06;Badajoz;029;Campillo de Llerena;1821;900;921
06;Badajoz;030;Capilla;243;112;131
06;Badajoz;031;Carmonita;739;394;345
06;Badajoz;032;Carrascalejo (El);30;15;15
06;Badajoz;033;Casas de Don Pedro;1941;942;999
06;Badajoz;034;Casas de Reina;326;140;186
06;Badajoz;035;Castilblanco;1477;732;745
06;Badajoz;036;Castuera;7563;3801;3762
06;Badajoz;042;Cheles;1348;680;668
06;Badajoz;037;Codosera (La);2611;1340;1271
06;Badajoz;038;Cordobilla de Lácara;1028;523;505
06;Badajoz;039;Coronada (La);2576;1287;1289
06;Badajoz;040;Corte de Peleas;1329;672;657
06;Badajoz;041;Cristina;557;298;259
06;Badajoz;043;Don Álvaro;629;317;312
06;Badajoz;044;Don Benito;30456;15081;15375
06;Badajoz;045;Entrín Bajo;682;338;344
06;Badajoz;046;Esparragalejo;1443;719;724
06;Badajoz;047;Esparragosa de la Serena;1152;576;576
06;Badajoz;048;Esparragosa de Lares;1289;631;658
06;Badajoz;049;Feria;1597;791;806
06;Badajoz;050;Fregenal de la Sierra;5574;2703;2871
06;Badajoz;051;Fuenlabrada de los Montes;2163;1056;1107
06;Badajoz;052;Fuente de Cantos;5164;2610;2554
06;Badajoz;053;Fuente del Arco;899;456;443
06;Badajoz;054;Fuente del Maestre;6823;3380;3443
06;Badajoz;055;Fuentes de León;2921;1403;1518
06;Badajoz;056;Garbayuela;620;329;291
06;Badajoz;057;Garlitos;875;441;434
06;Badajoz;058;Garrovilla (La);2710;1400;1310
06;Badajoz;059;Granja de Torrehermosa;2766;1386;1380
06;Badajoz;060;Guareña;7407;3756;3651
06;Badajoz;061;Haba (La);1570;791;779
06;Badajoz;062;Helechosa de los Montes;811;428;383
06;Badajoz;063;Herrera del Duque;4120;2103;2017
06;Badajoz;064;Higuera de la Serena;1319;671;648
06;Badajoz;065;Higuera de Llerena;547;261;286
06;Badajoz;066;Higuera de Vargas;3010;1503;1507
06;Badajoz;067;Higuera la Real;2809;1408;1401
06;Badajoz;068;Hinojosa del Valle;658;341;317
06;Badajoz;069;Hornachos;3878;1957;1921
06;Badajoz;070;Jerez de los Caballeros;10432;5220;5212
06;Badajoz;071;Lapa (La);366;180;186
06;Badajoz;073;Llera;1068;551;517
06;Badajoz;074;Llerena;5720;2771;2949
06;Badajoz;072;Lobón;2745;1418;1327
06;Badajoz;075;Magacela;896;461;435
06;Badajoz;076;Maguilla;1170;589;581
06;Badajoz;077;Malcocinado;624;332;292
06;Badajoz;078;Malpartida de la Serena;1069;540;529
06;Badajoz;079;Manchita;780;402;378
06;Badajoz;080;Medellín;2514;1270;1244
06;Badajoz;081;Medina de las Torres;1684;824;860
06;Badajoz;082;Mengabril;490;241;249
06;Badajoz;083;Mérida;51170;25054;26116
06;Badajoz;084;Mirandilla;1335;677;658
06;Badajoz;085;Monesterio;5226;2605;2621
06;Badajoz;086;Montemolín;1873;913;960
06;Badajoz;087;Monterrubio de la Serena;3254;1592;1662
06;Badajoz;088;Montijo;15220;7391;7829
06;Badajoz;089;Morera (La);812;412;400
06;Badajoz;090;Nava de Santiago (La);1161;590;571
06;Badajoz;091;Navalvillar de Pela;5094;2570;2524
06;Badajoz;092;Nogales;811;412;399
06;Badajoz;093;Oliva de la Frontera;6553;3267;3286
06;Badajoz;094;Oliva de Mérida;2177;1091;1086
06;Badajoz;095;Olivenza;10477;5154;5323
06;Badajoz;096;Orellana de la Sierra;480;250;230
06;Badajoz;097;Orellana la Vieja;4025;2007;2018
06;Badajoz;098;Palomas;712;375;337
06;Badajoz;099;Parra (La);1436;739;697
06;Badajoz;100;Peñalsordo;1769;842;927
06;Badajoz;101;Peraleda del Zaucejo;790;409;381
06;Badajoz;102;Puebla de Alcocer;1642;825;817
06;Badajoz;103;Puebla de la Calzada;5585;2787;2798
06;Badajoz;104;Puebla de la Reina;926;479;447
06;Badajoz;107;Puebla de Obando;2138;1055;1083
06;Badajoz;108;Puebla de Sancho Pérez;3030;1507;1523
06;Badajoz;105;Puebla del Maestre;1024;509;515
06;Badajoz;106;Puebla del Prior;633;329;304
06;Badajoz;109;Quintana de la Serena;5077;2540;2537
06;Badajoz;110;Reina;238;121;117
06;Badajoz;111;Rena;681;346;335
06;Badajoz;112;Retamal de Llerena;632;328;304
06;Badajoz;113;Ribera del Fresno;3493;1674;1819
06;Badajoz;114;Risco;244;123;121
06;Badajoz;115;Roca de la Sierra (La);1638;812;826
06;Badajoz;116;Salvaleón;2524;1289;1235
06;Badajoz;117;Salvatierra de los Barros;2024;992;1032
06;Badajoz;119;San Pedro de Mérida;792;418;374
06;Badajoz;123;San Vicente de Alcántara;6101;3005;3096
06;Badajoz;118;Sancti-Spíritus;384;182;202
06;Badajoz;120;Santa Amalia;4318;2160;2158
06;Badajoz;121;Santa Marta;4104;2029;2075
06;Badajoz;122;Santos de Maimona (Los);7767;3893;3874
06;Badajoz;124;Segura de León;2350;1161;1189
06;Badajoz;125;Siruela;2565;1260;1305
06;Badajoz;126;Solana de los Barros;2822;1441;1381
06;Badajoz;127;Talarrubias;3825;1893;1932
06;Badajoz;128;Talavera la Real;5294;2673;2621
06;Badajoz;129;Táliga;733;373;360
06;Badajoz;130;Tamurejo;296;143;153
06;Badajoz;131;Torre de Miguel Sesmero;1314;645;669
06;Badajoz;132;Torremayor;1157;571;586
06;Badajoz;133;Torremejía;1973;1001;972
06;Badajoz;134;Trasierra;711;378;333
06;Badajoz;135;Trujillanos;942;492;450
06;Badajoz;136;Usagre;2206;1121;1085
06;Badajoz;137;Valdecaballeros;1563;778;785
06;Badajoz;901;Valdelacalzada;"";"";""
06;Badajoz;138;Valdetorres;1409;713;696
06;Badajoz;139;Valencia de las Torres;932;460;472
06;Badajoz;140;Valencia del Mombuey;928;454;474
06;Badajoz;141;Valencia del Ventoso;2495;1237;1258
06;Badajoz;146;Valle de la Serena;1804;872;932
06;Badajoz;147;Valle de Matamoros;570;279;291
06;Badajoz;148;Valle de Santa Ana;1340;680;660
06;Badajoz;142;Valverde de Burguillos;417;204;213
06;Badajoz;143;Valverde de Leganés;3703;1878;1825
06;Badajoz;144;Valverde de Llerena;915;449;466
06;Badajoz;145;Valverde de Mérida;1168;594;574
06;Badajoz;149;Villafranca de los Barros;12608;6199;6409
06;Badajoz;150;Villagarcía de la Torre;1095;563;532
06;Badajoz;151;Villagonzalo;1561;763;798
06;Badajoz;152;Villalba de los Barros;1744;885;859
06;Badajoz;153;Villanueva de la Serena;23519;11577;11942
06;Badajoz;154;Villanueva del Fresno;3626;1821;1805
06;Badajoz;156;Villar de Rena;1811;953;858
06;Badajoz;155;Villar del Rey;2374;1227;1147
06;Badajoz;157;Villarta de los Montes;827;396;431
06;Badajoz;158;Zafra;14695;7111;7584
06;Badajoz;159;Zahínos;3239;1630;1609
06;Badajoz;160;Zalamea de la Serena;5122;2546;2576
06;Badajoz;162;Zarza (La);3711;1862;1849
06;Badajoz;161;Zarza-Capilla;616;309;307
07;Balears (Illes);002;Alaior;6815;3427;3388
07;Balears (Illes);001;Alaró;3941;1893;2048
07;Balears (Illes);003;Alcúdia;9249;4675;4574
07;Balears (Illes);004;Algaida;3367;1693;1674
07;Balears (Illes);005;Andratx;7278;3611;3667
07;Balears (Illes);901;Ariany;842;405;437
07;Balears (Illes);006;Artà;5844;2877;2967
07;Balears (Illes);007;Banyalbufar;446;214;232
07;Balears (Illes);008;Binissalem;4820;2344;2476
07;Balears (Illes);009;Búger;921;456;465
07;Balears (Illes);010;Bunyola;4567;2294;2273
07;Balears (Illes);011;Calvià;26501;13487;13014
07;Balears (Illes);012;Campanet;2239;1099;1140
07;Balears (Illes);013;Campos;6666;3345;3321
07;Balears (Illes);014;Capdepera;6846;3443;3403
07;Balears (Illes);064;Castell (Es);5839;2912;2927
07;Balears (Illes);015;Ciutadella de Menorca;20873;10419;10454
07;Balears (Illes);016;Consell;2053;1005;1048
07;Balears (Illes);017;Costitx;805;391;414
07;Balears (Illes);018;Deyá;562;274;288
07;Balears (Illes);026;Eivissa;34280;17280;17000
07;Balears (Illes);019;Escorca;221;123;98
07;Balears (Illes);020;Esporles;3399;1674;1725
07;Balears (Illes);021;Estellencs;350;183;167
07;Balears (Illes);022;Felanitx;14176;7044;7132
07;Balears (Illes);023;Ferreries;3801;2007;1794
07;Balears (Illes);024;Formentera;5229;2655;2574
07;Balears (Illes);025;Fornalutx;587;304;283
07;Balears (Illes);027;Inca;21197;10384;10813
07;Balears (Illes);028;Lloret de Vistalegre;823;403;420
07;Balears (Illes);029;Lloseta;4539;2262;2277
07;Balears (Illes);030;Llubí;1939;952;987
07;Balears (Illes);031;Llucmajor;18860;9360;9500
07;Balears (Illes);032;Mahón;23195;11341;11854
07;Balears (Illes);033;Manacor;27834;13743;14091
07;Balears (Illes);034;Mancor de la Vall;896;429;467
07;Balears (Illes);035;Maria de la Salut;1810;882;928
07;Balears (Illes);036;Marratxí;11769;5889;5880
07;Balears (Illes);037;Mercadal (Es);2510;1253;1257
07;Balears (Illes);902;Migjorn Gran (Es);1060;553;507
07;Balears (Illes);038;Montuïri;2115;1027;1088
07;Balears (Illes);039;Muro;5926;2901;3025
07;Balears (Illes);040;Palma de Mallorca;318873;155444;163429
07;Balears (Illes);041;Petra;2626;1267;1359
07;Balears (Illes);044;Pobla (Sa);10259;5231;5028
07;Balears (Illes);042;Pollença;12826;6455;6371
07;Balears (Illes);043;Porreres;4351;2148;2203
07;Balears (Illes);045;Puigpunyent;1148;563;585
07;Balears (Illes);059;Salines (Ses);3120;1555;1565
07;Balears (Illes);046;Sant Antoni de Portmany;14299;7275;7024
07;Balears (Illes);049;Sant Joan;1652;814;838
07;Balears (Illes);050;Sant Joan de Labritja;3750;1867;1883
07;Balears (Illes);048;Sant Josep de sa Talaia;11325;5842;5483
07;Balears (Illes);051;Sant Llorenç des Cardassar;4836;2396;2440
07;Balears (Illes);052;Sant Lluís;3448;1734;1714
07;Balears (Illes);053;Santa Eugènia;968;491;477
07;Balears (Illes);054;Santa Eulalia del Río;18128;9184;8944
07;Balears (Illes);055;Santa Margalida;6307;3150;3157
07;Balears (Illes);056;Santa María del Camí;4240;2087;2153
07;Balears (Illes);057;Santanyí;7401;3710;3691
07;Balears (Illes);058;Selva;2872;1417;1455
07;Balears (Illes);047;Sencelles;1723;854;869
07;Balears (Illes);060;Sineu;2586;1291;1295
07;Balears (Illes);061;Sóller;10493;5151;5342
07;Balears (Illes);062;Son Servera;7299;3639;3660
07;Balears (Illes);063;Valldemossa;1441;685;756
07;Balears (Illes);065;Vilafranca de Bonany;2165;1058;1107
08;Barcelona;001;Abrera;6041;3115;2926
08;Barcelona;002;Aguilar de Segarra;197;101;96
08;Barcelona;014;Aiguafreda;2069;1011;1058
08;Barcelona;003;Alella;7128;3515;3613
08;Barcelona;004;Alpens;252;135;117
08;Barcelona;005;Ametlla del Vallès (L');3899;1925;1974
08;Barcelona;006;Arenys de Mar;11512;5535;5977
08;Barcelona;007;Arenys de Munt;4983;2419;2564
08;Barcelona;008;Argençola;194;101;93
08;Barcelona;009;Argentona;8180;4041;4139
08;Barcelona;010;Artés;4232;2069;2163
08;Barcelona;011;Avià;1777;905;872
08;Barcelona;012;Avinyó;2057;1012;1045
08;Barcelona;013;Avinyonet del Penedès;1224;625;599
08;Barcelona;015;Badalona;219098;108343;110755
08;Barcelona;904;Badia del Vallès;"";"";""
08;Barcelona;016;Bagà;2106;1040;1066
08;Barcelona;017;Balenyà;3277;1666;1611
08;Barcelona;018;Balsareny;3412;1679;1733
08;Barcelona;252;Barberà del Vallès;31760;16114;15646
08;Barcelona;019;Barcelona;1635067;771864;863203
08;Barcelona;020;Begues;2393;1194;1199
08;Barcelona;021;Bellprat;90;48;42
08;Barcelona;022;Berga;14457;6995;7462
08;Barcelona;023;Bigues i Riells;3302;1713;1589
08;Barcelona;024;Borredà;455;220;235
08;Barcelona;025;Bruc (El);810;410;400
08;Barcelona;026;Brull (El);191;95;96
08;Barcelona;027;Cabanyes (Les);428;236;192
08;Barcelona;029;Cabrera de Mar;3056;1548;1508
08;Barcelona;028;Cabrera d'Igualada;288;159;129
08;Barcelona;030;Cabrils;3320;1626;1694
08;Barcelona;031;Calaf;3169;1552;1617
08;Barcelona;034;Calders;584;310;274
08;Barcelona;033;Caldes de Montbui;11809;5823;5986
08;Barcelona;032;Caldes d'Estrac;1516;725;791
08;Barcelona;035;Calella;11732;5501;6231
08;Barcelona;037;Calldetenes;1517;784;733
08;Barcelona;038;Callús;1381;664;717
08;Barcelona;036;Calonge de Segarra;194;103;91
08;Barcelona;039;Campins;209;96;113
08;Barcelona;040;Canet de Mar;9077;4417;4660
08;Barcelona;041;Canovelles;13477;6816;6661
08;Barcelona;042;Cànoves i Samalús;1196;602;594
08;Barcelona;043;Canyelles;837;446;391
08;Barcelona;044;Capellades;5084;2485;2599
08;Barcelona;045;Capolat;59;34;25
08;Barcelona;046;Cardedeu;9676;4801;4875
08;Barcelona;047;Cardona;6280;3063;3217
08;Barcelona;048;Carme;675;354;321
08;Barcelona;049;Casserres;1633;782;851
08;Barcelona;057;Castell de l'Areny;48;28;20
08;Barcelona;052;Castellar de n'Hug;160;84;76
08;Barcelona;050;Castellar del Riu;63;36;27
08;Barcelona;051;Castellar del Vallès;14382;7188;7194
08;Barcelona;053;Castellbell i el Vilar;2796;1384;1412
08;Barcelona;054;Castellbisbal;5425;2789;2636
08;Barcelona;055;Castellcir;247;133;114
08;Barcelona;056;Castelldefels;34600;17278;17322
08;Barcelona;058;Castellet i la Gornal;1127;562;565
08;Barcelona;060;Castellfollit de Riubregós;230;113;117
08;Barcelona;059;Castellfollit del Boix;323;156;167
08;Barcelona;061;Castellgalí;727;362;365
08;Barcelona;062;Castellnou de Bages;234;123;111
08;Barcelona;063;Castellolí;426;212;214
08;Barcelona;064;Castellterçol;1933;920;1013
08;Barcelona;065;Castellví de la Marca;1429;717;712
08;Barcelona;066;Castellví de Rosanes;715;365;350
08;Barcelona;067;Centelles;5751;2815;2936
08;Barcelona;268;Cercs;1630;792;838
08;Barcelona;266;Cerdanyola del Vallès;58071;29168;28903
08;Barcelona;068;Cervelló;6401;3241;3160
08;Barcelona;069;Collbató;1251;641;610
08;Barcelona;070;Collsuspina;221;117;104
08;Barcelona;071;Copons;263;133;130
08;Barcelona;072;Corbera de Llobregat;6083;3080;3003
08;Barcelona;073;Cornellà de Llobregat;84542;41808;42734
08;Barcelona;074;Cubelles;3755;1911;1844
08;Barcelona;075;Dosrius;1779;904;875
08;Barcelona;076;Esparreguera;13347;6683;6664
08;Barcelona;077;Esplugues de Llobregat;48543;24060;24483
08;Barcelona;078;Espunyola (L');272;138;134
08;Barcelona;079;Estany (L');380;180;200
08;Barcelona;134;Figaró-Montmany;633;331;302
08;Barcelona;080;Fígols;34;18;16
08;Barcelona;082;Fogars de la Selva;444;221;223
08;Barcelona;081;Fogars de Montclús;268;138;130
08;Barcelona;083;Folgueroles;1186;588;598
08;Barcelona;084;Fonollosa;706;352;354
08;Barcelona;085;Font-rubí;1176;617;559
08;Barcelona;086;Franqueses del Vallès (Les);10494;5308;5186
08;Barcelona;090;Gaià;142;78;64
08;Barcelona;087;Gallifa;94;50;44
08;Barcelona;088;Garriga (La);9883;4810;5073
08;Barcelona;089;Gavà;36802;18371;18431
08;Barcelona;091;Gelida;4009;2003;2006
08;Barcelona;092;Gironella;5113;2455;2658
08;Barcelona;093;Gisclareny;36;18;18
08;Barcelona;094;Granada (La);1249;619;630
08;Barcelona;095;Granera;51;30;21
08;Barcelona;096;Granollers;52784;25945;26839
08;Barcelona;097;Gualba;655;338;317
08;Barcelona;099;Guardiola de Berguedà;1245;615;630
08;Barcelona;100;Gurb;1744;895;849
08;Barcelona;101;Hospitalet de Llobregat (L');268840;132378;136462
08;Barcelona;162;Hostalets de Pierola (Els);1007;509;498
08;Barcelona;102;Igualada;32132;15578;16554
08;Barcelona;103;Jorba;560;272;288
08;Barcelona;104;Llacuna (La);814;413;401
08;Barcelona;105;Llagosta (La);11585;5785;5800
08;Barcelona;107;Lliçà d'Amunt;6427;3324;3103
08;Barcelona;108;Lliçà de Vall;3944;2016;1928
08;Barcelona;106;Llinars del Vallès;5885;2982;2903
08;Barcelona;109;Lluçà;271;152;119
08;Barcelona;110;Malgrat de Mar;11936;5919;6017
08;Barcelona;111;Malla;255;119;136
08;Barcelona;112;Manlleu;16743;8337;8406
08;Barcelona;113;Manresa;66154;31870;34284
08;Barcelona;242;Marganell;218;90;128
08;Barcelona;114;Martorell;16962;8492;8470
08;Barcelona;115;Martorelles;5057;2518;2539
08;Barcelona;116;Masies de Roda (Les);631;317;314
08;Barcelona;117;Masies de Voltregà (Les);2541;1255;1286
08;Barcelona;118;Masnou (El);19377;9416;9961
08;Barcelona;119;Masquefa;2902;1448;1454
08;Barcelona;120;Matadepera;5218;2610;2608
08;Barcelona;121;Mataró;101873;50053;51820
08;Barcelona;122;Mediona;1074;543;531
08;Barcelona;138;Moià;3439;1678;1761
08;Barcelona;123;Molins de Rei;18754;9240;9514
08;Barcelona;124;Mollet del Vallès;42302;21190;21112
08;Barcelona;128;Monistrol de Calders;606;294;312
08;Barcelona;127;Monistrol de Montserrat;2507;1245;1262
08;Barcelona;125;Montcada i Reixac;27144;13466;13678
08;Barcelona;130;Montclar;255;109;146
08;Barcelona;131;Montesquiu;850;412;438
08;Barcelona;126;Montgat;7603;3725;3878
08;Barcelona;132;Montmajor;486;254;232
08;Barcelona;133;Montmaneu;238;133;105
08;Barcelona;135;Montmeló;7689;3826;3863
08;Barcelona;136;Montornès del Vallès;11193;5594;5599
08;Barcelona;137;Montseny;294;155;139
08;Barcelona;129;Muntanyola;173;96;77
08;Barcelona;139;Mura;296;155;141
08;Barcelona;140;Navarcles;5199;2585;2614
08;Barcelona;141;Navàs;5690;2815;2875
08;Barcelona;142;Nou de Berguedà (La);139;76;63
08;Barcelona;143;Òdena;2549;1289;1260
08;Barcelona;145;Olèrdola;1745;897;848
08;Barcelona;146;Olesa de Bonesvalls;504;271;233
08;Barcelona;147;Olesa de Montserrat;15602;7781;7821
08;Barcelona;148;Olivella;500;256;244
08;Barcelona;149;Olost;961;472;489
08;Barcelona;144;Olvan;961;452;509
08;Barcelona;150;Orís;225;119;106
08;Barcelona;151;Oristà;958;487;471
08;Barcelona;152;Orpí;146;78;68
08;Barcelona;153;Òrrius;384;197;187
08;Barcelona;154;Pacs del Penedès;492;258;234
08;Barcelona;155;Palafolls;3618;1779;1839
08;Barcelona;156;Palau-solità i Plegamans;8680;4467;4213
08;Barcelona;157;Pallejà;6764;3392;3372
08;Barcelona;905;Palma de Cervelló (La);"";"";""
08;Barcelona;158;Papiol (El);3385;1687;1698
08;Barcelona;159;Parets del Vallès;11651;5878;5773
08;Barcelona;160;Perafita;323;154;169
08;Barcelona;161;Piera;6419;3237;3182
08;Barcelona;163;Pineda de Mar;17087;8535;8552
08;Barcelona;164;Pla del Penedès (El);972;481;491
08;Barcelona;165;Pobla de Claramunt (La);1711;855;856
08;Barcelona;166;Pobla de Lillet (La);1737;843;894
08;Barcelona;167;Polinyà;3722;1912;1810
08;Barcelona;182;Pont de Vilomara i Rocafort (El);2238;1117;1121
08;Barcelona;168;Pontons;297;158;139
08;Barcelona;169;Prat de Llobregat (El);65018;32613;32405
08;Barcelona;171;Prats de Lluçanès;2684;1339;1345
08;Barcelona;170;Prats de Rei (Els);551;268;283
08;Barcelona;230;Premià de Dalt;6893;3453;3440
08;Barcelona;172;Premià de Mar;24002;12003;11999
08;Barcelona;174;Puigdàlber;305;141;164
08;Barcelona;175;Puig-reig;4721;2309;2412
08;Barcelona;176;Pujalt;175;89;86
08;Barcelona;177;Quar (La);49;23;26
08;Barcelona;178;Rajadell;298;156;142
08;Barcelona;179;Rellinars;256;125;131
08;Barcelona;180;Ripollet;27802;13895;13907
08;Barcelona;181;Roca del Vallès (La);6140;3066;3074
08;Barcelona;183;Roda de Ter;5003;2432;2571
08;Barcelona;184;Rubí;51754;26001;25753
08;Barcelona;185;Rubió;119;65;54
08;Barcelona;901;Rupit i Pruit;357;183;174
08;Barcelona;187;Sabadell;189443;92452;96991
08;Barcelona;188;Sagàs;182;96;86
08;Barcelona;190;Saldes;328;181;147
08;Barcelona;191;Sallent;7621;3690;3931
08;Barcelona;194;Sant Adrià de Besòs;34503;17148;17355
08;Barcelona;195;Sant Agustí de Lluçanès;108;55;53
08;Barcelona;196;Sant Andreu de la Barca;15927;8162;7765
08;Barcelona;197;Sant Andreu de Llavaneres;4854;2416;2438
08;Barcelona;198;Sant Antoni de Vilamajor;2375;1175;1200
08;Barcelona;199;Sant Bartomeu del Grau;1183;629;554
08;Barcelona;200;Sant Boi de Llobregat;79029;39471;39558
08;Barcelona;201;Sant Boi de Lluçanès;528;265;263
08;Barcelona;203;Sant Cebrià de Vallalta;993;546;447
08;Barcelona;202;Sant Celoni;12471;6209;6262
08;Barcelona;204;Sant Climent de Llobregat;2327;1151;1176
08;Barcelona;205;Sant Cugat del Vallès;41875;20691;21184
08;Barcelona;206;Sant Cugat Sesgarrigues;738;391;347
08;Barcelona;207;Sant Esteve de Palautordera;1225;626;599
08;Barcelona;208;Sant Esteve Sesrovires;2984;1523;1461
08;Barcelona;210;Sant Feliu de Codines;3832;1853;1979
08;Barcelona;211;Sant Feliu de Llobregat;36809;18262;18547
08;Barcelona;212;Sant Feliu Sasserra;650;331;319
08;Barcelona;209;Sant Fost de Campsentelles;5273;2701;2572
08;Barcelona;213;Sant Fruitós de Bages;4856;2442;2414
08;Barcelona;215;Sant Hipòlit de Voltregà;2983;1462;1521
08;Barcelona;193;Sant Iscle de Vallalta;550;280;270
08;Barcelona;216;Sant Jaume de Frontanyà;30;16;14
08;Barcelona;218;Sant Joan de Vilatorrada;8183;4090;4093
08;Barcelona;217;Sant Joan Despí;25692;12839;12853
08;Barcelona;903;Sant Julià de Cerdanyola;"";"";""
08;Barcelona;220;Sant Julià de Vilatorta;1951;943;1008
08;Barcelona;221;Sant Just Desvern;13168;6309;6859
08;Barcelona;222;Sant Llorenç d'Hortons;1163;585;578
08;Barcelona;223;Sant Llorenç Savall;1973;944;1029
08;Barcelona;225;Sant Martí d'Albars;128;70;58
08;Barcelona;224;Sant Martí de Centelles;638;320;318
08;Barcelona;226;Sant Martí de Tous;958;481;477
08;Barcelona;227;Sant Martí Sarroca;2450;1224;1226
08;Barcelona;228;Sant Martí Sesgueioles;356;176;180
08;Barcelona;229;Sant Mateu de Bages;530;270;260
08;Barcelona;231;Sant Pere de Ribes;15373;7699;7674
08;Barcelona;232;Sant Pere de Riudebitlles;2102;1034;1068
08;Barcelona;233;Sant Pere de Torelló;2022;972;1050
08;Barcelona;234;Sant Pere de Vilamajor;1339;676;663
08;Barcelona;189;Sant Pere Sallavinera;180;92;88
08;Barcelona;235;Sant Pol de Mar;2592;1281;1311
08;Barcelona;236;Sant Quintí de Mediona;1533;763;770
08;Barcelona;237;Sant Quirze de Besora;2002;968;1034
08;Barcelona;238;Sant Quirze del Vallès;9607;4757;4850
08;Barcelona;239;Sant Quirze Safaja;255;125;130
08;Barcelona;240;Sant Sadurní d'Anoia;9424;4723;4701
08;Barcelona;241;Sant Sadurní d'Osormort;73;36;37
08;Barcelona;098;Sant Salvador de Guardiola;1428;732;696
08;Barcelona;262;Sant Vicenç de Castellet;7471;3587;3884
08;Barcelona;264;Sant Vicenç de Montalt;1805;889;916
08;Barcelona;265;Sant Vicenç de Torelló;1720;822;898
08;Barcelona;263;Sant Vicenç dels Horts;21787;10964;10823
08;Barcelona;243;Santa Cecilia de Voltregà;189;106;83
08;Barcelona;244;Santa Coloma de Cervelló;3150;1542;1608
08;Barcelona;245;Santa Coloma de Gramenet;132701;66352;66349
08;Barcelona;246;Santa Eugènia de Berga;2020;1025;995
08;Barcelona;247;Santa Eulàlia de Riuprimer;844;432;412
08;Barcelona;248;Santa Eulàlia de Ronçana;3331;1680;1651
08;Barcelona;249;Santa Fe del Penedès;222;104;118
08;Barcelona;250;Santa Margarida de Montbui;9485;4754;4731
08;Barcelona;251;Santa Margarida i els Monjos;4086;2098;1988
08;Barcelona;253;Santa Maria de Besora;201;102;99
08;Barcelona;254;Santa Maria de Corcó;1993;1000;993
08;Barcelona;256;Santa Maria de Martorelles;561;274;287
08;Barcelona;255;Santa Maria de Merlès;197;99;98
08;Barcelona;257;Santa Maria de Miralles;110;57;53
08;Barcelona;259;Santa Maria de Palautordera;5182;2634;2548
08;Barcelona;258;Santa Maria d'Oló;1012;513;499
08;Barcelona;260;Santa Perpètua de Mogoda;17229;8737;8492
08;Barcelona;261;Santa Susanna;1207;600;607
08;Barcelona;192;Santpedor;4749;2324;2425
08;Barcelona;267;Sentmenat;4874;2432;2442
08;Barcelona;269;Seva;1832;930;902
08;Barcelona;270;Sitges;14559;7106;7453
08;Barcelona;271;Sobremunt;98;44;54
08;Barcelona;272;Sora;206;108;98
08;Barcelona;273;Subirats;2145;1071;1074
08;Barcelona;274;Súria;6483;3178;3305
08;Barcelona;276;Tagamanent;163;90;73
08;Barcelona;277;Talamanca;92;45;47
08;Barcelona;278;Taradell;4358;2155;2203
08;Barcelona;275;Tavèrnoles;206;97;109
08;Barcelona;280;Tavertet;131;69;62
08;Barcelona;281;Teià;4037;2035;2002
08;Barcelona;279;Terrassa;159964;78114;81850
08;Barcelona;282;Tiana;4905;2468;2437
08;Barcelona;283;Tona;5643;2803;2840
08;Barcelona;284;Tordera;8577;4281;4296
08;Barcelona;285;Torelló;11665;5704;5961
08;Barcelona;286;Torre de Claramunt (La);1686;865;821
08;Barcelona;287;Torrelavit;1219;621;598
08;Barcelona;288;Torrelles de Foix;1464;774;690
08;Barcelona;289;Torrelles de Llobregat;2746;1410;1336
08;Barcelona;290;Ullastrell;968;494;474
08;Barcelona;291;Vacarisses;1176;618;558
08;Barcelona;292;Vallbona d'Anoia;1026;510;516
08;Barcelona;293;Vallcebre;291;157;134
08;Barcelona;294;Vallgorguina;796;397;399
08;Barcelona;295;Vallirana;7006;3512;3494
08;Barcelona;296;Vallromanes;779;391;388
08;Barcelona;297;Veciana;168;87;81
08;Barcelona;298;Vic;29816;14368;15448
08;Barcelona;299;Vilada;531;272;259
08;Barcelona;301;Viladecans;50495;25496;24999
08;Barcelona;300;Viladecavalls;3849;1903;1946
08;Barcelona;305;Vilafranca del Penedès;28017;13690;14327
08;Barcelona;306;Vilalba Sasserra;310;164;146
08;Barcelona;303;Vilanova de Sau;299;146;153
08;Barcelona;302;Vilanova del Camí;9625;4849;4776
08;Barcelona;902;Vilanova del Vallès;1630;814;816
08;Barcelona;307;Vilanova i la Geltrú;47339;23207;24132
08;Barcelona;214;Vilassar de Dalt;6982;3418;3564
08;Barcelona;219;Vilassar de Mar;13330;6536;6794
08;Barcelona;304;Vilobí del Penedès;821;417;404
08;Barcelona;308;Viver i Serrateix;211;116;95
09;Burgos;001;Abajas;49;22;27
09;Burgos;003;Adrada de Haza;317;167;150
09;Burgos;006;Aguas Cándidas;108;60;48
09;Burgos;007;Aguilar de Bureba;110;58;52
09;Burgos;009;Albillos;156;82;74
09;Burgos;010;Alcocero de Mola;64;38;26
09;Burgos;011;Alfoz de Bricia;144;71;73
09;Burgos;907;Alfoz de Quintanadueñas;481;255;226
09;Burgos;012;Alfoz de Santa Gadea;168;90;78
09;Burgos;013;Altable;75;46;29
09;Burgos;014;Altos (Los);290;167;123
09;Burgos;016;Ameyugo;63;32;31
09;Burgos;017;Anguix;182;92;90
09;Burgos;018;Aranda de Duero;30283;15141;15142
09;Burgos;019;Arandilla;221;132;89
09;Burgos;020;Arauzo de Miel;435;241;194
09;Burgos;021;Arauzo de Salce;78;47;31
09;Burgos;022;Arauzo de Torre;118;65;53
09;Burgos;023;Arcos;239;143;96
09;Burgos;024;Arenillas de Riopisuerga;237;126;111
09;Burgos;025;Arija;292;136;156
09;Burgos;026;Arlanzón;417;221;196
09;Burgos;027;Arraya de Oca;56;29;27
09;Burgos;029;Atapuerca;146;73;73
09;Burgos;030;Ausines (Los);124;70;54
09;Burgos;032;Avellanosa de Muñó;202;106;96
09;Burgos;033;Bahabón de Esgueva;173;99;74
09;Burgos;034;Balbases (Los);390;205;185
09;Burgos;035;Baños de Valdearados;547;303;244
09;Burgos;036;Bañuelos de Bureba;60;40;20
09;Burgos;037;Barbadillo de Herreros;158;84;74
09;Burgos;038;Barbadillo del Mercado;200;99;101
09;Burgos;039;Barbadillo del Pez;114;63;51
09;Burgos;041;Barrio de Muñó;35;20;15
09;Burgos;043;Barrios de Bureba (Los);328;174;154
09;Burgos;044;Barrios de Colina;82;44;38
09;Burgos;045;Basconcillos del Tozo;428;224;204
09;Burgos;046;Bascuñana;83;44;39
09;Burgos;047;Belbimbre;84;43;41
09;Burgos;048;Belorado;2216;1123;1093
09;Burgos;050;Berberana;98;49;49
09;Burgos;051;Berlangas de Roa;309;161;148
09;Burgos;052;Berzosa de Bureba;53;30;23
09;Burgos;054;Bozoó;106;54;52
09;Burgos;055;Brazacorta;99;54;45
09;Burgos;056;Briviesca;5873;2911;2962
09;Burgos;057;Bugedo;119;88;31
09;Burgos;058;Buniel;137;79;58
09;Burgos;059;Burgos;164162;79766;84396
09;Burgos;060;Busto de Bureba;313;165;148
09;Burgos;061;Cabañes de Esgueva;311;163;148
09;Burgos;062;Cabezón de la Sierra;94;43;51
09;Burgos;063;Cabia;220;117;103
09;Burgos;064;Caleruega;448;224;224
09;Burgos;065;Campillo de Aranda;190;105;85
09;Burgos;066;Campolara;110;61;49
09;Burgos;067;Canicosa de la Sierra;668;336;332
09;Burgos;068;Cantabrana;66;37;29
09;Burgos;070;Carazo;51;30;21
09;Burgos;071;Carcedo de Bureba;41;22;19
09;Burgos;072;Carcedo de Burgos;124;73;51
09;Burgos;073;Cardeñadijo;341;183;158
09;Burgos;074;Cardeñajimeno;328;182;146
09;Burgos;075;Cardeñuela Riopico;74;36;38
09;Burgos;076;Carrias;56;37;19
09;Burgos;077;Cascajares de Bureba;65;37;28
09;Burgos;078;Cascajares de la Sierra;17;10;7
09;Burgos;079;Castellanos de Castro;73;41;32
09;Burgos;083;Castil de Peones;48;24;24
09;Burgos;082;Castildelgado;92;45;47
09;Burgos;084;Castrillo de la Reina;342;203;139
09;Burgos;085;Castrillo de la Vega;638;333;305
09;Burgos;088;Castrillo de Riopisuerga;101;59;42
09;Burgos;086;Castrillo del Val;215;128;87
09;Burgos;090;Castrillo Matajudíos;81;43;38
09;Burgos;091;Castrojeriz;1129;571;558
09;Burgos;093;Cayuela;116;69;47
09;Burgos;094;Cebrecos;78;45;33
09;Burgos;095;Celada del Camino;99;43;56
09;Burgos;098;Cerezo de Río Tirón;854;446;408
09;Burgos;100;Cerratón de Juarros;69;36;33
09;Burgos;101;Ciadoncha;146;85;61
09;Burgos;102;Cillaperlata;81;43;38
09;Burgos;103;Cilleruelo de Abajo;390;211;179
09;Burgos;104;Cilleruelo de Arriba;94;50;44
09;Burgos;105;Ciruelos de Cervera;183;94;89
09;Burgos;108;Cogollos;205;116;89
09;Burgos;109;Condado de Treviño;936;509;427
09;Burgos;110;Contreras;89;54;35
09;Burgos;112;Coruña del Conde;176;94;82
09;Burgos;113;Covarrubias;661;343;318
09;Burgos;114;Cubillo del Campo;76;40;36
09;Burgos;115;Cubo de Bureba;149;74;75
09;Burgos;117;Cueva de Roa (La);146;82;64
09;Burgos;119;Cuevas de San Clemente;68;32;36
09;Burgos;120;Encío;68;36;32
09;Burgos;122;Espinosa de Cervera;121;72;49
09;Burgos;124;Espinosa de los Monteros;2465;1274;1191
09;Burgos;123;Espinosa del Camino;58;29;29
09;Burgos;125;Estépar;883;472;411
09;Burgos;127;Fontioso;103;54;49
09;Burgos;128;Frandovínez;99;54;45
09;Burgos;129;Fresneda de la Sierra Tirón;112;56;56
09;Burgos;130;Fresneña;143;77;66
09;Burgos;131;Fresnillo de las Dueñas;314;162;152
09;Burgos;132;Fresno de Río Tirón;276;155;121
09;Burgos;133;Fresno de Rodilla;34;19;15
09;Burgos;134;Frías;334;173;161
09;Burgos;135;Fuentebureba;100;48;52
09;Burgos;136;Fuentecén;324;175;149
09;Burgos;137;Fuentelcésped;232;116;116
09;Burgos;138;Fuentelisendo;139;71;68
09;Burgos;139;Fuentemolinos;136;73;63
09;Burgos;140;Fuentenebro;216;116;100
09;Burgos;141;Fuentespina;567;291;276
09;Burgos;143;Galbarros;30;21;9
09;Burgos;144;Gallega (La);94;56;38
09;Burgos;148;Grijalba;155;74;81
09;Burgos;149;Grisaleña;64;36;28
09;Burgos;151;Gumiel de Izán;705;377;328
09;Burgos;152;Gumiel de Mercado;458;253;205
09;Burgos;154;Hacinas;222;119;103
09;Burgos;155;Haza;51;25;26
09;Burgos;159;Hontanas;95;55;40
09;Burgos;160;Hontangas;163;89;74
09;Burgos;162;Hontoria de la Cantera;104;49;55
09;Burgos;164;Hontoria de Valdearados;265;156;109
09;Burgos;163;Hontoria del Pinar;990;528;462
09;Burgos;166;Hormazas (Las);165;82;83
09;Burgos;167;Hornillos del Camino;87;46;41
09;Burgos;168;Horra (La);513;264;249
09;Burgos;169;Hortigüela;116;63;53
09;Burgos;170;Hoyales de Roa;348;168;180
09;Burgos;172;Huérmeces;154;89;65
09;Burgos;173;Huerta de Arriba;214;108;106
09;Burgos;174;Huerta de Rey;1244;646;598
09;Burgos;175;Humada;288;165;123
09;Burgos;176;Hurones;60;38;22
09;Burgos;177;Ibeas de Juarros;859;464;395
09;Burgos;178;Ibrillos;110;63;47
09;Burgos;179;Iglesiarrubia;74;39;35
09;Burgos;180;Iglesias;214;110;104
09;Burgos;181;Isar;445;208;237
09;Burgos;182;Itero del Castillo;142;68;74
09;Burgos;183;Jaramillo de la Fuente;35;19;16
09;Burgos;184;Jaramillo Quemado;16;10;6
09;Burgos;189;Junta de Traslaloma;251;127;124
09;Burgos;190;Junta de Villalba de Losa;103;57;46
09;Burgos;191;Jurisdicción de Lara;77;45;32
09;Burgos;192;Jurisdicción de San Zadornil;83;43;40
09;Burgos;194;Lerma;2590;1307;1283
09;Burgos;195;Llano de Bureba;67;42;25
09;Burgos;196;Madrigal del Monte;182;89;93
09;Burgos;197;Madrigalejo del Monte;184;101;83
09;Burgos;198;Mahamud;177;89;88
09;Burgos;199;Mambrilla de Castrejón;176;94;82
09;Burgos;200;Mambrillas de Lara;77;39;38
09;Burgos;201;Mamolar;94;50;44
09;Burgos;202;Manciles;49;27;22
09;Burgos;206;Mazuela;93;48;45
09;Burgos;208;Mecerreyes;304;147;157
09;Burgos;209;Medina de Pomar;5560;2783;2777
09;Burgos;211;Melgar de Fernamental;2233;1139;1094
09;Burgos;213;Merindad de Cuesta-Urria;594;346;248
09;Burgos;214;Merindad de Montija;1058;561;497
09;Burgos;431;Villafranca Montes de Oca;217;115;102
09;Burgos;432;Villafruela;341;185;156
09;Burgos;433;Villagalijo;57;29;28
09;Burgos;434;Villagonzalo Pedernales;494;243;251
09;Burgos;437;Villahoz;446;217;229
09;Burgos;438;Villalba de Duero;545;302;243
09;Burgos;439;Villalbilla de Burgos;599;325;274
09;Burgos;440;Villalbilla de Gumiel;145;81;64
09;Burgos;441;Villaldemiro;94;43;51
09;Burgos;442;Villalmanzo;453;241;212
09;Burgos;443;Villamayor de los Montes;298;146;152
09;Burgos;444;Villamayor de Treviño;124;71;53
09;Burgos;445;Villambistia;86;48;38
09;Burgos;446;Villamedianilla;27;14;13
09;Burgos;447;Villamiel de la Sierra;34;22;12
09;Burgos;448;Villangómez;384;198;186
09;Burgos;449;Villanueva de Argaño;118;63;55
09;Burgos;450;Villanueva de Carazo;26;15;11
09;Burgos;451;Villanueva de Gumiel;334;177;157
09;Burgos;454;Villanueva de Teba;79;44;35
09;Burgos;455;Villaquirán de la Puebla;80;45;35
09;Burgos;456;Villaquirán de los Infantes;221;114;107
09;Burgos;903;Villarcayo de Merindad de Castilla la Vieja;4181;2085;2096
09;Burgos;458;Villariezo;148;80;68
09;Burgos;460;Villasandino;307;155;152
09;Burgos;463;Villasur de Herreros;352;183;169
09;Burgos;464;Villatuelda;84;45;39
09;Burgos;466;Villaverde del Monte;204;111;93
09;Burgos;467;Villaverde-Mogina;149;85;64
09;Burgos;471;Villayerno Morquillas;134;60;74
09;Burgos;472;Villazopeque;97;53;44
09;Burgos;473;Villegas;150;78;72
09;Burgos;476;Villoruebo;45;31;14
09;Burgos;424;Viloria de Rioja;83;45;38
09;Burgos;425;Vilviestre del Pinar;843;431;412
09;Burgos;478;Vizcaínos;48;26;22
09;Burgos;480;Zael;164;80;84
09;Burgos;482;Zarzosa de Río Pisuerga;87;44;43
09;Burgos;483;Zazuar;305;156;149
09;Burgos;485;Zuñeda;100;49;51
09;Burgos;906;Merindad de Río Ubierna;1169;617;552
09;Burgos;215;Merindad de Sotoscueva;710;371;339
09;Burgos;216;Merindad de Valdeporres;579;294;285
09;Burgos;217;Merindad de Valdivielso;631;323;308
09;Burgos;218;Milagros;470;247;223
09;Burgos;219;Miranda de Ebro;36827;18323;18504
09;Burgos;220;Miraveche;124;69;55
09;Burgos;221;Modúbar de la Emparedada;220;117;103
09;Burgos;223;Monasterio de la Sierra;36;20;16
09;Burgos;224;Monasterio de Rodilla;215;112;103
09;Burgos;225;Moncalvillo;149;85;64
09;Burgos;226;Monterrubio de la Demanda;101;55;46
09;Burgos;227;Montorio;170;82;88
09;Burgos;228;Moradillo de Roa;243;130;113
09;Burgos;229;Nava de Roa;323;164;159
09;Burgos;230;Navas de Bureba;50;25;25
09;Burgos;231;Nebreda;118;74;44
09;Burgos;232;Neila;248;120;128
09;Burgos;235;Olmedillo de Roa;266;134;132
09;Burgos;236;Olmillos de Muñó;50;27;23
09;Burgos;238;Oña;1925;962;963
09;Burgos;239;Oquillas;73;35;38
09;Burgos;241;Orbaneja Riopico;170;93;77
09;Burgos;242;Padilla de Abajo;129;70;59
09;Burgos;243;Padilla de Arriba;145;74;71
09;Burgos;244;Padrones de Bureba;94;50;44
09;Burgos;246;Palacios de la Sierra;1002;511;491
09;Burgos;247;Palacios de Riopisuerga;46;23;23
09;Burgos;248;Palazuelos de la Sierra;71;35;36
09;Burgos;249;Palazuelos de Muñó;85;46;39
09;Burgos;250;Pampliega;454;233;221
09;Burgos;251;Pancorbo;567;291;276
09;Burgos;253;Pardilla;115;54;61
09;Burgos;255;Partido de la Sierra en Tobalina;79;44;35
09;Burgos;256;Pedrosa de Duero;636;338;298
09;Burgos;259;Pedrosa de Río Úrbel;316;181;135
09;Burgos;257;Pedrosa del Páramo;123;69;54
09;Burgos;258;Pedrosa del Príncipe;333;169;164
09;Burgos;261;Peñaranda de Duero;667;352;315
09;Burgos;262;Peral de Arlanza;261;138;123
09;Burgos;265;Piérnigas;41;27;14
09;Burgos;266;Pineda de la Sierra;118;65;53
09;Burgos;267;Pineda Trasmonte;213;107;106
09;Burgos;268;Pinilla de los Barruecos;139;73;66
09;Burgos;269;Pinilla de los Moros;54;35;19
09;Burgos;270;Pinilla Trasmonte;275;147;128
09;Burgos;272;Poza de la Sal;476;234;242
09;Burgos;273;Prádanos de Bureba;86;50;36
09;Burgos;274;Pradoluengo;1714;828;886
09;Burgos;275;Presencio;340;180;160
09;Burgos;276;Puebla de Arganzón (La);228;126;102
09;Burgos;277;Puentedura;143;75;68
09;Burgos;279;Quemada;255;141;114
09;Burgos;281;Quintana del Pidio;212;116;96
09;Burgos;280;Quintanabureba;51;31;20
09;Burgos;283;Quintanaélez;124;64;60
09;Burgos;287;Quintanaortuño;118;60;58
09;Burgos;288;Quintanapalla;130;69;61
09;Burgos;289;Quintanar de la Sierra;2483;1275;1208
09;Burgos;292;Quintanavides;82;35;47
09;Burgos;294;Quintanilla de la Mata;178;102;76
09;Burgos;901;Quintanilla del Agua y Tordueles;660;341;319
09;Burgos;295;Quintanilla del Coco;129;67;62
09;Burgos;298;Quintanilla San García;141;72;69
09;Burgos;301;Quintanilla Vivar;339;167;172
09;Burgos;297;Quintanillas (Las);344;183;161
09;Burgos;302;Rabanera del Pinar;170;88;82
09;Burgos;303;Rábanos;61;32;29
09;Burgos;304;Rabé de las Calzadas;156;84;72
09;Burgos;306;Rebolledo de la Torre;193;95;98
09;Burgos;307;Redecilla del Camino;148;88;60
09;Burgos;308;Redecilla del Campo;100;48;52
09;Burgos;309;Regumiel de la Sierra;561;284;277
09;Burgos;310;Reinoso;30;20;10
09;Burgos;311;Retuerta;79;44;35
09;Burgos;314;Revilla del Campo;133;69;64
09;Burgos;316;Revilla Vallejera;186;102;84
09;Burgos;312;Revilla y Ahedo (La);133;68;65
09;Burgos;315;Revillarruz;149;78;71
09;Burgos;317;Rezmondo;28;15;13
09;Burgos;318;Riocavado de la Sierra;79;45;34
09;Burgos;321;Roa;2382;1204;1178
09;Burgos;323;Rojas;112;61;51
09;Burgos;325;Royuela de Río Franco;397;216;181
09;Burgos;326;Rubena;161;78;83
09;Burgos;327;Rublacedo de Abajo;41;20;21
09;Burgos;328;Rucandio;144;69;75
09;Burgos;329;Salas de Bureba;183;100;83
09;Burgos;330;Salas de los Infantes;2097;1051;1046
09;Burgos;332;Saldaña de Burgos;102;54;48
09;Burgos;334;Salinillas de Bureba;67;39;28
09;Burgos;335;San Adrián de Juarros;40;18;22
09;Burgos;337;San Juan del Monte;195;102;93
09;Burgos;338;San Mamés de Burgos;146;82;64
09;Burgos;339;San Martín de Rubiales;334;178;156
09;Burgos;340;San Millán de Lara;99;57;42
09;Burgos;360;San Vicente del Valle;30;19;11
09;Burgos;343;Santa Cecilia;143;76;67
09;Burgos;345;Santa Cruz de la Salceda;189;101;88
09;Burgos;346;Santa Cruz del Valle Urbión;138;80;58
09;Burgos;347;Santa Gadea del Cid;213;109;104
09;Burgos;348;Santa Inés;215;114;101
09;Burgos;350;Santa María del Campo;772;399;373
09;Burgos;351;Santa María del Invierno;62;36;26
09;Burgos;352;Santa María del Mercadillo;210;117;93
09;Burgos;353;Santa María Rivarredonda;139;76;63
09;Burgos;354;Santa Olalla de Bureba;46;19;27
09;Burgos;355;Santibáñez de Esgueva;192;96;96
09;Burgos;356;Santibáñez del Val;71;39;32
09;Burgos;358;Santo Domingo de Silos;337;214;123
09;Burgos;361;Sargentes de la Lora;197;100;97
09;Burgos;362;Sarracín;147;82;65
09;Burgos;363;Sasamón;1532;815;717
09;Burgos;365;Sequera de Haza (La);75;43;32
09;Burgos;366;Solarana;128;68;60
09;Burgos;368;Sordillos;43;25;18
09;Burgos;369;Sotillo de la Ribera;614;337;277
09;Burgos;372;Sotragero;130;75;55
09;Burgos;373;Sotresgudo;849;456;393
09;Burgos;374;Susinos del Páramo;61;34;27
09;Burgos;375;Tamarón;53;28;25
09;Burgos;377;Tardajos;754;425;329
09;Burgos;378;Tejada;56;32;24
09;Burgos;380;Terradillos de Esgueva;141;72;69
09;Burgos;381;Tinieblas de la Sierra;33;18;15
09;Burgos;382;Tobar;56;28;28
09;Burgos;384;Tordómar;411;229;182
09;Burgos;386;Torrecilla del Monte;85;46;39
09;Burgos;387;Torregalindo;165;89;76
09;Burgos;388;Torrelara;23;11;12
09;Burgos;389;Torrepadre;197;107;90
09;Burgos;390;Torresandino;820;434;386
09;Burgos;391;Tórtoles de Esgueva;596;322;274
09;Burgos;392;Tosantos;81;39;42
09;Burgos;394;Trespaderne;1213;636;577
09;Burgos;395;Tubilla del Agua;174;101;73
09;Burgos;396;Tubilla del Lago;224;117;107
09;Burgos;398;Úrbel del Castillo;112;59;53
09;Burgos;400;Vadocondes;479;243;236
09;Burgos;403;Valdeande;185;106;79
09;Burgos;405;Valdezate;238;125;113
09;Burgos;406;Valdorros;106;59;47
09;Burgos;408;Vallarta de Bureba;88;49;39
09;Burgos;904;Valle de las Navas;687;370;317
09;Burgos;908;Valle de Losa;731;411;320
09;Burgos;409;Valle de Manzanedo;116;66;50
09;Burgos;410;Valle de Mena;4672;2377;2295
09;Burgos;411;Valle de Oca;218;110;108
09;Burgos;902;Valle de Santibáñez;710;369;341
09;Burgos;905;Valle de Sedano;524;283;241
09;Burgos;412;Valle de Tobalina;1098;591;507
09;Burgos;413;Valle de Valdebezana;866;471;395
09;Burgos;414;Valle de Valdelaguna;292;154;138
09;Burgos;415;Valle de Valdelucio;417;224;193
09;Burgos;416;Valle de Zamanzas;47;25;22
09;Burgos;417;Vallejera;58;31;27
09;Burgos;418;Valles de Palenzuela;111;57;54
09;Burgos;419;Valluércanes;137;81;56
09;Burgos;407;Valmala;35;19;16
09;Burgos;422;Vid de Bureba (La);61;28;33
09;Burgos;421;Vid y Barrios (La);389;224;165
09;Burgos;423;Vileña;51;31;20
09;Burgos;427;Villadiego;2326;1247;1079
09;Burgos;428;Villaescusa de Roa;190;102;88
09;Burgos;429;Villaescusa la Sombría;70;42;28
09;Burgos;430;Villaespasa;40;23;17
10;Cáceres;001;Abadía;306;174;132
10;Cáceres;002;Abertura;531;278;253
10;Cáceres;003;Acebo;870;440;430
10;Cáceres;004;Acehúche;1016;513;503
10;Cáceres;005;Aceituna;758;379;379
10;Cáceres;006;Ahigal;1795;934;861
10;Cáceres;007;Albalá del Caudillo;941;465;476
10;Cáceres;008;Alcántara;2012;1015;997
10;Cáceres;009;Alcollarín;379;178;201
10;Cáceres;010;Alcuéscar;3360;1755;1605
10;Cáceres;012;Aldea del Cano;787;391;396
10;Cáceres;013;Aldea del Obispo (La);423;220;203
10;Cáceres;011;Aldeacentenera;1035;504;531
10;Cáceres;014;Aldeanueva de la Vera;2662;1331;1331
10;Cáceres;015;Aldeanueva del Camino;973;460;513
10;Cáceres;016;Aldehuela de Jerte;394;226;168
10;Cáceres;017;Alía;1650;822;828
10;Cáceres;018;Aliseda;2482;1247;1235
10;Cáceres;019;Almaraz;1397;704;693
10;Cáceres;020;Almoharín;2131;1048;1083
10;Cáceres;021;Arroyo de la Luz;6674;3335;3339
10;Cáceres;023;Arroyomolinos;1161;598;563
10;Cáceres;022;Arroyomolinos de la Vera;662;329;333
10;Cáceres;024;Baños de Montemayor;728;339;389
10;Cáceres;025;Barrado;579;288;291
10;Cáceres;026;Belvís de Monroy;563;289;274
10;Cáceres;027;Benquerencia;117;66;51
10;Cáceres;028;Berrocalejo;154;72;82
10;Cáceres;029;Berzocana;722;361;361
10;Cáceres;030;Bohonal de Ibor;656;330;326
10;Cáceres;031;Botija;203;93;110
10;Cáceres;032;Brozas;2502;1240;1262
10;Cáceres;033;Cabañas del Castillo;679;347;332
10;Cáceres;034;Cabezabellosa;635;314;321
10;Cáceres;035;Cabezuela del Valle;2392;1217;1175
10;Cáceres;036;Cabrero;477;247;230
10;Cáceres;037;Cáceres;78261;37551;40710
10;Cáceres;038;Cachorrilla;110;53;57
10;Cáceres;039;Cadalso;610;309;301
10;Cáceres;040;Calzadilla;614;296;318
10;Cáceres;041;Caminomorisco;1334;705;629
10;Cáceres;042;Campillo de Deleitosa;167;82;85
10;Cáceres;043;Campo Lugar;1283;640;643
10;Cáceres;044;Cañamero;2053;1047;1006
10;Cáceres;045;Cañaveral;1706;819;887
10;Cáceres;046;Carbajo;306;162;144
10;Cáceres;047;Carcaboso;1294;678;616
10;Cáceres;048;Carrascalejo;488;236;252
10;Cáceres;049;Casar de Cáceres;4167;2114;2053
10;Cáceres;050;Casar de Palomero;1476;756;720
10;Cáceres;051;Casares de las Hurdes;978;500;478
10;Cáceres;052;Casas de Don Antonio;244;118;126
10;Cáceres;053;Casas de Don Gómez;404;206;198
10;Cáceres;056;Casas de Millán;870;449;421
10;Cáceres;057;Casas de Miravete;153;81;72
10;Cáceres;054;Casas del Castañar;741;360;381
10;Cáceres;055;Casas del Monte;939;490;449
10;Cáceres;058;Casatejada;1424;710;714
10;Cáceres;059;Casillas de Coria;640;305;335
10;Cáceres;060;Castañar de Ibor;1424;717;707
10;Cáceres;061;Ceclavín;2422;1228;1194
10;Cáceres;062;Cedillo;599;303;296
10;Cáceres;063;Cerezo;255;122;133
10;Cáceres;064;Cilleros;2372;1183;1189
10;Cáceres;065;Collado;370;190;180
10;Cáceres;066;Conquista de la Sierra;201;104;97
10;Cáceres;067;Coria;11687;5828;5859
10;Cáceres;068;Cuacos de Yuste;971;500;471
10;Cáceres;069;Cumbre (La);1268;629;639
10;Cáceres;070;Deleitosa;1062;521;541
10;Cáceres;071;Descargamaría;252;126;126
10;Cáceres;072;Eljas;1372;699;673
10;Cáceres;073;Escurial;1006;504;502
10;Cáceres;075;Fresnedoso de Ibor;502;262;240
10;Cáceres;076;Galisteo;2073;1039;1034
10;Cáceres;077;Garciaz;1098;554;544
10;Cáceres;078;Garganta (La);658;342;316
10;Cáceres;079;Garganta la Olla;1264;652;612
10;Cáceres;080;Gargantilla;564;289;275
10;Cáceres;081;Gargüera;273;129;144
10;Cáceres;082;Garrovillas de Alconétar;2647;1270;1377
10;Cáceres;083;Garvín;127;69;58
10;Cáceres;084;Gata;2088;1045;1043
10;Cáceres;085;Gordo (El);344;173;171
10;Cáceres;086;Granja (La);467;249;218
10;Cáceres;087;Guadalupe;2494;1234;1260
10;Cáceres;088;Guijo de Coria;333;177;156
10;Cáceres;089;Guijo de Galisteo;1782;917;865
10;Cáceres;090;Guijo de Granadilla;832;407;425
10;Cáceres;091;Guijo de Santa Bárbara;559;281;278
10;Cáceres;092;Herguijuela;454;221;233
10;Cáceres;093;Hernán-Pérez;506;267;239
10;Cáceres;094;Herrera de Alcántara;384;194;190
10;Cáceres;095;Herreruela;523;263;260
10;Cáceres;096;Hervás;3918;1885;2033
10;Cáceres;097;Higuera;120;65;55
10;Cáceres;098;Hinojal;468;228;240
10;Cáceres;099;Holguera;865;433;432
10;Cáceres;100;Hoyos;994;488;506
10;Cáceres;101;Huélaga;188;93;95
10;Cáceres;102;Ibahernando;853;424;429
10;Cáceres;103;Jaraicejo;761;380;381
10;Cáceres;104;Jaraíz de la Vera;7527;3796;3731
10;Cáceres;105;Jarandilla de la Vera;3135;1550;1585
10;Cáceres;106;Jarilla;202;104;98
10;Cáceres;107;Jerte;1389;723;666
10;Cáceres;108;Ladrillar;443;231;212
10;Cáceres;109;Logrosán;2772;1355;1417
10;Cáceres;110;Losar de la Vera;3118;1557;1561
10;Cáceres;111;Madrigal de la Vera;1824;934;890
10;Cáceres;112;Madrigalejo;2472;1228;1244
10;Cáceres;113;Madroñera;3266;1620;1646
10;Cáceres;114;Majadas;1327;755;572
10;Cáceres;115;Malpartida de Cáceres;4036;2017;2019
10;Cáceres;116;Malpartida de Plasencia;4213;2063;2150
10;Cáceres;117;Marchagaz;433;206;227
10;Cáceres;118;Mata de Alcántara;392;196;196
10;Cáceres;119;Membrío;983;466;517
10;Cáceres;120;Mesas de Ibor;226;119;107
10;Cáceres;121;Miajadas;10022;5028;4994
10;Cáceres;122;Millanes;267;146;121
10;Cáceres;123;Mirabel;911;450;461
10;Cáceres;124;Mohedas de Granadilla;1191;612;579
10;Cáceres;125;Monroy;1361;661;700
10;Cáceres;126;Montánchez;2449;1214;1235
10;Cáceres;127;Montehermoso;5333;2687;2646
10;Cáceres;128;Moraleja;8113;4039;4074
10;Cáceres;129;Morcillo;579;271;308
10;Cáceres;130;Navaconcejo;2195;1115;1080
10;Cáceres;131;Navalmoral de la Mata;15894;7943;7951
10;Cáceres;132;Navalvillar de Ibor;621;311;310
10;Cáceres;133;Navas del Madroño;1710;855;855
10;Cáceres;134;Navezuelas;787;418;369
10;Cáceres;135;Nuñomoral;2158;1131;1027
10;Cáceres;136;Oliva de Plasencia;367;175;192
10;Cáceres;137;Palomero;614;322;292
10;Cáceres;138;Pasarón de la Vera;720;362;358
10;Cáceres;139;Pedroso de Acim;195;94;101
10;Cáceres;140;Peraleda de la Mata;1511;757;754
10;Cáceres;141;Peraleda de San Román;418;202;216
10;Cáceres;142;Perales del Puerto;1043;520;523
10;Cáceres;143;Pescueza;271;133;138
10;Cáceres;144;Pesga (La);1380;718;662
10;Cáceres;145;Piedras Albas;260;119;141
10;Cáceres;146;Pinofranqueado;1843;976;867
10;Cáceres;147;Piornal;1628;798;830
10;Cáceres;148;Plasencia;36994;18150;18844
10;Cáceres;149;Plasenzuela;522;265;257
10;Cáceres;150;Portaje;462;227;235
10;Cáceres;151;Portezuelo;357;163;194
10;Cáceres;152;Pozuelo de Zarzón;687;337;350
10;Cáceres;153;Puerto de Santa Cruz;449;220;229
10;Cáceres;154;Rebollar;276;147;129
10;Cáceres;155;Riolobos;1802;949;853
10;Cáceres;156;Robledillo de Gata;211;105;106
10;Cáceres;157;Robledillo de la Vera;459;224;235
10;Cáceres;158;Robledillo de Trujillo;533;270;263
10;Cáceres;159;Robledollano;434;229;205
10;Cáceres;160;Romangordo;221;108;113
10;Cáceres;901;Rosalejo;"";"";""
10;Cáceres;161;Ruanes;109;54;55
10;Cáceres;162;Salorino;977;472;505
10;Cáceres;163;Salvatierra de Santiago;462;237;225
10;Cáceres;164;San Martín de Trevejo;958;473;485
10;Cáceres;165;Santa Ana;396;197;199
10;Cáceres;166;Santa Cruz de la Sierra;397;207;190
10;Cáceres;167;Santa Cruz de Paniagua;489;259;230
10;Cáceres;168;Santa Marta de Magasca;400;202;198
10;Cáceres;169;Santiago de Alcántara;870;430;440
10;Cáceres;170;Santiago del Campo;371;186;185
10;Cáceres;171;Santibáñez el Alto;525;266;259
10;Cáceres;172;Santibáñez el Bajo;1064;567;497
10;Cáceres;173;Saucedilla;592;292;300
10;Cáceres;174;Segura de Toro;208;111;97
10;Cáceres;175;Serradilla;2227;1119;1108
10;Cáceres;176;Serrejón;498;249;249
10;Cáceres;177;Sierra de Fuentes;1603;790;813
10;Cáceres;178;Talaván;1100;543;557
10;Cáceres;179;Talaveruela de la Vera;528;251;277
10;Cáceres;180;Talayuela;8047;4081;3966
10;Cáceres;181;Tejeda de Tiétar;1069;575;494
10;Cáceres;182;Toril;194;109;85
10;Cáceres;183;Tornavacas;1463;762;701
10;Cáceres;184;Torno (El);1112;578;534
10;Cáceres;187;Torre de Don Miguel;705;356;349
10;Cáceres;188;Torre de Santa María;826;400;426
10;Cáceres;185;Torrecilla de los Ángeles;708;362;346
10;Cáceres;186;Torrecillas de la Tiesa;1289;650;639
10;Cáceres;190;Torrejón el Rubio;793;402;391
10;Cáceres;189;Torrejoncillo;3748;1801;1947
10;Cáceres;191;Torremenga;612;317;295
10;Cáceres;192;Torremocha;1358;653;705
10;Cáceres;193;Torreorgaz;1472;749;723
10;Cáceres;194;Torrequemada;641;291;350
10;Cáceres;195;Trujillo;9197;4365;4832
10;Cáceres;196;Valdastillas;459;223;236
10;Cáceres;197;Valdecañas de Tajo;132;69;63
10;Cáceres;198;Valdefuentes;1700;843;857
10;Cáceres;199;Valdehúncar;166;75;91
10;Cáceres;200;Valdelacasa de Tajo;717;337;380
10;Cáceres;201;Valdemorales;272;132;140
10;Cáceres;202;Valdeobispo;886;445;441
10;Cáceres;203;Valencia de Alcántara;6488;3171;3317
10;Cáceres;204;Valverde de la Vera;699;348;351
10;Cáceres;205;Valverde del Fresno;2815;1413;1402
10;Cáceres;206;Viandar de la Vera;370;169;201
10;Cáceres;207;Villa del Campo;702;347;355
10;Cáceres;208;Villa del Rey;196;96;100
10;Cáceres;209;Villamesías;492;234;258
10;Cáceres;210;Villamiel;811;402;409
10;Cáceres;211;Villanueva de la Sierra;714;345;369
10;Cáceres;212;Villanueva de la Vera;2198;1098;1100
10;Cáceres;214;Villar de Plasencia;341;167;174
10;Cáceres;213;Villar del Pedroso;946;486;460
10;Cáceres;215;Villasbuenas de Gata;531;269;262
10;Cáceres;216;Zarza de Granadilla;1905;971;934
10;Cáceres;217;Zarza de Montánchez;715;355;360
10;Cáceres;218;Zarza la Mayor;1702;851;851
10;Cáceres;219;Zorita;2254;1095;1159
11;Cádiz;001;Alcalá de los Gazules;5655;2935;2720
11;Cádiz;002;Alcalá del Valle;5378;2728;2650
11;Cádiz;003;Algar;1901;1022;879
11;Cádiz;004;Algeciras;102998;50700;52298
11;Cádiz;005;Algodonales;5795;3009;2786
11;Cádiz;006;Arcos de la Frontera;27693;13889;13804
11;Cádiz;007;Barbate;22406;11200;11206
11;Cádiz;008;Barrios (Los);14482;7362;7120
11;Cádiz;901;Benalup-Casas Viejas;5973;3081;2892
11;Cádiz;009;Benaocaz;543;277;266
11;Cádiz;010;Bornos;8022;4026;3996
11;Cádiz;011;Bosque (El);1785;905;880
11;Cádiz;013;Castellar de la Frontera;2384;1210;1174
11;Cádiz;015;Chiclana de la Frontera;48988;25027;23961
11;Cádiz;016;Chipiona;14995;7581;7414
11;Cádiz;014;Conil de la Frontera;16067;8188;7879
11;Cádiz;012;Cádiz;155555;75227;80328
11;Cádiz;017;Espera;4192;2159;2033
11;Cádiz;018;Gastor (El);2131;1143;988
11;Cádiz;019;Grazalema;2272;1170;1102
11;Cádiz;020;Jerez de la Frontera;187622;92145;95477
11;Cádiz;021;Jimena de la Frontera;9023;4627;4396
11;Cádiz;022;Línea de la Concepción (La);60302;29400;30902
11;Cádiz;023;Medina-Sidonia;10844;5600;5244
11;Cádiz;024;Olvera;9106;4584;4522
11;Cádiz;025;Paterna de Rivera;4990;2576;2414
11;Cádiz;026;Prado del Rey;5631;2834;2797
11;Cádiz;028;Puerto Real;30483;15396;15087
11;Cádiz;029;Puerto Serrano;6552;3331;3221
11;Cádiz;027;Puerto de Santa María (El);67939;33958;33981
11;Cádiz;030;Rota;23727;11948;11779
11;Cádiz;031;San Fernando;86679;42776;43903
11;Cádiz;902;San José del Valle;"";"";""
11;Cádiz;033;San Roque;21769;10950;10819
11;Cádiz;032;Sanlúcar de Barrameda;58580;29349;29231
11;Cádiz;034;Setenil de las Bodegas;3255;1630;1625
11;Cádiz;035;Tarifa;14781;7465;7316
11;Cádiz;036;Torre Alháquime;1013;518;495
11;Cádiz;037;Trebujena;6999;3563;3436
11;Cádiz;038;Ubrique;18292;9099;9193
11;Cádiz;039;Vejer de la Frontera;12933;6615;6318
11;Cádiz;040;Villaluenga del Rosario;500;259;241
11;Cádiz;041;Villamartín;12442;6248;6194
11;Cádiz;042;Zahara;1581;798;783
12;Castellón/Castelló;002;Aín;132;65;67
12;Castellón/Castelló;003;Albocàsser;1476;707;769
12;Castellón/Castelló;004;Alcalà de Xivert;4851;2454;2397
12;Castellón/Castelló;005;Alcora (L');8409;4267;4142
12;Castellón/Castelló;006;Alcudia de Veo;185;86;99
12;Castellón/Castelló;007;Alfondeguilla;905;441;464
12;Castellón/Castelló;008;Algimia de Almonacid;322;180;142
12;Castellón/Castelló;009;Almazora/Almassora;16060;7887;8173
12;Castellón/Castelló;010;Almedíjar;291;141;150
12;Castellón/Castelló;011;Almenara;5049;2501;2548
12;Castellón/Castelló;901;Alquerías del Niño Perdido;3590;1743;1847
12;Castellón/Castelló;012;Altura;3045;1518;1527
12;Castellón/Castelló;013;Arañuel;103;42;61
12;Castellón/Castelló;014;Ares del Maestre;326;157;169
12;Castellón/Castelló;015;Argelita;104;50;54
12;Castellón/Castelló;016;Artana;1933;963;970
12;Castellón/Castelló;001;Atzeneta del Maestrat;1561;778;783
12;Castellón/Castelló;017;Ayódar;220;121;99
12;Castellón/Castelló;018;Azuébar;401;205;196
12;Castellón/Castelló;020;Barracas;177;102;75
12;Castellón/Castelló;022;Bejís;420;218;202
12;Castellón/Castelló;024;Benafer;127;66;61
12;Castellón/Castelló;025;Benafigos;248;135;113
12;Castellón/Castelló;026;Benasal;1444;700;744
12;Castellón/Castelló;027;Benicarló;18935;9338;9597
12;Castellón/Castelló;028;Benicasim/Benicàssim;7560;3810;3750
12;Castellón/Castelló;029;Benlloch;922;476;446
12;Castellón/Castelló;021;Betxí;5364;2730;2634
12;Castellón/Castelló;031;Borriol;2818;1427;1391
12;Castellón/Castelló;032;Burriana;26273;12888;13385
12;Castellón/Castelló;033;Cabanes;2479;1219;1260
12;Castellón/Castelló;034;Càlig;1785;870;915
12;Castellón/Castelló;036;Canet lo Roig;999;491;508
12;Castellón/Castelló;037;Castell de Cabres;24;12;12
12;Castellón/Castelló;038;Castellfort;263;136;127
12;Castellón/Castelló;039;Castellnovo;1084;539;545
12;Castellón/Castelló;040;Castellón de la Plana/Castelló de la Plana;137874;67334;70540
12;Castellón/Castelló;041;Castillo de Villamalefa;134;67;67
12;Castellón/Castelló;042;Catí;920;473;447
12;Castellón/Castelló;043;Caudiel;708;358;350
12;Castellón/Castelló;044;Cervera del Maestre;769;372;397
12;Castellón/Castelló;052;Chert/Xert;1016;492;524
12;Castellón/Castelló;053;Chilches/Xilxes;2163;1089;1074
12;Castellón/Castelló;055;Chodos/Xodos;168;94;74
12;Castellón/Castelló;056;Chóvar;415;214;201
12;Castellón/Castelló;045;Cinctorres;600;279;321
12;Castellón/Castelló;046;Cirat;285;140;145
12;Castellón/Castelló;048;Cortes de Arenoso;422;231;191
12;Castellón/Castelló;049;Costur;473;235;238
12;Castellón/Castelló;050;Coves de Vinromà (les);1884;930;954
12;Castellón/Castelló;051;Culla;930;460;470
12;Castellón/Castelló;057;Eslida;834;402;432
12;Castellón/Castelló;058;Espadilla;78;34;44
12;Castellón/Castelló;059;Fanzara;318;150;168
12;Castellón/Castelló;060;Figueroles;587;291;296
12;Castellón/Castelló;061;Forcall;585;282;303
12;Castellón/Castelló;063;Fuente la Reina;33;18;15
12;Castellón/Castelló;064;Fuentes de Ayódar;86;43;43
12;Castellón/Castelló;065;Gaibiel;221;116;105
12;Castellón/Castelló;066;Gatova;503;249;254
12;Castellón/Castelló;067;Geldo;709;354;355
12;Castellón/Castelló;068;Herbés;131;63;68
12;Castellón/Castelló;069;Higueras;30;16;14
12;Castellón/Castelló;070;Jana (La);910;453;457
12;Castellón/Castelló;071;Jérica;1617;831;786
12;Castellón/Castelló;074;Llosa (La);946;469;477
12;Castellón/Castelló;072;Lucena del Cid;1628;795;833
12;Castellón/Castelló;073;Ludiente;254;126;128
12;Castellón/Castelló;075;Mata de Morella (La);218;102;116
12;Castellón/Castelló;076;Matet;139;71;68
12;Castellón/Castelló;077;Moncofa;3656;1839;1817
12;Castellón/Castelló;078;Montán;357;178;179
12;Castellón/Castelló;079;Montanejos;404;199;205
12;Castellón/Castelló;080;Morella;2865;1397;1468
12;Castellón/Castelló;081;Navajas;452;218;234
12;Castellón/Castelló;082;Nules;11606;5770;5836
12;Castellón/Castelló;083;Olocau del Rey;163;93;70
12;Castellón/Castelló;084;Onda;18380;9208;9172
12;Castellón/Castelló;085;Oropesa del Mar/Orpesa;2548;1308;1240
12;Castellón/Castelló;087;Palanques;24;15;9
12;Castellón/Castelló;088;Pavías;63;37;26
12;Castellón/Castelló;089;Peñíscola;3867;1948;1919
12;Castellón/Castelló;090;Pina de Montalgrao;194;106;88
12;Castellón/Castelló;093;Pobla de Benifassà (La);223;108;115
12;Castellón/Castelló;094;Pobla Tornesa (La);526;259;267
12;Castellón/Castelló;091;Portell de Morella;293;149;144
12;Castellón/Castelló;092;Puebla de Arenoso;207;106;101
12;Castellón/Castelló;095;Ribesalbes;1317;649;668
12;Castellón/Castelló;096;Rossell;1220;613;607
12;Castellón/Castelló;097;Sacañet;130;65;65
12;Castellón/Castelló;098;Salzadella (La);858;418;440
12;Castellón/Castelló;101;San Rafael del Río;491;251;240
12;Castellón/Castelló;902;Sant Joan de Moró;1633;834;799
12;Castellón/Castelló;099;Sant Jordi/San Jorge;569;273;296
12;Castellón/Castelló;100;Sant Mateu;1805;880;925
12;Castellón/Castelló;102;Santa Magdalena de Pulpis;734;379;355
12;Castellón/Castelló;103;Sarratella;111;62;49
12;Castellón/Castelló;104;Segorbe;7606;3714;3892
12;Castellón/Castelló;105;Sierra Engarcerán;1136;599;537
12;Castellón/Castelló;106;Soneja;1445;720;725
12;Castellón/Castelló;107;Sot de Ferrer;410;209;201
12;Castellón/Castelló;108;Sueras/Suera;571;288;283
12;Castellón/Castelló;109;Tales;784;384;400
12;Castellón/Castelló;110;Teresa;398;206;192
12;Castellón/Castelló;111;Tírig;602;289;313
12;Castellón/Castelló;112;Todolella;147;84;63
12;Castellón/Castelló;113;Toga;108;47;61
12;Castellón/Castelló;114;Torás;298;153;145
12;Castellón/Castelló;115;Toro (El);312;162;150
12;Castellón/Castelló;116;Torralba del Pinar;73;37;36
12;Castellón/Castelló;119;Torre d'En Besora (La);236;126;110
12;Castellón/Castelló;120;Torre Endoménech;277;139;138
12;Castellón/Castelló;117;Torreblanca;4650;2341;2309
12;Castellón/Castelló;118;Torrechiva;61;36;25
12;Castellón/Castelló;121;Traiguera;1640;840;800
12;Castellón/Castelló;122;Useras/Useres (Les);1126;568;558
12;Castellón/Castelló;124;Vall d'Alba;1888;943;945
12;Castellón/Castelló;125;Vall de Almonacid;277;134;143
12;Castellón/Castelló;126;Vall d'Uixó (La);28687;14336;14351
12;Castellón/Castelló;123;Vallat;34;15;19
12;Castellón/Castelló;127;Vallibona;110;55;55
12;Castellón/Castelló;128;Vilafamés;1406;737;669
12;Castellón/Castelló;132;Vilanova d'Alcolea;717;363;354
12;Castellón/Castelló;134;Vilar de Canes;193;97;96
12;Castellón/Castelló;129;Villafranca del Cid;2762;1318;1444
12;Castellón/Castelló;130;Villahermosa del Río;512;276;236
12;Castellón/Castelló;131;Villamalur;151;81;70
12;Castellón/Castelló;133;Villanueva de Viver;103;51;52
12;Castellón/Castelló;135;Villarreal/Vila-real;39159;19453;19706
12;Castellón/Castelló;136;Villavieja;3459;1703;1756
12;Castellón/Castelló;137;Villores;84;43;41
12;Castellón/Castelló;138;Vinaròs;20539;10006;10533
12;Castellón/Castelló;139;Vistabella del Maestrazgo;509;245;264
12;Castellón/Castelló;140;Viver;1212;611;601
12;Castellón/Castelló;141;Zorita del Maestrazgo;158;80;78
12;Castellón/Castelló;142;Zucaina;237;129;108
13;Ciudad Real;001;Abenójar;2004;1006;998
13;Ciudad Real;002;Agudo;2244;1135;1109
13;Ciudad Real;003;Alamillo;730;371;359
13;Ciudad Real;004;Albaladejo;1849;910;939
13;Ciudad Real;005;Alcázar de San Juan;26463;12972;13491
13;Ciudad Real;006;Alcoba;834;428;406
13;Ciudad Real;007;Alcolea de Calatrava;1624;813;811
13;Ciudad Real;008;Alcubillas;791;381;410
13;Ciudad Real;009;Aldea del Rey;2399;1167;1232
13;Ciudad Real;010;Alhambra;1419;715;704
13;Ciudad Real;011;Almadén;8240;4010;4230
13;Ciudad Real;012;Almadenejos;673;353;320
13;Ciudad Real;013;Almagro;8530;4140;4390
13;Ciudad Real;014;Almedina;867;424;443
13;Ciudad Real;015;Almodóvar del Campo;7743;3857;3886
13;Ciudad Real;016;Almuradiel;869;414;455
13;Ciudad Real;017;Anchuras;478;254;224
13;Ciudad Real;903;Arenales de San Gregorio;"";"";""
13;Ciudad Real;018;Arenas de San Juan;1087;549;538
13;Ciudad Real;019;Argamasilla de Alba;6586;3238;3348
13;Ciudad Real;020;Argamasilla de Calatrava;5510;2767;2743
13;Ciudad Real;021;Arroba de los Montes;713;381;332
13;Ciudad Real;022;Ballesteros de Calatrava;638;316;322
13;Ciudad Real;023;Bolaños de Calatrava;10402;5189;5213
13;Ciudad Real;024;Brazatortas;1386;691;695
13;Ciudad Real;025;Cabezarados;415;214;201
13;Ciudad Real;026;Cabezarrubias del Puerto;741;379;362
13;Ciudad Real;027;Calzada de Calatrava;5081;2465;2616
13;Ciudad Real;028;Campo de Criptana;14092;6869;7223
13;Ciudad Real;029;Cañada de Calatrava;88;51;37
13;Ciudad Real;030;Caracuel de Calatrava;198;104;94
13;Ciudad Real;031;Carrión de Calatrava;2505;1215;1290
13;Ciudad Real;032;Carrizosa;1779;898;881
13;Ciudad Real;033;Castellar de Santiago;2330;1124;1206
13;Ciudad Real;038;Chillón;2554;1243;1311
13;Ciudad Real;034;Ciudad Real;60230;28614;31616
13;Ciudad Real;035;Corral de Calatrava;1379;693;686
13;Ciudad Real;036;Cortijos (Los);1109;549;560
13;Ciudad Real;037;Cózar;1467;719;748
13;Ciudad Real;039;Daimiel;17128;8337;8791
13;Ciudad Real;040;Fernán Caballero;1057;500;557
13;Ciudad Real;041;Fontanarejo;430;222;208
13;Ciudad Real;042;Fuencaliente;1378;749;629
13;Ciudad Real;043;Fuenllana;363;158;205
13;Ciudad Real;044;Fuente el Fresno;3533;1713;1820
13;Ciudad Real;045;Granátula de Calatrava;1086;521;565
13;Ciudad Real;046;Guadalmez;1096;561;535
13;Ciudad Real;047;Herencia;6975;3483;3492
13;Ciudad Real;048;Hinojosas de Calatrava;903;440;463
13;Ciudad Real;049;Horcajo de los Montes;1109;568;541
13;Ciudad Real;050;Labores (Las);690;336;354
13;Ciudad Real;904;Llanos del Caudillo;"";"";""
13;Ciudad Real;051;Luciana;490;255;235
13;Ciudad Real;052;Malagón;8004;3938;4066
13;Ciudad Real;053;Manzanares;18191;8870;9321
13;Ciudad Real;054;Membrilla;6782;3366;3416
13;Ciudad Real;055;Mestanza;1091;546;545
13;Ciudad Real;056;Miguelturra;7450;3677;3773
13;Ciudad Real;057;Montiel;1778;873;905
13;Ciudad Real;058;Moral de Calatrava;5263;2541;2722
13;Ciudad Real;059;Navalpino;366;181;185
13;Ciudad Real;060;Navas de Estena;434;236;198
13;Ciudad Real;061;Pedro Muñoz;7188;3566;3622
13;Ciudad Real;062;Picón;612;322;290
13;Ciudad Real;063;Piedrabuena;5310;2675;2635
13;Ciudad Real;064;Poblete;662;339;323
13;Ciudad Real;065;Porzuna;4031;2001;2030
13;Ciudad Real;066;Pozuelo de Calatrava;2407;1171;1236
13;Ciudad Real;067;Pozuelos de Calatrava (Los);627;313;314
13;Ciudad Real;068;Puebla de Don Rodrigo;1377;711;666
13;Ciudad Real;069;Puebla del Príncipe;1103;556;547
13;Ciudad Real;070;Puerto Lápice;1023;499;524
13;Ciudad Real;071;Puertollano;52477;25566;26911
13;Ciudad Real;072;Retuerta del Bullaque;1108;568;540
13;Ciudad Real;901;Robledo (El);1152;606;546
13;Ciudad Real;902;Ruidera;618;333;285
13;Ciudad Real;073;Saceruela;815;420;395
13;Ciudad Real;074;San Carlos del Valle;1285;642;643
13;Ciudad Real;075;San Lorenzo de Calatrava;368;189;179
13;Ciudad Real;076;Santa Cruz de los Cáñamos;681;337;344
13;Ciudad Real;077;Santa Cruz de Mudela;4914;2364;2550
13;Ciudad Real;078;Socuéllamos;11501;5625;5876
13;Ciudad Real;080;Solana del Pino;694;346;348
13;Ciudad Real;079;Solana (La);14796;7380;7416
13;Ciudad Real;081;Terrinches;1084;517;567
13;Ciudad Real;082;Tomelloso;28936;14198;14738
13;Ciudad Real;083;Torralba de Calatrava;3053;1486;1567
13;Ciudad Real;084;Torre de Juan Abad;1733;870;863
13;Ciudad Real;085;Torrenueva;3239;1621;1618
13;Ciudad Real;086;Valdemanco del Esteras;350;178;172
13;Ciudad Real;087;Valdepeñas;25908;12550;13358
13;Ciudad Real;088;Valenzuela de Calatrava;844;407;437
13;Ciudad Real;089;Villahermosa;2951;1392;1559
13;Ciudad Real;090;Villamanrique;1857;922;935
13;Ciudad Real;091;Villamayor de Calatrava;786;383;403
13;Ciudad Real;092;Villanueva de la Fuente;2961;1469;1492
13;Ciudad Real;093;Villanueva de los Infantes;6133;2936;3197
13;Ciudad Real;094;Villanueva de San Carlos;578;291;287
13;Ciudad Real;095;Villar del Pozo;100;53;47
13;Ciudad Real;096;Villarrubia de los Ojos;9707;4852;4855
13;Ciudad Real;097;Villarta de San Juan;3000;1503;1497
13;Ciudad Real;098;Viso del Marqués;3304;1615;1689
14;Córdoba;001;Adamuz;4572;2266;2306
14;Córdoba;002;Aguilar de la Frontera;13303;6589;6714
14;Córdoba;003;Alcaracejos;1532;766;766
14;Córdoba;004;Almedinilla;2604;1302;1302
14;Córdoba;005;Almodóvar del Río;7214;3629;3585
14;Córdoba;006;Añora;1704;845;859
14;Córdoba;007;Baena;20489;10097;10392
14;Córdoba;008;Belalcázar;4138;1995;2143
14;Córdoba;009;Belmez;4367;2097;2270
14;Córdoba;010;Benamejí;4627;2293;2334
14;Córdoba;011;Blázquez (Los);759;383;376
14;Córdoba;012;Bujalance;8622;4233;4389
14;Córdoba;013;Cabra;20591;10004;10587
14;Córdoba;015;Carcabuey;2909;1440;1469
14;Córdoba;016;Cardeña;2098;1051;1047
14;Córdoba;017;Carlota (La);9547;4771;4776
14;Córdoba;018;Carpio (El);4644;2278;2366
14;Córdoba;019;Castro del Río;7984;3898;4086
14;Córdoba;014;Cañete de las Torres;3438;1704;1734
14;Córdoba;020;Conquista;563;282;281
14;Córdoba;021;Córdoba;311641;150407;161234
14;Córdoba;023;Dos Torres;2563;1247;1316
14;Córdoba;022;Doña Mencía;5152;2551;2601
14;Córdoba;024;Encinas Reales;2336;1137;1199
14;Córdoba;025;Espejo;5045;2503;2542
14;Córdoba;026;Espiel;2652;1335;1317
14;Córdoba;027;Fernán-Núñez;9543;4751;4792
14;Córdoba;029;Fuente Obejuna;6393;3221;3172
14;Córdoba;030;Fuente Palmera;9690;4913;4777
14;Córdoba;028;Fuente la Lancha;469;232;237
14;Córdoba;031;Fuente-Tójar;881;431;450
14;Córdoba;032;Granjuela (La);540;285;255
14;Córdoba;033;Guadalcázar;1177;611;566
14;Córdoba;034;Guijo (El);451;233;218
14;Córdoba;035;Hinojosa del Duque;8236;3941;4295
14;Córdoba;036;Hornachuelos;5144;2633;2511
14;Córdoba;037;Iznájar;5647;2823;2824
14;Córdoba;038;Lucena;33553;16680;16873
14;Córdoba;039;Luque;3402;1674;1728
14;Córdoba;040;Montalbán de Córdoba;4588;2294;2294
14;Córdoba;041;Montemayor;3750;1886;1864
14;Córdoba;042;Montilla;23008;11380;11628
14;Córdoba;043;Montoro;9833;4847;4986
14;Córdoba;044;Monturque;1990;1007;983
14;Córdoba;045;Moriles;3740;1865;1875
14;Córdoba;046;Nueva Carteya;5757;2870;2887
14;Córdoba;047;Obejo;1457;715;742
14;Córdoba;048;Palenciana;1697;864;833
14;Córdoba;049;Palma del Río;18975;9491;9484
14;Córdoba;050;Pedro Abad;3052;1518;1534
14;Córdoba;051;Pedroche;1902;927;975
14;Córdoba;052;Peñarroya-Pueblonuevo;14170;6793;7377
14;Córdoba;053;Posadas;7205;3591;3614
14;Córdoba;054;Pozoblanco;15567;7472;8095
14;Córdoba;055;Priego de Córdoba;22136;10893;11243
14;Córdoba;056;Puente Genil;27292;13391;13901
14;Córdoba;057;Rambla (La);6986;3463;3523
14;Córdoba;058;Rute;10140;4944;5196
14;Córdoba;059;San Sebastián de los Ballesteros;821;425;396
14;Córdoba;061;Santa Eufemia;1273;651;622
14;Córdoba;060;Santaella;5829;2928;2901
14;Córdoba;062;Torrecampo;1552;753;799
14;Córdoba;063;Valenzuela;1573;741;832
14;Córdoba;064;Valsequillo;534;261;273
14;Córdoba;065;Victoria (La);1733;854;879
14;Córdoba;066;Villa del Río;7100;3588;3512
14;Córdoba;067;Villafranca de Córdoba;3669;1888;1781
14;Córdoba;068;Villaharta;638;310;328
14;Córdoba;069;Villanueva de Córdoba;10376;5033;5343
14;Córdoba;070;Villanueva del Duque;2006;932;1074
14;Córdoba;071;Villanueva del Rey;1324;689;635
14;Córdoba;072;Villaralto;1706;812;894
14;Córdoba;073;Villaviciosa de Córdoba;4020;2050;1970
14;Córdoba;074;Viso (El);3454;1678;1776
14;Córdoba;075;Zuheros;945;457;488
15;Coruña (A);001;Abegondo;5455;2709;2746
15;Coruña (A);002;Ames;10732;5208;5524
15;Coruña (A);003;Aranga;2500;1239;1261
15;Coruña (A);004;Ares;4602;2262;2340
15;Coruña (A);005;Arteixo;18688;9391;9297
15;Coruña (A);006;Arzúa;7024;3487;3537
15;Coruña (A);007;Baña (A);5853;2835;3018
15;Coruña (A);008;Bergondo;5502;2687;2815
15;Coruña (A);009;Betanzos;12103;5737;6366
15;Coruña (A);010;Boimorto;2973;1513;1460
15;Coruña (A);011;Boiro;17950;8789;9161
15;Coruña (A);012;Boqueixón;4253;2084;2169
15;Coruña (A);013;Brión;6349;3031;3318
15;Coruña (A);014;Cabana de Bergantiños;6433;3185;3248
15;Coruña (A);015;Cabanas;3236;1567;1669
15;Coruña (A);016;Camariñas;7492;3717;3775
15;Coruña (A);017;Cambre;12918;6290;6628
15;Coruña (A);018;Capela (A);1721;850;871
15;Coruña (A);019;Carballo;27717;13602;14115
15;Coruña (A);901;Cariño;5615;2764;2851
15;Coruña (A);020;Carnota;6772;3277;3495
15;Coruña (A);021;Carral;5269;2597;2672
15;Coruña (A);022;Cedeira;7728;3791;3937
15;Coruña (A);023;Cee;7497;3633;3864
15;Coruña (A);024;Cerceda;7069;3464;3605
15;Coruña (A);025;Cerdido;1911;923;988
15;Coruña (A);026;Cesuras;2932;1442;1490
15;Coruña (A);027;Coirós;1610;789;821
15;Coruña (A);028;Corcubión;2095;1013;1082
15;Coruña (A);029;Coristanco;9284;4644;4640
15;Coruña (A);030;A Coruña;252451;118572;133879
15;Coruña (A);031;Culleredo;15994;7793;8201
15;Coruña (A);032;Curtis;4669;2284;2385
15;Coruña (A);033;Dodro;3508;1710;1798
15;Coruña (A);034;Dumbría;4964;2426;2538
15;Coruña (A);035;Fene;15138;7413;7725
15;Coruña (A);036;Ferrol;84743;39850;44893
15;Coruña (A);037;Fisterra;5557;2785;2772
15;Coruña (A);038;Frades;3317;1676;1641
15;Coruña (A);039;Irixoa;1888;926;962
15;Coruña (A);041;Laracha (A);10813;5356;5457
15;Coruña (A);040;Laxe;3559;1761;1798
15;Coruña (A);042;Lousame;4713;2295;2418
15;Coruña (A);043;Malpica de Bergantiños;7911;3909;4002
15;Coruña (A);045;Mazaricos;6984;3381;3603
15;Coruña (A);044;Mañón;2202;1060;1142
15;Coruña (A);046;Melide;8470;4181;4289
15;Coruña (A);047;Mesía;3682;1836;1846
15;Coruña (A);048;Miño;5071;2430;2641
15;Coruña (A);049;Moeche;1713;825;888
15;Coruña (A);050;Monfero;2968;1529;1439
15;Coruña (A);051;Mugardos;6626;3204;3422
15;Coruña (A);053;Muros;11526;5554;5972
15;Coruña (A);052;Muxía;6769;3305;3464
15;Coruña (A);054;Narón;31824;15552;16272
15;Coruña (A);055;Neda;6463;3121;3342
15;Coruña (A);056;Negreira;6772;3203;3569
15;Coruña (A);057;Noia;15122;7307;7815
15;Coruña (A);058;Oleiros;19797;9573;10224
15;Coruña (A);059;Ordes;11891;5788;6103
15;Coruña (A);060;Oroso;3946;1921;2025
15;Coruña (A);061;Ortigueira;9948;4786;5162
15;Coruña (A);062;Outes;9349;4432;4917
15;Coruña (A);063;Oza dos Ríos;3371;1631;1740
15;Coruña (A);064;Paderne;2860;1355;1505
15;Coruña (A);065;Padrón;10177;4905;5272
15;Coruña (A);066;Pino (O);5271;2643;2628
15;Coruña (A);067;Pobra do Caramiñal (A);10373;4975;5398
15;Coruña (A);068;Ponteceso;7989;4027;3962
15;Coruña (A);069;Pontedeume;8893;4248;4645
15;Coruña (A);070;Pontes de García Rodríguez (As);13455;6799;6656
15;Coruña (A);071;Porto do Son;10854;5282;5572
15;Coruña (A);072;Rianxo;12902;6404;6498
15;Coruña (A);073;Ribeira;25977;12784;13193
15;Coruña (A);074;Rois;5628;2724;2904
15;Coruña (A);075;Sada;9476;4583;4893
15;Coruña (A);076;San Sadurniño;3743;1849;1894
15;Coruña (A);077;Santa Comba;11491;5587;5904
15;Coruña (A);078;Santiago de Compostela;90845;42802;48043
15;Coruña (A);079;Santiso;2484;1289;1195
15;Coruña (A);080;Sobrado;2881;1481;1400
15;Coruña (A);081;Somozas (As);1629;820;809
15;Coruña (A);082;Teo;13040;6350;6690
15;Coruña (A);083;Toques;1947;1016;931
15;Coruña (A);084;Tordoia;5825;2819;3006
15;Coruña (A);085;Touro;5044;2460;2584
15;Coruña (A);086;Trazo;4279;2135;2144
15;Coruña (A);088;Val do Dubra;5476;2684;2792
15;Coruña (A);087;Valdoviño;7012;3480;3532
15;Coruña (A);089;Vedra;5114;2467;2647
15;Coruña (A);091;Vilarmaior;1433;712;721
15;Coruña (A);090;Vilasantar;1866;956;910
15;Coruña (A);092;Vimianzo;9631;4776;4855
15;Coruña (A);093;Zas;6698;3280;3418
16;Cuenca;001;Abia de la Obispalía;115;62;53
16;Cuenca;002;Acebrón (El);312;154;158
16;Cuenca;003;Alarcón;219;111;108
16;Cuenca;004;Albaladejo del Cuende;458;247;211
16;Cuenca;005;Albalate de las Nogueras;415;223;192
16;Cuenca;006;Albendea;212;106;106
16;Cuenca;007;Alberca de Záncara (La);1885;933;952
16;Cuenca;008;Alcalá de la Vega;186;96;90
16;Cuenca;009;Alcantud;157;83;74
16;Cuenca;011;Alcohujate;72;38;34
16;Cuenca;012;Alconchel de la Estrella;245;125;120
16;Cuenca;010;Alcázar del Rey;283;143;140
16;Cuenca;013;Algarra;40;21;19
16;Cuenca;014;Aliaguilla;925;483;442
16;Cuenca;015;Almarcha (La);686;342;344
16;Cuenca;016;Almendros;413;201;212
16;Cuenca;017;Almodóvar del Pinar;606;312;294
16;Cuenca;018;Almonacid del Marquesado;592;303;289
16;Cuenca;019;Altarejos;419;212;207
16;Cuenca;020;Arandilla del Arroyo;52;23;29
16;Cuenca;905;Arcas del Villar;418;209;209
16;Cuenca;022;Arcos de la Sierra;129;68;61
16;Cuenca;024;Arguisuelas;215;112;103
16;Cuenca;025;Arrancacepas;40;22;18
16;Cuenca;026;Atalaya del Cañavate;142;66;76
16;Cuenca;027;Barajas de Melo;712;352;360
16;Cuenca;029;Barchín del Hoyo;152;84;68
16;Cuenca;030;Bascuñana de San Pedro;41;23;18
16;Cuenca;031;Beamud;104;57;47
16;Cuenca;032;Belinchón;324;158;166
16;Cuenca;033;Belmonte;2642;1225;1417
16;Cuenca;034;Belmontejo;301;152;149
16;Cuenca;035;Beteta;445;225;220
16;Cuenca;036;Boniches;264;130;134
16;Cuenca;038;Buciegas;98;49;49
16;Cuenca;039;Buenache de Alarcón;660;339;321
16;Cuenca;040;Buenache de la Sierra;113;66;47
16;Cuenca;041;Buendía;489;245;244
16;Cuenca;042;Campillo de Altobuey;1754;871;883
16;Cuenca;043;Campillos-Paravientos;163;84;79
16;Cuenca;044;Campillos-Sierra;96;52;44
16;Cuenca;901;Campos del Paraíso;1300;610;690
16;Cuenca;045;Canalejas del Arroyo;386;205;181
16;Cuenca;055;Carboneras de Guadazaón;1043;557;486
16;Cuenca;056;Cardenete;736;387;349
16;Cuenca;057;Carrascosa;135;72;63
16;Cuenca;058;Carrascosa de Haro;165;83;82
16;Cuenca;060;Casas de Benítez;1125;557;568
16;Cuenca;061;Casas de Fernando Alonso;1431;694;737
16;Cuenca;062;Casas de Garcimolina;44;20;24
16;Cuenca;063;Casas de Guijarro;186;95;91
16;Cuenca;064;Casas de Haro;897;453;444
16;Cuenca;065;Casas de los Pinos;567;278;289
16;Cuenca;066;Casasimarro;3076;1562;1514
16;Cuenca;067;Castejón;260;134;126
16;Cuenca;068;Castillejo de Iniesta;194;108;86
16;Cuenca;070;Castillejo-Sierra;66;30;36
16;Cuenca;072;Castillo de Garcimuñoz;309;159;150
16;Cuenca;071;Castillo-Albaráñez;34;18;16
16;Cuenca;047;Cañada Juncosa;418;219;199
16;Cuenca;046;Cañada del Hoyo;414;210;204
16;Cuenca;048;Cañamares;621;330;291
16;Cuenca;049;Cañavate (El);306;150;156
16;Cuenca;050;Cañaveras;437;221;216
16;Cuenca;051;Cañaveruelas;264;134;130
16;Cuenca;052;Cañete;798;397;401
16;Cuenca;053;Cañizares;659;339;320
16;Cuenca;073;Cervera del Llano;338;175;163
16;Cuenca;023;Chillarón de Cuenca;310;159;151
16;Cuenca;081;Chumillas;55;34;21
16;Cuenca;074;Cierva (La);58;31;27
16;Cuenca;078;Cuenca;44094;21255;22839
16;Cuenca;079;Cueva del Hierro;54;34;20
16;Cuenca;082;Enguídanos;621;322;299
16;Cuenca;083;Fresneda de Altarejos;105;60;45
16;Cuenca;084;Fresneda de la Sierra;85;43;42
16;Cuenca;085;Frontera (La);256;127;129
16;Cuenca;086;Fuente de Pedro Naharro;1262;622;640
16;Cuenca;087;Fuentelespino de Haro;400;214;186
16;Cuenca;088;Fuentelespino de Moya;153;74;79
16;Cuenca;904;Fuentenava de Jábaga;241;128;113
16;Cuenca;089;Fuentes;558;292;266
16;Cuenca;091;Fuertescusa;130;66;64
16;Cuenca;092;Gabaldón;203;110;93
16;Cuenca;093;Garaballa;180;92;88
16;Cuenca;094;Gascueña;191;92;99
16;Cuenca;095;Graja de Campalbo;144;81;63
16;Cuenca;096;Graja de Iniesta;346;182;164
16;Cuenca;097;Henarejos;348;167;181
16;Cuenca;098;Herrumblar (El);792;415;377
16;Cuenca;099;Hinojosa (La);398;200;198
16;Cuenca;100;Hinojosos (Los);1226;606;620
16;Cuenca;101;Hito (El);267;133;134
16;Cuenca;102;Honrubia;1697;841;856
16;Cuenca;103;Hontanaya;556;270;286
16;Cuenca;104;Hontecillas;105;48;57
16;Cuenca;106;Horcajo de Santiago;3633;1804;1829
16;Cuenca;108;Huelves;80;37;43
16;Cuenca;110;Huerta de la Obispalía;177;100;77
16;Cuenca;111;Huerta del Marquesado;210;113;97
16;Cuenca;112;Huete;2435;1245;1190
16;Cuenca;107;Huélamo;153;79;74
16;Cuenca;109;Huérguina;94;51;43
16;Cuenca;113;Iniesta;3711;1848;1863
16;Cuenca;115;Laguna del Marquesado;74;38;36
16;Cuenca;116;Lagunaseca;104;50;54
16;Cuenca;117;Landete;1618;803;815
16;Cuenca;118;Ledaña;2004;997;1007
16;Cuenca;119;Leganiel;279;135;144
16;Cuenca;121;Majadas (Las);405;207;198
16;Cuenca;122;Mariana;314;157;157
16;Cuenca;123;Masegosa;134;69;65
16;Cuenca;124;Mesas (Las);2656;1364;1292
16;Cuenca;125;Minglanilla;2377;1203;1174
16;Cuenca;126;Mira;1170;588;582
16;Cuenca;128;Monreal del Llano;98;52;46
16;Cuenca;129;Montalbanejo;230;110;120
16;Cuenca;130;Montalbo;840;450;390
16;Cuenca;131;Monteagudo de las Salinas;131;71;60
16;Cuenca;132;Mota de Altarejos;74;43;31
16;Cuenca;133;Mota del Cuervo;5586;2772;2814
16;Cuenca;134;Motilla del Palancar;4908;2462;2446
16;Cuenca;135;Moya;330;173;157
16;Cuenca;137;Narboneta;103;58;45
16;Cuenca;139;Olivares de Júcar;662;334;328
16;Cuenca;140;Olmeda de la Cuesta;49;26;23
16;Cuenca;141;Olmeda del Rey;267;123;144
16;Cuenca;142;Olmedilla de Alarcón;254;132;122
16;Cuenca;143;Olmedilla de Eliz;39;21;18
16;Cuenca;145;Osa de la Vega;730;374;356
16;Cuenca;147;Pajaroncillo;104;52;52
16;Cuenca;146;Pajarón;161;84;77
16;Cuenca;148;Palomares del Campo;1069;520;549
16;Cuenca;149;Palomera;180;87;93
16;Cuenca;150;Paracuellos;185;92;93
16;Cuenca;151;Paredes;80;45;35
16;Cuenca;152;Parra de las Vegas (La);67;31;36
16;Cuenca;153;Pedernoso (El);1405;692;713
16;Cuenca;154;Pedroñeras (Las);6609;3348;3261
16;Cuenca;155;Peral (El);762;391;371
16;Cuenca;156;Peraleja (La);187;100;87
16;Cuenca;157;Pesquera (La);297;156;141
16;Cuenca;158;Picazo (El);729;356;373
16;Cuenca;159;Pinarejo;628;328;300
16;Cuenca;160;Pineda de Gigüela;189;99;90
16;Cuenca;161;Piqueras del Castillo;89;48;41
16;Cuenca;162;Portalrubio de Guadamejud;114;54;60
16;Cuenca;163;Portilla;111;57;54
16;Cuenca;165;Poyatos;134;74;60
16;Cuenca;166;Pozoamargo;342;159;183
16;Cuenca;908;Pozorrubielos de la Mancha;309;157;152
16;Cuenca;167;Pozorrubio;558;268;290
16;Cuenca;169;Pozuelo (El);108;54;54
16;Cuenca;170;Priego;1117;573;544
16;Cuenca;171;Provencio (El);2730;1356;1374
16;Cuenca;172;Puebla de Almenara;661;340;321
16;Cuenca;173;Puebla de Don Francisco;424;221;203
16;Cuenca;174;Puebla del Salvador;327;180;147
16;Cuenca;175;Quintanar del Rey;5987;3047;2940
16;Cuenca;176;Rada de Haro;78;37;41
16;Cuenca;177;Reíllo;162;77;85
16;Cuenca;181;Rozalén del Monte;154;73;81
16;Cuenca;185;Saceda-Trasierra;61;28;33
16;Cuenca;186;Saelices;797;400;397
16;Cuenca;187;Salinas del Manzano;145;79;66
16;Cuenca;188;Salmeroncillos;166;91;75
16;Cuenca;189;Salvacañete;367;203;164
16;Cuenca;190;San Clemente;6260;3071;3189
16;Cuenca;191;San Lorenzo de la Parrilla;1668;845;823
16;Cuenca;192;San Martín de Boniches;101;50;51
16;Cuenca;193;San Pedro Palmiches;113;64;49
16;Cuenca;194;Santa Cruz de Moya;433;219;214
16;Cuenca;196;Santa María de los Llanos;912;455;457
16;Cuenca;195;Santa María del Campo Rus;930;459;471
16;Cuenca;197;Santa María del Val;133;71;62
16;Cuenca;198;Sisante;1869;943;926
16;Cuenca;199;Solera de Gabaldón;43;25;18
16;Cuenca;909;Sotorribas;1003;501;502
16;Cuenca;202;Talayuelas;1249;642;607
16;Cuenca;203;Tarancón;11266;5562;5704
16;Cuenca;205;Tejadillos;206;97;109
16;Cuenca;206;Tinajas;412;222;190
16;Cuenca;209;Torralba;234;113;121
16;Cuenca;211;Torrejoncillo del Rey;830;397;433
16;Cuenca;212;Torrubia del Campo;375;170;205
16;Cuenca;213;Torrubia del Castillo;52;27;25
16;Cuenca;215;Tragacete;419;225;194
16;Cuenca;216;Tresjuncos;594;300;294
16;Cuenca;217;Tribaldos;156;76;80
16;Cuenca;204;Tébar;451;243;208
16;Cuenca;218;Uclés;299;144;155
16;Cuenca;219;Uña;175;89;86
16;Cuenca;906;Valdecolmenas (Los);164;83;81
16;Cuenca;224;Valdemeca;104;60;44
16;Cuenca;225;Valdemorillo de la Sierra;102;53;49
16;Cuenca;227;Valdemoro-Sierra;192;113;79
16;Cuenca;228;Valdeolivas;319;172;147
16;Cuenca;902;Valdetórtola;169;93;76
16;Cuenca;903;Valeras (Las);1453;724;729
16;Cuenca;231;Valhermoso de la Fuente;71;33;38
16;Cuenca;234;Valsalobre;61;31;30
16;Cuenca;236;Valverde de Júcar;1513;756;757
16;Cuenca;237;Valverdejo;157;79;78
16;Cuenca;238;Vara de Rey;798;392;406
16;Cuenca;239;Vega del Codorno;276;135;141
16;Cuenca;240;Vellisca;204;95;109
16;Cuenca;242;Villaconejos de Trabaque;569;288;281
16;Cuenca;243;Villaescusa de Haro;630;320;310
16;Cuenca;244;Villagarcía del Llano;1024;521;503
16;Cuenca;245;Villalba de la Sierra;556;282;274
16;Cuenca;246;Villalba del Rey;796;401;395
16;Cuenca;247;Villalgordo del Marquesado;175;87;88
16;Cuenca;248;Villalpardo;1135;574;561
16;Cuenca;249;Villamayor de Santiago;2958;1461;1497
16;Cuenca;250;Villanueva de Guadamejud;145;76;69
16;Cuenca;251;Villanueva de la Jara;2457;1232;1225
16;Cuenca;253;Villar de Cañas;503;253;250
16;Cuenca;254;Villar de Domingo García;293;150;143
16;Cuenca;263;Villar de Olalla;806;413;393
16;Cuenca;255;Villar de la Encina;263;132;131
16;Cuenca;258;Villar del Humo;514;263;251
16;Cuenca;259;Villar del Infantado;55;32;23
16;Cuenca;910;Villar y Velasco;165;90;75
16;Cuenca;264;Villarejo de Fuentes;900;435;465
16;Cuenca;265;Villarejo de la Peñuela;41;21;20
16;Cuenca;266;Villarejo-Periesteban;583;302;281
16;Cuenca;269;Villares del Saz;846;429;417
16;Cuenca;270;Villarrubio;273;129;144
16;Cuenca;271;Villarta;816;408;408
16;Cuenca;272;Villas de la Ventosa;447;244;203
16;Cuenca;273;Villaverde y Pasaconsol;440;220;220
16;Cuenca;275;Vindel;25;14;11
16;Cuenca;274;Víllora;270;125;145
16;Cuenca;276;Yémeda;37;16;21
16;Cuenca;277;Zafra de Záncara;267;138;129
16;Cuenca;278;Zafrilla;140;72;68
16;Cuenca;279;Zarza de Tajo;311;136;175
16;Cuenca;280;Zarzuela;342;166;176
17;Girona;001;Agullana;665;349;316
17;Girona;002;Aiguaviva;370;185;185
17;Girona;003;Albanyà;130;66;64
17;Girona;004;Albons;483;257;226
17;Girona;006;Alp;979;496;483
17;Girona;007;Amer;2300;1136;1164
17;Girona;008;Anglès;5131;2597;2534
17;Girona;009;Arbúcies;4763;2401;2362
17;Girona;010;Argelaguer;366;182;184
17;Girona;011;Armentera (L');745;361;384
17;Girona;012;Avinyonet de Puigventós;436;213;223
17;Girona;015;Banyoles;14295;7075;7220
17;Girona;016;Bàscara;747;384;363
17;Girona;013;Begur;2920;1481;1439
17;Girona;018;Bellcaire d'Empordà;483;244;239
17;Girona;019;Besalú;2065;1010;1055
17;Girona;020;Bescanó;2915;1470;1445
17;Girona;021;Beuda;131;69;62
17;Girona;022;Bisbal d'Empordà (La);7976;3933;4043
17;Girona;234;Biure;220;112;108
17;Girona;023;Blanes;26697;13495;13202
17;Girona;029;Boadella d'Empordà;227;115;112
17;Girona;024;Bolvir;230;110;120
17;Girona;025;Bordils;1369;686;683
17;Girona;026;Borrassà;483;240;243
17;Girona;027;Breda;3324;1729;1595
17;Girona;028;Brunyola;384;191;193
17;Girona;031;Cabanelles;234;125;109
17;Girona;030;Cabanes;792;412;380
17;Girona;032;Cadaqués;1880;929;951
17;Girona;033;Caldes de Malavella;3307;1631;1676
17;Girona;034;Calonge;5513;2756;2757
17;Girona;035;Camós;620;316;304
17;Girona;036;Campdevànol;3354;1636;1718
17;Girona;037;Campelles;135;70;65
17;Girona;038;Campllong;281;146;135
17;Girona;039;Camprodon;2178;1076;1102
17;Girona;040;Canet d'Adri;465;242;223
17;Girona;041;Cantallops;277;135;142
17;Girona;042;Capmany;391;198;193
17;Girona;044;Cassà de la Selva;7309;3621;3688
17;Girona;046;Castellfollit de la Roca;1012;490;522
17;Girona;047;Castelló d'Empúries;4187;2141;2046
17;Girona;048;Castell-Platja d'Aro;5122;2610;2512
17;Girona;189;Cellera de Ter (La);2089;1024;1065
17;Girona;049;Celrà;2565;1279;1286
17;Girona;050;Cervià de Ter;635;313;322
17;Girona;051;Cistella;210;103;107
17;Girona;054;Colera;446;233;213
17;Girona;055;Colomers;204;99;105
17;Girona;057;Corçà;1109;550;559
17;Girona;056;Cornellà del Terri;1809;909;900
17;Girona;058;Crespià;231;117;114
17;Girona;901;Cruïlles, Monells i Sant Sadurní de l'Heura;1072;533;539
17;Girona;060;Darnius;523;275;248
17;Girona;061;Das;135;75;60
17;Girona;062;Escala (L');5585;2827;2758
17;Girona;063;Espinelves;175;85;90
17;Girona;064;Espolla;400;203;197
17;Girona;065;Esponellà;383;191;192
17;Girona;005;Far d'Empordà (El);416;208;208
17;Girona;066;Figueres;35233;17210;18023
17;Girona;067;Flaçà;920;457;463
17;Girona;068;Foixà;302;148;154
17;Girona;069;Fontanals de Cerdanya;305;151;154
17;Girona;070;Fontanilles;117;66;51
17;Girona;071;Fontcoberta;972;503;469
17;Girona;902;Forallac;1599;794;805
17;Girona;073;Fornells de la Selva;1182;580;602
17;Girona;074;Fortià;516;259;257
17;Girona;075;Garrigàs;296;149;147
17;Girona;076;Garrigoles;151;82;69
17;Girona;077;Garriguella;675;342;333
17;Girona;078;Ger;282;148;134
17;Girona;079;Girona;71164;34275;36889
17;Girona;080;Gombrèn;243;117;126
17;Girona;081;Gualta;267;125;142
17;Girona;082;Guils de Cerdanya;298;153;145
17;Girona;083;Hostalric;2898;1445;1453
17;Girona;084;Isòvol;169;84;85
17;Girona;085;Jafre;368;182;186
17;Girona;086;Jonquera (La);2571;1301;1270
17;Girona;087;Juià;273;133;140
17;Girona;088;Lladó;484;242;242
17;Girona;089;Llagostera;5418;2735;2683
17;Girona;090;Llambilles;451;221;230
17;Girona;091;Llanars;407;210;197
17;Girona;092;Llançà;3661;1841;1820
17;Girona;093;Llers;813;431;382
17;Girona;094;Llívia;881;456;425
17;Girona;095;Lloret de Mar;16270;8248;8022
17;Girona;096;Llosses (Les);392;223;169
17;Girona;102;Maçanet de Cabrenys;680;344;336
17;Girona;103;Maçanet de la Selva;3152;1590;1562
17;Girona;097;Madremanya;179;80;99
17;Girona;098;Maià de Montcal;323;157;166
17;Girona;100;Masarac;259;130;129
17;Girona;101;Massanes;511;267;244
17;Girona;099;Meranges;72;40;32
17;Girona;105;Mieres;341;169;172
17;Girona;106;Mollet de Peralada;181;99;82
17;Girona;107;Molló;364;186;178
17;Girona;109;Montagut i Oix;777;401;376
17;Girona;110;Mont-ras;1437;742;695
17;Girona;111;Navata;672;326;346
17;Girona;112;Ogassa;267;155;112
17;Girona;114;Olot;27377;13181;14196
17;Girona;115;Ordis;302;163;139
17;Girona;116;Osor;494;249;245
17;Girona;117;Palafrugell;17547;8985;8562
17;Girona;118;Palamós;13669;6781;6888
17;Girona;119;Palau de Santa Eulàlia;85;45;40
17;Girona;121;Palau-sator;295;150;145
17;Girona;120;Palau-saverdera;721;360;361
17;Girona;122;Palmerola;"";"";""
17;Girona;123;Palol de Revardit;364;175;189
17;Girona;124;Pals;1728;894;834
17;Girona;125;Pardines;130;70;60
17;Girona;126;Parlavà;337;180;157
17;Girona;128;Pau;350;160;190
17;Girona;129;Pedret i Marzà;126;59;67
17;Girona;130;Pera (La);379;198;181
17;Girona;132;Peralada;1143;593;550
17;Girona;133;Planes d'Hostoles (Les);1807;887;920
17;Girona;134;Planoles;262;143;119
17;Girona;135;Pont de Molins;413;222;191
17;Girona;136;Pontós;198;116;82
17;Girona;137;Porqueres;3161;1582;1579
17;Girona;140;Port de la Selva (El);815;392;423
17;Girona;138;Portbou;1868;923;945
17;Girona;139;Preses (Les);1315;647;668
17;Girona;141;Puigcerdà;6531;3315;3216
17;Girona;142;Quart;2095;1064;1031
17;Girona;043;Queralbs;196;106;90
17;Girona;143;Rabós;135;58;77
17;Girona;144;Regencós;268;150;118
17;Girona;145;Ribes de Freser;2271;1092;1179
17;Girona;146;Riells i Viabrea;1106;557;549
17;Girona;147;Ripoll;11339;5530;5809
17;Girona;148;Riudarenes;1115;559;556
17;Girona;149;Riudaura;379;182;197
17;Girona;150;Riudellots de la Selva;1385;705;680
17;Girona;151;Riumors;201;95;106
17;Girona;152;Roses;11106;5709;5397
17;Girona;153;Rupià;202;105;97
17;Girona;154;Sales de Llierca;54;31;23
17;Girona;155;Salt;22221;11153;11068
17;Girona;157;Sant Andreu Salou;129;69;60
17;Girona;183;Sant Aniol de Finestres;251;129;122
17;Girona;158;Sant Climent Sescebes;427;229;198
17;Girona;159;Sant Feliu de Buixalleu;621;333;288
17;Girona;160;Sant Feliu de Guíxols;16767;8180;8587
17;Girona;161;Sant Feliu de Pallerols;1092;527;565
17;Girona;162;Sant Ferriol;209;110;99
17;Girona;163;Sant Gregori;1992;1044;948
17;Girona;164;Sant Hilari Sacalm;4881;2488;2393
17;Girona;165;Sant Jaume de Llierca;774;396;378
17;Girona;167;Sant Joan de les Abadesses;3896;1892;2004
17;Girona;168;Sant Joan de Mollet;312;151;161
17;Girona;185;Sant Joan les Fonts;2846;1422;1424
17;Girona;166;Sant Jordi Desvalls;592;300;292
17;Girona;169;Sant Julià de Ramis;1813;901;912
17;Girona;903;Sant Julià del Llor i Bonmatí;912;448;464
17;Girona;171;Sant Llorenç de la Muga;169;83;86
17;Girona;172;Sant Martí de Llémena;359;189;170
17;Girona;173;Sant Martí Vell;204;111;93
17;Girona;174;Sant Miquel de Campmajor;221;126;95
17;Girona;175;Sant Miquel de Fluvià;560;289;271
17;Girona;176;Sant Mori;143;65;78
17;Girona;177;Sant Pau de Segúries;642;321;321
17;Girona;178;Sant Pere Pescador;1331;720;611
17;Girona;180;Santa Coloma de Farners;8550;4391;4159
17;Girona;181;Santa Cristina d'Aro;2052;1083;969
17;Girona;182;Santa Llogaia d'Àlguema;314;167;147
17;Girona;184;Santa Pau;1413;729;684
17;Girona;186;Sarrià de Ter;3283;1618;1665
17;Girona;187;Saus;699;350;349
17;Girona;188;Selva de Mar (La);167;88;79
17;Girona;190;Serinyà;786;400;386
17;Girona;191;Serra de Daró;188;97;91
17;Girona;192;Setcases;155;82;73
17;Girona;193;Sils;2519;1275;1244
17;Girona;052;Siurana;151;69;82
17;Girona;194;Susqueda;92;49;43
17;Girona;195;Tallada d'Empordà (La);330;165;165
17;Girona;196;Terrades;183;83;100
17;Girona;197;Torrent;176;85;91
17;Girona;198;Torroella de Fluvià;295;164;131
17;Girona;199;Torroella de Montgrí;7364;3731;3633
17;Girona;200;Tortellà;675;340;335
17;Girona;201;Toses;146;88;58
17;Girona;202;Tossa de Mar;3751;1890;1861
17;Girona;204;Ullà;722;361;361
17;Girona;205;Ullastret;258;135;123
17;Girona;203;Ultramort;208;107;101
17;Girona;206;Urús;129;66;63
17;Girona;014;Vajol (La);82;44;38
17;Girona;208;Vall de Bianya (La);1034;510;524
17;Girona;207;Vall d'en Bas (La);2533;1285;1248
17;Girona;170;Vallfogona de Ripollès;256;130;126
17;Girona;209;Vall-llobrega;261;139;122
17;Girona;210;Ventalló;541;278;263
17;Girona;211;Verges;1125;528;597
17;Girona;212;Vidrà;174;90;84
17;Girona;213;Vidreres;3957;1987;1970
17;Girona;214;Vilabertran;805;402;403
17;Girona;215;Vilablareix;1078;536;542
17;Girona;217;Viladamat;388;203;185
17;Girona;216;Viladasens;197;99;98
17;Girona;218;Vilademuls;761;374;387
17;Girona;220;Viladrau;869;434;435
17;Girona;221;Vilafant;3015;1506;1509
17;Girona;223;Vilajuïga;601;292;309
17;Girona;224;Vilallonga de Ter;422;221;201
17;Girona;225;Vilamacolum;232;121;111
17;Girona;226;Vilamalla;705;358;347
17;Girona;227;Vilamaniscle;115;57;58
17;Girona;228;Vilanant;269;138;131
17;Girona;230;Vila-sacra;395;184;211
17;Girona;222;Vilaür;111;55;56
17;Girona;233;Vilobí d'Onyar;2136;1129;1007
17;Girona;232;Vilopriu;176;87;89
18;Granada;001;Agrón;451;229;222
18;Granada;002;Alamedilla;1021;504;517
18;Granada;003;Albolote;10898;5478;5420
18;Granada;004;Albondón;1352;678;674
18;Granada;005;Albuñán;494;249;245
18;Granada;006;Albuñol;5442;2690;2752
18;Granada;007;Albuñuelas;1369;693;676
18;Granada;010;Aldeire;805;401;404
18;Granada;011;Alfacar;3834;1954;1880
18;Granada;012;Algarinejo;5240;2668;2572
18;Granada;013;Alhama de Granada;6070;3052;3018
18;Granada;014;Alhendín;3839;1934;1905
18;Granada;015;Alicún de Ortega;811;409;402
18;Granada;016;Almegíjar;449;229;220
18;Granada;017;Almuñécar;20708;10249;10459
18;Granada;904;Alpujarra de la Sierra;1302;661;641
18;Granada;018;Alquife;1113;538;575
18;Granada;020;Arenas del Rey;2084;1079;1005
18;Granada;021;Armilla;11660;5778;5882
18;Granada;022;Atarfe;10289;5085;5204
18;Granada;023;Baza;21036;10263;10773
18;Granada;024;Beas de Granada;936;487;449
18;Granada;025;Beas de Guadix;413;223;190
18;Granada;027;Benalúa;3435;1720;1715
18;Granada;028;Benalúa de las Villas;1395;699;696
18;Granada;029;Benamaurel;2521;1295;1226
18;Granada;030;Bérchules;856;438;418
18;Granada;032;Bubión;356;173;183
18;Granada;033;Busquístar;454;236;218
18;Granada;034;Cacín;890;457;433
18;Granada;035;Cádiar;1967;1001;966
18;Granada;036;Cájar;2389;1121;1268
18;Granada;114;Calahorra (La);1036;490;546
18;Granada;037;Calicasas;603;303;300
18;Granada;038;Campotéjar;1486;731;755
18;Granada;039;Caniles;5231;2551;2680
18;Granada;040;Cáñar;337;164;173
18;Granada;042;Capileira;570;280;290
18;Granada;043;Carataunas;219;115;104
18;Granada;044;Cástaras;340;176;164
18;Granada;045;Castilléjar;2190;1105;1085
18;Granada;046;Castril;3224;1672;1552
18;Granada;047;Cenes de la Vega;2798;1436;1362
18;Granada;059;Chauchina;3891;1932;1959
18;Granada;061;Chimeneas;1573;790;783
18;Granada;062;Churriana de la Vega;5860;2926;2934
18;Granada;048;Cijuela;1406;680;726
18;Granada;049;Cogollos de Guadix;807;421;386
18;Granada;050;Cogollos de la Vega;2023;1010;1013
18;Granada;051;Colomera;1862;946;916
18;Granada;053;Cortes de Baza;2946;1494;1452
18;Granada;054;Cortes y Graena;1015;537;478
18;Granada;912;Cuevas del Campo;2380;1157;1223
18;Granada;056;Cúllar;5478;2715;2763
18;Granada;057;Cúllar Vega;1928;968;960
18;Granada;063;Darro;1617;772;845
18;Granada;064;Dehesas de Guadix;682;346;336
18;Granada;066;Deifontes;2494;1252;1242
18;Granada;067;Diezma;1040;531;509
18;Granada;068;Dílar;1499;747;752
18;Granada;069;Dólar;708;353;355
18;Granada;070;Dúdar;259;127;132
18;Granada;071;Dúrcal;6007;2991;3016
18;Granada;072;Escúzar;967;498;469
18;Granada;074;Ferreira;423;200;223
18;Granada;076;Fonelas;1399;698;701
18;Granada;078;Freila;1236;630;606
18;Granada;079;Fuente Vaqueros;3928;1956;1972
18;Granada;905;Gabias (Las);6389;3176;3213
18;Granada;082;Galera;1624;802;822
18;Granada;083;Gobernador;411;202;209
18;Granada;084;Gójar;2532;1287;1245
18;Granada;085;Gor;1291;646;645
18;Granada;086;Gorafe;617;314;303
18;Granada;087;Granada;265371;125050;140321
18;Granada;088;Guadahortuna;2462;1256;1206
18;Granada;089;Guadix;20468;10114;10354
18;Granada;906;Guajares (Los);1504;772;732
18;Granada;093;Gualchos;3021;1531;1490
18;Granada;094;Güejar Sierra;2849;1439;1410
18;Granada;095;Güevéjar;1323;655;668
18;Granada;096;Huélago;696;360;336
18;Granada;097;Huéneja;1373;677;696
18;Granada;098;Huéscar;10120;5055;5065
18;Granada;099;Huétor de Santillán;1609;840;769
18;Granada;100;Huétor Tájar;7800;3878;3922
18;Granada;101;Huétor Vega;6964;3476;3488
18;Granada;102;Illora;10864;5450;5414
18;Granada;103;Itrabo;1098;548;550
18;Granada;105;Iznalloz;6783;3442;3341
18;Granada;107;Jayena;1530;789;741
18;Granada;108;Jerez del Marquesado;1231;621;610
18;Granada;109;Jete;739;357;382
18;Granada;111;Jun;1266;637;629
18;Granada;112;Juviles;217;109;108
18;Granada;115;Láchar;2352;1179;1173
18;Granada;116;Lanjarón;4039;2027;2012
18;Granada;117;Lanteira;712;361;351
18;Granada;119;Lecrín;2429;1179;1250
18;Granada;120;Lentegí;382;184;198
18;Granada;121;Lobras;221;112;109
18;Granada;122;Loja;21357;10618;10739
18;Granada;123;Lugros;461;250;211
18;Granada;124;Lújar;624;330;294
18;Granada;126;Malahá (La);1626;827;799
18;Granada;127;Maracena;13489;6710;6779
18;Granada;128;Marchal;472;230;242
18;Granada;132;Moclín;4800;2384;2416
18;Granada;133;Molvízar;2594;1279;1315
18;Granada;134;Monachil;4741;2421;2320
18;Granada;135;Montefrío;8202;4141;4061
18;Granada;136;Montejícar;3011;1541;1470
18;Granada;137;Montillana;1402;709;693
18;Granada;138;Moraleda de Zafayona;2624;1355;1269
18;Granada;909;Morelábor;1038;512;526
18;Granada;140;Motril;47911;23670;24241
18;Granada;141;Murtas;1127;573;554
18;Granada;903;Nevada;1513;756;757
18;Granada;143;Nigüelas;1205;609;596
18;Granada;144;Nívar;580;303;277
18;Granada;145;Ogíjares;5665;2857;2808
18;Granada;146;Orce;1498;760;738
18;Granada;147;Órgiva;5242;2628;2614
18;Granada;148;Otívar;1164;583;581
18;Granada;149;Otura;2967;1502;1465
18;Granada;150;Padul;6348;3181;3167
18;Granada;151;Pampaneira;350;184;166
18;Granada;152;Pedro Martínez;1533;774;759
18;Granada;153;Peligros;6717;3348;3369
18;Granada;154;Peza (La);1572;814;758
18;Granada;910;Pinar (El);1311;653;658
18;Granada;157;Pinos Genil;1096;565;531
18;Granada;158;Pinos Puente;13545;6769;6776
18;Granada;159;Píñar;1537;785;752
18;Granada;161;Polícar;258;136;122
18;Granada;162;Polopos;1204;638;566
18;Granada;163;Pórtugos;466;236;230
18;Granada;164;Puebla de Don Fadrique;2672;1330;1342
18;Granada;165;Pulianas;2705;1354;1351
18;Granada;167;Purullena;2595;1280;1315
18;Granada;168;Quéntar;1126;563;563
18;Granada;170;Rubite;431;228;203
18;Granada;171;Salar;2817;1395;1422
18;Granada;173;Salobreña;9832;4889;4943
18;Granada;174;Santa Cruz del Comercio;594;314;280
18;Granada;175;Santa Fe;12459;6095;6364
18;Granada;176;Soportújar;274;148;126
18;Granada;177;Sorvilán;954;474;480
18;Granada;901;Taha (La);981;496;485
18;Granada;178;Torre-Cardela;1254;628;626
18;Granada;179;Torvizcón;1149;582;567
18;Granada;180;Trevélez;825;450;375
18;Granada;181;Turón;444;254;190
18;Granada;182;Ugíjar;3006;1467;1539
18;Granada;907;Valle del Zalabí;2502;1245;1257
18;Granada;902;Valle (El);1511;748;763
18;Granada;183;Válor;1120;561;559
18;Granada;911;Vegas del Genil;2691;1363;1328
18;Granada;184;Vélez de Benaudalla;2533;1242;1291
18;Granada;185;Ventas de Huelma;694;347;347
18;Granada;908;Villamena;1000;482;518
18;Granada;187;Villanueva de las Torres;1054;548;506
18;Granada;188;Villanueva Mesía;1926;971;955
18;Granada;189;Víznar;802;419;383
18;Granada;192;Zafarraya;2249;1130;1119
18;Granada;913;Zagra;1267;627;640
18;Granada;193;Zubia (La);9657;4773;4884
18;Granada;194;Zújar;3003;1514;1489
19;Guadalajara;001;Abánades;124;71;53
19;Guadalajara;002;Ablanque;163;86;77
19;Guadalajara;003;Adobes;47;23;24
19;Guadalajara;004;Alaminos;100;48;52
19;Guadalajara;005;Alarilla;125;64;61
19;Guadalajara;006;Albalate de Zorita;1011;531;480
19;Guadalajara;007;Albares;538;274;264
19;Guadalajara;008;Albendiego;55;27;28
19;Guadalajara;009;Alcocer;335;164;171
19;Guadalajara;010;Alcolea de las Peñas;43;25;18
19;Guadalajara;011;Alcolea del Pinar;442;215;227
19;Guadalajara;013;Alcoroches;202;104;98
19;Guadalajara;015;Aldeanueva de Guadalajara;105;48;57
19;Guadalajara;016;Algar de Mesa;92;49;43
19;Guadalajara;017;Algora;114;66;48
19;Guadalajara;018;Alhóndiga;271;152;119
19;Guadalajara;019;Alique;38;9;29
19;Guadalajara;020;Almadrones;109;69;40
19;Guadalajara;021;Almoguera;788;402;386
19;Guadalajara;022;Almonacid de Zorita;956;483;473
19;Guadalajara;023;Alocén;141;73;68
19;Guadalajara;024;Alovera;1369;690;679
19;Guadalajara;027;Alustante;309;168;141
19;Guadalajara;031;Angón;35;20;15
19;Guadalajara;032;Anguita;339;168;171
19;Guadalajara;033;Anquela del Ducado;79;39;40
19;Guadalajara;034;Anquela del Pedregal;19;12;7
19;Guadalajara;036;Aranzueque;371;188;183
19;Guadalajara;037;Arbancón;226;123;103
19;Guadalajara;038;Arbeteta;52;29;23
19;Guadalajara;039;Argecilla;137;77;60
19;Guadalajara;040;Armallones;62;37;25
19;Guadalajara;041;Armuña de Tajuña;106;57;49
19;Guadalajara;042;Arroyo de las Fraguas;25;13;12
19;Guadalajara;043;Atanzón;111;65;46
19;Guadalajara;044;Atienza;504;253;251
19;Guadalajara;045;Auñón;285;146;139
19;Guadalajara;046;Azuqueca de Henares;12752;6425;6327
19;Guadalajara;047;Baides;86;46;40
19;Guadalajara;048;Baños de Tajo;35;23;12
19;Guadalajara;049;Bañuelos;38;20;18
19;Guadalajara;050;Barriopedro;35;15;20
19;Guadalajara;051;Berninches;135;78;57
19;Guadalajara;052;Bodera (La);55;31;24
19;Guadalajara;053;Brihuega;3038;1583;1455
19;Guadalajara;054;Budia;322;179;143
19;Guadalajara;055;Bujalaro;102;58;44
19;Guadalajara;057;Bustares;121;66;55
19;Guadalajara;058;Cabanillas del Campo;1198;640;558
19;Guadalajara;059;Campillo de Dueñas;164;87;77
19;Guadalajara;060;Campillo de Ranas;132;57;75
19;Guadalajara;061;Campisábalos;73;35;38
19;Guadalajara;064;Canredondo;143;74;69
19;Guadalajara;065;Cantalojas;162;92;70
19;Guadalajara;066;Cañizar;122;62;60
19;Guadalajara;067;Cardoso de la Sierra (El);124;76;48
19;Guadalajara;070;Casa de Uceda;128;65;63
19;Guadalajara;071;Casar (El);1565;813;752
19;Guadalajara;073;Casas de San Galindo;36;21;15
19;Guadalajara;074;Caspueñas;55;31;24
19;Guadalajara;075;Castejón de Henares;121;66;55
19;Guadalajara;076;Castellar de la Muela;63;33;30
19;Guadalajara;078;Castilforte;60;33;27
19;Guadalajara;079;Castilnuevo;12;4;8
19;Guadalajara;080;Cendejas de Enmedio;133;64;69
19;Guadalajara;081;Cendejas de la Torre;126;71;55
19;Guadalajara;082;Centenera;76;39;37
19;Guadalajara;103;Checa;442;227;215
19;Guadalajara;104;Chequilla;28;13;15
19;Guadalajara;106;Chillarón del Rey;139;75;64
19;Guadalajara;105;Chiloeches;1125;588;537
19;Guadalajara;086;Cifuentes;2606;1309;1297
19;Guadalajara;087;Cincovillas;39;19;20
19;Guadalajara;088;Ciruelas;68;36;32
19;Guadalajara;089;Ciruelos del Pinar;71;36;35
19;Guadalajara;090;Cobeta;149;74;75
19;Guadalajara;091;Cogollor;59;33;26
19;Guadalajara;092;Cogolludo;604;335;269
19;Guadalajara;095;Condemios de Abajo;32;18;14
19;Guadalajara;096;Condemios de Arriba;182;96;86
19;Guadalajara;097;Congostrina;54;27;27
19;Guadalajara;098;Copernal;33;18;15
19;Guadalajara;099;Corduente;509;274;235
19;Guadalajara;102;Cubillo de Uceda (El);150;75;75
19;Guadalajara;107;Driebes;352;198;154
19;Guadalajara;108;Durón;122;58;64
19;Guadalajara;109;Embid;76;43;33
19;Guadalajara;110;Escamilla;123;63;60
19;Guadalajara;111;Escariche;223;118;105
19;Guadalajara;112;Escopete;60;19;41
19;Guadalajara;113;Espinosa de Henares;522;250;272
19;Guadalajara;114;Esplegares;90;53;37
19;Guadalajara;115;Establés;54;25;29
19;Guadalajara;116;Estriégana;33;18;15
19;Guadalajara;117;Fontanar;828;426;402
19;Guadalajara;118;Fuembellida;19;10;9
19;Guadalajara;119;Fuencemillán;128;68;60
19;Guadalajara;120;Fuentelahiguera de Albatages;209;109;100
19;Guadalajara;121;Fuentelencina;185;102;83
19;Guadalajara;122;Fuentelsaz;159;76;83
19;Guadalajara;123;Fuentelviejo;80;40;40
19;Guadalajara;124;Fuentenovilla;223;128;95
19;Guadalajara;125;Gajanejos;115;65;50
19;Guadalajara;126;Galápagos;198;100;98
19;Guadalajara;127;Galve de Sorbe;187;90;97
19;Guadalajara;129;Gascueña de Bornova;39;19;20
19;Guadalajara;130;Guadalajara;66224;32733;33491
19;Guadalajara;132;Henche;37;25;12
19;Guadalajara;133;Heras de Ayuso;114;60;54
19;Guadalajara;134;Herrería;38;15;23
19;Guadalajara;135;Hiendelaencina;161;89;72
19;Guadalajara;136;Hijes;27;14;13
19;Guadalajara;138;Hita;263;143;120
19;Guadalajara;139;Hombrados;58;31;27
19;Guadalajara;142;Hontoba;141;69;72
19;Guadalajara;143;Horche;1157;594;563
19;Guadalajara;145;Hortezuela de Océn;100;51;49
19;Guadalajara;146;Huerce (La);38;21;17
19;Guadalajara;147;Huérmeces del Cerro;67;40;27
19;Guadalajara;148;Huertahernando;81;45;36
19;Guadalajara;150;Hueva;150;75;75
19;Guadalajara;151;Humanes;1202;629;573
19;Guadalajara;152;Illana;672;343;329
19;Guadalajara;153;Iniéstola;27;15;12
19;Guadalajara;154;Inviernas (Las);105;62;43
19;Guadalajara;155;Irueste;72;34;38
19;Guadalajara;156;Jadraque;1227;629;598
19;Guadalajara;157;Jirueque;62;35;27
19;Guadalajara;159;Ledanca;189;88;101
19;Guadalajara;160;Loranca de Tajuña;282;145;137
19;Guadalajara;161;Lupiana;268;146;122
19;Guadalajara;162;Luzaga;131;62;69
19;Guadalajara;163;Luzón;95;50;45
19;Guadalajara;165;Majaelrayo;55;26;29
19;Guadalajara;166;Málaga del Fresno;221;115;106
19;Guadalajara;167;Malaguilla;182;104;78
19;Guadalajara;168;Mandayona;490;229;261
19;Guadalajara;169;Mantiel;76;34;42
19;Guadalajara;170;Maranchón;237;132;105
19;Guadalajara;171;Marchamalo;"";"";""
19;Guadalajara;172;Masegoso de Tajuña;102;52;50
19;Guadalajara;173;Matarrubia;57;35;22
19;Guadalajara;174;Matillas;260;134;126
19;Guadalajara;175;Mazarete;94;48;46
19;Guadalajara;176;Mazuecos;415;212;203
19;Guadalajara;177;Medranda;152;77;75
19;Guadalajara;178;Megina;94;54;40
19;Guadalajara;179;Membrillera;109;54;55
19;Guadalajara;181;Miedes de Atienza;129;68;61
19;Guadalajara;182;Mierla (La);35;21;14
19;Guadalajara;184;Millana;111;52;59
19;Guadalajara;183;Milmarcos;114;64;50
19;Guadalajara;185;Miñosa (La);50;28;22
19;Guadalajara;186;Mirabueno;119;66;53
19;Guadalajara;187;Miralrío;103;55;48
19;Guadalajara;188;Mochales;144;71;73
19;Guadalajara;189;Mohernando;140;81;59
19;Guadalajara;190;Molina de Aragón;3621;1837;1784
19;Guadalajara;191;Monasterio;19;9;10
19;Guadalajara;192;Mondéjar;2137;1059;1078
19;Guadalajara;193;Montarrón;77;44;33
19;Guadalajara;194;Moratilla de los Meleros;129;73;56
19;Guadalajara;195;Morenilla;60;37;23
19;Guadalajara;196;Muduex;135;69;66
19;Guadalajara;197;Navas de Jadraque (Las);26;17;9
19;Guadalajara;198;Negredo;23;10;13
19;Guadalajara;199;Ocentejo;46;20;26
19;Guadalajara;200;Olivar (El);85;47;38
19;Guadalajara;201;Olmeda de Cobeta;88;34;54
19;Guadalajara;202;Olmeda de Jadraque (La);14;8;6
19;Guadalajara;203;Ordial (El);40;17;23
19;Guadalajara;204;Orea;314;168;146
19;Guadalajara;208;Pálmaces de Jadraque;81;42;39
19;Guadalajara;209;Pardos;63;32;31
19;Guadalajara;210;Paredes de Sigüenza;86;44;42
19;Guadalajara;211;Pareja;473;231;242
19;Guadalajara;212;Pastrana;1151;582;569
19;Guadalajara;213;Pedregal (El);110;57;53
19;Guadalajara;214;Peñalén;167;86;81
19;Guadalajara;215;Peñalver;293;168;125
19;Guadalajara;216;Peralejos de las Truchas;188;102;86
19;Guadalajara;217;Peralveche;78;43;35
19;Guadalajara;218;Pinilla de Jadraque;94;48;46
19;Guadalajara;219;Pinilla de Molina;25;15;10
19;Guadalajara;220;Pioz;201;110;91
19;Guadalajara;221;Piqueras;55;31;24
19;Guadalajara;222;Pobo de Dueñas (El);180;99;81
19;Guadalajara;223;Poveda de la Sierra;193;96;97
19;Guadalajara;224;Pozo de Almoguera;230;115;115
19;Guadalajara;225;Pozo de Guadalajara;346;186;160
19;Guadalajara;226;Prádena de Atienza;51;30;21
19;Guadalajara;227;Prados Redondos;97;55;42
19;Guadalajara;228;Puebla de Beleña;36;25;11
19;Guadalajara;229;Puebla de Valles;76;42;34
19;Guadalajara;230;Quer;114;56;58
19;Guadalajara;231;Rebollosa de Jadraque;37;22;15
19;Guadalajara;232;Recuenco (El);131;68;63
19;Guadalajara;233;Renera;69;33;36
19;Guadalajara;234;Retiendas;46;21;25
19;Guadalajara;235;Riba de Saelices;173;96;77
19;Guadalajara;237;Rillo de Gallo;68;38;30
19;Guadalajara;238;Riofrío del Llano;86;43;43
19;Guadalajara;239;Robledillo de Mohernando;167;91;76
19;Guadalajara;240;Robledo de Corpes;81;38;43
19;Guadalajara;241;Romanillos de Atienza;75;46;29
19;Guadalajara;242;Romanones;163;94;69
19;Guadalajara;243;Rueda de la Sierra;87;42;45
19;Guadalajara;244;Sacecorbo;159;83;76
19;Guadalajara;245;Sacedón;1621;823;798
19;Guadalajara;246;Saelices de la Sal;80;44;36
19;Guadalajara;247;Salmerón;280;147;133
19;Guadalajara;248;San Andrés del Congosto;77;42;35
19;Guadalajara;249;San Andrés del Rey;47;18;29
19;Guadalajara;250;Santiuste;30;13;17
19;Guadalajara;251;Saúca;66;31;35
19;Guadalajara;252;Sayatón;212;105;107
19;Guadalajara;254;Selas;70;34;36
19;Guadalajara;901;Semillas;33;15;18
19;Guadalajara;255;Setiles;218;118;100
19;Guadalajara;256;Sienes;106;62;44
19;Guadalajara;257;Sigüenza;4835;2399;2436
19;Guadalajara;258;Solanillos del Extremo;127;68;59
19;Guadalajara;259;Somolinos;51;21;30
19;Guadalajara;260;Sotillo (El);64;40;24
19;Guadalajara;261;Sotodosos;73;36;37
19;Guadalajara;262;Tamajón;198;98;100
19;Guadalajara;263;Taragudo;35;18;17
19;Guadalajara;264;Taravilla;75;41;34
19;Guadalajara;265;Tartanedo;235;115;120
19;Guadalajara;266;Tendilla;406;222;184
19;Guadalajara;267;Terzaga;48;27;21
19;Guadalajara;268;Tierzo;46;24;22
19;Guadalajara;269;Toba (La);135;71;64
19;Guadalajara;271;Tordellego;98;53;45
19;Guadalajara;270;Tordelrábano;17;8;9
19;Guadalajara;272;Tordesilos;169;88;81
19;Guadalajara;274;Torija;356;170;186
19;Guadalajara;279;Torre del Burgo;61;33;28
19;Guadalajara;276;Torrecilla del Ducado;"";"";""
19;Guadalajara;277;Torrecuadrada de Molina;26;16;10
19;Guadalajara;278;Torrecuadradilla;81;47;34
19;Guadalajara;280;Torrejón del Rey;600;330;270
19;Guadalajara;281;Torremocha de Jadraque;18;12;6
19;Guadalajara;282;Torremocha del Campo;380;209;171
19;Guadalajara;283;Torremocha del Pinar;79;38;41
19;Guadalajara;284;Torremochuela;10;5;5
19;Guadalajara;285;Torrubia;46;22;24
19;Guadalajara;286;Tórtola de Henares;414;210;204
19;Guadalajara;287;Tortuera;274;144;130
19;Guadalajara;288;Tortuero;38;23;15
19;Guadalajara;289;Traíd;79;39;40
19;Guadalajara;290;Trijueque;382;206;176
19;Guadalajara;291;Trillo;1516;767;749
19;Guadalajara;293;Uceda;526;257;269
19;Guadalajara;294;Ujados;45;24;21
19;Guadalajara;296;Utande;74;44;30
19;Guadalajara;297;Valdarachas;26;11;15
19;Guadalajara;298;Valdearenas;61;32;29
19;Guadalajara;299;Valdeavellano;92;47;45
19;Guadalajara;300;Valdeaveruelo;171;95;76
19;Guadalajara;301;Valdeconcha;41;19;22
19;Guadalajara;302;Valdegrudas;66;35;31
19;Guadalajara;303;Valdelcubo;73;44;29
19;Guadalajara;304;Valdenuño Fernández;138;73;65
19;Guadalajara;305;Valdepeñas de la Sierra;265;144;121
19;Guadalajara;306;Valderrebollo;48;23;25
19;Guadalajara;307;Valdesotos;50;19;31
19;Guadalajara;308;Valfermoso de Tajuña;71;39;32
19;Guadalajara;309;Valhermoso;47;26;21
19;Guadalajara;310;Valtablado del Río;22;13;9
19;Guadalajara;311;Valverde de los Arroyos;92;48;44
19;Guadalajara;314;Viana de Jadraque;68;35;33
19;Guadalajara;317;Villanueva de Alcorón;333;179;154
19;Guadalajara;318;Villanueva de Argecilla;51;29;22
19;Guadalajara;319;Villanueva de la Torre;110;57;53
19;Guadalajara;321;Villares de Jadraque;63;33;30
19;Guadalajara;322;Villaseca de Henares;65;35;30
19;Guadalajara;323;Villaseca de Uceda;65;33;32
19;Guadalajara;324;Villel de Mesa;266;127;139
19;Guadalajara;325;Viñuelas;124;68;56
19;Guadalajara;326;Yebes;67;40;27
19;Guadalajara;327;Yebra;597;297;300
19;Guadalajara;329;Yélamos de Abajo;97;47;50
19;Guadalajara;330;Yélamos de Arriba;130;68;62
19;Guadalajara;331;Yunquera de Henares;1998;1012;986
19;Guadalajara;332;Yunta (La);185;90;95
19;Guadalajara;333;Zaorejas;211;115;96
19;Guadalajara;334;Zarzuela de Jadraque;34;20;14
19;Guadalajara;335;Zorita de los Canes;100;56;44
20;Guipúzcoa;001;Abaltzisketa;272;151;121
20;Guipúzcoa;002;Aduna;299;156;143
20;Guipúzcoa;016;Aia;1690;968;722
20;Guipúzcoa;003;Aizarnazabal;537;294;243
20;Guipúzcoa;004;Albiztur;301;160;141
20;Guipúzcoa;005;Alegia;1672;874;798
20;Guipúzcoa;006;Alkiza;269;154;115
20;Guipúzcoa;906;Altzaga;95;46;49
20;Guipúzcoa;007;Altzo;317;179;138
20;Guipúzcoa;008;Amezketa;1032;555;477
20;Guipúzcoa;009;Andoain;15118;7552;7566
20;Guipúzcoa;010;Anoeta;1798;906;892
20;Guipúzcoa;011;Antzuola;2031;1050;981
20;Guipúzcoa;012;Arama;152;76;76
20;Guipúzcoa;013;Aretxabaleta;6190;3158;3032
20;Guipúzcoa;055;Arrasate/Mondragón;25316;12705;12611
20;Guipúzcoa;014;Asteasu;1216;658;558
20;Guipúzcoa;903;Astigarraga;3261;1603;1658
20;Guipúzcoa;015;Ataun;1688;862;826
20;Guipúzcoa;017;Azkoitia;10528;5251;5277
20;Guipúzcoa;018;Azpeitia;13755;6932;6823
20;Guipúzcoa;904;Baliarrain;99;51;48
20;Guipúzcoa;019;Beasain;12452;6275;6177
20;Guipúzcoa;020;Beizama;173;97;76
20;Guipúzcoa;021;Belauntza;299;161;138
20;Guipúzcoa;022;Berastegi;951;531;420
20;Guipúzcoa;074;Bergara;15589;7778;7811
20;Guipúzcoa;023;Berrobi;593;325;268
20;Guipúzcoa;024;Bidegoyan;440;252;188
20;Guipúzcoa;029;Deba;5009;2555;2454
20;Guipúzcoa;069;Donostia/San Sebastián;176989;82982;94007
20;Guipúzcoa;030;Eibar;31932;15712;16220
20;Guipúzcoa;031;Elduain;234;125;109
20;Guipúzcoa;033;Elgeta;1001;505;496
20;Guipúzcoa;032;Elgoibar;11548;5817;5731
20;Guipúzcoa;067;Errenteria;41625;20597;21028
20;Guipúzcoa;066;Errezil;680;379;301
20;Guipúzcoa;034;Eskoriatza;3864;2005;1859
20;Guipúzcoa;035;Ezkio-Itsaso;520;266;254
20;Guipúzcoa;038;Gabiria;435;238;197
20;Guipúzcoa;037;Gaintza;128;73;55
20;Guipúzcoa;907;Gaztelu;"";"";""
20;Guipúzcoa;039;Getaria;2377;1196;1181
20;Guipúzcoa;040;Hernani;18590;9238;9352
20;Guipúzcoa;041;Hernialde;288;151;137
20;Guipúzcoa;036;Hondarribia;13662;6820;6842
20;Guipúzcoa;042;Ibarra;4421;2296;2125
20;Guipúzcoa;043;Idiazabal;2034;1026;1008
20;Guipúzcoa;044;Ikaztegieta;373;194;179
20;Guipúzcoa;045;Irún;54911;26991;27920
20;Guipúzcoa;046;Irura;662;333;329
20;Guipúzcoa;047;Itsasondo;616;308;308
20;Guipúzcoa;048;Larraul;142;83;59
20;Guipúzcoa;902;Lasarte-Oria;18289;9161;9128
20;Guipúzcoa;049;Lazkao;5032;2580;2452
20;Guipúzcoa;050;Leaburu;548;310;238
20;Guipúzcoa;051;Legazpi;9743;5036;4707
20;Guipúzcoa;052;Legorreta;1482;751;731
20;Guipúzcoa;068;Leintz-Gatzaga;242;134;108
20;Guipúzcoa;053;Lezo;5478;2692;2786
20;Guipúzcoa;054;Lizartza;695;368;327
20;Guipúzcoa;901;Mendaro;1397;722;675
20;Guipúzcoa;057;Mutiloa;182;89;93
20;Guipúzcoa;056;Mutriku;4641;2306;2335
20;Guipúzcoa;063;Oiartzun;8655;4312;4343
20;Guipúzcoa;058;Olaberria;1094;562;532
20;Guipúzcoa;076;Ordizia;9353;4588;4765
20;Guipúzcoa;905;Orendain;164;98;66
20;Guipúzcoa;060;Orexa;79;42;37
20;Guipúzcoa;061;Orio;4298;2182;2116
20;Guipúzcoa;062;Ormaiztegi;1235;614;621
20;Guipúzcoa;059;Oñati;10649;5318;5331
20;Guipúzcoa;064;Pasaia;18373;8974;9399
20;Guipúzcoa;070;Segura;1293;653;640
20;Guipúzcoa;065;Soraluze/Placencia de las Armas;4744;2353;2391
20;Guipúzcoa;071;Tolosa;18218;8748;9470
20;Guipúzcoa;072;Urnieta;4662;2394;2268
20;Guipúzcoa;077;Urretxu;6138;3106;3032
20;Guipúzcoa;073;Usurbil;5353;2741;2612
20;Guipúzcoa;075;Villabona;5431;2755;2676
20;Guipúzcoa;078;Zaldibia;1559;816;743
20;Guipúzcoa;079;Zarautz;18428;9118;9310
20;Guipúzcoa;025;Zegama;1404;714;690
20;Guipúzcoa;026;Zerain;238;114;124
20;Guipúzcoa;027;Zestoa;3371;1760;1611
20;Guipúzcoa;028;Zizurkil;2722;1385;1337
20;Guipúzcoa;081;Zumaia;8269;4140;4129
20;Guipúzcoa;080;Zumarraga;10966;5529;5437
21;Huelva;001;Alájar;862;446;416
21;Huelva;002;Aljaraque;7202;3606;3596
21;Huelva;003;Almendro (El);875;457;418
21;Huelva;004;Almonaster la Real;2145;1039;1106
21;Huelva;005;Almonte;16792;8456;8336
21;Huelva;006;Alosno;4982;2410;2572
21;Huelva;007;Aracena;6679;3275;3404
21;Huelva;008;Aroche;3599;1756;1843
21;Huelva;009;Arroyomolinos de León;1231;620;611
21;Huelva;010;Ayamonte;15702;7677;8025
21;Huelva;011;Beas;4075;2022;2053
21;Huelva;012;Berrocal;421;214;207
21;Huelva;013;Bollullos Par del Condado;12792;6348;6444
21;Huelva;014;Bonares;4986;2518;2468
21;Huelva;015;Cabezas Rubias;970;498;472
21;Huelva;016;Cala;1493;763;730
21;Huelva;017;Calañas;5057;2484;2573
21;Huelva;018;Campillo (El);2632;1277;1355
21;Huelva;019;Campofrío;894;451;443
21;Huelva;020;Cañaveral de León;583;277;306
21;Huelva;021;Cartaya;10806;5340;5466
21;Huelva;022;Castaño del Robledo;204;100;104
21;Huelva;023;Cerro de Andévalo (El);2872;1404;1468
21;Huelva;030;Chucena;1945;998;947
21;Huelva;024;Corteconcepción;689;347;342
21;Huelva;025;Cortegana;5305;2610;2695
21;Huelva;026;Cortelazor;320;158;162
21;Huelva;027;Cumbres de Enmedio;59;30;29
21;Huelva;028;Cumbres de San Bartolomé;628;319;309
21;Huelva;029;Cumbres Mayores;2307;1115;1192
21;Huelva;031;Encinasola;1995;987;1008
21;Huelva;032;Escacena del Campo;2237;1104;1133
21;Huelva;033;Fuenteheridos;666;345;321
21;Huelva;034;Galaroza;1636;791;845
21;Huelva;035;Gibraleón;10128;5086;5042
21;Huelva;036;Granada de Río-Tinto (La);221;115;106
21;Huelva;037;Granado (El);692;367;325
21;Huelva;038;Higuera de la Sierra;1318;652;666
21;Huelva;039;Hinojales;469;236;233
21;Huelva;040;Hinojos;3421;1730;1691
21;Huelva;041;Huelva;144008;69911;74097
21;Huelva;042;Isla Cristina;17269;8567;8702
21;Huelva;043;Jabugo;2606;1282;1324
21;Huelva;044;Lepe;16959;8590;8369
21;Huelva;045;Linares de la Sierra;291;140;151
21;Huelva;046;Lucena del Puerto;2092;1071;1021
21;Huelva;047;Manzanilla;2578;1267;1311
21;Huelva;048;Marines (Los);354;177;177
21;Huelva;049;Minas de Riotinto;5422;2598;2824
21;Huelva;050;Moguer;12291;6239;6052
21;Huelva;051;Nava (La);346;174;172
21;Huelva;052;Nerva;7043;3428;3615
21;Huelva;053;Niebla;3844;1943;1901
21;Huelva;054;Palma del Condado (La);9583;4721;4862
21;Huelva;055;Palos de la Frontera;6844;3454;3390
21;Huelva;056;Paterna del Campo;3882;1997;1885
21;Huelva;057;Paymogo;1380;665;715
21;Huelva;058;Puebla de Guzmán;3229;1620;1609
21;Huelva;059;Puerto Moral;234;108;126
21;Huelva;060;Punta Umbría;10447;5286;5161
21;Huelva;061;Rociana del Condado;6228;3175;3053
21;Huelva;062;Rosal de la Frontera;1946;923;1023
21;Huelva;063;San Bartolomé de la Torre;2901;1456;1445
21;Huelva;064;San Juan del Puerto;5827;2939;2888
21;Huelva;066;San Silvestre de Guzmán;680;338;342
21;Huelva;065;Sanlúcar de Guadiana;396;194;202
21;Huelva;067;Santa Ana la Real;505;235;270
21;Huelva;068;Santa Bárbara de Casa;1422;709;713
21;Huelva;069;Santa Olalla del Cala;2327;1186;1141
21;Huelva;070;Trigueros;7109;3562;3547
21;Huelva;071;Valdelarco;289;139;150
21;Huelva;072;Valverde del Camino;12458;5997;6461
21;Huelva;073;Villablanca;2048;1059;989
21;Huelva;074;Villalba del Alcor;3698;1836;1862
21;Huelva;075;Villanueva de las Cruces;417;203;214
21;Huelva;076;Villanueva de los Castillejos;2641;1283;1358
21;Huelva;077;Villarrasa;2185;1111;1074
21;Huelva;078;Zalamea la Real;3780;1857;1923
21;Huelva;079;Zufre;1309;671;638
22;Huesca;001;Abiego;302;151;151
22;Huesca;002;Abizanda;127;68;59
22;Huesca;003;Adahuesca;176;92;84
22;Huesca;004;Agüero;165;84;81
22;Huesca;907;Aínsa-Sobrarbe;1452;786;666
22;Huesca;006;Aisa;339;187;152
22;Huesca;007;Albalate de Cinca;1153;602;551
22;Huesca;008;Albalatillo;267;134;133
22;Huesca;009;Albelda;1023;529;494
22;Huesca;011;Albero Alto;102;55;47
22;Huesca;012;Albero Bajo;113;64;49
22;Huesca;013;Alberuela de Tubo;429;223;206
22;Huesca;014;Alcalá de Gurrea;391;194;197
22;Huesca;015;Alcalá del Obispo;351;169;182
22;Huesca;016;Alcampell;1051;523;528
22;Huesca;017;Alcolea de Cinca;1231;621;610
22;Huesca;018;Alcubierre;504;257;247
22;Huesca;019;Alerre;159;80;79
22;Huesca;020;Alfántega;139;70;69
22;Huesca;021;Almudévar;2440;1278;1162
22;Huesca;022;Almunia de San Juan;753;379;374
22;Huesca;023;Almuniente;673;344;329
22;Huesca;024;Alquézar;266;134;132
22;Huesca;025;Altorricón;1501;782;719
22;Huesca;027;Angüés;480;262;218
22;Huesca;028;Ansó;506;250;256
22;Huesca;029;Antillón;176;87;89
22;Huesca;032;Aragüés del Puerto;121;73;48
22;Huesca;035;Arén;441;240;201
22;Huesca;036;Argavieso;116;65;51
22;Huesca;037;Arguis;59;34;25
22;Huesca;039;Ayerbe;1209;621;588
22;Huesca;040;Azanuy-Alins;226;108;118
22;Huesca;041;Azara;223;114;109
22;Huesca;042;Azlor;189;99;90
22;Huesca;043;Baélls;166;84;82
22;Huesca;044;Bailo;352;200;152
22;Huesca;045;Baldellou;169;84;85
22;Huesca;046;Ballobar;1137;571;566
22;Huesca;047;Banastás;127;62;65
22;Huesca;048;Barbastro;15159;7435;7724
22;Huesca;049;Barbués;128;64;64
22;Huesca;050;Barbuñales;118;58;60
22;Huesca;051;Bárcabo;123;66;57
22;Huesca;052;Belver de Cinca;1484;767;717
22;Huesca;053;Benabarre;1247;651;596
22;Huesca;054;Benasque;1200;616;584
22;Huesca;055;Berbegal;517;256;261
22;Huesca;057;Bielsa;444;231;213
22;Huesca;058;Bierge;187;103;84
22;Huesca;059;Biescas;1226;643;583
22;Huesca;060;Binaced;1628;829;799
22;Huesca;061;Binéfar;8028;4023;4005
22;Huesca;062;Bisaurri;237;141;96
22;Huesca;063;Biscarrués;255;137;118
22;Huesca;064;Blecua y Torres;189;98;91
22;Huesca;066;Boltaña;859;434;425
22;Huesca;067;Bonansa;71;36;35
22;Huesca;068;Borau;72;37;35
22;Huesca;069;Broto;518;264;254
22;Huesca;072;Caldearenas;265;141;124
22;Huesca;074;Campo;394;189;205
22;Huesca;075;Camporrélls;260;119;141
22;Huesca;076;Canal de Berdún;459;238;221
22;Huesca;077;Candasnos;618;312;306
22;Huesca;078;Canfranc;489;263;226
22;Huesca;079;Capdesaso;192;92;100
22;Huesca;080;Capella;439;225;214
22;Huesca;081;Casbas de Huesca;356;178;178
22;Huesca;083;Castejón de Monegros;775;381;394
22;Huesca;084;Castejón de Sos;475;251;224
22;Huesca;082;Castejón del Puente;433;211;222
22;Huesca;085;Castelflorite;166;87;79
22;Huesca;086;Castiello de Jaca;154;69;85
22;Huesca;087;Castigaleu;95;53;42
22;Huesca;088;Castillazuelo;242;120;122
22;Huesca;089;Castillonroy;429;210;219
22;Huesca;094;Chalamera;167;92;75
22;Huesca;095;Chía;124;74;50
22;Huesca;096;Chimillas;158;88;70
22;Huesca;090;Colungo;139;76;63
22;Huesca;099;Esplús;882;423;459
22;Huesca;102;Estada;193;94;99
22;Huesca;103;Estadilla;1008;512;496
22;Huesca;105;Estopiñán del Castillo;186;94;92
22;Huesca;106;Fago;47;30;17
22;Huesca;107;Fanlo;58;41;17
22;Huesca;109;Fiscal;253;135;118
22;Huesca;110;Fonz;1207;611;596
22;Huesca;111;Foradada del Toscar;281;137;144
22;Huesca;112;Fraga;11794;5949;5845
22;Huesca;113;Fueva (La);643;350;293
22;Huesca;114;Gistaín;203;116;87
22;Huesca;115;Grado (El);600;315;285
22;Huesca;116;Grañén;2133;1075;1058
22;Huesca;117;Graus;3357;1711;1646
22;Huesca;119;Gurrea de Gállego;1960;978;982
22;Huesca;122;Hoz de Jaca;86;35;51
22;Huesca;908;Hoz y Costean;261;137;124
22;Huesca;124;Huerto;306;161;145
22;Huesca;125;Huesca;45095;21952;23143
22;Huesca;126;Ibieca;112;60;52
22;Huesca;127;Igriés;149;84;65
22;Huesca;128;Ilche;313;160;153
22;Huesca;129;Isábena;280;151;129
22;Huesca;130;Jaca;11091;5464;5627
22;Huesca;131;Jasa;119;66;53
22;Huesca;133;Labuerda;166;86;80
22;Huesca;135;Laluenga;284;149;135
22;Huesca;136;Lalueza;1380;745;635
22;Huesca;137;Lanaja;1751;907;844
22;Huesca;139;Laperdiguera;112;58;54
22;Huesca;141;Lascellas-Ponzano;175;83;92
22;Huesca;142;Lascuarre;172;87;85
22;Huesca;143;Laspaúles;313;177;136
22;Huesca;144;Laspuña;301;163;138
22;Huesca;149;Loarre;412;219;193
22;Huesca;150;Loporzano;600;305;295
22;Huesca;151;Loscorrales;132;71;61
22;Huesca;905;Lupiñén-Ortilla;377;200;177
22;Huesca;155;Monesma y Cajigar;105;51;54
22;Huesca;156;Monflorite-Lascasas;183;102;81
22;Huesca;157;Montanuy;329;188;141
22;Huesca;158;Monzón;14869;7502;7367
22;Huesca;160;Naval;286;145;141
22;Huesca;162;Novales;188;91;97
22;Huesca;163;Nueno;219;117;102
22;Huesca;164;Olvena;55;25;30
22;Huesca;165;Ontiñena;745;378;367
22;Huesca;167;Osso de Cinca;737;383;354
22;Huesca;168;Palo;33;19;14
22;Huesca;170;Panticosa;619;319;300
22;Huesca;172;Peñalba;802;396;406
22;Huesca;173;Peñas de Riglos (Las);301;161;140
22;Huesca;174;Peralta de Alcofea;769;385;384
22;Huesca;175;Peralta de Calasanz;337;185;152
22;Huesca;176;Peraltilla;167;89;78
22;Huesca;177;Perarrúa;160;78;82
22;Huesca;178;Pertusa;159;77;82
22;Huesca;181;Piracés;104;63;41
22;Huesca;182;Plan;297;166;131
22;Huesca;184;Poleñino;253;126;127
22;Huesca;186;Pozán de Vero;270;131;139
22;Huesca;187;Puebla de Castro (La);299;156;143
22;Huesca;188;Puente de Montañana;143;74;69
22;Huesca;902;Puente la Reina de Jaca;287;145;142
22;Huesca;189;Puértolas;192;112;80
22;Huesca;190;Pueyo de Araguás (El);179;108;71
22;Huesca;193;Pueyo de Santa Cruz;383;200;183
22;Huesca;195;Quicena;146;71;75
22;Huesca;197;Robres;727;373;354
22;Huesca;199;Sabiñánigo;9008;4620;4388
22;Huesca;200;Sahún;308;166;142
22;Huesca;201;Salas Altas;415;213;202
22;Huesca;202;Salas Bajas;203;99;104
22;Huesca;203;Salillas;129;67;62
22;Huesca;204;Sallent de Gállego;937;476;461
22;Huesca;205;San Esteban de Litera;696;344;352
22;Huesca;207;San Juan de Plan;170;96;74
22;Huesca;903;San Miguel del Cinca;985;506;479
22;Huesca;206;Sangarrén;296;141;155
22;Huesca;208;Santa Cilia;202;108;94
22;Huesca;209;Santa Cruz de la Serós;158;89;69
22;Huesca;906;Santa María de Dulcis;224;105;119
22;Huesca;212;Santaliestra y San Quílez;102;52;50
22;Huesca;213;Sariñena;4199;2108;2091
22;Huesca;214;Secastilla;184;84;100
22;Huesca;215;Seira;223;109;114
22;Huesca;217;Sena;641;328;313
22;Huesca;218;Senés de Alcubierre;61;29;32
22;Huesca;220;Sesa;289;146;143
22;Huesca;221;Sesué;85;49;36
22;Huesca;222;Siétamo;346;188;158
22;Huesca;223;Sopeira;141;76;65
22;Huesca;904;Sotonera (La);1222;632;590
22;Huesca;225;Tamarite de Litera;4012;1980;2032
22;Huesca;226;Tardienta;1172;600;572
22;Huesca;227;Tella-Sin;308;160;148
22;Huesca;228;Tierz;188;99;89
22;Huesca;229;Tolva;262;144;118
22;Huesca;230;Torla;369;199;170
22;Huesca;232;Torralba de Aragón;144;69;75
22;Huesca;233;Torre la Ribera;117;69;48
22;Huesca;234;Torrente de Cinca;1154;577;577
22;Huesca;235;Torres de Alcanadre;145;85;60
22;Huesca;236;Torres de Barbués;413;216;197
22;Huesca;239;Tramaced;128;75;53
22;Huesca;242;Valfarta;109;55;54
22;Huesca;243;Valle de Bardají;56;29;27
22;Huesca;901;Valle de Hecho;1038;553;485
22;Huesca;244;Valle de Lierp;65;32;33
22;Huesca;245;Velilla de Cinca;516;260;256
22;Huesca;909;Vencillón;517;275;242
22;Huesca;246;Veracruz;120;67;53
22;Huesca;247;Viacamp y Litera;38;24;14
22;Huesca;248;Vicién;123;67;56
22;Huesca;249;Villanova;100;52;48
22;Huesca;250;Villanúa;313;162;151
22;Huesca;251;Villanueva de Sigena;498;258;240
22;Huesca;252;Yebra de Basa;166;100;66
22;Huesca;253;Yésero;56;24;32
22;Huesca;254;Zaidín;1756;896;860
23;Jaén;001;Albanchez de Mágina;1614;802;812
23;Jaén;002;Alcalá la Real;21296;10589;10707
23;Jaén;003;Alcaudete;11623;5766;5857
23;Jaén;004;Aldeaquemada;575;296;279
23;Jaén;005;Andújar;37626;18655;18971
23;Jaén;006;Arjona;5570;2805;2765
23;Jaén;007;Arjonilla;4025;2014;2011
23;Jaén;008;Arquillos;1774;908;866
23;Jaén;009;Baeza;15483;7596;7887
23;Jaén;010;Bailén;17412;8781;8631
23;Jaén;011;Baños de la Encina;2772;1400;1372
23;Jaén;012;Beas de Segura;8552;4306;4246
23;Jaén;902;Bedmar y Garcíez;3442;1717;1725
23;Jaén;014;Begíjar;3149;1581;1568
23;Jaén;015;Bélmez de la Moraleda;2017;1006;1011
23;Jaén;016;Benatae;604;307;297
23;Jaén;017;Cabra del Santo Cristo;2329;1187;1142
23;Jaén;018;Cambil;3519;1845;1674
23;Jaén;019;Campillo de Arenas;2314;1170;1144
23;Jaén;020;Canena;2074;1003;1071
23;Jaén;021;Carboneros;720;354;366
23;Jaén;901;Cárcheles;1590;775;815
23;Jaén;024;Carolina (La);15182;7477;7705
23;Jaén;025;Castellar;3738;1880;1858
23;Jaén;026;Castillo de Locubín;5733;2833;2900
23;Jaén;027;Cazalilla;859;438;421
23;Jaén;028;Cazorla;9066;4441;4625
23;Jaén;029;Chiclana de Segura;1657;842;815
23;Jaén;030;Chilluévar;1934;965;969
23;Jaén;031;Escañuela;1042;521;521
23;Jaén;032;Espelúy;788;382;406
23;Jaén;033;Frailes;1955;987;968
23;Jaén;034;Fuensanta de Martos;3457;1678;1779
23;Jaén;035;Fuerte del Rey;1174;589;585
23;Jaén;037;Génave;783;394;389
23;Jaén;038;Guardia de Jaén (La);1881;971;910
23;Jaén;039;Guarromán;2871;1388;1483
23;Jaén;041;Higuera de Calatrava;745;386;359
23;Jaén;042;Hinojares;598;302;296
23;Jaén;043;Hornos;817;407;410
23;Jaén;044;Huelma;6064;3038;3026
23;Jaén;045;Huesa;2818;1424;1394
23;Jaén;046;Ibros;3206;1603;1603
23;Jaén;047;Iruela (La);2146;1078;1068
23;Jaén;048;Iznatoraf;1277;617;660
23;Jaén;049;Jabalquinto;2722;1336;1386
23;Jaén;050;Jaén;110042;53223;56819
23;Jaén;051;Jamilena;3181;1622;1559
23;Jaén;052;Jimena;1671;819;852
23;Jaén;053;Jódar;12318;6103;6215
23;Jaén;040;Lahiguera;1960;961;999
23;Jaén;054;Larva;571;290;281
23;Jaén;055;Linares;61460;30028;31432
23;Jaén;056;Lopera;4003;1986;2017
23;Jaén;057;Lupión;1160;542;618
23;Jaén;058;Mancha Real;8735;4360;4375
23;Jaén;059;Marmolejo;7523;3773;3750
23;Jaén;060;Martos;21905;10804;11101
23;Jaén;061;Mengíbar;8467;4242;4225
23;Jaén;062;Montizón;2026;1012;1014
23;Jaén;063;Navas de San Juan;5516;2765;2751
23;Jaén;064;Noalejo;2375;1202;1173
23;Jaén;065;Orcera;2436;1238;1198
23;Jaén;066;Peal de Becerro;5396;2685;2711
23;Jaén;067;Pegalajar;3088;1524;1564
23;Jaén;069;Porcuna;7088;3542;3546
23;Jaén;070;Pozo Alcón;6295;3173;3122
23;Jaén;071;Puente de Génave;2077;1047;1030
23;Jaén;072;Puerta de Segura (La);2872;1430;1442
23;Jaén;073;Quesada;6531;3187;3344
23;Jaén;074;Rus;3759;1882;1877
23;Jaén;075;Sabiote;4329;2116;2213
23;Jaén;076;Santa Elena;1102;584;518
23;Jaén;077;Santiago de Calatrava;994;502;492
23;Jaén;904;Santiago-Pontones;5031;2563;2468
23;Jaén;079;Santisteban del Puerto;5020;2567;2453
23;Jaén;080;Santo Tomé;2622;1314;1308
23;Jaén;081;Segura de la Sierra;2281;1153;1128
23;Jaén;082;Siles;2915;1486;1429
23;Jaén;084;Sorihuela del Guadalimar;1358;667;691
23;Jaén;086;Torre del Campo;11689;5753;5936
23;Jaén;085;Torreblascopedro;3014;1497;1517
23;Jaén;087;Torredonjimeno;13699;6729;6970
23;Jaén;088;Torreperogil;7815;3833;3982
23;Jaén;090;Torres;1951;989;962
23;Jaén;091;Torres de Albánchez;1143;566;577
23;Jaén;092;Úbeda;31434;15451;15983
23;Jaén;093;Valdepeñas de Jaén;4646;2330;2316
23;Jaén;094;Vilches;5101;2555;2546
23;Jaén;095;Villacarrillo;12000;5957;6043
23;Jaén;096;Villanueva de la Reina;3330;1653;1677
23;Jaén;097;Villanueva del Arzobispo;8845;4309;4536
23;Jaén;098;Villardompardo;1314;636;678
23;Jaén;099;Villares (Los);4613;2280;2333
23;Jaén;101;Villarrodrigo;714;351;363
23;Jaén;903;Villatorres;4085;2028;2057
24;León;001;Acebedo;414;215;199
24;León;002;Algadefe;409;204;205
24;León;003;Alija del Infantado;1079;543;536
24;León;004;Almanza;879;455;424
24;León;005;Antigua (La);758;400;358
24;León;006;Ardón;804;413;391
24;León;007;Arganza;1140;545;595
24;León;008;Astorga;12715;6069;6646
24;León;009;Balboa;593;309;284
24;León;010;Bañeza (La);10244;5003;5241
24;León;011;Barjas;686;363;323
24;León;012;Barrios de Luna (Los);401;193;208
24;León;014;Bembibre;11276;5629;5647
24;León;015;Benavides;3243;1670;1573
24;León;016;Benuza;832;429;403
24;León;017;Bercianos del Páramo;952;478;474
24;León;018;Bercianos del Real Camino;277;137;140
24;León;019;Berlanga del Bierzo;491;241;250
24;León;020;Boca de Huérgano;724;394;330
24;León;021;Boñar;2845;1397;1448
24;León;022;Borrenes;609;312;297
24;León;023;Brazuelo;374;187;187
24;León;024;Burgo Ranero (El);1118;591;527
24;León;025;Burón;548;286;262
24;León;026;Bustillo del Páramo;2136;1067;1069
24;León;027;Cabañas Raras;1400;724;676
24;León;028;Cabreros del Río;692;361;331
24;León;029;Cabrillanes;1316;642;674
24;León;030;Cacabelos;5039;2582;2457
24;León;031;Calzada del Coto;330;185;145
24;León;032;Campazas;212;100;112
24;León;033;Campo de Villavidel;412;215;197
24;León;034;Camponaraya;3149;1528;1621
24;León;036;Candín;591;321;270
24;León;037;Cármenes;497;241;256
24;León;038;Carracedelo;3565;1789;1776
24;León;039;Carrizo;2872;1439;1433
24;León;040;Carrocera;641;307;334
24;León;041;Carucedo;698;327;371
24;León;042;Castilfalé;128;68;60
24;León;043;Castrillo de Cabrera;306;152;154
24;León;044;Castrillo de la Valduerna;303;135;168
24;León;046;Castrocalbón;1470;752;718
24;León;047;Castrocontrigo;1435;715;720
24;León;049;Castropodame;1952;985;967
24;León;050;Castrotierra de Valmadrigal;177;91;86
24;León;051;Cea;846;440;406
24;León;052;Cebanico;302;163;139
24;León;053;Cebrones del Río;807;407;400
24;León;065;Chozas de Abajo;2250;1177;1073
24;León;054;Cimanes de la Vega;766;381;385
24;León;055;Cimanes del Tejar;1207;604;603
24;León;056;Cistierna;4980;2508;2472
24;León;057;Congosto;1972;969;1003
24;León;058;Corbillos de los Oteros;377;187;190
24;León;059;Corullón;1522;755;767
24;León;060;Crémenes;1622;791;831
24;León;061;Cuadros;1722;823;899
24;León;062;Cubillas de los Oteros;256;125;131
24;León;063;Cubillas de Rueda;746;372;374
24;León;064;Cubillos del Sil;1545;795;750
24;León;066;Destriana;1119;546;573
24;León;067;Encinedo;1109;581;528
24;León;068;Ercina (La);882;424;458
24;León;069;Escobar de Campos;100;57;43
24;León;070;Fabero;6547;3282;3265
24;León;071;Folgoso de la Ribera;1581;785;796
24;León;072;Fresnedo;"";"";""
24;León;073;Fresno de la Vega;787;396;391
24;León;074;Fuentes de Carbajal;164;86;78
24;León;076;Garrafe de Torío;1122;562;560
24;León;077;Gordaliza del Pino;444;221;223
24;León;078;Gordoncillo;694;338;356
24;León;079;Gradefes;1619;790;829
24;León;080;Grajal de Campos;335;137;198
24;León;081;Gusendos de los Oteros;273;138;135
24;León;082;Hospital de Órbigo;1223;602;621
24;León;083;Igüeña;2406;1265;1141
24;León;084;Izagre;326;153;173
24;León;086;Joarilla de las Matas;516;271;245
24;León;087;Laguna Dalga;1075;540;535
24;León;088;Laguna de Negrillos;1741;880;861
24;León;089;León;146175;69134;77041
24;León;092;Llamas de la Ribera;1385;706;679
24;León;090;Lucillo;595;299;296
24;León;091;Luyego;1039;496;543
24;León;093;Magaz de Cepeda;659;313;346
24;León;094;Mansilla de las Mulas;1769;867;902
24;León;095;Mansilla Mayor;459;232;227
24;León;096;Maraña;206;102;104
24;León;097;Matadeón de los Oteros;393;191;202
24;León;098;Matallana de Torío;2049;1018;1031
24;León;099;Matanza;400;191;209
24;León;100;Molinaseca;771;393;378
24;León;101;Murias de Paredes;872;415;457
24;León;102;Noceda del Bierzo;1010;493;517
24;León;103;Oencia;536;288;248
24;León;104;Omañas (Las);529;263;266
24;León;105;Onzonilla;1442;710;732
24;León;106;Oseja de Sajambre;383;216;167
24;León;107;Pajares de los Oteros;466;238;228
24;León;108;Palacios de la Valduerna;642;311;331
24;León;109;Palacios del Sil;1676;843;833
24;León;110;Páramo del Sil;2254;1148;1106
24;León;111;Pedrosa del Rey;"";"";""
24;León;112;Peranzanes;390;202;188
24;León;113;Pobladura de Pelayo García;698;361;337
24;León;114;Pola de Gordón (La);5892;2886;3006
24;León;115;Ponferrada;60975;29814;31161
24;León;116;Posada de Valdeón;548;287;261
24;León;117;Pozuelo del Páramo;733;384;349
24;León;118;Prado de la Guzpeña;199;106;93
24;León;119;Priaranza del Bierzo;1059;546;513
24;León;120;Prioro;561;293;268
24;León;121;Puebla de Lillo;764;406;358
24;León;122;Puente de Domingo Flórez;2098;1101;997
24;León;123;Quintana del Castillo;1363;715;648
24;León;124;Quintana del Marco;662;336;326
24;León;125;Quintana y Congosto;987;516;471
24;León;127;Regueras de Arriba;467;244;223
24;León;129;Reyero;191;105;86
24;León;130;Riaño;571;308;263
24;León;131;Riego de la Vega;1244;608;636
24;León;132;Riello;1318;657;661
24;León;133;Rioseco de Tapia;646;346;300
24;León;134;Robla (La);5575;2818;2757
24;León;136;Roperuelos del Páramo;952;486;466
24;León;137;Sabero;2359;1161;1198
24;León;139;Sahagún;3371;1683;1688
24;León;141;San Adrián del Valle;229;104;125
24;León;142;San Andrés del Rabanedo;20950;10262;10688
24;León;144;San Cristóbal de la Polantera;1266;636;630
24;León;145;San Emiliano;1072;528;544
24;León;146;San Esteban de Nogales;541;251;290
24;León;148;San Justo de la Vega;2415;1208;1207
24;León;149;San Millán de los Caballeros;218;103;115
24;León;150;San Pedro Bercianos;417;206;211
24;León;143;Sancedo;703;353;350
24;León;151;Santa Colomba de Curueño;814;384;430
24;León;152;Santa Colomba de Somoza;524;265;259
24;León;153;Santa Cristina de Valmadrigal;453;228;225
24;León;154;Santa Elena de Jamuz;1565;791;774
24;León;155;Santa María de la Isla;821;433;388
24;León;158;Santa María de Ordás;556;279;277
24;León;156;Santa María del Monte de Cea;488;243;245
24;León;157;Santa María del Páramo;3195;1522;1673
24;León;159;Santa Marina del Rey;2796;1411;1385
24;León;160;Santas Martas;1182;608;574
24;León;161;Santiago Millas;405;203;202
24;León;162;Santovenia de la Valdoncina;1329;635;694
24;León;163;Sariegos;1739;864;875
24;León;164;Sena de Luna;627;309;318
24;León;165;Sobrado;617;307;310
24;León;166;Soto de la Vega;2189;1107;1082
24;León;167;Soto y Amío;1312;637;675
24;León;168;Toral de los Guzmanes;802;407;395
24;León;169;Toreno;5052;2635;2417
24;León;170;Torre del Bierzo;3612;1810;1802
24;León;171;Trabadelo;742;394;348
24;León;172;Truchas;1153;580;573
24;León;173;Turcia;1610;818;792
24;León;174;Urdiales del Páramo;901;453;448
24;León;185;Val de San Lorenzo;839;410;429
24;León;175;Valdefresno;1603;805;798
24;León;176;Valdefuentes del Páramo;527;268;259
24;León;177;Valdelugueros;468;238;230
24;León;178;Valdemora;136;70;66
24;León;179;Valdepiélago;470;228;242
24;León;180;Valdepolo;1801;934;867
24;León;181;Valderas;2388;1210;1178
24;León;182;Valderrey;751;370;381
24;León;183;Valderrueda;1559;772;787
24;León;184;Valdesamario;370;182;188
24;León;187;Valdevimbre;1365;701;664
24;León;188;Valencia de Don Juan;3884;1950;1934
24;León;191;Vallecillo;218;114;104
24;León;189;Valverde de la Virgen;3682;1807;1875
24;León;190;Valverde-Enrique;284;143;141
24;León;193;Vecilla (La);467;230;237
24;León;196;Vega de Espinareda;3261;1661;1600
24;León;197;Vega de Infanzones;878;433;445
24;León;198;Vega de Valcarce;1155;588;567
24;León;194;Vegacervera;407;214;193
24;León;199;Vegaquemada;650;310;340
24;León;201;Vegas del Condado;1598;801;797
24;León;202;Villablino;16215;8184;8031
24;León;203;Villabraz;194;100;94
24;León;205;Villadangos del Páramo;1027;502;525
24;León;206;Villadecanes;2466;1249;1217
24;León;207;Villademor de la Vega;538;278;260
24;León;209;Villafranca del Bierzo;4199;2104;2095
24;León;210;Villagatón;1056;537;519
24;León;211;Villamandos;530;255;275
24;León;901;Villamanín;1518;754;764
24;León;212;Villamañán;1603;805;798
24;León;213;Villamartín de Don Sancho;256;132;124
24;León;214;Villamejil;1112;564;548
24;León;215;Villamol;297;154;143
24;León;216;Villamontán de la Valduerna;1284;643;641
24;León;217;Villamoratiel de las Matas;236;132;104
24;León;218;Villanueva de las Manzanas;692;327;365
24;León;219;Villaobispo de Otero;794;404;390
24;León;902;Villaornate y Castro;615;320;295
24;León;221;Villaquejida;1157;598;559
24;León;222;Villaquilambre;5823;2889;2934
24;León;223;Villarejo de Órbigo;3703;1815;1888
24;León;224;Villares de Órbigo;1067;545;522
24;León;225;Villasabariego;1277;636;641
24;León;226;Villaselán;391;210;181
24;León;227;Villaturiel;1774;897;877
24;León;228;Villazala;1221;630;591
24;León;229;Villazanzo de Valderaduey;797;425;372
24;León;230;Zotes del Páramo;827;423;404
25;Lleida;001;Abella de la Conca;157;82;75
25;Lleida;002;Àger;601;321;280
25;Lleida;003;Agramunt;4862;2440;2422
25;Lleida;038;Aitona;2407;1266;1141
25;Lleida;004;Alamús (Els);659;339;320
25;Lleida;005;Alàs i Cerc;400;219;181
25;Lleida;006;Albagés (L');553;273;280
25;Lleida;007;Albatàrrec;1008;476;532
25;Lleida;008;Albesa;1474;736;738
25;Lleida;009;Albi (L');776;396;380
25;Lleida;010;Alcanó;277;137;140
25;Lleida;011;Alcarràs;4562;2265;2297
25;Lleida;012;Alcoletge;1553;791;762
25;Lleida;013;Alfarràs;3038;1497;1541
25;Lleida;014;Alfés;346;185;161
25;Lleida;015;Algerri;556;275;281
25;Lleida;016;Alguaire;2865;1443;1422
25;Lleida;017;Alins;298;154;144
25;Lleida;019;Almacelles;5536;2840;2696
25;Lleida;020;Almatret;534;281;253
25;Lleida;021;Almenar;3618;1850;1768
25;Lleida;022;Alòs de Balaguer;160;94;66
25;Lleida;023;Alpicat;2793;1415;1378
25;Lleida;024;Alt Àneu;361;199;162
25;Lleida;027;Anglesola;1259;615;644
25;Lleida;029;Arbeca;2318;1152;1166
25;Lleida;031;Arres;95;48;47
25;Lleida;032;Arsèguel;112;57;55
25;Lleida;033;Artesa de Lleida;1222;601;621
25;Lleida;034;Artesa de Segre;3135;1604;1531
25;Lleida;036;Aspa;248;123;125
25;Lleida;037;Avellanes i Santa Linya (Les);472;252;220
25;Lleida;039;Baix Pallars;353;199;154
25;Lleida;040;Balaguer;13108;6477;6631
25;Lleida;041;Barbens;789;408;381
25;Lleida;042;Baronia de Rialb (La);261;139;122
25;Lleida;044;Bassella;368;184;184
25;Lleida;045;Bausen;70;42;28
25;Lleida;046;Belianes;568;266;302
25;Lleida;170;Bellaguarda;376;192;184
25;Lleida;047;Bellcaire d'Urgell;1408;679;729
25;Lleida;048;Bell-lloc d'Urgell;2198;1101;1097
25;Lleida;049;Bellmunt d'Urgell;239;121;118
25;Lleida;050;Bellpuig;3908;1940;1968
25;Lleida;051;Bellver de Cerdanya;1573;814;759
25;Lleida;052;Bellvís;2223;1104;1119
25;Lleida;053;Benavent de Segrià;757;388;369
25;Lleida;055;Biosca;270;134;136
25;Lleida;057;Bòrdes (Es);197;97;100
25;Lleida;058;Borges Blanques (Les);5185;2573;2612
25;Lleida;059;Bossòst;829;401;428
25;Lleida;056;Bovera;443;221;222
25;Lleida;060;Cabanabona;105;49;56
25;Lleida;061;Cabó;141;76;65
25;Lleida;062;Camarasa;917;463;454
25;Lleida;063;Canejan;107;57;50
25;Lleida;904;Castell de Mur;152;76;76
25;Lleida;064;Castellar de la Ribera;152;74;78
25;Lleida;067;Castelldans;988;513;475
25;Lleida;068;Castellnou de Seana;726;347;379
25;Lleida;069;Castelló de Farfanya;613;306;307
25;Lleida;070;Castellserà;1163;576;587
25;Lleida;071;Cava;53;32;21
25;Lleida;072;Cervera;7176;3555;3621
25;Lleida;073;Cervià de les Garrigues;832;423;409
25;Lleida;074;Ciutadilla;223;113;110
25;Lleida;075;Clariana de Cardener;142;74;68
25;Lleida;076;Cogul (El);233;118;115
25;Lleida;077;Coll de Nargó;615;320;295
25;Lleida;163;Coma i la Pedra (La);253;151;102
25;Lleida;161;Conca de Dalt;476;246;230
25;Lleida;078;Corbins;1021;524;497
25;Lleida;079;Cubells;377;192;185
25;Lleida;081;Espluga Calba (L');446;235;211
25;Lleida;082;Espot;242;119;123
25;Lleida;088;Estamariu;135;70;65
25;Lleida;085;Estaràs;163;83;80
25;Lleida;086;Esterri d'Àneu;499;248;251
25;Lleida;087;Esterri de Cardós;68;36;32
25;Lleida;089;Farrera;92;50;42
25;Lleida;908;Fígols i Alinyà;347;193;154
25;Lleida;092;Floresta (La);202;104;98
25;Lleida;093;Fondarella;634;306;328
25;Lleida;094;Foradada;161;89;72
25;Lleida;096;Fuliola (La);1316;670;646
25;Lleida;097;Fulleda;129;68;61
25;Lleida;098;Gavet de la Conca;367;187;180
25;Lleida;912;Gimenells i el Pla de la Font;1191;627;564
25;Lleida;099;Golmés;1298;632;666
25;Lleida;100;Gósol;196;104;92
25;Lleida;101;Granadella (La);841;420;421
25;Lleida;102;Granja d'Escarp (La);1141;576;565
25;Lleida;103;Granyanella;138;72;66
25;Lleida;105;Granyena de les Garrigues;177;85;92
25;Lleida;104;Granyena de Segarra;171;89;82
25;Lleida;109;Guimerà;419;206;213
25;Lleida;903;Guingueta d'Àneu (La);261;132;129
25;Lleida;110;Guissona;2847;1463;1384
25;Lleida;111;Guixers;158;96;62
25;Lleida;115;Isona i Conca Dellà;1341;697;644
25;Lleida;112;Ivars de Noguera;342;171;171
25;Lleida;113;Ivars d'Urgell;1735;857;878
25;Lleida;114;Ivorra;143;77;66
25;Lleida;910;Josa i Tuixén;148;76;72
25;Lleida;118;Juncosa;581;302;279
25;Lleida;119;Juneda;3010;1528;1482
25;Lleida;121;Les;682;341;341
25;Lleida;122;Linyola;2375;1193;1182
25;Lleida;123;Lladorre;220;118;102
25;Lleida;124;Lladurs;259;140;119
25;Lleida;125;Llardecans;662;335;327
25;Lleida;126;Llavorsí;276;147;129
25;Lleida;120;Lleida;113686;55565;58121
25;Lleida;127;Lles de Cerdanya;301;163;138
25;Lleida;128;Llimiana;125;64;61
25;Lleida;129;Llobera;253;129;124
25;Lleida;133;Maials;1058;535;523
25;Lleida;130;Maldà;324;165;159
25;Lleida;131;Massalcoreig;667;323;344
25;Lleida;132;Massoteres;154;75;79
25;Lleida;134;Menàrguens;881;443;438
25;Lleida;135;Miralcamp;1223;590;633
25;Lleida;137;Mollerussa;9185;4561;4624
25;Lleida;136;Molsosa (La);135;68;67
25;Lleida;139;Montellà i Martinet;526;274;252
25;Lleida;140;Montferrer i Castellbò;663;359;304
25;Lleida;138;Montgai;850;431;419
25;Lleida;142;Montoliu de Lleida;460;228;232
25;Lleida;141;Montoliu de Segarra;208;110;98
25;Lleida;143;Montornès de Segarra;120;54;66
25;Lleida;145;Nalec;108;48;60
25;Lleida;025;Naut Aran;1212;657;555
25;Lleida;146;Navès;279;142;137
25;Lleida;148;Odèn;308;170;138
25;Lleida;149;Oliana;1970;1013;957
25;Lleida;150;Oliola;195;100;95
25;Lleida;151;Olius;510;252;258
25;Lleida;152;Oluges (Les);208;106;102
25;Lleida;153;Omellons (Els);265;136;129
25;Lleida;154;Omells de na Gaia (Els);150;80;70
25;Lleida;155;Organyà;1044;532;512
25;Lleida;156;Os de Balaguer;788;414;374
25;Lleida;157;Ossó de Sió;243;123;120
25;Lleida;158;Palau d'Anglesola (El);1622;818;804
25;Lleida;164;Penelles;558;301;257
25;Lleida;165;Peramola;398;206;192
25;Lleida;166;Pinell de Solsonès;257;136;121
25;Lleida;167;Pinós;340;185;155
25;Lleida;911;Plans de Sió (Els);656;332;324
25;Lleida;168;Poal (El);638;330;308
25;Lleida;169;Pobla de Cérvoles (La);215;118;97
25;Lleida;171;Pobla de Segur (La);3112;1511;1601
25;Lleida;030;Pont de Bar (El);162;89;73
25;Lleida;173;Pont de Suert (El);2296;1156;1140
25;Lleida;172;Ponts;2242;1119;1123
25;Lleida;174;Portella (La);616;315;301
25;Lleida;175;Prats i Sansor;149;80;69
25;Lleida;176;Preixana;469;242;227
25;Lleida;177;Preixens;549;267;282
25;Lleida;179;Prullans;210;111;99
25;Lleida;180;Puiggròs;261;129;132
25;Lleida;181;Puigverd d'Agramunt;242;126;116
25;Lleida;182;Puigverd de Lleida;962;466;496
25;Lleida;183;Rialp;567;296;271
25;Lleida;905;Ribera d'Ondara;481;241;240
25;Lleida;185;Ribera d'Urgellet;811;426;385
25;Lleida;186;Riner;261;136;125
25;Lleida;913;Riu de Cerdanya;"";"";""
25;Lleida;189;Rosselló;1662;817;845
25;Lleida;190;Salàs de Pallars;337;175;162
25;Lleida;191;Sanaüja;460;224;236
25;Lleida;196;Sant Esteve de la Sarga;96;59;37
25;Lleida;192;Sant Guim de Freixenet;1074;536;538
25;Lleida;197;Sant Guim de la Plana;188;98;90
25;Lleida;193;Sant Llorenç de Morunys;865;449;416
25;Lleida;902;Sant Martí de Riucorb;778;401;377
25;Lleida;194;Sant Ramon;574;287;287
25;Lleida;201;Sarroca de Bellera;136;78;58
25;Lleida;200;Sarroca de Lleida;491;257;234
25;Lleida;202;Senterada;111;66;45
25;Lleida;035;Sentiu de Sió (La);470;227;243
25;Lleida;204;Seròs;1884;999;885
25;Lleida;203;Seu d'Urgell (La);10348;5132;5216
25;Lleida;205;Sidamon;457;229;228
25;Lleida;206;Soleràs (El);444;222;222
25;Lleida;207;Solsona;6919;3478;3441
25;Lleida;208;Soriguera;291;155;136
25;Lleida;209;Sort;1586;809;777
25;Lleida;210;Soses;1520;778;742
25;Lleida;211;Sudanell;728;388;340
25;Lleida;212;Sunyer;313;153;160
25;Lleida;215;Talarn;367;185;182
25;Lleida;216;Talavera;309;158;151
25;Lleida;217;Tàrrega;11443;5567;5876
25;Lleida;218;Tarrés;101;53;48
25;Lleida;219;Tarroja de Segarra;194;94;100
25;Lleida;220;Térmens;1426;713;713
25;Lleida;221;Tírvia;105;57;48
25;Lleida;222;Tiurana;226;123;103
25;Lleida;223;Torà;1149;586;563
25;Lleida;224;Torms (Els);210;114;96
25;Lleida;225;Tornabous;840;416;424
25;Lleida;227;Torre de Cabdella (La);740;361;379
25;Lleida;226;Torrebesses;361;180;181
25;Lleida;228;Torrefarrera;1534;780;754
25;Lleida;907;Torrefeta i Florejacs;710;351;359
25;Lleida;230;Torregrossa;2229;1102;1127
25;Lleida;231;Torrelameu;590;314;276
25;Lleida;232;Torres de Segre;1823;934;889
25;Lleida;233;Torre-serona;299;149;150
25;Lleida;234;Tremp;5294;2588;2706
25;Lleida;043;Vall de Boí (La);681;372;309
25;Lleida;901;Vall de Cardós;334;169;165
25;Lleida;238;Vallbona de les Monges;286;138;148
25;Lleida;240;Vallfogona de Balaguer;1418;710;708
25;Lleida;906;Valls d'Aguilar (Les);236;125;111
25;Lleida;239;Valls de Valira (Les);807;424;383
25;Lleida;909;Vansa i Fórnols (La);178;92;86
25;Lleida;242;Verdú;936;461;475
25;Lleida;243;Vielha e Mijaran;3468;1749;1719
25;Lleida;244;Vilagrassa;437;218;219
25;Lleida;245;Vilaller;618;324;294
25;Lleida;247;Vilamòs;131;66;65
25;Lleida;248;Vilanova de Bellpuig;1177;565;612
25;Lleida;254;Vilanova de la Barca;911;463;448
25;Lleida;249;Vilanova de l'Aguda;282;146;136
25;Lleida;250;Vilanova de Meià;501;250;251
25;Lleida;251;Vilanova de Segrià;687;343;344
25;Lleida;252;Vila-sana;523;256;267
25;Lleida;253;Vilosell (El);209;90;119
25;Lleida;255;Vinaixa;724;357;367
26;Rioja (La);001;Ábalos;287;160;127
26;Rioja (La);002;Agoncillo;904;476;428
26;Rioja (La);003;Aguilar del Río Alhama;816;421;395
26;Rioja (La);004;Ajamil;71;46;25
26;Rioja (La);005;Albelda de Iregua;2205;1117;1088
26;Rioja (La);006;Alberite;1956;987;969
26;Rioja (La);007;Alcanadre;883;450;433
26;Rioja (La);008;Aldeanueva de Ebro;2525;1294;1231
26;Rioja (La);009;Alesanco;570;291;279
26;Rioja (La);010;Alesón;159;77;82
26;Rioja (La);011;Alfaro;9341;4668;4673
26;Rioja (La);012;Almarza de Cameros;38;21;17
26;Rioja (La);013;Anguciana;313;160;153
26;Rioja (La);014;Anguiano;666;367;299
26;Rioja (La);015;Arenzana de Abajo;384;200;184
26;Rioja (La);016;Arenzana de Arriba;46;25;21
26;Rioja (La);017;Arnedillo;417;201;216
26;Rioja (La);018;Arnedo;12521;6227;6294
26;Rioja (La);019;Arrúbal;409;216;193
26;Rioja (La);020;Ausejo;740;391;349
26;Rioja (La);021;Autol;3403;1721;1682
26;Rioja (La);022;Azofra;398;208;190
26;Rioja (La);023;Badarán;803;424;379
26;Rioja (La);024;Bañares;478;242;236
26;Rioja (La);026;Baños de Río Tobía;1886;959;927
26;Rioja (La);025;Baños de Rioja;131;76;55
26;Rioja (La);027;Berceo;257;148;109
26;Rioja (La);028;Bergasa;205;110;95
26;Rioja (La);029;Bergasillas Bajera;30;15;15
26;Rioja (La);030;Bezares;30;20;10
26;Rioja (La);031;Bobadilla;187;93;94
26;Rioja (La);032;Brieva de Cameros;77;44;33
26;Rioja (La);033;Briñas;192;96;96
26;Rioja (La);034;Briones;925;488;437
26;Rioja (La);035;Cabezón de Cameros;36;21;15
26;Rioja (La);036;Calahorra;19182;9282;9900
26;Rioja (La);037;Camprovín;259;137;122
26;Rioja (La);038;Canales de la Sierra;100;50;50
26;Rioja (La);039;Canillas de Río Tuerto;78;36;42
26;Rioja (La);040;Cañas;125;57;68
26;Rioja (La);041;Cárdenas;257;129;128
26;Rioja (La);042;Casalarreina;925;464;461
26;Rioja (La);043;Castañares de Rioja;528;277;251
26;Rioja (La);044;Castroviejo;52;25;27
26;Rioja (La);045;Cellorigo;18;11;7
26;Rioja (La);046;Cenicero;2171;1087;1084
26;Rioja (La);047;Cervera del Río Alhama;3386;1685;1701
26;Rioja (La);048;Cidamón;82;46;36
26;Rioja (La);049;Cihuri;187;102;85
26;Rioja (La);050;Cirueña;130;76;54
26;Rioja (La);051;Clavijo;195;101;94
26;Rioja (La);052;Cordovín;246;124;122
26;Rioja (La);053;Corera;251;121;130
26;Rioja (La);054;Cornago;707;387;320
26;Rioja (La);055;Corporales;72;37;35
26;Rioja (La);056;Cuzcurrita de Río Tirón;493;263;230
26;Rioja (La);057;Daroca de Rioja;59;37;22
26;Rioja (La);058;Enciso;193;113;80
26;Rioja (La);059;Entrena;1123;592;531
26;Rioja (La);060;Estollo;166;90;76
26;Rioja (La);061;Ezcaray;1801;956;845
26;Rioja (La);062;Foncea;149;81;68
26;Rioja (La);063;Fonzaleche;196;111;85
26;Rioja (La);064;Fuenmayor;2114;1046;1068
26;Rioja (La);065;Galbárruli;62;35;27
26;Rioja (La);066;Galilea;291;154;137
26;Rioja (La);067;Gallinero de Cameros;25;16;9
26;Rioja (La);068;Gimileo;91;45;46
26;Rioja (La);069;Grañón;481;254;227
26;Rioja (La);070;Grávalos;302;157;145
26;Rioja (La);071;Haro;8882;4358;4524
26;Rioja (La);072;Herce;379;191;188
26;Rioja (La);073;Herramélluri;190;100;90
26;Rioja (La);074;Hervías;225;119;106
26;Rioja (La);075;Hormilla;488;256;232
26;Rioja (La);076;Hormilleja;191;96;95
26;Rioja (La);077;Hornillos de Cameros;30;15;15
26;Rioja (La);078;Hornos de Moncalvillo;107;57;50
26;Rioja (La);079;Huércanos;933;476;457
26;Rioja (La);080;Igea;945;508;437
26;Rioja (La);081;Jalón de Cameros;47;26;21
26;Rioja (La);082;Laguna de Cameros;181;98;83
26;Rioja (La);083;Lagunilla del Jubera;366;192;174
26;Rioja (La);084;Lardero;3175;1584;1591
26;Rioja (La);086;Ledesma de la Cogolla;21;12;9
26;Rioja (La);087;Leiva;360;176;184
26;Rioja (La);088;Leza de Río Leza;42;26;16
26;Rioja (La);089;Logroño;123848;59828;64020
26;Rioja (La);091;Lumbreras;189;107;82
26;Rioja (La);092;Manjarrés;147;79;68
26;Rioja (La);093;Mansilla de la Sierra;51;31;20
26;Rioja (La);094;Manzanares de Rioja;149;79;70
26;Rioja (La);095;Matute;188;92;96
26;Rioja (La);096;Medrano;243;131;112
26;Rioja (La);098;Munilla;142;64;78
26;Rioja (La);099;Murillo de Río Leza;1594;801;793
26;Rioja (La);100;Muro de Aguas;71;40;31
26;Rioja (La);101;Muro en Cameros;43;30;13
26;Rioja (La);102;Nájera;7056;3521;3535
26;Rioja (La);103;Nalda;905;466;439
26;Rioja (La);104;Navajún;21;14;7
26;Rioja (La);105;Navarrete;2034;1035;999
26;Rioja (La);106;Nestares;65;35;30
26;Rioja (La);107;Nieva de Cameros;123;64;59
26;Rioja (La);109;Ochánduri;115;58;57
26;Rioja (La);108;Ocón;343;187;156
26;Rioja (La);110;Ojacastro;234;135;99
26;Rioja (La);111;Ollauri;308;168;140
26;Rioja (La);112;Ortigosa de Cameros;352;174;178
26;Rioja (La);113;Pazuengos;46;28;18
26;Rioja (La);114;Pedroso;116;62;54
26;Rioja (La);115;Pinillos;28;17;11
26;Rioja (La);117;Pradejón;2842;1446;1396
26;Rioja (La);118;Pradillo;120;63;57
26;Rioja (La);119;Préjano;220;102;118
26;Rioja (La);120;Quel;2010;1050;960
26;Rioja (La);121;Rabanera;45;23;22
26;Rioja (La);122;Rasillo de Cameros (El);129;68;61
26;Rioja (La);123;Redal (El);232;116;116
26;Rioja (La);124;Ribafrecha;1080;581;499
26;Rioja (La);125;Rincón de Soto;3356;1683;1673
26;Rioja (La);126;Robres del Castillo;24;14;10
26;Rioja (La);127;Rodezno;364;183;181
26;Rioja (La);128;Sajazarra;169;86;83
26;Rioja (La);129;San Asensio;1398;726;672
26;Rioja (La);130;San Millán de la Cogolla;307;183;124
26;Rioja (La);131;San Millán de Yécora;77;47;30
26;Rioja (La);132;San Román de Cameros;194;102;92
26;Rioja (La);139;San Torcuato;136;73;63
26;Rioja (La);142;San Vicente de la Sonsierra;1153;595;558
26;Rioja (La);134;Santa Coloma;163;100;63
26;Rioja (La);135;Santa Engracia del Jubera;192;114;78
26;Rioja (La);136;Santa Eulalia Bajera;111;62;49
26;Rioja (La);138;Santo Domingo de la Calzada;5695;2873;2822
26;Rioja (La);140;Santurde de Rioja;327;163;164
26;Rioja (La);141;Santurdejo;254;138;116
26;Rioja (La);143;Sojuela;96;56;40
26;Rioja (La);144;Sorzano;270;147;123
26;Rioja (La);145;Sotés;288;154;134
26;Rioja (La);146;Soto en Cameros;138;74;64
26;Rioja (La);147;Terroba;35;20;15
26;Rioja (La);148;Tirgo;296;149;147
26;Rioja (La);149;Tobía;66;39;27
26;Rioja (La);150;Tormantos;227;116;111
26;Rioja (La);153;Torre en Cameros;17;12;5
26;Rioja (La);151;Torrecilla en Cameros;536;279;257
26;Rioja (La);152;Torrecilla sobre Alesanco;109;56;53
26;Rioja (La);154;Torremontalbo;17;10;7
26;Rioja (La);155;Treviana;320;173;147
26;Rioja (La);157;Tricio;389;191;198
26;Rioja (La);158;Tudelilla;506;254;252
26;Rioja (La);160;Uruñuela;729;381;348
26;Rioja (La);161;Valdemadera;16;10;6
26;Rioja (La);162;Valgañón;180;97;83
26;Rioja (La);163;Ventosa;144;73;71
26;Rioja (La);164;Ventrosa;98;40;58
26;Rioja (La);165;Viguera;424;227;197
26;Rioja (La);166;Villalba de Rioja;176;99;77
26;Rioja (La);167;Villalobar de Rioja;141;80;61
26;Rioja (La);168;Villamediana de Iregua;1875;961;914
26;Rioja (La);169;Villanueva de Cameros;123;61;62
26;Rioja (La);170;Villar de Arnedo (El);745;370;375
26;Rioja (La);171;Villar de Torre;366;187;179
26;Rioja (La);172;Villarejo;47;29;18
26;Rioja (La);173;Villarroya;10;4;6
26;Rioja (La);174;Villarta-Quintana;233;117;116
26;Rioja (La);175;Villavelayo;80;46;34
26;Rioja (La);176;Villaverde de Rioja;93;52;41
26;Rioja (La);177;Villoslada de Cameros;403;227;176
26;Rioja (La);178;Viniegra de Abajo;145;76;69
26;Rioja (La);179;Viniegra de Arriba;46;26;20
26;Rioja (La);180;Zarratón;303;156;147
26;Rioja (La);181;Zarzosa;17;12;5
26;Rioja (La);183;Zorraquín;40;25;15
27;Lugo;001;Abadín;4033;1925;2108
27;Lugo;002;Alfoz;2676;1305;1371
27;Lugo;003;Antas de Ulla;3281;1600;1681
27;Lugo;004;Baleira;2171;1140;1031
27;Lugo;901;Baralla;3810;1937;1873
27;Lugo;005;Barreiros;3766;1804;1962
27;Lugo;006;Becerreá;4097;2087;2010
27;Lugo;007;Begonte;4544;2254;2290
27;Lugo;008;Bóveda;2317;1121;1196
27;Lugo;902;Burela;"";"";""
27;Lugo;009;Carballedo;4197;2088;2109
27;Lugo;010;Castro de Rei;5889;2955;2934
27;Lugo;011;Castroverde;3900;1997;1903
27;Lugo;012;Cervantes;2613;1421;1192
27;Lugo;013;Cervo;12926;6420;6506
27;Lugo;016;Chantada;10339;5049;5290
27;Lugo;014;Corgo (O);4794;2437;2357
27;Lugo;015;Cospeito;6402;3152;3250
27;Lugo;017;Folgoso do Courel;1889;969;920
27;Lugo;018;Fonsagrada (A);6864;3615;3249
27;Lugo;019;Foz;9891;4799;5092
27;Lugo;020;Friol;5112;2556;2556
27;Lugo;022;Guitiriz;6960;3466;3494
27;Lugo;023;Guntín;3939;1934;2005
27;Lugo;024;Incio (O);2851;1428;1423
27;Lugo;026;Láncara;3572;1857;1715
27;Lugo;027;Lourenzá;3123;1514;1609
27;Lugo;028;Lugo;85753;40607;45146
27;Lugo;029;Meira;1892;938;954
27;Lugo;030;Mondoñedo;5817;2715;3102
27;Lugo;031;Monforte de Lemos;20445;9830;10615
27;Lugo;032;Monterroso;4542;2290;2252
27;Lugo;033;Muras;1389;701;688
27;Lugo;034;Navia de Suarna;2288;1229;1059
27;Lugo;035;Negueira de Muñiz;338;175;163
27;Lugo;037;Nogais (As);1904;1002;902
27;Lugo;038;Ourol;1900;910;990
27;Lugo;039;Outeiro de Rei;4170;2077;2093
27;Lugo;040;Palas de Rei;4953;2467;2486
27;Lugo;041;Pantón;4172;2014;2158
27;Lugo;042;Paradela;3167;1567;1600
27;Lugo;043;Páramo (O);2069;1067;1002
27;Lugo;044;Pastoriza (A);4432;2222;2210
27;Lugo;045;Pedrafita do Cebreiro;2058;1093;965
27;Lugo;047;Pobra do Brollón (A);3210;1580;1630
27;Lugo;046;Pol;2445;1199;1246
27;Lugo;048;Pontenova (A);3716;1802;1914
27;Lugo;049;Portomarín;2229;1107;1122
27;Lugo;050;Quiroga;5132;2513;2619
27;Lugo;056;Rábade;1770;905;865
27;Lugo;051;Ribadeo;9062;4268;4794
27;Lugo;052;Ribas de Sil;1667;808;859
27;Lugo;053;Ribeira de Piquín;1068;530;538
27;Lugo;054;Riotorto;2205;1084;1121
27;Lugo;055;Samos;2420;1271;1149
27;Lugo;057;Sarria;12611;6243;6368
27;Lugo;058;Saviñao (O);5835;2870;2965
27;Lugo;059;Sober;3765;1799;1966
27;Lugo;060;Taboada;5069;2513;2556
27;Lugo;061;Trabada;1986;963;1023
27;Lugo;062;Triacastela;1061;546;515
27;Lugo;063;Valadouro (O);2775;1373;1402
27;Lugo;064;Vicedo (O);2698;1307;1391
27;Lugo;065;Vilalba;16242;7938;8304
27;Lugo;066;Viveiro;15348;7322;8026
27;Lugo;021;Xermade;3074;1529;1545
27;Lugo;025;Xove;3607;1801;1806
28;Madrid;001;Acebeda (La);54;27;27
28;Madrid;002;Ajalvir;1441;775;666
28;Madrid;003;Alameda del Valle;175;96;79
28;Madrid;004;Álamo (El);3183;1591;1592
28;Madrid;005;Alcalá de Henares;164140;82127;82013
28;Madrid;006;Alcobendas;82317;40855;41462
28;Madrid;007;Alcorcón;140539;69903;70636
28;Madrid;008;Aldea del Fresno;1205;619;586
28;Madrid;009;Algete;11461;5744;5717
28;Madrid;010;Alpedrete;4019;2039;1980
28;Madrid;011;Ambite;281;139;142
28;Madrid;012;Anchuelo;540;292;248
28;Madrid;013;Aranjuez;38215;18586;19629
28;Madrid;014;Arganda del Rey;27792;13853;13939
28;Madrid;015;Arroyomolinos;1545;779;766
28;Madrid;016;Atazar (El);88;51;37
28;Madrid;017;Batres;438;230;208
28;Madrid;018;Becerril de la Sierra;2192;1106;1086
28;Madrid;019;Belmonte de Tajo;1159;593;566
28;Madrid;021;Berrueco (El);288;159;129
28;Madrid;020;Berzosa del Lozoya;92;44;48
28;Madrid;022;Boadilla del Monte;17414;8776;8638
28;Madrid;023;Boalo (El);1977;997;980
28;Madrid;024;Braojos;135;73;62
28;Madrid;025;Brea de Tajo;482;256;226
28;Madrid;026;Brunete;2743;1369;1374
28;Madrid;027;Buitrago del Lozoya;1334;648;686
28;Madrid;028;Bustarviejo;1289;663;626
28;Madrid;029;Cabanillas de la Sierra;371;195;176
28;Madrid;030;Cabrera (La);1122;570;552
28;Madrid;031;Cadalso de los Vidrios;2141;1090;1051
28;Madrid;032;Camarma de Esteruelas;1648;832;816
28;Madrid;033;Campo Real;2231;1123;1108
28;Madrid;034;Canencia;458;235;223
28;Madrid;035;Carabaña;1105;561;544
28;Madrid;036;Casarrubuelos;590;310;280
28;Madrid;037;Cenicientos;1806;894;912
28;Madrid;038;Cercedilla;4342;2142;2200
28;Madrid;039;Cervera de Buitrago;88;48;40
28;Madrid;051;Chapinería;976;513;463
28;Madrid;052;Chinchón;4053;2020;2033
28;Madrid;040;Ciempozuelos;11315;5800;5515
28;Madrid;041;Cobeña;1292;661;631
28;Madrid;046;Collado Mediano;2799;1445;1354
28;Madrid;047;Collado Villalba;31069;15554;15515
28;Madrid;043;Colmenar de Oreja;5342;2603;2739
28;Madrid;042;Colmenar del Arroyo;589;303;286
28;Madrid;045;Colmenar Viejo;26059;12976;13083
28;Madrid;044;Colmenarejo;2708;1425;1283
28;Madrid;048;Corpa;360;187;173
28;Madrid;049;Coslada;78384;39381;39003
28;Madrid;050;Cubas de la Sagra;997;483;514
28;Madrid;053;Daganzo de Arriba;1814;918;896
28;Madrid;054;Escorial (El);8090;4091;3999
28;Madrid;055;Estremera;1074;563;511
28;Madrid;056;Fresnedillas de la Oliva;488;245;243
28;Madrid;057;Fresno de Torote;316;167;149
28;Madrid;058;Fuenlabrada;155168;78505;76663
28;Madrid;059;Fuente el Saz de Jarama;2862;1476;1386
28;Madrid;060;Fuentidueña de Tajo;1318;632;686
28;Madrid;061;Galapagar;11974;6116;5858
28;Madrid;062;Garganta de los Montes;316;154;162
28;Madrid;063;Gargantilla del Lozoya y Pinilla de Buitrago;219;128;91
28;Madrid;064;Gascones;111;53;58
28;Madrid;065;Getafe;142231;70994;71237
28;Madrid;066;Griñón;3036;1556;1480
28;Madrid;067;Guadalix de la Sierra;1990;995;995
28;Madrid;068;Guadarrama;7334;3644;3690
28;Madrid;069;Hiruela (La);51;31;20
28;Madrid;070;Horcajo de la Sierra;120;62;58
28;Madrid;071;Horcajuelo de la Sierra;80;40;40
28;Madrid;072;Hoyo de Manzanares;3974;2009;1965
28;Madrid;073;Humanes de Madrid;8648;4396;4252
28;Madrid;074;Leganés;175952;88205;87747
28;Madrid;075;Loeches;2323;1183;1140
28;Madrid;076;Lozoya;409;213;196
28;Madrid;901;Lozoyuela-Navas-Sieteiglesias;647;346;301
28;Madrid;078;Madarcos;31;16;15
28;Madrid;079;Madrid;3037977;1429103;1608874
28;Madrid;080;Majadahonda;35900;17542;18358
28;Madrid;082;Manzanares el Real;2587;1329;1258
28;Madrid;083;Meco;3644;1872;1772
28;Madrid;084;Mejorada del Campo;14503;7382;7121
28;Madrid;085;Miraflores de la Sierra;2897;1443;1454
28;Madrid;086;Molar (El);3093;1645;1448
28;Madrid;087;Molinos (Los);2597;1232;1365
28;Madrid;088;Montejo de la Sierra;257;124;133
28;Madrid;089;Moraleja de Enmedio;1695;840;855
28;Madrid;090;Moralzarzal;2550;1299;1251
28;Madrid;091;Morata de Tajuña;5191;2528;2663
28;Madrid;092;Móstoles;196023;97536;98487
28;Madrid;093;Navacerrada;1667;890;777
28;Madrid;094;Navalafuente;345;185;160
28;Madrid;095;Navalagamella;683;340;343
28;Madrid;096;Navalcarnero;10757;5506;5251
28;Madrid;097;Navarredonda y San Mamés;104;52;52
28;Madrid;099;Navas del Rey;1134;567;567
28;Madrid;100;Nuevo Baztán;1129;606;523
28;Madrid;101;Olmeda de las Fuentes;134;71;63
28;Madrid;102;Orusco de Tajuña;597;301;296
28;Madrid;104;Paracuellos de Jarama;5053;2626;2427
28;Madrid;106;Parla;71125;35740;35385
28;Madrid;107;Patones;353;180;173
28;Madrid;108;Pedrezuela;894;467;427
28;Madrid;109;Pelayos de la Presa;1012;500;512
28;Madrid;110;Perales de Tajuña;2009;975;1034
28;Madrid;111;Pezuela de las Torres;479;254;225
28;Madrid;112;Pinilla del Valle;152;82;70
28;Madrid;113;Pinto;23643;11796;11847
28;Madrid;114;Piñuécar-Gandullas;141;65;76
28;Madrid;115;Pozuelo de Alarcón;53339;26293;27046
28;Madrid;116;Pozuelo del Rey;229;114;115
28;Madrid;117;Prádena del Rincón;112;60;52
28;Madrid;118;Puebla de la Sierra;51;29;22
28;Madrid;902;Puentes Viejas;406;210;196
28;Madrid;119;Quijorna;657;341;316
28;Madrid;120;Rascafría;1348;701;647
28;Madrid;121;Redueña;147;73;74
28;Madrid;122;Ribatejada;307;151;156
28;Madrid;123;Rivas-Vaciamadrid;17555;8856;8699
28;Madrid;124;Robledillo de la Jara;69;33;36
28;Madrid;125;Robledo de Chavela;1931;949;982
28;Madrid;126;Robregordo;90;45;45
28;Madrid;127;Rozas de Madrid (Las);41566;20529;21037
28;Madrid;128;Rozas de Puerto Real;335;173;162
28;Madrid;129;San Agustín del Guadalix;3817;1972;1845
28;Madrid;130;San Fernando de Henares;27079;13544;13535
28;Madrid;131;San Lorenzo de El Escorial;9534;4611;4923
28;Madrid;132;San Martín de la Vega;7334;3755;3579
28;Madrid;133;San Martín de Valdeiglesias;5581;2789;2792
28;Madrid;134;San Sebastián de los Reyes;55534;27893;27641
28;Madrid;135;Santa María de la Alameda;699;383;316
28;Madrid;136;Santorcaz;541;284;257
28;Madrid;137;Santos de la Humosa (Los);968;503;465
28;Madrid;138;Serna del Monte (La);91;47;44
28;Madrid;140;Serranillos del Valle;591;307;284
28;Madrid;141;Sevilla la Nueva;1668;852;816
28;Madrid;143;Somosierra;108;65;43
28;Madrid;144;Soto del Real;2947;1497;1450
28;Madrid;145;Talamanca de Jarama;1173;579;594
28;Madrid;146;Tielmes;1974;1007;967
28;Madrid;147;Titulcia;872;431;441
28;Madrid;148;Torrejón de Ardoz;85286;42836;42450
28;Madrid;149;Torrejón de la Calzada;1913;974;939
28;Madrid;150;Torrejón de Velasco;1517;781;736
28;Madrid;151;Torrelaguna;2554;1233;1321
28;Madrid;152;Torrelodones;8553;4252;4301
28;Madrid;153;Torremocha de Jarama;249;121;128
28;Madrid;154;Torres de la Alameda;3373;1681;1692
28;Madrid;903;Tres Cantos;19256;9554;9702
28;Madrid;155;Valdaracete;676;337;339
28;Madrid;156;Valdeavero;492;251;241
28;Madrid;157;Valdelaguna;546;288;258
28;Madrid;158;Valdemanco;508;265;243
28;Madrid;159;Valdemaqueda;500;243;257
28;Madrid;160;Valdemorillo;3192;1630;1562
28;Madrid;161;Valdemoro;18749;9387;9362
28;Madrid;162;Valdeolmos-Alalpardo;1249;663;586
28;Madrid;163;Valdepiélagos;328;165;163
28;Madrid;164;Valdetorres de Jarama;1322;676;646
28;Madrid;165;Valdilecha;1726;857;869
28;Madrid;166;Valverde de Alcalá;257;137;120
28;Madrid;167;Velilla de San Antonio;2829;1446;1383
28;Madrid;168;Vellón (El);939;482;457
28;Madrid;169;Venturada;400;206;194
28;Madrid;171;Villa del Prado;3415;1721;1694
28;Madrid;170;Villaconejos;2856;1467;1389
28;Madrid;172;Villalbilla;2386;1215;1171
28;Madrid;173;Villamanrique de Tajo;590;304;286
28;Madrid;174;Villamanta;1316;673;643
28;Madrid;175;Villamantilla;316;159;157
28;Madrid;176;Villanueva de la Cañada;5236;2675;2561
28;Madrid;178;Villanueva de Perales;387;216;171
28;Madrid;177;Villanueva del Pardillo;2282;1158;1124
28;Madrid;179;Villar del Olmo;628;322;306
28;Madrid;180;Villarejo de Salvanés;5101;2540;2561
28;Madrid;181;Villaviciosa de Odón;15038;7437;7601
28;Madrid;182;Villavieja del Lozoya;161;80;81
28;Madrid;183;Zarzalejo;903;464;439
29;Málaga;001;Alameda;4905;2462;2443
29;Málaga;002;Alcaucín;1402;698;704
29;Málaga;003;Alfarnate;1519;793;726
29;Málaga;004;Alfarnatejo;425;235;190
29;Málaga;005;Algarrobo;4710;2382;2328
29;Málaga;006;Algatocín;1000;514;486
29;Málaga;007;Alhaurín de la Torre;14949;7573;7376
29;Málaga;008;Alhaurín el Grande;17744;8760;8984
29;Málaga;009;Almáchar;2040;1049;991
29;Málaga;010;Almargen;2244;1137;1107
29;Málaga;011;Almogía;3941;1999;1942
29;Málaga;012;Álora;13182;6625;6557
29;Málaga;013;Alozaina;2563;1345;1218
29;Málaga;014;Alpandeire;328;173;155
29;Málaga;015;Antequera;39284;19224;20060
29;Málaga;016;Árchez;329;179;150
29;Málaga;017;Archidona;10318;5163;5155
29;Málaga;018;Ardales;3207;1618;1589
29;Málaga;019;Arenas;1264;675;589
29;Málaga;020;Arriate;3297;1636;1661
29;Málaga;021;Atajate;163;90;73
29;Málaga;022;Benadalid;271;147;124
29;Málaga;023;Benahavís;1527;748;779
29;Málaga;024;Benalauría;529;278;251
29;Málaga;025;Benalmádena;23260;11468;11792
29;Málaga;026;Benamargosa;1649;827;822
29;Málaga;027;Benamocarra;2804;1421;1383
29;Málaga;028;Benaoján;1646;818;828
29;Málaga;029;Benarrabá;682;342;340
29;Málaga;030;Borge (El);1065;554;511
29;Málaga;031;Burgo (El);2155;1101;1054
29;Málaga;032;Campillos;7818;3957;3861
29;Málaga;033;Canillas de Aceituno;2785;1409;1376
29;Málaga;034;Canillas de Albaida;657;341;316
29;Málaga;035;Cañete la Real;2341;1203;1138
29;Málaga;036;Carratraca;823;412;411
29;Málaga;037;Cartajima;352;182;170
29;Málaga;038;Cártama;11540;5811;5729
29;Málaga;039;Casabermeja;3159;1664;1495
29;Málaga;040;Casarabonela;2567;1328;1239
29;Málaga;041;Casares;3256;1694;1562
29;Málaga;042;Coín;14855;7408;7447
29;Málaga;043;Colmenar;3170;1544;1626
29;Málaga;044;Comares;1461;764;697
29;Málaga;045;Cómpeta;2474;1233;1241
29;Málaga;046;Cortes de la Frontera;3767;1884;1883
29;Málaga;047;Cuevas Bajas;1540;730;810
29;Málaga;049;Cuevas de San Marcos;4130;2060;2070
29;Málaga;048;Cuevas del Becerro;2027;1049;978
29;Málaga;050;Cútar;624;321;303
29;Málaga;051;Estepona;35799;17909;17890
29;Málaga;052;Faraján;323;169;154
29;Málaga;053;Frigiliana;2171;1059;1112
29;Málaga;054;Fuengirola;41167;20164;21003
29;Málaga;055;Fuente de Piedra;2049;1010;1039
29;Málaga;056;Gaucín;1813;938;875
29;Málaga;057;Genalguacil;665;342;323
29;Málaga;058;Guaro;1946;987;959
29;Málaga;059;Humilladero;2386;1202;1184
29;Málaga;060;Igualeja;1027;520;507
29;Málaga;061;Istán;1326;673;653
29;Málaga;062;Iznate;758;383;375
29;Málaga;063;Jimera de Líbar;460;233;227
29;Málaga;064;Jubrique;885;449;436
29;Málaga;065;Júzcar;253;142;111
29;Málaga;066;Macharaviaya;365;194;171
29;Málaga;067;Málaga;528534;254687;273847
29;Málaga;068;Manilva;5136;2621;2515
29;Málaga;069;Marbella;84114;41705;42409
29;Málaga;070;Mijas;33322;16501;16821
29;Málaga;071;Moclinejo;1096;554;542
29;Málaga;072;Mollina;3244;1591;1653
29;Málaga;073;Monda;1629;833;796
29;Málaga;074;Montejaque;1039;508;531
29;Málaga;075;Nerja;14491;7157;7334
29;Málaga;076;Ojén;1973;1035;938
29;Málaga;077;Parauta;301;150;151
29;Málaga;079;Periana;3435;1800;1635
29;Málaga;080;Pizarra;6539;3316;3223
29;Málaga;081;Pujerra;346;194;152
29;Málaga;082;Rincón de la Victoria;14379;7125;7254
29;Málaga;083;Riogordo;2617;1323;1294
29;Málaga;084;Ronda;34214;16830;17384
29;Málaga;085;Salares;234;122;112
29;Málaga;086;Sayalonga;1056;545;511
29;Málaga;087;Sedella;459;244;215
29;Málaga;088;Sierra de Yeguas;3206;1616;1590
29;Málaga;089;Teba;4442;2263;2179
29;Málaga;090;Tolox;3044;1562;1482
29;Málaga;901;Torremolinos;30393;14915;15478
29;Málaga;091;Torrox;10746;5440;5306
29;Málaga;092;Totalán;609;316;293
29;Málaga;093;Valle de Abdalajís;3055;1546;1509
29;Málaga;094;Vélez-Málaga;53133;26490;26643
29;Málaga;095;Villanueva de Algaidas;4277;2117;2160
29;Málaga;098;Villanueva de Tapia;1617;810;807
29;Málaga;096;Villanueva del Rosario;3222;1583;1639
29;Málaga;097;Villanueva del Trabuco;4595;2340;2255
29;Málaga;099;Viñuela;1181;596;585
29;Málaga;100;Yunquera;3176;1647;1529
30;Murcia;001;Abanilla;6249;3087;3162
30;Murcia;002;Abarán;12007;5952;6055
30;Murcia;003;Águilas;25551;12793;12758
30;Murcia;004;Albudeite;1417;714;703
30;Murcia;005;Alcantarilla;31412;15343;16069
30;Murcia;902;Alcázares (Los);4183;2036;2147
30;Murcia;006;Aledo;989;513;476
30;Murcia;007;Alguazas;7068;3510;3558
30;Murcia;008;Alhama de Murcia;14602;7210;7392
30;Murcia;009;Archena;13934;6918;7016
30;Murcia;010;Beniel;7521;3733;3788
30;Murcia;011;Blanca;5785;2823;2962
30;Murcia;012;Bullas;10275;5180;5095
30;Murcia;013;Calasparra;8914;4443;4471
30;Murcia;014;Campos del Río;2032;1011;1021
30;Murcia;015;Caravaca de la Cruz;21612;10708;10904
30;Murcia;016;Cartagena;176139;87353;88786
30;Murcia;017;Cehegín;13933;6940;6993
30;Murcia;018;Ceutí;6703;3369;3334
30;Murcia;019;Cieza;31927;15574;16353
30;Murcia;020;Fortuna;6224;3154;3070
30;Murcia;021;Fuente Álamo de Murcia;8909;4454;4455
30;Murcia;022;Jumilla;20593;10224;10369
30;Murcia;023;Librilla;3766;1846;1920
30;Murcia;024;Lorca;68545;33871;34674
30;Murcia;025;Lorquí;5489;2706;2783
30;Murcia;026;Mazarrón;15144;7607;7537
30;Murcia;027;Molina de Segura;40210;19814;20396
30;Murcia;028;Moratalla;9002;4564;4438
30;Murcia;029;Mula;13429;6683;6746
30;Murcia;030;Murcia;335055;163151;171904
30;Murcia;031;Ojós;633;314;319
30;Murcia;032;Pliego;3367;1715;1652
30;Murcia;033;Puerto Lumbreras;10310;5016;5294
30;Murcia;034;Ricote;1676;813;863
30;Murcia;035;San Javier;16120;8011;8109
30;Murcia;036;San Pedro del Pinatar;13076;6481;6595
30;Murcia;901;Santomera;9118;4528;4590
30;Murcia;037;Torre-Pacheco;17738;8963;8775
30;Murcia;038;Torres de Cotillas (Las);14722;7377;7345
30;Murcia;039;Totana;21117;10517;10600
30;Murcia;040;Ulea;1050;529;521
30;Murcia;041;Unión (La);14201;7035;7166
30;Murcia;042;Villanueva del Río Segura;1650;826;824
30;Murcia;043;Yecla;27589;13759;13830
31;Navarra;001;Abáigar;93;49;44
31;Navarra;002;Abárzuza;498;241;257
31;Navarra;003;Abaurregaina/Abaurrea Alta;211;123;88
31;Navarra;004;Abaurrepea/Abaurrea Baja;51;36;15
31;Navarra;005;Aberin;375;195;180
31;Navarra;006;Ablitas;2312;1188;1124
31;Navarra;007;Adiós;114;57;57
31;Navarra;008;Aguilar de Codés;118;63;55
31;Navarra;009;Aibar/Oibar;974;498;476
31;Navarra;011;Allín;816;424;392
31;Navarra;012;Allo;1112;544;568
31;Navarra;010;Altsasu/Alsasua;7081;3597;3484
31;Navarra;013;Améscoa Baja;845;441;404
31;Navarra;014;Ancín;303;157;146
31;Navarra;015;Andosilla;2524;1258;1266
31;Navarra;016;Ansoáin;5111;2571;2540
31;Navarra;017;Anue;469;268;201
31;Navarra;018;Añorbe;408;226;182
31;Navarra;019;Aoiz/Agoitz;1920;945;975
31;Navarra;020;Araitz;649;376;273
31;Navarra;025;Arakil;867;477;390
31;Navarra;021;Aranarache;108;53;55
31;Navarra;023;Aranguren;1904;1000;904
31;Navarra;024;Arano;179;96;83
31;Navarra;022;Arantza;734;407;327
31;Navarra;026;Aras;230;116;114
31;Navarra;027;Arbizu;898;474;424
31;Navarra;028;Arce/Artzi;278;154;124
31;Navarra;029;Arcos (Los);1405;709;696
31;Navarra;030;Arellano;219;120;99
31;Navarra;031;Areso;296;155;141
31;Navarra;032;Arguedas;2298;1137;1161
31;Navarra;033;Aria;74;47;27
31;Navarra;034;Aribe;78;41;37
31;Navarra;035;Armañanzas;113;57;56
31;Navarra;036;Arróniz;1245;671;574
31;Navarra;037;Arruazu;127;67;60
31;Navarra;038;Artajona;1677;880;797
31;Navarra;039;Artazu;99;52;47
31;Navarra;040;Atez;251;147;104
31;Navarra;058;Auritz/Burguete;302;134;168
31;Navarra;041;Ayegui;780;398;382
31;Navarra;042;Azagra;3388;1690;1698
31;Navarra;043;Azuelo;75;39;36
31;Navarra;044;Bakaiku;357;200;157
31;Navarra;901;Barañain;18121;8993;9128
31;Navarra;045;Barásoain;432;218;214
31;Navarra;046;Barbarin;117;53;64
31;Navarra;047;Bargota;409;208;201
31;Navarra;048;Barillas;205;95;110
31;Navarra;049;Basaburua;737;419;318
31;Navarra;050;Baztan;8016;4057;3959
31;Navarra;137;Beintza-Labaien;317;183;134
31;Navarra;051;Beire;342;164;178
31;Navarra;052;Belascoáin;88;46;42
31;Navarra;250;Bera/Vera de Bidasoa;3543;1806;1737
31;Navarra;053;Berbinzana;737;370;367
31;Navarra;905;Beriáin;2256;1130;1126
31;Navarra;902;Berrioplano;913;457;456
31;Navarra;903;Berriozar;5365;2746;2619
31;Navarra;054;Bertizarana;658;328;330
31;Navarra;055;Betelu;341;189;152
31;Navarra;253;Bidaurreta;104;63;41
31;Navarra;056;Biurrun-Olcoz;179;96;83
31;Navarra;057;Buñuel;2399;1166;1233
31;Navarra;059;Burgui/Burgi;254;143;111
31;Navarra;060;Burlada/Burlata;15549;7768;7781
31;Navarra;061;Busto (El);112;54;58
31;Navarra;062;Cabanillas;1429;719;710
31;Navarra;063;Cabredo;149;76;73
31;Navarra;064;Cadreita;1878;908;970
31;Navarra;065;Caparroso;2366;1146;1220
31;Navarra;066;Cárcar;1265;627;638
31;Navarra;067;Carcastillo;2598;1313;1285
31;Navarra;068;Cascante;3510;1706;1804
31;Navarra;069;Cáseda;1113;553;560
31;Navarra;070;Castejón;3198;1613;1585
31;Navarra;071;Castillonuevo;23;14;9
31;Navarra;072;Cintruénigo;5429;2716;2713
31;Navarra;074;Cirauqui;476;264;212
31;Navarra;075;Ciriza;59;25;34
31;Navarra;076;Cizur;1049;546;503
31;Navarra;077;Corella;6360;3201;3159
31;Navarra;078;Cortes;3255;1647;1608
31;Navarra;079;Desojo;161;87;74
31;Navarra;080;Dicastillo;758;402;356
31;Navarra;081;Donamaria;369;187;182
31;Navarra;221;Doneztebe/Santesteban;1288;645;643
31;Navarra;083;Echarri;69;37;32
31;Navarra;086;Egüés;1207;584;623
31;Navarra;087;Elgorriaga;190;94;96
31;Navarra;089;Enériz;190;99;91
31;Navarra;090;Eratsun;195;119;76
31;Navarra;091;Ergoiena;513;287;226
31;Navarra;092;Erro;776;423;353
31;Navarra;094;Eslava;213;111;102
31;Navarra;095;Esparza de Salazar;125;65;60
31;Navarra;096;Espronceda;201;118;83
31;Navarra;097;Estella/Lizarra;12873;6234;6639
31;Navarra;098;Esteribar;1465;793;672
31;Navarra;099;Etayo;102;53;49
31;Navarra;082;Etxalar;874;447;427
31;Navarra;084;Etxarri-Aranatz;2421;1259;1162
31;Navarra;085;Etxauri;415;208;207
31;Navarra;100;Eulate;405;206;199
31;Navarra;101;Ezcabarte;1003;533;470
31;Navarra;093;Ezcároz/Ezkaroze;357;194;163
31;Navarra;102;Ezkurra;263;160;103
31;Navarra;103;Ezprogui;73;38;35
31;Navarra;104;Falces;2705;1328;1377
31;Navarra;105;Fitero;2137;1064;1073
31;Navarra;106;Fontellas;572;292;280
31;Navarra;107;Funes;2134;1079;1055
31;Navarra;108;Fustiñana;2326;1180;1146
31;Navarra;109;Galar;1012;541;471
31;Navarra;110;Gallipienzo;197;111;86
31;Navarra;111;Gallués/Galoze;127;81;46
31;Navarra;112;Garaioa;148;78;70
31;Navarra;113;Garde;219;115;104
31;Navarra;114;Garínoain;291;152;139
31;Navarra;115;Garralda;241;126;115
31;Navarra;116;Genevilla;135;69;66
31;Navarra;117;Goizueta;1025;558;467
31;Navarra;118;Goñi;209;115;94
31;Navarra;119;Güesa/Gorza;86;46;40
31;Navarra;120;Guesálaz;509;278;231
31;Navarra;121;Guirguillano;89;49;40
31;Navarra;256;Hiriberri/Villanueva de Aezkoa;171;88;83
31;Navarra;122;Huarte/Uharte;2813;1412;1401
31;Navarra;124;Ibargoiti;204;125;79
31;Navarra;259;Igantzi;588;307;281
31;Navarra;125;Igúzquiza;361;178;183
31;Navarra;126;Imotz;436;231;205
31;Navarra;127;Irañeta;161;89;72
31;Navarra;904;Irurtzun;2055;1061;994
31;Navarra;128;Isaba/Izaba;582;292;290
31;Navarra;129;Ituren;485;245;240
31;Navarra;130;Iturmendi;355;185;170
31;Navarra;131;Iza;619;328;291
31;Navarra;132;Izagaondoa;211;125;86
31;Navarra;133;Izalzu/Itzaltzu;54;29;25
31;Navarra;134;Jaurrieta;312;161;151
31;Navarra;135;Javier;163;69;94
31;Navarra;136;Juslapeña;460;252;208
31;Navarra;138;Lakuntza;992;525;467
31;Navarra;139;Lana;226;126;100
31;Navarra;140;Lantz;129;81;48
31;Navarra;141;Lapoblación;184;99;85
31;Navarra;142;Larraga;1904;994;910
31;Navarra;143;Larraona;188;95;93
31;Navarra;144;Larraun;1940;1036;904
31;Navarra;145;Lazagurría;246;129;117
31;Navarra;146;Leache;63;34;29
31;Navarra;147;Legarda;75;41;34
31;Navarra;148;Legaria;169;90;79
31;Navarra;149;Leitza;3169;1640;1529
31;Navarra;908;Lekunberri;"";"";""
31;Navarra;150;Leoz;211;122;89
31;Navarra;151;Lerga;110;58;52
31;Navarra;152;Lerín;2039;1010;1029
31;Navarra;153;Lesaka;2749;1447;1302
31;Navarra;154;Lezáun;283;159;124
31;Navarra;155;Liédena;342;164;178
31;Navarra;156;Lizoáin;246;136;110
31;Navarra;157;Lodosa;4637;2346;2291
31;Navarra;158;Lónguida/Longida;301;161;140
31;Navarra;159;Lumbier;1521;830;691
31;Navarra;160;Luquin;136;75;61
31;Navarra;248;Luzaide/Valcarlos;530;261;269
31;Navarra;161;Mañeru;366;184;182
31;Navarra;162;Marañón;91;46;45
31;Navarra;163;Marcilla;2372;1182;1190
31;Navarra;164;Mélida;895;454;441
31;Navarra;165;Mendavia;3585;1808;1777
31;Navarra;166;Mendaza;437;206;231
31;Navarra;167;Mendigorría;976;507;469
31;Navarra;168;Metauten;325;166;159
31;Navarra;169;Milagro;2614;1294;1320
31;Navarra;170;Mirafuentes;50;23;27
31;Navarra;171;Miranda de Arga;976;480;496
31;Navarra;172;Monreal;312;155;157
31;Navarra;173;Monteagudo;1159;576;583
31;Navarra;174;Morentin;137;67;70
31;Navarra;175;Mues;128;65;63
31;Navarra;176;Murchante;2951;1460;1491
31;Navarra;177;Murieta;287;155;132
31;Navarra;178;Murillo el Cuende;667;353;314
31;Navarra;179;Murillo el Fruto;822;419;403
31;Navarra;180;Muruzábal;194;102;92
31;Navarra;181;Navascués;256;157;99
31;Navarra;182;Nazar;52;29;23
31;Navarra;088;Noáin (Valle de Elorz)/Noain (Elortzibar);3819;1921;1898
31;Navarra;183;Obanos;722;351;371
31;Navarra;185;Ochagavía;681;358;323
31;Navarra;184;Oco;92;56;36
31;Navarra;186;Odieta;331;181;150
31;Navarra;187;Oitz;167;103;64
31;Navarra;188;Olaibar;165;88;77
31;Navarra;189;Olazti/Olazagutía;1727;897;830
31;Navarra;190;Olejua;66;35;31
31;Navarra;191;Olite;3086;1548;1538
31;Navarra;194;Ollo;362;206;156
31;Navarra;192;Olóriz;176;99;77
31;Navarra;193;Olza;1184;618;566
31;Navarra;195;Orbaitzeta;256;142;114
31;Navarra;196;Orbara;64;32;32
31;Navarra;906;Orcoyen;1222;694;528
31;Navarra;197;Orísoain;107;56;51
31;Navarra;198;Oronz;55;30;25
31;Navarra;199;Oroz-Betelu;235;128;107
31;Navarra;211;Orreaga/Roncesvalles;36;21;15
31;Navarra;200;Oteiza;932;480;452
31;Navarra;201;Pamplona/Iruña;182098;87463;94635
31;Navarra;202;Peralta;4657;2295;2362
31;Navarra;203;Petilla de Aragón;54;26;28
31;Navarra;204;Piedramillera;84;47;37
31;Navarra;205;Pitillas;640;324;316
31;Navarra;206;Puente la Reina/Gares;2195;1091;1104
31;Navarra;207;Pueyo;331;171;160
31;Navarra;208;Ribaforada;3101;1588;1513
31;Navarra;209;Romanzado;160;87;73
31;Navarra;210;Roncal/Erronkari;362;184;178
31;Navarra;212;Sada;285;153;132
31;Navarra;213;Saldías;167;90;77
31;Navarra;214;Salinas de Oro;104;60;44
31;Navarra;215;San Adrián;5215;2543;2672
31;Navarra;217;San Martín de Unx;522;280;242
31;Navarra;216;Sangüesa/Zangoza;4636;2366;2270
31;Navarra;219;Sansol;149;78;71
31;Navarra;220;Santacara;1098;557;541
31;Navarra;222;Sarriés/Sartze;106;60;46
31;Navarra;223;Sartaguda;1430;711;719
31;Navarra;224;Sesma;1451;713;738
31;Navarra;225;Sorlada;68;33;35
31;Navarra;226;Sunbilla;703;366;337
31;Navarra;227;Tafalla;10303;5083;5220
31;Navarra;228;Tiebas-Muruarte de Reta;595;318;277
31;Navarra;229;Tirapu;69;36;33
31;Navarra;230;Torralba del Río;169;92;77
31;Navarra;231;Torres del Río;210;103;107
31;Navarra;232;Tudela;27031;13231;13800
31;Navarra;233;Tulebras;109;43;66
31;Navarra;234;Ucar;115;61;54
31;Navarra;123;Uharte-Arakil;847;445;402
31;Navarra;235;Ujué;282;150;132
31;Navarra;236;Ultzama;1674;856;818
31;Navarra;237;Unciti;261;142;119
31;Navarra;238;Unzué;143;76;67
31;Navarra;239;Urdazubi/Urdax;455;225;230
31;Navarra;240;Urdiain;691;363;328
31;Navarra;241;Urraul Alto;158;93;65
31;Navarra;242;Urraul Bajo;271;124;147
31;Navarra;244;Urrotz;205;116;89
31;Navarra;243;Urroz;369;186;183
31;Navarra;245;Urzainqui;118;63;55
31;Navarra;246;Uterga;138;64;74
31;Navarra;247;Uztárroz/Uztarroze;316;154;162
31;Navarra;249;Valtierra;2523;1256;1267
31;Navarra;251;Viana;3473;1764;1709
31;Navarra;252;Vidángoz/Bidankoze;114;56;58
31;Navarra;254;Villafranca;2569;1236;1333
31;Navarra;255;Villamayor de Monjardín;115;65;50
31;Navarra;257;Villatuerta;795;399;396
31;Navarra;258;Villava/Atarrabia;8135;4108;4027
31;Navarra;260;Yerri;1555;829;726
31;Navarra;261;Yesa;297;168;129
31;Navarra;262;Zabalza;143;67;76
31;Navarra;073;Ziordia;398;189;209
31;Navarra;907;Zizur Mayor/Zizur Nagusia;6320;3169;3151
31;Navarra;263;Zubieta;331;197;134
31;Navarra;264;Zugarramurdi;256;136;120
31;Navarra;265;Zúñiga;126;67;59
32;Ourense;001;Allariz;5369;2560;2809
32;Ourense;002;Amoeiro;2373;1142;1231
32;Ourense;003;Arnoia (A);1101;522;579
32;Ourense;004;Avión;3555;1619;1936
32;Ourense;005;Baltar;1845;905;940
32;Ourense;006;Bande;2880;1380;1500
32;Ourense;007;Baños de Molgas;3154;1552;1602
32;Ourense;008;Barbadás;4097;1980;2117
32;Ourense;009;Barco de Valdeorras (O);11228;5572;5656
32;Ourense;010;Beade;894;445;449
32;Ourense;011;Beariz;1894;857;1037
32;Ourense;012;Blancos (Os);1297;651;646
32;Ourense;013;Boborás;3925;1794;2131
32;Ourense;014;Bola (A);1735;818;917
32;Ourense;015;Bolo (O);1859;932;927
32;Ourense;016;Calvos de Randín;1996;1013;983
32;Ourense;018;Carballeda de Avia;1874;889;985
32;Ourense;017;Carballeda de Valdeorras;2721;1389;1332
32;Ourense;019;Carballiño (O);11706;5530;6176
32;Ourense;020;Cartelle;4291;2083;2208
32;Ourense;022;Castrelo de Miño;3599;1762;1837
32;Ourense;021;Castrelo do Val;1462;722;740
32;Ourense;023;Castro Caldelas;2156;1095;1061
32;Ourense;024;Celanova;6127;2896;3231
32;Ourense;025;Cenlle;1976;913;1063
32;Ourense;029;Chandrexa de Queixa;1050;560;490
32;Ourense;026;Coles;3268;1591;1677
32;Ourense;027;Cortegada;1614;774;840
32;Ourense;028;Cualedro;2674;1364;1310
32;Ourense;030;Entrimo;1697;769;928
32;Ourense;031;Esgos;1483;710;773
32;Ourense;033;Gomesende;1381;639;742
32;Ourense;034;Gudiña (A);2003;1001;1002
32;Ourense;035;Irixo (O);2562;1180;1382
32;Ourense;038;Larouco;700;333;367
32;Ourense;039;Laza;2336;1162;1174
32;Ourense;040;Leiro;2221;1067;1154
32;Ourense;041;Lobeira;1466;706;760
32;Ourense;042;Lobios;3226;1544;1682
32;Ourense;043;Maceda;3465;1663;1802
32;Ourense;044;Manzaneda;1607;817;790
32;Ourense;045;Maside;3620;1678;1942
32;Ourense;046;Melón;1768;773;995
32;Ourense;047;Merca (A);2766;1322;1444
32;Ourense;048;Mezquita (A);1869;942;927
32;Ourense;049;Montederramo;1499;766;733
32;Ourense;050;Monterrei;3700;1857;1843
32;Ourense;051;Muíños;2284;1106;1178
32;Ourense;052;Nogueira de Ramuín;2851;1343;1508
32;Ourense;053;Oímbra;2120;1048;1072
32;Ourense;054;Ourense;106347;50297;56050
32;Ourense;055;Paderne de Allariz;1831;852;979
32;Ourense;056;Padrenda;2924;1389;1535
32;Ourense;057;Parada de Sil;1091;529;562
32;Ourense;058;Pereiro de Aguiar (O);4783;2305;2478
32;Ourense;059;Peroxa (A);2884;1372;1512
32;Ourense;060;Petín;1335;638;697
32;Ourense;061;Piñor;1815;916;899
32;Ourense;063;Pobra de Trives (A);3123;1535;1588
32;Ourense;064;Pontedeva;857;411;446
32;Ourense;062;Porqueira;1329;649;680
32;Ourense;065;Punxín;1050;484;566
32;Ourense;066;Quintela de Leirado;1059;484;575
32;Ourense;067;Rairiz de Veiga;2349;1169;1180
32;Ourense;068;Ramirás;2162;992;1170
32;Ourense;069;Ribadavia;6128;2923;3205
32;Ourense;071;Riós;2540;1285;1255
32;Ourense;072;Rúa (A);5140;2552;2588
32;Ourense;073;Rubiá;2175;1089;1086
32;Ourense;074;San Amaro;1675;815;860
32;Ourense;075;San Cibrao das Viñas;3462;1657;1805
32;Ourense;076;San Cristovo de Cea;3781;1856;1925
32;Ourense;070;San Xoán de Río;1288;619;669
32;Ourense;077;Sandiás;1950;914;1036
32;Ourense;078;Sarreaus;2681;1324;1357
32;Ourense;079;Taboadela;1886;926;960
32;Ourense;080;Teixeira (A);714;348;366
32;Ourense;081;Toén;2772;1370;1402
32;Ourense;082;Trasmiras;2287;1129;1158
32;Ourense;083;Veiga (A);1704;845;859
32;Ourense;084;Verea;1791;845;946
32;Ourense;085;Verín;11733;5670;6063
32;Ourense;086;Viana do Bolo;4673;2387;2286
32;Ourense;087;Vilamarín;2285;1107;1178
32;Ourense;088;Vilamartín de Valdeorras;2557;1273;1284
32;Ourense;089;Vilar de Barrio;2640;1322;1318
32;Ourense;090;Vilar de Santos;1489;750;739
32;Ourense;091;Vilardevós;3282;1658;1624
32;Ourense;092;Vilariño de Conso;928;514;414
32;Ourense;032;Xinzo de Limia;9459;4612;4847
32;Ourense;036;Xunqueira de Ambía;2339;1147;1192
32;Ourense;037;Xunqueira de Espadanedo;1225;582;643
33;Asturias;001;Allande;2795;1449;1346
33;Asturias;002;Aller;17428;8637;8791
33;Asturias;003;Amieva;1025;538;487
33;Asturias;004;Avilés;87818;42613;45205
33;Asturias;005;Belmonte de Miranda;2789;1427;1362
33;Asturias;006;Bimenes;2520;1198;1322
33;Asturias;007;Boal;2947;1470;1477
33;Asturias;008;Cabrales;2526;1280;1246
33;Asturias;009;Cabranes;1438;690;748
33;Asturias;010;Candamo;2906;1420;1486
33;Asturias;012;Cangas de Onís;6419;3164;3255
33;Asturias;011;Cangas del Narcea;19157;9810;9347
33;Asturias;013;Caravia;603;307;296
33;Asturias;014;Carreño;11189;5418;5771
33;Asturias;015;Caso;2084;1077;1007
33;Asturias;016;Castrillón;22159;10763;11396
33;Asturias;017;Castropol;5059;2451;2608
33;Asturias;018;Coaña;4023;1930;2093
33;Asturias;019;Colunga;5123;2502;2621
33;Asturias;020;Corvera de Asturias;17364;8650;8714
33;Asturias;021;Cudillero;6615;3289;3326
33;Asturias;022;Degaña;1688;887;801
33;Asturias;023;Franco (El);4297;2097;2200
33;Asturias;024;Gijón;267033;127613;139420
33;Asturias;025;Gozón;11684;5667;6017
33;Asturias;026;Grado;12242;5927;6315
33;Asturias;027;Grandas de Salime;1472;759;713
33;Asturias;028;Ibias;2507;1350;1157
33;Asturias;029;Illano;763;393;370
33;Asturias;030;Illas;1282;668;614
33;Asturias;031;Langreo;51907;24848;27059
33;Asturias;032;Laviana;15418;7543;7875
33;Asturias;033;Lena;14567;7160;7407
33;Asturias;035;Llanera;10832;5305;5527
33;Asturias;036;Llanes;14497;6933;7564
33;Asturias;037;Mieres;53406;25870;27536
33;Asturias;038;Morcín;3084;1541;1543
33;Asturias;039;Muros de Nalón;2617;1230;1387
33;Asturias;040;Nava;5761;2824;2937
33;Asturias;041;Navia;9102;4370;4732
33;Asturias;042;Noreña;4180;1970;2210
33;Asturias;043;Onís;1074;539;535
33;Asturias;044;Oviedo;199946;93811;106135
33;Asturias;045;Parres;5768;2828;2940
33;Asturias;046;Peñamellera Alta;893;442;451
33;Asturias;047;Peñamellera Baja;1775;868;907
33;Asturias;048;Pesoz;323;162;161
33;Asturias;049;Piloña;9736;4728;5008
33;Asturias;050;Ponga;872;485;387
33;Asturias;051;Pravia;10024;4820;5204
33;Asturias;052;Proaza;1007;494;513
33;Asturias;053;Quirós;1816;947;869
33;Asturias;054;Regueras (Las);2421;1197;1224
33;Asturias;055;Ribadedeva;2068;991;1077
33;Asturias;056;Ribadesella;6433;3053;3380
33;Asturias;057;Ribera de Arriba;2227;1110;1117
33;Asturias;058;Riosa;2813;1459;1354
33;Asturias;059;Salas;7885;3903;3982
33;Asturias;061;San Martín de Oscos;614;326;288
33;Asturias;060;San Martín del Rey Aurelio;23665;11455;12210
33;Asturias;063;San Tirso de Abres;724;360;364
33;Asturias;062;Santa Eulalia de Oscos;655;337;318
33;Asturias;064;Santo Adriano;384;189;195
33;Asturias;065;Sariego;1511;760;751
33;Asturias;066;Siero;45391;22032;23359
33;Asturias;067;Sobrescobio;816;420;396
33;Asturias;068;Somiedo;1793;930;863
33;Asturias;069;Soto del Barco;4632;2216;2416
33;Asturias;070;Tapia de Casariego;4495;2152;2343
33;Asturias;071;Taramundi;1028;501;527
33;Asturias;072;Teverga;2579;1321;1258
33;Asturias;073;Tineo;14731;7454;7277
33;Asturias;034;Valdés;16871;8283;8588
33;Asturias;074;Vegadeo;5151;2465;2686
33;Asturias;075;Villanueva de Oscos;483;249;234
33;Asturias;076;Villaviciosa;15057;7406;7651
33;Asturias;077;Villayón;2236;1149;1087
33;Asturias;078;Yernes y Tameza;192;93;99
34;Palencia;001;Abarca de Campos;47;22;25
34;Palencia;003;Abia de las Torres;236;123;113
34;Palencia;004;Aguilar de Campoo;7793;3823;3970
34;Palencia;005;Alar del Rey;1550;725;825
34;Palencia;006;Alba de Cerrato;134;66;68
34;Palencia;009;Amayuelas de Arriba;62;36;26
34;Palencia;010;Ampudia;836;431;405
34;Palencia;011;Amusco;615;331;284
34;Palencia;012;Antigüedad;457;248;209
34;Palencia;015;Arconada;106;54;52
34;Palencia;017;Astudillo;1425;747;678
34;Palencia;018;Autilla del Pino;314;164;150
34;Palencia;019;Autillo de Campos;222;102;120
34;Palencia;020;Ayuela;105;59;46
34;Palencia;022;Baltanás;1659;849;810
34;Palencia;024;Baquerín de Campos;45;27;18
34;Palencia;025;Bárcena de Campos;66;28;38
34;Palencia;027;Barruelo de Santullán;2178;1028;1150
34;Palencia;028;Báscones de Ojeda;206;105;101
34;Palencia;029;Becerril de Campos;1238;600;638
34;Palencia;031;Belmonte de Campos;58;28;30
34;Palencia;032;Berzosilla;85;43;42
34;Palencia;033;Boada de Campos;29;14;15
34;Palencia;035;Boadilla de Rioseco;223;113;110
34;Palencia;034;Boadilla del Camino;224;118;106
34;Palencia;036;Brañosera;312;160;152
34;Palencia;037;Buenavista de Valdavia;476;234;242
34;Palencia;038;Bustillo de la Vega;402;214;188
34;Palencia;039;Bustillo del Páramo de Carrión;116;61;55
34;Palencia;041;Calahorra de Boedo;165;81;84
34;Palencia;042;Calzada de los Molinos;412;219;193
34;Palencia;045;Capillas;151;72;79
34;Palencia;046;Cardeñosa de Volpejera;54;24;30
34;Palencia;047;Carrión de los Condes;2529;1201;1328
34;Palencia;048;Castil de Vela;129;62;67
34;Palencia;049;Castrejón de la Peña;755;407;348
34;Palencia;050;Castrillo de Don Juan;391;215;176
34;Palencia;051;Castrillo de Onielo;211;104;107
34;Palencia;052;Castrillo de Villavega;328;164;164
34;Palencia;053;Castromocho;301;155;146
34;Palencia;055;Cervatos de la Cueza;429;218;211
34;Palencia;056;Cervera de Pisuerga;2888;1453;1435
34;Palencia;057;Cevico de la Torre;726;345;381
34;Palencia;058;Cevico Navero;326;170;156
34;Palencia;059;Cisneros;673;328;345
34;Palencia;060;Cobos de Cerrato;260;129;131
34;Palencia;061;Collazos de Boedo;181;99;82
34;Palencia;062;Congosto de Valdavia;306;167;139
34;Palencia;063;Cordovilla la Real;157;89;68
34;Palencia;066;Cubillas de Cerrato;125;63;62
34;Palencia;067;Dehesa de Montejo;356;203;153
34;Palencia;068;Dehesa de Romanos;67;35;32
34;Palencia;069;Dueñas;3087;1591;1496
34;Palencia;070;Espinosa de Cerrato;301;154;147
34;Palencia;071;Espinosa de Villagonzalo;321;157;164
34;Palencia;072;Frechilla;310;142;168
34;Palencia;073;Fresno del Río;217;114;103
34;Palencia;074;Frómista;1079;549;530
34;Palencia;076;Fuentes de Nava;906;444;462
34;Palencia;077;Fuentes de Valdepero;258;134;124
34;Palencia;079;Grijota;822;410;412
34;Palencia;080;Guardo;9362;4783;4579
34;Palencia;081;Guaza de Campos;104;51;53
34;Palencia;082;Hérmedes de Cerrato;173;79;94
34;Palencia;083;Herrera de Pisuerga;2845;1413;1432
34;Palencia;084;Herrera de Valdecañas;203;98;105
34;Palencia;086;Hontoria de Cerrato;136;69;67
34;Palencia;087;Hornillos de Cerrato;171;80;91
34;Palencia;088;Husillos;225;122;103
34;Palencia;089;Itero de la Vega;279;146;133
34;Palencia;091;Lagartos;194;107;87
34;Palencia;092;Lantadilla;627;308;319
34;Palencia;094;Ledigos;127;63;64
34;Palencia;903;Loma de Ucieza;376;195;181
34;Palencia;096;Lomas;71;35;36
34;Palencia;098;Magaz de Pisuerga;742;377;365
34;Palencia;099;Manquillos;92;51;41
34;Palencia;100;Mantinos;221;119;102
34;Palencia;101;Marcilla de Campos;85;37;48
34;Palencia;102;Mazariegos;292;156;136
34;Palencia;103;Mazuecos de Valdeginate;160;79;81
34;Palencia;104;Melgar de Yuso;471;255;216
34;Palencia;106;Meneses de Campos;174;94;80
34;Palencia;107;Micieces de Ojeda;133;67;66
34;Palencia;108;Monzón de Campos;902;466;436
34;Palencia;109;Moratinos;98;49;49
34;Palencia;110;Mudá;164;83;81
34;Palencia;112;Nogal de las Huertas;96;57;39
34;Palencia;113;Olea de Boedo;53;24;29
34;Palencia;114;Olmos de Ojeda;461;248;213
34;Palencia;116;Osornillo;114;59;55
34;Palencia;901;Osorno la Mayor;1877;977;900
34;Palencia;120;Palencia;78935;38015;40920
34;Palencia;121;Palenzuela;384;209;175
34;Palencia;122;Páramo de Boedo;137;66;71
34;Palencia;123;Paredes de Nava;2625;1300;1325
34;Palencia;124;Payo de Ojeda;106;55;51
34;Palencia;125;Pedraza de Campos;171;92;79
34;Palencia;126;Pedrosa de la Vega;424;228;196
34;Palencia;127;Perales;164;81;83
34;Palencia;904;Pernía (La);529;280;249
34;Palencia;129;Pino del Río;284;159;125
34;Palencia;130;Piña de Campos;359;190;169
34;Palencia;131;Población de Arroyo;102;57;45
34;Palencia;132;Población de Campos;249;135;114
34;Palencia;133;Población de Cerrato;141;76;65
34;Palencia;134;Polentinos;130;66;64
34;Palencia;135;Pomar de Valdivia;624;309;315
34;Palencia;136;Poza de la Vega;309;176;133
34;Palencia;137;Pozo de Urama;50;26;24
34;Palencia;139;Prádanos de Ojeda;259;131;128
34;Palencia;140;Puebla de Valdavia (La);195;98;97
34;Palencia;141;Quintana del Puente;323;159;164
34;Palencia;143;Quintanilla de Onsoña;297;165;132
34;Palencia;146;Reinoso de Cerrato;93;52;41
34;Palencia;147;Renedo de la Vega;310;172;138
34;Palencia;149;Requena de Campos;58;30;28
34;Palencia;151;Respenda de la Peña;335;177;158
34;Palencia;152;Revenga de Campos;213;100;113
34;Palencia;154;Revilla de Collazos;109;62;47
34;Palencia;155;Ribas de Campos;243;127;116
34;Palencia;156;Riberos de la Cueza;93;49;44
34;Palencia;157;Saldaña;3185;1645;1540
34;Palencia;158;Salinas de Pisuerga;286;155;131
34;Palencia;159;San Cebrián de Campos;536;297;239
34;Palencia;160;San Cebrián de Mudá;271;133;138
34;Palencia;161;San Cristóbal de Boedo;55;31;24
34;Palencia;163;San Mamés de Campos;137;61;76
34;Palencia;165;San Román de la Cuba;136;70;66
34;Palencia;167;Santa Cecilia del Alcor;180;94;86
34;Palencia;168;Santa Cruz de Boedo;88;45;43
34;Palencia;169;Santervás de la Vega;621;336;285
34;Palencia;170;Santibáñez de Ecla;115;47;68
34;Palencia;171;Santibáñez de la Peña;1846;927;919
34;Palencia;174;Santoyo;334;159;175
34;Palencia;175;Serna (La);152;85;67
34;Palencia;177;Soto de Cerrato;235;119;116
34;Palencia;176;Sotobañado y Priorato;210;109;101
34;Palencia;178;Tabanera de Cerrato;205;105;100
34;Palencia;179;Tabanera de Valdavia;60;27;33
34;Palencia;180;Támara de Campos;100;49;51
34;Palencia;181;Tariego de Cerrato;565;288;277
34;Palencia;182;Torquemada;1372;690;682
34;Palencia;184;Torremormojón;95;46;49
34;Palencia;185;Triollo;126;71;55
34;Palencia;186;Valbuena de Pisuerga;91;52;39
34;Palencia;189;Valdeolmillos;99;47;52
34;Palencia;190;Valderrábano;122;67;55
34;Palencia;192;Valde-Ucieza;160;89;71
34;Palencia;196;Valle de Cerrato;160;86;74
34;Palencia;902;Valle del Retortillo;279;136;143
34;Palencia;199;Velilla del Río Carrión;2079;1064;1015
34;Palencia;023;Venta de Baños;7038;3491;3547
34;Palencia;201;Vertavillo;283;155;128
34;Palencia;093;Vid de Ojeda (La);162;94;68
34;Palencia;202;Villabasta de Valdavia;49;22;27
34;Palencia;204;Villacidaler;94;48;46
34;Palencia;205;Villaconancio;100;52;48
34;Palencia;206;Villada;1433;697;736
34;Palencia;208;Villaeles de Valdavia;105;58;47
34;Palencia;210;Villahán;167;94;73
34;Palencia;211;Villaherreros;333;155;178
34;Palencia;213;Villalaco;91;40;51
34;Palencia;214;Villalba de Guardo;228;122;106
34;Palencia;215;Villalcázar de Sirga;251;116;135
34;Palencia;216;Villalcón;107;53;54
34;Palencia;217;Villalobón;272;144;128
34;Palencia;218;Villaluenga de la Vega;748;419;329
34;Palencia;220;Villamartín de Campos;176;94;82
34;Palencia;221;Villamediana;282;145;137
34;Palencia;222;Villameriel;187;98;89
34;Palencia;223;Villamoronta;360;187;173
34;Palencia;224;Villamuera de la Cueza;98;57;41
34;Palencia;225;Villamuriel de Cerrato;4100;2077;2023
34;Palencia;227;Villanueva del Rebollar;128;65;63
34;Palencia;228;Villanuño de Valdavia;145;80;65
34;Palencia;229;Villaprovedo;118;70;48
34;Palencia;230;Villarmentero de Campos;23;11;12
34;Palencia;231;Villarrabé;307;158;149
34;Palencia;232;Villarramiel;1205;602;603
34;Palencia;233;Villasarracino;362;181;181
34;Palencia;234;Villasila de Valdavia;127;66;61
34;Palencia;236;Villaturde;313;158;155
34;Palencia;237;Villaumbrales;952;501;451
34;Palencia;238;Villaviudas;495;242;253
34;Palencia;240;Villerías de Campos;148;82;66
34;Palencia;241;Villodre;50;26;24
34;Palencia;242;Villodrigo;154;78;76
34;Palencia;243;Villoldo;567;295;272
34;Palencia;245;Villota del Páramo;524;300;224
34;Palencia;246;Villovieco;148;81;67
35;Palmas (Las);001;Agaete;5416;2712;2704
35;Palmas (Las);002;Agüimes;17020;8625;8395
35;Palmas (Las);003;Antigua;2516;1340;1176
35;Palmas (Las);004;Arrecife;36631;18567;18064
35;Palmas (Las);005;Artenara;1130;574;556
35;Palmas (Las);006;Arucas;28521;14314;14207
35;Palmas (Las);007;Betancuria;581;303;278
35;Palmas (Las);008;Firgas;5980;3014;2966
35;Palmas (Las);009;Gáldar;21201;10666;10535
35;Palmas (Las);010;Haría;2997;1535;1462
35;Palmas (Las);011;Ingenio;22394;11406;10988
35;Palmas (Las);016;Las Palmas de Gran Canaria;362645;178443;184202
35;Palmas (Las);012;Mogán;9936;5204;4732
35;Palmas (Las);013;Moya;8256;4183;4073
35;Palmas (Las);014;Oliva (La);5956;3091;2865
35;Palmas (Las);015;Pájara;5835;3088;2747
35;Palmas (Las);017;Puerto del Rosario;17738;9486;8252
35;Palmas (Las);018;San Bartolomé;8297;4261;4036
35;Palmas (Las);019;San Bartolomé de Tirajana;31203;16208;14995
35;Palmas (Las);020;San Nicolás de Tolentino;7937;3969;3968
35;Palmas (Las);021;Santa Brígida;13873;6887;6986
35;Palmas (Las);022;Santa Lucía de Tirajana;35659;18162;17497
35;Palmas (Las);023;Santa María de Guía de Gran Canaria;12767;6445;6322
35;Palmas (Las);024;Teguise;8919;4634;4285
35;Palmas (Las);025;Tejeda;2398;1190;1208
35;Palmas (Las);026;Telde;82469;41343;41126
35;Palmas (Las);027;Teror;10856;5453;5403
35;Palmas (Las);028;Tías;9277;4862;4415
35;Palmas (Las);029;Tinajo;3537;1805;1732
35;Palmas (Las);030;Tuineje;7362;3863;3499
35;Palmas (Las);032;Valleseco;4424;2250;2174
35;Palmas (Las);031;Valsequillo de Gran Canaria;7000;3547;3453
35;Palmas (Las);033;Vega de San Mateo;6153;3139;3014
35;Palmas (Las);034;Yaiza;3097;1661;1436
36;Pontevedra;020;Agolada;5057;2485;2572
36;Pontevedra;001;Arbo;5011;2440;2571
36;Pontevedra;003;Baiona;10448;5123;5325
36;Pontevedra;002;Barro;3685;1763;1922
36;Pontevedra;004;Bueu;12788;6305;6483
36;Pontevedra;005;Caldas de Reis;9312;4502;4810
36;Pontevedra;006;Cambados;12906;6332;6574
36;Pontevedra;007;Campo Lameiro;2660;1275;1385
36;Pontevedra;008;Cangas;23465;11614;11851
36;Pontevedra;009;Cañiza (A);8001;3823;4178
36;Pontevedra;010;Catoira;3755;1862;1893
36;Pontevedra;011;Cerdedo;3724;1685;2039
36;Pontevedra;012;Cotobade;5464;2482;2982
36;Pontevedra;013;Covelo;4553;2061;2492
36;Pontevedra;014;Crecente;4009;1904;2105
36;Pontevedra;015;Cuntis;6027;2784;3243
36;Pontevedra;016;Dozón;2771;1372;1399
36;Pontevedra;017;Estrada (A);22683;10609;12074
36;Pontevedra;018;Forcarei;5886;2791;3095
36;Pontevedra;019;Fornelos de Montes;2456;1135;1321
36;Pontevedra;021;Gondomar;10851;5319;5532
36;Pontevedra;022;Grove (O);10878;5368;5510
36;Pontevedra;023;Guarda (A);10382;5024;5358
36;Pontevedra;901;Illa de Arousa (A);"";"";""
36;Pontevedra;024;Lalín;20839;10197;10642
36;Pontevedra;025;Lama (A);3471;1569;1902
36;Pontevedra;026;Marín;25129;12243;12886
36;Pontevedra;027;Meaño;5410;2607;2803
36;Pontevedra;028;Meis;5060;2394;2666
36;Pontevedra;029;Moaña;17830;8640;9190
36;Pontevedra;030;Mondariz;6699;3201;3498
36;Pontevedra;031;Mondariz-Balneario;637;299;338
36;Pontevedra;032;Moraña;4843;2330;2513
36;Pontevedra;033;Mos;13717;6667;7050
36;Pontevedra;034;Neves (As);5378;2535;2843
36;Pontevedra;035;Nigrán;14591;7145;7446
36;Pontevedra;036;Oia;3170;1578;1592
36;Pontevedra;037;Pazos de Borbén;3533;1650;1883
36;Pontevedra;041;Poio;13447;6535;6912
36;Pontevedra;043;Ponte Caldelas;7924;3753;4171
36;Pontevedra;042;Ponteareas;16257;7725;8532
36;Pontevedra;044;Pontecesures;2814;1380;1434
36;Pontevedra;038;Pontevedra;75324;35745;39579
36;Pontevedra;039;Porriño (O);15886;7691;8195
36;Pontevedra;040;Portas;3367;1571;1796
36;Pontevedra;045;Redondela;28519;13892;14627
36;Pontevedra;046;Ribadumia;4138;2000;2138
36;Pontevedra;047;Rodeiro;4938;2552;2386
36;Pontevedra;048;Rosal (O);5823;2840;2983
36;Pontevedra;049;Salceda de Caselas;5893;2898;2995
36;Pontevedra;050;Salvaterra de Miño;8991;4275;4716
36;Pontevedra;051;Sanxenxo;15325;7584;7741
36;Pontevedra;052;Silleda;10079;4833;5246
36;Pontevedra;053;Soutomaior;5008;2391;2617
36;Pontevedra;054;Tomiño;10455;5091;5364
36;Pontevedra;055;Tui;15496;7353;8143
36;Pontevedra;056;Valga;6427;3145;3282
36;Pontevedra;057;Vigo;285379;136309;149070
36;Pontevedra;059;Vila de Cruces;7582;3698;3884
36;Pontevedra;058;Vilaboa;5863;2859;3004
36;Pontevedra;060;Vilagarcía de Arousa;33204;16067;17137
36;Pontevedra;061;Vilanova de Arousa;15299;7512;7787
37;Salamanca;001;Abusejo;333;172;161
37;Salamanca;002;Agallas;244;123;121
37;Salamanca;003;Ahigal de los Aceiteros;241;120;121
37;Salamanca;004;Ahigal de Villarino;58;30;28
37;Salamanca;005;Alameda de Gardón (La);171;79;92
37;Salamanca;006;Alamedilla (La);249;119;130
37;Salamanca;007;Alaraz;734;384;350
37;Salamanca;008;Alba de Tormes;4416;2177;2239
37;Salamanca;009;Alba de Yeltes;332;162;170
37;Salamanca;010;Alberca (La);1104;564;540
37;Salamanca;011;Alberguería de Argañán (La);225;114;111
37;Salamanca;012;Alconada;254;129;125
37;Salamanca;015;Aldea del Obispo;445;223;222
37;Salamanca;013;Aldeacipreste;329;182;147
37;Salamanca;014;Aldeadávila de la Ribera;1708;870;838
37;Salamanca;016;Aldealengua;490;243;247
37;Salamanca;017;Aldeanueva de Figueroa;402;202;200
37;Salamanca;018;Aldeanueva de la Sierra;105;56;49
37;Salamanca;019;Aldearrodrigo;228;120;108
37;Salamanca;020;Aldearrubia;492;255;237
37;Salamanca;021;Aldeaseca de Alba;160;78;82
37;Salamanca;022;Aldeaseca de la Frontera;421;215;206
37;Salamanca;023;Aldeatejada;542;261;281
37;Salamanca;024;Aldeavieja de Tormes;146;70;76
37;Salamanca;025;Aldehuela de la Bóveda;422;213;209
37;Salamanca;026;Aldehuela de Yeltes;389;195;194
37;Salamanca;027;Almenara de Tormes;262;129;133
37;Salamanca;028;Almendra;242;122;120
37;Salamanca;029;Anaya de Alba;351;183;168
37;Salamanca;030;Añover de Tormes;129;66;63
37;Salamanca;031;Arabayona de Mógica;597;315;282
37;Salamanca;032;Arapiles;553;271;282
37;Salamanca;033;Arcediano;114;58;56
37;Salamanca;034;Arco (El);103;54;49
37;Salamanca;035;Armenteros;380;181;199
37;Salamanca;037;Atalaya (La);178;97;81
37;Salamanca;038;Babilafuente;1012;531;481
37;Salamanca;039;Bañobárez;537;282;255
37;Salamanca;040;Barbadillo;587;284;303
37;Salamanca;041;Barbalos;140;70;70
37;Salamanca;042;Barceo;90;47;43
37;Salamanca;044;Barruecopardo;668;334;334
37;Salamanca;045;Bastida (La);50;23;27
37;Salamanca;046;Béjar;17267;8250;9017
37;Salamanca;047;Beleña;125;54;71
37;Salamanca;049;Bermellar;262;127;135
37;Salamanca;050;Berrocal de Huebra;138;64;74
37;Salamanca;051;Berrocal de Salvatierra;168;86;82
37;Salamanca;052;Boada;502;248;254
37;Salamanca;054;Bodón (El);405;208;197
37;Salamanca;055;Bogajo;245;130;115
37;Salamanca;056;Bouza (La);77;40;37
37;Salamanca;057;Bóveda del Río Almar;353;180;173
37;Salamanca;058;Brincones;141;64;77
37;Salamanca;059;Buenamadre;202;104;98
37;Salamanca;060;Buenavista;114;62;52
37;Salamanca;061;Cabaco (El);305;155;150
37;Salamanca;063;Cabeza de Béjar (La);133;69;64
37;Salamanca;065;Cabeza del Caballo;562;287;275
37;Salamanca;062;Cabezabellosa de la Calzada;143;78;65
37;Salamanca;067;Cabrerizos;1019;507;512
37;Salamanca;068;Cabrillas;625;295;330
37;Salamanca;069;Calvarrasa de Abajo;1089;542;547
37;Salamanca;070;Calvarrasa de Arriba;637;331;306
37;Salamanca;071;Calzada de Béjar (La);113;59;54
37;Salamanca;072;Calzada de Don Diego;317;158;159
37;Salamanca;073;Calzada de Valdunciel;673;329;344
37;Salamanca;074;Campillo de Azaba;332;159;173
37;Salamanca;077;Campo de Peñaranda (El);458;235;223
37;Salamanca;078;Candelario;1209;604;605
37;Salamanca;079;Canillas de Abajo;147;82;65
37;Salamanca;080;Cantagallo;287;138;149
37;Salamanca;081;Cantalapiedra;1595;799;796
37;Salamanca;082;Cantalpino;1296;690;606
37;Salamanca;083;Cantaracillo;321;161;160
37;Salamanca;085;Carbajosa de la Sagrada;775;387;388
37;Salamanca;086;Carpio de Azaba;128;62;66
37;Salamanca;087;Carrascal de Barregas;273;135;138
37;Salamanca;088;Carrascal del Obispo;264;130;134
37;Salamanca;089;Casafranca;94;44;50
37;Salamanca;090;Casas del Conde (Las);112;53;59
37;Salamanca;091;Casillas de Flores;306;141;165
37;Salamanca;092;Castellanos de Moriscos;384;178;206
37;Salamanca;185;Castellanos de Villiquera;470;238;232
37;Salamanca;096;Castillejo de Martín Viejo;344;172;172
37;Salamanca;097;Castraz;78;44;34
37;Salamanca;098;Cepeda;587;278;309
37;Salamanca;099;Cereceda de la Sierra;125;64;61
37;Salamanca;100;Cerezal de Peñahorcada;156;80;76
37;Salamanca;101;Cerralbo;291;154;137
37;Salamanca;102;Cerro (El);625;311;314
37;Salamanca;103;Cespedosa de Tormes;754;403;351
37;Salamanca;114;Chagarcía Medianero;169;85;84
37;Salamanca;104;Cilleros de la Bastida;58;26;32
37;Salamanca;106;Cipérez;526;260;266
37;Salamanca;107;Ciudad Rodrigo;15309;7416;7893
37;Salamanca;108;Coca de Alba;202;98;104
37;Salamanca;109;Colmenar de Montemayor;312;165;147
37;Salamanca;110;Cordovilla;149;80;69
37;Salamanca;112;Cristóbal;253;140;113
37;Salamanca;113;Cubo de Don Sancho (El);660;349;311
37;Salamanca;115;Dios le Guarde;181;97;84
37;Salamanca;116;Doñinos de Ledesma;119;58;61
37;Salamanca;117;Doñinos de Salamanca;645;330;315
37;Salamanca;118;Ejeme;280;147;133
37;Salamanca;120;Encina de San Silvestre;127;63;64
37;Salamanca;119;Encina (La);262;143;119
37;Salamanca;121;Encinas de Abajo;764;392;372
37;Salamanca;122;Encinas de Arriba;301;149;152
37;Salamanca;123;Encinasola de los Comendadores;353;184;169
37;Salamanca;124;Endrinal;324;171;153
37;Salamanca;125;Escurial de la Sierra;350;167;183
37;Salamanca;126;Espadaña;67;37;30
37;Salamanca;127;Espeja;346;175;171
37;Salamanca;128;Espino de la Orbada;385;191;194
37;Salamanca;129;Florida de Liébana;251;141;110
37;Salamanca;130;Forfoleda;252;122;130
37;Salamanca;131;Frades de la Sierra;323;172;151
37;Salamanca;132;Fregeneda (La);650;305;345
37;Salamanca;133;Fresnedoso;150;70;80
37;Salamanca;134;Fresno Alhándiga;376;208;168
37;Salamanca;135;Fuente de San Esteban (La);1794;901;893
37;Salamanca;136;Fuenteguinaldo;1068;538;530
37;Salamanca;137;Fuenteliante;161;73;88
37;Salamanca;138;Fuenterroble de Salvatierra;279;145;134
37;Salamanca;139;Fuentes de Béjar;326;138;188
37;Salamanca;140;Fuentes de Oñoro;1456;720;736
37;Salamanca;141;Gajates;286;148;138
37;Salamanca;142;Galindo y Perahuy;184;94;90
37;Salamanca;143;Galinduste;614;309;305
37;Salamanca;144;Galisancho;774;410;364
37;Salamanca;145;Gallegos de Argañán;504;252;252
37;Salamanca;146;Gallegos de Solmirón;259;121;138
37;Salamanca;147;Garcibuey;334;187;147
37;Salamanca;148;Garcihernández;659;359;300
37;Salamanca;149;Garcirrey;113;57;56
37;Salamanca;150;Gejuelo del Barro;55;31;24
37;Salamanca;151;Golpejas;238;125;113
37;Salamanca;152;Gomecello;637;317;320
37;Salamanca;154;Guadramiro;260;150;110
37;Salamanca;155;Guijo de Ávila;120;68;52
37;Salamanca;156;Guijuelo;5004;2506;2498
37;Salamanca;157;Herguijuela de Ciudad Rodrigo;186;95;91
37;Salamanca;158;Herguijuela de la Sierra;390;189;201
37;Salamanca;159;Herguijuela del Campo;167;81;86
37;Salamanca;160;Hinojosa de Duero;958;460;498
37;Salamanca;161;Horcajo de Montemayor;208;107;101
37;Salamanca;162;Horcajo Medianero;449;228;221
37;Salamanca;163;Hoya (La);25;16;9
37;Salamanca;164;Huerta;286;152;134
37;Salamanca;165;Iruelos;82;38;44
37;Salamanca;166;Ituero de Azaba;338;171;167
37;Salamanca;167;Juzbado;200;102;98
37;Salamanca;168;Lagunilla;765;401;364
37;Salamanca;169;Larrodrigo;352;187;165
37;Salamanca;170;Ledesma;2016;988;1028
37;Salamanca;171;Ledrada;631;303;328
37;Salamanca;172;Linares de Riofrío;1215;629;586
37;Salamanca;173;Lumbrales;2410;1200;1210
37;Salamanca;175;Machacón;581;292;289
37;Salamanca;174;Macotera;1854;934;920
37;Salamanca;176;Madroñal;172;88;84
37;Salamanca;177;Maíllo (El);466;238;228
37;Salamanca;178;Malpartida;192;102;90
37;Salamanca;179;Mancera de Abajo;412;207;205
37;Salamanca;180;Manzano (El);118;63;55
37;Salamanca;181;Martiago;504;246;258
37;Salamanca;183;Martín de Yeltes;604;306;298
37;Salamanca;182;Martinamor;100;53;47
37;Salamanca;184;Masueco;526;261;265
37;Salamanca;186;Mata de Ledesma (La);167;78;89
37;Salamanca;187;Matilla de los Caños del Río;745;382;363
37;Salamanca;188;Maya (La);278;148;130
37;Salamanca;189;Membribe de la Sierra;120;61;59
37;Salamanca;190;Mieza;422;216;206
37;Salamanca;191;Milano (El);193;100;93
37;Salamanca;192;Miranda de Azán;147;75;72
37;Salamanca;193;Miranda del Castañar;627;337;290
37;Salamanca;194;Mogarraz;406;193;213
37;Salamanca;195;Molinillo;96;50;46
37;Salamanca;196;Monforte de la Sierra;140;74;66
37;Salamanca;197;Monleón;145;88;57
37;Salamanca;198;Monleras;309;155;154
37;Salamanca;199;Monsagro;285;161;124
37;Salamanca;200;Montejo;251;134;117
37;Salamanca;201;Montemayor del Río;379;193;186
37;Salamanca;202;Monterrubio de Armuña;218;112;106
37;Salamanca;203;Monterrubio de la Sierra;176;90;86
37;Salamanca;204;Morasverdes;520;269;251
37;Salamanca;205;Morille;226;114;112
37;Salamanca;206;Moríñigo;159;90;69
37;Salamanca;207;Moriscos;139;79;60
37;Salamanca;208;Moronta;161;80;81
37;Salamanca;209;Mozárbez;382;187;195
37;Salamanca;211;Narros de Matalayegua;363;192;171
37;Salamanca;213;Nava de Béjar;126;61;65
37;Salamanca;214;Nava de Francia;159;85;74
37;Salamanca;215;Nava de Sotrobal;238;127;111
37;Salamanca;212;Navacarros;97;49;48
37;Salamanca;216;Navales;414;236;178
37;Salamanca;217;Navalmoral de Béjar;87;40;47
37;Salamanca;218;Navamorales;210;114;96
37;Salamanca;219;Navarredonda de la Rinconada;308;154;154
37;Salamanca;221;Navasfrías;805;395;410
37;Salamanca;222;Negrilla de Palencia;121;61;60
37;Salamanca;223;Olmedo de Camaces;209;100;109
37;Salamanca;224;Orbada (La);312;151;161
37;Salamanca;225;Pajares de la Laguna;164;81;83
37;Salamanca;226;Palacios del Arzobispo;282;147;135
37;Salamanca;228;Palaciosrubios;611;314;297
37;Salamanca;229;Palencia de Negrilla;224;111;113
37;Salamanca;230;Parada de Arriba;245;124;121
37;Salamanca;231;Parada de Rubiales;386;190;196
37;Salamanca;232;Paradinas de San Juan;673;357;316
37;Salamanca;233;Pastores;82;43;39
37;Salamanca;234;Payo (El);599;287;312
37;Salamanca;235;Pedraza de Alba;307;167;140
37;Salamanca;236;Pedrosillo de Alba;322;164;158
37;Salamanca;237;Pedrosillo de los Aires;508;272;236
37;Salamanca;238;Pedrosillo el Ralo;157;82;75
37;Salamanca;239;Pedroso de la Armuña (El);359;176;183
37;Salamanca;240;Pelabravo;670;346;324
37;Salamanca;241;Pelarrodríguez;232;126;106
37;Salamanca;242;Pelayos;99;54;45
37;Salamanca;243;Peña (La);172;83;89
37;Salamanca;244;Peñacaballera;257;123;134
37;Salamanca;245;Peñaparda;544;254;290
37;Salamanca;246;Peñaranda de Bracamonte;6388;3122;3266
37;Salamanca;247;Peñarandilla;321;162;159
37;Salamanca;248;Peralejos de Abajo;239;113;126
37;Salamanca;249;Peralejos de Arriba;84;47;37
37;Salamanca;250;Pereña de la Ribera;549;285;264
37;Salamanca;251;Peromingo;171;81;90
37;Salamanca;252;Pinedas;239;120;119
37;Salamanca;253;Pino de Tormes (El);168;90;78
37;Salamanca;254;Pitiegua;289;143;146
37;Salamanca;255;Pizarral;99;46;53
37;Salamanca;256;Poveda de las Cintas;410;219;191
37;Salamanca;257;Pozos de Hinojo;107;56;51
37;Salamanca;258;Puebla de Azaba;329;165;164
37;Salamanca;259;Puebla de San Medel;74;38;36
37;Salamanca;260;Puebla de Yeltes;265;140;125
37;Salamanca;261;Puente del Congosto;394;195;199
37;Salamanca;262;Puertas;129;69;60
37;Salamanca;263;Puerto de Béjar;545;260;285
37;Salamanca;264;Puerto Seguro;130;65;65
37;Salamanca;265;Rágama;366;195;171
37;Salamanca;266;Redonda (La);118;55;63
37;Salamanca;267;Retortillo;291;136;155
37;Salamanca;268;Rinconada de la Sierra (La);193;90;103
37;Salamanca;269;Robleda;646;341;305
37;Salamanca;270;Robliza de Cojos;237;113;124
37;Salamanca;271;Rollán;640;327;313
37;Salamanca;272;Saelices el Chico;214;115;99
37;Salamanca;273;Sagrada (La);222;107;115
37;Salamanca;303;Sahugo (El);344;174;170
37;Salamanca;274;Salamanca;166435;78807;87628
37;Salamanca;275;Saldeana;218;113;105
37;Salamanca;276;Salmoral;405;206;199
37;Salamanca;277;Salvatierra de Tormes;74;38;36
37;Salamanca;278;San Cristóbal de la Cuesta;261;135;126
37;Salamanca;284;San Esteban de la Sierra;495;262;233
37;Salamanca;285;San Felices de los Gallegos;704;355;349
37;Salamanca;286;San Martín del Castañar;323;167;156
37;Salamanca;287;San Miguel de Valero;455;227;228
37;Salamanca;036;San Miguel del Robledo;111;55;56
37;Salamanca;288;San Morales;198;105;93
37;Salamanca;289;San Muñoz;421;209;212
37;Salamanca;291;San Pedro de Rozados;426;219;207
37;Salamanca;290;San Pedro del Valle;136;70;66
37;Salamanca;292;San Pelayo de Guareña;131;67;64
37;Salamanca;280;Sanchón de la Ribera;152;76;76
37;Salamanca;281;Sanchón de la Sagrada;65;34;31
37;Salamanca;282;Sanchotello;369;189;180
37;Salamanca;279;Sancti-Spíritus;1322;672;650
37;Salamanca;283;Sando;267;152;115
37;Salamanca;293;Santa María de Sando;222;121;101
37;Salamanca;294;Santa Marta de Tormes;7820;3876;3944
37;Salamanca;296;Santiago de la Puebla;671;352;319
37;Salamanca;297;Santibáñez de Béjar;747;373;374
37;Salamanca;298;Santibáñez de la Sierra;265;141;124
37;Salamanca;299;Santiz;320;168;152
37;Salamanca;300;Santos (Los);800;431;369
37;Salamanca;301;Sardón de los Frailes;121;69;52
37;Salamanca;302;Saucelle;544;273;271
37;Salamanca;304;Sepulcro-Hilario;337;169;168
37;Salamanca;305;Sequeros;268;124;144
37;Salamanca;306;Serradilla del Arroyo;508;260;248
37;Salamanca;307;Serradilla del Llano;375;187;188
37;Salamanca;309;Sierpe (La);61;32;29
37;Salamanca;310;Sieteiglesias de Tormes;177;93;84
37;Salamanca;311;Sobradillo;444;213;231
37;Salamanca;312;Sorihuela;467;231;236
37;Salamanca;313;Sotoserrano;805;412;393
37;Salamanca;314;Tabera de Abajo;123;62;61
37;Salamanca;315;Tala (La);170;90;80
37;Salamanca;316;Tamames;1138;574;564
37;Salamanca;317;Tarazona de Guareña;472;254;218
37;Salamanca;318;Tardáguila;283;149;134
37;Salamanca;319;Tejado (El);216;106;110
37;Salamanca;320;Tejeda y Segoyuela;163;83;80
37;Salamanca;321;Tenebrón;251;123;128
37;Salamanca;322;Terradillos;2064;1027;1037
37;Salamanca;323;Topas;763;392;371
37;Salamanca;324;Tordillos;678;343;335
37;Salamanca;325;Tornadizo (El);155;82;73
37;Salamanca;327;Torresmenudas;269;131;138
37;Salamanca;328;Trabanca;278;143;135
37;Salamanca;329;Tremedal de Tormes;67;34;33
37;Salamanca;330;Valdecarros;478;243;235
37;Salamanca;331;Valdefuentes de Sangusín;370;184;186
37;Salamanca;332;Valdehijaderos;130;73;57
37;Salamanca;333;Valdelacasa;369;190;179
37;Salamanca;334;Valdelageve;145;80;65
37;Salamanca;335;Valdelosa;501;243;258
37;Salamanca;336;Valdemierque;80;41;39
37;Salamanca;337;Valderrodrigo;215;108;107
37;Salamanca;338;Valdunciel;141;67;74
37;Salamanca;339;Valero;512;260;252
37;Salamanca;343;Vallejera de Riofrío;53;20;33
37;Salamanca;340;Valsalabroso;264;133;131
37;Salamanca;341;Valverde de Valdelacasa;86;41;45
37;Salamanca;342;Valverdón;273;146;127
37;Salamanca;344;Vecinos;340;170;170
37;Salamanca;345;Vega de Tirados;257;136;121
37;Salamanca;346;Veguillas (Las);332;159;173
37;Salamanca;347;Vellés (La);447;222;225
37;Salamanca;348;Ventosa del Río Almar;178;86;92
37;Salamanca;349;Vídola (La);232;119;113
37;Salamanca;351;Villaflores;534;270;264
37;Salamanca;352;Villagonzalo de Tormes;275;147;128
37;Salamanca;353;Villalba de los Llanos;221;123;98
37;Salamanca;354;Villamayor;1328;686;642
37;Salamanca;355;Villanueva del Conde;299;154;145
37;Salamanca;356;Villar de Argañán;129;65;64
37;Salamanca;357;Villar de Ciervo;476;254;222
37;Salamanca;358;Villar de Gallimazo;270;140;130
37;Salamanca;359;Villar de la Yegua;369;177;192
37;Salamanca;360;Villar de Peralonso;399;194;205
37;Salamanca;361;Villar de Samaniego;152;81;71
37;Salamanca;362;Villares de la Reina;1240;610;630
37;Salamanca;363;Villares de Yeltes;192;93;99
37;Salamanca;364;Villarino de los Aires;1264;620;644
37;Salamanca;365;Villarmayor;240;122;118
37;Salamanca;366;Villarmuerto;77;43;34
37;Salamanca;367;Villasbuenas;373;183;190
37;Salamanca;368;Villasdardo;33;18;15
37;Salamanca;369;Villaseco de los Gamitos;235;115;120
37;Salamanca;370;Villaseco de los Reyes;455;234;221
37;Salamanca;371;Villasrubias;454;245;209
37;Salamanca;372;Villaverde de Guareña;229;116;113
37;Salamanca;373;Villavieja de Yeltes;1173;588;585
37;Salamanca;374;Villoria;1415;701;714
37;Salamanca;375;Villoruela;1090;540;550
37;Salamanca;350;Vilvestre;679;333;346
37;Salamanca;376;Vitigudino;3222;1578;1644
37;Salamanca;377;Yecla de Yeltes;440;218;222
37;Salamanca;378;Zamarra;175;96;79
37;Salamanca;379;Zamayón;197;108;89
37;Salamanca;380;Zarapicos;81;42;39
37;Salamanca;381;Zarza de Pumareda (La);237;133;104
37;Salamanca;382;Zorita de la Frontera;337;180;157
38;Santa Cruz de Tenerife;001;Adeje;11804;5958;5846
38;Santa Cruz de Tenerife;002;Agulo;1192;599;593
38;Santa Cruz de Tenerife;003;Alajeró;1188;624;564
38;Santa Cruz de Tenerife;004;Arafo;4309;2088;2221
38;Santa Cruz de Tenerife;005;Arico;4782;2448;2334
38;Santa Cruz de Tenerife;006;Arona;26490;13331;13159
38;Santa Cruz de Tenerife;007;Barlovento;2666;1341;1325
38;Santa Cruz de Tenerife;008;Breña Alta;5569;2781;2788
38;Santa Cruz de Tenerife;009;Breña Baja;3452;1724;1728
38;Santa Cruz de Tenerife;010;Buenavista del Norte;5573;2831;2742
38;Santa Cruz de Tenerife;011;Candelaria;11305;5617;5688
38;Santa Cruz de Tenerife;012;Fasnia;2288;1142;1146
38;Santa Cruz de Tenerife;013;Frontera;3967;2002;1965
38;Santa Cruz de Tenerife;014;Fuencaliente de la Palma;1754;892;862
38;Santa Cruz de Tenerife;015;Garachico;6032;2960;3072
38;Santa Cruz de Tenerife;016;Garafía;2016;1014;1002
38;Santa Cruz de Tenerife;017;Granadilla de Abona;17593;8941;8652
38;Santa Cruz de Tenerife;018;Guancha (La);5337;2666;2671
38;Santa Cruz de Tenerife;019;Guía de Isora;12528;6169;6359
38;Santa Cruz de Tenerife;020;Güímar;15023;7461;7562
38;Santa Cruz de Tenerife;021;Hermigua;2146;1112;1034
38;Santa Cruz de Tenerife;022;Icod de los Vinos;21801;10776;11025
38;Santa Cruz de Tenerife;024;Llanos de Aridane (Los);17116;8411;8705
38;Santa Cruz de Tenerife;025;Matanza de Acentejo (La);6172;3169;3003
38;Santa Cruz de Tenerife;026;Orotava (La);35723;17610;18113
38;Santa Cruz de Tenerife;027;Paso (El);7220;3575;3645
38;Santa Cruz de Tenerife;028;Puerto de la Cruz;26866;13126;13740
38;Santa Cruz de Tenerife;029;Puntagorda;1813;898;915
38;Santa Cruz de Tenerife;030;Puntallana;2286;1144;1142
38;Santa Cruz de Tenerife;031;Realejos (Los);31789;15730;16059
38;Santa Cruz de Tenerife;032;Rosario (El);9462;4804;4658
38;Santa Cruz de Tenerife;033;San Andrés y Sauces;5383;2702;2681
38;Santa Cruz de Tenerife;023;San Cristóbal de La Laguna;112917;55520;57397
38;Santa Cruz de Tenerife;034;San Juan de la Rambla;4624;2287;2337
38;Santa Cruz de Tenerife;035;San Miguel de Abona;5673;2893;2780
38;Santa Cruz de Tenerife;036;San Sebastián de la Gomera;5908;2999;2909
38;Santa Cruz de Tenerife;037;Santa Cruz de la Palma;17362;8390;8972
38;Santa Cruz de Tenerife;038;Santa Cruz de Tenerife;202237;97938;104299
38;Santa Cruz de Tenerife;039;Santa Úrsula;9016;4509;4507
38;Santa Cruz de Tenerife;040;Santiago del Teide;6256;3145;3111
38;Santa Cruz de Tenerife;041;Sauzal (El);6507;3265;3242
38;Santa Cruz de Tenerife;042;Silos (Los);5513;2712;2801
38;Santa Cruz de Tenerife;043;Tacoronte;18211;9102;9109
38;Santa Cruz de Tenerife;044;Tanque (El);3110;1556;1554
38;Santa Cruz de Tenerife;045;Tazacorte;6601;3314;3287
38;Santa Cruz de Tenerife;046;Tegueste;8336;4190;4146
38;Santa Cruz de Tenerife;047;Tijarafe;2516;1266;1250
38;Santa Cruz de Tenerife;049;Valle Gran Rey;3117;1587;1530
38;Santa Cruz de Tenerife;050;Vallehermoso;2986;1514;1472
38;Santa Cruz de Tenerife;048;Valverde;3644;1810;1834
38;Santa Cruz de Tenerife;051;Victoria de Acentejo (La);7508;3790;3718
38;Santa Cruz de Tenerife;052;Vilaflor;1576;803;773
38;Santa Cruz de Tenerife;053;Villa de Mazo;5159;2570;2589
39;Cantabria;001;Alfoz de Lloredo;2760;1422;1338
39;Cantabria;002;Ampuero;3429;1707;1722
39;Cantabria;003;Anievas;438;218;220
39;Cantabria;004;Arenas de Iguña;2264;1153;1111
39;Cantabria;005;Argoños;673;338;335
39;Cantabria;006;Arnuero;1902;949;953
39;Cantabria;007;Arredondo;728;393;335
39;Cantabria;008;Astillero (El);12714;6278;6436
39;Cantabria;009;Bárcena de Cicero;2304;1172;1132
39;Cantabria;010;Bárcena de Pie de Concha;946;436;510
39;Cantabria;011;Bareyo;1657;833;824
39;Cantabria;012;Cabezón de la Sal;7095;3472;3623
39;Cantabria;013;Cabezón de Liébana;823;441;382
39;Cantabria;014;Cabuérniga;1127;565;562
39;Cantabria;015;Camaleño;1207;619;588
39;Cantabria;016;Camargo;21117;10454;10663
39;Cantabria;027;Campoo de Enmedio;3958;2006;1952
39;Cantabria;017;Campoo de Yuso;819;406;413
39;Cantabria;018;Cartes;2277;1136;1141
39;Cantabria;019;Castañeda;1568;775;793
39;Cantabria;020;Castro-Urdiales;14080;7009;7071
39;Cantabria;021;Cieza;790;387;403
39;Cantabria;022;Cillorigo de Liébana;1112;594;518
39;Cantabria;023;Colindres;5722;2847;2875
39;Cantabria;024;Comillas;2491;1184;1307
39;Cantabria;025;Corrales de Buelna (Los);9999;4988;5011
39;Cantabria;026;Corvera de Toranzo;2197;1102;1095
39;Cantabria;028;Entrambasaguas;2561;1279;1282
39;Cantabria;029;Escalante;740;372;368
39;Cantabria;030;Guriezo;1771;916;855
39;Cantabria;031;Hazas de Cesto;1280;646;634
39;Cantabria;032;Hermandad de Campoo de Suso;1925;1019;906
39;Cantabria;033;Herrerías;813;444;369
39;Cantabria;034;Lamasón;474;256;218
39;Cantabria;035;Laredo;13741;6677;7064
39;Cantabria;036;Liendo;798;396;402
39;Cantabria;037;Liérganes;2314;1155;1159
39;Cantabria;038;Limpias;1195;599;596
39;Cantabria;039;Luena;1160;590;570
39;Cantabria;040;Marina de Cudeyo;4504;2244;2260
39;Cantabria;041;Mazcuerras;1829;956;873
39;Cantabria;042;Medio Cudeyo;5810;2863;2947
39;Cantabria;043;Meruelo;1000;509;491
39;Cantabria;044;Miengo;3113;1550;1563
39;Cantabria;045;Miera;654;318;336
39;Cantabria;046;Molledo;2131;1055;1076
39;Cantabria;047;Noja;1600;789;811
39;Cantabria;048;Penagos;1812;896;916
39;Cantabria;049;Peñarrubia;337;173;164
39;Cantabria;050;Pesaguero;467;258;209
39;Cantabria;051;Pesquera;111;54;57
39;Cantabria;052;Piélagos;9467;4680;4787
39;Cantabria;053;Polaciones;343;200;143
39;Cantabria;054;Polanco;3804;1867;1937
39;Cantabria;055;Potes;1486;732;754
39;Cantabria;056;Puente Viesgo;2479;1239;1240
39;Cantabria;057;Ramales de la Victoria;2437;1244;1193
39;Cantabria;058;Rasines;1043;527;516
39;Cantabria;059;Reinosa;12521;6106;6415
39;Cantabria;060;Reocín;6725;3338;3387
39;Cantabria;061;Ribamontán al Mar;2994;1531;1463
39;Cantabria;062;Ribamontán al Monte;2037;1061;976
39;Cantabria;063;Rionansa;1668;889;779
39;Cantabria;064;Riotuerto;1585;763;822
39;Cantabria;065;Rozas de Valdearroyo (Las);307;158;149
39;Cantabria;066;Ruente;956;487;469
39;Cantabria;067;Ruesga;1334;666;668
39;Cantabria;068;Ruiloba;746;371;375
39;Cantabria;069;San Felices de Buelna;2355;1155;1200
39;Cantabria;070;San Miguel de Aguayo;169;88;81
39;Cantabria;071;San Pedro del Romeral;807;423;384
39;Cantabria;072;San Roque de Riomiera;615;333;282
39;Cantabria;080;San Vicente de la Barquera;4551;2313;2238
39;Cantabria;073;Santa Cruz de Bezana;5581;2777;2804
39;Cantabria;074;Santa María de Cayón;6123;3072;3051
39;Cantabria;075;Santander;193237;91360;101877
39;Cantabria;076;Santillana del Mar;3939;1919;2020
39;Cantabria;077;Santiurde de Reinosa;388;208;180
39;Cantabria;078;Santiurde de Toranzo;1794;900;894
39;Cantabria;079;Santoña;11771;6090;5681
39;Cantabria;081;Saro;567;292;275
39;Cantabria;082;Selaya;2067;1052;1015
39;Cantabria;083;Soba;1843;966;877
39;Cantabria;084;Solórzano;1001;514;487
39;Cantabria;085;Suances;6006;2959;3047
39;Cantabria;086;Tojos (Los);418;224;194
39;Cantabria;087;Torrelavega;60027;29224;30803
39;Cantabria;088;Tresviso;78;46;32
39;Cantabria;089;Tudanca;280;168;112
39;Cantabria;090;Udías;832;420;412
39;Cantabria;095;Val de San Vicente;2540;1307;1233
39;Cantabria;091;Valdáliga;2755;1410;1345
39;Cantabria;092;Valdeolea;1763;899;864
39;Cantabria;093;Valdeprado del Río;374;188;186
39;Cantabria;094;Valderredible;1199;629;570
39;Cantabria;096;Vega de Liébana;1118;588;530
39;Cantabria;097;Vega de Pas;1135;573;562
39;Cantabria;098;Villacarriedo;2150;1078;1072
39;Cantabria;099;Villaescusa;2939;1422;1517
39;Cantabria;100;Villafufre;1161;590;571
39;Cantabria;101;Villaverde de Trucíos;365;187;178
39;Cantabria;102;Voto;2513;1304;1209
40;Segovia;001;Abades;909;450;459
40;Segovia;002;Adrada de Pirón;53;31;22
40;Segovia;003;Adrados;263;129;134
40;Segovia;004;Aguilafuente;801;391;410
40;Segovia;005;Alconada de Maderuelo;60;31;29
40;Segovia;012;Aldea Real;421;223;198
40;Segovia;006;Aldealcorvo;38;19;19
40;Segovia;007;Aldealengua de Pedraza;115;62;53
40;Segovia;008;Aldealengua de Santa María;83;47;36
40;Segovia;009;Aldeanueva de la Serrezuela;56;31;25
40;Segovia;010;Aldeanueva del Codonal;248;125;123
40;Segovia;013;Aldeasoña;167;77;90
40;Segovia;014;Aldehorno;96;53;43
40;Segovia;015;Aldehuela del Codonal;67;29;38
40;Segovia;016;Aldeonte;107;53;54
40;Segovia;017;Anaya;128;66;62
40;Segovia;018;Añe;126;70;56
40;Segovia;019;Arahuetes;55;28;27
40;Segovia;020;Arcones;292;154;138
40;Segovia;021;Arevalillo de Cega;43;23;20
40;Segovia;022;Armuña;316;161;155
40;Segovia;024;Ayllón;1272;641;631
40;Segovia;025;Barbolla;244;128;116
40;Segovia;026;Basardilla;120;60;60
40;Segovia;028;Bercial;160;75;85
40;Segovia;029;Bercimuel;77;32;45
40;Segovia;030;Bernardos;803;396;407
40;Segovia;031;Bernuy de Porreros;325;169;156
40;Segovia;032;Boceguillas;541;261;280
40;Segovia;033;Brieva;53;35;18
40;Segovia;034;Caballar;110;51;59
40;Segovia;035;Cabañas de Polendos;114;60;54
40;Segovia;036;Cabezuela;807;423;384
40;Segovia;037;Calabazas de Fuentidueña;98;47;51
40;Segovia;039;Campo de San Pedro;398;229;169
40;Segovia;040;Cantalejo;3469;1748;1721
40;Segovia;041;Cantimpalos;1349;685;664
40;Segovia;043;Carbonero el Mayor;2370;1201;1169
40;Segovia;044;Carrascal del Río;225;119;106
40;Segovia;045;Casla;155;83;72
40;Segovia;046;Castillejo de Mesleón;142;68;74
40;Segovia;047;Castro de Fuentidueña;102;59;43
40;Segovia;048;Castrojimeno;53;33;20
40;Segovia;049;Castroserna de Abajo;70;42;28
40;Segovia;051;Castroserracín;46;27;19
40;Segovia;052;Cedillo de la Torre;161;83;78
40;Segovia;053;Cerezo de Abajo;172;92;80
40;Segovia;054;Cerezo de Arriba;201;108;93
40;Segovia;065;Chañe;758;392;366
40;Segovia;055;Cilleruelo de San Mamés;67;32;35
40;Segovia;056;Cobos de Fuentidueña;86;39;47
40;Segovia;057;Coca;2036;1015;1021
40;Segovia;058;Codorniz;502;250;252
40;Segovia;059;Collado Hermoso;135;66;69
40;Segovia;060;Condado de Castilnovo;154;82;72
40;Segovia;061;Corral de Ayllón;130;70;60
40;Segovia;902;Cozuelos de Fuentidueña;241;122;119
40;Segovia;062;Cubillo;78;42;36
40;Segovia;063;Cuéllar;9171;4635;4536
40;Segovia;905;Cuevas de Provanco;260;139;121
40;Segovia;068;Domingo García;58;26;32
40;Segovia;069;Donhierro;124;71;53
40;Segovia;070;Duruelo;125;62;63
40;Segovia;071;Encinas;76;36;40
40;Segovia;072;Encinillas;74;37;37
40;Segovia;073;Escalona del Prado;624;318;306
40;Segovia;074;Escarabajosa de Cabezas;410;221;189
40;Segovia;075;Escobar de Polendos;244;120;124
40;Segovia;076;Espinar (El);5359;2724;2635
40;Segovia;077;Espirdo;219;124;95
40;Segovia;078;Fresneda de Cuéllar;270;143;127
40;Segovia;079;Fresno de Cantespino;237;126;111
40;Segovia;080;Fresno de la Fuente;90;50;40
40;Segovia;081;Frumales;259;132;127
40;Segovia;082;Fuente de Santa Cruz;226;119;107
40;Segovia;083;Fuente el Olmo de Fuentidueña;212;108;104
40;Segovia;084;Fuente el Olmo de Íscar;116;66;50
40;Segovia;086;Fuentepelayo;1020;518;502
40;Segovia;087;Fuentepiñel;200;98;102
40;Segovia;088;Fuenterrebollo;488;237;251
40;Segovia;089;Fuentesaúco de Fuentidueña;394;206;188
40;Segovia;091;Fuentesoto;181;93;88
40;Segovia;092;Fuentidueña;217;102;115
40;Segovia;093;Gallegos;103;54;49
40;Segovia;094;Garcillán;362;189;173
40;Segovia;095;Gomezserracín;676;342;334
40;Segovia;097;Grajera;83;43;40
40;Segovia;099;Honrubia de la Cuesta;104;51;53
40;Segovia;100;Hontalbilla;516;264;252
40;Segovia;101;Hontanares de Eresma;140;74;66
40;Segovia;103;Huertos (Los);159;83;76
40;Segovia;104;Ituero y Lama;56;33;23
40;Segovia;105;Juarros de Riomoros;87;47;40
40;Segovia;106;Juarros de Voltoya;299;162;137
40;Segovia;107;Labajos;165;91;74
40;Segovia;108;Laguna de Contreras;207;113;94
40;Segovia;109;Languilla;160;85;75
40;Segovia;110;Lastras de Cuéllar;608;315;293
40;Segovia;111;Lastras del Pozo;98;53;45
40;Segovia;112;Lastrilla (La);829;428;401
40;Segovia;113;Losa (La);332;171;161
40;Segovia;115;Maderuelo;164;84;80
40;Segovia;903;Marazoleja;177;97;80
40;Segovia;118;Marazuela;99;48;51
40;Segovia;119;Martín Miguel;208;104;104
40;Segovia;120;Martín Muñoz de la Dehesa;185;100;85
40;Segovia;121;Martín Muñoz de las Posadas;607;306;301
40;Segovia;122;Marugán;270;132;138
40;Segovia;124;Mata de Cuéllar;337;182;155
40;Segovia;123;Matabuena;224;114;110
40;Segovia;125;Matilla (La);131;70;61
40;Segovia;126;Melque de Cercos;151;68;83
40;Segovia;127;Membibre de la Hoz;97;50;47
40;Segovia;128;Migueláñez;193;97;96
40;Segovia;129;Montejo de Arévalo;323;171;152
40;Segovia;130;Montejo de la Vega de la Serrezuela;208;113;95
40;Segovia;131;Monterrubio;62;31;31
40;Segovia;132;Moral de Hornuez;127;66;61
40;Segovia;134;Mozoncillo;1053;545;508
40;Segovia;135;Muñopedro;439;223;216
40;Segovia;136;Muñoveros;237;125;112
40;Segovia;138;Nava de la Asunción;2662;1354;1308
40;Segovia;139;Navafría;414;221;193
40;Segovia;140;Navalilla;185;95;90
40;Segovia;141;Navalmanzano;1181;608;573
40;Segovia;142;Navares de Ayuso;81;44;37
40;Segovia;143;Navares de Enmedio;199;105;94
40;Segovia;144;Navares de las Cuevas;27;15;12
40;Segovia;145;Navas de Oro;1501;761;740
40;Segovia;904;Navas de Riofrío;250;107;143
40;Segovia;146;Navas de San Antonio;321;164;157
40;Segovia;148;Nieva;395;199;196
40;Segovia;149;Olombrada;887;465;422
40;Segovia;150;Orejana;119;62;57
40;Segovia;151;Ortigosa de Pestaño;98;51;47
40;Segovia;901;Ortigosa del Monte;323;155;168
40;Segovia;152;Otero de Herreros;852;431;421
40;Segovia;154;Pajarejos;48;22;26
40;Segovia;155;Palazuelos de Eresma;1700;844;856
40;Segovia;156;Pedraza;466;228;238
40;Segovia;157;Pelayos del Arroyo;44;24;20
40;Segovia;158;Perosillo;35;20;15
40;Segovia;159;Pinarejos;221;120;101
40;Segovia;160;Pinarnegrillo;218;114;104
40;Segovia;161;Pradales;69;41;28
40;Segovia;162;Prádena;570;303;267
40;Segovia;163;Puebla de Pedraza;95;47;48
40;Segovia;164;Rapariegos;323;174;149
40;Segovia;165;Rebollo;150;84;66
40;Segovia;166;Remondo;395;187;208
40;Segovia;168;Riaguas de San Bartolomé;78;41;37
40;Segovia;170;Riaza;1662;874;788
40;Segovia;171;Ribota;39;22;17
40;Segovia;172;Riofrío de Riaza;62;36;26
40;Segovia;173;Roda de Eresma;106;53;53
40;Segovia;174;Sacramenia;605;318;287
40;Segovia;176;Samboal;673;344;329
40;Segovia;177;San Cristóbal de Cuéllar;269;136;133
40;Segovia;178;San Cristóbal de la Vega;187;96;91
40;Segovia;906;San Cristóbal de Segovia;"";"";""
40;Segovia;181;San Ildefonso;4964;2403;2561
40;Segovia;182;San Martín y Mudrián;332;171;161
40;Segovia;183;San Miguel de Bernuy;214;112;102
40;Segovia;184;San Pedro de Gaíllos;336;177;159
40;Segovia;179;Sanchonuño;751;380;371
40;Segovia;180;Sangarcía;533;274;259
40;Segovia;185;Santa María la Real de Nieva;1643;825;818
40;Segovia;186;Santa Marta del Cerro;55;25;30
40;Segovia;188;Santiuste de Pedraza;125;69;56
40;Segovia;189;Santiuste de San Juan Bautista;844;421;423
40;Segovia;190;Santo Domingo de Pirón;52;25;27
40;Segovia;191;Santo Tomé del Puerto;373;188;185
40;Segovia;192;Sauquillo de Cabezas;268;139;129
40;Segovia;193;Sebúlcor;289;154;135
40;Segovia;194;Segovia;54653;26359;28294
40;Segovia;195;Sepúlveda;1398;716;682
40;Segovia;196;Sequera de Fresno;70;38;32
40;Segovia;198;Sotillo;63;28;35
40;Segovia;199;Sotosalbos;99;50;49
40;Segovia;200;Tabanera la Luenga;88;48;40
40;Segovia;201;Tolocirio;74;35;39
40;Segovia;206;Torre Val de San Pedro;221;113;108
40;Segovia;202;Torreadrada;159;80;79
40;Segovia;203;Torrecaballeros;317;156;161
40;Segovia;204;Torrecilla del Pinar;363;175;188
40;Segovia;205;Torreiglesias;405;216;189
40;Segovia;207;Trescasas;177;94;83
40;Segovia;208;Turégano;1151;571;580
40;Segovia;210;Urueñas;134;76;58
40;Segovia;211;Valdeprados;43;25;18
40;Segovia;212;Valdevacas de Montejo;40;23;17
40;Segovia;213;Valdevacas y Guijar;165;91;74
40;Segovia;218;Valle de Tabladillo;199;102;97
40;Segovia;219;Vallelado;890;448;442
40;Segovia;220;Valleruela de Pedraza;74;42;32
40;Segovia;221;Valleruela de Sepúlveda;80;42;38
40;Segovia;214;Valseca;328;166;162
40;Segovia;215;Valtiendas;219;117;102
40;Segovia;216;Valverde del Majano;514;264;250
40;Segovia;222;Veganzones;330;163;167
40;Segovia;223;Vegas de Matute;275;149;126
40;Segovia;224;Ventosilla y Tejadilla;23;13;10
40;Segovia;225;Villacastín;1610;835;775
40;Segovia;228;Villaverde de Íscar;788;404;384
40;Segovia;229;Villaverde de Montejo;90;44;46
40;Segovia;230;Villeguillo;144;80;64
40;Segovia;231;Yanguas de Eresma;220;102;118
40;Segovia;233;Zarzuela del Monte;550;275;275
40;Segovia;234;Zarzuela del Pinar;635;340;295
41;Sevilla;001;Aguadulce;1964;991;973
41;Sevilla;002;Alanís;2109;1065;1044
41;Sevilla;003;Albaida del Aljarafe;1746;888;858
41;Sevilla;004;Alcalá de Guadaira;53414;26493;26921
41;Sevilla;005;Alcalá del Río;9298;4739;4559
41;Sevilla;006;Alcolea del Río;3517;1748;1769
41;Sevilla;007;Algaba (La);12662;6393;6269
41;Sevilla;008;Algámitas;1467;754;713
41;Sevilla;009;Almadén de la Plata;1766;904;862
41;Sevilla;010;Almensilla;1967;982;985
41;Sevilla;011;Arahal;18059;8968;9091
41;Sevilla;012;Aznalcázar;3283;1627;1656
41;Sevilla;013;Aznalcóllar;5679;2889;2790
41;Sevilla;014;Badolatosa;3168;1622;1546
41;Sevilla;015;Benacazón;4830;2442;2388
41;Sevilla;016;Bollullos de la Mitación;6165;3097;3068
41;Sevilla;017;Bormujos;5446;2680;2766
41;Sevilla;018;Brenes;10526;5289;5237
41;Sevilla;019;Burguillos;3317;1666;1651
41;Sevilla;020;Cabezas de San Juan (Las);15796;8126;7670
41;Sevilla;021;Camas;25865;12582;13283
41;Sevilla;022;Campana (La);5443;2757;2686
41;Sevilla;023;Cantillana;8942;4489;4453
41;Sevilla;901;Cañada Rosal;2900;1465;1435
41;Sevilla;024;Carmona;24307;12242;12065
41;Sevilla;025;Carrión de los Céspedes;2369;1128;1241
41;Sevilla;026;Casariche;5165;2608;2557
41;Sevilla;027;Castilblanco de los Arroyos;4173;2105;2068
41;Sevilla;028;Castilleja de Guzmán;477;239;238
41;Sevilla;029;Castilleja de la Cuesta;15746;7720;8026
41;Sevilla;030;Castilleja del Campo;651;318;333
41;Sevilla;031;Castillo de las Guardas (El);1720;872;848
41;Sevilla;032;Cazalla de la Sierra;5155;2578;2577
41;Sevilla;033;Constantina;7463;3669;3794
41;Sevilla;034;Coria del Río;22882;11392;11490
41;Sevilla;035;Coripe;1716;880;836
41;Sevilla;036;Coronil (El);5157;2609;2548
41;Sevilla;037;Corrales (Los);4086;2096;1990
41;Sevilla;903;Cuervo de Sevilla (El);7467;3794;3673
41;Sevilla;038;Dos Hermanas;80804;39936;40868
41;Sevilla;039;Écija;36949;18228;18721
41;Sevilla;040;Espartinas;3263;1660;1603
41;Sevilla;041;Estepa;11165;5540;5625
41;Sevilla;042;Fuentes de Andalucía;7493;3717;3776
41;Sevilla;043;Garrobo (El);750;375;375
41;Sevilla;044;Gelves;4173;2040;2133
41;Sevilla;045;Gerena;5361;2694;2667
41;Sevilla;046;Gilena;3827;1922;1905
41;Sevilla;047;Gines;7101;3473;3628
41;Sevilla;048;Guadalcanal;3134;1552;1582
41;Sevilla;049;Guillena;7979;4006;3973
41;Sevilla;050;Herrera;5862;2908;2954
41;Sevilla;051;Huévar del Aljarafe;2211;1141;1070
41;Sevilla;052;Lantejuela (La);3483;1768;1715
41;Sevilla;053;Lebrija;23578;12020;11558
41;Sevilla;054;Lora de Estepa;722;365;357
41;Sevilla;055;Lora del Río;19392;9580;9812
41;Sevilla;056;Luisiana (La);4272;2178;2094
41;Sevilla;057;Madroño (El);401;207;194
41;Sevilla;058;Mairena del Alcor;15379;7679;7700
41;Sevilla;059;Mairena del Aljarafe;26538;13268;13270
41;Sevilla;060;Marchena;17673;8748;8925
41;Sevilla;061;Marinaleda;2593;1285;1308
41;Sevilla;062;Martín de la Jara;2807;1470;1337
41;Sevilla;063;Molares (Los);2728;1374;1354
41;Sevilla;064;Montellano;7040;3569;3471
41;Sevilla;065;Morón de la Frontera;29021;14520;14501
41;Sevilla;066;Navas de la Concepción (Las);2010;1001;1009
41;Sevilla;067;Olivares;6889;3508;3381
41;Sevilla;068;Osuna;17065;8444;8621
41;Sevilla;069;Palacios y Villafranca (Los);30642;15573;15069
41;Sevilla;070;Palomares del Río;2728;1416;1312
41;Sevilla;071;Paradas;7157;3437;3720
41;Sevilla;072;Pedrera;4821;2429;2392
41;Sevilla;073;Pedroso (El);2419;1202;1217
41;Sevilla;074;Peñaflor;4073;2044;2029
41;Sevilla;075;Pilas;10899;5348;5551
41;Sevilla;076;Pruna;3536;1815;1721
41;Sevilla;077;Puebla de Cazalla (La);10941;5506;5435
41;Sevilla;078;Puebla de los Infantes (La);3644;1839;1805
41;Sevilla;079;Puebla del Río (La);16847;8493;8354
41;Sevilla;080;Real de la Jara (El);1745;867;878
41;Sevilla;081;Rinconada (La);22606;11363;11243
41;Sevilla;082;Roda de Andalucía (La);4120;2031;2089
41;Sevilla;083;Ronquillo (El);1373;678;695
41;Sevilla;084;Rubio (El);3697;1846;1851
41;Sevilla;085;Salteras;2632;1322;1310
41;Sevilla;086;San Juan de Aznalfarache;22950;11152;11798
41;Sevilla;088;San Nicolás del Puerto;729;390;339
41;Sevilla;087;Sanlúcar la Mayor;9836;4907;4929
41;Sevilla;089;Santiponce;6533;3272;3261
41;Sevilla;090;Saucejo (El);4097;2069;2028
41;Sevilla;091;Sevilla;707438;339309;368129
41;Sevilla;092;Tocina;8918;4443;4475
41;Sevilla;093;Tomares;14155;7001;7154
41;Sevilla;094;Umbrete;3014;1509;1505
41;Sevilla;095;Utrera;44578;22301;22277
41;Sevilla;096;Valencina de la Concepción;4824;2442;2382
41;Sevilla;902;Villafranco del Guadalquivir;"";"";""
41;Sevilla;097;Villamanrique de la Condesa;3649;1806;1843
41;Sevilla;100;Villanueva de San Juan;1696;847;849
41;Sevilla;098;Villanueva del Ariscal;4148;1979;2169
41;Sevilla;099;Villanueva del Río y Minas;6152;2970;3182
41;Sevilla;101;Villaverde del Río;6672;3388;3284
41;Sevilla;102;Viso del Alcor (El);15373;7801;7572
42;Soria;001;Abejar;378;193;185
42;Soria;003;Adradas;122;62;60
42;Soria;004;Ágreda;3620;1779;1841
42;Soria;006;Alconaba;180;101;79
42;Soria;007;Alcubilla de Avellaneda;262;137;125
42;Soria;008;Alcubilla de las Peñas;109;53;56
42;Soria;009;Aldealafuente;170;84;86
42;Soria;010;Aldealices;38;18;20
42;Soria;011;Aldealpozo;31;14;17
42;Soria;012;Aldealseñor;55;30;25
42;Soria;013;Aldehuela de Periáñez;46;23;23
42;Soria;014;Aldehuelas (Las);158;84;74
42;Soria;015;Alentisque;58;30;28
42;Soria;016;Aliud;58;28;30
42;Soria;017;Almajano;204;101;103
42;Soria;018;Almaluez;373;184;189
42;Soria;019;Almarza;656;346;310
42;Soria;020;Almazán;6021;3006;3015
42;Soria;021;Almazul;212;108;104
42;Soria;022;Almenar de Soria;457;235;222
42;Soria;023;Alpanseque;132;67;65
42;Soria;024;Arancón;126;67;59
42;Soria;025;Arcos de Jalón;2154;1073;1081
42;Soria;026;Arenillas;66;36;30
42;Soria;027;Arévalo de la Sierra;133;70;63
42;Soria;028;Ausejo de la Sierra;62;31;31
42;Soria;029;Baraona;288;141;147
42;Soria;030;Barca;172;93;79
42;Soria;031;Barcones;59;33;26
42;Soria;032;Bayubas de Abajo;315;163;152
42;Soria;033;Bayubas de Arriba;97;49;48
42;Soria;034;Beratón;40;29;11
42;Soria;035;Berlanga de Duero;1317;672;645
42;Soria;036;Blacos;72;40;32
42;Soria;037;Bliecos;69;35;34
42;Soria;038;Borjabad;74;39;35
42;Soria;039;Borobia;428;212;216
42;Soria;041;Buberos;60;27;33
42;Soria;042;Buitrago;58;29;29
42;Soria;043;Burgo de Osma-Ciudad de Osma;4982;2439;2543
42;Soria;044;Cabrejas del Campo;96;54;42
42;Soria;045;Cabrejas del Pinar;512;275;237
42;Soria;046;Calatañazor;75;39;36
42;Soria;048;Caltojar;168;86;82
42;Soria;049;Candilichera;250;129;121
42;Soria;050;Cañamaque;67;38;29
42;Soria;051;Carabantes;44;21;23
42;Soria;052;Caracena;13;7;6
42;Soria;053;Carrascosa de Abajo;48;26;22
42;Soria;054;Carrascosa de la Sierra;19;7;12
42;Soria;055;Casarejos;295;149;146
42;Soria;056;Castilfrío de la Sierra;40;21;19
42;Soria;058;Castillejo de Robledo;241;127;114
42;Soria;057;Castilruiz;380;193;187
42;Soria;059;Centenera de Andaluz;36;15;21
42;Soria;060;Cerbón;62;34;28
42;Soria;061;Cidones;363;194;169
42;Soria;062;Cigudosa;110;67;43
42;Soria;063;Cihuela;122;62;60
42;Soria;064;Ciria;108;51;57
42;Soria;065;Cirujales del Río;44;26;18
42;Soria;068;Coscurita;166;93;73
42;Soria;069;Covaleda;2117;1084;1033
42;Soria;070;Cubilla;104;54;50
42;Soria;071;Cubo de la Solana;332;166;166
42;Soria;073;Cueva de Ágreda;141;69;72
42;Soria;075;Dévanos;170;90;80
42;Soria;076;Deza;454;229;225
42;Soria;078;Duruelo de la Sierra;1486;760;726
42;Soria;079;Escobosa de Almazán;51;28;23
42;Soria;080;Espeja de San Marcelino;287;159;128
42;Soria;081;Espejón;244;128;116
42;Soria;082;Estepa de San Juan;21;11;10
42;Soria;083;Frechilla de Almazán;56;29;27
42;Soria;084;Fresno de Caracena;62;32;30
42;Soria;085;Fuentearmegil;419;224;195
42;Soria;086;Fuentecambrón;78;46;32
42;Soria;087;Fuentecantos;53;25;28
42;Soria;088;Fuentelmonge;176;89;87
42;Soria;089;Fuentelsaz de Soria;68;35;33
42;Soria;090;Fuentepinilla;176;93;83
42;Soria;092;Fuentes de Magaña;127;63;64
42;Soria;093;Fuentestrún;86;50;36
42;Soria;094;Garray;345;174;171
42;Soria;095;Golmayo;563;297;266
42;Soria;096;Gómara;617;300;317
42;Soria;097;Gormaz;29;13;16
42;Soria;098;Herrera de Soria;41;23;18
42;Soria;100;Hinojosa del Campo;62;38;24
42;Soria;103;Langa de Duero;1017;533;484
42;Soria;105;Liceras;73;36;37
42;Soria;106;Losilla (La);22;14;8
42;Soria;107;Magaña;112;56;56
42;Soria;108;Maján;17;8;9
42;Soria;110;Matalebreras;153;75;78
42;Soria;111;Matamala de Almazán;480;245;235
42;Soria;113;Medinaceli;744;379;365
42;Soria;115;Miño de Medinaceli;155;74;81
42;Soria;116;Miño de San Esteban;116;61;55
42;Soria;117;Molinos de Duero;207;108;99
42;Soria;118;Momblona;55;31;24
42;Soria;119;Monteagudo de las Vicarías;352;174;178
42;Soria;120;Montejo de Tiermes;300;163;137
42;Soria;121;Montenegro de Cameros;125;67;58
42;Soria;123;Morón de Almazán;318;152;166
42;Soria;124;Muriel de la Fuente;84;45;39
42;Soria;125;Muriel Viejo;100;49;51
42;Soria;127;Nafría de Ucero;108;54;54
42;Soria;128;Narros;63;30;33
42;Soria;129;Navaleno;950;482;468
42;Soria;130;Nepas;102;59;43
42;Soria;131;Nolay;102;56;46
42;Soria;132;Noviercas;265;125;140
42;Soria;134;Ólvega;3215;1668;1547
42;Soria;135;Oncala;126;78;48
42;Soria;139;Pinilla del Campo;31;17;14
42;Soria;140;Portillo de Soria;25;15;10
42;Soria;141;Póveda de Soria (La);143;71;72
42;Soria;142;Pozalmuro;119;53;66
42;Soria;144;Quintana Redonda;661;343;318
42;Soria;145;Quintanas de Gormaz;216;106;110
42;Soria;148;Quiñonería;21;8;13
42;Soria;149;Rábanos (Los);445;251;194
42;Soria;151;Rebollar;50;29;21
42;Soria;152;Recuerda;170;87;83
42;Soria;153;Rello;50;22;28
42;Soria;154;Renieblas;140;75;65
42;Soria;155;Retortillo de Soria;307;159;148
42;Soria;156;Reznos;68;38;30
42;Soria;157;Riba de Escalote (La);42;23;19
42;Soria;158;Rioseco de Soria;170;89;81
42;Soria;159;Rollamienta;55;29;26
42;Soria;160;Royo (El);387;179;208
42;Soria;161;Salduero;212;115;97
42;Soria;162;San Esteban de Gormaz;3567;1835;1732
42;Soria;163;San Felices;123;81;42
42;Soria;164;San Leonardo de Yagüe;2119;1080;1039
42;Soria;165;San Pedro Manrique;522;265;257
42;Soria;166;Santa Cruz de Yanguas;69;44;25
42;Soria;167;Santa María de Huerta;513;258;255
42;Soria;168;Santa María de las Hoyas;236;123;113
42;Soria;171;Serón de Nágima;341;174;167
42;Soria;172;Soliedra;48;28;20
42;Soria;173;Soria;33001;15730;17271
42;Soria;174;Sotillo del Rincón;198;90;108
42;Soria;175;Suellacabras;52;26;26
42;Soria;176;Tajahuerce;52;25;27
42;Soria;177;Tajueco;152;78;74
42;Soria;178;Talveila;229;122;107
42;Soria;181;Tardelcuende;718;350;368
42;Soria;182;Taroda;91;47;44
42;Soria;183;Tejado;262;129;133
42;Soria;184;Torlengua;141;66;75
42;Soria;185;Torreblacos;57;27;30
42;Soria;187;Torrubia de Soria;106;56;50
42;Soria;188;Trévago;89;41;48
42;Soria;189;Ucero;109;54;55
42;Soria;190;Vadillo;176;91;85
42;Soria;191;Valdeavellano de Tera;234;127;107
42;Soria;192;Valdegeña;61;32;29
42;Soria;193;Valdelagua del Cerro;42;20;22
42;Soria;194;Valdemaluque;350;175;175
42;Soria;195;Valdenebro;175;94;81
42;Soria;196;Valdeprado;24;10;14
42;Soria;197;Valderrodilla;145;68;77
42;Soria;198;Valtajeros;33;18;15
42;Soria;200;Velamazán;164;93;71
42;Soria;201;Velilla de la Sierra;23;9;14
42;Soria;202;Velilla de los Ajos;57;33;24
42;Soria;204;Viana de Duero;89;46;43
42;Soria;205;Villaciervos;92;48;44
42;Soria;206;Villanueva de Gormaz;22;12;10
42;Soria;207;Villar del Ala;44;20;24
42;Soria;208;Villar del Campo;46;23;23
42;Soria;209;Villar del Río;208;114;94
42;Soria;211;Villares de Soria (Los);135;62;73
42;Soria;212;Villasayas;123;75;48
42;Soria;213;Villaseca de Arciel;54;30;24
42;Soria;215;Vinuesa;1153;612;541
42;Soria;216;Vizmanos;48;30;18
42;Soria;217;Vozmediano;62;34;28
42;Soria;218;Yanguas;80;43;37
42;Soria;219;Yelo;87;46;41
43;Tarragona;001;Aiguamúrcia;591;307;284
43;Tarragona;002;Albinyana;935;480;455
43;Tarragona;003;Albiol (L');121;62;59
43;Tarragona;004;Alcanar;7985;3967;4018
43;Tarragona;005;Alcover;3436;1755;1681
43;Tarragona;904;Aldea (L');3587;1795;1792
43;Tarragona;006;Aldover;813;392;421
43;Tarragona;007;Aleixar (L');600;300;300
43;Tarragona;008;Alfara de Carles;390;206;184
43;Tarragona;009;Alforja;1113;541;572
43;Tarragona;010;Alió;352;175;177
43;Tarragona;011;Almoster;528;262;266
43;Tarragona;012;Altafulla;2086;1061;1025
43;Tarragona;013;Ametlla de Mar (L');4298;2145;2153
43;Tarragona;906;Ampolla (L');1590;770;820
43;Tarragona;014;Amposta;15448;7675;7773
43;Tarragona;016;Arboç (L');3539;1806;1733
43;Tarragona;015;Arbolí;136;69;67
43;Tarragona;017;Argentera (L');131;69;62
43;Tarragona;018;Arnes;534;277;257
43;Tarragona;019;Ascó;1777;905;872
43;Tarragona;020;Banyeres del Penedès;1478;765;713
43;Tarragona;021;Barberà de la Conca;424;217;207
43;Tarragona;022;Batea;2020;1028;992
43;Tarragona;023;Bellmunt del Priorat;295;143;152
43;Tarragona;024;Bellvei;1062;568;494
43;Tarragona;025;Benifallet;927;467;460
43;Tarragona;026;Benissanet;1017;495;522
43;Tarragona;027;Bisbal de Falset (La);262;132;130
43;Tarragona;028;Bisbal del Penedès (La);1497;767;730
43;Tarragona;029;Blancafort;398;196;202
43;Tarragona;030;Bonastre;281;141;140
43;Tarragona;031;Borges del Camp (Les);1413;700;713
43;Tarragona;032;Bot;896;451;445
43;Tarragona;033;Botarell;483;238;245
43;Tarragona;034;Bràfim;566;273;293
43;Tarragona;035;Cabacés;349;180;169
43;Tarragona;036;Cabra del Camp;454;242;212
43;Tarragona;037;Calafell;8246;4127;4119
43;Tarragona;903;Camarles;2862;1433;1429
43;Tarragona;038;Cambrils;15747;7877;7870
43;Tarragona;039;Capafonts;105;49;56
43;Tarragona;040;Capçanes;408;185;223
43;Tarragona;041;Caseres;342;170;172
43;Tarragona;042;Castellvell del Camp;935;471;464
43;Tarragona;043;Catllar (El);1439;746;693
43;Tarragona;045;Colldejou;190;103;87
43;Tarragona;046;Conesa;125;57;68
43;Tarragona;047;Constantí;5365;2779;2586
43;Tarragona;048;Corbera d'Ebre;1129;585;544
43;Tarragona;049;Cornudella de Montsant;829;423;406
43;Tarragona;050;Creixell;1192;606;586
43;Tarragona;051;Cunit;3200;1646;1554
43;Tarragona;901;Deltebre;10293;5179;5114
43;Tarragona;053;Duesaigües;218;130;88
43;Tarragona;054;Espluga de Francolí (L');3613;1772;1841
43;Tarragona;055;Falset;2540;1254;1286
43;Tarragona;056;Fatarella (La);1360;681;679
43;Tarragona;057;Febró (La);64;35;29
43;Tarragona;058;Figuera (La);132;65;67
43;Tarragona;059;Figuerola del Camp;207;103;104
43;Tarragona;060;Flix;4902;2468;2434
43;Tarragona;061;Forès;62;30;32
43;Tarragona;062;Freginals;368;177;191
43;Tarragona;063;Galera (La);763;365;398
43;Tarragona;064;Gandesa;2679;1332;1347
43;Tarragona;065;Garcia;568;280;288
43;Tarragona;066;Garidells (Els);182;92;90
43;Tarragona;067;Ginestar;875;455;420
43;Tarragona;068;Godall;758;373;385
43;Tarragona;069;Gratallops;237;114;123
43;Tarragona;070;Guiamets (Els);298;147;151
43;Tarragona;071;Horta de Sant Joan;1318;678;640
43;Tarragona;072;Lloar (El);136;71;65
43;Tarragona;073;Llorac;107;52;55
43;Tarragona;074;Llorenç del Penedès;1353;657;696
43;Tarragona;076;Marçà;585;282;303
43;Tarragona;075;Margalef;151;80;71
43;Tarragona;077;Mas de Barberans;758;377;381
43;Tarragona;078;Masdenverge;932;477;455
43;Tarragona;079;Masllorenç;388;197;191
43;Tarragona;080;Masó (La);257;127;130
43;Tarragona;081;Maspujols;388;197;191
43;Tarragona;082;Masroig (El);532;253;279
43;Tarragona;083;Milà (El);151;70;81
43;Tarragona;084;Miravet;818;418;400
43;Tarragona;085;Molar (El);310;157;153
43;Tarragona;086;Montblanc;5833;2890;2943
43;Tarragona;088;Montbrió del Camp;1405;684;721
43;Tarragona;089;Montferri;159;79;80
43;Tarragona;090;Montmell (El);280;141;139
43;Tarragona;091;Mont-ral;136;65;71
43;Tarragona;092;Mont-roig del Camp;5283;2733;2550
43;Tarragona;093;Móra d'Ebre;4536;2233;2303
43;Tarragona;094;Móra la Nova;2755;1360;1395
43;Tarragona;095;Morell (El);2316;1188;1128
43;Tarragona;096;Morera de Montsant (La);200;99;101
43;Tarragona;097;Nou de Gaià (La);374;182;192
43;Tarragona;098;Nulles;335;158;177
43;Tarragona;100;Pallaresos (Els);819;440;379
43;Tarragona;099;Palma d'Ebre (La);439;208;231
43;Tarragona;101;Passanant;194;108;86
43;Tarragona;102;Paüls;715;367;348
43;Tarragona;103;Perafort;516;269;247
43;Tarragona;104;Perelló (El);2166;1107;1059
43;Tarragona;105;Piles (Les);148;81;67
43;Tarragona;106;Pinell de Brai (El);1174;602;572
43;Tarragona;107;Pira;310;145;165
43;Tarragona;108;Pla de Santa Maria (El);1633;832;801
43;Tarragona;109;Pobla de Mafumet (La);946;471;475
43;Tarragona;110;Pobla de Massaluca (La);459;237;222
43;Tarragona;111;Pobla de Montornès (La);992;547;445
43;Tarragona;112;Poboleda;366;188;178
43;Tarragona;113;Pont d'Armentera (El);600;297;303
43;Tarragona;141;Pontils;112;55;57
43;Tarragona;114;Porrera;439;229;210
43;Tarragona;115;Pradell de la Teixeta;254;129;125
43;Tarragona;116;Prades;530;277;253
43;Tarragona;117;Prat de Comte;215;101;114
43;Tarragona;118;Pratdip;448;216;232
43;Tarragona;119;Puigpelat;451;225;226
43;Tarragona;120;Querol;173;91;82
43;Tarragona;121;Rasquera;875;445;430
43;Tarragona;122;Renau;68;37;31
43;Tarragona;123;Reus;89319;43954;45365
43;Tarragona;124;Riba (La);881;442;439
43;Tarragona;125;Riba-roja d'Ebre;1584;815;769
43;Tarragona;126;Riera de Gaià (La);924;448;476
43;Tarragona;127;Riudecanyes;580;294;286
43;Tarragona;128;Riudecols;949;490;459
43;Tarragona;129;Riudoms;4879;2457;2422
43;Tarragona;130;Rocafort de Queralt;259;136;123
43;Tarragona;131;Roda de Barà;2396;1261;1135
43;Tarragona;132;Rodonyà;370;182;188
43;Tarragona;133;Roquetes;5756;2829;2927
43;Tarragona;134;Rourell (El);271;147;124
43;Tarragona;135;Salomó;433;221;212
43;Tarragona;905;Salou;8943;4479;4464
43;Tarragona;136;Sant Carles de la Ràpita;10781;5383;5398
43;Tarragona;137;Sant Jaume dels Domenys;1257;643;614
43;Tarragona;902;Sant Jaume d'Enveja;3447;1735;1712
43;Tarragona;138;Santa Bàrbara;3382;1671;1711
43;Tarragona;139;Santa Coloma de Queralt;2540;1250;1290
43;Tarragona;140;Santa Oliva;1618;837;781
43;Tarragona;142;Sarral;1391;702;689
43;Tarragona;143;Savallà del Comtat;53;24;29
43;Tarragona;144;Secuita (La);1026;501;525
43;Tarragona;145;Selva del Camp (La);3609;1789;1820
43;Tarragona;146;Senan;25;16;9
43;Tarragona;044;Sénia (La);4989;2532;2457
43;Tarragona;147;Solivella;706;337;369
43;Tarragona;148;Tarragona;113796;55807;57989
43;Tarragona;149;Tivenys;1024;503;521
43;Tarragona;150;Tivissa;1778;889;889
43;Tarragona;151;Torre de Fontaubella (La);77;33;44
43;Tarragona;152;Torre de l'Espanyol (La);692;350;342
43;Tarragona;153;Torredembarra;7528;3744;3784
43;Tarragona;154;Torroja del Priorat;133;74;59
43;Tarragona;155;Tortosa;30203;14661;15542
43;Tarragona;156;Ulldecona;5186;2572;2614
43;Tarragona;157;Ulldemolins;528;265;263
43;Tarragona;158;Vallclara;107;53;54
43;Tarragona;159;Vallfogona de Riucorb;106;62;44
43;Tarragona;160;Vallmoll;1066;539;527
43;Tarragona;161;Valls;20206;9919;10287
43;Tarragona;162;Vandellòs i l'Hospitalet de l'Infant;4392;2213;2179
43;Tarragona;163;Vendrell (El);16303;8061;8242
43;Tarragona;164;Vespella de Gaià;105;60;45
43;Tarragona;165;Vilabella;854;421;433
43;Tarragona;175;Vilalba dels Arcs;789;415;374
43;Tarragona;166;Vilallonga del Camp;1205;613;592
43;Tarragona;168;Vilanova de Prades;160;81;79
43;Tarragona;167;Vilanova d'Escornalbou;436;216;220
43;Tarragona;169;Vilaplana;516;266;250
43;Tarragona;170;Vila-rodona;1015;527;488
43;Tarragona;171;Vila-seca;12184;6151;6033
43;Tarragona;172;Vilaverd;376;191;185
43;Tarragona;173;Vilella Alta (La);136;69;67
43;Tarragona;174;Vilella Baixa (La);161;86;75
43;Tarragona;176;Vimbodí;1107;573;534
43;Tarragona;177;Vinebre;456;214;242
43;Tarragona;178;Vinyols i els Arcs;892;490;402
43;Tarragona;052;Xerta;1254;613;641
44;Teruel;001;Ababuj;85;49;36
44;Teruel;002;Abejuela;77;45;32
44;Teruel;003;Aguatón;31;16;15
44;Teruel;004;Aguaviva;623;307;316
44;Teruel;005;Aguilar del Alfambra;96;46;50
44;Teruel;006;Alacón;508;263;245
44;Teruel;007;Alba;318;165;153
44;Teruel;008;Albalate del Arzobispo;2462;1206;1256
44;Teruel;009;Albarracín;1062;518;544
44;Teruel;010;Albentosa;275;132;143
44;Teruel;011;Alcaine;52;27;25
44;Teruel;012;Alcalá de la Selva;443;232;211
44;Teruel;013;Alcañiz;12697;6221;6476
44;Teruel;014;Alcorisa;3261;1647;1614
44;Teruel;016;Alfambra;768;382;386
44;Teruel;017;Aliaga;458;232;226
44;Teruel;021;Allepuz;161;87;74
44;Teruel;022;Alloza;900;433;467
44;Teruel;023;Allueva;15;8;7
44;Teruel;018;Almohaja;37;21;16
44;Teruel;019;Alobras;108;56;52
44;Teruel;020;Alpeñés;35;20;15
44;Teruel;024;Anadón;29;15;14
44;Teruel;025;Andorra;8598;4462;4136
44;Teruel;026;Arcos de las Salinas;190;101;89
44;Teruel;027;Arens de Lledó;261;120;141
44;Teruel;028;Argente;286;143;143
44;Teruel;029;Ariño;960;483;477
44;Teruel;031;Azaila;227;121;106
44;Teruel;032;Bádenas;28;12;16
44;Teruel;033;Báguena;589;295;294
44;Teruel;034;Bañón;220;115;105
44;Teruel;035;Barrachina;192;97;95
44;Teruel;036;Bea;27;17;10
44;Teruel;037;Beceite;690;358;332
44;Teruel;039;Bello;464;213;251
44;Teruel;038;Belmonte de San José;164;84;80
44;Teruel;040;Berge;262;139;123
44;Teruel;041;Bezas;81;42;39
44;Teruel;042;Blancas;238;117;121
44;Teruel;043;Blesa;167;96;71
44;Teruel;044;Bordón;144;78;66
44;Teruel;045;Bronchales;484;251;233
44;Teruel;046;Bueña;120;64;56
44;Teruel;047;Burbáguena;362;163;199
44;Teruel;048;Cabra de Mora;100;52;48
44;Teruel;049;Calaceite;1291;653;638
44;Teruel;050;Calamocha;4233;2114;2119
44;Teruel;051;Calanda;3540;1793;1747
44;Teruel;052;Calomarde;105;54;51
44;Teruel;053;Camañas;160;89;71
44;Teruel;054;Camarena de la Sierra;149;79;70
44;Teruel;055;Camarillas;131;70;61
44;Teruel;056;Caminreal;894;440;454
44;Teruel;059;Cantavieja;757;396;361
44;Teruel;060;Cañada de Benatanduz;81;51;30
44;Teruel;061;Cañada de Verich (La);109;61;48
44;Teruel;062;Cañada Vellida;68;43;25
44;Teruel;063;Cañizar del Olivar;151;76;75
44;Teruel;064;Cascante del Río;137;81;56
44;Teruel;065;Castejón de Tornos;116;56;60
44;Teruel;066;Castel de Cabra;223;113;110
44;Teruel;070;Castellar (El);99;52;47
44;Teruel;071;Castellote;874;419;455
44;Teruel;067;Castelnou;119;62;57
44;Teruel;068;Castelserás;921;480;441
44;Teruel;074;Cedrillas;556;290;266
44;Teruel;075;Celadas;489;255;234
44;Teruel;076;Cella;3130;1591;1539
44;Teruel;077;Cerollera (La);93;50;43
44;Teruel;080;Codoñera (La);359;186;173
44;Teruel;082;Corbalán;76;47;29
44;Teruel;084;Cortes de Aragón;141;69;72
44;Teruel;085;Cosa;127;67;60
44;Teruel;086;Cretas;692;350;342
44;Teruel;087;Crivillén;158;80;78
44;Teruel;088;Cuba (La);77;37;40
44;Teruel;089;Cubla;66;34;32
44;Teruel;090;Cucalón;97;49;48
44;Teruel;092;Cuervo (El);148;73;75
44;Teruel;093;Cuevas de Almudén;115;60;55
44;Teruel;094;Cuevas Labradas;212;111;101
44;Teruel;096;Ejulve;244;121;123
44;Teruel;097;Escorihuela;265;131;134
44;Teruel;099;Escucha;1171;635;536
44;Teruel;100;Estercuel;421;213;208
44;Teruel;101;Ferreruela de Huerva;94;49;45
44;Teruel;102;Fonfría;33;18;15
44;Teruel;103;Formiche Alto;211;111;100
44;Teruel;105;Fórnoles;130;58;72
44;Teruel;106;Fortanete;217;108;109
44;Teruel;107;Foz-Calanda;269;145;124
44;Teruel;108;Fresneda (La);484;253;231
44;Teruel;109;Frías de Albarracín;214;114;100
44;Teruel;110;Fuenferrada;52;27;25
44;Teruel;111;Fuentes Calientes;155;82;73
44;Teruel;112;Fuentes Claras;745;368;377
44;Teruel;113;Fuentes de Rubielos;75;38;37
44;Teruel;114;Fuentespalda;424;211;213
44;Teruel;115;Galve;163;84;79
44;Teruel;116;Gargallo;142;76;66
44;Teruel;117;Gea de Albarracín;507;262;245
44;Teruel;118;Ginebrosa (La);278;153;125
44;Teruel;119;Griegos;150;88;62
44;Teruel;120;Guadalaviar;299;151;148
44;Teruel;121;Gúdar;87;54;33
44;Teruel;122;Híjar;2075;1030;1045
44;Teruel;123;Hinojosa de Jarque;209;114;95
44;Teruel;124;Hoz de la Vieja (La);161;83;78
44;Teruel;125;Huesa del Común;154;79;75
44;Teruel;126;Iglesuela del Cid (La);505;263;242
44;Teruel;127;Jabaloyas;115;62;53
44;Teruel;128;Jarque de la Val;119;63;56
44;Teruel;129;Jatiel;74;34;40
44;Teruel;130;Jorcas;69;42;27
44;Teruel;131;Josa;42;22;20
44;Teruel;132;Lagueruela;84;46;38
44;Teruel;133;Lanzuela;39;24;15
44;Teruel;135;Libros;212;105;107
44;Teruel;136;Lidón;103;50;53
44;Teruel;137;Linares de Mora;337;189;148
44;Teruel;141;Lledó;226;115;111
44;Teruel;138;Loscos;232;125;107
44;Teruel;142;Maicas;19;8;11
44;Teruel;143;Manzanera;500;261;239
44;Teruel;144;Martín del Río;553;288;265
44;Teruel;145;Mas de las Matas;1480;744;736
44;Teruel;146;Mata de los Olmos (La);279;137;142
44;Teruel;147;Mazaleón;628;325;303
44;Teruel;148;Mezquita de Jarque;174;90;84
44;Teruel;149;Mirambel;157;84;73
44;Teruel;150;Miravete de la Sierra;48;27;21
44;Teruel;151;Molinos;396;201;195
44;Teruel;152;Monforte de Moyuela;107;59;48
44;Teruel;153;Monreal del Campo;2323;1162;1161
44;Teruel;154;Monroyo;403;207;196
44;Teruel;155;Montalbán;1750;876;874
44;Teruel;156;Monteagudo del Castillo;83;47;36
44;Teruel;157;Monterde de Albarracín;84;41;43
44;Teruel;158;Mora de Rubielos;1362;711;651
44;Teruel;159;Moscardón;64;35;29
44;Teruel;160;Mosqueruela;702;361;341
44;Teruel;161;Muniesa;806;409;397
44;Teruel;163;Noguera de Albarracín;170;85;85
44;Teruel;164;Nogueras;29;21;8
44;Teruel;165;Nogueruelas;252;129;123
44;Teruel;167;Obón;70;31;39
44;Teruel;168;Odón;304;146;158
44;Teruel;169;Ojos Negros;690;352;338
44;Teruel;171;Olba;237;119;118
44;Teruel;172;Oliete;553;276;277
44;Teruel;173;Olmos (Los);170;94;76
44;Teruel;174;Orihuela del Tremedal;641;324;317
44;Teruel;175;Orrios;221;112;109
44;Teruel;176;Palomar de Arroyos;313;169;144
44;Teruel;177;Pancrudo;238;122;116
44;Teruel;178;Parras de Castellote (Las);105;57;48
44;Teruel;179;Peñarroya de Tastavins;585;301;284
44;Teruel;180;Peracense;110;54;56
44;Teruel;181;Peralejos;105;53;52
44;Teruel;182;Perales del Alfambra;317;171;146
44;Teruel;183;Pitarque;121;57;64
44;Teruel;184;Plou;59;29;30
44;Teruel;185;Pobo (El);165;94;71
44;Teruel;187;Portellada (La);347;183;164
44;Teruel;189;Pozondón;100;50;50
44;Teruel;190;Pozuel del Campo;150;81;69
44;Teruel;191;Puebla de Híjar (La);1216;592;624
44;Teruel;192;Puebla de Valverde (La);486;258;228
44;Teruel;193;Puertomingalvo;149;77;72
44;Teruel;194;Ráfales;255;130;125
44;Teruel;195;Rillo;163;88;75
44;Teruel;196;Riodeva;265;129;136
44;Teruel;197;Ródenas;96;50;46
44;Teruel;198;Royuela;243;132;111
44;Teruel;199;Rubiales;55;29;26
44;Teruel;200;Rubielos de la Cérida;70;33;37
44;Teruel;201;Rubielos de Mora;623;316;307
44;Teruel;203;Salcedillo;12;5;7
44;Teruel;204;Saldón;51;32;19
44;Teruel;205;Samper de Calanda;1148;557;591
44;Teruel;206;San Agustín;166;86;80
44;Teruel;207;San Martín del Río;342;168;174
44;Teruel;208;Santa Cruz de Nogueras;32;18;14
44;Teruel;209;Santa Eulalia;1387;658;729
44;Teruel;210;Sarrión;1069;557;512
44;Teruel;211;Segura de los Baños;62;33;29
44;Teruel;212;Seno;57;28;29
44;Teruel;213;Singra;111;56;55
44;Teruel;215;Terriente;188;102;86
44;Teruel;216;Teruel;29493;14318;15175
44;Teruel;217;Toril y Masegoso;45;26;19
44;Teruel;218;Tormón;45;23;22
44;Teruel;219;Tornos;294;152;142
44;Teruel;220;Torralba de los Sisones;245;128;117
44;Teruel;223;Torre de Arcas;125;59;66
44;Teruel;224;Torre de las Arcas;46;25;21
44;Teruel;225;Torre del Compte;198;95;103
44;Teruel;227;Torre los Negros;102;52;50
44;Teruel;221;Torrecilla de Alcañiz;472;242;230
44;Teruel;222;Torrecilla del Rebollar;194;104;90
44;Teruel;226;Torrelacárcel;346;175;171
44;Teruel;228;Torremocha de Jiloca;196;92;104
44;Teruel;229;Torres de Albarracín;184;95;89
44;Teruel;230;Torrevelilla;230;113;117
44;Teruel;231;Torrijas;97;48;49
44;Teruel;232;Torrijo del Campo;652;320;332
44;Teruel;234;Tramacastiel;140;65;75
44;Teruel;235;Tramacastilla;142;70;72
44;Teruel;236;Tronchón;106;54;52
44;Teruel;237;Urrea de Gaén;685;333;352
44;Teruel;238;Utrillas;3678;1888;1790
44;Teruel;239;Valacloche;29;15;14
44;Teruel;240;Valbona;215;112;103
44;Teruel;241;Valdealgorfa;821;402;419
44;Teruel;243;Valdecuenca;47;29;18
44;Teruel;244;Valdelinares;125;70;55
44;Teruel;245;Valdeltormo;428;220;208
44;Teruel;246;Valderrobres;1899;958;941
44;Teruel;247;Valjunquera;478;242;236
44;Teruel;249;Vallecillo (El);30;14;16
44;Teruel;250;Veguillas de la Sierra;32;17;15
44;Teruel;251;Villafranca del Campo;411;216;195
44;Teruel;252;Villahermosa del Campo;85;46;39
44;Teruel;256;Villanueva del Rebollar de la Sierra;53;27;26
44;Teruel;257;Villar del Cobo;242;125;117
44;Teruel;258;Villar del Salz;139;73;66
44;Teruel;260;Villarluengo;236;123;113
44;Teruel;261;Villarquemado;1042;512;530
44;Teruel;262;Villarroya de los Pinares;208;105;103
44;Teruel;263;Villastar;365;191;174
44;Teruel;264;Villel;373;187;186
44;Teruel;265;Vinaceite;344;173;171
44;Teruel;266;Visiedo;262;130;132
44;Teruel;267;Vivel del Río Martín;133;70;63
44;Teruel;268;Zoma (La);44;22;22
45;Toledo;001;Ajofrín;2218;1139;1079
45;Toledo;002;Alameda de la Sagra;2819;1492;1327
45;Toledo;003;Albarreal de Tajo;593;306;287
45;Toledo;004;Alcabón;509;255;254
45;Toledo;005;Alcañizo;365;192;173
45;Toledo;006;Alcaudete de la Jara;1542;735;807
45;Toledo;007;Alcolea de Tajo;811;404;407
45;Toledo;008;Aldea en Cabo;196;100;96
45;Toledo;009;Aldeanueva de Barbarroya;901;447;454
45;Toledo;010;Aldeanueva de San Bartolomé;681;330;351
45;Toledo;011;Almendral de la Cañada;436;231;205
45;Toledo;012;Almonacid de Toledo;823;407;416
45;Toledo;013;Almorox;2249;1162;1087
45;Toledo;014;Añover de Tajo;4522;2302;2220
45;Toledo;015;Arcicóllar;542;265;277
45;Toledo;016;Argés;1920;960;960
45;Toledo;017;Azután;377;190;187
45;Toledo;018;Barcience;124;63;61
45;Toledo;019;Bargas;6218;3148;3070
45;Toledo;020;Belvís de la Jara;1852;906;946
45;Toledo;021;Borox;2044;998;1046
45;Toledo;022;Buenaventura;569;288;281
45;Toledo;023;Burguillos de Toledo;704;350;354
45;Toledo;024;Burujón;1252;651;601
45;Toledo;025;Cabañas de la Sagra;992;505;487
45;Toledo;026;Cabañas de Yepes;258;135;123
45;Toledo;027;Cabezamesada;565;289;276
45;Toledo;028;Calera y Chozas;3709;1893;1816
45;Toledo;029;Caleruela;349;175;174
45;Toledo;030;Calzada de Oropesa;721;355;366
45;Toledo;031;Camarena;2097;1068;1029
45;Toledo;032;Camarenilla;553;270;283
45;Toledo;033;Campillo de la Jara (El);632;334;298
45;Toledo;034;Camuñas;1812;907;905
45;Toledo;035;Cardiel de los Montes;146;75;71
45;Toledo;036;Carmena;811;410;401
45;Toledo;037;Carpio de Tajo (El);2386;1144;1242
45;Toledo;038;Carranque;1154;582;572
45;Toledo;039;Carriches;316;151;165
45;Toledo;040;Casar de Escalona (El);876;431;445
45;Toledo;041;Casarrubios del Monte;2069;1036;1033
45;Toledo;042;Casasbuenas;254;125;129
45;Toledo;043;Castillo de Bayuela;1062;544;518
45;Toledo;045;Cazalegas;1146;562;584
45;Toledo;046;Cebolla;2656;1319;1337
45;Toledo;047;Cedillo del Condado;1042;540;502
45;Toledo;048;Cerralbos (Los);507;254;253
45;Toledo;049;Cervera de los Montes;431;230;201
45;Toledo;056;Chozas de Canales;944;467;477
45;Toledo;057;Chueca;255;130;125
45;Toledo;050;Ciruelos;321;167;154
45;Toledo;051;Cobeja;1663;846;817
45;Toledo;052;Cobisa;375;186;189
45;Toledo;053;Consuegra;10013;4931;5082
45;Toledo;054;Corral de Almaguer;5965;2953;3012
45;Toledo;055;Cuerva;1249;627;622
45;Toledo;058;Domingo Pérez;532;255;277
45;Toledo;059;Dosbarrios;2061;1048;1013
45;Toledo;060;Erustes;215;108;107
45;Toledo;061;Escalona;1873;933;940
45;Toledo;062;Escalonilla;1458;710;748
45;Toledo;063;Espinoso del Rey;649;334;315
45;Toledo;064;Esquivias;3555;1805;1750
45;Toledo;065;Estrella (La);499;273;226
45;Toledo;066;Fuensalida;7060;3560;3500
45;Toledo;067;Gálvez;3179;1601;1578
45;Toledo;068;Garciotum;153;75;78
45;Toledo;069;Gerindote;1749;887;862
45;Toledo;070;Guadamur;1604;820;784
45;Toledo;071;Guardia (La);2501;1242;1259
45;Toledo;072;Herencias (Las);726;374;352
45;Toledo;073;Herreruela de Oropesa;438;222;216
45;Toledo;074;Hinojosa de San Vicente;519;286;233
45;Toledo;075;Hontanar;112;61;51
45;Toledo;076;Hormigos;412;216;196
45;Toledo;077;Huecas;384;196;188
45;Toledo;078;Huerta de Valdecarábanos;1714;843;871
45;Toledo;079;Iglesuela (La);487;244;243
45;Toledo;080;Illán de Vacas;5;4;1
45;Toledo;081;Illescas;8410;4218;4192
45;Toledo;082;Lagartera;1941;954;987
45;Toledo;083;Layos;266;135;131
45;Toledo;084;Lillo;2905;1440;1465
45;Toledo;085;Lominchar;1030;540;490
45;Toledo;086;Lucillos;519;255;264
45;Toledo;087;Madridejos;10519;5176;5343
45;Toledo;088;Magán;879;438;441
45;Toledo;089;Malpica de Tajo;1788;913;875
45;Toledo;090;Manzaneque;463;231;232
45;Toledo;091;Maqueda;544;266;278
45;Toledo;092;Marjaliza;329;171;158
45;Toledo;093;Marrupe;148;70;78
45;Toledo;094;Mascaraque;528;252;276
45;Toledo;095;Mata (La);1021;510;511
45;Toledo;096;Mazarambroz;1230;604;626
45;Toledo;097;Mejorada;1125;579;546
45;Toledo;098;Menasalbas;2980;1553;1427
45;Toledo;099;Méntrida;1535;791;744
45;Toledo;100;Mesegar de Tajo;244;120;124
45;Toledo;101;Miguel Esteban;4768;2372;2396
45;Toledo;102;Mocejón;4078;2053;2025
45;Toledo;103;Mohedas de la Jara;717;360;357
45;Toledo;104;Montearagón;482;248;234
45;Toledo;105;Montesclaros;489;232;257
45;Toledo;106;Mora;9251;4522;4729
45;Toledo;107;Nambroca;2008;978;1030
45;Toledo;108;Nava de Ricomalillo (La);794;411;383
45;Toledo;109;Navahermosa;3797;1943;1854
45;Toledo;110;Navalcán;2562;1330;1232
45;Toledo;111;Navalmoralejo;94;46;48
45;Toledo;112;Navalmorales (Los);2719;1356;1363
45;Toledo;113;Navalucillos (Los);2987;1503;1484
45;Toledo;114;Navamorcuende;757;390;367
45;Toledo;115;Noblejas;2916;1455;1461
45;Toledo;116;Noez;988;508;480
45;Toledo;117;Nombela;897;455;442
45;Toledo;118;Novés;1581;796;785
45;Toledo;119;Numancia de la Sagra;1168;597;571
45;Toledo;120;Nuño Gómez;184;91;93
45;Toledo;121;Ocaña;5929;2907;3022
45;Toledo;122;Olías del Rey;3678;1856;1822
45;Toledo;123;Ontígola;863;460;403
45;Toledo;124;Orgaz;2663;1337;1326
45;Toledo;125;Oropesa;2973;1490;1483
45;Toledo;126;Otero;236;113;123
45;Toledo;127;Palomeque;426;214;212
45;Toledo;128;Pantoja;2080;1069;1011
45;Toledo;129;Paredes de Escalona;96;44;52
45;Toledo;130;Parrillas;496;245;251
45;Toledo;131;Pelahustán;385;199;186
45;Toledo;132;Pepino;681;351;330
45;Toledo;133;Polán;3174;1600;1574
45;Toledo;134;Portillo de Toledo;1957;988;969
45;Toledo;135;Puebla de Almoradiel (La);5406;2683;2723
45;Toledo;136;Puebla de Montalbán (La);6572;3274;3298
45;Toledo;137;Pueblanueva (La);1978;991;987
45;Toledo;138;Puente del Arzobispo (El);1604;768;836
45;Toledo;139;Puerto de San Vicente;299;141;158
45;Toledo;140;Pulgar;1165;599;566
45;Toledo;141;Quero;1447;724;723
45;Toledo;142;Quintanar de la Orden;9220;4599;4621
45;Toledo;143;Quismondo;1250;618;632
45;Toledo;144;Real de San Vicente (El);1009;514;495
45;Toledo;145;Recas;2347;1208;1139
45;Toledo;146;Retamoso;192;104;88
45;Toledo;147;Rielves;467;234;233
45;Toledo;148;Robledo del Mazo;569;289;280
45;Toledo;149;Romeral (El);988;481;507
45;Toledo;150;San Bartolomé de las Abiertas;471;240;231
45;Toledo;151;San Martín de Montalbán;778;388;390
45;Toledo;152;San Martín de Pusa;829;440;389
45;Toledo;153;San Pablo de los Montes;2066;1041;1025
45;Toledo;154;San Román de los Montes;509;267;242
45;Toledo;155;Santa Ana de Pusa;390;198;192
45;Toledo;156;Santa Cruz de la Zarza;4368;2194;2174
45;Toledo;157;Santa Cruz del Retamar;1507;766;741
45;Toledo;158;Santa Olalla;2331;1199;1132
45;Toledo;901;Santo Domingo-Caudilla;811;394;417
45;Toledo;159;Sartajada;124;73;51
45;Toledo;160;Segurilla;958;476;482
45;Toledo;161;Seseña;2995;1539;1456
45;Toledo;162;Sevilleja de la Jara;1178;612;566
45;Toledo;163;Sonseca;8825;4416;4409
45;Toledo;164;Sotillo de las Palomas;195;105;90
45;Toledo;165;Talavera de la Reina;73589;36361;37228
45;Toledo;166;Tembleque;2190;1098;1092
45;Toledo;167;Toboso (El);2179;1060;1119
45;Toledo;168;Toledo;62183;30133;32050
45;Toledo;169;Torralba de Oropesa;317;153;164
45;Toledo;171;Torre de Esteban Hambrán (La);1326;682;644
45;Toledo;170;Torrecilla de la Jara;343;185;158
45;Toledo;172;Torrico;987;492;495
45;Toledo;173;Torrijos;9619;4753;4866
45;Toledo;174;Totanés;378;189;189
45;Toledo;175;Turleque;1081;548;533
45;Toledo;176;Ugena;553;293;260
45;Toledo;177;Urda;3117;1549;1568
45;Toledo;179;Valdeverdeja;932;435;497
45;Toledo;180;Valmojado;2253;1145;1108
45;Toledo;181;Velada;2337;1196;1141
45;Toledo;182;Ventas con Peña Aguilera (Las);1460;743;717
45;Toledo;183;Ventas de Retamosa (Las);530;273;257
45;Toledo;184;Ventas de San Julián (Las);239;105;134
45;Toledo;186;Villa de Don Fadrique (La);4260;2086;2174
45;Toledo;185;Villacañas;8920;4437;4483
45;Toledo;187;Villafranca de los Caballeros;5417;2670;2747
45;Toledo;188;Villaluenga de la Sagra;2562;1290;1272
45;Toledo;189;Villamiel de Toledo;295;140;155
45;Toledo;190;Villaminaya;686;341;345
45;Toledo;191;Villamuelas;782;399;383
45;Toledo;192;Villanueva de Alcardete;3251;1632;1619
45;Toledo;193;Villanueva de Bogas;860;426;434
45;Toledo;194;Villarejo de Montalbán;107;51;56
45;Toledo;195;Villarrubia de Santiago;2965;1480;1485
45;Toledo;196;Villaseca de la Sagra;1621;816;805
45;Toledo;197;Villasequilla;2378;1241;1137
45;Toledo;198;Villatobas;2426;1213;1213
45;Toledo;199;Viso de San Juan (El);658;337;321
45;Toledo;200;Yébenes (Los);6642;3333;3309
45;Toledo;201;Yeles;1151;581;570
45;Toledo;202;Yepes;4378;2208;2170
45;Toledo;203;Yuncler;1856;964;892
45;Toledo;204;Yunclillos;577;288;289
45;Toledo;205;Yuncos;2901;1508;1393
46;Valencia/València;001;Ademuz;1254;628;626
46;Valencia/València;002;Ador;1083;544;539
46;Valencia/València;004;Agullent;2176;1048;1128
46;Valencia/València;042;Aielo de Malferit;3857;1912;1945
46;Valencia/València;043;Aielo de Rugat;200;103;97
46;Valencia/València;005;Alaquàs;24569;12224;12345
46;Valencia/València;006;Albaida;5911;2898;3013
46;Valencia/València;007;Albal;9605;4790;4815
46;Valencia/València;008;Albalat de la Ribera;3500;1696;1804
46;Valencia/València;009;Albalat dels Sorells;3589;1751;1838
46;Valencia/València;010;Albalat dels Tarongers;566;282;284
46;Valencia/València;011;Alberic;9417;4632;4785
46;Valencia/València;012;Alborache;901;459;442
46;Valencia/València;013;Alboraya;12235;6004;6231
46;Valencia/València;014;Albuixech;3056;1506;1550
46;Valencia/València;016;Alcàntera de Xúquer;1437;718;719
46;Valencia/València;015;Alcàsser;7347;3681;3666
46;Valencia/València;018;Alcublas;857;431;426
46;Valencia/València;020;Alcúdia de Crespins (L');4135;2045;2090
46;Valencia/València;019;Alcúdia (L');10514;5174;5340
46;Valencia/València;021;Aldaia;23130;11470;11660
46;Valencia/València;022;Alfafar;20484;10159;10325
46;Valencia/València;024;Alfara de Algimia;525;256;269
46;Valencia/València;025;Alfara del Patriarca;2838;1400;1438
46;Valencia/València;026;Alfarp;1362;661;701
46;Valencia/València;027;Alfarrasí;1250;609;641
46;Valencia/València;023;Alfauir;302;153;149
46;Valencia/València;028;Algar de Palancia;389;188;201
46;Valencia/València;029;Algemesí;25758;12690;13068
46;Valencia/València;030;Algimia de Alfara;859;421;438
46;Valencia/València;031;Alginet;11899;5904;5995
46;Valencia/València;032;Almàssera;5481;2648;2833
46;Valencia/València;033;Almiserà;207;105;102
46;Valencia/València;034;Almoines;1837;928;909
46;Valencia/València;035;Almussafes;6598;3295;3303
46;Valencia/València;036;Alpuente;1149;602;547
46;Valencia/València;037;Alquería de la Condesa/Alqueria de la Comtessa (l');1538;729;809
46;Valencia/València;017;Alzira;40787;19874;20913
46;Valencia/València;038;Andilla;199;104;95
46;Valencia/València;039;Anna;2691;1340;1351
46;Valencia/València;040;Antella;1617;811;806
46;Valencia/València;041;Aras de los Olmos;433;240;193
46;Valencia/València;003;Atzeneta d'Albaida;1263;641;622
46;Valencia/València;044;Ayora;5574;2889;2685
46;Valencia/València;046;Barx;1044;512;532
46;Valencia/València;045;Barxeta;1626;822;804
46;Valencia/València;047;Bèlgida;683;330;353
46;Valencia/València;048;Bellreguard;3714;1822;1892
46;Valencia/València;049;Bellús;405;202;203
46;Valencia/València;050;Benagéber;139;73;66
46;Valencia/València;051;Benaguasil;9087;4547;4540
46;Valencia/València;052;Benavites;673;327;346
46;Valencia/València;053;Beneixida;673;327;346
46;Valencia/València;054;Benetússer;14151;6991;7160
46;Valencia/València;055;Beniarjó;1151;543;608
46;Valencia/València;056;Beniatjar;257;128;129
46;Valencia/València;057;Benicolet;496;256;240
46;Valencia/València;060;Benifaió;12324;6089;6235
46;Valencia/València;059;Benifairó de la Valldigna;1646;816;830
46;Valencia/València;058;Benifairó de les Valls;1990;987;1003
46;Valencia/València;061;Beniflá;148;68;80
46;Valencia/València;062;Benigánim;5382;2769;2613
46;Valencia/València;063;Benimodo;1745;906;839
46;Valencia/València;064;Benimuslem;570;271;299
46;Valencia/València;065;Beniparrell;1389;697;692
46;Valencia/València;066;Benirredrà;965;460;505
46;Valencia/València;067;Benisanó;1690;861;829
46;Valencia/València;068;Benissoda;307;171;136
46;Valencia/València;069;Benisuera;205;93;112
46;Valencia/València;070;Bétera;10439;5149;5290
46;Valencia/València;071;Bicorp;707;355;352
46;Valencia/València;072;Bocairent;4684;2296;2388
46;Valencia/València;073;Bolbaite;1409;711;698
46;Valencia/València;074;Bonrepòs i Mirambell;2426;1190;1236
46;Valencia/València;075;Bufali;217;111;106
46;Valencia/València;076;Bugarra;861;434;427
46;Valencia/València;077;Buñol;9257;4602;4655
46;Valencia/València;078;Burjassot;34825;17205;17620
46;Valencia/València;079;Calles;418;225;193
46;Valencia/València;080;Camporrobles;1464;733;731
46;Valencia/València;081;Canals;12440;6134;6306
46;Valencia/València;082;Canet d'En Berenguer;1646;807;839
46;Valencia/València;083;Carcaixent;20470;9974;10496
46;Valencia/València;084;Càrcer;2002;959;1043
46;Valencia/València;085;Carlet;14441;7079;7362
46;Valencia/València;086;Carrícola;76;33;43
46;Valencia/València;087;Casas Altas;150;78;72
46;Valencia/València;088;Casas Bajas;317;164;153
46;Valencia/València;089;Casinos;2280;1171;1109
46;Valencia/València;090;Castelló de Rugat;2116;1097;1019
46;Valencia/València;091;Castellonet de la Conquesta;105;53;52
46;Valencia/València;092;Castielfabib;645;340;305
46;Valencia/València;093;Catadau;2228;1097;1131
46;Valencia/València;094;Catarroja;20853;10207;10646
46;Valencia/València;095;Caudete de las Fuentes;894;453;441
46;Valencia/València;096;Cerdà;260;129;131
46;Valencia/València;107;Chella;2539;1256;1283
46;Valencia/València;106;Chelva;2130;1090;1040
46;Valencia/València;108;Chera;617;318;299
46;Valencia/València;109;Cheste;6783;3428;3355
46;Valencia/València;111;Chiva;7859;3910;3949
46;Valencia/València;112;Chulilla;713;347;366
46;Valencia/València;097;Cofrentes;925;469;456
46;Valencia/València;098;Corbera;3193;1550;1643
46;Valencia/València;099;Cortes de Pallás;712;378;334
46;Valencia/València;100;Cotes;395;180;215
46;Valencia/València;105;Cullera;20446;10101;10345
46;Valencia/València;113;Daimús;1293;652;641
46;Valencia/València;114;Domeño;507;262;245
46;Valencia/València;115;Dos Aguas;401;224;177
46;Valencia/València;116;Eliana (L');9595;4820;4775
46;Valencia/València;117;Emperador;162;79;83
46;Valencia/València;118;Enguera;5050;2471;2579
46;Valencia/València;119;Ènova (L');1164;584;580
46;Valencia/València;120;Estivella;1111;515;596
46;Valencia/València;121;Estubeny;136;63;73
46;Valencia/València;122;Faura;2828;1393;1435
46;Valencia/València;123;Favara;1732;841;891
46;Valencia/València;126;Foios;5435;2641;2794
46;Valencia/València;128;Font de la Figuera (La);2210;1098;1112
46;Valencia/València;127;Font d'En Carròs (La);3250;1608;1642
46;Valencia/València;124;Fontanars dels Alforins;961;499;462
46;Valencia/València;125;Fortaleny;1010;510;500
46;Valencia/València;129;Fuenterrobles;737;376;361
46;Valencia/València;131;Gandia;55717;27210;28507
46;Valencia/València;130;Gavarda;1289;626;663
46;Valencia/València;132;Genovés;2239;1109;1130
46;Valencia/València;133;Gestalgar;631;295;336
46;Valencia/València;134;Gilet;1286;640;646
46;Valencia/València;135;Godella;10265;5029;5236
46;Valencia/València;136;Godelleta;1989;980;1009
46;Valencia/València;137;Granja de la Costera (La);367;176;191
46;Valencia/València;138;Guadasequies;407;201;206
46;Valencia/València;139;Guadassuar;5435;2715;2720
46;Valencia/València;140;Guardamar de la Safor;64;38;26
46;Valencia/València;141;Higueruelas;582;313;269
46;Valencia/València;142;Jalance;1212;628;584
46;Valencia/València;144;Jarafuel;1039;537;502
46;Valencia/València;154;Llanera de Ranes;975;485;490
46;Valencia/València;155;Llaurí;1377;665;712
46;Valencia/València;147;Llíria;14407;7115;7292
46;Valencia/València;153;Llocnou de Sant Jeroni;569;279;290
46;Valencia/València;151;Llocnou d'En Fenollet;671;323;348
46;Valencia/València;156;Llombai;2197;1090;1107
46;Valencia/València;157;Llosa de Ranes (La);3614;1853;1761
46;Valencia/València;150;Llutxent;2369;1199;1170
46;Valencia/València;148;Loriguilla;1066;539;527
46;Valencia/València;149;Losa del Obispo;491;235;256
46;Valencia/València;152;Lugar Nuevo de la Corona;122;57;65
46;Valencia/València;158;Macastre;903;429;474
46;Valencia/València;159;Manises;25244;12332;12912
46;Valencia/València;160;Manuel;2463;1184;1279
46;Valencia/València;161;Marines;1235;639;596
46;Valencia/València;162;Masalavés;1478;757;721
46;Valencia/València;163;Massalfassar;1406;704;702
46;Valencia/València;164;Massamagrell;12342;6087;6255
46;Valencia/València;165;Massanassa;7775;3809;3966
46;Valencia/València;166;Meliana;9204;4470;4734
46;Valencia/València;167;Millares;748;379;369
46;Valencia/València;168;Miramar;966;472;494
46;Valencia/València;169;Mislata;39959;19578;20381
46;Valencia/València;170;Mogente/Moixent;4207;2149;2058
46;Valencia/València;171;Moncada;18206;9044;9162
46;Valencia/València;172;Monserrat;2709;1393;1316
46;Valencia/València;173;Montaverner;1671;844;827
46;Valencia/València;174;Montesa;1250;630;620
46;Valencia/València;175;Montichelvo;614;305;309
46;Valencia/València;176;Montroy;1495;768;727
46;Valencia/València;177;Museros;4144;2052;2092
46;Valencia/València;178;Náquera;1687;838;849
46;Valencia/València;179;Navarrés;2804;1395;1409
46;Valencia/València;180;Novelé/Novetlè;592;294;298
46;Valencia/València;181;Oliva;20662;10160;10502
46;Valencia/València;183;Olleria (L');6910;3527;3383
46;Valencia/València;182;Olocau;685;362;323
46;Valencia/València;184;Ontinyent;30570;15028;15542
46;Valencia/València;185;Otos;559;276;283
46;Valencia/València;186;Paiporta;16351;8097;8254
46;Valencia/València;187;Palma de Gandía;1514;748;766
46;Valencia/València;188;Palmera;456;225;231
46;Valencia/València;189;Palomar (El);510;243;267
46;Valencia/València;190;Paterna;43788;21625;22163
46;Valencia/València;191;Pedralba;2044;1033;1011
46;Valencia/València;192;Petrés;712;339;373
46;Valencia/València;193;Picanya;8050;4012;4038
46;Valencia/València;194;Picassent;15062;7572;7490
46;Valencia/València;195;Piles;2115;1025;1090
46;Valencia/València;196;Pinet;247;134;113
46;Valencia/València;199;Pobla de Farnals (La);4993;2492;2501
46;Valencia/València;202;Pobla de Vallbona (La);8423;4331;4092
46;Valencia/València;200;Pobla del Duc (La);2611;1286;1325
46;Valencia/València;203;Pobla Llarga (La);4425;2156;2269
46;Valencia/València;197;Polinyà de Xúquer;3100;1542;1558
46;Valencia/València;198;Potríes;970;467;503
46;Valencia/València;205;Puçol;12932;6384;6548
46;Valencia/València;201;Puebla de San Miguel;67;37;30
46;Valencia/València;204;Puig;6705;3314;3391
46;Valencia/València;101;Quart de les Valls;1071;501;570
46;Valencia/València;102;Quart de Poblet;27346;13547;13799
46;Valencia/València;103;Quartell;1357;661;696
46;Valencia/València;104;Quatretonda;2590;1320;1270
46;Valencia/València;206;Quesa;829;419;410
46;Valencia/València;207;Rafelbuñol/Rafelbunyol;4982;2471;2511
46;Valencia/València;208;Rafelcofer;1469;681;788
46;Valencia/València;209;Rafelguaraf;2460;1202;1258
46;Valencia/València;210;Ráfol de Salem;376;168;208
46;Valencia/València;211;Real de Gandía;1875;885;990
46;Valencia/València;212;Real de Montroi;1836;932;904
46;Valencia/València;213;Requena;18171;9105;9066
46;Valencia/València;214;Riba-roja de Túria;10475;5218;5257
46;Valencia/València;215;Riola;1649;836;813
46;Valencia/València;216;Rocafort;4449;2184;2265
46;Valencia/València;217;Rotglá y Corberá;1028;517;511
46;Valencia/València;218;Rótova;1349;686;663
46;Valencia/València;219;Rugat;195;96;99
46;Valencia/València;220;Sagunto/Sagunt;56894;27847;29047
46;Valencia/València;221;Salem;472;239;233
46;Valencia/València;222;San Juan de Énova;357;155;202
46;Valencia/València;223;Sedaví;8260;4049;4211
46;Valencia/València;224;Segart;174;81;93
46;Valencia/València;225;Sellent;476;245;231
46;Valencia/València;226;Sempere;43;21;22
46;Valencia/València;227;Senyera;830;395;435
46;Valencia/València;228;Serra;1554;773;781
46;Valencia/València;229;Siete Aguas;1050;513;537
46;Valencia/València;230;Silla;16614;8394;8220
46;Valencia/València;231;Simat de la Valldigna;3166;1603;1563
46;Valencia/València;232;Sinarcas;1313;681;632
46;Valencia/València;233;Sollana;4330;2112;2218
46;Valencia/València;234;Sot de Chera;307;158;149
46;Valencia/València;235;Sueca;23567;11555;12012
46;Valencia/València;236;Sumacàrcer;1383;702;681
46;Valencia/València;237;Tavernes Blanques;8318;4103;4215
46;Valencia/València;238;Tavernes de la Valldigna;16357;8134;8223
46;Valencia/València;239;Teresa de Cofrentes;752;382;370
46;Valencia/València;240;Terrateig;195;99;96
46;Valencia/València;241;Titaguas;609;318;291
46;Valencia/València;242;Torrebaja;482;244;238
46;Valencia/València;243;Torrella;207;102;105
46;Valencia/València;244;Torrent;59116;29265;29851
46;Valencia/València;245;Torres Torres;391;189;202
46;Valencia/València;246;Tous;1243;610;633
46;Valencia/València;247;Tuéjar;1399;736;663
46;Valencia/València;248;Turís;4295;2196;2099
46;Valencia/València;249;Utiel;11946;5926;6020
46;Valencia/València;250;Valencia;761164;363172;397992
46;Valencia/València;251;Vallada;2973;1506;1467
46;Valencia/València;252;Vallanca;248;120;128
46;Valencia/València;253;Vallés;104;57;47
46;Valencia/València;254;Venta del Moro;1701;876;825
46;Valencia/València;256;Vilamarxant;4979;2519;2460
46;Valencia/València;255;Villalonga;3554;1777;1777
46;Valencia/València;257;Villanueva de Castellón;6973;3422;3551
46;Valencia/València;258;Villar del Arzobispo;3431;1707;1724
46;Valencia/València;259;Villargordo del Cabriel;776;400;376
46;Valencia/València;260;Vinalesa;2285;1084;1201
46;Valencia/València;145;Xàtiva;25467;12378;13089
46;Valencia/València;143;Xeraco;4643;2334;2309
46;Valencia/València;146;Xeresa;1975;999;976
46;Valencia/València;110;Xirivella;26529;13173;13356
46;Valencia/València;261;Yátova;2005;1043;962
46;Valencia/València;262;Yesa (La);291;145;146
46;Valencia/València;263;Zarra;444;229;215
47;Valladolid;001;Adalia;87;47;40
47;Valladolid;002;Aguasal;28;15;13
47;Valladolid;003;Aguilar de Campos;422;221;201
47;Valladolid;004;Alaejos;1803;926;877
47;Valladolid;005;Alcazarén;795;424;371
47;Valladolid;006;Aldea de San Miguel;247;125;122
47;Valladolid;007;Aldeamayor de San Martín;1114;559;555
47;Valladolid;008;Almenara de Adaja;36;20;16
47;Valladolid;009;Amusquillo;198;106;92
47;Valladolid;010;Arroyo de la Encomienda;1548;794;754
47;Valladolid;011;Ataquines;946;491;455
47;Valladolid;012;Bahabón;256;126;130
47;Valladolid;013;Barcial de la Loma;182;90;92
47;Valladolid;014;Barruelo del Valle;83;43;40
47;Valladolid;015;Becilla de Valderaduey;491;247;244
47;Valladolid;016;Benafarces;105;50;55
47;Valladolid;017;Bercero;296;154;142
47;Valladolid;018;Berceruelo;35;19;16
47;Valladolid;019;Berrueces;116;68;48
47;Valladolid;020;Bobadilla del Campo;443;233;210
47;Valladolid;021;Bocigas;172;83;89
47;Valladolid;022;Bocos de Duero;95;42;53
47;Valladolid;023;Boecillo;964;492;472
47;Valladolid;024;Bolaños de Campos;398;201;197
47;Valladolid;025;Brahojos de Medina;193;109;84
47;Valladolid;026;Bustillo de Chaves;109;53;56
47;Valladolid;027;Cabezón de Pisuerga;1549;773;776
47;Valladolid;028;Cabezón de Valderaduey;54;27;27
47;Valladolid;029;Cabreros del Monte;113;60;53
47;Valladolid;030;Campaspero;1695;876;819
47;Valladolid;031;Campillo (El);248;133;115
47;Valladolid;032;Camporredondo;246;136;110
47;Valladolid;033;Canalejas de Peñafiel;339;178;161
47;Valladolid;034;Canillas de Esgueva;164;87;77
47;Valladolid;035;Carpio;1299;696;603
47;Valladolid;036;Casasola de Arión;418;220;198
47;Valladolid;037;Castrejón de Trabancos;286;155;131
47;Valladolid;038;Castrillo de Duero;257;135;122
47;Valladolid;039;Castrillo-Tejeriego;315;165;150
47;Valladolid;040;Castrobol;103;47;56
47;Valladolid;041;Castrodeza;276;145;131
47;Valladolid;042;Castromembibre;95;46;49
47;Valladolid;043;Castromonte;522;273;249
47;Valladolid;044;Castronuevo de Esgueva;309;161;148
47;Valladolid;045;Castronuño;1190;624;566
47;Valladolid;046;Castroponce;217;106;111
47;Valladolid;047;Castroverde de Cerrato;307;169;138
47;Valladolid;048;Ceinos de Campos;276;150;126
47;Valladolid;049;Cervillego de la Cruz;178;92;86
47;Valladolid;050;Cigales;1829;877;952
47;Valladolid;051;Ciguñuela;383;201;182
47;Valladolid;052;Cistérniga;1980;1014;966
47;Valladolid;053;Cogeces de Íscar;160;84;76
47;Valladolid;054;Cogeces del Monte;1035;549;486
47;Valladolid;055;Corcos;277;142;135
47;Valladolid;056;Corrales de Duero;167;91;76
47;Valladolid;057;Cubillas de Santa Marta;261;136;125
47;Valladolid;058;Cuenca de Campos;316;160;156
47;Valladolid;059;Curiel de Duero;159;86;73
47;Valladolid;060;Encinas de Esgueva;425;224;201
47;Valladolid;061;Esguevillas de Esgueva;446;231;215
47;Valladolid;062;Fombellida;324;172;152
47;Valladolid;063;Fompedraza;153;86;67
47;Valladolid;064;Fontihoyuelo;52;30;22
47;Valladolid;065;Fresno el Viejo;1352;678;674
47;Valladolid;066;Fuensaldaña;803;405;398
47;Valladolid;067;Fuente el Sol;340;175;165
47;Valladolid;068;Fuente-Olmedo;66;31;35
47;Valladolid;069;Gallegos de Hornija;161;83;78
47;Valladolid;070;Gatón de Campos;66;34;32
47;Valladolid;071;Geria;422;233;189
47;Valladolid;073;Herrín de Campos;237;115;122
47;Valladolid;074;Hornillos de Eresma;145;73;72
47;Valladolid;075;Íscar;6004;3029;2975
47;Valladolid;076;Laguna de Duero;12577;6383;6194
47;Valladolid;077;Langayo;520;274;246
47;Valladolid;079;Llano de Olmedo;114;55;59
47;Valladolid;078;Lomoviejo;285;141;144
47;Valladolid;080;Manzanillo;62;36;26
47;Valladolid;081;Marzales;81;39;42
47;Valladolid;082;Matapozuelos;958;485;473
47;Valladolid;083;Matilla de los Caños;95;52;43
47;Valladolid;084;Mayorga;1679;809;870
47;Valladolid;086;Medina de Rioseco;5031;2469;2562
47;Valladolid;085;Medina del Campo;20115;9891;10224
47;Valladolid;087;Megeces;488;241;247
47;Valladolid;088;Melgar de Abajo;209;104;105
47;Valladolid;089;Melgar de Arriba;323;160;163
47;Valladolid;090;Mojados;2263;1131;1132
47;Valladolid;091;Monasterio de Vega;96;48;48
47;Valladolid;092;Montealegre de Campos;186;103;83
47;Valladolid;093;Montemayor de Pililla;1105;577;528
47;Valladolid;094;Moral de la Reina;257;134;123
47;Valladolid;095;Moraleja de las Panaderas;29;16;13
47;Valladolid;096;Morales de Campos;222;118;104
47;Valladolid;097;Mota del Marqués;494;235;259
47;Valladolid;098;Mucientes;661;338;323
47;Valladolid;099;Mudarra (La);287;152;135
47;Valladolid;100;Muriel;275;138;137
47;Valladolid;101;Nava del Rey;2374;1154;1220
47;Valladolid;102;Nueva Villa de las Torres;428;230;198
47;Valladolid;103;Olivares de Duero;340;180;160
47;Valladolid;104;Olmedo;3666;1792;1874
47;Valladolid;105;Olmos de Esgueva;194;104;90
47;Valladolid;106;Olmos de Peñafiel;98;53;45
47;Valladolid;109;Palazuelo de Vedija;243;131;112
47;Valladolid;110;Parrilla (La);671;326;345
47;Valladolid;111;Pedraja de Portillo (La);1080;535;545
47;Valladolid;112;Pedrajas de San Esteban;3179;1623;1556
47;Valladolid;113;Pedrosa del Rey;271;141;130
47;Valladolid;114;Peñafiel;5119;2597;2522
47;Valladolid;115;Peñaflor de Hornija;488;259;229
47;Valladolid;116;Pesquera de Duero;567;300;267
47;Valladolid;117;Piña de Esgueva;425;219;206
47;Valladolid;118;Piñel de Abajo;265;144;121
47;Valladolid;119;Piñel de Arriba;170;88;82
47;Valladolid;121;Pollos;877;448;429
47;Valladolid;122;Portillo;2582;1314;1268
47;Valladolid;123;Pozal de Gallinas;503;258;245
47;Valladolid;124;Pozaldez;591;287;304
47;Valladolid;125;Pozuelo de la Orden;99;55;44
47;Valladolid;126;Puras;71;36;35
47;Valladolid;127;Quintanilla de Arriba;252;134;118
47;Valladolid;129;Quintanilla de Onésimo;1131;597;534
47;Valladolid;130;Quintanilla de Trigueros;103;51;52
47;Valladolid;128;Quintanilla del Molar;91;38;53
47;Valladolid;131;Rábano;261;134;127
47;Valladolid;132;Ramiro;91;46;45
47;Valladolid;133;Renedo de Esgueva;881;461;420
47;Valladolid;134;Roales de Campos;293;155;138
47;Valladolid;135;Robladillo;107;56;51
47;Valladolid;137;Roturas;22;12;10
47;Valladolid;138;Rubí de Bracamonte;370;195;175
47;Valladolid;139;Rueda;1609;830;779
47;Valladolid;140;Saelices de Mayorga;217;116;101
47;Valladolid;141;Salvador de Zapardiel;218;113;105
47;Valladolid;142;San Cebrián de Mazote;253;136;117
47;Valladolid;143;San Llorente;236;122;114
47;Valladolid;144;San Martín de Valvení;117;65;52
47;Valladolid;145;San Miguel del Arroyo;859;442;417
47;Valladolid;146;San Miguel del Pino;228;123;105
47;Valladolid;147;San Pablo de la Moraleja;196;104;92
47;Valladolid;148;San Pedro de Latarce;713;387;326
47;Valladolid;149;San Pelayo;49;23;26
47;Valladolid;150;San Román de Hornija;520;257;263
47;Valladolid;151;San Salvador;51;26;25
47;Valladolid;156;San Vicente del Palacio;296;150;146
47;Valladolid;152;Santa Eufemia del Arroyo;152;75;77
47;Valladolid;153;Santervás de Campos;191;102;89
47;Valladolid;154;Santibáñez de Valcorba;230;117;113
47;Valladolid;155;Santovenia de Pisuerga;1178;599;579
47;Valladolid;157;Sardón de Duero;648;325;323
47;Valladolid;158;Seca (La);1072;564;508
47;Valladolid;159;Serrada;1038;533;505
47;Valladolid;160;Siete Iglesias de Trabancos;706;355;351
47;Valladolid;161;Simancas;2237;1144;1093
47;Valladolid;162;Tamariz de Campos;116;63;53
47;Valladolid;163;Tiedra;464;226;238
47;Valladolid;164;Tordehumos;596;307;289
47;Valladolid;165;Tordesillas;7725;3874;3851
47;Valladolid;169;Torre de Esgueva;127;59;68
47;Valladolid;170;Torre de Peñafiel;52;27;25
47;Valladolid;166;Torrecilla de la Abadesa;407;218;189
47;Valladolid;167;Torrecilla de la Orden;415;201;214
47;Valladolid;168;Torrecilla de la Torre;46;26;20
47;Valladolid;171;Torrelobatón;657;327;330
47;Valladolid;172;Torrescárcela;189;95;94
47;Valladolid;173;Traspinedo;786;401;385
47;Valladolid;174;Trigueros del Valle;275;139;136
47;Valladolid;175;Tudela de Duero;5190;2664;2526
47;Valladolid;176;Unión de Campos (La);370;176;194
47;Valladolid;177;Urones de Castroponce;201;113;88
47;Valladolid;178;Urueña;226;112;114
47;Valladolid;179;Valbuena de Duero;541;279;262
47;Valladolid;180;Valdearcos de la Vega;165;81;84
47;Valladolid;181;Valdenebro de los Valles;263;137;126
47;Valladolid;182;Valdestillas;1423;727;696
47;Valladolid;183;Valdunquillo;289;140;149
47;Valladolid;186;Valladolid;334886;162267;172619
47;Valladolid;184;Valoria la Buena;692;362;330
47;Valladolid;185;Valverde de Campos;121;64;57
47;Valladolid;187;Vega de Ruiponce;185;88;97
47;Valladolid;188;Vega de Valdetronco;209;112;97
47;Valladolid;189;Velascálvaro;199;105;94
47;Valladolid;190;Velilla;149;80;69
47;Valladolid;191;Velliza;166;92;74
47;Valladolid;192;Ventosa de la Cuesta;166;83;83
47;Valladolid;193;Viana de Cega;1117;569;548
47;Valladolid;195;Villabáñez;463;239;224
47;Valladolid;196;Villabaruz de Campos;55;25;30
47;Valladolid;197;Villabrágima;1313;682;631
47;Valladolid;198;Villacarralón;139;71;68
47;Valladolid;199;Villacid de Campos;129;73;56
47;Valladolid;200;Villaco;165;95;70
47;Valladolid;203;Villafrades de Campos;156;71;85
47;Valladolid;204;Villafranca de Duero;419;210;209
47;Valladolid;205;Villafrechós;558;283;275
47;Valladolid;206;Villafuerte;180;82;98
47;Valladolid;207;Villagarcía de Campos;469;251;218
47;Valladolid;208;Villagómez la Nueva;110;50;60
47;Valladolid;209;Villalán de Campos;55;27;28
47;Valladolid;210;Villalar de los Comuneros;512;259;253
47;Valladolid;211;Villalba de la Loma;57;31;26
47;Valladolid;212;Villalba de los Alcores;610;315;295
47;Valladolid;213;Villalbarba;182;93;89
47;Valladolid;214;Villalón de Campos;2217;1079;1138
47;Valladolid;215;Villamuriel de Campos;96;47;49
47;Valladolid;216;Villán de Tordesillas;175;88;87
47;Valladolid;217;Villanubla;959;497;462
47;Valladolid;218;Villanueva de Duero;878;452;426
47;Valladolid;219;Villanueva de la Condesa;49;31;18
47;Valladolid;220;Villanueva de los Caballeros;323;155;168
47;Valladolid;221;Villanueva de los Infantes;173;89;84
47;Valladolid;222;Villanueva de San Mancio;100;50;50
47;Valladolid;223;Villardefrades;267;141;126
47;Valladolid;224;Villarmentero de Esgueva;131;68;63
47;Valladolid;225;Villasexmir;144;76;68
47;Valladolid;226;Villavaquerín;225;118;107
47;Valladolid;227;Villavellid;71;41;30
47;Valladolid;228;Villaverde de Medina;652;349;303
47;Valladolid;229;Villavicencio de los Caballeros;381;182;199
47;Valladolid;194;Viloria;420;229;191
47;Valladolid;230;Wamba;379;196;183
47;Valladolid;231;Zaratán;1198;612;586
47;Valladolid;232;Zarza (La);182;92;90
48;Vizcaya;001;Abadiño;7031;3555;3476
48;Vizcaya;002;Abanto y Ciérvana-Abanto Zierbena;9623;4786;4837
48;Vizcaya;911;Ajangiz;367;189;178
48;Vizcaya;912;Alonsotegi;3058;1501;1557
48;Vizcaya;003;Amorebieta-Etxano;16022;8035;7987
48;Vizcaya;004;Amoroto;388;209;179
48;Vizcaya;005;Arakaldo;105;57;48
48;Vizcaya;006;Arantzazu;285;135;150
48;Vizcaya;093;Areatza;1122;517;605
48;Vizcaya;009;Arrankudiaga;724;354;370
48;Vizcaya;914;Arratzu;372;187;185
48;Vizcaya;010;Arrieta;427;218;209
48;Vizcaya;011;Arrigorriaga;10229;5055;5174
48;Vizcaya;023;Artea;606;296;310
48;Vizcaya;008;Artzentales;660;364;296
48;Vizcaya;091;Atxondo;1529;761;768
48;Vizcaya;070;Aulesti;684;367;317
48;Vizcaya;012;Bakio;1265;640;625
48;Vizcaya;090;Balmaseda;7348;3557;3791
48;Vizcaya;013;Barakaldo;104197;51339;52858
48;Vizcaya;014;Barrika;902;441;461
48;Vizcaya;015;Basauri;50028;25008;25020
48;Vizcaya;092;Bedia;1015;492;523
48;Vizcaya;016;Berango;4308;2133;2175
48;Vizcaya;017;Bermeo;17805;8833;8972
48;Vizcaya;018;Berriatua;1015;533;482
48;Vizcaya;019;Berriz;4202;2114;2088
48;Vizcaya;020;Bilbao;372786;178162;194624
48;Vizcaya;021;Busturia;1707;861;846
48;Vizcaya;901;Derio;4806;2404;2402
48;Vizcaya;026;Dima;1041;548;493
48;Vizcaya;027;Durango;22929;11314;11615
48;Vizcaya;028;Ea;796;387;409
48;Vizcaya;031;Elantxobe;540;243;297
48;Vizcaya;032;Elorrio;7425;3745;3680
48;Vizcaya;902;Erandio;24713;12196;12517
48;Vizcaya;033;Ereño;280;136;144
48;Vizcaya;034;Ermua;17820;9155;8665
48;Vizcaya;079;Errigoiti;437;239;198
48;Vizcaya;029;Etxebarri, Anteiglesia de San Esteban-Etxebarri Doneztebeko Elizatea;6539;3310;3229
48;Vizcaya;030;Etxebarria;793;417;376
48;Vizcaya;906;Forua;920;470;450
48;Vizcaya;035;Fruiz;311;161;150
48;Vizcaya;036;Galdakao;29392;14698;14694
48;Vizcaya;037;Galdames;820;434;386
48;Vizcaya;038;Gamiz-Fika;902;478;424
48;Vizcaya;039;Garay;256;139;117
48;Vizcaya;040;Gatika;964;482;482
48;Vizcaya;041;Gautegiz Arteaga;773;377;396
48;Vizcaya;046;Gernika-Lumo;15747;7714;8033
48;Vizcaya;044;Getxo;82250;39594;42656
48;Vizcaya;047;Gizaburuaga;128;64;64
48;Vizcaya;042;Gordexola;1506;754;752
48;Vizcaya;043;Gorliz;3145;1552;1593
48;Vizcaya;045;Güeñes;5871;2906;2965
48;Vizcaya;048;Ibarrangelu;540;243;297
48;Vizcaya;094;Igorre;3917;1954;1963
48;Vizcaya;049;Ispaster;611;322;289
48;Vizcaya;910;Iurreta;4820;2371;2449
48;Vizcaya;050;Izurtza;285;147;138
48;Vizcaya;022;Karrantza Harana/Valle de Carranza;3135;1652;1483
48;Vizcaya;907;Kortezubi;396;207;189
48;Vizcaya;051;Lanestosa;306;157;149
48;Vizcaya;052;Larrabetzu;1489;738;751
48;Vizcaya;053;Laukiz;972;498;474
48;Vizcaya;054;Leioa;25417;12573;12844
48;Vizcaya;057;Lekeitio;7510;3682;3828
48;Vizcaya;055;Lemoa;2667;1354;1313
48;Vizcaya;056;Lemoiz;776;399;377
48;Vizcaya;081;Lezama;2031;1028;1003
48;Vizcaya;903;Loiu;1737;891;846
48;Vizcaya;058;Mallabia;1117;591;526
48;Vizcaya;059;Mañaria;504;264;240
48;Vizcaya;060;Markina-Xemein;4871;2413;2458
48;Vizcaya;061;Maruri-Jatabe;543;265;278
48;Vizcaya;062;Mendata;338;184;154
48;Vizcaya;063;Mendexa;336;171;165
48;Vizcaya;064;Meñaka;446;235;211
48;Vizcaya;066;Morga;349;175;174
48;Vizcaya;068;Mundaka;1742;804;938
48;Vizcaya;069;Mungia;12331;6050;6281
48;Vizcaya;007;Munitibar-Arbatzegi Gerrikaitz;434;238;196
48;Vizcaya;908;Murueta;196;96;100
48;Vizcaya;071;Muskiz;6472;3197;3275
48;Vizcaya;067;Muxika;1432;739;693
48;Vizcaya;909;Nabarniz;256;127;129
48;Vizcaya;073;Ondarroa;10700;5343;5357
48;Vizcaya;075;Orozko;1891;956;935
48;Vizcaya;083;Ortuella;8919;4401;4518
48;Vizcaya;072;Otxandio;1113;585;528
48;Vizcaya;077;Plentzia;2752;1346;1406
48;Vizcaya;078;Portugalete;56472;27834;28638
48;Vizcaya;082;Santurtzi;50473;24965;25508
48;Vizcaya;084;Sestao;35927;17554;18373
48;Vizcaya;904;Sondika;3395;1652;1743
48;Vizcaya;085;Sopelana;8555;4266;4289
48;Vizcaya;086;Sopuerta;2176;1116;1060
48;Vizcaya;076;Sukarrieta;308;149;159
48;Vizcaya;087;Trucios-Turtzioz;533;261;272
48;Vizcaya;088;Ubide;155;79;76
48;Vizcaya;065;Ugao-Miraballes;4161;2076;2085
48;Vizcaya;089;Urduliz;2615;1313;1302
48;Vizcaya;074;Urduña-Orduña;4013;2057;1956
48;Vizcaya;080;Valle de Trápaga-Trapagaran;13253;6547;6706
48;Vizcaya;095;Zaldibar;3099;1479;1620
48;Vizcaya;096;Zalla;7412;3665;3747
48;Vizcaya;905;Zamudio;3141;1572;1569
48;Vizcaya;097;Zaratamo;1623;810;813
48;Vizcaya;024;Zeanuri;1158;608;550
48;Vizcaya;025;Zeberio;937;480;457
48;Vizcaya;913;Zierbena;"";"";""
49;Zamora;002;Abezames;119;58;61
49;Zamora;003;Alcañices;1236;634;602
49;Zamora;004;Alcubilla de Nogales;256;125;131
49;Zamora;005;Alfaraz de Sayago;243;132;111
49;Zamora;006;Algodre;240;127;113
49;Zamora;007;Almaraz de Duero;495;242;253
49;Zamora;008;Almeida de Sayago;747;390;357
49;Zamora;009;Andavías;539;256;283
49;Zamora;010;Arcenillas;258;132;126
49;Zamora;011;Arcos de la Polvorosa;325;173;152
49;Zamora;012;Argañín;133;62;71
49;Zamora;013;Argujillo;424;227;197
49;Zamora;014;Arquillinos;199;99;100
49;Zamora;015;Arrabalde;478;234;244
49;Zamora;016;Aspariegos;429;197;232
49;Zamora;017;Asturianos;421;204;217
49;Zamora;018;Ayoó de Vidriales;564;277;287
49;Zamora;019;Barcial del Barco;332;182;150
49;Zamora;020;Belver de los Montes;577;301;276
49;Zamora;021;Benavente;15088;7333;7755
49;Zamora;022;Benegiles;472;253;219
49;Zamora;023;Bermillo de Sayago;1713;887;826
49;Zamora;024;Bóveda de Toro (La);1070;551;519
49;Zamora;025;Bretó;301;152;149
49;Zamora;026;Bretocino;342;186;156
49;Zamora;027;Brime de Sog;284;126;158
49;Zamora;028;Brime de Urz;188;103;85
49;Zamora;029;Burganes de Valverde;915;458;457
49;Zamora;030;Bustillo del Oro;200;97;103
49;Zamora;031;Cabañas de Sayago;243;125;118
49;Zamora;032;Calzadilla de Tera;627;301;326
49;Zamora;033;Camarzana de Tera;1139;564;575
49;Zamora;034;Cañizal;694;357;337
49;Zamora;035;Cañizo;389;194;195
49;Zamora;036;Carbajales de Alba;757;374;383
49;Zamora;037;Carbellino;283;149;134
49;Zamora;038;Casaseca de Campeán;180;96;84
49;Zamora;039;Casaseca de las Chanas;406;200;206
49;Zamora;040;Castrillo de la Guareña;187;94;93
49;Zamora;041;Castrogonzalo;587;297;290
49;Zamora;042;Castronuevo;404;207;197
49;Zamora;043;Castroverde de Campos;481;235;246
49;Zamora;044;Cazurra;107;57;50
49;Zamora;046;Cerecinos de Campos;495;258;237
49;Zamora;047;Cerecinos del Carrizal;183;97;86
49;Zamora;048;Cernadilla;183;86;97
49;Zamora;050;Cobreros;862;428;434
49;Zamora;052;Coomonte;373;191;182
49;Zamora;053;Coreses;1340;690;650
49;Zamora;054;Corrales;1350;661;689
49;Zamora;055;Cotanes del Monte;196;100;96
49;Zamora;056;Cubillos;451;234;217
49;Zamora;057;Cubo de Benavente;251;133;118
49;Zamora;058;Cubo de Tierra del Vino (El);502;259;243
49;Zamora;059;Cuelgamures;159;90;69
49;Zamora;061;Entrala;167;81;86
49;Zamora;062;Espadañedo;259;126;133
49;Zamora;063;Faramontanos de Tábara;588;294;294
49;Zamora;064;Fariza;806;402;404
49;Zamora;065;Fermoselle;1949;939;1010
49;Zamora;066;Ferreras de Abajo;677;342;335
49;Zamora;067;Ferreras de Arriba;572;292;280
49;Zamora;068;Ferreruela;742;391;351
49;Zamora;069;Figueruela de Arriba;630;310;320
49;Zamora;071;Fonfría;1283;646;637
49;Zamora;075;Fresno de la Polvorosa;265;134;131
49;Zamora;076;Fresno de la Ribera;441;241;200
49;Zamora;077;Fresno de Sayago;333;173;160
49;Zamora;078;Friera de Valverde;336;172;164
49;Zamora;079;Fuente Encalada;189;97;92
49;Zamora;080;Fuentelapeña;1116;560;556
49;Zamora;082;Fuentes de Ropel;714;365;349
49;Zamora;081;Fuentesaúco;1993;978;1015
49;Zamora;083;Fuentesecas;105;52;53
49;Zamora;084;Fuentespreadas;454;241;213
49;Zamora;085;Galende;1411;698;713
49;Zamora;086;Gallegos del Pan;202;99;103
49;Zamora;087;Gallegos del Río;1003;519;484
49;Zamora;088;Gamones;114;64;50
49;Zamora;090;Gema;335;166;169
49;Zamora;091;Granja de Moreruela;405;190;215
49;Zamora;092;Granucillo;308;154;154
49;Zamora;093;Guarrate;426;229;197
49;Zamora;094;Hermisende;518;260;258
49;Zamora;095;Hiniesta (La);441;217;224
49;Zamora;096;Jambrina;308;153;155
49;Zamora;097;Justel;248;132;116
49;Zamora;098;Losacino;395;207;188
49;Zamora;099;Losacio;190;105;85
49;Zamora;100;Lubián;426;212;214
49;Zamora;101;Luelmo;293;155;138
49;Zamora;102;Maderal (El);314;159;155
49;Zamora;103;Madridanos;592;306;286
49;Zamora;104;Mahide;626;327;299
49;Zamora;105;Maire de Castroponce;292;144;148
49;Zamora;107;Malva;283;133;150
49;Zamora;108;Manganeses de la Lampreana;917;462;455
49;Zamora;109;Manganeses de la Polvorosa;987;467;520
49;Zamora;110;Manzanal de Arriba;554;279;275
49;Zamora;112;Manzanal de los Infantes;246;115;131
49;Zamora;111;Manzanal del Barco;244;129;115
49;Zamora;113;Matilla de Arzón;328;175;153
49;Zamora;114;Matilla la Seca;95;50;45
49;Zamora;115;Mayalde;290;148;142
49;Zamora;116;Melgar de Tera;679;338;341
49;Zamora;117;Micereces de Tera;695;359;336
49;Zamora;118;Milles de la Polvorosa;302;148;154
49;Zamora;119;Molacillos;329;176;153
49;Zamora;120;Molezuelas de la Carballeda;172;85;87
49;Zamora;121;Mombuey;529;266;263
49;Zamora;122;Monfarracinos;558;297;261
49;Zamora;123;Montamarta;776;366;410
49;Zamora;124;Moral de Sayago;424;227;197
49;Zamora;126;Moraleja de Sayago;317;169;148
49;Zamora;125;Moraleja del Vino;1230;642;588
49;Zamora;128;Morales de Rey;823;402;421
49;Zamora;129;Morales de Toro;1145;564;581
49;Zamora;130;Morales de Valverde;363;180;183
49;Zamora;127;Morales del Vino;1238;635;603
49;Zamora;131;Moralina;412;220;192
49;Zamora;132;Moreruela de los Infanzones;529;279;250
49;Zamora;133;Moreruela de Tábara;642;334;308
49;Zamora;134;Muelas de los Caballeros;282;144;138
49;Zamora;135;Muelas del Pan;959;466;493
49;Zamora;136;Muga de Sayago;552;267;285
49;Zamora;137;Navianos de Valverde;294;164;130
49;Zamora;138;Olmillos de Castro;510;254;256
49;Zamora;139;Otero de Bodas;306;157;149
49;Zamora;141;Pajares de la Lampreana;569;282;287
49;Zamora;143;Palacios de Sanabria;337;162;175
49;Zamora;142;Palacios del Pan;283;135;148
49;Zamora;145;Pedralba de la Pradería;432;224;208
49;Zamora;146;Pego (El);500;258;242
49;Zamora;147;Peleagonzalo;506;255;251
49;Zamora;148;Peleas de Abajo;218;112;106
49;Zamora;149;Peñausende;641;325;316
49;Zamora;150;Peque;251;121;130
49;Zamora;151;Perdigón (El);926;466;460
49;Zamora;152;Pereruela;877;430;447
49;Zamora;153;Perilla de Castro;297;149;148
49;Zamora;154;Pías;293;152;141
49;Zamora;155;Piedrahita de Castro;175;108;67
49;Zamora;156;Pinilla de Toro;476;239;237
49;Zamora;157;Pino del Oro;272;150;122
49;Zamora;158;Piñero (El);335;192;143
49;Zamora;160;Pobladura de Valderaduey;91;42;49
49;Zamora;159;Pobladura del Valle;389;188;201
49;Zamora;162;Porto;424;209;215
49;Zamora;163;Pozoantiguo;420;211;209
49;Zamora;164;Pozuelo de Tábara;280;137;143
49;Zamora;165;Prado;129;62;67
49;Zamora;166;Puebla de Sanabria;1688;800;888
49;Zamora;167;Pueblica de Valverde;393;197;196
49;Zamora;170;Quintanilla de Urz;152;85;67
49;Zamora;168;Quintanilla del Monte;169;79;90
49;Zamora;169;Quintanilla del Olmo;73;33;40
49;Zamora;171;Quiruelas de Vidriales;1091;529;562
49;Zamora;172;Rabanales;983;502;481
49;Zamora;173;Rábano de Aliste;559;275;284
49;Zamora;174;Requejo;271;136;135
49;Zamora;175;Revellinos;396;200;196
49;Zamora;176;Riofrío de Aliste;1163;616;547
49;Zamora;177;Rionegro del Puente;449;219;230
49;Zamora;178;Roales;351;175;176
49;Zamora;179;Robleda-Cervantes;482;228;254
49;Zamora;180;Roelos de Sayago;179;92;87
49;Zamora;181;Rosinos de la Requejada;634;301;333
49;Zamora;183;Salce;173;93;80
49;Zamora;184;Samir de los Caños;280;149;131
49;Zamora;185;San Agustín del Pozo;224;124;100
49;Zamora;186;San Cebrián de Castro;467;220;247
49;Zamora;187;San Cristóbal de Entreviñas;1680;861;819
49;Zamora;188;San Esteban del Molar;234;130;104
49;Zamora;189;San Justo;394;191;203
49;Zamora;190;San Martín de Valderaduey;104;46;58
49;Zamora;191;San Miguel de la Ribera;464;233;231
49;Zamora;192;San Miguel del Valle;291;137;154
49;Zamora;193;San Pedro de Ceque;740;368;372
49;Zamora;194;San Pedro de la Nave-Almendra;555;276;279
49;Zamora;208;San Vicente de la Cabeza;747;385;362
49;Zamora;209;San Vitero;807;423;384
49;Zamora;197;Santa Clara de Avedillo;290;144;146
49;Zamora;199;Santa Colomba de las Monjas;369;191;178
49;Zamora;200;Santa Cristina de la Polvorosa;1341;681;660
49;Zamora;201;Santa Croya de Tera;567;283;284
49;Zamora;202;Santa Eufemia del Barco;345;186;159
49;Zamora;203;Santa María de la Vega;562;295;267
49;Zamora;204;Santa María de Valverde;131;71;60
49;Zamora;205;Santibáñez de Tera;669;343;326
49;Zamora;206;Santibáñez de Vidriales;1560;759;801
49;Zamora;207;Santovenia;516;258;258
49;Zamora;210;Sanzoles;783;402;381
49;Zamora;214;Tábara;991;503;488
49;Zamora;216;Tapioles;273;149;124
49;Zamora;219;Toro;9476;4611;4865
49;Zamora;220;Torre del Valle (La);217;116;101
49;Zamora;221;Torregamones;395;191;204
49;Zamora;222;Torres del Carrizal;579;302;277
49;Zamora;223;Trabazos;1102;563;539
49;Zamora;224;Trefacio;253;115;138
49;Zamora;225;Uña de Quintana;281;139;142
49;Zamora;226;Vadillo de la Guareña;372;187;185
49;Zamora;227;Valcabado;343;171;172
49;Zamora;228;Valdefinjas;108;59;49
49;Zamora;229;Valdescorriel;213;103;110
49;Zamora;230;Vallesa de la Guareña;209;115;94
49;Zamora;231;Vega de Tera;623;293;330
49;Zamora;232;Vega de Villalobos;195;95;100
49;Zamora;233;Vegalatrave;201;95;106
49;Zamora;234;Venialbo;589;307;282
49;Zamora;235;Vezdemarbán;783;371;412
49;Zamora;236;Vidayanes;138;68;70
49;Zamora;237;Videmala;262;131;131
49;Zamora;238;Villabrázaro;459;231;228
49;Zamora;239;Villabuena del Puente;1107;576;531
49;Zamora;240;Villadepera;309;152;157
49;Zamora;241;Villaescusa;465;237;228
49;Zamora;242;Villafáfila;703;344;359
49;Zamora;243;Villaferrueña;188;97;91
49;Zamora;244;Villageriz;73;37;36
49;Zamora;245;Villalazán;420;211;209
49;Zamora;246;Villalba de la Lampreana;369;189;180
49;Zamora;247;Villalcampo;804;386;418
49;Zamora;248;Villalobos;363;172;191
49;Zamora;249;Villalonso;166;77;89
49;Zamora;250;Villalpando;1836;892;944
49;Zamora;251;Villalube;378;189;189
49;Zamora;252;Villamayor de Campos;654;329;325
49;Zamora;255;Villamor de los Escuderos;632;318;314
49;Zamora;256;Villanázar;415;199;216
49;Zamora;257;Villanueva de Azoague;456;228;228
49;Zamora;258;Villanueva de Campeán;213;105;108
49;Zamora;259;Villanueva de las Peras;246;119;127
49;Zamora;260;Villanueva del Campo;1217;604;613
49;Zamora;263;Villar de Fallaves;123;68;55
49;Zamora;264;Villar del Buey;979;519;460
49;Zamora;261;Villaralbo;1582;794;788
49;Zamora;262;Villardeciervos;590;265;325
49;Zamora;265;Villardiegua de la Ribera;193;90;103
49;Zamora;266;Villárdiga;130;63;67
49;Zamora;267;Villardondiego;165;88;77
49;Zamora;268;Villarrín de Campos;664;337;327
49;Zamora;269;Villaseco del Pan;375;185;190
49;Zamora;270;Villavendimio;244;136;108
49;Zamora;272;Villaveza de Valverde;169;86;83
49;Zamora;271;Villaveza del Agua;316;163;153
49;Zamora;273;Viñas;350;184;166
49;Zamora;275;Zamora;65409;31124;34285
50;Zaragoza;001;Abanto;216;111;105
50;Zaragoza;002;Acered;311;161;150
50;Zaragoza;003;Agón;225;117;108
50;Zaragoza;004;Aguarón;759;375;384
50;Zaragoza;005;Aguilón;266;134;132
50;Zaragoza;006;Ainzón;1218;610;608
50;Zaragoza;007;Aladrén;68;36;32
50;Zaragoza;008;Alagón;5623;2766;2857
50;Zaragoza;009;Alarba;174;99;75
50;Zaragoza;010;Alberite de San Juan;114;58;56
50;Zaragoza;011;Albeta;140;67;73
50;Zaragoza;012;Alborge;134;64;70
50;Zaragoza;013;Alcalá de Ebro;336;167;169
50;Zaragoza;014;Alcalá de Moncayo;172;96;76
50;Zaragoza;015;Alconchel de Ariza;186;103;83
50;Zaragoza;016;Aldehuela de Liestos;82;43;39
50;Zaragoza;017;Alfajarín;1463;755;708
50;Zaragoza;018;Alfamén;1312;699;613
50;Zaragoza;019;Alforque;92;50;42
50;Zaragoza;020;Alhama de Aragón;1226;596;630
50;Zaragoza;021;Almochuel;52;31;21
50;Zaragoza;022;Almolda (La);732;360;372
50;Zaragoza;023;Almonacid de la Cuba;378;196;182
50;Zaragoza;024;Almonacid de la Sierra;838;428;410
50;Zaragoza;025;Almunia de Doña Godina (La);5161;2630;2531
50;Zaragoza;026;Alpartir;631;332;299
50;Zaragoza;027;Ambel;408;197;211
50;Zaragoza;028;Anento;97;52;45
50;Zaragoza;029;Aniñón;945;490;455
50;Zaragoza;030;Añón de Moncayo;342;196;146
50;Zaragoza;031;Aranda de Moncayo;262;144;118
50;Zaragoza;032;Arándiga;572;280;292
50;Zaragoza;033;Ardisa;78;39;39
50;Zaragoza;034;Ariza;1407;700;707
50;Zaragoza;035;Artieda;104;57;47
50;Zaragoza;036;Asín;110;56;54
50;Zaragoza;037;Atea;281;150;131
50;Zaragoza;038;Ateca;2117;1023;1094
50;Zaragoza;039;Azuara;801;422;379
50;Zaragoza;040;Badules;120;62;58
50;Zaragoza;041;Bagüés;21;11;10
50;Zaragoza;042;Balconchán;34;19;15
50;Zaragoza;043;Bárboles;344;180;164
50;Zaragoza;044;Bardallur;322;155;167
50;Zaragoza;045;Belchite;1704;857;847
50;Zaragoza;046;Belmonte de Gracián;336;184;152
50;Zaragoza;047;Berdejo;47;24;23
50;Zaragoza;048;Berrueco;39;21;18
50;Zaragoza;901;Biel;241;127;114
50;Zaragoza;050;Bijuesca;136;73;63
50;Zaragoza;051;Biota;1286;680;606
50;Zaragoza;052;Bisimbre;145;66;79
50;Zaragoza;053;Boquiñeni;1064;544;520
50;Zaragoza;054;Bordalba;111;60;51
50;Zaragoza;055;Borja;4101;1996;2105
50;Zaragoza;056;Botorrita;465;246;219
50;Zaragoza;057;Brea de Aragón;2026;1010;1016
50;Zaragoza;058;Bubierca;118;56;62
50;Zaragoza;059;Bujaraloz;1063;551;512
50;Zaragoza;060;Bulbuente;278;153;125
50;Zaragoza;061;Bureta;345;175;170
50;Zaragoza;062;Burgo de Ebro (El);1316;646;670
50;Zaragoza;063;Buste (El);128;65;63
50;Zaragoza;064;Cabañas de Ebro;557;285;272
50;Zaragoza;065;Cabolafuente;99;56;43
50;Zaragoza;066;Cadrete;1020;535;485
50;Zaragoza;067;Calatayud;17494;8414;9080
50;Zaragoza;068;Calatorao;2645;1360;1285
50;Zaragoza;069;Calcena;106;54;52
50;Zaragoza;070;Calmarza;123;64;59
50;Zaragoza;071;Campillo de Aragón;227;128;99
50;Zaragoza;072;Carenas;235;119;116
50;Zaragoza;073;Cariñena;2938;1464;1474
50;Zaragoza;074;Caspe;8219;4078;4141
50;Zaragoza;075;Castejón de Alarba;135;76;59
50;Zaragoza;076;Castejón de las Armas;159;83;76
50;Zaragoza;077;Castejón de Valdejasa;390;211;179
50;Zaragoza;078;Castiliscar;459;229;230
50;Zaragoza;079;Cervera de la Cañada;372;180;192
50;Zaragoza;080;Cerveruela;4;2;2
50;Zaragoza;081;Cetina;817;406;411
50;Zaragoza;092;Chiprana;437;222;215
50;Zaragoza;093;Chodes;148;72;76
50;Zaragoza;082;Cimballa;136;67;69
50;Zaragoza;083;Cinco Olivas;154;75;79
50;Zaragoza;084;Clarés de Ribota;113;60;53
50;Zaragoza;085;Codo;316;159;157
50;Zaragoza;086;Codos;321;182;139
50;Zaragoza;087;Contamina;67;35;32
50;Zaragoza;088;Cosuenda;446;228;218
50;Zaragoza;089;Cuarte de Huerva;1426;736;690
50;Zaragoza;090;Cubel;255;127;128
50;Zaragoza;091;Cuerlas (Las);105;53;52
50;Zaragoza;094;Daroca;2366;1173;1193
50;Zaragoza;095;Ejea de los Caballeros;15523;7897;7626
50;Zaragoza;096;Embid de Ariza;75;41;34
50;Zaragoza;098;Encinacorba;360;195;165
50;Zaragoza;099;Épila;3922;2000;1922
50;Zaragoza;100;Erla;524;253;271
50;Zaragoza;101;Escatrón;1401;687;714
50;Zaragoza;102;Fabara;1316;697;619
50;Zaragoza;104;Farlete;490;249;241
50;Zaragoza;105;Fayón;428;218;210
50;Zaragoza;106;Fayos (Los);215;115;100
50;Zaragoza;107;Figueruelas;943;466;477
50;Zaragoza;108;Fombuena;13;11;2
50;Zaragoza;109;Frago (El);125;74;51
50;Zaragoza;110;Frasno (El);629;330;299
50;Zaragoza;111;Fréscano;279;138;141
50;Zaragoza;113;Fuendejalón;971;487;484
50;Zaragoza;114;Fuendetodos;166;94;72
50;Zaragoza;115;Fuentes de Ebro;3871;1984;1887
50;Zaragoza;116;Fuentes de Jiloca;407;212;195
50;Zaragoza;117;Gallocanta;190;96;94
50;Zaragoza;118;Gallur;3052;1518;1534
50;Zaragoza;119;Gelsa;1352;684;668
50;Zaragoza;120;Godojos;84;46;38
50;Zaragoza;121;Gotor;400;209;191
50;Zaragoza;122;Grisel;70;35;35
50;Zaragoza;123;Grisén;468;234;234
50;Zaragoza;124;Herrera de los Navarros;690;357;333
50;Zaragoza;125;Ibdes;615;319;296
50;Zaragoza;126;Illueca;3233;1611;1622
50;Zaragoza;128;Isuerre;65;32;33
50;Zaragoza;129;Jaraba;324;164;160
50;Zaragoza;130;Jarque;599;314;285
50;Zaragoza;131;Jaulín;308;155;153
50;Zaragoza;132;Joyosa (La);361;182;179
50;Zaragoza;133;Lagata;148;81;67
50;Zaragoza;134;Langa del Castillo;203;91;112
50;Zaragoza;135;Layana;180;88;92
50;Zaragoza;136;Lécera;975;480;495
50;Zaragoza;138;Lechón;60;34;26
50;Zaragoza;137;Leciñena;1441;716;725
50;Zaragoza;139;Letux;496;259;237
50;Zaragoza;140;Litago;194;110;84
50;Zaragoza;141;Lituénigo;129;62;67
50;Zaragoza;142;Lobera de Onsella;60;36;24
50;Zaragoza;143;Longares;901;468;433
50;Zaragoza;144;Longás;35;24;11
50;Zaragoza;146;Lucena de Jalón;317;156;161
50;Zaragoza;147;Luceni;1098;542;556
50;Zaragoza;148;Luesia;454;240;214
50;Zaragoza;149;Luesma;30;16;14
50;Zaragoza;150;Lumpiaque;993;518;475
50;Zaragoza;151;Luna;976;507;469
50;Zaragoza;152;Maella;2176;1099;1077
50;Zaragoza;153;Magallón;1346;698;648
50;Zaragoza;154;Mainar;188;103;85
50;Zaragoza;155;Malanquilla;137;68;69
50;Zaragoza;156;Maleján;325;165;160
50;Zaragoza;160;Mallén;3019;1530;1489
50;Zaragoza;157;Malón;525;263;262
50;Zaragoza;159;Maluenda;1053;524;529
50;Zaragoza;161;Manchones;171;84;87
50;Zaragoza;162;Mara;252;133;119
50;Zaragoza;163;María de Huerva;840;401;439
50;Zaragoza;902;Marracos;"";"";""
50;Zaragoza;164;Mediana de Aragón;528;259;269
50;Zaragoza;165;Mequinenza;2706;1363;1343
50;Zaragoza;166;Mesones de Isuela;434;217;217
50;Zaragoza;167;Mezalocha;332;176;156
50;Zaragoza;168;Mianos;40;22;18
50;Zaragoza;169;Miedes de Aragón;564;286;278
50;Zaragoza;170;Monegrillo;562;302;260
50;Zaragoza;171;Moneva;104;51;53
50;Zaragoza;172;Monreal de Ariza;336;172;164
50;Zaragoza;173;Monterde;200;99;101
50;Zaragoza;174;Montón;165;78;87
50;Zaragoza;175;Morata de Jalón;1699;832;867
50;Zaragoza;176;Morata de Jiloca;356;194;162
50;Zaragoza;177;Morés;548;284;264
50;Zaragoza;178;Moros;594;309;285
50;Zaragoza;179;Moyuela;422;212;210
50;Zaragoza;180;Mozota;119;56;63
50;Zaragoza;181;Muel;1189;592;597
50;Zaragoza;182;Muela (La);1025;545;480
50;Zaragoza;183;Munébrega;519;273;246
50;Zaragoza;184;Murero;162;91;71
50;Zaragoza;185;Murillo de Gállego;159;79;80
50;Zaragoza;186;Navardún;86;44;42
50;Zaragoza;187;Nigüella;136;68;68
50;Zaragoza;188;Nombrevilla;35;17;18
50;Zaragoza;189;Nonaspe;1140;572;568
50;Zaragoza;190;Novallas;813;402;411
50;Zaragoza;191;Novillas;731;370;361
50;Zaragoza;192;Nuévalos;318;184;134
50;Zaragoza;193;Nuez de Ebro;543;281;262
50;Zaragoza;194;Olvés;183;103;80
50;Zaragoza;195;Orcajo;52;25;27
50;Zaragoza;196;Orera;175;87;88
50;Zaragoza;197;Orés;131;71;60
50;Zaragoza;198;Oseja;32;14;18
50;Zaragoza;199;Osera de Ebro;356;173;183
50;Zaragoza;200;Paniza;766;382;384
50;Zaragoza;201;Paracuellos de Jiloca;533;250;283
50;Zaragoza;202;Paracuellos de la Ribera;361;173;188
50;Zaragoza;203;Pastriz;783;383;400
50;Zaragoza;204;Pedrola;2513;1293;1220
50;Zaragoza;205;Pedrosas (Las);109;53;56
50;Zaragoza;206;Perdiguera;479;252;227
50;Zaragoza;207;Piedratajada;224;115;109
50;Zaragoza;208;Pina de Ebro;2230;1117;1113
50;Zaragoza;209;Pinseque;1406;702;704
50;Zaragoza;210;Pintanos (Los);84;47;37
50;Zaragoza;211;Plasencia de Jalón;385;201;184
50;Zaragoza;212;Pleitas;78;42;36
50;Zaragoza;213;Plenas;174;87;87
50;Zaragoza;214;Pomer;21;8;13
50;Zaragoza;215;Pozuel de Ariza;32;19;13
50;Zaragoza;216;Pozuelo de Aragón;383;208;175
50;Zaragoza;217;Pradilla de Ebro;691;360;331
50;Zaragoza;218;Puebla de Albortón;155;80;75
50;Zaragoza;219;Puebla de Alfindén (La);1491;771;720
50;Zaragoza;220;Puendeluna;68;37;31
50;Zaragoza;221;Purujosa;35;21;14
50;Zaragoza;222;Quinto;2207;1120;1087
50;Zaragoza;223;Remolinos;1264;640;624
50;Zaragoza;224;Retascón;83;47;36
50;Zaragoza;225;Ricla;2049;1059;990
50;Zaragoza;227;Romanos;153;87;66
50;Zaragoza;228;Rueda de Jalón;374;196;178
50;Zaragoza;229;Ruesca;82;41;41
50;Zaragoza;241;Sabiñán;1030;497;533
50;Zaragoza;230;Sádaba;1874;956;918
50;Zaragoza;231;Salillas de Jalón;390;205;185
50;Zaragoza;232;Salvatierra de Esca;318;169;149
50;Zaragoza;233;Samper del Salz;104;53;51
50;Zaragoza;234;San Martín de la Virgen de Moncayo;316;166;150
50;Zaragoza;235;San Mateo de Gállego;1872;965;907
50;Zaragoza;236;Santa Cruz de Grío;240;132;108
50;Zaragoza;237;Santa Cruz de Moncayo;112;58;54
50;Zaragoza;238;Santa Eulalia de Gállego;135;69;66
50;Zaragoza;239;Santed;84;39;45
50;Zaragoza;240;Sástago;1631;819;812
50;Zaragoza;242;Sediles;106;55;51
50;Zaragoza;243;Sestrica;543;276;267
50;Zaragoza;244;Sierra de Luna;323;165;158
50;Zaragoza;245;Sigüés;189;100;89
50;Zaragoza;246;Sisamón;105;61;44
50;Zaragoza;247;Sobradiel;589;279;310
50;Zaragoza;248;Sos del Rey Católico;907;457;450
50;Zaragoza;249;Tabuenca;532;280;252
50;Zaragoza;250;Talamantes;62;32;30
50;Zaragoza;251;Tarazona;10626;5132;5494
50;Zaragoza;252;Tauste;7065;3532;3533
50;Zaragoza;253;Terrer;755;362;393
50;Zaragoza;254;Tierga;287;153;134
50;Zaragoza;255;Tobed;309;148;161
50;Zaragoza;256;Torralba de los Frailes;122;60;62
50;Zaragoza;257;Torralba de Ribota;251;140;111
50;Zaragoza;258;Torralbilla;76;37;39
50;Zaragoza;259;Torrehermosa;130;71;59
50;Zaragoza;260;Torrelapaja;56;27;29
50;Zaragoza;261;Torrellas;360;180;180
50;Zaragoza;262;Torres de Berrellén;1421;712;709
50;Zaragoza;263;Torrijo de la Cañada;474;251;223
50;Zaragoza;264;Tosos;246;130;116
50;Zaragoza;265;Trasmoz;79;40;39
50;Zaragoza;266;Trasobares;279;147;132
50;Zaragoza;267;Uncastillo;970;468;502
50;Zaragoza;268;Undués de Lerda;48;22;26
50;Zaragoza;269;Urrea de Jalón;378;184;194
50;Zaragoza;270;Urriés;75;40;35
50;Zaragoza;271;Used;434;221;213
50;Zaragoza;272;Utebo;8409;4241;4168
50;Zaragoza;274;Val de San Martín;74;33;41
50;Zaragoza;273;Valdehorna;77;38;39
50;Zaragoza;275;Valmadrid;72;37;35
50;Zaragoza;276;Valpalmas;228;115;113
50;Zaragoza;277;Valtorres;118;57;61
50;Zaragoza;278;Velilla de Ebro;288;143;145
50;Zaragoza;279;Velilla de Jiloca;153;75;78
50;Zaragoza;280;Vera de Moncayo;502;254;248
50;Zaragoza;281;Vierlas;106;50;56
50;Zaragoza;283;Villadoz;92;49;43
50;Zaragoza;284;Villafeliche;256;124;132
50;Zaragoza;285;Villafranca de Ebro;678;327;351
50;Zaragoza;286;Villalba de Perejil;101;50;51
50;Zaragoza;287;Villalengua;495;260;235
50;Zaragoza;288;Villanueva de Gállego;2548;1271;1277
50;Zaragoza;290;Villanueva de Huerva;653;325;328
50;Zaragoza;289;Villanueva de Jiloca;111;55;56
50;Zaragoza;291;Villar de los Navarros;195;98;97
50;Zaragoza;292;Villarreal de Huerva;209;115;94
50;Zaragoza;293;Villarroya de la Sierra;783;395;388
50;Zaragoza;294;Villarroya del Campo;75;39;36
50;Zaragoza;282;Vilueña (La);110;51;59
50;Zaragoza;295;Vistabella;32;17;15
50;Zaragoza;296;Zaida (La);648;326;322
50;Zaragoza;297;Zaragoza;600892;290362;310530
50;Zaragoza;298;Zuera;5353;2713;2640
51;Ceuta;001;Ceuta;70777;35024;35753
52;Melilla;001;Melilla;61524;30763;30761
