01;Álava;001;Alegría-Dulantzi;1030;523;507
01;Álava;002;Amurrio;9785;4929;4856
01;Álava;049;Añana;194;101;93
01;Álava;003;Aramaio;1351;715;636
01;Álava;006;Armiñón;154;75;79
01;Álava;037;Arraia-Maeztu;797;421;376
01;Álava;008;Arrazua-Ubarrundia;630;339;291
01;Álava;004;Artziniega;1197;589;608
01;Álava;009;Asparrena;1564;775;789
01;Álava;010;Ayala/Aiara;2165;1078;1087
01;Álava;011;Baños de Ebro/Mañueta;354;189;165
01;Álava;013;Barrundia;584;329;255
01;Álava;014;Berantevilla;421;213;208
01;Álava;016;Bernedo;577;325;252
01;Álava;017;Campezo/Kanpezu;1172;615;557
01;Álava;021;Elburgo/Burgelu;209;114;95
01;Álava;022;Elciego;916;459;457
01;Álava;023;Elvillar/Bilar;383;198;185
01;Álava;056;Harana/Valle de Arana;417;228;189
01;Álava;901;Iruña Oka/Iruña de Oca;1598;838;760
01;Álava;027;Iruraiz-Gauna;452;239;213
01;Álava;019;Kripan;205;108;97
01;Álava;020;Kuartango;360;202;158
01;Álava;028;Labastida;994;537;457
01;Álava;030;Lagrán;202;108;94
01;Álava;031;Laguardia;1508;785;723
01;Álava;032;Lanciego/Lantziego;630;344;286
01;Álava;902;Lantarón;832;428;404
01;Álava;033;Lapuebla de Labarca;837;422;415
01;Álava;058;Legutiano;1285;705;580
01;Álava;034;Leza;189;101;88
01;Álava;036;Llodio;20882;10616;10266
01;Álava;039;Moreda de Álava;282;150;132
01;Álava;041;Navaridas;216;116;100
01;Álava;042;Okondo;769;416;353
01;Álava;043;Oyón/Oion;2276;1151;1125
01;Álava;044;Peñacerrada-Urizaharra;239;134;105
01;Álava;046;Ribera Alta;529;310;219
01;Álava;047;Ribera Baja/Erribera Beitia;390;211;179
01;Álava;051;Salvatierra/Agurain;3703;1863;1840
01;Álava;052;Samaniego;297;146;151
01;Álava;053;San Millán/Donemiliaga;766;407;359
01;Álava;054;Urkabustaiz;903;461;442
01;Álava;055;Valdegovía;870;491;379
01;Álava;057;Villabuena de Álava/Eskuernaga;360;184;176
01;Álava;059;Vitoria-Gasteiz;209506;103821;105685
01;Álava;060;Yécora/Lekora;251;127;124
01;Álava;061;Zalduondo;126;69;57
01;Álava;062;Zambrana;344;185;159
01;Álava;018;Zigoitia;795;434;361
01;Álava;063;Zuia;1238;621;617
02;Albacete;001;Abengibre;1100;553;547
02;Albacete;002;Alatoz;794;411;383
02;Albacete;003;Albacete;129002;63360;65642
02;Albacete;004;Albatana;940;477;463
02;Albacete;005;Alborea;880;451;429
02;Albacete;006;Alcadozo;885;456;429
02;Albacete;007;Alcalá del Júcar;1746;886;860
02;Albacete;008;Alcaraz;2041;993;1048
02;Albacete;009;Almansa;22556;11029;11527
02;Albacete;010;Alpera;2354;1194;1160
02;Albacete;011;Ayna;1357;683;674
02;Albacete;012;Balazote;2266;1133;1133
02;Albacete;014;Ballestero (El);740;365;375
02;Albacete;013;Balsa de Ves;283;140;143
02;Albacete;015;Barrax;2055;1021;1034
02;Albacete;016;Bienservida;1203;625;578
02;Albacete;017;Bogarra;1692;897;795
02;Albacete;018;Bonete;1297;650;647
02;Albacete;019;Bonillo (El);3340;1658;1682
02;Albacete;020;Carcelén;846;417;429
02;Albacete;021;Casas de Juan Núñez;1347;686;661
02;Albacete;022;Casas de Lázaro;561;293;268
02;Albacete;023;Casas de Ves;1220;616;604
02;Albacete;024;Casas-Ibáñez;3931;1970;1961
02;Albacete;025;Caudete;8533;4262;4271
02;Albacete;026;Cenizate;1096;559;537
02;Albacete;029;Chinchilla de Monte-Aragón;3553;1845;1708
02;Albacete;027;Corral-Rubio;548;285;263
02;Albacete;028;Cotillas;287;146;141
02;Albacete;030;Elche de la Sierra;4024;1969;2055
02;Albacete;032;Fuensanta;435;216;219
02;Albacete;033;Fuente-Álamo;2538;1290;1248
02;Albacete;034;Fuentealbilla;1874;958;916
02;Albacete;031;Férez;953;473;480
02;Albacete;035;Gineta (La);2334;1126;1208
02;Albacete;036;Golosalvo;146;69;77
02;Albacete;037;Hellín;25094;12377;12717
02;Albacete;038;Herrera (La);493;259;234
02;Albacete;039;Higueruela;1368;680;688
02;Albacete;040;Hoya-Gonzalo;818;422;396
02;Albacete;041;Jorquera;774;399;375
02;Albacete;042;Letur;1733;887;846
02;Albacete;043;Lezuza;2175;1112;1063
02;Albacete;044;Liétor;2012;1038;974
02;Albacete;045;Madrigueras;4513;2270;2243
02;Albacete;046;Mahora;1471;722;749
02;Albacete;047;Masegoso;371;202;169
02;Albacete;048;Minaya;2034;1028;1006
02;Albacete;049;Molinicos;1869;963;906
02;Albacete;050;Montalvos;167;86;81
02;Albacete;051;Montealegre del Castillo;2183;1090;1093
02;Albacete;052;Motilleja;584;290;294
02;Albacete;053;Munera;4301;2201;2100
02;Albacete;054;Navas de Jorquera;610;315;295
02;Albacete;055;Nerpio;2291;1207;1084
02;Albacete;056;Ontur;2774;1351;1423
02;Albacete;057;Ossa de Montiel;2894;1465;1429
02;Albacete;058;Paterna del Madera;708;374;334
02;Albacete;060;Peñas de San Pedro;1480;772;708
02;Albacete;059;Peñascosa;539;282;257
02;Albacete;061;Pétrola;1173;591;582
02;Albacete;062;Povedilla;795;412;383
02;Albacete;064;Pozo-Lorente;540;263;277
02;Albacete;063;Pozohondo;2147;1094;1053
02;Albacete;065;Pozuelo;745;372;373
02;Albacete;066;Recueja (La);454;226;228
02;Albacete;067;Riópar;1449;732;717
02;Albacete;068;Robledo;488;263;225
02;Albacete;069;Roda (La);12982;6501;6481
02;Albacete;070;Salobre;717;374;343
02;Albacete;071;San Pedro;1409;724;685
02;Albacete;072;Socovos;2339;1180;1159
02;Albacete;073;Tarazona de la Mancha;6053;3040;3013
02;Albacete;074;Tobarra;7685;3806;3879
02;Albacete;075;Valdeganga;2340;1177;1163
02;Albacete;076;Vianos;565;291;274
02;Albacete;077;Villa de Ves;44;23;21
02;Albacete;078;Villalgordo del Júcar;1329;655;674
02;Albacete;079;Villamalea;3437;1800;1637
02;Albacete;080;Villapalacios;1057;522;535
02;Albacete;081;Villarrobledo;21395;10558;10837
02;Albacete;082;Villatoya;228;125;103
02;Albacete;083;Villavaliente;355;183;172
02;Albacete;084;Villaverde de Guadalimar;719;390;329
02;Albacete;085;Viveros;676;352;324
02;Albacete;086;Yeste;5165;2675;2490
03;Alicante/Alacant;001;Adsubia;549;276;273
03;Alicante/Alacant;002;Agost;3893;1953;1940
03;Alicante/Alacant;003;Agres;701;365;336
03;Alicante/Alacant;004;Aigües;373;183;190
03;Alicante/Alacant;005;Albatera;9112;4593;4519
03;Alicante/Alacant;006;Alcalalí;645;327;318
03;Alicante/Alacant;007;Alcocer de Planes;112;53;59
03;Alicante/Alacant;008;Alcoleja;329;151;178
03;Alicante/Alacant;009;Alcoy/Alcoi;65082;31428;33654
03;Alicante/Alacant;010;Alfafara;387;187;200
03;Alicante/Alacant;011;Alfàs del Pi (L');8129;3969;4160
03;Alicante/Alacant;012;Algorfa;1122;567;555
03;Alicante/Alacant;013;Algueña;1527;745;782
03;Alicante/Alacant;014;Alicante/Alacant;267485;129382;138103
03;Alicante/Alacant;015;Almoradí;14674;7405;7269
03;Alicante/Alacant;016;Almudaina;139;66;73
03;Alicante/Alacant;017;Alquería d'Asnar (L');396;198;198
03;Alicante/Alacant;018;Altea;12844;6361;6483
03;Alicante/Alacant;019;Aspe;16008;7935;8073
03;Alicante/Alacant;020;Balones;169;73;96
03;Alicante/Alacant;021;Banyeres de Mariola;7085;3518;3567
03;Alicante/Alacant;022;Benasau;222;107;115
03;Alicante/Alacant;023;Beneixama;1850;918;932
03;Alicante/Alacant;024;Benejúzar;4607;2293;2314
03;Alicante/Alacant;025;Benferri;967;485;482
03;Alicante/Alacant;026;Beniarbeig;1193;587;606
03;Alicante/Alacant;027;Beniardá;249;117;132
03;Alicante/Alacant;028;Beniarrés;1554;773;781
03;Alicante/Alacant;030;Benidoleig;789;374;415
03;Alicante/Alacant;031;Benidorm;41556;20711;20845
03;Alicante/Alacant;032;Benifallim;190;94;96
03;Alicante/Alacant;033;Benifato;128;67;61
03;Alicante/Alacant;029;Benigembla;365;182;183
03;Alicante/Alacant;034;Benijófar;1465;687;778
03;Alicante/Alacant;035;Benilloba;948;484;464
03;Alicante/Alacant;036;Benillup;77;40;37
03;Alicante/Alacant;037;Benimantell;431;205;226
03;Alicante/Alacant;038;Benimarfull;418;194;224
03;Alicante/Alacant;039;Benimassot;111;54;57
03;Alicante/Alacant;040;Benimeli;337;167;170
03;Alicante/Alacant;041;Benissa;7841;3891;3950
03;Alicante/Alacant;042;Benitachell/Poble Nou de Benitatxell (el);1622;811;811
03;Alicante/Alacant;043;Biar;3412;1649;1763
03;Alicante/Alacant;044;Bigastro;4448;2270;2178
03;Alicante/Alacant;045;Bolulla;271;132;139
03;Alicante/Alacant;046;Busot;817;405;412
03;Alicante/Alacant;048;Callosa d'En Sarrià;7947;3930;4017
03;Alicante/Alacant;049;Callosa de Segura;15486;7754;7732
03;Alicante/Alacant;047;Calpe/Calp;11896;5928;5968
03;Alicante/Alacant;050;Campello (El);10871;5383;5488
03;Alicante/Alacant;051;Campo de Mirra/Camp de Mirra (el);396;193;203
03;Alicante/Alacant;053;Castalla;7192;3549;3643
03;Alicante/Alacant;054;Castell de Castells;562;282;280
03;Alicante/Alacant;055;Catral;4525;2269;2256
03;Alicante/Alacant;052;Cañada;1058;512;546
03;Alicante/Alacant;056;Cocentaina;10540;5163;5377
03;Alicante/Alacant;057;Confrides;310;171;139
03;Alicante/Alacant;058;Cox;5502;2800;2702
03;Alicante/Alacant;059;Crevillent;22456;11358;11098
03;Alicante/Alacant;061;Daya Nueva;1235;611;624
03;Alicante/Alacant;062;Daya Vieja;241;117;124
03;Alicante/Alacant;064;Dolores;5884;2933;2951
03;Alicante/Alacant;063;Dénia;25803;12680;13123
03;Alicante/Alacant;065;Elche/Elx;184912;91637;93275
03;Alicante/Alacant;066;Elda;57515;28180;29335
03;Alicante/Alacant;067;Facheca;141;72;69
03;Alicante/Alacant;068;Famorca;74;30;44
03;Alicante/Alacant;069;Finestrat;1215;607;608
03;Alicante/Alacant;070;Formentera del Segura;1971;973;998
03;Alicante/Alacant;072;Gaianes;330;157;173
03;Alicante/Alacant;071;Gata de Gorgos;5096;2545;2551
03;Alicante/Alacant;073;Gorga;300;151;149
03;Alicante/Alacant;074;Granja de Rocamora;1922;980;942
03;Alicante/Alacant;075;Guadalest;170;89;81
03;Alicante/Alacant;076;Guardamar del Segura;6613;3224;3389
03;Alicante/Alacant;077;Hondón de las Nieves;1517;755;762
03;Alicante/Alacant;078;Hondón de los Frailes;554;280;274
03;Alicante/Alacant;079;Ibi;21007;10435;10572
03;Alicante/Alacant;080;Jacarilla;1428;716;712
03;Alicante/Alacant;081;Jalón/Xaló;1823;893;930
03;Alicante/Alacant;083;Jijona/Xixona;7690;3647;4043
03;Alicante/Alacant;082;Jávea/Xàbia;15036;7427;7609
03;Alicante/Alacant;085;Llíber;471;234;237
03;Alicante/Alacant;084;Lorcha/Orxa (L');882;442;440
03;Alicante/Alacant;086;Millena;132;66;66
03;Alicante/Alacant;088;Monforte del Cid;4943;2548;2395
03;Alicante/Alacant;903;Montesinos (Los);"";"";""
03;Alicante/Alacant;089;Monóvar/Monòver;12122;5882;6240
03;Alicante/Alacant;091;Murla;348;149;199
03;Alicante/Alacant;092;Muro de Alcoy;6476;3233;3243
03;Alicante/Alacant;090;Mutxamel;9359;4713;4646
03;Alicante/Alacant;093;Novelda;22288;10954;11334
03;Alicante/Alacant;094;Nucia (la);5931;2943;2988
03;Alicante/Alacant;095;Ondara;4793;2352;2441
03;Alicante/Alacant;096;Onil;6708;3356;3352
03;Alicante/Alacant;097;Orba;1531;729;802
03;Alicante/Alacant;099;Orihuela;46471;22768;23703
03;Alicante/Alacant;098;Orxeta;490;240;250
03;Alicante/Alacant;100;Parcent;668;335;333
03;Alicante/Alacant;101;Pedreguer;5687;2767;2920
03;Alicante/Alacant;102;Pego;9390;4666;4724
03;Alicante/Alacant;103;Penàguila;381;187;194
03;Alicante/Alacant;104;Petrer;23591;11786;11805
03;Alicante/Alacant;902;Pilar de la Horadada;7505;3799;3706
03;Alicante/Alacant;105;Pinoso;5674;2830;2844
03;Alicante/Alacant;106;Planes;815;407;408
03;Alicante/Alacant;901;Poblets (Els);1200;581;619
03;Alicante/Alacant;107;Polop;2072;1012;1060
03;Alicante/Alacant;060;Quatretondeta;218;104;114
03;Alicante/Alacant;109;Rafal;2652;1320;1332
03;Alicante/Alacant;111;Redován;4965;2530;2435
03;Alicante/Alacant;112;Relleu;822;412;410
03;Alicante/Alacant;113;Rojales;5379;2707;2672
03;Alicante/Alacant;114;Romana (La);1971;1005;966
03;Alicante/Alacant;110;Ràfol d'Almúnia (El);365;177;188
03;Alicante/Alacant;115;Sagra;379;183;196
03;Alicante/Alacant;116;Salinas;1096;574;522
03;Alicante/Alacant;118;San Fulgencio;1652;831;821
03;Alicante/Alacant;904;San Isidro;"";"";""
03;Alicante/Alacant;120;San Miguel de Salinas;2511;1287;1224
03;Alicante/Alacant;122;San Vicente del Raspeig/Sant Vicent del Raspeig;28151;13985;14166
03;Alicante/Alacant;117;Sanet y Negrals;546;244;302
03;Alicante/Alacant;119;Sant Joan d'Alacant;13581;6707;6874
03;Alicante/Alacant;121;Santa Pola;14725;7337;7388
03;Alicante/Alacant;123;Sax;8309;4155;4154
03;Alicante/Alacant;124;Sella;596;306;290
03;Alicante/Alacant;125;Senija;438;222;216
03;Alicante/Alacant;128;Teulada;5599;2730;2869
03;Alicante/Alacant;129;Tibi;1051;533;518
03;Alicante/Alacant;130;Tollos;50;30;20
03;Alicante/Alacant;131;Tormos;258;135;123
03;Alicante/Alacant;132;Torremanzanas/Torre de les Maçanes (la);752;358;394
03;Alicante/Alacant;133;Torrevieja;23192;11370;11822
03;Alicante/Alacant;127;Tárbena;699;359;340
03;Alicante/Alacant;134;Vall d'Alcalà (La);161;77;84
03;Alicante/Alacant;135;Vall de Ebo;368;188;180
03;Alicante/Alacant;136;Vall de Gallinera;763;383;380
03;Alicante/Alacant;137;Vall de Laguar (La);992;492;500
03;Alicante/Alacant;138;Verger (El);3692;1797;1895
03;Alicante/Alacant;139;Villajoyosa/Vila Joiosa (La);23517;11609;11908
03;Alicante/Alacant;140;Villena;31037;15367;15670
04;Almería;001;Abla;1706;833;873
04;Almería;002;Abrucena;1557;772;785
04;Almería;003;Adra;20308;10146;10162
04;Almería;004;Albánchez;803;391;412
04;Almería;005;Alboloduy;954;443;511
04;Almería;006;Albox;10651;5391;5260
04;Almería;007;Alcolea;858;432;426
04;Almería;008;Alcóntar;678;349;329
04;Almería;009;Alcudia de Monteagud;213;94;119
04;Almería;010;Alhabia;849;423;426
04;Almería;011;Alhama de Almería;3088;1545;1543
04;Almería;012;Alicún;247;109;138
04;Almería;013;Almería;161566;78518;83048
04;Almería;014;Almócita;214;107;107
04;Almería;015;Alsodux;126;55;71
04;Almería;016;Antas;2580;1285;1295
04;Almería;017;Arboleas;1527;746;781
04;Almería;018;Armuña de Almanzora;375;181;194
04;Almería;019;Bacares;334;182;152
04;Almería;020;Bayárcal;435;232;203
04;Almería;021;Bayarque;258;125;133
04;Almería;022;Bédar;533;285;248
04;Almería;023;Beires;167;77;90
04;Almería;024;Benahadux;2171;1050;1121
04;Almería;026;Benitagla;117;57;60
04;Almería;027;Benizalón;399;205;194
04;Almería;028;Bentarique;376;191;185
04;Almería;029;Berja;12107;5974;6133
04;Almería;030;Canjáyar;2029;1012;1017
04;Almería;031;Cantoria;3374;1693;1681
04;Almería;032;Carboneras;6190;3218;2972
04;Almería;033;Castro de Filabres;147;71;76
04;Almería;036;Chercos;335;167;168
04;Almería;037;Chirivel;2062;1036;1026
04;Almería;034;Cóbdar;284;147;137
04;Almería;035;Cuevas del Almanzora;9204;4586;4618
04;Almería;038;Dalías;3616;1785;1831
04;Almería;039;Darrical;398;199;199
04;Almería;902;Ejido (El);41080;20875;20205
04;Almería;041;Enix;244;113;131
04;Almería;043;Felix;665;307;358
04;Almería;044;Fines;1596;804;792
04;Almería;045;Fiñana;2710;1306;1404
04;Almería;046;Fondón;1007;512;495
04;Almería;047;Gádor;2564;1241;1323
04;Almería;048;Gallardos (Los);1705;871;834
04;Almería;049;Garrucha;4149;2119;2030
04;Almería;050;Gérgal;1190;581;609
04;Almería;051;Huécija;583;287;296
04;Almería;052;Huércal de Almería;3961;1953;2008
04;Almería;053;Huércal-Overa;13277;6542;6735
04;Almería;054;Illar;525;240;285
04;Almería;055;Instinción;648;317;331
04;Almería;056;Laroya;153;83;70
04;Almería;057;Láujar de Andarax;1848;905;943
04;Almería;058;Líjar;567;283;284
04;Almería;059;Lubrín;2179;1061;1118
04;Almería;060;Lucainena de las Torres;635;312;323
04;Almería;061;Lúcar;804;405;399
04;Almería;062;Macael;5830;2949;2881
04;Almería;063;María;1852;949;903
04;Almería;064;Mojácar;3982;1995;1987
04;Almería;903;Mojonera (La);5595;2838;2757
04;Almería;065;Nacimiento;540;267;273
04;Almería;066;Níjar;13093;6703;6390
04;Almería;067;Ohanes;905;456;449
04;Almería;068;Olula de Castro;234;126;108
04;Almería;069;Olula del Río;5371;2704;2667
04;Almería;070;Oria;2617;1325;1292
04;Almería;071;Padules;562;295;267
04;Almería;072;Partaloa;453;224;229
04;Almería;073;Paterna del Río;402;198;204
04;Almería;074;Pechina;2175;1081;1094
04;Almería;075;Pulpí;4650;2323;2327
04;Almería;076;Purchena;1829;916;913
04;Almería;077;Rágol;466;230;236
04;Almería;078;Rioja;1174;575;599
04;Almería;079;Roquetas de Mar;28129;14128;14001
04;Almería;080;Santa Cruz de Marchena;253;119;134
04;Almería;081;Santa Fe de Mondújar;425;210;215
04;Almería;082;Senés;472;243;229
04;Almería;083;Serón;3160;1583;1577
04;Almería;084;Sierro;694;357;337
04;Almería;085;Somontín;553;283;270
04;Almería;086;Sorbas;3074;1563;1511
04;Almería;087;Suflí;265;138;127
04;Almería;088;Tabernas;3171;1578;1593
04;Almería;089;Taberno;1016;495;521
04;Almería;090;Tahal;561;277;284
04;Almería;091;Terque;499;244;255
04;Almería;092;Tíjola;3527;1790;1737
04;Almería;901;Tres Villas (Las);735;393;342
04;Almería;093;Turre;2181;1061;1120
04;Almería;094;Turrillas;280;150;130
04;Almería;095;Uleila del Campo;1033;519;514
04;Almería;096;Urrácal;379;185;194
04;Almería;097;Velefique;428;217;211
04;Almería;098;Vélez-Blanco;2479;1259;1220
04;Almería;099;Vélez-Rubio;6717;3267;3450
04;Almería;100;Vera;6052;2956;3096
04;Almería;101;Viator;2743;1359;1384
04;Almería;102;Vícar;11326;5813;5513
04;Almería;103;Zurgena;2164;1065;1099
05;Ávila;001;Adanero;410;222;188
05;Ávila;002;Adrada (La);1900;981;919
05;Ávila;005;Albornos;302;158;144
05;Ávila;007;Aldeanueva de Santa Cruz;241;127;114
05;Ávila;008;Aldeaseca;427;210;217
05;Ávila;010;Aldehuela (La);316;164;152
05;Ávila;012;Amavida;225;111;114
05;Ávila;013;Arenal (El);1154;580;574
05;Ávila;014;Arenas de San Pedro;6821;3446;3375
05;Ávila;015;Arevalillo;205;98;107
05;Ávila;016;Arévalo;7284;3538;3746
05;Ávila;017;Aveinte;172;83;89
05;Ávila;018;Avellaneda;70;31;39
05;Ávila;019;Ávila;46992;22778;24214
05;Ávila;021;Barco de Ávila (El);2672;1326;1346
05;Ávila;022;Barraco (El);2201;1121;1080
05;Ávila;023;Barromán;336;177;159
05;Ávila;024;Becedas;655;325;330
05;Ávila;025;Becedillas;225;119;106
05;Ávila;026;Bercial de Zapardiel;380;189;191
05;Ávila;027;Berlanas (Las);428;209;219
05;Ávila;029;Bernuy-Zapardiel;315;167;148
05;Ávila;030;Berrocalejo de Aragona;37;17;20
05;Ávila;033;Blascomillán;396;189;207
05;Ávila;034;Blasconuño de Matacabras;33;17;16
05;Ávila;035;Blascosancho;195;104;91
05;Ávila;036;Bohodón (El);236;124;112
05;Ávila;037;Bohoyo;612;333;279
05;Ávila;038;Bonilla de la Sierra;274;147;127
05;Ávila;039;Brabos;88;47;41
05;Ávila;040;Bularros;159;86;73
05;Ávila;041;Burgohondo;1444;735;709
05;Ávila;042;Cabezas de Alambre;313;163;150
05;Ávila;043;Cabezas del Pozo;253;126;127
05;Ávila;044;Cabezas del Villar;656;357;299
05;Ávila;045;Cabizuela;175;87;88
05;Ávila;046;Canales;100;49;51
05;Ávila;047;Candeleda;5392;2766;2626
05;Ávila;048;Cantiveros;259;131;128
05;Ávila;049;Cardeñosa;624;331;293
05;Ávila;051;Carrera (La);375;184;191
05;Ávila;052;Casas del Puerto de Villatoro;142;79;63
05;Ávila;053;Casasola;240;122;118
05;Ávila;054;Casavieja;1697;863;834
05;Ávila;055;Casillas;1024;519;505
05;Ávila;056;Castellanos de Zapardiel;192;113;79
05;Ávila;057;Cebreros;3426;1719;1707
05;Ávila;058;Cepeda la Mora;192;100;92
05;Ávila;067;Chamartín;136;75;61
05;Ávila;059;Cillán;180;87;93
05;Ávila;060;Cisla;264;131;133
05;Ávila;061;Colilla (La);237;117;120
05;Ávila;062;Collado de Contreras;354;186;168
05;Ávila;063;Collado del Mirón;132;68;64
05;Ávila;064;Constanzana;231;126;105
05;Ávila;065;Crespos;843;441;402
05;Ávila;066;Cuevas del Valle;703;372;331
05;Ávila;903;Diego del Carpio;447;240;207
05;Ávila;069;Donjimeno;173;88;85
05;Ávila;070;Donvidas;97;48;49
05;Ávila;072;Espinosa de los Caballeros;136;74;62
05;Ávila;073;Flores de Ávila;544;286;258
05;Ávila;074;Fontíveros;1184;605;579
05;Ávila;075;Fresnedilla;157;74;83
05;Ávila;076;Fresno (El);441;223;218
05;Ávila;077;Fuente el Saúz;402;196;206
05;Ávila;078;Fuentes de Año;268;140;128
05;Ávila;079;Gallegos de Altamiros;139;76;63
05;Ávila;080;Gallegos de Sobrinos;133;64;69
05;Ávila;081;Garganta del Villar;114;65;49
05;Ávila;082;Gavilanes;840;440;400
05;Ávila;083;Gemuño;290;140;150
05;Ávila;085;Gil García;107;52;55
05;Ávila;084;Gilbuena;224;121;103
05;Ávila;086;Gimialcón;163;85;78
05;Ávila;087;Gotarrendura;215;76;139
05;Ávila;088;Grandes y San Martín;84;40;44
05;Ávila;089;Guisando;795;406;389
05;Ávila;090;Gutierre-Muñoz;152;73;79
05;Ávila;092;Hernansancho;260;131;129
05;Ávila;093;Herradón de Pinares;516;264;252
05;Ávila;094;Herreros de Suso;382;186;196
05;Ávila;095;Higuera de las Dueñas;332;176;156
05;Ávila;096;Hija de Dios (La);173;93;80
05;Ávila;097;Horcajada (La);1066;532;534
05;Ávila;099;Horcajo de las Torres;1000;548;452
05;Ávila;100;Hornillo (El);566;277;289
05;Ávila;102;Hoyo de Pinares (El);2715;1376;1339
05;Ávila;101;Hoyocasero;501;267;234
05;Ávila;103;Hoyorredondo;192;92;100
05;Ávila;106;Hoyos de Miguel Muñoz;85;47;38
05;Ávila;104;Hoyos del Collado;56;36;20
05;Ávila;105;Hoyos del Espino;427;220;207
05;Ávila;107;Hurtumpascual;181;93;88
05;Ávila;108;Junciana;111;56;55
05;Ávila;109;Langa;641;336;305
05;Ávila;110;Lanzahíta;1000;507;493
05;Ávila;113;Llanos de Tormes (Los);193;101;92
05;Ávila;112;Losar del Barco (El);223;123;100
05;Ávila;114;Madrigal de las Altas Torres;2279;1179;1100
05;Ávila;115;Maello;718;364;354
05;Ávila;116;Malpartida de Corneja;314;154;160
05;Ávila;117;Mamblas;346;182;164
05;Ávila;118;Mancera de Arriba;230;119;111
05;Ávila;119;Manjabálago;122;64;58
05;Ávila;120;Marlín;48;25;23
05;Ávila;121;Martiherrero;230;117;113
05;Ávila;122;Martínez;303;159;144
05;Ávila;123;Mediana de Voltoya;120;66;54
05;Ávila;124;Medinilla;349;173;176
05;Ávila;125;Mengamuñoz;85;41;44
05;Ávila;126;Mesegar de Corneja;152;72;80
05;Ávila;127;Mijares;1156;594;562
05;Ávila;128;Mingorría;588;297;291
05;Ávila;129;Mirón (El);385;204;181
05;Ávila;130;Mironcillo;149;86;63
05;Ávila;131;Mirueña de los Infanzones;286;136;150
05;Ávila;132;Mombeltrán;1337;712;625
05;Ávila;133;Monsalupe;136;67;69
05;Ávila;134;Moraleja de Matacabras;93;44;49
05;Ávila;135;Muñana;675;355;320
05;Ávila;136;Muñico;201;108;93
05;Ávila;138;Muñogalindo;470;254;216
05;Ávila;139;Muñogrande;120;63;57
05;Ávila;140;Muñomer del Peco;153;85;68
05;Ávila;141;Muñopepe;116;56;60
05;Ávila;142;Muñosancho;221;103;118
05;Ávila;143;Muñotello;173;95;78
05;Ávila;144;Narrillos del Álamo;195;102;93
05;Ávila;145;Narrillos del Rebollar;109;56;53
05;Ávila;149;Narros de Saldueña;253;134;119
05;Ávila;147;Narros del Castillo;350;187;163
05;Ávila;148;Narros del Puerto;65;36;29
05;Ávila;152;Nava de Arévalo;1218;636;582
05;Ávila;153;Nava del Barco;258;123;135
05;Ávila;151;Navacepedilla de Corneja;179;93;86
05;Ávila;154;Navadijos;98;53;45
05;Ávila;155;Navaescurial;133;76;57
05;Ávila;156;Navahondilla;170;74;96
05;Ávila;157;Navalacruz;385;192;193
05;Ávila;158;Navalmoral;747;376;371
05;Ávila;159;Navalonguilla;595;300;295
05;Ávila;160;Navalosa;620;313;307
05;Ávila;161;Navalperal de Pinares;993;482;511
05;Ávila;162;Navalperal de Tormes;194;95;99
05;Ávila;163;Navaluenga;2114;1073;1041
05;Ávila;164;Navaquesera;128;66;62
05;Ávila;165;Navarredonda de Gredos;542;278;264
05;Ávila;166;Navarredondilla;349;169;180
05;Ávila;167;Navarrevisca;451;237;214
05;Ávila;168;Navas del Marqués (Las);4215;2125;2090
05;Ávila;169;Navatalgordo;1204;619;585
05;Ávila;170;Navatejares;196;92;104
05;Ávila;171;Neila de San Miguel;170;91;79
05;Ávila;172;Niharra;233;117;116
05;Ávila;173;Ojos-Albos;43;21;22
05;Ávila;174;Orbita;118;64;54
05;Ávila;175;Oso (El);277;148;129
05;Ávila;176;Padiernos;324;175;149
05;Ávila;177;Pajares de Adaja;241;125;116
05;Ávila;178;Palacios de Goda;621;294;327
05;Ávila;179;Papatrigo;403;200;203
05;Ávila;180;Parral (El);192;96;96
05;Ávila;181;Pascualcobo;74;37;37
05;Ávila;182;Pedro Bernardo;1870;962;908
05;Ávila;183;Pedro-Rodríguez;260;125;135
05;Ávila;184;Peguerinos;421;218;203
05;Ávila;185;Peñalba de Ávila;158;89;69
05;Ávila;186;Piedrahíta;2418;1181;1237
05;Ávila;187;Piedralaves;2183;1088;1095
05;Ávila;188;Poveda;113;59;54
05;Ávila;189;Poyales del Hoyo;883;446;437
05;Ávila;190;Pozanco;81;46;35
05;Ávila;191;Pradosegar;222;117;105
05;Ávila;192;Puerto Castilla;196;91;105
05;Ávila;193;Rasueros;491;257;234
05;Ávila;194;Riocabado;241;137;104
05;Ávila;195;Riofrío;407;221;186
05;Ávila;196;Rivilla de Barajas;126;70;56
05;Ávila;197;Salobral;144;72;72
05;Ávila;198;Salvadiós;155;83;72
05;Ávila;199;San Bartolomé de Béjar;128;55;73
05;Ávila;200;San Bartolomé de Corneja;173;89;84
05;Ávila;201;San Bartolomé de Pinares;841;452;389
05;Ávila;206;San Esteban de los Patos;63;34;29
05;Ávila;208;San Esteban de Zapardiel;124;59;65
05;Ávila;207;San Esteban del Valle;1129;573;556
05;Ávila;209;San García de Ingelmos;226;117;109
05;Ávila;901;San Juan de Gredos;549;277;272
05;Ávila;210;San Juan de la Encinilla;178;81;97
05;Ávila;211;San Juan de la Nava;786;408;378
05;Ávila;212;San Juan del Molinillo;617;326;291
05;Ávila;213;San Juan del Olmo;241;125;116
05;Ávila;214;San Lorenzo de Tormes;93;43;50
05;Ávila;215;San Martín de la Vega del Alberche;377;212;165
05;Ávila;216;San Martín del Pimpollar;327;169;158
05;Ávila;217;San Miguel de Corneja;139;70;69
05;Ávila;218;San Miguel de Serrezuela;287;149;138
05;Ávila;219;San Pascual;76;38;38
05;Ávila;220;San Pedro del Arroyo;556;292;264
05;Ávila;231;San Vicente de Arévalo;260;131;129
05;Ávila;204;Sanchidrián;869;433;436
05;Ávila;205;Sanchorreja;156;83;73
05;Ávila;222;Santa Cruz de Pinares;260;150;110
05;Ávila;221;Santa Cruz del Valle;749;365;384
05;Ávila;226;Santa María de los Caballeros;237;118;119
05;Ávila;224;Santa María del Arroyo;166;80;86
05;Ávila;225;Santa María del Berrocal;771;376;395
05;Ávila;902;Santa María del Cubillo;467;255;212
05;Ávila;227;Santa María del Tiétar;378;192;186
05;Ávila;228;Santiago del Collado;362;212;150
05;Ávila;904;Santiago del Tormes;440;222;218
05;Ávila;229;Santo Domingo de las Posadas;111;54;57
05;Ávila;230;Santo Tomé de Zabarcos;148;80;68
05;Ávila;232;Serrada (La);156;82;74
05;Ávila;233;Serranillos;570;301;269
05;Ávila;234;Sigeres;95;42;53
05;Ávila;235;Sinlabajos;302;155;147
05;Ávila;236;Solana de Ávila;336;176;160
05;Ávila;237;Solana de Rioalmar;374;198;176
05;Ávila;238;Solosancho;1340;692;648
05;Ávila;239;Sotalbo;305;161;144
05;Ávila;240;Sotillo de la Adrada;3433;1735;1698
05;Ávila;241;Tiemblo (El);3849;1919;1930
05;Ávila;242;Tiñosillos;787;414;373
05;Ávila;243;Tolbaños;202;102;100
05;Ávila;244;Tormellas;148;74;74
05;Ávila;245;Tornadizos de Ávila;348;170;178
05;Ávila;247;Torre (La);571;303;268
05;Ávila;246;Tórtoles;182;98;84
05;Ávila;249;Umbrías;224;110;114
05;Ávila;251;Vadillo de la Sierra;223;133;90
05;Ávila;252;Valdecasa;156;80;76
05;Ávila;253;Vega de Santa María;166;90;76
05;Ávila;254;Velayos;347;172;175
05;Ávila;256;Villaflor;210;107;103
05;Ávila;257;Villafranca de la Sierra;289;155;134
05;Ávila;905;Villanueva de Ávila;"";"";""
05;Ávila;258;Villanueva de Gómez;202;96;106
05;Ávila;259;Villanueva del Aceral;259;123;136
05;Ávila;260;Villanueva del Campillo;276;143;133
05;Ávila;261;Villar de Corneja;125;59;66
05;Ávila;262;Villarejo del Valle;521;266;255
05;Ávila;263;Villatoro;281;149;132
05;Ávila;264;Viñegra de Moraña;101;56;45
05;Ávila;265;Vita;139;77;62
05;Ávila;266;Zapardiel de la Cañada;262;131;131
05;Ávila;267;Zapardiel de la Ribera;164;86;78
06;Badajoz;001;Acedera;1088;583;505
06;Badajoz;002;Aceuchal;5168;2581;2587
06;Badajoz;003;Ahillones;1389;686;703
06;Badajoz;004;Alange;2044;1062;982
06;Badajoz;005;Albuera (La);1792;910;882
06;Badajoz;006;Alburquerque;5548;2825;2723
06;Badajoz;007;Alconchel;2719;1355;1364
06;Badajoz;008;Alconera;847;437;410
06;Badajoz;009;Aljucén;217;122;95
06;Badajoz;010;Almendral;1557;767;790
06;Badajoz;011;Almendralejo;25485;12421;13064
06;Badajoz;012;Arroyo de San Serván;3819;1954;1865
06;Badajoz;013;Atalaya;379;188;191
06;Badajoz;014;Azuaga;10229;5049;5180
06;Badajoz;015;Badajoz;126781;61500;65281
06;Badajoz;016;Barcarrota;4284;2147;2137
06;Badajoz;017;Baterno;466;235;231
06;Badajoz;018;Benquerencia de la Serena;1356;677;679
06;Badajoz;019;Berlanga;2972;1486;1486
06;Badajoz;020;Bienvenida;2655;1330;1325
06;Badajoz;021;Bodonal de la Sierra;1560;781;779
06;Badajoz;022;Burguillos del Cerro;3371;1658;1713
06;Badajoz;023;Cabeza del Buey;6733;3307;3426
06;Badajoz;024;Cabeza la Vaca;1874;925;949
06;Badajoz;025;Calamonte;5561;2764;2797
06;Badajoz;026;Calera de León;1214;619;595
06;Badajoz;027;Calzadilla de los Barros;861;429;432
06;Badajoz;028;Campanario;6112;2945;3167
06;Badajoz;029;Campillo de Llerena;1843;924;919
06;Badajoz;030;Capilla;261;123;138
06;Badajoz;031;Carmonita;773;408;365
06;Badajoz;032;Carrascalejo (El);27;14;13
06;Badajoz;033;Casas de Don Pedro;1903;916;987
06;Badajoz;034;Casas de Reina;337;152;185
06;Badajoz;035;Castilblanco;1695;846;849
06;Badajoz;036;Castuera;8287;4114;4173
06;Badajoz;042;Cheles;1442;728;714
06;Badajoz;037;Codosera (La);2787;1439;1348
06;Badajoz;038;Cordobilla de Lácara;1100;570;530
06;Badajoz;039;Coronada (La);2658;1334;1324
06;Badajoz;040;Corte de Peleas;1332;683;649
06;Badajoz;041;Cristina;556;296;260
06;Badajoz;043;Don Álvaro;601;301;300
06;Badajoz;044;Don Benito;29659;14889;14770
06;Badajoz;045;Entrín Bajo;696;341;355
06;Badajoz;046;Esparragalejo;1403;715;688
06;Badajoz;047;Esparragosa de la Serena;1196;595;601
06;Badajoz;048;Esparragosa de Lares;1393;681;712
06;Badajoz;049;Feria;1666;818;848
06;Badajoz;050;Fregenal de la Sierra;5965;2877;3088
06;Badajoz;051;Fuenlabrada de los Montes;2262;1119;1143
06;Badajoz;052;Fuente de Cantos;5180;2604;2576
06;Badajoz;053;Fuente del Arco;1006;506;500
06;Badajoz;054;Fuente del Maestre;6984;3493;3491
06;Badajoz;055;Fuentes de León;3008;1428;1580
06;Badajoz;056;Garbayuela;626;326;300
06;Badajoz;057;Garlitos;935;467;468
06;Badajoz;058;Garrovilla (La);2723;1414;1309
06;Badajoz;059;Granja de Torrehermosa;2928;1446;1482
06;Badajoz;060;Guareña;7749;3894;3855
06;Badajoz;061;Haba (La);1876;910;966
06;Badajoz;062;Helechosa de los Montes;943;488;455
06;Badajoz;063;Herrera del Duque;4219;2100;2119
06;Badajoz;064;Higuera de la Serena;1372;682;690
06;Badajoz;065;Higuera de Llerena;647;303;344
06;Badajoz;066;Higuera de Vargas;3073;1537;1536
06;Badajoz;067;Higuera la Real;2889;1456;1433
06;Badajoz;068;Hinojosa del Valle;739;395;344
06;Badajoz;069;Hornachos;4123;2104;2019
06;Badajoz;070;Jerez de los Caballeros;9318;4647;4671
06;Badajoz;071;Lapa (La);380;189;191
06;Badajoz;073;Llera;1128;572;556
06;Badajoz;074;Llerena;5771;2775;2996
06;Badajoz;072;Lobón;2755;1435;1320
06;Badajoz;075;Magacela;956;498;458
06;Badajoz;076;Maguilla;1391;700;691
06;Badajoz;077;Malcocinado;714;378;336
06;Badajoz;078;Malpartida de la Serena;1061;534;527
06;Badajoz;079;Manchita;780;408;372
06;Badajoz;080;Medellín;2604;1329;1275
06;Badajoz;081;Medina de las Torres;1973;979;994
06;Badajoz;082;Mengabril;536;274;262
06;Badajoz;083;Mérida;53732;26153;27579
06;Badajoz;084;Mirandilla;1365;691;674
06;Badajoz;085;Monesterio;5224;2602;2622
06;Badajoz;086;Montemolín;1986;990;996
06;Badajoz;087;Monterrubio de la Serena;3635;1774;1861
06;Badajoz;088;Montijo;15083;7407;7676
06;Badajoz;089;Morera (La);815;408;407
06;Badajoz;090;Nava de Santiago (La);1245;620;625
06;Badajoz;091;Navalvillar de Pela;5219;2629;2590
06;Badajoz;092;Nogales;811;418;393
06;Badajoz;093;Oliva de la Frontera;7002;3430;3572
06;Badajoz;094;Oliva de Mérida;2303;1150;1153
06;Badajoz;095;Olivenza;10545;5194;5351
06;Badajoz;096;Orellana de la Sierra;503;251;252
06;Badajoz;097;Orellana la Vieja;4298;2160;2138
06;Badajoz;098;Palomas;716;372;344
06;Badajoz;099;Parra (La);1445;747;698
06;Badajoz;100;Peñalsordo;1944;929;1015
06;Badajoz;101;Peraleda del Zaucejo;862;411;451
06;Badajoz;102;Puebla de Alcocer;1823;906;917
06;Badajoz;103;Puebla de la Calzada;5662;2834;2828
06;Badajoz;104;Puebla de la Reina;967;492;475
06;Badajoz;107;Puebla de Obando;2185;1119;1066
06;Badajoz;108;Puebla de Sancho Pérez;3042;1494;1548
06;Badajoz;105;Puebla del Maestre;1203;582;621
06;Badajoz;106;Puebla del Prior;652;344;308
06;Badajoz;109;Quintana de la Serena;5055;2528;2527
06;Badajoz;110;Reina;270;135;135
06;Badajoz;111;Rena;686;353;333
06;Badajoz;112;Retamal de Llerena;725;361;364
06;Badajoz;113;Ribera del Fresno;3595;1713;1882
06;Badajoz;114;Risco;272;138;134
06;Badajoz;115;Roca de la Sierra (La);1741;873;868
06;Badajoz;116;Salvaleón;2520;1296;1224
06;Badajoz;117;Salvatierra de los Barros;2050;1026;1024
06;Badajoz;119;San Pedro de Mérida;796;422;374
06;Badajoz;123;San Vicente de Alcántara;6178;3043;3135
06;Badajoz;118;Sancti-Spíritus;414;197;217
06;Badajoz;120;Santa Amalia;4382;2217;2165
06;Badajoz;121;Santa Marta;4096;2069;2027
06;Badajoz;122;Santos de Maimona (Los);7664;3830;3834
06;Badajoz;124;Segura de León;2480;1228;1252
06;Badajoz;125;Siruela;2676;1306;1370
06;Badajoz;126;Solana de los Barros;2803;1440;1363
06;Badajoz;127;Talarrubias;4021;1948;2073
06;Badajoz;128;Talavera la Real;5309;2698;2611
06;Badajoz;129;Táliga;831;432;399
06;Badajoz;130;Tamurejo;323;155;168
06;Badajoz;131;Torre de Miguel Sesmero;1341;664;677
06;Badajoz;132;Torremayor;1168;580;588
06;Badajoz;133;Torremejía;1926;975;951
06;Badajoz;134;Trasierra;741;390;351
06;Badajoz;135;Trujillanos;975;495;480
06;Badajoz;136;Usagre;2237;1144;1093
06;Badajoz;137;Valdecaballeros;1814;910;904
06;Badajoz;901;Valdelacalzada;"";"";""
06;Badajoz;138;Valdetorres;1490;747;743
06;Badajoz;139;Valencia de las Torres;989;491;498
06;Badajoz;140;Valencia del Mombuey;1017;504;513
06;Badajoz;141;Valencia del Ventoso;2600;1305;1295
06;Badajoz;146;Valle de la Serena;2000;980;1020
06;Badajoz;147;Valle de Matamoros;687;335;352
06;Badajoz;148;Valle de Santa Ana;1395;718;677
06;Badajoz;142;Valverde de Burguillos;410;202;208
06;Badajoz;143;Valverde de Leganés;3668;1864;1804
06;Badajoz;144;Valverde de Llerena;1002;494;508
06;Badajoz;145;Valverde de Mérida;1170;599;571
06;Badajoz;149;Villafranca de los Barros;12628;6211;6417
06;Badajoz;150;Villagarcía de la Torre;1164;598;566
06;Badajoz;151;Villagonzalo;1605;768;837
06;Badajoz;152;Villalba de los Barros;1749;873;876
06;Badajoz;153;Villanueva de la Serena;24417;12043;12374
06;Badajoz;154;Villanueva del Fresno;4057;2003;2054
06;Badajoz;156;Villar de Rena;2020;1065;955
06;Badajoz;155;Villar del Rey;2497;1280;1217
06;Badajoz;157;Villarta de los Montes;899;442;457
06;Badajoz;158;Zafra;14270;6842;7428
06;Badajoz;159;Zahínos;3211;1605;1606
06;Badajoz;160;Zalamea de la Serena;5849;2858;2991
06;Badajoz;162;Zarza (La);3741;1891;1850
06;Badajoz;161;Zarza-Capilla;735;361;374
07;Balears (Illes);002;Alaior;6616;3290;3326
07;Balears (Illes);001;Alaró;3640;1740;1900
07;Balears (Illes);003;Alcúdia;8317;4049;4268
07;Balears (Illes);004;Algaida;3173;1585;1588
07;Balears (Illes);005;Andratx;7062;3499;3563
07;Balears (Illes);901;Ariany;914;442;472
07;Balears (Illes);006;Artà;5954;2931;3023
07;Balears (Illes);007;Banyalbufar;449;220;229
07;Balears (Illes);008;Binissalem;4716;2296;2420
07;Balears (Illes);009;Búger;1025;500;525
07;Balears (Illes);010;Bunyola;3972;1964;2008
07;Balears (Illes);011;Calvià;23277;12058;11219
07;Balears (Illes);012;Campanet;2249;1113;1136
07;Balears (Illes);013;Campos;6717;3359;3358
07;Balears (Illes);014;Capdepera;7254;3670;3584
07;Balears (Illes);064;Castell (Es);5822;2925;2897
07;Balears (Illes);015;Ciutadella de Menorca;21092;10584;10508
07;Balears (Illes);016;Consell;2058;1001;1057
07;Balears (Illes);017;Costitx;771;368;403
07;Balears (Illes);018;Deyá;542;266;276
07;Balears (Illes);026;Eivissa;33776;17177;16599
07;Balears (Illes);019;Escorca;252;150;102
07;Balears (Illes);020;Esporles;3180;1562;1618
07;Balears (Illes);021;Estellencs;331;167;164
07;Balears (Illes);022;Felanitx;14627;7309;7318
07;Balears (Illes);023;Ferreries;3628;1946;1682
07;Balears (Illes);024;Formentera;5202;2673;2529
07;Balears (Illes);025;Fornalutx;594;300;294
07;Balears (Illes);027;Inca;22219;11034;11185
07;Balears (Illes);028;Lloret de Vistalegre;810;397;413
07;Balears (Illes);029;Lloseta;4582;2275;2307
07;Balears (Illes);030;Llubí;1964;969;995
07;Balears (Illes);031;Llucmajor;17977;9028;8949
07;Balears (Illes);032;Mahón;24383;12047;12336
07;Balears (Illes);033;Manacor;28791;14258;14533
07;Balears (Illes);034;Mancor de la Vall;958;467;491
07;Balears (Illes);035;Maria de la Salut;1875;919;956
07;Balears (Illes);036;Marratxí;12202;6127;6075
07;Balears (Illes);037;Mercadal (Es);2436;1214;1222
07;Balears (Illes);902;Migjorn Gran (Es);1066;567;499
07;Balears (Illes);038;Montuïri;2102;1008;1094
07;Balears (Illes);039;Muro;6061;2990;3071
07;Balears (Illes);040;Palma de Mallorca;325120;159370;165750
07;Balears (Illes);041;Petra;2602;1254;1348
07;Balears (Illes);044;Pobla (Sa);10331;5152;5179
07;Balears (Illes);042;Pollença;12788;6374;6414
07;Balears (Illes);043;Porreres;4433;2205;2228
07;Balears (Illes);045;Puigpunyent;1141;569;572
07;Balears (Illes);059;Salines (Ses);3241;1581;1660
07;Balears (Illes);046;Sant Antoni de Portmany;14740;7403;7337
07;Balears (Illes);049;Sant Joan;1725;839;886
07;Balears (Illes);050;Sant Joan de Labritja;3824;1896;1928
07;Balears (Illes);048;Sant Josep de sa Talaia;10583;5463;5120
07;Balears (Illes);051;Sant Llorenç des Cardassar;4640;2350;2290
07;Balears (Illes);052;Sant Lluís;3304;1659;1645
07;Balears (Illes);053;Santa Eugènia;948;463;485
07;Balears (Illes);054;Santa Eulalia del Río;17615;8987;8628
07;Balears (Illes);055;Santa Margalida;5944;3005;2939
07;Balears (Illes);056;Santa María del Camí;4186;2078;2108
07;Balears (Illes);057;Santanyí;7388;3767;3621
07;Balears (Illes);058;Selva;3054;1513;1541
07;Balears (Illes);047;Sencelles;1607;778;829
07;Balears (Illes);060;Sineu;2647;1317;1330
07;Balears (Illes);061;Sóller;10489;5126;5363
07;Balears (Illes);062;Son Servera;7419;3768;3651
07;Balears (Illes);063;Valldemossa;1386;662;724
07;Balears (Illes);065;Vilafranca de Bonany;2127;1049;1078
08;Barcelona;001;Abrera;5238;2685;2553
08;Barcelona;002;Aguilar de Segarra;209;104;105
08;Barcelona;014;Aiguafreda;2071;1011;1060
08;Barcelona;003;Alella;6433;3172;3261
08;Barcelona;004;Alpens;249;135;114
08;Barcelona;005;Ametlla del Vallès (L');3261;1584;1677
08;Barcelona;006;Arenys de Mar;11057;5356;5701
08;Barcelona;007;Arenys de Munt;4847;2345;2502
08;Barcelona;008;Argençola;198;105;93
08;Barcelona;009;Argentona;7995;3989;4006
08;Barcelona;010;Artés;4098;1995;2103
08;Barcelona;011;Avià;1796;914;882
08;Barcelona;012;Avinyó;2047;998;1049
08;Barcelona;013;Avinyonet del Penedès;1196;598;598
08;Barcelona;015;Badalona;225207;112290;112917
08;Barcelona;904;Badia del Vallès;"";"";""
08;Barcelona;016;Bagà;2142;1071;1071
08;Barcelona;017;Balenyà;3236;1662;1574
08;Barcelona;018;Balsareny;3438;1690;1748
08;Barcelona;252;Barberà del Vallès;31370;16255;15115
08;Barcelona;019;Barcelona;1707286;809808;897478
08;Barcelona;020;Begues;1920;921;999
08;Barcelona;021;Bellprat;91;48;43
08;Barcelona;022;Berga;14076;6840;7236
08;Barcelona;023;Bigues i Riells;2643;1356;1287
08;Barcelona;024;Borredà;436;207;229
08;Barcelona;025;Bruc (El);731;373;358
08;Barcelona;026;Brull (El);177;98;79
08;Barcelona;027;Cabanyes (Les);405;217;188
08;Barcelona;029;Cabrera de Mar;2770;1398;1372
08;Barcelona;028;Cabrera d'Igualada;269;142;127
08;Barcelona;030;Cabrils;2782;1338;1444
08;Barcelona;031;Calaf;3187;1574;1613
08;Barcelona;034;Calders;545;287;258
08;Barcelona;033;Caldes de Montbui;11003;5454;5549
08;Barcelona;032;Caldes d'Estrac;1457;711;746
08;Barcelona;035;Calella;11817;5526;6291
08;Barcelona;037;Calldetenes;1480;754;726
08;Barcelona;038;Callús;1491;720;771
08;Barcelona;036;Calonge de Segarra;201;106;95
08;Barcelona;039;Campins;195;91;104
08;Barcelona;040;Canet de Mar;8850;4344;4506
08;Barcelona;041;Canovelles;13165;6614;6551
08;Barcelona;042;Cànoves i Samalús;889;442;447
08;Barcelona;043;Canyelles;691;374;317
08;Barcelona;044;Capellades;4986;2438;2548
08;Barcelona;045;Capolat;112;60;52
08;Barcelona;046;Cardedeu;8911;4442;4469
08;Barcelona;047;Cardona;6647;3245;3402
08;Barcelona;048;Carme;711;370;341
08;Barcelona;049;Casserres;1798;875;923
08;Barcelona;057;Castell de l'Areny;61;32;29
08;Barcelona;052;Castellar de n'Hug;187;99;88
08;Barcelona;050;Castellar del Riu;67;38;29
08;Barcelona;051;Castellar del Vallès;13153;6544;6609
08;Barcelona;053;Castellbell i el Vilar;3334;1633;1701
08;Barcelona;054;Castellbisbal;4725;2448;2277
08;Barcelona;055;Castellcir;248;134;114
08;Barcelona;056;Castelldefels;32080;16070;16010
08;Barcelona;058;Castellet i la Gornal;1078;548;530
08;Barcelona;060;Castellfollit de Riubregós;274;137;137
08;Barcelona;059;Castellfollit del Boix;318;153;165
08;Barcelona;061;Castellgalí;712;358;354
08;Barcelona;062;Castellnou de Bages;169;92;77
08;Barcelona;063;Castellolí;437;208;229
08;Barcelona;064;Castellterçol;1972;946;1026
08;Barcelona;065;Castellví de la Marca;1442;720;722
08;Barcelona;066;Castellví de Rosanes;572;289;283
08;Barcelona;067;Centelles;5751;2833;2918
08;Barcelona;268;Cercs;1745;868;877
08;Barcelona;266;Cerdanyola del Vallès;56497;28367;28130
08;Barcelona;068;Cervelló;5279;2675;2604
08;Barcelona;069;Collbató;1021;511;510
08;Barcelona;070;Collsuspina;217;109;108
08;Barcelona;071;Copons;302;147;155
08;Barcelona;072;Corbera de Llobregat;4996;2519;2477
08;Barcelona;073;Cornellà de Llobregat;86287;42779;43508
08;Barcelona;074;Cubelles;2984;1524;1460
08;Barcelona;075;Dosrius;1260;665;595
08;Barcelona;076;Esparreguera;12177;6100;6077
08;Barcelona;077;Esplugues de Llobregat;49054;24404;24650
08;Barcelona;078;Espunyola (L');306;161;145
08;Barcelona;079;Estany (L');386;178;208
08;Barcelona;134;Figaró-Montmany;614;318;296
08;Barcelona;080;Fígols;34;18;16
08;Barcelona;082;Fogars de la Selva;391;196;195
08;Barcelona;081;Fogars de Montclús;278;140;138
08;Barcelona;083;Folgueroles;1115;552;563
08;Barcelona;084;Fonollosa;652;330;322
08;Barcelona;085;Font-rubí;1112;576;536
08;Barcelona;086;Franqueses del Vallès (Les);10070;5073;4997
08;Barcelona;090;Gaià;154;83;71
08;Barcelona;087;Gallifa;84;43;41
08;Barcelona;088;Garriga (La);9273;4487;4786
08;Barcelona;089;Gavà;35990;18073;17917
08;Barcelona;091;Gelida;3899;1947;1952
08;Barcelona;092;Gironella;5289;2542;2747
08;Barcelona;093;Gisclareny;33;17;16
08;Barcelona;094;Granada (La);1225;603;622
08;Barcelona;095;Granera;71;41;30
08;Barcelona;096;Granollers;50562;24898;25664
08;Barcelona;097;Gualba;597;306;291
08;Barcelona;099;Guardiola de Berguedà;1227;594;633
08;Barcelona;100;Gurb;1734;909;825
08;Barcelona;101;Hospitalet de Llobregat (L');276198;136628;139570
08;Barcelona;162;Hostalets de Pierola (Els);881;446;435
08;Barcelona;102;Igualada;31855;15529;16326
08;Barcelona;103;Jorba;524;262;262
08;Barcelona;104;Llacuna (La);763;395;368
08;Barcelona;105;Llagosta (La);12086;6023;6063
08;Barcelona;107;Lliçà d'Amunt;4963;2517;2446
08;Barcelona;108;Lliçà de Vall;3083;1594;1489
08;Barcelona;106;Llinars del Vallès;5420;2743;2677
08;Barcelona;109;Lluçà;281;158;123
08;Barcelona;110;Malgrat de Mar;11470;5664;5806
08;Barcelona;111;Malla;256;119;137
08;Barcelona;112;Manlleu;16560;8181;8379
08;Barcelona;113;Manresa;65818;31779;34039
08;Barcelona;242;Marganell;208;80;128
08;Barcelona;114;Martorell;16480;8253;8227
08;Barcelona;115;Martorelles;4951;2468;2483
08;Barcelona;116;Masies de Roda (Les);614;301;313
08;Barcelona;117;Masies de Voltregà (Les);2483;1216;1267
08;Barcelona;118;Masnou (El);18040;8696;9344
08;Barcelona;119;Masquefa;2647;1319;1328
08;Barcelona;120;Matadepera;4270;2167;2103
08;Barcelona;121;Mataró;101882;50059;51823
08;Barcelona;122;Mediona;1008;510;498
08;Barcelona;138;Moià;3287;1601;1686
08;Barcelona;123;Molins de Rei;18500;9142;9358
08;Barcelona;124;Mollet del Vallès;39928;19939;19989
08;Barcelona;128;Monistrol de Calders;621;303;318
08;Barcelona;127;Monistrol de Montserrat;2542;1261;1281
08;Barcelona;125;Montcada i Reixac;27113;13485;13628
08;Barcelona;130;Montclar;256;111;145
08;Barcelona;131;Montesquiu;856;412;444
08;Barcelona;126;Montgat;7363;3629;3734
08;Barcelona;132;Montmajor;656;331;325
08;Barcelona;133;Montmaneu;275;160;115
08;Barcelona;135;Montmeló;7326;3629;3697
08;Barcelona;136;Montornès del Vallès;10869;5456;5413
08;Barcelona;137;Montseny;272;140;132
08;Barcelona;129;Muntanyola;180;102;78
08;Barcelona;139;Mura;193;105;88
08;Barcelona;140;Navarcles;5169;2580;2589
08;Barcelona;141;Navàs;5473;2681;2792
08;Barcelona;142;Nou de Berguedà (La);139;78;61
08;Barcelona;143;Òdena;2567;1304;1263
08;Barcelona;145;Olèrdola;1601;837;764
08;Barcelona;146;Olesa de Bonesvalls;406;215;191
08;Barcelona;147;Olesa de Montserrat;14864;7394;7470
08;Barcelona;148;Olivella;347;161;186
08;Barcelona;149;Olost;969;477;492
08;Barcelona;144;Olvan;1068;506;562
08;Barcelona;150;Orís;223;114;109
08;Barcelona;151;Oristà;897;449;448
08;Barcelona;152;Orpí;144;75;69
08;Barcelona;153;Òrrius;366;196;170
08;Barcelona;154;Pacs del Penedès;419;221;198
08;Barcelona;155;Palafolls;3322;1648;1674
08;Barcelona;156;Palau-solità i Plegamans;6879;3564;3315
08;Barcelona;157;Pallejà;6331;3145;3186
08;Barcelona;905;Palma de Cervelló (La);"";"";""
08;Barcelona;158;Papiol (El);3186;1569;1617
08;Barcelona;159;Parets del Vallès;10743;5417;5326
08;Barcelona;160;Perafita;354;167;187
08;Barcelona;161;Piera;5810;2896;2914
08;Barcelona;163;Pineda de Mar;15858;7963;7895
08;Barcelona;164;Pla del Penedès (El);995;497;498
08;Barcelona;165;Pobla de Claramunt (La);1658;832;826
08;Barcelona;166;Pobla de Lillet (La);1830;904;926
08;Barcelona;167;Polinyà;3306;1661;1645
08;Barcelona;182;Pont de Vilomara i Rocafort (El);2226;1100;1126
08;Barcelona;168;Pontons;236;128;108
08;Barcelona;169;Prat de Llobregat (El);65276;32964;32312
08;Barcelona;171;Prats de Lluçanès;2571;1296;1275
08;Barcelona;170;Prats de Rei (Els);568;278;290
08;Barcelona;230;Premià de Dalt;6121;3095;3026
08;Barcelona;172;Premià de Mar;22209;11168;11041
08;Barcelona;174;Puigdàlber;302;146;156
08;Barcelona;175;Puig-reig;5006;2463;2543
08;Barcelona;176;Pujalt;177;90;87
08;Barcelona;177;Quar (La);36;18;18
08;Barcelona;178;Rajadell;272;146;126
08;Barcelona;179;Rellinars;220;104;116
08;Barcelona;180;Ripollet;26771;13341;13430
08;Barcelona;181;Roca del Vallès (La);5805;2906;2899
08;Barcelona;183;Roda de Ter;4812;2303;2509
08;Barcelona;184;Rubí;50987;25727;25260
08;Barcelona;185;Rubió;119;62;57
08;Barcelona;901;Rupit i Pruit;353;176;177
08;Barcelona;187;Sabadell;192142;94160;97982
08;Barcelona;188;Sagàs;243;128;115
08;Barcelona;190;Saldes;350;198;152
08;Barcelona;191;Sallent;7785;3753;4032
08;Barcelona;194;Sant Adrià de Besòs;34729;17264;17465
08;Barcelona;195;Sant Agustí de Lluçanès;130;67;63
08;Barcelona;196;Sant Andreu de la Barca;15405;7770;7635
08;Barcelona;197;Sant Andreu de Llavaneres;4389;2183;2206
08;Barcelona;198;Sant Antoni de Vilamajor;2056;1013;1043
08;Barcelona;199;Sant Bartomeu del Grau;1108;583;525
08;Barcelona;200;Sant Boi de Llobregat;78882;39634;39248
08;Barcelona;201;Sant Boi de Lluçanès;528;266;262
08;Barcelona;203;Sant Cebrià de Vallalta;806;425;381
08;Barcelona;202;Sant Celoni;12567;6276;6291
08;Barcelona;204;Sant Climent de Llobregat;2235;1112;1123
08;Barcelona;205;Sant Cugat del Vallès;39316;19357;19959
08;Barcelona;206;Sant Cugat Sesgarrigues;739;376;363
08;Barcelona;207;Sant Esteve de Palautordera;1127;580;547
08;Barcelona;208;Sant Esteve Sesrovires;2418;1241;1177
08;Barcelona;210;Sant Feliu de Codines;3549;1722;1827
08;Barcelona;211;Sant Feliu de Llobregat;37823;18850;18973
08;Barcelona;212;Sant Feliu Sasserra;666;332;334
08;Barcelona;209;Sant Fost de Campsentelles;4703;2388;2315
08;Barcelona;213;Sant Fruitós de Bages;4787;2396;2391
08;Barcelona;215;Sant Hipòlit de Voltregà;2990;1446;1544
08;Barcelona;193;Sant Iscle de Vallalta;496;261;235
08;Barcelona;216;Sant Jaume de Frontanyà;30;18;12
08;Barcelona;218;Sant Joan de Vilatorrada;7963;3977;3986
08;Barcelona;217;Sant Joan Despí;24782;12406;12376
08;Barcelona;903;Sant Julià de Cerdanyola;"";"";""
08;Barcelona;220;Sant Julià de Vilatorta;1831;888;943
08;Barcelona;221;Sant Just Desvern;12301;5938;6363
08;Barcelona;222;Sant Llorenç d'Hortons;1000;503;497
08;Barcelona;223;Sant Llorenç Savall;1901;893;1008
08;Barcelona;225;Sant Martí d'Albars;125;70;55
08;Barcelona;224;Sant Martí de Centelles;628;319;309
08;Barcelona;226;Sant Martí de Tous;988;493;495
08;Barcelona;227;Sant Martí Sarroca;2428;1214;1214
08;Barcelona;228;Sant Martí Sesgueioles;376;191;185
08;Barcelona;229;Sant Mateu de Bages;573;291;282
08;Barcelona;231;Sant Pere de Ribes;13991;7056;6935
08;Barcelona;232;Sant Pere de Riudebitlles;2206;1086;1120
08;Barcelona;233;Sant Pere de Torelló;2057;962;1095
08;Barcelona;234;Sant Pere de Vilamajor;1056;548;508
08;Barcelona;189;Sant Pere Sallavinera;185;94;91
08;Barcelona;235;Sant Pol de Mar;2535;1242;1293
08;Barcelona;236;Sant Quintí de Mediona;1581;790;791
08;Barcelona;237;Sant Quirze de Besora;2040;976;1064
08;Barcelona;238;Sant Quirze del Vallès;8512;4226;4286
08;Barcelona;239;Sant Quirze Safaja;257;123;134
08;Barcelona;240;Sant Sadurní d'Anoia;9209;4621;4588
08;Barcelona;241;Sant Sadurní d'Osormort;81;39;42
08;Barcelona;098;Sant Salvador de Guardiola;1067;537;530
08;Barcelona;262;Sant Vicenç de Castellet;7583;3661;3922
08;Barcelona;264;Sant Vicenç de Montalt;1685;844;841
08;Barcelona;265;Sant Vicenç de Torelló;1722;826;896
08;Barcelona;263;Sant Vicenç dels Horts;21107;10564;10543
08;Barcelona;243;Santa Cecilia de Voltregà;182;103;79
08;Barcelona;244;Santa Coloma de Cervelló;2894;1425;1469
08;Barcelona;245;Santa Coloma de Gramenet;135486;67788;67698
08;Barcelona;246;Santa Eugènia de Berga;1536;789;747
08;Barcelona;247;Santa Eulàlia de Riuprimer;855;433;422
08;Barcelona;248;Santa Eulàlia de Ronçana;2908;1483;1425
08;Barcelona;249;Santa Fe del Penedès;200;93;107
08;Barcelona;250;Santa Margarida de Montbui;9392;4725;4667
08;Barcelona;251;Santa Margarida i els Monjos;3772;1962;1810
08;Barcelona;253;Santa Maria de Besora;208;103;105
08;Barcelona;254;Santa Maria de Corcó;1984;974;1010
08;Barcelona;256;Santa Maria de Martorelles;452;227;225
08;Barcelona;255;Santa Maria de Merlès;264;131;133
08;Barcelona;257;Santa Maria de Miralles;114;58;56
08;Barcelona;259;Santa Maria de Palautordera;4797;2442;2355
08;Barcelona;258;Santa Maria d'Oló;1047;527;520
08;Barcelona;260;Santa Perpètua de Mogoda;16811;8524;8287
08;Barcelona;261;Santa Susanna;896;449;447
08;Barcelona;192;Santpedor;4347;2110;2237
08;Barcelona;267;Sentmenat;4407;2215;2192
08;Barcelona;269;Seva;1727;866;861
08;Barcelona;270;Sitges;13550;6616;6934
08;Barcelona;271;Sobremunt;100;50;50
08;Barcelona;272;Sora;217;116;101
08;Barcelona;273;Subirats;2138;1084;1054
08;Barcelona;274;Súria;6654;3302;3352
08;Barcelona;276;Tagamanent;148;77;71
08;Barcelona;277;Talamanca;76;41;35
08;Barcelona;278;Taradell;4557;2263;2294
08;Barcelona;275;Tavèrnoles;218;109;109
08;Barcelona;280;Tavertet;121;64;57
08;Barcelona;281;Teià;3509;1760;1749
08;Barcelona;279;Terrassa;161682;79174;82508
08;Barcelona;282;Tiana;4578;2309;2269
08;Barcelona;283;Tona;5552;2751;2801
08;Barcelona;284;Tordera;8249;4145;4104
08;Barcelona;285;Torelló;11763;5758;6005
08;Barcelona;286;Torre de Claramunt (La);1643;845;798
08;Barcelona;287;Torrelavit;1190;607;583
08;Barcelona;288;Torrelles de Foix;1235;648;587
08;Barcelona;289;Torrelles de Llobregat;2179;1118;1061
08;Barcelona;290;Ullastrell;929;465;464
08;Barcelona;291;Vacarisses;789;403;386
08;Barcelona;292;Vallbona d'Anoia;1062;534;528
08;Barcelona;293;Vallcebre;332;177;155
08;Barcelona;294;Vallgorguina;712;354;358
08;Barcelona;295;Vallirana;6179;3089;3090
08;Barcelona;296;Vallromanes;583;299;284
08;Barcelona;297;Veciana;183;95;88
08;Barcelona;298;Vic;29078;13909;15169
08;Barcelona;299;Vilada;614;312;302
08;Barcelona;301;Viladecans;48018;24316;23702
08;Barcelona;300;Viladecavalls;3138;1586;1552
08;Barcelona;305;Vilafranca del Penedès;27642;13528;14114
08;Barcelona;306;Vilalba Sasserra;295;156;139
08;Barcelona;303;Vilanova de Sau;334;161;173
08;Barcelona;302;Vilanova del Camí;9137;4602;4535
08;Barcelona;902;Vilanova del Vallès;1361;669;692
08;Barcelona;307;Vilanova i la Geltrú;47340;23440;23900
08;Barcelona;214;Vilassar de Dalt;6791;3344;3447
08;Barcelona;219;Vilassar de Mar;12136;6019;6117
08;Barcelona;304;Vilobí del Penedès;804;408;396
08;Barcelona;308;Viver i Serrateix;216;115;101
09;Burgos;001;Abajas;53;27;26
09;Burgos;003;Adrada de Haza;327;177;150
09;Burgos;006;Aguas Cándidas;123;72;51
09;Burgos;007;Aguilar de Bureba;123;67;56
09;Burgos;009;Albillos;160;93;67
09;Burgos;010;Alcocero de Mola;66;38;28
09;Burgos;011;Alfoz de Bricia;162;77;85
09;Burgos;907;Alfoz de Quintanadueñas;476;237;239
09;Burgos;012;Alfoz de Santa Gadea;170;91;79
09;Burgos;013;Altable;82;50;32
09;Burgos;014;Altos (Los);331;192;139
09;Burgos;016;Ameyugo;69;45;24
09;Burgos;017;Anguix;199;103;96
09;Burgos;018;Aranda de Duero;29300;14764;14536
09;Burgos;019;Arandilla;239;143;96
09;Burgos;020;Arauzo de Miel;478;261;217
09;Burgos;021;Arauzo de Salce;99;58;41
09;Burgos;022;Arauzo de Torre;129;75;54
09;Burgos;023;Arcos;278;155;123
09;Burgos;024;Arenillas de Riopisuerga;245;132;113
09;Burgos;025;Arija;316;144;172
09;Burgos;026;Arlanzón;425;216;209
09;Burgos;027;Arraya de Oca;51;26;25
09;Burgos;029;Atapuerca;178;84;94
09;Burgos;030;Ausines (Los);133;73;60
09;Burgos;032;Avellanosa de Muñó;229;121;108
09;Burgos;033;Bahabón de Esgueva;186;110;76
09;Burgos;034;Balbases (Los);434;231;203
09;Burgos;035;Baños de Valdearados;589;329;260
09;Burgos;036;Bañuelos de Bureba;60;40;20
09;Burgos;037;Barbadillo de Herreros;165;81;84
09;Burgos;038;Barbadillo del Mercado;221;109;112
09;Burgos;039;Barbadillo del Pez;136;73;63
09;Burgos;041;Barrio de Muñó;43;22;21
09;Burgos;043;Barrios de Bureba (Los);364;186;178
09;Burgos;044;Barrios de Colina;77;43;34
09;Burgos;045;Basconcillos del Tozo;484;256;228
09;Burgos;046;Bascuñana;92;50;42
09;Burgos;047;Belbimbre;87;42;45
09;Burgos;048;Belorado;2183;1110;1073
09;Burgos;050;Berberana;114;61;53
09;Burgos;051;Berlangas de Roa;350;176;174
09;Burgos;052;Berzosa de Bureba;59;34;25
09;Burgos;054;Bozoó;104;54;50
09;Burgos;055;Brazacorta;102;55;47
09;Burgos;056;Briviesca;5536;2769;2767
09;Burgos;057;Bugedo;111;79;32
09;Burgos;058;Buniel;160;88;72
09;Burgos;059;Burgos;163507;79721;83786
09;Burgos;060;Busto de Bureba;369;193;176
09;Burgos;061;Cabañes de Esgueva;339;172;167
09;Burgos;062;Cabezón de la Sierra;63;29;34
09;Burgos;063;Cabia;227;134;93
09;Burgos;064;Caleruega;465;253;212
09;Burgos;065;Campillo de Aranda;210;113;97
09;Burgos;066;Campolara;107;58;49
09;Burgos;067;Canicosa de la Sierra;724;360;364
09;Burgos;068;Cantabrana;75;41;34
09;Burgos;070;Carazo;55;31;24
09;Burgos;071;Carcedo de Bureba;51;27;24
09;Burgos;072;Carcedo de Burgos;103;60;43
09;Burgos;073;Cardeñadijo;343;188;155
09;Burgos;074;Cardeñajimeno;311;170;141
09;Burgos;075;Cardeñuela Riopico;59;31;28
09;Burgos;076;Carrias;65;42;23
09;Burgos;077;Cascajares de Bureba;71;41;30
09;Burgos;078;Cascajares de la Sierra;34;17;17
09;Burgos;079;Castellanos de Castro;83;48;35
09;Burgos;083;Castil de Peones;58;29;29
09;Burgos;082;Castildelgado;100;50;50
09;Burgos;084;Castrillo de la Reina;381;221;160
09;Burgos;085;Castrillo de la Vega;697;362;335
09;Burgos;088;Castrillo de Riopisuerga;115;66;49
09;Burgos;086;Castrillo del Val;144;86;58
09;Burgos;090;Castrillo Matajudíos;86;46;40
09;Burgos;091;Castrojeriz;1191;600;591
09;Burgos;093;Cayuela;126;73;53
09;Burgos;094;Cebrecos;85;46;39
09;Burgos;095;Celada del Camino;102;47;55
09;Burgos;098;Cerezo de Río Tirón;946;492;454
09;Burgos;100;Cerratón de Juarros;73;39;34
09;Burgos;101;Ciadoncha;150;81;69
09;Burgos;102;Cillaperlata;98;52;46
09;Burgos;103;Cilleruelo de Abajo;420;229;191
09;Burgos;104;Cilleruelo de Arriba;105;58;47
09;Burgos;105;Ciruelos de Cervera;213;108;105
09;Burgos;108;Cogollos;213;116;97
09;Burgos;109;Condado de Treviño;1035;563;472
09;Burgos;110;Contreras;100;61;39
09;Burgos;112;Coruña del Conde;203;115;88
09;Burgos;113;Covarrubias;701;359;342
09;Burgos;114;Cubillo del Campo;75;42;33
09;Burgos;115;Cubo de Bureba;155;78;77
09;Burgos;117;Cueva de Roa (La);156;90;66
09;Burgos;119;Cuevas de San Clemente;99;44;55
09;Burgos;120;Encío;57;32;25
09;Burgos;122;Espinosa de Cervera;129;80;49
09;Burgos;124;Espinosa de los Monteros;2464;1267;1197
09;Burgos;123;Espinosa del Camino;62;32;30
09;Burgos;125;Estépar;982;522;460
09;Burgos;127;Fontioso;118;65;53
09;Burgos;128;Frandovínez;93;49;44
09;Burgos;129;Fresneda de la Sierra Tirón;132;66;66
09;Burgos;130;Fresneña;157;87;70
09;Burgos;131;Fresnillo de las Dueñas;344;181;163
09;Burgos;132;Fresno de Río Tirón;310;179;131
09;Burgos;133;Fresno de Rodilla;36;20;16
09;Burgos;134;Frías;342;178;164
09;Burgos;135;Fuentebureba;126;61;65
09;Burgos;136;Fuentecén;364;206;158
09;Burgos;137;Fuentelcésped;269;132;137
09;Burgos;138;Fuentelisendo;160;88;72
09;Burgos;139;Fuentemolinos;156;83;73
09;Burgos;140;Fuentenebro;235;128;107
09;Burgos;141;Fuentespina;616;323;293
09;Burgos;143;Galbarros;33;22;11
09;Burgos;144;Gallega (La);101;59;42
09;Burgos;148;Grijalba;181;86;95
09;Burgos;149;Grisaleña;78;48;30
09;Burgos;151;Gumiel de Izán;728;386;342
09;Burgos;152;Gumiel de Mercado;517;270;247
09;Burgos;154;Hacinas;230;126;104
09;Burgos;155;Haza;46;25;21
09;Burgos;159;Hontanas;102;57;45
09;Burgos;160;Hontangas;192;104;88
09;Burgos;162;Hontoria de la Cantera;157;71;86
09;Burgos;164;Hontoria de Valdearados;307;179;128
09;Burgos;163;Hontoria del Pinar;1067;583;484
09;Burgos;166;Hormazas (Las);184;94;90
09;Burgos;167;Hornillos del Camino;106;54;52
09;Burgos;168;Horra (La);542;284;258
09;Burgos;169;Hortigüela;122;72;50
09;Burgos;170;Hoyales de Roa;386;188;198
09;Burgos;172;Huérmeces;171;97;74
09;Burgos;173;Huerta de Arriba;238;124;114
09;Burgos;174;Huerta de Rey;1325;691;634
09;Burgos;175;Humada;334;191;143
09;Burgos;176;Hurones;70;42;28
09;Burgos;177;Ibeas de Juarros;875;464;411
09;Burgos;178;Ibrillos;126;70;56
09;Burgos;179;Iglesiarrubia;77;41;36
09;Burgos;180;Iglesias;224;115;109
09;Burgos;181;Isar;481;226;255
09;Burgos;182;Itero del Castillo;160;77;83
09;Burgos;183;Jaramillo de la Fuente;38;18;20
09;Burgos;184;Jaramillo Quemado;25;14;11
09;Burgos;189;Junta de Traslaloma;242;129;113
09;Burgos;190;Junta de Villalba de Losa;108;58;50
09;Burgos;191;Jurisdicción de Lara;63;33;30
09;Burgos;192;Jurisdicción de San Zadornil;91;48;43
09;Burgos;194;Lerma;2570;1283;1287
09;Burgos;195;Llano de Bureba;80;43;37
09;Burgos;196;Madrigal del Monte;197;94;103
09;Burgos;197;Madrigalejo del Monte;168;93;75
09;Burgos;198;Mahamud;197;97;100
09;Burgos;199;Mambrilla de Castrejón;187;96;91
09;Burgos;200;Mambrillas de Lara;86;46;40
09;Burgos;201;Mamolar;111;61;50
09;Burgos;202;Manciles;53;28;25
09;Burgos;206;Mazuela;96;49;47
09;Burgos;208;Mecerreyes;382;181;201
09;Burgos;209;Medina de Pomar;5458;2716;2742
09;Burgos;211;Melgar de Fernamental;2139;1080;1059
09;Burgos;213;Merindad de Cuesta-Urria;640;356;284
09;Burgos;214;Merindad de Montija;1094;583;511
09;Burgos;431;Villafranca Montes de Oca;236;124;112
09;Burgos;432;Villafruela;362;190;172
09;Burgos;433;Villagalijo;83;46;37
09;Burgos;434;Villagonzalo Pedernales;493;251;242
09;Burgos;437;Villahoz;504;247;257
09;Burgos;438;Villalba de Duero;553;301;252
09;Burgos;439;Villalbilla de Burgos;520;291;229
09;Burgos;440;Villalbilla de Gumiel;162;88;74
09;Burgos;441;Villaldemiro;92;44;48
09;Burgos;442;Villalmanzo;490;262;228
09;Burgos;443;Villamayor de los Montes;325;156;169
09;Burgos;444;Villamayor de Treviño;133;77;56
09;Burgos;445;Villambistia;105;56;49
09;Burgos;446;Villamedianilla;39;17;22
09;Burgos;447;Villamiel de la Sierra;39;23;16
09;Burgos;448;Villangómez;422;213;209
09;Burgos;449;Villanueva de Argaño;122;69;53
09;Burgos;450;Villanueva de Carazo;28;18;10
09;Burgos;451;Villanueva de Gumiel;341;182;159
09;Burgos;454;Villanueva de Teba;99;55;44
09;Burgos;455;Villaquirán de la Puebla;72;41;31
09;Burgos;456;Villaquirán de los Infantes;245;125;120
09;Burgos;903;Villarcayo de Merindad de Castilla la Vieja;4487;2231;2256
09;Burgos;458;Villariezo;142;75;67
09;Burgos;460;Villasandino;350;180;170
09;Burgos;463;Villasur de Herreros;313;161;152
09;Burgos;464;Villatuelda;89;49;40
09;Burgos;466;Villaverde del Monte;252;137;115
09;Burgos;467;Villaverde-Mogina;155;88;67
09;Burgos;471;Villayerno Morquillas;134;64;70
09;Burgos;472;Villazopeque;100;56;44
09;Burgos;473;Villegas;155;75;80
09;Burgos;476;Villoruebo;39;27;12
09;Burgos;424;Viloria de Rioja;85;44;41
09;Burgos;425;Vilviestre del Pinar;901;459;442
09;Burgos;478;Vizcaínos;64;33;31
09;Burgos;480;Zael;171;83;88
09;Burgos;482;Zarzosa de Río Pisuerga;75;36;39
09;Burgos;483;Zazuar;354;185;169
09;Burgos;485;Zuñeda;118;64;54
09;Burgos;906;Merindad de Río Ubierna;1072;571;501
09;Burgos;215;Merindad de Sotoscueva;751;386;365
09;Burgos;216;Merindad de Valdeporres;597;305;292
09;Burgos;217;Merindad de Valdivielso;690;341;349
09;Burgos;218;Milagros;455;232;223
09;Burgos;219;Miranda de Ebro;36525;18250;18275
09;Burgos;220;Miraveche;154;81;73
09;Burgos;221;Modúbar de la Emparedada;207;113;94
09;Burgos;223;Monasterio de la Sierra;32;17;15
09;Burgos;224;Monasterio de Rodilla;213;114;99
09;Burgos;225;Moncalvillo;166;94;72
09;Burgos;226;Monterrubio de la Demanda;107;64;43
09;Burgos;227;Montorio;192;89;103
09;Burgos;228;Moradillo de Roa;252;130;122
09;Burgos;229;Nava de Roa;371;181;190
09;Burgos;230;Navas de Bureba;59;30;29
09;Burgos;231;Nebreda;154;95;59
09;Burgos;232;Neila;256;126;130
09;Burgos;235;Olmedillo de Roa;317;156;161
09;Burgos;236;Olmillos de Muñó;58;31;27
09;Burgos;238;Oña;1723;899;824
09;Burgos;239;Oquillas;79;41;38
09;Burgos;241;Orbaneja Riopico;130;70;60
09;Burgos;242;Padilla de Abajo;138;75;63
09;Burgos;243;Padilla de Arriba;154;80;74
09;Burgos;244;Padrones de Bureba;104;55;49
09;Burgos;246;Palacios de la Sierra;1012;513;499
09;Burgos;247;Palacios de Riopisuerga;54;27;27
09;Burgos;248;Palazuelos de la Sierra;75;39;36
09;Burgos;249;Palazuelos de Muñó;88;46;42
09;Burgos;250;Pampliega;461;244;217
09;Burgos;251;Pancorbo;619;312;307
09;Burgos;253;Pardilla;121;61;60
09;Burgos;255;Partido de la Sierra en Tobalina;94;57;37
09;Burgos;256;Pedrosa de Duero;678;360;318
09;Burgos;259;Pedrosa de Río Úrbel;329;172;157
09;Burgos;257;Pedrosa del Páramo;124;69;55
09;Burgos;258;Pedrosa del Príncipe;334;175;159
09;Burgos;261;Peñaranda de Duero;730;381;349
09;Burgos;262;Peral de Arlanza;283;151;132
09;Burgos;265;Piérnigas;54;32;22
09;Burgos;266;Pineda de la Sierra;120;68;52
09;Burgos;267;Pineda Trasmonte;235;120;115
09;Burgos;268;Pinilla de los Barruecos;195;101;94
09;Burgos;269;Pinilla de los Moros;59;37;22
09;Burgos;270;Pinilla Trasmonte;314;160;154
09;Burgos;272;Poza de la Sal;529;245;284
09;Burgos;273;Prádanos de Bureba;97;58;39
09;Burgos;274;Pradoluengo;1747;855;892
09;Burgos;275;Presencio;349;192;157
09;Burgos;276;Puebla de Arganzón (La);303;160;143
09;Burgos;277;Puentedura;158;86;72
09;Burgos;279;Quemada;276;153;123
09;Burgos;281;Quintana del Pidio;224;121;103
09;Burgos;280;Quintanabureba;67;41;26
09;Burgos;283;Quintanaélez;142;74;68
09;Burgos;287;Quintanaortuño;126;61;65
09;Burgos;288;Quintanapalla;167;91;76
09;Burgos;289;Quintanar de la Sierra;2835;1453;1382
09;Burgos;292;Quintanavides;88;40;48
09;Burgos;294;Quintanilla de la Mata;189;107;82
09;Burgos;901;Quintanilla del Agua y Tordueles;702;358;344
09;Burgos;295;Quintanilla del Coco;148;81;67
09;Burgos;298;Quintanilla San García;163;86;77
09;Burgos;301;Quintanilla Vivar;278;131;147
09;Burgos;297;Quintanillas (Las);359;189;170
09;Burgos;302;Rabanera del Pinar;240;109;131
09;Burgos;303;Rábanos;65;36;29
09;Burgos;304;Rabé de las Calzadas;157;89;68
09;Burgos;306;Rebolledo de la Torre;210;105;105
09;Burgos;307;Redecilla del Camino;149;87;62
09;Burgos;308;Redecilla del Campo;112;58;54
09;Burgos;309;Regumiel de la Sierra;597;301;296
09;Burgos;310;Reinoso;35;23;12
09;Burgos;311;Retuerta;82;43;39
09;Burgos;314;Revilla del Campo;161;84;77
09;Burgos;316;Revilla Vallejera;181;100;81
09;Burgos;312;Revilla y Ahedo (La);135;70;65
09;Burgos;315;Revillarruz;181;91;90
09;Burgos;317;Rezmondo;27;14;13
09;Burgos;318;Riocavado de la Sierra;71;39;32
09;Burgos;321;Roa;2463;1251;1212
09;Burgos;323;Rojas;107;55;52
09;Burgos;325;Royuela de Río Franco;465;253;212
09;Burgos;326;Rubena;179;94;85
09;Burgos;327;Rublacedo de Abajo;47;22;25
09;Burgos;328;Rucandio;133;65;68
09;Burgos;329;Salas de Bureba;200;109;91
09;Burgos;330;Salas de los Infantes;2139;1097;1042
09;Burgos;332;Saldaña de Burgos;74;38;36
09;Burgos;334;Salinillas de Bureba;81;51;30
09;Burgos;335;San Adrián de Juarros;39;18;21
09;Burgos;337;San Juan del Monte;242;126;116
09;Burgos;338;San Mamés de Burgos;138;75;63
09;Burgos;339;San Martín de Rubiales;392;211;181
09;Burgos;340;San Millán de Lara;117;65;52
09;Burgos;360;San Vicente del Valle;35;17;18
09;Burgos;343;Santa Cecilia;141;75;66
09;Burgos;345;Santa Cruz de la Salceda;218;111;107
09;Burgos;346;Santa Cruz del Valle Urbión;158;97;61
09;Burgos;347;Santa Gadea del Cid;211;111;100
09;Burgos;348;Santa Inés;244;130;114
09;Burgos;350;Santa María del Campo;821;428;393
09;Burgos;351;Santa María del Invierno;73;43;30
09;Burgos;352;Santa María del Mercadillo;246;141;105
09;Burgos;353;Santa María Rivarredonda;177;94;83
09;Burgos;354;Santa Olalla de Bureba;56;25;31
09;Burgos;355;Santibáñez de Esgueva;211;106;105
09;Burgos;356;Santibáñez del Val;82;48;34
09;Burgos;358;Santo Domingo de Silos;358;233;125
09;Burgos;361;Sargentes de la Lora;220;114;106
09;Burgos;362;Sarracín;160;80;80
09;Burgos;363;Sasamón;1786;949;837
09;Burgos;365;Sequera de Haza (La);80;48;32
09;Burgos;366;Solarana;147;76;71
09;Burgos;368;Sordillos;53;32;21
09;Burgos;369;Sotillo de la Ribera;587;323;264
09;Burgos;372;Sotragero;130;75;55
09;Burgos;373;Sotresgudo;917;486;431
09;Burgos;374;Susinos del Páramo;83;39;44
09;Burgos;375;Tamarón;57;30;27
09;Burgos;377;Tardajos;698;367;331
09;Burgos;378;Tejada;61;32;29
09;Burgos;380;Terradillos de Esgueva;148;78;70
09;Burgos;381;Tinieblas de la Sierra;27;16;11
09;Burgos;382;Tobar;68;36;32
09;Burgos;384;Tordómar;445;247;198
09;Burgos;386;Torrecilla del Monte;96;49;47
09;Burgos;387;Torregalindo;192;105;87
09;Burgos;388;Torrelara;21;10;11
09;Burgos;389;Torrepadre;227;122;105
09;Burgos;390;Torresandino;873;468;405
09;Burgos;391;Tórtoles de Esgueva;681;362;319
09;Burgos;392;Tosantos;80;37;43
09;Burgos;394;Trespaderne;1220;651;569
09;Burgos;395;Tubilla del Agua;172;100;72
09;Burgos;396;Tubilla del Lago;254;126;128
09;Burgos;398;Úrbel del Castillo;150;78;72
09;Burgos;400;Vadocondes;572;287;285
09;Burgos;403;Valdeande;224;114;110
09;Burgos;405;Valdezate;264;139;125
09;Burgos;406;Valdorros;113;62;51
09;Burgos;408;Vallarta de Bureba;106;59;47
09;Burgos;904;Valle de las Navas;678;380;298
09;Burgos;908;Valle de Losa;765;421;344
09;Burgos;409;Valle de Manzanedo;147;74;73
09;Burgos;410;Valle de Mena;5044;2577;2467
09;Burgos;411;Valle de Oca;227;117;110
09;Burgos;902;Valle de Santibáñez;726;378;348
09;Burgos;905;Valle de Sedano;497;258;239
09;Burgos;412;Valle de Tobalina;1112;595;517
09;Burgos;413;Valle de Valdebezana;965;510;455
09;Burgos;414;Valle de Valdelaguna;305;153;152
09;Burgos;415;Valle de Valdelucio;454;236;218
09;Burgos;416;Valle de Zamanzas;55;30;25
09;Burgos;417;Vallejera;66;36;30
09;Burgos;418;Valles de Palenzuela;114;60;54
09;Burgos;419;Valluércanes;174;100;74
09;Burgos;407;Valmala;40;19;21
09;Burgos;422;Vid de Bureba (La);53;27;26
09;Burgos;421;Vid y Barrios (La);424;241;183
09;Burgos;423;Vileña;53;31;22
09;Burgos;427;Villadiego;2541;1322;1219
09;Burgos;428;Villaescusa de Roa;219;121;98
09;Burgos;429;Villaescusa la Sombría;81;44;37
09;Burgos;430;Villaespasa;45;27;18
10;Cáceres;001;Abadía;357;200;157
10;Cáceres;002;Abertura;527;262;265
10;Cáceres;003;Acebo;905;461;444
10;Cáceres;004;Acehúche;1066;531;535
10;Cáceres;005;Aceituna;825;421;404
10;Cáceres;006;Ahigal;1987;1019;968
10;Cáceres;007;Albalá del Caudillo;1053;515;538
10;Cáceres;008;Alcántara;2213;1107;1106
10;Cáceres;009;Alcollarín;401;197;204
10;Cáceres;010;Alcuéscar;3454;1844;1610
10;Cáceres;012;Aldea del Cano;874;418;456
10;Cáceres;013;Aldea del Obispo (La);545;277;268
10;Cáceres;011;Aldeacentenera;1091;540;551
10;Cáceres;014;Aldeanueva de la Vera;2815;1412;1403
10;Cáceres;015;Aldeanueva del Camino;1033;493;540
10;Cáceres;016;Aldehuela de Jerte;456;259;197
10;Cáceres;017;Alía;1892;927;965
10;Cáceres;018;Aliseda;2586;1297;1289
10;Cáceres;019;Almaraz;1398;708;690
10;Cáceres;020;Almoharín;2220;1097;1123
10;Cáceres;021;Arroyo de la Luz;6675;3318;3357
10;Cáceres;023;Arroyomolinos;1171;591;580
10;Cáceres;022;Arroyomolinos de la Vera;734;374;360
10;Cáceres;024;Baños de Montemayor;800;369;431
10;Cáceres;025;Barrado;627;303;324
10;Cáceres;026;Belvís de Monroy;535;263;272
10;Cáceres;027;Benquerencia;129;70;59
10;Cáceres;028;Berrocalejo;159;72;87
10;Cáceres;029;Berzocana;768;396;372
10;Cáceres;030;Bohonal de Ibor;780;430;350
10;Cáceres;031;Botija;226;107;119
10;Cáceres;032;Brozas;2615;1298;1317
10;Cáceres;033;Cabañas del Castillo;740;393;347
10;Cáceres;034;Cabezabellosa;677;341;336
10;Cáceres;035;Cabezuela del Valle;2585;1314;1271
10;Cáceres;036;Cabrero;546;302;244
10;Cáceres;037;Cáceres;73915;35421;38494
10;Cáceres;038;Cachorrilla;133;57;76
10;Cáceres;039;Cadalso;677;353;324
10;Cáceres;040;Calzadilla;674;318;356
10;Cáceres;041;Caminomorisco;1511;791;720
10;Cáceres;042;Campillo de Deleitosa;191;94;97
10;Cáceres;043;Campo Lugar;1455;745;710
10;Cáceres;044;Cañamero;2161;1109;1052
10;Cáceres;045;Cañaveral;1862;878;984
10;Cáceres;046;Carbajo;301;159;142
10;Cáceres;047;Carcaboso;1351;716;635
10;Cáceres;048;Carrascalejo;517;246;271
10;Cáceres;049;Casar de Cáceres;4064;2061;2003
10;Cáceres;050;Casar de Palomero;1641;829;812
10;Cáceres;051;Casares de las Hurdes;1095;571;524
10;Cáceres;052;Casas de Don Antonio;272;126;146
10;Cáceres;053;Casas de Don Gómez;465;232;233
10;Cáceres;056;Casas de Millán;896;462;434
10;Cáceres;057;Casas de Miravete;180;91;89
10;Cáceres;054;Casas del Castañar;790;384;406
10;Cáceres;055;Casas del Monte;1000;518;482
10;Cáceres;058;Casatejada;1488;731;757
10;Cáceres;059;Casillas de Coria;714;339;375
10;Cáceres;060;Castañar de Ibor;1568;794;774
10;Cáceres;061;Ceclavín;2505;1274;1231
10;Cáceres;062;Cedillo;599;300;299
10;Cáceres;063;Cerezo;281;132;149
10;Cáceres;064;Cilleros;2482;1247;1235
10;Cáceres;065;Collado;536;288;248
10;Cáceres;066;Conquista de la Sierra;203;103;100
10;Cáceres;067;Coria;11412;5717;5695
10;Cáceres;068;Cuacos de Yuste;1030;536;494
10;Cáceres;069;Cumbre (La);1320;652;668
10;Cáceres;070;Deleitosa;1122;543;579
10;Cáceres;071;Descargamaría;302;158;144
10;Cáceres;072;Eljas;1588;801;787
10;Cáceres;073;Escurial;1038;524;514
10;Cáceres;075;Fresnedoso de Ibor;548;288;260
10;Cáceres;076;Galisteo;2344;1186;1158
10;Cáceres;077;Garciaz;1177;588;589
10;Cáceres;078;Garganta (La);713;370;343
10;Cáceres;079;Garganta la Olla;1302;669;633
10;Cáceres;080;Gargantilla;595;301;294
10;Cáceres;081;Gargüera;287;145;142
10;Cáceres;082;Garrovillas de Alconétar;2710;1278;1432
10;Cáceres;083;Garvín;152;85;67
10;Cáceres;084;Gata;2292;1129;1163
10;Cáceres;085;Gordo (El);395;189;206
10;Cáceres;086;Granja (La);482;248;234
10;Cáceres;087;Guadalupe;2652;1302;1350
10;Cáceres;088;Guijo de Coria;372;189;183
10;Cáceres;089;Guijo de Galisteo;1911;990;921
10;Cáceres;090;Guijo de Granadilla;877;428;449
10;Cáceres;091;Guijo de Santa Bárbara;648;331;317
10;Cáceres;092;Herguijuela;569;281;288
10;Cáceres;093;Hernán-Pérez;542;284;258
10;Cáceres;094;Herrera de Alcántara;420;205;215
10;Cáceres;095;Herreruela;575;289;286
10;Cáceres;096;Hervás;3821;1856;1965
10;Cáceres;097;Higuera;141;70;71
10;Cáceres;098;Hinojal;496;239;257
10;Cáceres;099;Holguera;947;476;471
10;Cáceres;100;Hoyos;1030;518;512
10;Cáceres;101;Huélaga;211;109;102
10;Cáceres;102;Ibahernando;892;449;443
10;Cáceres;103;Jaraicejo;811;390;421
10;Cáceres;104;Jaraíz de la Vera;7734;3835;3899
10;Cáceres;105;Jarandilla de la Vera;3226;1631;1595
10;Cáceres;106;Jarilla;222;111;111
10;Cáceres;107;Jerte;1450;754;696
10;Cáceres;108;Ladrillar;611;316;295
10;Cáceres;109;Logrosán;3093;1514;1579
10;Cáceres;110;Losar de la Vera;3165;1579;1586
10;Cáceres;111;Madrigal de la Vera;1946;1001;945
10;Cáceres;112;Madrigalejo;2690;1334;1356
10;Cáceres;113;Madroñera;3430;1685;1745
10;Cáceres;114;Majadas;1168;587;581
10;Cáceres;115;Malpartida de Cáceres;3720;1834;1886
10;Cáceres;116;Malpartida de Plasencia;4465;2237;2228
10;Cáceres;117;Marchagaz;455;218;237
10;Cáceres;118;Mata de Alcántara;435;216;219
10;Cáceres;119;Membrío;1007;481;526
10;Cáceres;120;Mesas de Ibor;223;122;101
10;Cáceres;121;Miajadas;9548;4757;4791
10;Cáceres;122;Millanes;252;133;119
10;Cáceres;123;Mirabel;949;488;461
10;Cáceres;124;Mohedas de Granadilla;1269;661;608
10;Cáceres;125;Monroy;1368;690;678
10;Cáceres;126;Montánchez;2675;1322;1353
10;Cáceres;127;Montehermoso;5459;2749;2710
10;Cáceres;128;Moraleja;8526;4321;4205
10;Cáceres;129;Morcillo;605;276;329
10;Cáceres;130;Navaconcejo;2228;1147;1081
10;Cáceres;131;Navalmoral de la Mata;14915;7397;7518
10;Cáceres;132;Navalvillar de Ibor;646;331;315
10;Cáceres;133;Navas del Madroño;1756;881;875
10;Cáceres;134;Navezuelas;862;472;390
10;Cáceres;135;Nuñomoral;2283;1223;1060
10;Cáceres;136;Oliva de Plasencia;418;209;209
10;Cáceres;137;Palomero;666;346;320
10;Cáceres;138;Pasarón de la Vera;741;364;377
10;Cáceres;139;Pedroso de Acim;204;111;93
10;Cáceres;140;Peraleda de la Mata;1569;781;788
10;Cáceres;141;Peraleda de San Román;513;261;252
10;Cáceres;142;Perales del Puerto;1055;515;540
10;Cáceres;143;Pescueza;287;138;149
10;Cáceres;144;Pesga (La);1553;806;747
10;Cáceres;145;Piedras Albas;289;134;155
10;Cáceres;146;Pinofranqueado;1995;1050;945
10;Cáceres;147;Piornal;1679;836;843
10;Cáceres;148;Plasencia;34488;17011;17477
10;Cáceres;149;Plasenzuela;530;264;266
10;Cáceres;150;Portaje;517;259;258
10;Cáceres;151;Portezuelo;358;169;189
10;Cáceres;152;Pozuelo de Zarzón;755;368;387
10;Cáceres;153;Puerto de Santa Cruz;483;232;251
10;Cáceres;154;Rebollar;284;151;133
10;Cáceres;155;Riolobos;1856;974;882
10;Cáceres;156;Robledillo de Gata;251;133;118
10;Cáceres;157;Robledillo de la Vera;522;263;259
10;Cáceres;158;Robledillo de Trujillo;604;314;290
10;Cáceres;159;Robledollano;546;294;252
10;Cáceres;160;Romangordo;198;99;99
10;Cáceres;901;Rosalejo;"";"";""
10;Cáceres;161;Ruanes;105;51;54
10;Cáceres;162;Salorino;1051;493;558
10;Cáceres;163;Salvatierra de Santiago;531;277;254
10;Cáceres;164;San Martín de Trevejo;974;488;486
10;Cáceres;165;Santa Ana;437;225;212
10;Cáceres;166;Santa Cruz de la Sierra;425;213;212
10;Cáceres;167;Santa Cruz de Paniagua;583;302;281
10;Cáceres;168;Santa Marta de Magasca;433;222;211
10;Cáceres;169;Santiago de Alcántara;1077;545;532
10;Cáceres;170;Santiago del Campo;388;201;187
10;Cáceres;171;Santibáñez el Alto;675;360;315
10;Cáceres;172;Santibáñez el Bajo;1149;620;529
10;Cáceres;173;Saucedilla;567;289;278
10;Cáceres;174;Segura de Toro;232;126;106
10;Cáceres;175;Serradilla;2342;1166;1176
10;Cáceres;176;Serrejón;525;262;263
10;Cáceres;177;Sierra de Fuentes;1593;784;809
10;Cáceres;178;Talaván;1115;541;574
10;Cáceres;179;Talaveruela de la Vera;578;267;311
10;Cáceres;180;Talayuela;7995;4086;3909
10;Cáceres;181;Tejeda de Tiétar;1167;621;546
10;Cáceres;182;Toril;302;163;139
10;Cáceres;183;Tornavacas;1545;794;751
10;Cáceres;184;Torno (El);1221;630;591
10;Cáceres;187;Torre de Don Miguel;822;414;408
10;Cáceres;188;Torre de Santa María;863;434;429
10;Cáceres;185;Torrecilla de los Ángeles;767;396;371
10;Cáceres;186;Torrecillas de la Tiesa;1342;666;676
10;Cáceres;190;Torrejón el Rubio;855;436;419
10;Cáceres;189;Torrejoncillo;3915;1892;2023
10;Cáceres;191;Torremenga;602;317;285
10;Cáceres;192;Torremocha;1470;720;750
10;Cáceres;193;Torreorgaz;1498;751;747
10;Cáceres;194;Torrequemada;666;310;356
10;Cáceres;195;Trujillo;9337;4464;4873
10;Cáceres;196;Valdastillas;464;227;237
10;Cáceres;197;Valdecañas de Tajo;147;86;61
10;Cáceres;198;Valdefuentes;1733;854;879
10;Cáceres;199;Valdehúncar;189;94;95
10;Cáceres;200;Valdelacasa de Tajo;1034;494;540
10;Cáceres;201;Valdemorales;287;149;138
10;Cáceres;202;Valdeobispo;950;484;466
10;Cáceres;203;Valencia de Alcántara;7324;3634;3690
10;Cáceres;204;Valverde de la Vera;779;385;394
10;Cáceres;205;Valverde del Fresno;2905;1476;1429
10;Cáceres;206;Viandar de la Vera;461;231;230
10;Cáceres;207;Villa del Campo;754;374;380
10;Cáceres;208;Villa del Rey;218;108;110
10;Cáceres;209;Villamesías;489;232;257
10;Cáceres;210;Villamiel;883;436;447
10;Cáceres;211;Villanueva de la Sierra;823;394;429
10;Cáceres;212;Villanueva de la Vera;2157;1087;1070
10;Cáceres;214;Villar de Plasencia;396;192;204
10;Cáceres;213;Villar del Pedroso;1027;519;508
10;Cáceres;215;Villasbuenas de Gata;602;308;294
10;Cáceres;216;Zarza de Granadilla;1918;991;927
10;Cáceres;217;Zarza de Montánchez;824;414;410
10;Cáceres;218;Zarza la Mayor;1862;904;958
10;Cáceres;219;Zorita;2552;1249;1303
11;Cádiz;001;Alcalá de los Gazules;5840;3048;2792
11;Cádiz;002;Alcalá del Valle;5400;2734;2666
11;Cádiz;003;Algar;2131;1127;1004
11;Cádiz;004;Algeciras;102079;50458;51621
11;Cádiz;005;Algodonales;6035;3154;2881
11;Cádiz;006;Arcos de la Frontera;27722;13957;13765
11;Cádiz;007;Barbate;22706;11412;11294
11;Cádiz;008;Barrios (Los);13693;7012;6681
11;Cádiz;901;Benalup-Casas Viejas;"";"";""
11;Cádiz;009;Benaocaz;519;256;263
11;Cádiz;010;Bornos;8189;4101;4088
11;Cádiz;011;Bosque (El);1812;919;893
11;Cádiz;013;Castellar de la Frontera;2330;1210;1120
11;Cádiz;015;Chiclana de la Frontera;44998;22974;22024
11;Cádiz;016;Chipiona;14607;7484;7123
11;Cádiz;014;Conil de la Frontera;15396;7929;7467
11;Cádiz;012;Cádiz;156903;75727;81176
11;Cádiz;017;Espera;4194;2183;2011
11;Cádiz;018;Gastor (El);2295;1208;1087
11;Cádiz;019;Grazalema;2302;1193;1109
11;Cádiz;020;Jerez de la Frontera;186812;92127;94685
11;Cádiz;021;Jimena de la Frontera;8936;4625;4311
11;Cádiz;022;Línea de la Concepción (La);61597;30039;31558
11;Cádiz;023;Medina-Sidonia;16660;8602;8058
11;Cádiz;024;Olvera;9293;4709;4584
11;Cádiz;025;Paterna de Rivera;4974;2577;2397
11;Cádiz;026;Prado del Rey;5522;2771;2751
11;Cádiz;028;Puerto Real;29070;14565;14505
11;Cádiz;029;Puerto Serrano;6337;3218;3119
11;Cádiz;027;Puerto de Santa María (El);64849;32467;32382
11;Cádiz;030;Rota;22677;11482;11195
11;Cádiz;031;San Fernando;83923;41515;42408
11;Cádiz;902;San José del Valle;"";"";""
11;Cádiz;033;San Roque;22231;11203;11028
11;Cádiz;032;Sanlúcar de Barrameda;56375;28315;28060
11;Cádiz;034;Setenil de las Bodegas;3287;1669;1618
11;Cádiz;035;Tarifa;14860;7534;7326
11;Cádiz;036;Torre Alháquime;1049;522;527
11;Cádiz;037;Trebujena;7060;3598;3462
11;Cádiz;038;Ubrique;18171;9035;9136
11;Cádiz;039;Vejer de la Frontera;13285;6780;6505
11;Cádiz;040;Villaluenga del Rosario;482;254;228
11;Cádiz;041;Villamartín;12331;6142;6189
11;Cádiz;042;Zahara;1696;875;821
12;Castellón/Castelló;002;Aín;129;65;64
12;Castellón/Castelló;003;Albocàsser;1526;745;781
12;Castellón/Castelló;004;Alcalà de Xivert;4781;2386;2395
12;Castellón/Castelló;005;Alcora (L');8394;4242;4152
12;Castellón/Castelló;006;Alcudia de Veo;197;92;105
12;Castellón/Castelló;007;Alfondeguilla;921;465;456
12;Castellón/Castelló;008;Algimia de Almonacid;366;195;171
12;Castellón/Castelló;009;Almazora/Almassora;15950;7919;8031
12;Castellón/Castelló;010;Almedíjar;308;154;154
12;Castellón/Castelló;011;Almenara;5090;2530;2560
12;Castellón/Castelló;901;Alquerías del Niño Perdido;3656;1793;1863
12;Castellón/Castelló;012;Altura;3111;1532;1579
12;Castellón/Castelló;013;Arañuel;125;56;69
12;Castellón/Castelló;014;Ares del Maestre;370;187;183
12;Castellón/Castelló;015;Argelita;109;56;53
12;Castellón/Castelló;016;Artana;2017;1018;999
12;Castellón/Castelló;001;Atzeneta del Maestrat;1645;827;818
12;Castellón/Castelló;017;Ayódar;234;120;114
12;Castellón/Castelló;018;Azuébar;401;196;205
12;Castellón/Castelló;020;Barracas;188;98;90
12;Castellón/Castelló;022;Bejís;474;242;232
12;Castellón/Castelló;024;Benafer;125;69;56
12;Castellón/Castelló;025;Benafigos;279;150;129
12;Castellón/Castelló;026;Benasal;1497;724;773
12;Castellón/Castelló;027;Benicarló;18200;8903;9297
12;Castellón/Castelló;028;Benicasim/Benicàssim;6565;3311;3254
12;Castellón/Castelló;029;Benlloch;1003;509;494
12;Castellón/Castelló;021;Betxí;5227;2672;2555
12;Castellón/Castelló;031;Borriol;2579;1302;1277
12;Castellón/Castelló;032;Burriana;26067;12783;13284
12;Castellón/Castelló;033;Cabanes;2614;1268;1346
12;Castellón/Castelló;034;Càlig;1801;880;921
12;Castellón/Castelló;036;Canet lo Roig;1099;550;549
12;Castellón/Castelló;037;Castell de Cabres;29;15;14
12;Castellón/Castelló;038;Castellfort;296;155;141
12;Castellón/Castelló;039;Castellnovo;1125;567;558
12;Castellón/Castelló;040;Castellón de la Plana/Castelló de la Plana;135863;66657;69206
12;Castellón/Castelló;041;Castillo de Villamalefa;151;72;79
12;Castellón/Castelló;042;Catí;971;498;473
12;Castellón/Castelló;043;Caudiel;691;348;343
12;Castellón/Castelló;044;Cervera del Maestre;831;408;423
12;Castellón/Castelló;052;Chert/Xert;1090;527;563
12;Castellón/Castelló;053;Chilches/Xilxes;2175;1086;1089
12;Castellón/Castelló;055;Chodos/Xodos;153;85;68
12;Castellón/Castelló;056;Chóvar;421;218;203
12;Castellón/Castelló;045;Cinctorres;635;289;346
12;Castellón/Castelló;046;Cirat;364;181;183
12;Castellón/Castelló;048;Cortes de Arenoso;425;229;196
12;Castellón/Castelló;049;Costur;486;247;239
12;Castellón/Castelló;050;Coves de Vinromà (les);2012;1002;1010
12;Castellón/Castelló;051;Culla;1010;502;508
12;Castellón/Castelló;057;Eslida;848;417;431
12;Castellón/Castelló;058;Espadilla;54;21;33
12;Castellón/Castelló;059;Fanzara;287;139;148
12;Castellón/Castelló;060;Figueroles;600;296;304
12;Castellón/Castelló;061;Forcall;645;309;336
12;Castellón/Castelló;063;Fuente la Reina;39;21;18
12;Castellón/Castelló;064;Fuentes de Ayódar;86;46;40
12;Castellón/Castelló;065;Gaibiel;253;125;128
12;Castellón/Castelló;066;Gatova;549;261;288
12;Castellón/Castelló;067;Geldo;745;374;371
12;Castellón/Castelló;068;Herbés;142;75;67
12;Castellón/Castelló;069;Higueras;42;23;19
12;Castellón/Castelló;070;Jana (La);955;484;471
12;Castellón/Castelló;071;Jérica;1699;865;834
12;Castellón/Castelló;074;Llosa (La);959;479;480
12;Castellón/Castelló;072;Lucena del Cid;1715;834;881
12;Castellón/Castelló;073;Ludiente;274;136;138
12;Castellón/Castelló;075;Mata de Morella (La);204;103;101
12;Castellón/Castelló;076;Matet;153;80;73
12;Castellón/Castelló;077;Moncofa;3571;1779;1792
12;Castellón/Castelló;078;Montán;389;194;195
12;Castellón/Castelló;079;Montanejos;443;223;220
12;Castellón/Castelló;080;Morella;2996;1439;1557
12;Castellón/Castelló;081;Navajas;494;238;256
12;Castellón/Castelló;082;Nules;11549;5682;5867
12;Castellón/Castelló;083;Olocau del Rey;166;92;74
12;Castellón/Castelló;084;Onda;18351;9153;9198
12;Castellón/Castelló;085;Oropesa del Mar/Orpesa;2292;1173;1119
12;Castellón/Castelló;087;Palanques;24;15;9
12;Castellón/Castelló;088;Pavías;74;40;34
12;Castellón/Castelló;089;Peñíscola;3585;1799;1786
12;Castellón/Castelló;090;Pina de Montalgrao;225;128;97
12;Castellón/Castelló;093;Pobla de Benifassà (La);244;120;124
12;Castellón/Castelló;094;Pobla Tornesa (La);503;247;256
12;Castellón/Castelló;091;Portell de Morella;316;164;152
12;Castellón/Castelló;092;Puebla de Arenoso;225;111;114
12;Castellón/Castelló;095;Ribesalbes;1359;666;693
12;Castellón/Castelló;096;Rossell;1276;647;629
12;Castellón/Castelló;097;Sacañet;79;38;41
12;Castellón/Castelló;098;Salzadella (La);916;441;475
12;Castellón/Castelló;101;San Rafael del Río;502;250;252
12;Castellón/Castelló;902;Sant Joan de Moró;"";"";""
12;Castellón/Castelló;099;Sant Jordi/San Jorge;600;292;308
12;Castellón/Castelló;100;Sant Mateu;1885;909;976
12;Castellón/Castelló;102;Santa Magdalena de Pulpis;757;391;366
12;Castellón/Castelló;103;Sarratella;123;66;57
12;Castellón/Castelló;104;Segorbe;7788;3806;3982
12;Castellón/Castelló;105;Sierra Engarcerán;1177;618;559
12;Castellón/Castelló;106;Soneja;1490;750;740
12;Castellón/Castelló;107;Sot de Ferrer;422;208;214
12;Castellón/Castelló;108;Sueras/Suera;605;302;303
12;Castellón/Castelló;109;Tales;772;365;407
12;Castellón/Castelló;110;Teresa;464;238;226
12;Castellón/Castelló;111;Tírig;675;326;349
12;Castellón/Castelló;112;Todolella;160;83;77
12;Castellón/Castelló;113;Toga;111;48;63
12;Castellón/Castelló;114;Torás;308;160;148
12;Castellón/Castelló;115;Toro (El);318;167;151
12;Castellón/Castelló;116;Torralba del Pinar;72;36;36
12;Castellón/Castelló;119;Torre d'En Besora (La);265;142;123
12;Castellón/Castelló;120;Torre Endoménech;309;156;153
12;Castellón/Castelló;117;Torreblanca;4633;2328;2305
12;Castellón/Castelló;118;Torrechiva;62;35;27
12;Castellón/Castelló;121;Traiguera;1670;850;820
12;Castellón/Castelló;122;Useras/Useres (Les);1214;614;600
12;Castellón/Castelló;124;Vall d'Alba;1967;986;981
12;Castellón/Castelló;125;Vall de Almonacid;282;142;140
12;Castellón/Castelló;126;Vall d'Uixó (La);28407;14208;14199
12;Castellón/Castelló;123;Vallat;32;15;17
12;Castellón/Castelló;127;Vallibona;123;59;64
12;Castellón/Castelló;128;Vilafamés;3093;1596;1497
12;Castellón/Castelló;132;Vilanova d'Alcolea;804;399;405
12;Castellón/Castelló;134;Vilar de Canes;221;112;109
12;Castellón/Castelló;129;Villafranca del Cid;2801;1326;1475
12;Castellón/Castelló;130;Villahermosa del Río;542;280;262
12;Castellón/Castelló;131;Villamalur;170;91;79
12;Castellón/Castelló;133;Villanueva de Viver;129;67;62
12;Castellón/Castelló;135;Villarreal/Vila-real;38660;19165;19495
12;Castellón/Castelló;136;Villavieja;3495;1726;1769
12;Castellón/Castelló;137;Villores;97;52;45
12;Castellón/Castelló;138;Vinaròs;19286;9390;9896
12;Castellón/Castelló;139;Vistabella del Maestrazgo;598;289;309
12;Castellón/Castelló;140;Viver;1310;661;649
12;Castellón/Castelló;141;Zorita del Maestrazgo;149;70;79
12;Castellón/Castelló;142;Zucaina;259;141;118
13;Ciudad Real;001;Abenójar;2081;1048;1033
13;Ciudad Real;002;Agudo;2402;1199;1203
13;Ciudad Real;003;Alamillo;774;397;377
13;Ciudad Real;004;Albaladejo;1989;974;1015
13;Ciudad Real;005;Alcázar de San Juan;26581;12945;13636
13;Ciudad Real;006;Alcoba;904;454;450
13;Ciudad Real;007;Alcolea de Calatrava;1597;792;805
13;Ciudad Real;008;Alcubillas;843;409;434
13;Ciudad Real;009;Aldea del Rey;2529;1218;1311
13;Ciudad Real;010;Alhambra;1472;749;723
13;Ciudad Real;011;Almadén;8920;4292;4628
13;Ciudad Real;012;Almadenejos;774;405;369
13;Ciudad Real;013;Almagro;8446;4042;4404
13;Ciudad Real;014;Almedina;984;472;512
13;Ciudad Real;015;Almodóvar del Campo;8553;4293;4260
13;Ciudad Real;016;Almuradiel;830;403;427
13;Ciudad Real;017;Anchuras;526;276;250
13;Ciudad Real;903;Arenales de San Gregorio;"";"";""
13;Ciudad Real;018;Arenas de San Juan;1069;543;526
13;Ciudad Real;019;Argamasilla de Alba;7306;3620;3686
13;Ciudad Real;020;Argamasilla de Calatrava;5645;2810;2835
13;Ciudad Real;021;Arroba de los Montes;718;373;345
13;Ciudad Real;022;Ballesteros de Calatrava;684;340;344
13;Ciudad Real;023;Bolaños de Calatrava;10333;5126;5207
13;Ciudad Real;024;Brazatortas;1460;721;739
13;Ciudad Real;025;Cabezarados;426;218;208
13;Ciudad Real;026;Cabezarrubias del Puerto;793;408;385
13;Ciudad Real;027;Calzada de Calatrava;5183;2552;2631
13;Ciudad Real;028;Campo de Criptana;13997;6868;7129
13;Ciudad Real;029;Cañada de Calatrava;111;62;49
13;Ciudad Real;030;Caracuel de Calatrava;207;108;99
13;Ciudad Real;031;Carrión de Calatrava;2509;1206;1303
13;Ciudad Real;032;Carrizosa;1839;918;921
13;Ciudad Real;033;Castellar de Santiago;2527;1227;1300
13;Ciudad Real;038;Chillón;2729;1312;1417
13;Ciudad Real;034;Ciudad Real;58175;27714;30461
13;Ciudad Real;035;Corral de Calatrava;1379;680;699
13;Ciudad Real;036;Cortijos (Los);1234;612;622
13;Ciudad Real;037;Cózar;1562;747;815
13;Ciudad Real;039;Daimiel;17312;8421;8891
13;Ciudad Real;040;Fernán Caballero;1091;515;576
13;Ciudad Real;041;Fontanarejo;496;257;239
13;Ciudad Real;042;Fuencaliente;1457;785;672
13;Ciudad Real;043;Fuenllana;361;156;205
13;Ciudad Real;044;Fuente el Fresno;3681;1786;1895
13;Ciudad Real;045;Granátula de Calatrava;1168;558;610
13;Ciudad Real;046;Guadalmez;1153;594;559
13;Ciudad Real;047;Herencia;7151;3539;3612
13;Ciudad Real;048;Hinojosas de Calatrava;1009;487;522
13;Ciudad Real;049;Horcajo de los Montes;1186;600;586
13;Ciudad Real;050;Labores (Las);698;339;359
13;Ciudad Real;904;Llanos del Caudillo;"";"";""
13;Ciudad Real;051;Luciana;536;273;263
13;Ciudad Real;052;Malagón;8205;4042;4163
13;Ciudad Real;053;Manzanares;18178;8875;9303
13;Ciudad Real;054;Membrilla;6824;3406;3418
13;Ciudad Real;055;Mestanza;1226;599;627
13;Ciudad Real;056;Miguelturra;7351;3617;3734
13;Ciudad Real;057;Montiel;1730;854;876
13;Ciudad Real;058;Moral de Calatrava;5328;2579;2749
13;Ciudad Real;059;Navalpino;382;190;192
13;Ciudad Real;060;Navas de Estena;505;271;234
13;Ciudad Real;061;Pedro Muñoz;7305;3667;3638
13;Ciudad Real;062;Picón;622;328;294
13;Ciudad Real;063;Piedrabuena;5178;2603;2575
13;Ciudad Real;064;Poblete;673;344;329
13;Ciudad Real;065;Porzuna;4119;2075;2044
13;Ciudad Real;066;Pozuelo de Calatrava;2341;1138;1203
13;Ciudad Real;067;Pozuelos de Calatrava (Los);659;347;312
13;Ciudad Real;068;Puebla de Don Rodrigo;1393;732;661
13;Ciudad Real;069;Puebla del Príncipe;1137;581;556
13;Ciudad Real;070;Puerto Lápice;1029;510;519
13;Ciudad Real;071;Puertollano;52154;25481;26673
13;Ciudad Real;072;Retuerta del Bullaque;1106;578;528
13;Ciudad Real;901;Robledo (El);1279;670;609
13;Ciudad Real;902;Ruidera;"";"";""
13;Ciudad Real;073;Saceruela;843;440;403
13;Ciudad Real;074;San Carlos del Valle;1288;652;636
13;Ciudad Real;075;San Lorenzo de Calatrava;428;221;207
13;Ciudad Real;076;Santa Cruz de los Cáñamos;703;351;352
13;Ciudad Real;077;Santa Cruz de Mudela;4999;2416;2583
13;Ciudad Real;078;Socuéllamos;11824;5781;6043
13;Ciudad Real;080;Solana del Pino;751;370;381
13;Ciudad Real;079;Solana (La);14707;7317;7390
13;Ciudad Real;081;Terrinches;1159;567;592
13;Ciudad Real;082;Tomelloso;28690;14063;14627
13;Ciudad Real;083;Torralba de Calatrava;3114;1511;1603
13;Ciudad Real;084;Torre de Juan Abad;1926;939;987
13;Ciudad Real;085;Torrenueva;3314;1639;1675
13;Ciudad Real;086;Valdemanco del Esteras;351;181;170
13;Ciudad Real;087;Valdepeñas;25862;12499;13363
13;Ciudad Real;088;Valenzuela de Calatrava;840;401;439
13;Ciudad Real;089;Villahermosa;3211;1497;1714
13;Ciudad Real;090;Villamanrique;1996;979;1017
13;Ciudad Real;091;Villamayor de Calatrava;831;412;419
13;Ciudad Real;092;Villanueva de la Fuente;3124;1532;1592
13;Ciudad Real;093;Villanueva de los Infantes;6344;3029;3315
13;Ciudad Real;094;Villanueva de San Carlos;574;280;294
13;Ciudad Real;095;Villar del Pozo;107;54;53
13;Ciudad Real;096;Villarrubia de los Ojos;9647;4802;4845
13;Ciudad Real;097;Villarta de San Juan;3037;1503;1534
13;Ciudad Real;098;Viso del Marqués;3386;1664;1722
14;Córdoba;001;Adamuz;4623;2312;2311
14;Córdoba;002;Aguilar de la Frontera;13304;6575;6729
14;Córdoba;003;Alcaracejos;1511;762;749
14;Córdoba;004;Almedinilla;2739;1358;1381
14;Córdoba;005;Almodóvar del Río;7116;3554;3562
14;Córdoba;006;Añora;1814;861;953
14;Córdoba;007;Baena;19322;9561;9761
14;Córdoba;008;Belalcázar;4206;2045;2161
14;Córdoba;009;Belmez;4653;2228;2425
14;Córdoba;010;Benamejí;4782;2363;2419
14;Córdoba;011;Blázquez (Los);810;412;398
14;Córdoba;012;Bujalance;8896;4399;4497
14;Córdoba;013;Cabra;20532;10017;10515
14;Córdoba;015;Carcabuey;3010;1472;1538
14;Córdoba;016;Cardeña;2163;1084;1079
14;Córdoba;017;Carlota (La);9300;4668;4632
14;Córdoba;018;Carpio (El);4838;2367;2471
14;Córdoba;019;Castro del Río;7974;3899;4075
14;Córdoba;014;Cañete de las Torres;3541;1780;1761
14;Córdoba;020;Conquista;584;287;297
14;Córdoba;021;Córdoba;307275;148573;158702
14;Córdoba;023;Dos Torres;2497;1221;1276
14;Córdoba;022;Doña Mencía;5160;2535;2625
14;Córdoba;024;Encinas Reales;2317;1132;1185
14;Córdoba;025;Espejo;5157;2548;2609
14;Córdoba;026;Espiel;2833;1409;1424
14;Córdoba;027;Fernán-Núñez;9402;4681;4721
14;Córdoba;029;Fuente Obejuna;6833;3450;3383
14;Córdoba;030;Fuente Palmera;9473;4812;4661
14;Córdoba;028;Fuente la Lancha;500;243;257
14;Córdoba;031;Fuente-Tójar;920;448;472
14;Córdoba;032;Granjuela (La);551;285;266
14;Córdoba;033;Guadalcázar;1313;670;643
14;Córdoba;034;Guijo (El);512;256;256
14;Córdoba;035;Hinojosa del Duque;8234;3936;4298
14;Córdoba;036;Hornachuelos;5439;2797;2642
14;Córdoba;037;Iznájar;6057;3032;3025
14;Córdoba;038;Lucena;33093;16545;16548
14;Córdoba;039;Luque;3509;1745;1764
14;Córdoba;040;Montalbán de Córdoba;4528;2268;2260
14;Córdoba;041;Montemayor;3821;1940;1881
14;Córdoba;042;Montilla;22699;11244;11455
14;Córdoba;043;Montoro;9959;4871;5088
14;Córdoba;044;Monturque;2005;1023;982
14;Córdoba;045;Moriles;3714;1852;1862
14;Córdoba;046;Nueva Carteya;5848;2929;2919
14;Córdoba;047;Obejo;1497;742;755
14;Córdoba;048;Palenciana;1754;874;880
14;Córdoba;049;Palma del Río;18966;9427;9539
14;Córdoba;050;Pedro Abad;3036;1489;1547
14;Córdoba;051;Pedroche;1872;928;944
14;Córdoba;052;Peñarroya-Pueblonuevo;14246;6813;7433
14;Córdoba;053;Posadas;7135;3585;3550
14;Córdoba;054;Pozoblanco;15014;7165;7849
14;Córdoba;055;Priego de Córdoba;21762;10668;11094
14;Córdoba;056;Puente Genil;27739;13565;14174
14;Córdoba;057;Rambla (La);7166;3553;3613
14;Córdoba;058;Rute;9909;4828;5081
14;Córdoba;059;San Sebastián de los Ballesteros;838;437;401
14;Córdoba;061;Santa Eufemia;1354;678;676
14;Córdoba;060;Santaella;5867;2937;2930
14;Córdoba;062;Torrecampo;1643;788;855
14;Córdoba;063;Valenzuela;1668;786;882
14;Córdoba;064;Valsequillo;627;311;316
14;Córdoba;065;Victoria (La);1752;873;879
14;Córdoba;066;Villa del Río;7158;3608;3550
14;Córdoba;067;Villafranca de Córdoba;3668;1866;1802
14;Córdoba;068;Villaharta;668;315;353
14;Córdoba;069;Villanueva de Córdoba;10548;5115;5433
14;Córdoba;070;Villanueva del Duque;2133;982;1151
14;Córdoba;071;Villanueva del Rey;1395;723;672
14;Córdoba;072;Villaralto;1849;871;978
14;Córdoba;073;Villaviciosa de Córdoba;4319;2199;2120
14;Córdoba;074;Viso (El);3572;1754;1818
14;Córdoba;075;Zuheros;1023;497;526
15;Coruña (A);001;Abegondo;6140;3045;3095
15;Coruña (A);002;Ames;10162;4904;5258
15;Coruña (A);003;Aranga;2644;1303;1341
15;Coruña (A);004;Ares;4788;2273;2515
15;Coruña (A);005;Arteixo;17923;9019;8904
15;Coruña (A);006;Arzúa;7292;3633;3659
15;Coruña (A);007;Baña (A);7311;3572;3739
15;Coruña (A);008;Bergondo;5638;2735;2903
15;Coruña (A);009;Betanzos;11991;5632;6359
15;Coruña (A);010;Boimorto;3223;1626;1597
15;Coruña (A);011;Boiro;18136;8776;9360
15;Coruña (A);012;Boqueixón;4990;2481;2509
15;Coruña (A);013;Brión;7033;3397;3636
15;Coruña (A);014;Cabana de Bergantiños;7201;3622;3579
15;Coruña (A);015;Cabanas;3316;1597;1719
15;Coruña (A);016;Camariñas;7577;3789;3788
15;Coruña (A);017;Cambre;11838;5736;6102
15;Coruña (A);018;Capela (A);1823;917;906
15;Coruña (A);019;Carballo;28127;13953;14174
15;Coruña (A);901;Cariño;5860;2892;2968
15;Coruña (A);020;Carnota;7063;3430;3633
15;Coruña (A);021;Carral;5608;2781;2827
15;Coruña (A);022;Cedeira;8024;3943;4081
15;Coruña (A);023;Cee;7892;3858;4034
15;Coruña (A);024;Cerceda;7201;3529;3672
15;Coruña (A);025;Cerdido;2063;1000;1063
15;Coruña (A);026;Cesuras;3198;1584;1614
15;Coruña (A);027;Coirós;1652;819;833
15;Coruña (A);028;Corcubión;2097;1020;1077
15;Coruña (A);029;Coristanco;10118;5143;4975
15;Coruña (A);030;A Coruña;256579;120909;135670
15;Coruña (A);031;Culleredo;13917;6767;7150
15;Coruña (A);032;Curtis;5087;2518;2569
15;Coruña (A);033;Dodro;3641;1758;1883
15;Coruña (A);034;Dumbría;4991;2479;2512
15;Coruña (A);035;Fene;15762;7750;8012
15;Coruña (A);036;Ferrol;86272;40795;45477
15;Coruña (A);037;Fisterra;5568;2799;2769
15;Coruña (A);038;Frades;3617;1836;1781
15;Coruña (A);039;Irixoa;1990;954;1036
15;Coruña (A);041;Laracha (A);11989;5976;6013
15;Coruña (A);040;Laxe;3869;1933;1936
15;Coruña (A);042;Lousame;4992;2413;2579
15;Coruña (A);043;Malpica de Bergantiños;8434;4157;4277
15;Coruña (A);045;Mazaricos;7155;3473;3682
15;Coruña (A);044;Mañón;2450;1191;1259
15;Coruña (A);046;Melide;8386;4163;4223
15;Coruña (A);047;Mesía;4159;2057;2102
15;Coruña (A);048;Miño;5236;2483;2753
15;Coruña (A);049;Moeche;1883;907;976
15;Coruña (A);050;Monfero;3172;1620;1552
15;Coruña (A);051;Mugardos;6857;3313;3544
15;Coruña (A);053;Muros;12001;5800;6201
15;Coruña (A);052;Muxía;7126;3511;3615
15;Coruña (A);054;Narón;31353;15264;16089
15;Coruña (A);055;Neda;6688;3180;3508
15;Coruña (A);056;Negreira;7221;3428;3793
15;Coruña (A);057;Noia;15041;7311;7730
15;Coruña (A);058;Oleiros;18067;8851;9216
15;Coruña (A);059;Ordes;12158;5944;6214
15;Coruña (A);060;Oroso;4110;2019;2091
15;Coruña (A);061;Ortigueira;10420;4975;5445
15;Coruña (A);062;Outes;10047;4783;5264
15;Coruña (A);063;Oza dos Ríos;3467;1697;1770
15;Coruña (A);064;Paderne;2994;1425;1569
15;Coruña (A);065;Padrón;10442;5090;5352
15;Coruña (A);066;Pino (O);5585;2772;2813
15;Coruña (A);067;Pobra do Caramiñal (A);10432;4996;5436
15;Coruña (A);068;Ponteceso;8541;4316;4225
15;Coruña (A);069;Pontedeume;8711;4227;4484
15;Coruña (A);070;Pontes de García Rodríguez (As);13717;6994;6723
15;Coruña (A);071;Porto do Son;11079;5424;5655
15;Coruña (A);072;Rianxo;13159;6475;6684
15;Coruña (A);073;Ribeira;26258;12939;13319
15;Coruña (A);074;Rois;6026;2959;3067
15;Coruña (A);075;Sada;8796;4230;4566
15;Coruña (A);076;San Sadurniño;3978;1934;2044
15;Coruña (A);077;Santa Comba;12047;5890;6157
15;Coruña (A);078;Santiago de Compostela;91419;43469;47950
15;Coruña (A);079;Santiso;2758;1438;1320
15;Coruña (A);080;Sobrado;3067;1585;1482
15;Coruña (A);081;Somozas (As);1784;881;903
15;Coruña (A);082;Teo;12156;5952;6204
15;Coruña (A);083;Toques;2125;1087;1038
15;Coruña (A);084;Tordoia;6044;2911;3133
15;Coruña (A);085;Touro;5411;2675;2736
15;Coruña (A);086;Trazo;4985;2531;2454
15;Coruña (A);088;Val do Dubra;6121;3020;3101
15;Coruña (A);087;Valdoviño;7109;3460;3649
15;Coruña (A);089;Vedra;5714;2769;2945
15;Coruña (A);091;Vilarmaior;1544;749;795
15;Coruña (A);090;Vilasantar;2256;1147;1109
15;Coruña (A);092;Vimianzo;9686;4796;4890
15;Coruña (A);093;Zas;6995;3411;3584
16;Cuenca;001;Abia de la Obispalía;117;64;53
16;Cuenca;002;Acebrón (El);326;161;165
16;Cuenca;003;Alarcón;233;119;114
16;Cuenca;004;Albaladejo del Cuende;486;262;224
16;Cuenca;005;Albalate de las Nogueras;449;240;209
16;Cuenca;006;Albendea;224;114;110
16;Cuenca;007;Alberca de Záncara (La);1978;978;1000
16;Cuenca;008;Alcalá de la Vega;227;122;105
16;Cuenca;009;Alcantud;169;91;78
16;Cuenca;011;Alcohujate;81;41;40
16;Cuenca;012;Alconchel de la Estrella;258;127;131
16;Cuenca;010;Alcázar del Rey;293;149;144
16;Cuenca;013;Algarra;43;21;22
16;Cuenca;014;Aliaguilla;964;488;476
16;Cuenca;015;Almarcha (La);716;353;363
16;Cuenca;016;Almendros;470;238;232
16;Cuenca;017;Almodóvar del Pinar;628;328;300
16;Cuenca;018;Almonacid del Marquesado;603;313;290
16;Cuenca;019;Altarejos;476;243;233
16;Cuenca;020;Arandilla del Arroyo;68;37;31
16;Cuenca;905;Arcas del Villar;391;195;196
16;Cuenca;022;Arcos de la Sierra;147;81;66
16;Cuenca;024;Arguisuelas;241;122;119
16;Cuenca;025;Arrancacepas;46;23;23
16;Cuenca;026;Atalaya del Cañavate;150;74;76
16;Cuenca;027;Barajas de Melo;805;394;411
16;Cuenca;029;Barchín del Hoyo;186;102;84
16;Cuenca;030;Bascuñana de San Pedro;36;20;16
16;Cuenca;031;Beamud;99;55;44
16;Cuenca;032;Belinchón;364;176;188
16;Cuenca;033;Belmonte;2751;1274;1477
16;Cuenca;034;Belmontejo;328;168;160
16;Cuenca;035;Beteta;474;237;237
16;Cuenca;036;Boniches;264;125;139
16;Cuenca;038;Buciegas;118;62;56
16;Cuenca;039;Buenache de Alarcón;705;362;343
16;Cuenca;040;Buenache de la Sierra;115;71;44
16;Cuenca;041;Buendía;456;223;233
16;Cuenca;042;Campillo de Altobuey;1871;929;942
16;Cuenca;043;Campillos-Paravientos;176;92;84
16;Cuenca;044;Campillos-Sierra;104;55;49
16;Cuenca;901;Campos del Paraíso;1469;681;788
16;Cuenca;045;Canalejas del Arroyo;439;223;216
16;Cuenca;055;Carboneras de Guadazaón;1090;577;513
16;Cuenca;056;Cardenete;782;397;385
16;Cuenca;057;Carrascosa;163;87;76
16;Cuenca;058;Carrascosa de Haro;190;96;94
16;Cuenca;060;Casas de Benítez;1212;586;626
16;Cuenca;061;Casas de Fernando Alonso;1468;720;748
16;Cuenca;062;Casas de Garcimolina;43;18;25
16;Cuenca;063;Casas de Guijarro;208;106;102
16;Cuenca;064;Casas de Haro;944;462;482
16;Cuenca;065;Casas de los Pinos;598;299;299
16;Cuenca;066;Casasimarro;3090;1548;1542
16;Cuenca;067;Castejón;283;153;130
16;Cuenca;068;Castillejo de Iniesta;210;116;94
16;Cuenca;070;Castillejo-Sierra;62;30;32
16;Cuenca;072;Castillo de Garcimuñoz;312;165;147
16;Cuenca;071;Castillo-Albaráñez;38;20;18
16;Cuenca;047;Cañada Juncosa;418;221;197
16;Cuenca;046;Cañada del Hoyo;432;221;211
16;Cuenca;048;Cañamares;646;351;295
16;Cuenca;049;Cañavate (El);338;173;165
16;Cuenca;050;Cañaveras;477;240;237
16;Cuenca;051;Cañaveruelas;283;147;136
16;Cuenca;052;Cañete;917;459;458
16;Cuenca;053;Cañizares;700;380;320
16;Cuenca;073;Cervera del Llano;385;198;187
16;Cuenca;023;Chillarón de Cuenca;305;156;149
16;Cuenca;081;Chumillas;66;37;29
16;Cuenca;074;Cierva (La);64;36;28
16;Cuenca;078;Cuenca;43209;20896;22313
16;Cuenca;079;Cueva del Hierro;55;33;22
16;Cuenca;082;Enguídanos;748;381;367
16;Cuenca;083;Fresneda de Altarejos;104;61;43
16;Cuenca;084;Fresneda de la Sierra;100;49;51
16;Cuenca;085;Frontera (La);301;157;144
16;Cuenca;086;Fuente de Pedro Naharro;1300;652;648
16;Cuenca;087;Fuentelespino de Haro;430;234;196
16;Cuenca;088;Fuentelespino de Moya;177;83;94
16;Cuenca;904;Fuentenava de Jábaga;274;143;131
16;Cuenca;089;Fuentes;606;317;289
16;Cuenca;091;Fuertescusa;136;65;71
16;Cuenca;092;Gabaldón;203;117;86
16;Cuenca;093;Garaballa;225;116;109
16;Cuenca;094;Gascueña;198;95;103
16;Cuenca;095;Graja de Campalbo;153;90;63
16;Cuenca;096;Graja de Iniesta;392;208;184
16;Cuenca;097;Henarejos;396;191;205
16;Cuenca;098;Herrumblar (El);798;402;396
16;Cuenca;099;Hinojosa (La);409;196;213
16;Cuenca;100;Hinojosos (Los);1344;661;683
16;Cuenca;101;Hito (El);281;142;139
16;Cuenca;102;Honrubia;1725;865;860
16;Cuenca;103;Hontanaya;607;305;302
16;Cuenca;104;Hontecillas;112;52;60
16;Cuenca;106;Horcajo de Santiago;3683;1829;1854
16;Cuenca;108;Huelves;86;40;46
16;Cuenca;110;Huerta de la Obispalía;198;114;84
16;Cuenca;111;Huerta del Marquesado;183;93;90
16;Cuenca;112;Huete;2518;1270;1248
16;Cuenca;107;Huélamo;141;75;66
16;Cuenca;109;Huérguina;100;49;51
16;Cuenca;113;Iniesta;3684;1817;1867
16;Cuenca;115;Laguna del Marquesado;85;47;38
16;Cuenca;116;Lagunaseca;108;52;56
16;Cuenca;117;Landete;1679;832;847
16;Cuenca;118;Ledaña;2154;1089;1065
16;Cuenca;119;Leganiel;318;152;166
16;Cuenca;121;Majadas (Las);421;223;198
16;Cuenca;122;Mariana;328;156;172
16;Cuenca;123;Masegosa;152;76;76
16;Cuenca;124;Mesas (Las);2692;1364;1328
16;Cuenca;125;Minglanilla;2367;1190;1177
16;Cuenca;126;Mira;1277;646;631
16;Cuenca;128;Monreal del Llano;103;54;49
16;Cuenca;129;Montalbanejo;248;118;130
16;Cuenca;130;Montalbo;884;474;410
16;Cuenca;131;Monteagudo de las Salinas;134;73;61
16;Cuenca;132;Mota de Altarejos;85;45;40
16;Cuenca;133;Mota del Cuervo;5663;2785;2878
16;Cuenca;134;Motilla del Palancar;4767;2385;2382
16;Cuenca;135;Moya;383;202;181
16;Cuenca;137;Narboneta;98;50;48
16;Cuenca;139;Olivares de Júcar;738;362;376
16;Cuenca;140;Olmeda de la Cuesta;70;37;33
16;Cuenca;141;Olmeda del Rey;290;138;152
16;Cuenca;142;Olmedilla de Alarcón;274;142;132
16;Cuenca;143;Olmedilla de Eliz;39;22;17
16;Cuenca;145;Osa de la Vega;784;395;389
16;Cuenca;147;Pajaroncillo;119;63;56
16;Cuenca;146;Pajarón;164;85;79
16;Cuenca;148;Palomares del Campo;1066;534;532
16;Cuenca;149;Palomera;139;68;71
16;Cuenca;150;Paracuellos;237;122;115
16;Cuenca;151;Paredes;82;46;36
16;Cuenca;152;Parra de las Vegas (La);79;38;41
16;Cuenca;153;Pedernoso (El);1435;706;729
16;Cuenca;154;Pedroñeras (Las);6602;3341;3261
16;Cuenca;155;Peral (El);755;384;371
16;Cuenca;156;Peraleja (La);244;126;118
16;Cuenca;157;Pesquera (La);355;189;166
16;Cuenca;158;Picazo (El);770;374;396
16;Cuenca;159;Pinarejo;634;323;311
16;Cuenca;160;Pineda de Gigüela;225;116;109
16;Cuenca;161;Piqueras del Castillo;111;63;48
16;Cuenca;162;Portalrubio de Guadamejud;131;62;69
16;Cuenca;163;Portilla;122;60;62
16;Cuenca;165;Poyatos;134;74;60
16;Cuenca;166;Pozoamargo;394;191;203
16;Cuenca;908;Pozorrubielos de la Mancha;323;163;160
16;Cuenca;167;Pozorrubio;548;264;284
16;Cuenca;169;Pozuelo (El);117;57;60
16;Cuenca;170;Priego;1213;624;589
16;Cuenca;171;Provencio (El);2844;1407;1437
16;Cuenca;172;Puebla de Almenara;714;371;343
16;Cuenca;173;Puebla de Don Francisco;490;251;239
16;Cuenca;174;Puebla del Salvador;371;201;170
16;Cuenca;175;Quintanar del Rey;5666;2896;2770
16;Cuenca;176;Rada de Haro;76;37;39
16;Cuenca;177;Reíllo;166;79;87
16;Cuenca;181;Rozalén del Monte;183;87;96
16;Cuenca;185;Saceda-Trasierra;67;31;36
16;Cuenca;186;Saelices;835;418;417
16;Cuenca;187;Salinas del Manzano;160;88;72
16;Cuenca;188;Salmeroncillos;209;110;99
16;Cuenca;189;Salvacañete;382;206;176
16;Cuenca;190;San Clemente;6401;3179;3222
16;Cuenca;191;San Lorenzo de la Parrilla;1796;900;896
16;Cuenca;192;San Martín de Boniches;101;51;50
16;Cuenca;193;San Pedro Palmiches;133;78;55
16;Cuenca;194;Santa Cruz de Moya;489;254;235
16;Cuenca;196;Santa María de los Llanos;931;464;467
16;Cuenca;195;Santa María del Campo Rus;1077;541;536
16;Cuenca;197;Santa María del Val;151;77;74
16;Cuenca;198;Sisante;1963;1003;960
16;Cuenca;199;Solera de Gabaldón;54;32;22
16;Cuenca;909;Sotorribas;1077;554;523
16;Cuenca;202;Talayuelas;1299;677;622
16;Cuenca;203;Tarancón;10708;5333;5375
16;Cuenca;205;Tejadillos;216;105;111
16;Cuenca;206;Tinajas;470;247;223
16;Cuenca;209;Torralba;266;134;132
16;Cuenca;211;Torrejoncillo del Rey;938;456;482
16;Cuenca;212;Torrubia del Campo;401;190;211
16;Cuenca;213;Torrubia del Castillo;60;30;30
16;Cuenca;215;Tragacete;426;230;196
16;Cuenca;216;Tresjuncos;648;319;329
16;Cuenca;217;Tribaldos;183;92;91
16;Cuenca;204;Tébar;505;265;240
16;Cuenca;218;Uclés;358;169;189
16;Cuenca;219;Uña;152;74;78
16;Cuenca;906;Valdecolmenas (Los);187;92;95
16;Cuenca;224;Valdemeca;104;59;45
16;Cuenca;225;Valdemorillo de la Sierra;106;53;53
16;Cuenca;227;Valdemoro-Sierra;204;115;89
16;Cuenca;228;Valdeolivas;345;181;164
16;Cuenca;902;Valdetórtola;209;110;99
16;Cuenca;903;Valeras (Las);1534;775;759
16;Cuenca;231;Valhermoso de la Fuente;78;37;41
16;Cuenca;234;Valsalobre;77;38;39
16;Cuenca;236;Valverde de Júcar;1556;778;778
16;Cuenca;237;Valverdejo;177;90;87
16;Cuenca;238;Vara de Rey;938;468;470
16;Cuenca;239;Vega del Codorno;291;146;145
16;Cuenca;240;Vellisca;248;121;127
16;Cuenca;242;Villaconejos de Trabaque;578;298;280
16;Cuenca;243;Villaescusa de Haro;638;320;318
16;Cuenca;244;Villagarcía del Llano;1015;513;502
16;Cuenca;245;Villalba de la Sierra;531;283;248
16;Cuenca;246;Villalba del Rey;900;472;428
16;Cuenca;247;Villalgordo del Marquesado;199;98;101
16;Cuenca;248;Villalpardo;1159;591;568
16;Cuenca;249;Villamayor de Santiago;2972;1473;1499
16;Cuenca;250;Villanueva de Guadamejud;169;74;95
16;Cuenca;251;Villanueva de la Jara;2543;1273;1270
16;Cuenca;253;Villar de Cañas;534;266;268
16;Cuenca;254;Villar de Domingo García;290;147;143
16;Cuenca;263;Villar de Olalla;822;413;409
16;Cuenca;255;Villar de la Encina;260;128;132
16;Cuenca;258;Villar del Humo;513;268;245
16;Cuenca;259;Villar del Infantado;74;44;30
16;Cuenca;910;Villar y Velasco;182;100;82
16;Cuenca;264;Villarejo de Fuentes;952;467;485
16;Cuenca;265;Villarejo de la Peñuela;46;25;21
16;Cuenca;266;Villarejo-Periesteban;594;302;292
16;Cuenca;269;Villares del Saz;989;488;501
16;Cuenca;270;Villarrubio;286;136;150
16;Cuenca;271;Villarta;833;439;394
16;Cuenca;272;Villas de la Ventosa;548;287;261
16;Cuenca;273;Villaverde y Pasaconsol;491;238;253
16;Cuenca;275;Vindel;32;15;17
16;Cuenca;274;Víllora;308;151;157
16;Cuenca;276;Yémeda;56;29;27
16;Cuenca;277;Zafra de Záncara;293;150;143
16;Cuenca;278;Zafrilla;171;87;84
16;Cuenca;279;Zarza de Tajo;338;157;181
16;Cuenca;280;Zarzuela;367;177;190
17;Girona;001;Agullana;711;372;339
17;Girona;002;Aiguaviva;388;191;197
17;Girona;003;Albanyà;108;59;49
17;Girona;004;Albons;485;252;233
17;Girona;006;Alp;930;482;448
17;Girona;007;Amer;2432;1204;1228
17;Girona;008;Anglès;5241;2651;2590
17;Girona;009;Arbúcies;4562;2269;2293
17;Girona;010;Argelaguer;349;174;175
17;Girona;011;Armentera (L');808;375;433
17;Girona;012;Avinyonet de Puigventós;391;201;190
17;Girona;015;Banyoles;13490;6576;6914
17;Girona;016;Bàscara;770;401;369
17;Girona;013;Begur;2740;1380;1360
17;Girona;018;Bellcaire d'Empordà;496;246;250
17;Girona;019;Besalú;2123;1030;1093
17;Girona;020;Bescanó;2871;1434;1437
17;Girona;021;Beuda;112;61;51
17;Girona;022;Bisbal d'Empordà (La);8091;3996;4095
17;Girona;234;Biure;273;138;135
17;Girona;023;Blanes;25632;12834;12798
17;Girona;029;Boadella d'Empordà;241;127;114
17;Girona;024;Bolvir;219;101;118
17;Girona;025;Bordils;1285;634;651
17;Girona;026;Borrassà;510;255;255
17;Girona;027;Breda;3177;1634;1543
17;Girona;028;Brunyola;399;205;194
17;Girona;031;Cabanelles;245;129;116
17;Girona;030;Cabanes;829;438;391
17;Girona;032;Cadaqués;1867;933;934
17;Girona;033;Caldes de Malavella;3160;1570;1590
17;Girona;034;Calonge;5116;2558;2558
17;Girona;035;Camós;624;323;301
17;Girona;036;Campdevànol;3476;1704;1772
17;Girona;037;Campelles;176;88;88
17;Girona;038;Campllong;268;141;127
17;Girona;039;Camprodon;2314;1135;1179
17;Girona;040;Canet d'Adri;473;253;220
17;Girona;041;Cantallops;256;122;134
17;Girona;042;Capmany;442;236;206
17;Girona;044;Cassà de la Selva;7320;3580;3740
17;Girona;046;Castellfollit de la Roca;1033;487;546
17;Girona;047;Castelló d'Empúries;4098;2089;2009
17;Girona;048;Castell-Platja d'Aro;5282;2700;2582
17;Girona;189;Cellera de Ter (La);2044;993;1051
17;Girona;049;Celrà;2436;1200;1236
17;Girona;050;Cervià de Ter;638;310;328
17;Girona;051;Cistella;209;99;110
17;Girona;054;Colera;429;222;207
17;Girona;055;Colomers;210;107;103
17;Girona;057;Corçà;1144;574;570
17;Girona;056;Cornellà del Terri;1824;929;895
17;Girona;058;Crespià;215;110;105
17;Girona;901;Cruïlles, Monells i Sant Sadurní de l'Heura;1031;518;513
17;Girona;060;Darnius;489;264;225
17;Girona;061;Das;153;79;74
17;Girona;062;Escala (L');5406;2781;2625
17;Girona;063;Espinelves;226;118;108
17;Girona;064;Espolla;399;208;191
17;Girona;065;Esponellà;380;177;203
17;Girona;005;Far d'Empordà (El);413;209;204
17;Girona;066;Figueres;34463;16914;17549
17;Girona;067;Flaçà;949;464;485
17;Girona;068;Foixà;318;156;162
17;Girona;069;Fontanals de Cerdanya;321;168;153
17;Girona;070;Fontanilles;123;68;55
17;Girona;071;Fontcoberta;871;446;425
17;Girona;902;Forallac;1554;787;767
17;Girona;073;Fornells de la Selva;1086;526;560
17;Girona;074;Fortià;512;248;264
17;Girona;075;Garrigàs;324;169;155
17;Girona;076;Garrigoles;155;87;68
17;Girona;077;Garriguella;656;352;304
17;Girona;078;Ger;262;133;129
17;Girona;079;Girona;70876;34393;36483
17;Girona;080;Gombrèn;251;124;127
17;Girona;081;Gualta;293;150;143
17;Girona;082;Guils de Cerdanya;275;143;132
17;Girona;083;Hostalric;2827;1378;1449
17;Girona;084;Isòvol;193;96;97
17;Girona;085;Jafre;341;168;173
17;Girona;086;Jonquera (La);2755;1422;1333
17;Girona;087;Juià;264;128;136
17;Girona;088;Lladó;481;248;233
17;Girona;089;Llagostera;5321;2684;2637
17;Girona;090;Llambilles;454;224;230
17;Girona;091;Llanars;396;205;191
17;Girona;092;Llançà;3432;1747;1685
17;Girona;093;Llers;776;393;383
17;Girona;094;Llívia;910;475;435
17;Girona;095;Lloret de Mar;16874;8526;8348
17;Girona;096;Llosses (Les);400;209;191
17;Girona;102;Maçanet de Cabrenys;718;360;358
17;Girona;103;Maçanet de la Selva;2966;1516;1450
17;Girona;097;Madremanya;206;96;110
17;Girona;098;Maià de Montcal;349;171;178
17;Girona;100;Masarac;257;129;128
17;Girona;101;Massanes;473;252;221
17;Girona;099;Meranges;67;37;30
17;Girona;105;Mieres;383;191;192
17;Girona;106;Mollet de Peralada;164;90;74
17;Girona;107;Molló;369;191;178
17;Girona;109;Montagut i Oix;804;418;386
17;Girona;110;Mont-ras;1336;700;636
17;Girona;111;Navata;659;320;339
17;Girona;112;Ogassa;294;167;127
17;Girona;114;Olot;27027;13051;13976
17;Girona;115;Ordis;298;163;135
17;Girona;116;Osor;521;271;250
17;Girona;117;Palafrugell;17014;8553;8461
17;Girona;118;Palamós;13296;6525;6771
17;Girona;119;Palau de Santa Eulàlia;75;36;39
17;Girona;121;Palau-sator;315;165;150
17;Girona;120;Palau-saverdera;724;365;359
17;Girona;122;Palmerola;"";"";""
17;Girona;123;Palol de Revardit;387;200;187
17;Girona;124;Pals;1696;867;829
17;Girona;125;Pardines;130;71;59
17;Girona;126;Parlavà;342;185;157
17;Girona;128;Pau;316;149;167
17;Girona;129;Pedret i Marzà;129;59;70
17;Girona;130;Pera (La);374;184;190
17;Girona;132;Peralada;1192;608;584
17;Girona;133;Planes d'Hostoles (Les);1845;895;950
17;Girona;134;Planoles;286;153;133
17;Girona;135;Pont de Molins;365;192;173
17;Girona;136;Pontós;204;117;87
17;Girona;137;Porqueres;3062;1527;1535
17;Girona;140;Port de la Selva (El);831;409;422
17;Girona;138;Portbou;1957;972;985
17;Girona;139;Preses (Les);1316;646;670
17;Girona;141;Puigcerdà;6475;3322;3153
17;Girona;142;Quart;1969;1006;963
17;Girona;043;Queralbs;216;114;102
17;Girona;143;Rabós;151;71;80
17;Girona;144;Regencós;275;156;119
17;Girona;145;Ribes de Freser;2560;1237;1323
17;Girona;146;Riells i Viabrea;911;458;453
17;Girona;147;Ripoll;11577;5683;5894
17;Girona;148;Riudarenes;1103;556;547
17;Girona;149;Riudaura;387;188;199
17;Girona;150;Riudellots de la Selva;1268;647;621
17;Girona;151;Riumors;203;93;110
17;Girona;152;Roses;11003;5715;5288
17;Girona;153;Rupià;206;108;98
17;Girona;154;Sales de Llierca;53;33;20
17;Girona;155;Salt;21738;10854;10884
17;Girona;157;Sant Andreu Salou;136;73;63
17;Girona;183;Sant Aniol de Finestres;281;138;143
17;Girona;158;Sant Climent Sescebes;469;260;209
17;Girona;159;Sant Feliu de Buixalleu;601;317;284
17;Girona;160;Sant Feliu de Guíxols;17337;8456;8881
17;Girona;161;Sant Feliu de Pallerols;1058;502;556
17;Girona;162;Sant Ferriol;185;102;83
17;Girona;163;Sant Gregori;1857;961;896
17;Girona;164;Sant Hilari Sacalm;4659;2357;2302
17;Girona;165;Sant Jaume de Llierca;776;393;383
17;Girona;167;Sant Joan de les Abadesses;3964;1906;2058
17;Girona;168;Sant Joan de Mollet;311;154;157
17;Girona;185;Sant Joan les Fonts;2911;1455;1456
17;Girona;166;Sant Jordi Desvalls;587;285;302
17;Girona;169;Sant Julià de Ramis;1769;893;876
17;Girona;903;Sant Julià del Llor i Bonmatí;881;426;455
17;Girona;171;Sant Llorenç de la Muga;160;78;82
17;Girona;172;Sant Martí de Llémena;340;182;158
17;Girona;173;Sant Martí Vell;208;103;105
17;Girona;174;Sant Miquel de Campmajor;212;121;91
17;Girona;175;Sant Miquel de Fluvià;563;290;273
17;Girona;176;Sant Mori;142;64;78
17;Girona;177;Sant Pau de Segúries;606;300;306
17;Girona;178;Sant Pere Pescador;1289;678;611
17;Girona;180;Santa Coloma de Farners;8073;4092;3981
17;Girona;181;Santa Cristina d'Aro;1811;961;850
17;Girona;182;Santa Llogaia d'Àlguema;307;160;147
17;Girona;184;Santa Pau;1388;710;678
17;Girona;186;Sarrià de Ter;3403;1687;1716
17;Girona;187;Saus;700;354;346
17;Girona;188;Selva de Mar (La);160;82;78
17;Girona;190;Serinyà;735;364;371
17;Girona;191;Serra de Daró;190;98;92
17;Girona;192;Setcases;170;87;83
17;Girona;193;Sils;2312;1173;1139
17;Girona;052;Siurana;175;78;97
17;Girona;194;Susqueda;121;64;57
17;Girona;195;Tallada d'Empordà (La);352;178;174
17;Girona;196;Terrades;179;81;98
17;Girona;197;Torrent;195;100;95
17;Girona;198;Torroella de Fluvià;287;155;132
17;Girona;199;Torroella de Montgrí;6884;3438;3446
17;Girona;200;Tortellà;706;350;356
17;Girona;201;Toses;175;104;71
17;Girona;202;Tossa de Mar;3754;1888;1866
17;Girona;204;Ullà;736;374;362
17;Girona;205;Ullastret;269;133;136
17;Girona;203;Ultramort;205;102;103
17;Girona;206;Urús;117;58;59
17;Girona;014;Vajol (La);60;31;29
17;Girona;208;Vall de Bianya (La);1067;526;541
17;Girona;207;Vall d'en Bas (La);2612;1343;1269
17;Girona;170;Vallfogona de Ripollès;256;130;126
17;Girona;209;Vall-llobrega;262;135;127
17;Girona;210;Ventalló;547;289;258
17;Girona;211;Verges;1162;571;591
17;Girona;212;Vidrà;175;88;87
17;Girona;213;Vidreres;3776;1905;1871
17;Girona;214;Vilabertran;785;394;391
17;Girona;215;Vilablareix;989;493;496
17;Girona;217;Viladamat;365;194;171
17;Girona;216;Viladasens;183;95;88
17;Girona;218;Vilademuls;792;408;384
17;Girona;220;Viladrau;844;424;420
17;Girona;221;Vilafant;2639;1299;1340
17;Girona;223;Vilajuïga;680;329;351
17;Girona;224;Vilallonga de Ter;436;221;215
17;Girona;225;Vilamacolum;264;124;140
17;Girona;226;Vilamalla;641;324;317
17;Girona;227;Vilamaniscle;122;52;70
17;Girona;228;Vilanant;277;136;141
17;Girona;230;Vila-sacra;438;216;222
17;Girona;222;Vilaür;103;47;56
17;Girona;233;Vilobí d'Onyar;2066;1076;990
17;Girona;232;Vilopriu;177;87;90
18;Granada;001;Agrón;461;232;229
18;Granada;002;Alamedilla;1111;557;554
18;Granada;003;Albolote;9365;4648;4717
18;Granada;004;Albondón;1378;682;696
18;Granada;005;Albuñán;531;270;261
18;Granada;006;Albuñol;5729;2846;2883
18;Granada;007;Albuñuelas;1426;720;706
18;Granada;010;Aldeire;903;450;453
18;Granada;011;Alfacar;3593;1831;1762
18;Granada;012;Algarinejo;5013;2564;2449
18;Granada;013;Alhama de Granada;6124;3108;3016
18;Granada;014;Alhendín;3594;1795;1799
18;Granada;015;Alicún de Ortega;776;394;382
18;Granada;016;Almegíjar;540;274;266
18;Granada;017;Almuñécar;20108;10004;10104
18;Granada;904;Alpujarra de la Sierra;1414;717;697
18;Granada;018;Alquife;1304;635;669
18;Granada;020;Arenas del Rey;2181;1141;1040
18;Granada;021;Armilla;11279;5661;5618
18;Granada;022;Atarfe;10062;4957;5105
18;Granada;023;Baza;21123;10287;10836
18;Granada;024;Beas de Granada;879;448;431
18;Granada;025;Beas de Guadix;468;245;223
18;Granada;027;Benalúa;3520;1779;1741
18;Granada;028;Benalúa de las Villas;1436;698;738
18;Granada;029;Benamaurel;2677;1381;1296
18;Granada;030;Bérchules;976;496;480
18;Granada;032;Bubión;334;168;166
18;Granada;033;Busquístar;425;219;206
18;Granada;034;Cacín;947;489;458
18;Granada;035;Cádiar;2045;1026;1019
18;Granada;036;Cájar;1948;900;1048
18;Granada;114;Calahorra (La);1093;533;560
18;Granada;037;Calicasas;594;284;310
18;Granada;038;Campotéjar;1510;742;768
18;Granada;039;Caniles;5970;2920;3050
18;Granada;040;Cáñar;366;173;193
18;Granada;042;Capileira;615;307;308
18;Granada;043;Carataunas;182;94;88
18;Granada;044;Cástaras;367;186;181
18;Granada;045;Castilléjar;2362;1171;1191
18;Granada;046;Castril;3516;1820;1696
18;Granada;047;Cenes de la Vega;1983;1011;972
18;Granada;059;Chauchina;4007;1982;2025
18;Granada;061;Chimeneas;1629;813;816
18;Granada;062;Churriana de la Vega;5270;2610;2660
18;Granada;048;Cijuela;1243;594;649
18;Granada;049;Cogollos de Guadix;811;444;367
18;Granada;050;Cogollos de la Vega;1960;987;973
18;Granada;051;Colomera;2029;1032;997
18;Granada;053;Cortes de Baza;3166;1618;1548
18;Granada;054;Cortes y Graena;1003;521;482
18;Granada;912;Cuevas del Campo;2588;1295;1293
18;Granada;056;Cúllar;5864;2876;2988
18;Granada;057;Cúllar Vega;1599;804;795
18;Granada;063;Darro;1670;812;858
18;Granada;064;Dehesas de Guadix;965;480;485
18;Granada;066;Deifontes;2530;1296;1234
18;Granada;067;Diezma;1151;600;551
18;Granada;068;Dílar;1372;679;693
18;Granada;069;Dólar;718;356;362
18;Granada;070;Dúdar;279;140;139
18;Granada;071;Dúrcal;5796;2875;2921
18;Granada;072;Escúzar;1184;599;585
18;Granada;074;Ferreira;447;210;237
18;Granada;076;Fonelas;1552;779;773
18;Granada;078;Freila;1354;682;672
18;Granada;079;Fuente Vaqueros;3856;1918;1938
18;Granada;905;Gabias (Las);5837;2910;2927
18;Granada;082;Galera;1829;903;926
18;Granada;083;Gobernador;439;213;226
18;Granada;084;Gójar;2219;1114;1105
18;Granada;085;Gor;1439;711;728
18;Granada;086;Gorafe;721;377;344
18;Granada;087;Granada;268674;127028;141646
18;Granada;088;Guadahortuna;2594;1320;1274
18;Granada;089;Guadix;20975;10278;10697
18;Granada;906;Guajares (Los);1580;807;773
18;Granada;093;Gualchos;3028;1512;1516
18;Granada;094;Güejar Sierra;2752;1395;1357
18;Granada;095;Güevéjar;1228;591;637
18;Granada;096;Huélago;740;386;354
18;Granada;097;Huéneja;1526;758;768
18;Granada;098;Huéscar;10283;5146;5137
18;Granada;099;Huétor de Santillán;1488;773;715
18;Granada;100;Huétor Tájar;7999;4017;3982
18;Granada;101;Huétor Vega;6531;3266;3265
18;Granada;102;Illora;10869;5464;5405
18;Granada;103;Itrabo;1176;595;581
18;Granada;105;Iznalloz;7024;3572;3452
18;Granada;107;Jayena;1543;808;735
18;Granada;108;Jerez del Marquesado;1320;670;650
18;Granada;109;Jete;751;372;379
18;Granada;111;Jun;892;438;454
18;Granada;112;Juviles;176;82;94
18;Granada;115;Láchar;2318;1173;1145
18;Granada;116;Lanjarón;4178;2071;2107
18;Granada;117;Lanteira;754;386;368
18;Granada;119;Lecrín;2606;1274;1332
18;Granada;120;Lentegí;370;178;192
18;Granada;121;Lobras;261;129;132
18;Granada;122;Loja;21273;10650;10623
18;Granada;123;Lugros;568;308;260
18;Granada;124;Lújar;690;358;332
18;Granada;126;Malahá (La);1708;878;830
18;Granada;127;Maracena;12273;6127;6146
18;Granada;128;Marchal;526;255;271
18;Granada;132;Moclín;5179;2603;2576
18;Granada;133;Molvízar;2531;1257;1274
18;Granada;134;Monachil;4147;2092;2055
18;Granada;135;Montefrío;8293;4224;4069
18;Granada;136;Montejícar;3006;1523;1483
18;Granada;137;Montillana;1422;713;709
18;Granada;138;Moraleda de Zafayona;2591;1301;1290
18;Granada;909;Morelábor;1115;540;575
18;Granada;140;Motril;47267;23461;23806
18;Granada;141;Murtas;1217;613;604
18;Granada;903;Nevada;1580;816;764
18;Granada;143;Nigüelas;1215;614;601
18;Granada;144;Nívar;484;246;238
18;Granada;145;Ogíjares;4355;2184;2171
18;Granada;146;Orce;1596;795;801
18;Granada;147;Órgiva;5260;2635;2625
18;Granada;148;Otívar;1212;608;604
18;Granada;149;Otura;2401;1195;1206
18;Granada;150;Padul;6481;3216;3265
18;Granada;151;Pampaneira;368;193;175
18;Granada;152;Pedro Martínez;1852;931;921
18;Granada;153;Peligros;5945;2973;2972
18;Granada;154;Peza (La);1679;877;802
18;Granada;910;Pinar (El);1447;724;723
18;Granada;157;Pinos Genil;1018;523;495
18;Granada;158;Pinos Puente;14320;7111;7209
18;Granada;159;Píñar;1539;789;750
18;Granada;161;Polícar;274;145;129
18;Granada;162;Polopos;1322;701;621
18;Granada;163;Pórtugos;478;241;237
18;Granada;164;Puebla de Don Fadrique;2950;1458;1492
18;Granada;165;Pulianas;2419;1211;1208
18;Granada;167;Purullena;2792;1395;1397
18;Granada;168;Quéntar;1283;647;636
18;Granada;170;Rubite;498;256;242
18;Granada;171;Salar;2864;1419;1445
18;Granada;173;Salobreña;9479;4677;4802
18;Granada;174;Santa Cruz del Comercio;612;327;285
18;Granada;175;Santa Fe;12089;5905;6184
18;Granada;176;Soportújar;271;142;129
18;Granada;177;Sorvilán;960;486;474
18;Granada;901;Taha (La);930;467;463
18;Granada;178;Torre-Cardela;1431;716;715
18;Granada;179;Torvizcón;1253;612;641
18;Granada;180;Trevélez;853;446;407
18;Granada;181;Turón;476;268;208
18;Granada;182;Ugíjar;3119;1518;1601
18;Granada;907;Valle del Zalabí;2662;1327;1335
18;Granada;902;Valle (El);1601;796;805
18;Granada;183;Válor;1156;572;584
18;Granada;911;Vegas del Genil;2692;1355;1337
18;Granada;184;Vélez de Benaudalla;2584;1278;1306
18;Granada;185;Ventas de Huelma;757;380;377
18;Granada;908;Villamena;1148;543;605
18;Granada;187;Villanueva de las Torres;1097;581;516
18;Granada;188;Villanueva Mesía;1898;951;947
18;Granada;189;Víznar;688;344;344
18;Granada;192;Zafarraya;2290;1155;1135
18;Granada;913;Zagra;1424;720;704
18;Granada;193;Zubia (La);8064;4032;4032
18;Granada;194;Zújar;3279;1674;1605
19;Guadalajara;001;Abánades;130;75;55
19;Guadalajara;002;Ablanque;170;94;76
19;Guadalajara;003;Adobes;41;20;21
19;Guadalajara;004;Alaminos;116;54;62
19;Guadalajara;005;Alarilla;110;59;51
19;Guadalajara;006;Albalate de Zorita;1061;553;508
19;Guadalajara;007;Albares;512;260;252
19;Guadalajara;008;Albendiego;69;36;33
19;Guadalajara;009;Alcocer;363;175;188
19;Guadalajara;010;Alcolea de las Peñas;44;27;17
19;Guadalajara;011;Alcolea del Pinar;514;262;252
19;Guadalajara;013;Alcoroches;216;112;104
19;Guadalajara;015;Aldeanueva de Guadalajara;119;60;59
19;Guadalajara;016;Algar de Mesa;91;46;45
19;Guadalajara;017;Algora;121;72;49
19;Guadalajara;018;Alhóndiga;290;158;132
19;Guadalajara;019;Alique;12;6;6
19;Guadalajara;020;Almadrones;125;80;45
19;Guadalajara;021;Almoguera;766;390;376
19;Guadalajara;022;Almonacid de Zorita;985;517;468
19;Guadalajara;023;Alocén;132;68;64
19;Guadalajara;024;Alovera;1369;686;683
19;Guadalajara;027;Alustante;312;167;145
19;Guadalajara;031;Angón;39;24;15
19;Guadalajara;032;Anguita;415;212;203
19;Guadalajara;033;Anquela del Ducado;85;43;42
19;Guadalajara;034;Anquela del Pedregal;37;21;16
19;Guadalajara;036;Aranzueque;374;188;186
19;Guadalajara;037;Arbancón;224;128;96
19;Guadalajara;038;Arbeteta;53;27;26
19;Guadalajara;039;Argecilla;141;80;61
19;Guadalajara;040;Armallones;93;52;41
19;Guadalajara;041;Armuña de Tajuña;107;60;47
19;Guadalajara;042;Arroyo de las Fraguas;21;12;9
19;Guadalajara;043;Atanzón;124;70;54
19;Guadalajara;044;Atienza;530;275;255
19;Guadalajara;045;Auñón;269;144;125
19;Guadalajara;046;Azuqueca de Henares;11363;5730;5633
19;Guadalajara;047;Baides;85;43;42
19;Guadalajara;048;Baños de Tajo;36;23;13
19;Guadalajara;049;Bañuelos;45;22;23
19;Guadalajara;050;Barriopedro;26;11;15
19;Guadalajara;051;Berninches;132;80;52
19;Guadalajara;052;Bodera (La);56;31;25
19;Guadalajara;053;Brihuega;3176;1686;1490
19;Guadalajara;054;Budia;370;199;171
19;Guadalajara;055;Bujalaro;141;78;63
19;Guadalajara;057;Bustares;152;82;70
19;Guadalajara;058;Cabanillas del Campo;981;520;461
19;Guadalajara;059;Campillo de Dueñas;188;105;83
19;Guadalajara;060;Campillo de Ranas;96;43;53
19;Guadalajara;061;Campisábalos;73;34;39
19;Guadalajara;064;Canredondo;143;76;67
19;Guadalajara;065;Cantalojas;179;102;77
19;Guadalajara;066;Cañizar;121;62;59
19;Guadalajara;067;Cardoso de la Sierra (El);122;74;48
19;Guadalajara;070;Casa de Uceda;151;77;74
19;Guadalajara;071;Casar (El);1360;705;655
19;Guadalajara;073;Casas de San Galindo;40;23;17
19;Guadalajara;074;Caspueñas;52;26;26
19;Guadalajara;075;Castejón de Henares;135;73;62
19;Guadalajara;076;Castellar de la Muela;71;40;31
19;Guadalajara;078;Castilforte;55;32;23
19;Guadalajara;079;Castilnuevo;10;3;7
19;Guadalajara;080;Cendejas de Enmedio;161;78;83
19;Guadalajara;081;Cendejas de la Torre;164;95;69
19;Guadalajara;082;Centenera;92;49;43
19;Guadalajara;103;Checa;496;251;245
19;Guadalajara;104;Chequilla;27;12;15
19;Guadalajara;106;Chillarón del Rey;133;72;61
19;Guadalajara;105;Chiloeches;1062;557;505
19;Guadalajara;086;Cifuentes;2621;1367;1254
19;Guadalajara;087;Cincovillas;44;22;22
19;Guadalajara;088;Ciruelas;66;34;32
19;Guadalajara;089;Ciruelos del Pinar;99;49;50
19;Guadalajara;090;Cobeta;151;76;75
19;Guadalajara;091;Cogollor;73;41;32
19;Guadalajara;092;Cogolludo;703;382;321
19;Guadalajara;095;Condemios de Abajo;34;20;14
19;Guadalajara;096;Condemios de Arriba;222;118;104
19;Guadalajara;097;Congostrina;47;22;25
19;Guadalajara;098;Copernal;33;18;15
19;Guadalajara;099;Corduente;532;288;244
19;Guadalajara;102;Cubillo de Uceda (El);166;87;79
19;Guadalajara;107;Driebes;389;216;173
19;Guadalajara;108;Durón;95;54;41
19;Guadalajara;109;Embid;78;45;33
19;Guadalajara;110;Escamilla;153;78;75
19;Guadalajara;111;Escariche;243;119;124
19;Guadalajara;112;Escopete;66;27;39
19;Guadalajara;113;Espinosa de Henares;517;251;266
19;Guadalajara;114;Esplegares;96;55;41
19;Guadalajara;115;Establés;64;29;35
19;Guadalajara;116;Estriégana;36;19;17
19;Guadalajara;117;Fontanar;743;372;371
19;Guadalajara;118;Fuembellida;21;11;10
19;Guadalajara;119;Fuencemillán;149;77;72
19;Guadalajara;120;Fuentelahiguera de Albatages;248;120;128
19;Guadalajara;121;Fuentelencina;217;117;100
19;Guadalajara;122;Fuentelsaz;164;78;86
19;Guadalajara;123;Fuentelviejo;105;53;52
19;Guadalajara;124;Fuentenovilla;240;143;97
19;Guadalajara;125;Gajanejos;114;67;47
19;Guadalajara;126;Galápagos;204;115;89
19;Guadalajara;127;Galve de Sorbe;196;101;95
19;Guadalajara;129;Gascueña de Bornova;43;23;20
19;Guadalajara;130;Guadalajara;63572;31568;32004
19;Guadalajara;132;Henche;29;19;10
19;Guadalajara;133;Heras de Ayuso;132;69;63
19;Guadalajara;134;Herrería;46;22;24
19;Guadalajara;135;Hiendelaencina;172;96;76
19;Guadalajara;136;Hijes;30;17;13
19;Guadalajara;138;Hita;260;147;113
19;Guadalajara;139;Hombrados;67;34;33
19;Guadalajara;142;Hontoba;143;71;72
19;Guadalajara;143;Horche;1147;601;546
19;Guadalajara;145;Hortezuela de Océn;110;62;48
19;Guadalajara;146;Huerce (La);36;20;16
19;Guadalajara;147;Huérmeces del Cerro;68;42;26
19;Guadalajara;148;Huertahernando;85;47;38
19;Guadalajara;150;Hueva;152;80;72
19;Guadalajara;151;Humanes;1218;637;581
19;Guadalajara;152;Illana;715;366;349
19;Guadalajara;153;Iniéstola;27;15;12
19;Guadalajara;154;Inviernas (Las);116;65;51
19;Guadalajara;155;Irueste;87;44;43
19;Guadalajara;156;Jadraque;1245;613;632
19;Guadalajara;157;Jirueque;74;43;31
19;Guadalajara;159;Ledanca;205;105;100
19;Guadalajara;160;Loranca de Tajuña;299;159;140
19;Guadalajara;161;Lupiana;267;142;125
19;Guadalajara;162;Luzaga;147;66;81
19;Guadalajara;163;Luzón;107;58;49
19;Guadalajara;165;Majaelrayo;63;31;32
19;Guadalajara;166;Málaga del Fresno;252;135;117
19;Guadalajara;167;Malaguilla;202;109;93
19;Guadalajara;168;Mandayona;532;251;281
19;Guadalajara;169;Mantiel;40;17;23
19;Guadalajara;170;Maranchón;266;130;136
19;Guadalajara;171;Marchamalo;"";"";""
19;Guadalajara;172;Masegoso de Tajuña;133;69;64
19;Guadalajara;173;Matarrubia;53;31;22
19;Guadalajara;174;Matillas;306;155;151
19;Guadalajara;175;Mazarete;115;58;57
19;Guadalajara;176;Mazuecos;452;238;214
19;Guadalajara;177;Medranda;167;89;78
19;Guadalajara;178;Megina;90;41;49
19;Guadalajara;179;Membrillera;94;51;43
19;Guadalajara;181;Miedes de Atienza;153;75;78
19;Guadalajara;182;Mierla (La);36;21;15
19;Guadalajara;184;Millana;115;56;59
19;Guadalajara;183;Milmarcos;123;64;59
19;Guadalajara;185;Miñosa (La);68;36;32
19;Guadalajara;186;Mirabueno;128;71;57
19;Guadalajara;187;Miralrío;124;65;59
19;Guadalajara;188;Mochales;162;84;78
19;Guadalajara;189;Mohernando;127;78;49
19;Guadalajara;190;Molina de Aragón;3860;1964;1896
19;Guadalajara;191;Monasterio;17;8;9
19;Guadalajara;192;Mondéjar;2146;1049;1097
19;Guadalajara;193;Montarrón;92;50;42
19;Guadalajara;194;Moratilla de los Meleros;136;77;59
19;Guadalajara;195;Morenilla;68;44;24
19;Guadalajara;196;Muduex;145;78;67
19;Guadalajara;197;Navas de Jadraque (Las);27;17;10
19;Guadalajara;198;Negredo;26;11;15
19;Guadalajara;199;Ocentejo;54;24;30
19;Guadalajara;200;Olivar (El);66;36;30
19;Guadalajara;201;Olmeda de Cobeta;87;32;55
19;Guadalajara;202;Olmeda de Jadraque (La);11;7;4
19;Guadalajara;203;Ordial (El);50;18;32
19;Guadalajara;204;Orea;355;188;167
19;Guadalajara;208;Pálmaces de Jadraque;107;55;52
19;Guadalajara;209;Pardos;70;36;34
19;Guadalajara;210;Paredes de Sigüenza;85;43;42
19;Guadalajara;211;Pareja;496;247;249
19;Guadalajara;212;Pastrana;1175;591;584
19;Guadalajara;213;Pedregal (El);123;63;60
19;Guadalajara;214;Peñalén;197;98;99
19;Guadalajara;215;Peñalver;320;184;136
19;Guadalajara;216;Peralejos de las Truchas;207;115;92
19;Guadalajara;217;Peralveche;71;38;33
19;Guadalajara;218;Pinilla de Jadraque;104;54;50
19;Guadalajara;219;Pinilla de Molina;32;16;16
19;Guadalajara;220;Pioz;189;105;84
19;Guadalajara;221;Piqueras;49;28;21
19;Guadalajara;222;Pobo de Dueñas (El);206;113;93
19;Guadalajara;223;Poveda de la Sierra;207;103;104
19;Guadalajara;224;Pozo de Almoguera;230;117;113
19;Guadalajara;225;Pozo de Guadalajara;348;190;158
19;Guadalajara;226;Prádena de Atienza;53;31;22
19;Guadalajara;227;Prados Redondos;122;69;53
19;Guadalajara;228;Puebla de Beleña;39;23;16
19;Guadalajara;229;Puebla de Valles;86;44;42
19;Guadalajara;230;Quer;108;55;53
19;Guadalajara;231;Rebollosa de Jadraque;36;22;14
19;Guadalajara;232;Recuenco (El);143;74;69
19;Guadalajara;233;Renera;59;26;33
19;Guadalajara;234;Retiendas;31;15;16
19;Guadalajara;235;Riba de Saelices;185;101;84
19;Guadalajara;237;Rillo de Gallo;90;45;45
19;Guadalajara;238;Riofrío del Llano;107;56;51
19;Guadalajara;239;Robledillo de Mohernando;181;96;85
19;Guadalajara;240;Robledo de Corpes;88;39;49
19;Guadalajara;241;Romanillos de Atienza;85;50;35
19;Guadalajara;242;Romanones;166;93;73
19;Guadalajara;243;Rueda de la Sierra;98;50;48
19;Guadalajara;244;Sacecorbo;162;87;75
19;Guadalajara;245;Sacedón;1737;878;859
19;Guadalajara;246;Saelices de la Sal;84;44;40
19;Guadalajara;247;Salmerón;307;161;146
19;Guadalajara;248;San Andrés del Congosto;84;46;38
19;Guadalajara;249;San Andrés del Rey;49;22;27
19;Guadalajara;250;Santiuste;24;11;13
19;Guadalajara;251;Saúca;67;37;30
19;Guadalajara;252;Sayatón;211;104;107
19;Guadalajara;254;Selas;77;36;41
19;Guadalajara;901;Semillas;32;19;13
19;Guadalajara;255;Setiles;252;131;121
19;Guadalajara;256;Sienes;108;64;44
19;Guadalajara;257;Sigüenza;5087;2536;2551
19;Guadalajara;258;Solanillos del Extremo;116;60;56
19;Guadalajara;259;Somolinos;61;29;32
19;Guadalajara;260;Sotillo (El);60;39;21
19;Guadalajara;261;Sotodosos;87;43;44
19;Guadalajara;262;Tamajón;207;104;103
19;Guadalajara;263;Taragudo;32;17;15
19;Guadalajara;264;Taravilla;76;38;38
19;Guadalajara;265;Tartanedo;256;130;126
19;Guadalajara;266;Tendilla;415;223;192
19;Guadalajara;267;Terzaga;53;30;23
19;Guadalajara;268;Tierzo;52;27;25
19;Guadalajara;269;Toba (La);133;70;63
19;Guadalajara;271;Tordellego;112;56;56
19;Guadalajara;270;Tordelrábano;21;8;13
19;Guadalajara;272;Tordesilos;178;94;84
19;Guadalajara;274;Torija;355;181;174
19;Guadalajara;279;Torre del Burgo;54;29;25
19;Guadalajara;276;Torrecilla del Ducado;9;5;4
19;Guadalajara;277;Torrecuadrada de Molina;28;16;12
19;Guadalajara;278;Torrecuadradilla;85;48;37
19;Guadalajara;280;Torrejón del Rey;420;230;190
19;Guadalajara;281;Torremocha de Jadraque;19;13;6
19;Guadalajara;282;Torremocha del Campo;426;232;194
19;Guadalajara;283;Torremocha del Pinar;97;45;52
19;Guadalajara;284;Torremochuela;11;6;5
19;Guadalajara;285;Torrubia;49;25;24
19;Guadalajara;286;Tórtola de Henares;410;205;205
19;Guadalajara;287;Tortuera;296;149;147
19;Guadalajara;288;Tortuero;31;18;13
19;Guadalajara;289;Traíd;61;33;28
19;Guadalajara;290;Trijueque;310;161;149
19;Guadalajara;291;Trillo;1434;758;676
19;Guadalajara;293;Uceda;467;235;232
19;Guadalajara;294;Ujados;53;30;23
19;Guadalajara;296;Utande;79;46;33
19;Guadalajara;297;Valdarachas;30;14;16
19;Guadalajara;298;Valdearenas;72;38;34
19;Guadalajara;299;Valdeavellano;101;52;49
19;Guadalajara;300;Valdeaveruelo;152;80;72
19;Guadalajara;301;Valdeconcha;45;20;25
19;Guadalajara;302;Valdegrudas;77;39;38
19;Guadalajara;303;Valdelcubo;80;45;35
19;Guadalajara;304;Valdenuño Fernández;149;78;71
19;Guadalajara;305;Valdepeñas de la Sierra;302;165;137
19;Guadalajara;306;Valderrebollo;52;27;25
19;Guadalajara;307;Valdesotos;49;21;28
19;Guadalajara;308;Valfermoso de Tajuña;85;52;33
19;Guadalajara;309;Valhermoso;62;34;28
19;Guadalajara;310;Valtablado del Río;19;12;7
19;Guadalajara;311;Valverde de los Arroyos;82;43;39
19;Guadalajara;314;Viana de Jadraque;74;38;36
19;Guadalajara;317;Villanueva de Alcorón;361;193;168
19;Guadalajara;318;Villanueva de Argecilla;55;32;23
19;Guadalajara;319;Villanueva de la Torre;109;49;60
19;Guadalajara;321;Villares de Jadraque;51;26;25
19;Guadalajara;322;Villaseca de Henares;92;46;46
19;Guadalajara;323;Villaseca de Uceda;71;35;36
19;Guadalajara;324;Villel de Mesa;298;141;157
19;Guadalajara;325;Viñuelas;160;86;74
19;Guadalajara;326;Yebes;57;29;28
19;Guadalajara;327;Yebra;624;314;310
19;Guadalajara;329;Yélamos de Abajo;115;56;59
19;Guadalajara;330;Yélamos de Arriba;159;86;73
19;Guadalajara;331;Yunquera de Henares;1889;970;919
19;Guadalajara;332;Yunta (La);217;104;113
19;Guadalajara;333;Zaorejas;255;139;116
19;Guadalajara;334;Zarzuela de Jadraque;38;23;15
19;Guadalajara;335;Zorita de los Canes;109;56;53
20;Guipúzcoa;001;Abaltzisketa;281;153;128
20;Guipúzcoa;002;Aduna;327;172;155
20;Guipúzcoa;016;Aia;1755;1003;752
20;Guipúzcoa;003;Aizarnazabal;562;305;257
20;Guipúzcoa;004;Albiztur;312;166;146
20;Guipúzcoa;005;Alegia;1686;887;799
20;Guipúzcoa;006;Alkiza;263;148;115
20;Guipúzcoa;906;Altzaga;"";"";""
20;Guipúzcoa;007;Altzo;327;188;139
20;Guipúzcoa;008;Amezketa;1087;590;497
20;Guipúzcoa;009;Andoain;15654;7811;7843
20;Guipúzcoa;010;Anoeta;1802;907;895
20;Guipúzcoa;011;Antzuola;2109;1094;1015
20;Guipúzcoa;012;Arama;147;74;73
20;Guipúzcoa;013;Aretxabaleta;6112;3102;3010
20;Guipúzcoa;055;Arrasate/Mondragón;25843;12951;12892
20;Guipúzcoa;014;Asteasu;1235;664;571
20;Guipúzcoa;903;Astigarraga;3300;1646;1654
20;Guipúzcoa;015;Ataun;1768;907;861
20;Guipúzcoa;017;Azkoitia;10561;5251;5310
20;Guipúzcoa;018;Azpeitia;13397;6764;6633
20;Guipúzcoa;904;Baliarrain;97;52;45
20;Guipúzcoa;019;Beasain;12461;6304;6157
20;Guipúzcoa;020;Beizama;178;98;80
20;Guipúzcoa;021;Belauntza;306;165;141
20;Guipúzcoa;022;Berastegi;966;543;423
20;Guipúzcoa;074;Bergara;15745;7870;7875
20;Guipúzcoa;023;Berrobi;588;325;263
20;Guipúzcoa;024;Bidegoyan;484;270;214
20;Guipúzcoa;029;Deba;4927;2534;2393
20;Guipúzcoa;069;Donostia/San Sebastián;183944;86548;97396
20;Guipúzcoa;030;Eibar;33422;16684;16738
20;Guipúzcoa;031;Elduain;255;139;116
20;Guipúzcoa;033;Elgeta;1018;520;498
20;Guipúzcoa;032;Elgoibar;12059;6102;5957
20;Guipúzcoa;067;Errenteria;42441;21084;21357
20;Guipúzcoa;066;Errezil;706;389;317
20;Guipúzcoa;034;Eskoriatza;3940;2054;1886
20;Guipúzcoa;035;Ezkio-Itsaso;580;298;282
20;Guipúzcoa;038;Gabiria;444;251;193
20;Guipúzcoa;037;Gaintza;125;72;53
20;Guipúzcoa;907;Gaztelu;"";"";""
20;Guipúzcoa;039;Getaria;2333;1175;1158
20;Guipúzcoa;040;Hernani;18864;9406;9458
20;Guipúzcoa;041;Hernialde;286;153;133
20;Guipúzcoa;036;Hondarribia;13608;6787;6821
20;Guipúzcoa;042;Ibarra;4460;2303;2157
20;Guipúzcoa;043;Idiazabal;2085;1058;1027
20;Guipúzcoa;044;Ikaztegieta;400;200;200
20;Guipúzcoa;045;Irún;55200;27136;28064
20;Guipúzcoa;046;Irura;652;326;326
20;Guipúzcoa;047;Itsasondo;757;387;370
20;Guipúzcoa;048;Larraul;154;94;60
20;Guipúzcoa;902;Lasarte-Oria;18288;9164;9124
20;Guipúzcoa;049;Lazkao;5087;2614;2473
20;Guipúzcoa;050;Leaburu;604;333;271
20;Guipúzcoa;051;Legazpi;10172;5266;4906
20;Guipúzcoa;052;Legorreta;1544;780;764
20;Guipúzcoa;068;Leintz-Gatzaga;231;128;103
20;Guipúzcoa;053;Lezo;5550;2749;2801
20;Guipúzcoa;054;Lizartza;715;383;332
20;Guipúzcoa;901;Mendaro;1496;764;732
20;Guipúzcoa;057;Mutiloa;190;95;95
20;Guipúzcoa;056;Mutriku;4687;2350;2337
20;Guipúzcoa;063;Oiartzun;8351;4160;4191
20;Guipúzcoa;058;Olaberria;1181;616;565
20;Guipúzcoa;076;Ordizia;9390;4598;4792
20;Guipúzcoa;905;Orendain;179;105;74
20;Guipúzcoa;060;Orexa;77;40;37
20;Guipúzcoa;061;Orio;4316;2198;2118
20;Guipúzcoa;062;Ormaiztegi;1258;623;635
20;Guipúzcoa;059;Oñati;10830;5446;5384
20;Guipúzcoa;064;Pasaia;19146;9374;9772
20;Guipúzcoa;070;Segura;1338;695;643
20;Guipúzcoa;065;Soraluze/Placencia de las Armas;4985;2502;2483
20;Guipúzcoa;071;Tolosa;18243;8759;9484
20;Guipúzcoa;072;Urnieta;4483;2303;2180
20;Guipúzcoa;077;Urretxu;6261;3210;3051
20;Guipúzcoa;073;Usurbil;5550;2847;2703
20;Guipúzcoa;075;Villabona;5282;2681;2601
20;Guipúzcoa;078;Zaldibia;1619;847;772
20;Guipúzcoa;079;Zarautz;17238;8572;8666
20;Guipúzcoa;025;Zegama;1456;739;717
20;Guipúzcoa;026;Zerain;233;113;120
20;Guipúzcoa;027;Zestoa;3545;1863;1682
20;Guipúzcoa;028;Zizurkil;2761;1405;1356
20;Guipúzcoa;081;Zumaia;8184;4106;4078
20;Guipúzcoa;080;Zumarraga;11435;5787;5648
21;Huelva;001;Alájar;904;456;448
21;Huelva;002;Aljaraque;6050;3016;3034
21;Huelva;003;Almendro (El);905;468;437
21;Huelva;004;Almonaster la Real;2291;1136;1155
21;Huelva;005;Almonte;16484;8336;8148
21;Huelva;006;Alosno;4962;2392;2570
21;Huelva;007;Aracena;6600;3204;3396
21;Huelva;008;Aroche;3862;1880;1982
21;Huelva;009;Arroyomolinos de León;1300;650;650
21;Huelva;010;Ayamonte;17490;8695;8795
21;Huelva;011;Beas;4101;2047;2054
21;Huelva;012;Berrocal;417;217;200
21;Huelva;013;Bollullos Par del Condado;12683;6306;6377
21;Huelva;014;Bonares;4940;2489;2451
21;Huelva;015;Cabezas Rubias;967;500;467
21;Huelva;016;Cala;1530;767;763
21;Huelva;017;Calañas;5301;2600;2701
21;Huelva;018;Campillo (El);2817;1373;1444
21;Huelva;019;Campofrío;897;454;443
21;Huelva;020;Cañaveral de León;604;289;315
21;Huelva;021;Cartaya;10504;5261;5243
21;Huelva;022;Castaño del Robledo;207;101;106
21;Huelva;023;Cerro de Andévalo (El);3093;1530;1563
21;Huelva;030;Chucena;1970;1015;955
21;Huelva;024;Corteconcepción;732;373;359
21;Huelva;025;Cortegana;5477;2659;2818
21;Huelva;026;Cortelazor;378;185;193
21;Huelva;027;Cumbres de Enmedio;58;27;31
21;Huelva;028;Cumbres de San Bartolomé;711;355;356
21;Huelva;029;Cumbres Mayores;2453;1166;1287
21;Huelva;031;Encinasola;2365;1149;1216
21;Huelva;032;Escacena del Campo;2229;1100;1129
21;Huelva;033;Fuenteheridos;665;336;329
21;Huelva;034;Galaroza;1660;800;860
21;Huelva;035;Gibraleón;9890;4963;4927
21;Huelva;036;Granada de Río-Tinto (La);234;126;108
21;Huelva;037;Granado (El);732;380;352
21;Huelva;038;Higuera de la Sierra;1404;694;710
21;Huelva;039;Hinojales;491;251;240
21;Huelva;040;Hinojos;3539;1795;1744
21;Huelva;041;Huelva;141002;68392;72610
21;Huelva;042;Isla Cristina;18521;9191;9330
21;Huelva;043;Jabugo;2643;1291;1352
21;Huelva;044;Lepe;16524;8426;8098
21;Huelva;045;Linares de la Sierra;282;134;148
21;Huelva;046;Lucena del Puerto;2068;1033;1035
21;Huelva;047;Manzanilla;2525;1252;1273
21;Huelva;048;Marines (Los);357;177;180
21;Huelva;049;Minas de Riotinto;5934;2815;3119
21;Huelva;050;Moguer;11853;5991;5862
21;Huelva;051;Nava (La);377;184;193
21;Huelva;052;Nerva;7194;3518;3676
21;Huelva;053;Niebla;4044;2051;1993
21;Huelva;054;Palma del Condado (La);9439;4687;4752
21;Huelva;055;Palos de la Frontera;6691;3372;3319
21;Huelva;056;Paterna del Campo;3852;2028;1824
21;Huelva;057;Paymogo;1487;702;785
21;Huelva;058;Puebla de Guzmán;3391;1707;1684
21;Huelva;059;Puerto Moral;245;115;130
21;Huelva;060;Punta Umbría;10183;5116;5067
21;Huelva;061;Rociana del Condado;6324;3214;3110
21;Huelva;062;Rosal de la Frontera;2070;992;1078
21;Huelva;063;San Bartolomé de la Torre;2866;1457;1409
21;Huelva;064;San Juan del Puerto;5758;2883;2875
21;Huelva;066;San Silvestre de Guzmán;761;370;391
21;Huelva;065;Sanlúcar de Guadiana;418;204;214
21;Huelva;067;Santa Ana la Real;553;261;292
21;Huelva;068;Santa Bárbara de Casa;1524;758;766
21;Huelva;069;Santa Olalla del Cala;2485;1253;1232
21;Huelva;070;Trigueros;7091;3561;3530
21;Huelva;071;Valdelarco;322;150;172
21;Huelva;072;Valverde del Camino;12173;5843;6330
21;Huelva;073;Villablanca;2042;1059;983
21;Huelva;074;Villalba del Alcor;3821;1890;1931
21;Huelva;075;Villanueva de las Cruces;435;213;222
21;Huelva;076;Villanueva de los Castillejos;2706;1342;1364
21;Huelva;077;Villarrasa;2271;1158;1113
21;Huelva;078;Zalamea la Real;3947;1921;2026
21;Huelva;079;Zufre;1446;753;693
22;Huesca;001;Abiego;349;178;171
22;Huesca;002;Abizanda;108;62;46
22;Huesca;003;Adahuesca;180;92;88
22;Huesca;004;Agüero;180;95;85
22;Huesca;907;Aínsa-Sobrarbe;1405;744;661
22;Huesca;006;Aisa;318;168;150
22;Huesca;007;Albalate de Cinca;1222;631;591
22;Huesca;008;Albalatillo;284;140;144
22;Huesca;009;Albelda;1063;546;517
22;Huesca;011;Albero Alto;113;56;57
22;Huesca;012;Albero Bajo;138;71;67
22;Huesca;013;Alberuela de Tubo;462;239;223
22;Huesca;014;Alcalá de Gurrea;440;219;221
22;Huesca;015;Alcalá del Obispo;438;218;220
22;Huesca;016;Alcampell;1131;576;555
22;Huesca;017;Alcolea de Cinca;1201;609;592
22;Huesca;018;Alcubierre;537;278;259
22;Huesca;019;Alerre;143;73;70
22;Huesca;020;Alfántega;136;71;65
22;Huesca;021;Almudévar;2535;1331;1204
22;Huesca;022;Almunia de San Juan;799;396;403
22;Huesca;023;Almuniente;690;343;347
22;Huesca;024;Alquézar;284;141;143
22;Huesca;025;Altorricón;1538;822;716
22;Huesca;027;Angüés;519;282;237
22;Huesca;028;Ansó;538;276;262
22;Huesca;029;Antillón;184;90;94
22;Huesca;032;Aragüés del Puerto;131;85;46
22;Huesca;035;Arén;455;251;204
22;Huesca;036;Argavieso;125;71;54
22;Huesca;037;Arguis;61;32;29
22;Huesca;039;Ayerbe;1306;666;640
22;Huesca;040;Azanuy-Alins;248;117;131
22;Huesca;041;Azara;226;115;111
22;Huesca;042;Azlor;196;104;92
22;Huesca;043;Baélls;189;98;91
22;Huesca;044;Bailo;393;221;172
22;Huesca;045;Baldellou;202;106;96
22;Huesca;046;Ballobar;1189;592;597
22;Huesca;047;Banastás;111;52;59
22;Huesca;048;Barbastro;15178;7431;7747
22;Huesca;049;Barbués;121;58;63
22;Huesca;050;Barbuñales;121;62;59
22;Huesca;051;Bárcabo;112;64;48
22;Huesca;052;Belver de Cinca;1559;817;742
22;Huesca;053;Benabarre;1274;687;587
22;Huesca;054;Benasque;1085;564;521
22;Huesca;055;Berbegal;520;255;265
22;Huesca;057;Bielsa;456;237;219
22;Huesca;058;Bierge;211;116;95
22;Huesca;059;Biescas;1229;632;597
22;Huesca;060;Binaced;1695;864;831
22;Huesca;061;Binéfar;7992;4041;3951
22;Huesca;062;Bisaurri;268;160;108
22;Huesca;063;Biscarrués;268;140;128
22;Huesca;064;Blecua y Torres;218;109;109
22;Huesca;066;Boltaña;861;428;433
22;Huesca;067;Bonansa;73;41;32
22;Huesca;068;Borau;75;41;34
22;Huesca;069;Broto;474;243;231
22;Huesca;072;Caldearenas;295;154;141
22;Huesca;074;Campo;400;188;212
22;Huesca;075;Camporrélls;318;143;175
22;Huesca;076;Canal de Berdún;489;253;236
22;Huesca;077;Candasnos;669;342;327
22;Huesca;078;Canfranc;558;302;256
22;Huesca;079;Capdesaso;210;104;106
22;Huesca;080;Capella;464;242;222
22;Huesca;081;Casbas de Huesca;369;190;179
22;Huesca;083;Castejón de Monegros;836;419;417
22;Huesca;084;Castejón de Sos;434;222;212
22;Huesca;082;Castejón del Puente;453;222;231
22;Huesca;085;Castelflorite;175;91;84
22;Huesca;086;Castiello de Jaca;178;82;96
22;Huesca;087;Castigaleu;95;52;43
22;Huesca;088;Castillazuelo;262;133;129
22;Huesca;089;Castillonroy;451;224;227
22;Huesca;094;Chalamera;177;98;79
22;Huesca;095;Chía;129;77;52
22;Huesca;096;Chimillas;151;81;70
22;Huesca;090;Colungo;151;78;73
22;Huesca;099;Esplús;927;448;479
22;Huesca;102;Estada;224;114;110
22;Huesca;103;Estadilla;1037;533;504
22;Huesca;105;Estopiñán del Castillo;203;102;101
22;Huesca;106;Fago;64;40;24
22;Huesca;107;Fanlo;49;32;17
22;Huesca;109;Fiscal;290;153;137
22;Huesca;110;Fonz;1325;669;656
22;Huesca;111;Foradada del Toscar;287;144;143
22;Huesca;112;Fraga;11528;5809;5719
22;Huesca;113;Fueva (La);701;389;312
22;Huesca;114;Gistaín;214;122;92
22;Huesca;115;Grado (El);584;306;278
22;Huesca;116;Grañén;2321;1171;1150
22;Huesca;117;Graus;3427;1755;1672
22;Huesca;119;Gurrea de Gállego;2052;1024;1028
22;Huesca;122;Hoz de Jaca;88;37;51
22;Huesca;908;Hoz y Costean;286;154;132
22;Huesca;124;Huerto;344;183;161
22;Huesca;125;Huesca;42805;20816;21989
22;Huesca;126;Ibieca;120;61;59
22;Huesca;127;Igriés;159;89;70
22;Huesca;128;Ilche;339;171;168
22;Huesca;129;Isábena;296;159;137
22;Huesca;130;Jaca;10874;5382;5492
22;Huesca;131;Jasa;117;65;52
22;Huesca;133;Labuerda;174;91;83
22;Huesca;135;Laluenga;327;171;156
22;Huesca;136;Lalueza;1424;773;651
22;Huesca;137;Lanaja;1877;977;900
22;Huesca;139;Laperdiguera;105;56;49
22;Huesca;141;Lascellas-Ponzano;210;101;109
22;Huesca;142;Lascuarre;182;91;91
22;Huesca;143;Laspaúles;328;196;132
22;Huesca;144;Laspuña;295;161;134
22;Huesca;149;Loarre;427;229;198
22;Huesca;150;Loporzano;528;254;274
22;Huesca;151;Loscorrales;134;75;59
22;Huesca;905;Lupiñén-Ortilla;401;213;188
22;Huesca;155;Monesma y Cajigar;111;52;59
22;Huesca;156;Monflorite-Lascasas;185;99;86
22;Huesca;157;Montanuy;355;203;152
22;Huesca;158;Monzón;14709;7389;7320
22;Huesca;160;Naval;293;146;147
22;Huesca;162;Novales;208;98;110
22;Huesca;163;Nueno;227;119;108
22;Huesca;164;Olvena;54;28;26
22;Huesca;165;Ontiñena;734;370;364
22;Huesca;167;Osso de Cinca;744;388;356
22;Huesca;168;Palo;42;25;17
22;Huesca;170;Panticosa;595;309;286
22;Huesca;172;Peñalba;817;401;416
22;Huesca;173;Peñas de Riglos (Las);311;168;143
22;Huesca;174;Peralta de Alcofea;800;392;408
22;Huesca;175;Peralta de Calasanz;405;213;192
22;Huesca;176;Peraltilla;179;96;83
22;Huesca;177;Perarrúa;159;79;80
22;Huesca;178;Pertusa;160;78;82
22;Huesca;181;Piracés;109;64;45
22;Huesca;182;Plan;307;165;142
22;Huesca;184;Poleñino;273;139;134
22;Huesca;186;Pozán de Vero;295;147;148
22;Huesca;187;Puebla de Castro (La);290;139;151
22;Huesca;188;Puente de Montañana;160;82;78
22;Huesca;902;Puente la Reina de Jaca;290;147;143
22;Huesca;189;Puértolas;206;114;92
22;Huesca;190;Pueyo de Araguás (El);166;102;64
22;Huesca;193;Pueyo de Santa Cruz;412;215;197
22;Huesca;195;Quicena;133;64;69
22;Huesca;197;Robres;774;390;384
22;Huesca;199;Sabiñánigo;9094;4691;4403
22;Huesca;200;Sahún;325;172;153
22;Huesca;201;Salas Altas;429;219;210
22;Huesca;202;Salas Bajas;224;106;118
22;Huesca;203;Salillas;141;72;69
22;Huesca;204;Sallent de Gállego;934;481;453
22;Huesca;205;San Esteban de Litera;780;381;399
22;Huesca;207;San Juan de Plan;176;102;74
22;Huesca;903;San Miguel del Cinca;983;508;475
22;Huesca;206;Sangarrén;321;159;162
22;Huesca;208;Santa Cilia;224;119;105
22;Huesca;209;Santa Cruz de la Serós;151;85;66
22;Huesca;906;Santa María de Dulcis;249;116;133
22;Huesca;212;Santaliestra y San Quílez;108;57;51
22;Huesca;213;Sariñena;4299;2172;2127
22;Huesca;214;Secastilla;201;87;114
22;Huesca;215;Seira;200;96;104
22;Huesca;217;Sena;709;363;346
22;Huesca;218;Senés de Alcubierre;68;29;39
22;Huesca;220;Sesa;316;161;155
22;Huesca;221;Sesué;74;42;32
22;Huesca;222;Siétamo;372;199;173
22;Huesca;223;Sopeira;157;86;71
22;Huesca;904;Sotonera (La);1392;700;692
22;Huesca;225;Tamarite de Litera;4135;2078;2057
22;Huesca;226;Tardienta;1266;650;616
22;Huesca;227;Tella-Sin;344;183;161
22;Huesca;228;Tierz;201;105;96
22;Huesca;229;Tolva;272;144;128
22;Huesca;230;Torla;357;196;161
22;Huesca;232;Torralba de Aragón;165;78;87
22;Huesca;233;Torre la Ribera;129;74;55
22;Huesca;234;Torrente de Cinca;1190;599;591
22;Huesca;235;Torres de Alcanadre;142;84;58
22;Huesca;236;Torres de Barbués;456;240;216
22;Huesca;239;Tramaced;143;82;61
22;Huesca;242;Valfarta;127;64;63
22;Huesca;243;Valle de Bardají;73;38;35
22;Huesca;901;Valle de Hecho;1070;579;491
22;Huesca;244;Valle de Lierp;66;36;30
22;Huesca;245;Velilla de Cinca;530;259;271
22;Huesca;909;Vencillón;507;263;244
22;Huesca;246;Veracruz;120;69;51
22;Huesca;247;Viacamp y Litera;41;26;15
22;Huesca;248;Vicién;133;76;57
22;Huesca;249;Villanova;102;51;51
22;Huesca;250;Villanúa;247;116;131
22;Huesca;251;Villanueva de Sigena;525;270;255
22;Huesca;252;Yebra de Basa;178;101;77
22;Huesca;253;Yésero;59;29;30
22;Huesca;254;Zaidín;1817;915;902
23;Jaén;001;Albanchez de Mágina;1788;876;912
23;Jaén;002;Alcalá la Real;21128;10562;10566
23;Jaén;003;Alcaudete;11935;5925;6010
23;Jaén;004;Aldeaquemada;665;341;324
23;Jaén;005;Andújar;37776;18714;19062
23;Jaén;006;Arjona;6121;3074;3047
23;Jaén;007;Arjonilla;4024;2011;2013
23;Jaén;008;Arquillos;1839;946;893
23;Jaén;009;Baeza;15273;7400;7873
23;Jaén;010;Bailén;16688;8402;8286
23;Jaén;011;Baños de la Encina;2832;1428;1404
23;Jaén;012;Beas de Segura;8487;4214;4273
23;Jaén;902;Bedmar y Garcíez;3924;1961;1963
23;Jaén;014;Begíjar;3149;1575;1574
23;Jaén;015;Bélmez de la Moraleda;2118;1057;1061
23;Jaén;016;Benatae;729;366;363
23;Jaén;017;Cabra del Santo Cristo;2514;1296;1218
23;Jaén;018;Cambil;3941;2042;1899
23;Jaén;019;Campillo de Arenas;2451;1235;1216
23;Jaén;020;Canena;2147;1044;1103
23;Jaén;021;Carboneros;765;371;394
23;Jaén;901;Cárcheles;1673;808;865
23;Jaén;024;Carolina (La);15328;7524;7804
23;Jaén;025;Castellar;3779;1905;1874
23;Jaén;026;Castillo de Locubín;6020;2989;3031
23;Jaén;027;Cazalilla;917;483;434
23;Jaén;028;Cazorla;9043;4474;4569
23;Jaén;029;Chiclana de Segura;2127;1059;1068
23;Jaén;030;Chilluévar;2032;1022;1010
23;Jaén;031;Escañuela;1079;553;526
23;Jaén;032;Espelúy;825;407;418
23;Jaén;033;Frailes;2015;1018;997
23;Jaén;034;Fuensanta de Martos;3656;1792;1864
23;Jaén;035;Fuerte del Rey;1192;592;600
23;Jaén;037;Génave;843;424;419
23;Jaén;038;Guardia de Jaén (La);1854;965;889
23;Jaén;039;Guarromán;3168;1559;1609
23;Jaén;041;Higuera de Calatrava;827;440;387
23;Jaén;042;Hinojares;732;369;363
23;Jaén;043;Hornos;905;465;440
23;Jaén;044;Huelma;6032;3009;3023
23;Jaén;045;Huesa;2898;1428;1470
23;Jaén;046;Ibros;3272;1608;1664
23;Jaén;047;Iruela (La);2240;1105;1135
23;Jaén;048;Iznatoraf;1390;669;721
23;Jaén;049;Jabalquinto;2658;1315;1343
23;Jaén;050;Jaén;109338;52811;56527
23;Jaén;051;Jamilena;3145;1601;1544
23;Jaén;052;Jimena;1820;898;922
23;Jaén;053;Jódar;12305;6169;6136
23;Jaén;040;Lahiguera;1971;965;1006
23;Jaén;054;Larva;698;359;339
23;Jaén;055;Linares;59150;28876;30274
23;Jaén;056;Lopera;4005;1969;2036
23;Jaén;057;Lupión;1233;573;660
23;Jaén;058;Mancha Real;8408;4192;4216
23;Jaén;059;Marmolejo;7522;3785;3737
23;Jaén;060;Martos;22840;11170;11670
23;Jaén;061;Mengíbar;8233;4092;4141
23;Jaén;062;Montizón;2124;1064;1060
23;Jaén;063;Navas de San Juan;5496;2719;2777
23;Jaén;064;Noalejo;2409;1230;1179
23;Jaén;065;Orcera;2456;1259;1197
23;Jaén;066;Peal de Becerro;5525;2769;2756
23;Jaén;067;Pegalajar;3326;1629;1697
23;Jaén;069;Porcuna;7353;3654;3699
23;Jaén;070;Pozo Alcón;5928;2991;2937
23;Jaén;071;Puente de Génave;2163;1096;1067
23;Jaén;072;Puerta de Segura (La);3088;1552;1536
23;Jaén;073;Quesada;7007;3484;3523
23;Jaén;074;Rus;3786;1902;1884
23;Jaén;075;Sabiote;4456;2168;2288
23;Jaén;076;Santa Elena;1102;574;528
23;Jaén;077;Santiago de Calatrava;1073;544;529
23;Jaén;904;Santiago-Pontones;5477;2788;2689
23;Jaén;079;Santisteban del Puerto;5098;2571;2527
23;Jaén;080;Santo Tomé;2782;1407;1375
23;Jaén;081;Segura de la Sierra;2564;1324;1240
23;Jaén;082;Siles;2910;1454;1456
23;Jaén;084;Sorihuela del Guadalimar;1405;701;704
23;Jaén;086;Torre del Campo;11604;5736;5868
23;Jaén;085;Torreblascopedro;3203;1601;1602
23;Jaén;087;Torredonjimeno;13611;6686;6925
23;Jaén;088;Torreperogil;7774;3820;3954
23;Jaén;090;Torres;2115;1063;1052
23;Jaén;091;Torres de Albánchez;1177;594;583
23;Jaén;092;Úbeda;31673;15520;16153
23;Jaén;093;Valdepeñas de Jaén;4955;2500;2455
23;Jaén;094;Vilches;5357;2693;2664
23;Jaén;095;Villacarrillo;12150;6066;6084
23;Jaén;096;Villanueva de la Reina;3681;1844;1837
23;Jaén;097;Villanueva del Arzobispo;9105;4446;4659
23;Jaén;098;Villardompardo;1304;639;665
23;Jaén;099;Villares (Los);4507;2231;2276
23;Jaén;101;Villarrodrigo;862;433;429
23;Jaén;903;Villatorres;4020;2031;1989
24;León;001;Acebedo;408;211;197
24;León;002;Algadefe;444;227;217
24;León;003;Alija del Infantado;1231;625;606
24;León;004;Almanza;932;462;470
24;León;005;Antigua (La);850;435;415
24;León;006;Ardón;860;450;410
24;León;007;Arganza;1189;573;616
24;León;008;Astorga;12629;6039;6590
24;León;009;Balboa;776;383;393
24;León;010;Bañeza (La);9480;4581;4899
24;León;011;Barjas;737;399;338
24;León;012;Barrios de Luna (Los);447;224;223
24;León;014;Bembibre;11436;5770;5666
24;León;015;Benavides;3449;1800;1649
24;León;016;Benuza;992;518;474
24;León;017;Bercianos del Páramo;1076;536;540
24;León;018;Bercianos del Real Camino;301;159;142
24;León;019;Berlanga del Bierzo;519;255;264
24;León;020;Boca de Huérgano;796;418;378
24;León;021;Boñar;3010;1481;1529
24;León;022;Borrenes;693;357;336
24;León;023;Brazuelo;377;190;187
24;León;024;Burgo Ranero (El);1242;634;608
24;León;025;Burón;620;326;294
24;León;026;Bustillo del Páramo;2347;1188;1159
24;León;027;Cabañas Raras;1299;688;611
24;León;028;Cabreros del Río;730;375;355
24;León;029;Cabrillanes;1455;719;736
24;León;030;Cacabelos;4719;2396;2323
24;León;031;Calzada del Coto;384;213;171
24;León;032;Campazas;235;115;120
24;León;033;Campo de Villavidel;476;247;229
24;León;034;Camponaraya;3162;1541;1621
24;León;036;Candín;600;326;274
24;León;037;Cármenes;610;288;322
24;León;038;Carracedelo;3668;1841;1827
24;León;039;Carrizo;2829;1462;1367
24;León;040;Carrocera;750;367;383
24;León;041;Carucedo;800;374;426
24;León;042;Castilfalé;145;75;70
24;León;043;Castrillo de Cabrera;433;224;209
24;León;044;Castrillo de la Valduerna;327;152;175
24;León;046;Castrocalbón;1552;786;766
24;León;047;Castrocontrigo;1493;749;744
24;León;049;Castropodame;1977;986;991
24;León;050;Castrotierra de Valmadrigal;184;98;86
24;León;051;Cea;922;480;442
24;León;052;Cebanico;363;194;169
24;León;053;Cebrones del Río;914;460;454
24;León;065;Chozas de Abajo;2413;1248;1165
24;León;054;Cimanes de la Vega;794;392;402
24;León;055;Cimanes del Tejar;1328;664;664
24;León;056;Cistierna;5522;2745;2777
24;León;057;Congosto;2082;1034;1048
24;León;058;Corbillos de los Oteros;432;214;218
24;León;059;Corullón;1729;855;874
24;León;060;Crémenes;1650;807;843
24;León;061;Cuadros;1857;874;983
24;León;062;Cubillas de los Oteros;281;134;147
24;León;063;Cubillas de Rueda;816;409;407
24;León;064;Cubillos del Sil;1611;821;790
24;León;066;Destriana;1171;559;612
24;León;067;Encinedo;1182;627;555
24;León;068;Ercina (La);1022;498;524
24;León;069;Escobar de Campos;108;62;46
24;León;070;Fabero;7007;3506;3501
24;León;071;Folgoso de la Ribera;1672;847;825
24;León;072;Fresnedo;"";"";""
24;León;073;Fresno de la Vega;839;405;434
24;León;074;Fuentes de Carbajal;180;101;79
24;León;076;Garrafe de Torío;1161;573;588
24;León;077;Gordaliza del Pino;477;232;245
24;León;078;Gordoncillo;736;360;376
24;León;079;Gradefes;1666;807;859
24;León;080;Grajal de Campos;426;183;243
24;León;081;Gusendos de los Oteros;313;154;159
24;León;082;Hospital de Órbigo;1231;623;608
24;León;083;Igüeña;2694;1451;1243
24;León;084;Izagre;444;211;233
24;León;086;Joarilla de las Matas;544;289;255
24;León;087;Laguna Dalga;1146;576;570
24;León;088;Laguna de Negrillos;1935;970;965
24;León;089;León;137758;65375;72383
24;León;092;Llamas de la Ribera;1558;800;758
24;León;090;Lucillo;631;332;299
24;León;091;Luyego;1134;533;601
24;León;093;Magaz de Cepeda;727;347;380
24;León;094;Mansilla de las Mulas;1843;907;936
24;León;095;Mansilla Mayor;508;250;258
24;León;096;Maraña;238;123;115
24;León;097;Matadeón de los Oteros;386;206;180
24;León;098;Matallana de Torío;2119;1047;1072
24;León;099;Matanza;448;225;223
24;León;100;Molinaseca;787;401;386
24;León;101;Murias de Paredes;938;445;493
24;León;102;Noceda del Bierzo;1167;569;598
24;León;103;Oencia;627;331;296
24;León;104;Omañas (Las);547;269;278
24;León;105;Onzonilla;1391;691;700
24;León;106;Oseja de Sajambre;433;223;210
24;León;107;Pajares de los Oteros;519;269;250
24;León;108;Palacios de la Valduerna;698;353;345
24;León;109;Palacios del Sil;1993;1021;972
24;León;110;Páramo del Sil;2475;1258;1217
24;León;111;Pedrosa del Rey;124;69;55
24;León;112;Peranzanes;490;252;238
24;León;113;Pobladura de Pelayo García;824;413;411
24;León;114;Pola de Gordón (La);6393;3123;3270
24;León;115;Ponferrada;60401;29746;30655
24;León;116;Posada de Valdeón;626;325;301
24;León;117;Pozuelo del Páramo;812;425;387
24;León;118;Prado de la Guzpeña;236;120;116
24;León;119;Priaranza del Bierzo;1143;589;554
24;León;120;Prioro;634;330;304
24;León;121;Puebla de Lillo;862;453;409
24;León;122;Puente de Domingo Flórez;2098;1100;998
24;León;123;Quintana del Castillo;1501;771;730
24;León;124;Quintana del Marco;732;373;359
24;León;125;Quintana y Congosto;1061;546;515
24;León;127;Regueras de Arriba;514;282;232
24;León;129;Reyero;240;128;112
24;León;130;Riaño;839;436;403
24;León;131;Riego de la Vega;1368;676;692
24;León;132;Riello;1382;678;704
24;León;133;Rioseco de Tapia;683;363;320
24;León;134;Robla (La);5661;2856;2805
24;León;136;Roperuelos del Páramo;1054;531;523
24;León;137;Sabero;2807;1428;1379
24;León;139;Sahagún;3487;1725;1762
24;León;141;San Adrián del Valle;250;120;130
24;León;142;San Andrés del Rabanedo;18005;8786;9219
24;León;144;San Cristóbal de la Polantera;1471;750;721
24;León;145;San Emiliano;1172;573;599
24;León;146;San Esteban de Nogales;555;259;296
24;León;148;San Justo de la Vega;2546;1277;1269
24;León;149;San Millán de los Caballeros;227;109;118
24;León;150;San Pedro Bercianos;475;240;235
24;León;143;Sancedo;694;354;340
24;León;151;Santa Colomba de Curueño;844;409;435
24;León;152;Santa Colomba de Somoza;596;300;296
24;León;153;Santa Cristina de Valmadrigal;496;268;228
24;León;154;Santa Elena de Jamuz;1623;823;800
24;León;155;Santa María de la Isla;876;461;415
24;León;158;Santa María de Ordás;596;297;299
24;León;156;Santa María del Monte de Cea;557;269;288
24;León;157;Santa María del Páramo;3099;1514;1585
24;León;159;Santa Marina del Rey;2976;1500;1476
24;León;160;Santas Martas;1320;670;650
24;León;161;Santiago Millas;423;210;213
24;León;162;Santovenia de la Valdoncina;1320;631;689
24;León;163;Sariegos;1672;837;835
24;León;164;Sena de Luna;670;330;340
24;León;165;Sobrado;696;349;347
24;León;166;Soto de la Vega;2269;1150;1119
24;León;167;Soto y Amío;1331;635;696
24;León;168;Toral de los Guzmanes;854;436;418
24;León;169;Toreno;5596;2905;2691
24;León;170;Torre del Bierzo;3904;1976;1928
24;León;171;Trabadelo;833;433;400
24;León;172;Truchas;1410;692;718
24;León;173;Turcia;1732;885;847
24;León;174;Urdiales del Páramo;1027;515;512
24;León;185;Val de San Lorenzo;891;431;460
24;León;175;Valdefresno;1625;818;807
24;León;176;Valdefuentes del Páramo;566;294;272
24;León;177;Valdelugueros;527;272;255
24;León;178;Valdemora;162;83;79
24;León;179;Valdepiélago;496;244;252
24;León;180;Valdepolo;1934;1022;912
24;León;181;Valderas;2523;1270;1253
24;León;182;Valderrey;839;408;431
24;León;183;Valderrueda;1756;865;891
24;León;184;Valdesamario;385;188;197
24;León;187;Valdevimbre;1482;752;730
24;León;188;Valencia de Don Juan;3878;1943;1935
24;León;191;Vallecillo;247;129;118
24;León;189;Valverde de la Virgen;3716;1896;1820
24;León;190;Valverde-Enrique;324;159;165
24;León;193;Vecilla (La);547;266;281
24;León;196;Vega de Espinareda;3682;1874;1808
24;León;197;Vega de Infanzones;977;497;480
24;León;198;Vega de Valcarce;1332;666;666
24;León;194;Vegacervera;409;213;196
24;León;199;Vegaquemada;712;343;369
24;León;201;Vegas del Condado;1784;899;885
24;León;202;Villablino;15993;8121;7872
24;León;203;Villabraz;229;119;110
24;León;205;Villadangos del Páramo;1088;533;555
24;León;206;Villadecanes;2643;1339;1304
24;León;207;Villademor de la Vega;594;313;281
24;León;209;Villafranca del Bierzo;5049;2531;2518
24;León;210;Villagatón;1281;662;619
24;León;211;Villamandos;596;284;312
24;León;901;Villamanín;1843;938;905
24;León;212;Villamañán;1694;821;873
24;León;213;Villamartín de Don Sancho;283;143;140
24;León;214;Villamejil;1224;628;596
24;León;215;Villamol;344;166;178
24;León;216;Villamontán de la Valduerna;1467;755;712
24;León;217;Villamoratiel de las Matas;280;151;129
24;León;218;Villanueva de las Manzanas;764;351;413
24;León;219;Villaobispo de Otero;871;445;426
24;León;902;Villaornate y Castro;674;344;330
24;León;221;Villaquejida;1252;637;615
24;León;222;Villaquilambre;4864;2387;2477
24;León;223;Villarejo de Órbigo;3824;1879;1945
24;León;224;Villares de Órbigo;1169;594;575
24;León;225;Villasabariego;1417;706;711
24;León;226;Villaselán;459;246;213
24;León;227;Villaturiel;1865;948;917
24;León;228;Villazala;1349;685;664
24;León;229;Villazanzo de Valderaduey;909;484;425
24;León;230;Zotes del Páramo;950;489;461
25;Lleida;001;Abella de la Conca;168;88;80
25;Lleida;002;Àger;619;323;296
25;Lleida;003;Agramunt;4775;2396;2379
25;Lleida;038;Aitona;2345;1165;1180
25;Lleida;004;Alamús (Els);667;337;330
25;Lleida;005;Alàs i Cerc;431;232;199
25;Lleida;006;Albagés (L');571;284;287
25;Lleida;007;Albatàrrec;1015;497;518
25;Lleida;008;Albesa;1451;727;724
25;Lleida;009;Albi (L');807;419;388
25;Lleida;010;Alcanó;291;142;149
25;Lleida;011;Alcarràs;4523;2261;2262
25;Lleida;012;Alcoletge;1481;744;737
25;Lleida;013;Alfarràs;3121;1527;1594
25;Lleida;014;Alfés;345;182;163
25;Lleida;015;Algerri;572;277;295
25;Lleida;016;Alguaire;2872;1423;1449
25;Lleida;017;Alins;299;153;146
25;Lleida;019;Almacelles;5553;2832;2721
25;Lleida;020;Almatret;568;294;274
25;Lleida;021;Almenar;3598;1850;1748
25;Lleida;022;Alòs de Balaguer;179;101;78
25;Lleida;023;Alpicat;3688;1915;1773
25;Lleida;024;Alt Àneu;349;188;161
25;Lleida;027;Anglesola;1300;657;643
25;Lleida;029;Arbeca;2397;1181;1216
25;Lleida;031;Arres;45;27;18
25;Lleida;032;Arsèguel;95;49;46
25;Lleida;033;Artesa de Lleida;1165;569;596
25;Lleida;034;Artesa de Segre;3186;1634;1552
25;Lleida;036;Aspa;266;133;133
25;Lleida;037;Avellanes i Santa Linya (Les);512;275;237
25;Lleida;039;Baix Pallars;396;218;178
25;Lleida;040;Balaguer;13378;6621;6757
25;Lleida;041;Barbens;799;413;386
25;Lleida;042;Baronia de Rialb (La);264;142;122
25;Lleida;044;Bassella;382;198;184
25;Lleida;045;Bausen;63;41;22
25;Lleida;046;Belianes;592;285;307
25;Lleida;170;Bellaguarda;394;199;195
25;Lleida;047;Bellcaire d'Urgell;1463;720;743
25;Lleida;048;Bell-lloc d'Urgell;2243;1121;1122
25;Lleida;049;Bellmunt d'Urgell;236;120;116
25;Lleida;050;Bellpuig;3800;1866;1934
25;Lleida;051;Bellver de Cerdanya;1584;820;764
25;Lleida;052;Bellvís;2313;1149;1164
25;Lleida;053;Benavent de Segrià;731;373;358
25;Lleida;055;Biosca;282;137;145
25;Lleida;057;Bòrdes (Es);190;97;93
25;Lleida;058;Borges Blanques (Les);5193;2559;2634
25;Lleida;059;Bossòst;827;410;417
25;Lleida;056;Bovera;468;238;230
25;Lleida;060;Cabanabona;119;57;62
25;Lleida;061;Cabó;158;88;70
25;Lleida;062;Camarasa;988;495;493
25;Lleida;063;Canejan;117;64;53
25;Lleida;904;Castell de Mur;144;71;73
25;Lleida;064;Castellar de la Ribera;170;83;87
25;Lleida;067;Castelldans;978;495;483
25;Lleida;068;Castellnou de Seana;770;377;393
25;Lleida;069;Castelló de Farfanya;642;324;318
25;Lleida;070;Castellserà;1238;615;623
25;Lleida;071;Cava;53;33;20
25;Lleida;072;Cervera;6950;3417;3533
25;Lleida;073;Cervià de les Garrigues;918;458;460
25;Lleida;074;Ciutadilla;243;127;116
25;Lleida;075;Clariana de Cardener;158;83;75
25;Lleida;076;Cogul (El);248;122;126
25;Lleida;077;Coll de Nargó;666;345;321
25;Lleida;163;Coma i la Pedra (La);253;144;109
25;Lleida;161;Conca de Dalt;487;258;229
25;Lleida;078;Corbins;1043;536;507
25;Lleida;079;Cubells;398;207;191
25;Lleida;081;Espluga Calba (L');438;231;207
25;Lleida;082;Espot;234;121;113
25;Lleida;088;Estamariu;138;73;65
25;Lleida;085;Estaràs;191;95;96
25;Lleida;086;Esterri d'Àneu;544;274;270
25;Lleida;087;Esterri de Cardós;65;34;31
25;Lleida;089;Farrera;94;51;43
25;Lleida;908;Fígols i Alinyà;358;201;157
25;Lleida;092;Floresta (La);201;97;104
25;Lleida;093;Fondarella;587;290;297
25;Lleida;094;Foradada;156;87;69
25;Lleida;096;Fuliola (La);1343;687;656
25;Lleida;097;Fulleda;120;57;63
25;Lleida;098;Gavet de la Conca;372;183;189
25;Lleida;912;Gimenells i el Pla de la Font;"";"";""
25;Lleida;099;Golmés;1273;632;641
25;Lleida;100;Gósol;203;110;93
25;Lleida;101;Granadella (La);893;451;442
25;Lleida;102;Granja d'Escarp (La);1164;580;584
25;Lleida;103;Granyanella;121;61;60
25;Lleida;105;Granyena de les Garrigues;199;99;100
25;Lleida;104;Granyena de Segarra;195;102;93
25;Lleida;109;Guimerà;473;234;239
25;Lleida;903;Guingueta d'Àneu (La);263;135;128
25;Lleida;110;Guissona;2648;1326;1322
25;Lleida;111;Guixers;166;96;70
25;Lleida;115;Isona i Conca Dellà;1428;726;702
25;Lleida;112;Ivars de Noguera;365;184;181
25;Lleida;113;Ivars d'Urgell;1764;869;895
25;Lleida;114;Ivorra;192;96;96
25;Lleida;910;Josa i Tuixén;138;70;68
25;Lleida;118;Juncosa;603;312;291
25;Lleida;119;Juneda;3008;1522;1486
25;Lleida;121;Les;666;328;338
25;Lleida;122;Linyola;2422;1233;1189
25;Lleida;123;Lladorre;227;128;99
25;Lleida;124;Lladurs;251;133;118
25;Lleida;125;Llardecans;690;351;339
25;Lleida;126;Llavorsí;285;145;140
25;Lleida;120;Lleida;111825;54810;57015
25;Lleida;127;Lles de Cerdanya;307;164;143
25;Lleida;128;Llimiana;140;77;63
25;Lleida;129;Llobera;240;123;117
25;Lleida;133;Maials;1154;580;574
25;Lleida;130;Maldà;333;175;158
25;Lleida;131;Massalcoreig;691;341;350
25;Lleida;132;Massoteres;168;88;80
25;Lleida;134;Menàrguens;904;439;465
25;Lleida;135;Miralcamp;1213;590;623
25;Lleida;137;Mollerussa;8792;4373;4419
25;Lleida;136;Molsosa (La);136;67;69
25;Lleida;139;Montellà i Martinet;559;299;260
25;Lleida;140;Montferrer i Castellbò;650;346;304
25;Lleida;138;Montgai;862;435;427
25;Lleida;142;Montoliu de Lleida;461;224;237
25;Lleida;141;Montoliu de Segarra;225;118;107
25;Lleida;143;Montornès de Segarra;132;56;76
25;Lleida;145;Nalec;101;46;55
25;Lleida;025;Naut Aran;1239;670;569
25;Lleida;146;Navès;291;151;140
25;Lleida;148;Odèn;337;184;153
25;Lleida;149;Oliana;2029;1040;989
25;Lleida;150;Oliola;245;137;108
25;Lleida;151;Olius;507;257;250
25;Lleida;152;Oluges (Les);227;117;110
25;Lleida;153;Omellons (Els);282;143;139
25;Lleida;154;Omells de na Gaia (Els);159;86;73
25;Lleida;155;Organyà;1048;538;510
25;Lleida;156;Os de Balaguer;846;484;362
25;Lleida;157;Ossó de Sió;253;123;130
25;Lleida;158;Palau d'Anglesola (El);1607;816;791
25;Lleida;164;Penelles;582;289;293
25;Lleida;165;Peramola;399;209;190
25;Lleida;166;Pinell de Solsonès;252;135;117
25;Lleida;167;Pinós;369;199;170
25;Lleida;911;Plans de Sió (Els);743;375;368
25;Lleida;168;Poal (El);693;362;331
25;Lleida;169;Pobla de Cérvoles (La);208;110;98
25;Lleida;171;Pobla de Segur (La);3202;1557;1645
25;Lleida;030;Pont de Bar (El);172;95;77
25;Lleida;173;Pont de Suert (El);2294;1147;1147
25;Lleida;172;Ponts;2250;1117;1133
25;Lleida;174;Portella (La);633;334;299
25;Lleida;175;Prats i Sansor;117;65;52
25;Lleida;176;Preixana;485;244;241
25;Lleida;177;Preixens;607;263;344
25;Lleida;179;Prullans;187;96;91
25;Lleida;180;Puiggròs;275;132;143
25;Lleida;181;Puigverd d'Agramunt;243;126;117
25;Lleida;182;Puigverd de Lleida;954;443;511
25;Lleida;183;Rialp;466;252;214
25;Lleida;905;Ribera d'Ondara;505;256;249
25;Lleida;185;Ribera d'Urgellet;822;446;376
25;Lleida;186;Riner;280;155;125
25;Lleida;913;Riu de Cerdanya;"";"";""
25;Lleida;189;Rosselló;1595;785;810
25;Lleida;190;Salàs de Pallars;357;177;180
25;Lleida;191;Sanaüja;457;223;234
25;Lleida;196;Sant Esteve de la Sarga;136;79;57
25;Lleida;192;Sant Guim de Freixenet;1049;519;530
25;Lleida;197;Sant Guim de la Plana;207;107;100
25;Lleida;193;Sant Llorenç de Morunys;861;449;412
25;Lleida;902;Sant Martí de Riucorb;802;410;392
25;Lleida;194;Sant Ramon;589;290;299
25;Lleida;201;Sarroca de Bellera;136;75;61
25;Lleida;200;Sarroca de Lleida;515;265;250
25;Lleida;202;Senterada;116;72;44
25;Lleida;035;Sentiu de Sió (La);475;237;238
25;Lleida;204;Seròs;1943;1032;911
25;Lleida;203;Seu d'Urgell (La);10468;5247;5221
25;Lleida;205;Sidamon;442;224;218
25;Lleida;206;Soleràs (El);476;237;239
25;Lleida;207;Solsona;6609;3308;3301
25;Lleida;208;Soriguera;281;141;140
25;Lleida;209;Sort;1546;785;761
25;Lleida;210;Soses;1511;770;741
25;Lleida;211;Sudanell;802;421;381
25;Lleida;212;Sunyer;317;162;155
25;Lleida;215;Talarn;364;187;177
25;Lleida;216;Talavera;315;151;164
25;Lleida;217;Tàrrega;11438;5571;5867
25;Lleida;218;Tarrés;103;52;51
25;Lleida;219;Tarroja de Segarra;208;109;99
25;Lleida;220;Térmens;1410;701;709
25;Lleida;221;Tírvia;102;57;45
25;Lleida;222;Tiurana;231;124;107
25;Lleida;223;Torà;1181;610;571
25;Lleida;224;Torms (Els);215;121;94
25;Lleida;225;Tornabous;927;460;467
25;Lleida;227;Torre de Cabdella (La);712;343;369
25;Lleida;226;Torrebesses;361;181;180
25;Lleida;228;Torrefarrera;1447;745;702
25;Lleida;907;Torrefeta i Florejacs;723;352;371
25;Lleida;230;Torregrossa;2246;1116;1130
25;Lleida;231;Torrelameu;600;321;279
25;Lleida;232;Torres de Segre;1863;944;919
25;Lleida;233;Torre-serona;302;155;147
25;Lleida;234;Tremp;5505;2710;2795
25;Lleida;043;Vall de Boí (La);566;313;253
25;Lleida;901;Vall de Cardós;323;171;152
25;Lleida;238;Vallbona de les Monges;285;134;151
25;Lleida;240;Vallfogona de Balaguer;1413;708;705
25;Lleida;906;Valls d'Aguilar (Les);240;132;108
25;Lleida;239;Valls de Valira (Les);759;407;352
25;Lleida;909;Vansa i Fórnols (La);161;87;74
25;Lleida;242;Verdú;960;469;491
25;Lleida;243;Vielha e Mijaran;3262;1656;1606
25;Lleida;244;Vilagrassa;422;208;214
25;Lleida;245;Vilaller;629;336;293
25;Lleida;247;Vilamòs;122;62;60
25;Lleida;248;Vilanova de Bellpuig;1222;595;627
25;Lleida;254;Vilanova de la Barca;907;455;452
25;Lleida;249;Vilanova de l'Aguda;277;147;130
25;Lleida;250;Vilanova de Meià;508;255;253
25;Lleida;251;Vilanova de Segrià;677;336;341
25;Lleida;252;Vila-sana;563;281;282
25;Lleida;253;Vilosell (El);206;95;111
25;Lleida;255;Vinaixa;722;365;357
26;Rioja (La);001;Ábalos;297;165;132
26;Rioja (La);002;Agoncillo;872;461;411
26;Rioja (La);003;Aguilar del Río Alhama;890;454;436
26;Rioja (La);004;Ajamil;74;45;29
26;Rioja (La);005;Albelda de Iregua;2341;1191;1150
26;Rioja (La);006;Alberite;1989;1002;987
26;Rioja (La);007;Alcanadre;950;474;476
26;Rioja (La);008;Aldeanueva de Ebro;2649;1374;1275
26;Rioja (La);009;Alesanco;578;294;284
26;Rioja (La);010;Alesón;174;88;86
26;Rioja (La);011;Alfaro;9235;4596;4639
26;Rioja (La);012;Almarza de Cameros;38;22;16
26;Rioja (La);013;Anguciana;369;184;185
26;Rioja (La);014;Anguiano;751;404;347
26;Rioja (La);015;Arenzana de Abajo;405;215;190
26;Rioja (La);016;Arenzana de Arriba;46;24;22
26;Rioja (La);017;Arnedillo;423;213;210
26;Rioja (La);018;Arnedo;12419;6185;6234
26;Rioja (La);019;Arrúbal;404;211;193
26;Rioja (La);020;Ausejo;745;389;356
26;Rioja (La);021;Autol;3461;1742;1719
26;Rioja (La);022;Azofra;442;233;209
26;Rioja (La);023;Badarán;877;469;408
26;Rioja (La);024;Bañares;548;277;271
26;Rioja (La);026;Baños de Río Tobía;1846;927;919
26;Rioja (La);025;Baños de Rioja;145;85;60
26;Rioja (La);027;Berceo;256;144;112
26;Rioja (La);028;Bergasa;219;119;100
26;Rioja (La);029;Bergasillas Bajera;32;18;14
26;Rioja (La);030;Bezares;26;16;10
26;Rioja (La);031;Bobadilla;197;96;101
26;Rioja (La);032;Brieva de Cameros;73;38;35
26;Rioja (La);033;Briñas;206;103;103
26;Rioja (La);034;Briones;956;518;438
26;Rioja (La);035;Cabezón de Cameros;43;24;19
26;Rioja (La);036;Calahorra;18869;9108;9761
26;Rioja (La);037;Camprovín;274;142;132
26;Rioja (La);038;Canales de la Sierra;89;46;43
26;Rioja (La);039;Canillas de Río Tuerto;89;42;47
26;Rioja (La);040;Cañas;124;58;66
26;Rioja (La);041;Cárdenas;282;135;147
26;Rioja (La);042;Casalarreina;969;491;478
26;Rioja (La);043;Castañares de Rioja;575;296;279
26;Rioja (La);044;Castroviejo;49;24;25
26;Rioja (La);045;Cellorigo;22;12;10
26;Rioja (La);046;Cenicero;2211;1123;1088
26;Rioja (La);047;Cervera del Río Alhama;3630;1797;1833
26;Rioja (La);048;Cidamón;99;56;43
26;Rioja (La);049;Cihuri;204;104;100
26;Rioja (La);050;Cirueña;140;79;61
26;Rioja (La);051;Clavijo;187;98;89
26;Rioja (La);052;Cordovín;271;132;139
26;Rioja (La);053;Corera;269;134;135
26;Rioja (La);054;Cornago;790;429;361
26;Rioja (La);055;Corporales;77;41;36
26;Rioja (La);056;Cuzcurrita de Río Tirón;561;302;259
26;Rioja (La);057;Daroca de Rioja;62;37;25
26;Rioja (La);058;Enciso;173;97;76
26;Rioja (La);059;Entrena;1116;592;524
26;Rioja (La);060;Estollo;151;80;71
26;Rioja (La);061;Ezcaray;1819;957;862
26;Rioja (La);062;Foncea;160;88;72
26;Rioja (La);063;Fonzaleche;239;122;117
26;Rioja (La);064;Fuenmayor;2126;1063;1063
26;Rioja (La);065;Galbárruli;59;34;25
26;Rioja (La);066;Galilea;275;149;126
26;Rioja (La);067;Gallinero de Cameros;22;14;8
26;Rioja (La);068;Gimileo;94;48;46
26;Rioja (La);069;Grañón;525;280;245
26;Rioja (La);070;Grávalos;355;179;176
26;Rioja (La);071;Haro;9172;4487;4685
26;Rioja (La);072;Herce;377;188;189
26;Rioja (La);073;Herramélluri;204;106;98
26;Rioja (La);074;Hervías;250;128;122
26;Rioja (La);075;Hormilla;500;259;241
26;Rioja (La);076;Hormilleja;206;104;102
26;Rioja (La);077;Hornillos de Cameros;22;11;11
26;Rioja (La);078;Hornos de Moncalvillo;93;48;45
26;Rioja (La);079;Huércanos;994;511;483
26;Rioja (La);080;Igea;1017;548;469
26;Rioja (La);081;Jalón de Cameros;48;27;21
26;Rioja (La);082;Laguna de Cameros;193;104;89
26;Rioja (La);083;Lagunilla del Jubera;407;203;204
26;Rioja (La);084;Lardero;2751;1362;1389
26;Rioja (La);086;Ledesma de la Cogolla;27;17;10
26;Rioja (La);087;Leiva;372;178;194
26;Rioja (La);088;Leza de Río Leza;26;20;6
26;Rioja (La);089;Logroño;121911;59109;62802
26;Rioja (La);091;Lumbreras;178;106;72
26;Rioja (La);092;Manjarrés;149;78;71
26;Rioja (La);093;Mansilla de la Sierra;57;36;21
26;Rioja (La);094;Manzanares de Rioja;162;86;76
26;Rioja (La);095;Matute;216;108;108
26;Rioja (La);096;Medrano;260;135;125
26;Rioja (La);098;Munilla;138;68;70
26;Rioja (La);099;Murillo de Río Leza;1671;831;840
26;Rioja (La);100;Muro de Aguas;70;39;31
26;Rioja (La);101;Muro en Cameros;46;31;15
26;Rioja (La);102;Nájera;6797;3384;3413
26;Rioja (La);103;Nalda;950;505;445
26;Rioja (La);104;Navajún;22;14;8
26;Rioja (La);105;Navarrete;2048;1055;993
26;Rioja (La);106;Nestares;59;30;29
26;Rioja (La);107;Nieva de Cameros;138;74;64
26;Rioja (La);109;Ochánduri;115;57;58
26;Rioja (La);108;Ocón;357;194;163
26;Rioja (La);110;Ojacastro;274;158;116
26;Rioja (La);111;Ollauri;321;174;147
26;Rioja (La);112;Ortigosa de Cameros;358;175;183
26;Rioja (La);113;Pazuengos;44;25;19
26;Rioja (La);114;Pedroso;116;61;55
26;Rioja (La);115;Pinillos;25;16;9
26;Rioja (La);117;Pradejón;2827;1430;1397
26;Rioja (La);118;Pradillo;105;55;50
26;Rioja (La);119;Préjano;247;121;126
26;Rioja (La);120;Quel;2047;1063;984
26;Rioja (La);121;Rabanera;50;24;26
26;Rioja (La);122;Rasillo de Cameros (El);115;60;55
26;Rioja (La);123;Redal (El);246;124;122
26;Rioja (La);124;Ribafrecha;1113;597;516
26;Rioja (La);125;Rincón de Soto;3449;1741;1708
26;Rioja (La);126;Robres del Castillo;29;17;12
26;Rioja (La);127;Rodezno;384;192;192
26;Rioja (La);128;Sajazarra;187;95;92
26;Rioja (La);129;San Asensio;1476;764;712
26;Rioja (La);130;San Millán de la Cogolla;306;183;123
26;Rioja (La);131;San Millán de Yécora;91;52;39
26;Rioja (La);132;San Román de Cameros;187;99;88
26;Rioja (La);139;San Torcuato;157;83;74
26;Rioja (La);142;San Vicente de la Sonsierra;1213;620;593
26;Rioja (La);134;Santa Coloma;183;106;77
26;Rioja (La);135;Santa Engracia del Jubera;205;123;82
26;Rioja (La);136;Santa Eulalia Bajera;117;64;53
26;Rioja (La);138;Santo Domingo de la Calzada;5767;2907;2860
26;Rioja (La);140;Santurde de Rioja;339;165;174
26;Rioja (La);141;Santurdejo;240;131;109
26;Rioja (La);143;Sojuela;98;57;41
26;Rioja (La);144;Sorzano;291;160;131
26;Rioja (La);145;Sotés;300;155;145
26;Rioja (La);146;Soto en Cameros;124;70;54
26;Rioja (La);147;Terroba;38;20;18
26;Rioja (La);148;Tirgo;303;154;149
26;Rioja (La);149;Tobía;73;42;31
26;Rioja (La);150;Tormantos;238;127;111
26;Rioja (La);153;Torre en Cameros;16;12;4
26;Rioja (La);151;Torrecilla en Cameros;545;285;260
26;Rioja (La);152;Torrecilla sobre Alesanco;115;58;57
26;Rioja (La);154;Torremontalbo;14;9;5
26;Rioja (La);155;Treviana;346;187;159
26;Rioja (La);157;Tricio;414;208;206
26;Rioja (La);158;Tudelilla;540;272;268
26;Rioja (La);160;Uruñuela;755;388;367
26;Rioja (La);161;Valdemadera;21;12;9
26;Rioja (La);162;Valgañón;185;96;89
26;Rioja (La);163;Ventosa;153;77;76
26;Rioja (La);164;Ventrosa;102;43;59
26;Rioja (La);165;Viguera;434;233;201
26;Rioja (La);166;Villalba de Rioja;193;106;87
26;Rioja (La);167;Villalobar de Rioja;145;83;62
26;Rioja (La);168;Villamediana de Iregua;1889;964;925
26;Rioja (La);169;Villanueva de Cameros;126;64;62
26;Rioja (La);170;Villar de Arnedo (El);795;386;409
26;Rioja (La);171;Villar de Torre;383;201;182
26;Rioja (La);172;Villarejo;48;27;21
26;Rioja (La);173;Villarroya;12;6;6
26;Rioja (La);174;Villarta-Quintana;255;128;127
26;Rioja (La);175;Villavelayo;81;48;33
26;Rioja (La);176;Villaverde de Rioja;104;60;44
26;Rioja (La);177;Villoslada de Cameros;417;229;188
26;Rioja (La);178;Viniegra de Abajo;148;73;75
26;Rioja (La);179;Viniegra de Arriba;47;26;21
26;Rioja (La);180;Zarratón;319;162;157
26;Rioja (La);181;Zarzosa;23;14;9
26;Rioja (La);183;Zorraquín;42;25;17
27;Lugo;001;Abadín;4697;2295;2402
27;Lugo;002;Alfoz;2801;1373;1428
27;Lugo;003;Antas de Ulla;4112;2035;2077
27;Lugo;004;Baleira;2428;1268;1160
27;Lugo;901;Baralla;4225;2171;2054
27;Lugo;005;Barreiros;4041;1980;2061
27;Lugo;006;Becerreá;4643;2374;2269
27;Lugo;007;Begonte;4687;2323;2364
27;Lugo;008;Bóveda;2560;1266;1294
27;Lugo;902;Burela;"";"";""
27;Lugo;009;Carballedo;5041;2525;2516
27;Lugo;010;Castro de Rei;6134;3087;3047
27;Lugo;011;Castroverde;4266;2175;2091
27;Lugo;012;Cervantes;3059;1669;1390
27;Lugo;013;Cervo;12325;6126;6199
27;Lugo;016;Chantada;11271;5484;5787
27;Lugo;014;Corgo (O);5158;2609;2549
27;Lugo;015;Cospeito;6971;3435;3536
27;Lugo;017;Folgoso do Courel;2542;1312;1230
27;Lugo;018;Fonsagrada (A);8115;4269;3846
27;Lugo;019;Foz;9930;4760;5170
27;Lugo;020;Friol;5452;2753;2699
27;Lugo;022;Guitiriz;7377;3657;3720
27;Lugo;023;Guntín;4379;2151;2228
27;Lugo;024;Incio (O);3498;1786;1712
27;Lugo;026;Láncara;4062;2086;1976
27;Lugo;027;Lourenzá;3227;1570;1657
27;Lugo;028;Lugo;81493;38753;42740
27;Lugo;029;Meira;2029;995;1034
27;Lugo;030;Mondoñedo;6377;3002;3375
27;Lugo;031;Monforte de Lemos;20415;9802;10613
27;Lugo;032;Monterroso;5176;2702;2474
27;Lugo;033;Muras;1934;968;966
27;Lugo;034;Navia de Suarna;3229;1695;1534
27;Lugo;035;Negueira de Muñiz;385;206;179
27;Lugo;037;Nogais (As);2129;1136;993
27;Lugo;038;Ourol;2224;1036;1188
27;Lugo;039;Outeiro de Rei;4474;2215;2259
27;Lugo;040;Palas de Rei;6100;3038;3062
27;Lugo;041;Pantón;5652;2720;2932
27;Lugo;042;Paradela;3290;1635;1655
27;Lugo;043;Páramo (O);2212;1138;1074
27;Lugo;044;Pastoriza (A);4815;2423;2392
27;Lugo;045;Pedrafita do Cebreiro;2394;1273;1121
27;Lugo;047;Pobra do Brollón (A);3419;1667;1752
27;Lugo;046;Pol;2642;1311;1331
27;Lugo;048;Pontenova (A);4004;1970;2034
27;Lugo;049;Portomarín;2449;1241;1208
27;Lugo;050;Quiroga;5593;2779;2814
27;Lugo;056;Rábade;1896;958;938
27;Lugo;051;Ribadeo;9266;4360;4906
27;Lugo;052;Ribas de Sil;1933;960;973
27;Lugo;053;Ribeira de Piquín;1203;613;590
27;Lugo;054;Riotorto;2409;1197;1212
27;Lugo;055;Samos;3026;1618;1408
27;Lugo;057;Sarria;13307;6631;6676
27;Lugo;058;Saviñao (O);7069;3491;3578
27;Lugo;059;Sober;4863;2392;2471
27;Lugo;060;Taboada;6004;2976;3028
27;Lugo;061;Trabada;2163;1050;1113
27;Lugo;062;Triacastela;1132;590;542
27;Lugo;063;Valadouro (O);3000;1480;1520
27;Lugo;064;Vicedo (O);2973;1450;1523
27;Lugo;065;Vilalba;16584;8088;8496
27;Lugo;066;Viveiro;15137;7285;7852
27;Lugo;021;Xermade;3345;1630;1715
27;Lugo;025;Xove;3789;1918;1871
28;Madrid;001;Acebeda (La);60;33;27
28;Madrid;002;Ajalvir;1181;628;553
28;Madrid;003;Alameda del Valle;144;82;62
28;Madrid;004;Álamo (El);2395;1228;1167
28;Madrid;005;Alcalá de Henares;155548;77295;78253
28;Madrid;006;Alcobendas;78295;38901;39394
28;Madrid;007;Alcorcón;141080;70149;70931
28;Madrid;008;Aldea del Fresno;1056;535;521
28;Madrid;009;Algete;9714;5026;4688
28;Madrid;010;Alpedrete;3294;1656;1638
28;Madrid;011;Ambite;313;152;161
28;Madrid;012;Anchuelo;516;277;239
28;Madrid;013;Aranjuez;38239;18602;19637
28;Madrid;014;Arganda del Rey;26124;13047;13077
28;Madrid;015;Arroyomolinos;683;340;343
28;Madrid;016;Atazar (El);88;47;41
28;Madrid;017;Batres;325;165;160
28;Madrid;018;Becerril de la Sierra;1732;856;876
28;Madrid;019;Belmonte de Tajo;1082;550;532
28;Madrid;021;Berrueco (El);246;131;115
28;Madrid;020;Berzosa del Lozoya;73;41;32
28;Madrid;022;Boadilla del Monte;13629;6902;6727
28;Madrid;023;Boalo (El);1610;816;794
28;Madrid;024;Braojos;131;71;60
28;Madrid;025;Brea de Tajo;503;258;245
28;Madrid;026;Brunete;2241;1126;1115
28;Madrid;027;Buitrago del Lozoya;1251;670;581
28;Madrid;028;Bustarviejo;1209;617;592
28;Madrid;029;Cabanillas de la Sierra;366;185;181
28;Madrid;030;Cabrera (La);903;450;453
28;Madrid;031;Cadalso de los Vidrios;2093;1070;1023
28;Madrid;032;Camarma de Esteruelas;1385;702;683
28;Madrid;033;Campo Real;2136;1091;1045
28;Madrid;034;Canencia;445;234;211
28;Madrid;035;Carabaña;1056;530;526
28;Madrid;036;Casarrubuelos;524;289;235
28;Madrid;037;Cenicientos;2055;1027;1028
28;Madrid;038;Cercedilla;3970;1954;2016
28;Madrid;039;Cervera de Buitrago;88;44;44
28;Madrid;051;Chapinería;798;426;372
28;Madrid;052;Chinchón;3993;2016;1977
28;Madrid;040;Ciempozuelos;10569;5398;5171
28;Madrid;041;Cobeña;1008;508;500
28;Madrid;046;Collado Mediano;2011;997;1014
28;Madrid;047;Collado Villalba;25889;12928;12961
28;Madrid;043;Colmenar de Oreja;5303;2558;2745
28;Madrid;042;Colmenar del Arroyo;434;218;216
28;Madrid;045;Colmenar Viejo;37159;18491;18668
28;Madrid;044;Colmenarejo;1965;1016;949
28;Madrid;048;Corpa;370;191;179
28;Madrid;049;Coslada;73252;36804;36448
28;Madrid;050;Cubas de la Sagra;863;418;445
28;Madrid;053;Daganzo de Arriba;1539;788;751
28;Madrid;054;Escorial (El);7255;3598;3657
28;Madrid;055;Estremera;1072;563;509
28;Madrid;056;Fresnedillas de la Oliva;425;208;217
28;Madrid;057;Fresno de Torote;180;89;91
28;Madrid;058;Fuenlabrada;141496;71835;69661
28;Madrid;059;Fuente el Saz de Jarama;2282;1177;1105
28;Madrid;060;Fuentidueña de Tajo;1263;624;639
28;Madrid;061;Galapagar;9729;4974;4755
28;Madrid;062;Garganta de los Montes;326;169;157
28;Madrid;063;Gargantilla del Lozoya y Pinilla de Buitrago;214;122;92
28;Madrid;064;Gascones;98;48;50
28;Madrid;065;Getafe;139068;69393;69675
28;Madrid;066;Griñón;2128;1127;1001
28;Madrid;067;Guadalix de la Sierra;1644;838;806
28;Madrid;068;Guadarrama;6782;3363;3419
28;Madrid;069;Hiruela (La);62;37;25
28;Madrid;070;Horcajo de la Sierra;129;65;64
28;Madrid;071;Horcajuelo de la Sierra;62;30;32
28;Madrid;072;Hoyo de Manzanares;3098;1589;1509
28;Madrid;073;Humanes de Madrid;7505;3830;3675
28;Madrid;074;Leganés;172729;86751;85978
28;Madrid;075;Loeches;2108;1068;1040
28;Madrid;076;Lozoya;447;232;215
28;Madrid;901;Lozoyuela-Navas-Sieteiglesias;610;340;270
28;Madrid;078;Madarcos;35;17;18
28;Madrid;079;Madrid;3120732;1471029;1649703
28;Madrid;080;Majadahonda;33900;16697;17203
28;Madrid;082;Manzanares el Real;2035;1053;982
28;Madrid;083;Meco;2642;1352;1290
28;Madrid;084;Mejorada del Campo;12977;6567;6410
28;Madrid;085;Miraflores de la Sierra;2664;1342;1322
28;Madrid;086;Molar (El);2742;1437;1305
28;Madrid;087;Molinos (Los);2405;1126;1279
28;Madrid;088;Montejo de la Sierra;255;128;127
28;Madrid;089;Moraleja de Enmedio;1519;763;756
28;Madrid;090;Moralzarzal;1855;927;928
28;Madrid;091;Morata de Tajuña;4828;2384;2444
28;Madrid;092;Móstoles;189707;94732;94975
28;Madrid;093;Navacerrada;1600;876;724
28;Madrid;094;Navalafuente;286;157;129
28;Madrid;095;Navalagamella;566;280;286
28;Madrid;096;Navalcarnero;9722;4911;4811
28;Madrid;097;Navarredonda y San Mamés;115;61;54
28;Madrid;099;Navas del Rey;1045;532;513
28;Madrid;100;Nuevo Baztán;771;427;344
28;Madrid;101;Olmeda de las Fuentes;136;70;66
28;Madrid;102;Orusco de Tajuña;583;289;294
28;Madrid;104;Paracuellos de Jarama;4408;2271;2137
28;Madrid;106;Parla;69017;34831;34186
28;Madrid;107;Patones;343;169;174
28;Madrid;108;Pedrezuela;799;409;390
28;Madrid;109;Pelayos de la Presa;807;409;398
28;Madrid;110;Perales de Tajuña;1925;924;1001
28;Madrid;111;Pezuela de las Torres;514;275;239
28;Madrid;112;Pinilla del Valle;149;81;68
28;Madrid;113;Pinto;22171;11114;11057
28;Madrid;114;Piñuécar-Gandullas;146;69;77
28;Madrid;115;Pozuelo de Alarcón;42504;20930;21574
28;Madrid;116;Pozuelo del Rey;210;109;101
28;Madrid;117;Prádena del Rincón;107;60;47
28;Madrid;118;Puebla de la Sierra;75;41;34
28;Madrid;902;Puentes Viejas;410;213;197
28;Madrid;119;Quijorna;593;312;281
28;Madrid;120;Rascafría;1273;653;620
28;Madrid;121;Redueña;122;60;62
28;Madrid;122;Ribatejada;250;124;126
28;Madrid;123;Rivas-Vaciamadrid;11604;5836;5768
28;Madrid;124;Robledillo de la Jara;62;27;35
28;Madrid;125;Robledo de Chavela;1743;873;870
28;Madrid;126;Robregordo;99;53;46
28;Madrid;127;Rozas de Madrid (Las);32478;16039;16439
28;Madrid;128;Rozas de Puerto Real;376;190;186
28;Madrid;129;San Agustín del Guadalix;3069;1585;1484
28;Madrid;130;San Fernando de Henares;24664;12387;12277
28;Madrid;131;San Lorenzo de El Escorial;9425;4568;4857
28;Madrid;132;San Martín de la Vega;6330;3251;3079
28;Madrid;133;San Martín de Valdeiglesias;5239;2652;2587
28;Madrid;134;San Sebastián de los Reyes;53427;26911;26516
28;Madrid;135;Santa María de la Alameda;740;404;336
28;Madrid;136;Santorcaz;530;274;256
28;Madrid;137;Santos de la Humosa (Los);909;471;438
28;Madrid;138;Serna del Monte (La);90;45;45
28;Madrid;140;Serranillos del Valle;492;259;233
28;Madrid;141;Sevilla la Nueva;975;503;472
28;Madrid;143;Somosierra;107;63;44
28;Madrid;144;Soto del Real;2230;1111;1119
28;Madrid;145;Talamanca de Jarama;1018;517;501
28;Madrid;146;Tielmes;1914;1000;914
28;Madrid;147;Titulcia;857;426;431
28;Madrid;148;Torrejón de Ardoz;86678;43636;43042
28;Madrid;149;Torrejón de la Calzada;1213;631;582
28;Madrid;150;Torrejón de Velasco;1322;667;655
28;Madrid;151;Torrelaguna;2520;1231;1289
28;Madrid;152;Torrelodones;6763;3340;3423
28;Madrid;153;Torremocha de Jarama;227;111;116
28;Madrid;154;Torres de la Alameda;2787;1402;1385
28;Madrid;903;Tres Cantos;"";"";""
28;Madrid;155;Valdaracete;724;349;375
28;Madrid;156;Valdeavero;485;250;235
28;Madrid;157;Valdelaguna;559;295;264
28;Madrid;158;Valdemanco;464;246;218
28;Madrid;159;Valdemaqueda;469;239;230
28;Madrid;160;Valdemorillo;2618;1345;1273
28;Madrid;161;Valdemoro;18552;9864;8688
28;Madrid;162;Valdeolmos-Alalpardo;892;490;402
28;Madrid;163;Valdepiélagos;312;160;152
28;Madrid;164;Valdetorres de Jarama;1146;582;564
28;Madrid;165;Valdilecha;1558;780;778
28;Madrid;166;Valverde de Alcalá;225;119;106
28;Madrid;167;Velilla de San Antonio;2070;1048;1022
28;Madrid;168;Vellón (El);884;450;434
28;Madrid;169;Venturada;302;157;145
28;Madrid;171;Villa del Prado;3287;1641;1646
28;Madrid;170;Villaconejos;2919;1491;1428
28;Madrid;172;Villalbilla;1772;910;862
28;Madrid;173;Villamanrique de Tajo;570;279;291
28;Madrid;174;Villamanta;1095;552;543
28;Madrid;175;Villamantilla;301;155;146
28;Madrid;176;Villanueva de la Cañada;3832;1945;1887
28;Madrid;178;Villanueva de Perales;363;199;164
28;Madrid;177;Villanueva del Pardillo;1898;948;950
28;Madrid;179;Villar del Olmo;462;236;226
28;Madrid;180;Villarejo de Salvanés;4725;2370;2355
28;Madrid;181;Villaviciosa de Odón;12218;5970;6248
28;Madrid;182;Villavieja del Lozoya;149;66;83
28;Madrid;183;Zarzalejo;790;409;381
29;Málaga;001;Alameda;4896;2456;2440
29;Málaga;002;Alcaucín;1467;736;731
29;Málaga;003;Alfarnate;1586;823;763
29;Málaga;004;Alfarnatejo;429;233;196
29;Málaga;005;Algarrobo;4804;2437;2367
29;Málaga;006;Algatocín;1081;559;522
29;Málaga;007;Alhaurín de la Torre;13056;6519;6537
29;Málaga;008;Alhaurín el Grande;16908;8443;8465
29;Málaga;009;Almáchar;2114;1086;1028
29;Málaga;010;Almargen;2350;1163;1187
29;Málaga;011;Almogía;4194;2127;2067
29;Málaga;012;Álora;13943;6960;6983
29;Málaga;013;Alozaina;2967;1541;1426
29;Málaga;014;Alpandeire;371;194;177
29;Málaga;015;Antequera;41863;20604;21259
29;Málaga;016;Árchez;383;207;176
29;Málaga;017;Archidona;10482;5261;5221
29;Málaga;018;Ardales;3091;1568;1523
29;Málaga;019;Arenas;1313;703;610
29;Málaga;020;Arriate;3320;1665;1655
29;Málaga;021;Atajate;165;93;72
29;Málaga;022;Benadalid;262;138;124
29;Málaga;023;Benahavís;2159;1082;1077
29;Málaga;024;Benalauría;598;309;289
29;Málaga;025;Benalmádena;24972;12541;12431
29;Málaga;026;Benamargosa;1684;860;824
29;Málaga;027;Benamocarra;2780;1393;1387
29;Málaga;028;Benaoján;1795;898;897
29;Málaga;029;Benarrabá;765;388;377
29;Málaga;030;Borge (El);1109;569;540
29;Málaga;031;Burgo (El);2201;1149;1052
29;Málaga;032;Campillos;7679;3890;3789
29;Málaga;033;Canillas de Aceituno;2773;1419;1354
29;Málaga;034;Canillas de Albaida;642;337;305
29;Málaga;035;Cañete la Real;2397;1240;1157
29;Málaga;036;Carratraca;1001;497;504
29;Málaga;037;Cartajima;397;201;196
29;Málaga;038;Cártama;12075;6044;6031
29;Málaga;039;Casabermeja;3182;1666;1516
29;Málaga;040;Casarabonela;2839;1480;1359
29;Málaga;041;Casares;3052;1561;1491
29;Málaga;042;Coín;20541;10495;10046
29;Málaga;043;Colmenar;3290;1612;1678
29;Málaga;044;Comares;1690;871;819
29;Málaga;045;Cómpeta;2316;1147;1169
29;Málaga;046;Cortes de la Frontera;4139;2079;2060
29;Málaga;047;Cuevas Bajas;1642;786;856
29;Málaga;049;Cuevas de San Marcos;4290;2141;2149
29;Málaga;048;Cuevas del Becerro;2075;1059;1016
29;Málaga;050;Cútar;667;322;345
29;Málaga;051;Estepona;31419;15802;15617
29;Málaga;052;Faraján;351;183;168
29;Málaga;053;Frigiliana;2126;1044;1082
29;Málaga;054;Fuengirola;41778;20685;21093
29;Málaga;055;Fuente de Piedra;2150;1089;1061
29;Málaga;056;Gaucín;1928;1006;922
29;Málaga;057;Genalguacil;746;384;362
29;Málaga;058;Guaro;2127;1070;1057
29;Málaga;059;Humilladero;2402;1217;1185
29;Málaga;060;Igualeja;1103;559;544
29;Málaga;061;Istán;1609;815;794
29;Málaga;062;Iznate;763;388;375
29;Málaga;063;Jimera de Líbar;526;265;261
29;Málaga;064;Jubrique;1005;516;489
29;Málaga;065;Júzcar;297;172;125
29;Málaga;066;Macharaviaya;364;189;175
29;Málaga;067;Málaga;560495;271787;288708
29;Málaga;068;Manilva;4847;2477;2370
29;Málaga;069;Marbella;81876;40693;41183
29;Málaga;070;Mijas;31011;15585;15426
29;Málaga;071;Moclinejo;1225;626;599
29;Málaga;072;Mollina;3235;1594;1641
29;Málaga;073;Monda;1684;858;826
29;Málaga;074;Montejaque;1357;674;683
29;Málaga;075;Nerja;13627;6820;6807
29;Málaga;076;Ojén;2080;1096;984
29;Málaga;077;Parauta;393;198;195
29;Málaga;079;Periana;3701;1936;1765
29;Málaga;080;Pizarra;6422;3277;3145
29;Málaga;081;Pujerra;320;186;134
29;Málaga;082;Rincón de la Victoria;12182;6078;6104
29;Málaga;083;Riogordo;2844;1438;1406
29;Málaga;084;Ronda;34102;16848;17254
29;Málaga;085;Salares;289;146;143
29;Málaga;086;Sayalonga;1131;590;541
29;Málaga;087;Sedella;577;306;271
29;Málaga;088;Sierra de Yeguas;3313;1630;1683
29;Málaga;089;Teba;4552;2334;2218
29;Málaga;090;Tolox;3133;1613;1520
29;Málaga;901;Torremolinos;26290;13091;13199
29;Málaga;091;Torrox;10623;5423;5200
29;Málaga;092;Totalán;619;320;299
29;Málaga;093;Valle de Abdalajís;3151;1594;1557
29;Málaga;094;Vélez-Málaga;54234;27201;27033
29;Málaga;095;Villanueva de Algaidas;4432;2206;2226
29;Málaga;098;Villanueva de Tapia;1564;796;768
29;Málaga;096;Villanueva del Rosario;3249;1600;1649
29;Málaga;097;Villanueva del Trabuco;4648;2361;2287
29;Málaga;099;Viñuela;1250;632;618
29;Málaga;100;Yunquera;3201;1665;1536
30;Murcia;001;Abanilla;6984;3421;3563
30;Murcia;002;Abarán;11941;5904;6037
30;Murcia;003;Águilas;24796;12398;12398
30;Murcia;004;Albudeite;1532;757;775
30;Murcia;005;Alcantarilla;30141;14730;15411
30;Murcia;902;Alcázares (Los);3852;1879;1973
30;Murcia;006;Aledo;1041;528;513
30;Murcia;007;Alguazas;6857;3398;3459
30;Murcia;008;Alhama de Murcia;14401;7081;7320
30;Murcia;009;Archena;13553;6717;6836
30;Murcia;010;Beniel;7063;3518;3545
30;Murcia;011;Blanca;6091;2941;3150
30;Murcia;012;Bullas;10340;5197;5143
30;Murcia;013;Calasparra;8888;4437;4451
30;Murcia;014;Campos del Río;2076;1031;1045
30;Murcia;015;Caravaca de la Cruz;23241;11501;11740
30;Murcia;016;Cartagena;175966;86935;89031
30;Murcia;017;Cehegín;15319;7643;7676
30;Murcia;018;Ceutí;6378;3207;3171
30;Murcia;019;Cieza;31284;15286;15998
30;Murcia;020;Fortuna;6280;3168;3112
30;Murcia;021;Fuente Álamo de Murcia;9049;4537;4512
30;Murcia;022;Jumilla;21125;10504;10621
30;Murcia;023;Librilla;3769;1854;1915
30;Murcia;024;Lorca;67338;33223;34115
30;Murcia;025;Lorquí;5447;2726;2721
30;Murcia;026;Mazarrón;14275;7165;7110
30;Murcia;027;Molina de Segura;38293;18999;19294
30;Murcia;028;Moratalla;10090;5102;4988
30;Murcia;029;Mula;13439;6687;6752
30;Murcia;030;Murcia;322911;157184;165727
30;Murcia;031;Ojós;647;316;331
30;Murcia;032;Pliego;3477;1747;1730
30;Murcia;033;Puerto Lumbreras;9709;4745;4964
30;Murcia;034;Ricote;1758;846;912
30;Murcia;035;San Javier;15467;7706;7761
30;Murcia;036;San Pedro del Pinatar;12661;6312;6349
30;Murcia;901;Santomera;8400;4195;4205
30;Murcia;037;Torre-Pacheco;16794;8548;8246
30;Murcia;038;Torres de Cotillas (Las);13802;6940;6862
30;Murcia;039;Totana;20339;10136;10203
30;Murcia;040;Ulea;1077;545;532
30;Murcia;041;Unión (La);15144;7495;7649
30;Murcia;042;Villanueva del Río Segura;1747;878;869
30;Murcia;043;Yecla;27284;13568;13716
31;Navarra;001;Abáigar;97;56;41
31;Navarra;002;Abárzuza;494;231;263
31;Navarra;003;Abaurregaina/Abaurrea Alta;231;128;103
31;Navarra;004;Abaurrepea/Abaurrea Baja;52;35;17
31;Navarra;005;Aberin;385;191;194
31;Navarra;006;Ablitas;2321;1186;1135
31;Navarra;007;Adiós;129;66;63
31;Navarra;008;Aguilar de Codés;144;77;67
31;Navarra;009;Aibar/Oibar;963;483;480
31;Navarra;011;Allín;830;438;392
31;Navarra;012;Allo;1194;583;611
31;Navarra;010;Altsasu/Alsasua;7075;3602;3473
31;Navarra;013;Améscoa Baja;903;459;444
31;Navarra;014;Ancín;281;145;136
31;Navarra;015;Andosilla;2524;1261;1263
31;Navarra;016;Ansoáin;10939;5551;5388
31;Navarra;017;Anue;494;280;214
31;Navarra;018;Añorbe;406;226;180
31;Navarra;019;Aoiz/Agoitz;1901;948;953
31;Navarra;020;Araitz;675;391;284
31;Navarra;025;Arakil;2898;1516;1382
31;Navarra;021;Aranarache;111;54;57
31;Navarra;023;Aranguren;1450;796;654
31;Navarra;024;Arano;184;101;83
31;Navarra;022;Arantza;745;411;334
31;Navarra;026;Aras;245;123;122
31;Navarra;027;Arbizu;901;484;417
31;Navarra;028;Arce/Artzi;300;167;133
31;Navarra;029;Arcos (Los);1401;690;711
31;Navarra;030;Arellano;230;125;105
31;Navarra;031;Areso;316;163;153
31;Navarra;032;Arguedas;2373;1173;1200
31;Navarra;033;Aria;81;50;31
31;Navarra;034;Aribe;81;39;42
31;Navarra;035;Armañanzas;117;55;62
31;Navarra;036;Arróniz;1303;687;616
31;Navarra;037;Arruazu;114;59;55
31;Navarra;038;Artajona;1753;919;834
31;Navarra;039;Artazu;111;59;52
31;Navarra;040;Atez;188;106;82
31;Navarra;058;Auritz/Burguete;350;160;190
31;Navarra;041;Ayegui;716;373;343
31;Navarra;042;Azagra;3303;1623;1680
31;Navarra;043;Azuelo;81;41;40
31;Navarra;044;Bakaiku;362;203;159
31;Navarra;901;Barañain;16184;8025;8159
31;Navarra;045;Barásoain;435;227;208
31;Navarra;046;Barbarin;125;56;69
31;Navarra;047;Bargota;422;223;199
31;Navarra;048;Barillas;208;100;108
31;Navarra;049;Basaburua;816;445;371
31;Navarra;050;Baztan;8202;4198;4004
31;Navarra;137;Beintza-Labaien;336;194;142
31;Navarra;051;Beire;355;167;188
31;Navarra;052;Belascoáin;78;41;37
31;Navarra;250;Bera/Vera de Bidasoa;3543;1823;1720
31;Navarra;053;Berbinzana;793;392;401
31;Navarra;905;Beriáin;"";"";""
31;Navarra;902;Berrioplano;"";"";""
31;Navarra;903;Berriozar;"";"";""
31;Navarra;054;Bertizarana;668;335;333
31;Navarra;055;Betelu;343;187;156
31;Navarra;253;Bidaurreta;112;65;47
31;Navarra;056;Biurrun-Olcoz;192;106;86
31;Navarra;057;Buñuel;2483;1219;1264
31;Navarra;059;Burgui/Burgi;263;144;119
31;Navarra;060;Burlada/Burlata;14476;7192;7284
31;Navarra;061;Busto (El);129;62;67
31;Navarra;062;Cabanillas;1461;743;718
31;Navarra;063;Cabredo;147;73;74
31;Navarra;064;Cadreita;1901;916;985
31;Navarra;065;Caparroso;2431;1170;1261
31;Navarra;066;Cárcar;1274;625;649
31;Navarra;067;Carcastillo;2677;1353;1324
31;Navarra;068;Cascante;3596;1744;1852
31;Navarra;069;Cáseda;1197;582;615
31;Navarra;070;Castejón;3280;1629;1651
31;Navarra;071;Castillonuevo;20;12;8
31;Navarra;072;Cintruénigo;5447;2709;2738
31;Navarra;074;Cirauqui;503;268;235
31;Navarra;075;Ciriza;54;26;28
31;Navarra;076;Cizur;5741;2887;2854
31;Navarra;077;Corella;6450;3209;3241
31;Navarra;078;Cortes;3335;1710;1625
31;Navarra;079;Desojo;172;91;81
31;Navarra;080;Dicastillo;781;408;373
31;Navarra;081;Donamaria;406;203;203
31;Navarra;221;Doneztebe/Santesteban;1189;606;583
31;Navarra;083;Echarri;51;27;24
31;Navarra;086;Egüés;1067;507;560
31;Navarra;087;Elgorriaga;190;94;96
31;Navarra;089;Enériz;185;97;88
31;Navarra;090;Eratsun;224;136;88
31;Navarra;091;Ergoiena;557;308;249
31;Navarra;092;Erro;837;444;393
31;Navarra;094;Eslava;239;121;118
31;Navarra;095;Esparza de Salazar;149;80;69
31;Navarra;096;Espronceda;211;121;90
31;Navarra;097;Estella/Lizarra;12868;6286;6582
31;Navarra;098;Esteribar;1436;762;674
31;Navarra;099;Etayo;106;52;54
31;Navarra;082;Etxalar;852;442;410
31;Navarra;084;Etxarri-Aranatz;2333;1212;1121
31;Navarra;085;Etxauri;406;211;195
31;Navarra;100;Eulate;431;220;211
31;Navarra;101;Ezcabarte;985;521;464
31;Navarra;093;Ezcároz/Ezkaroze;403;213;190
31;Navarra;102;Ezkurra;298;179;119
31;Navarra;103;Ezprogui;80;42;38
31;Navarra;104;Falces;2787;1374;1413
31;Navarra;105;Fitero;2211;1101;1110
31;Navarra;106;Fontellas;534;263;271
31;Navarra;107;Funes;2156;1069;1087
31;Navarra;108;Fustiñana;2364;1206;1158
31;Navarra;109;Galar;3318;1680;1638
31;Navarra;110;Gallipienzo;200;107;93
31;Navarra;111;Gallués/Galoze;139;85;54
31;Navarra;112;Garaioa;154;85;69
31;Navarra;113;Garde;222;115;107
31;Navarra;114;Garínoain;286;152;134
31;Navarra;115;Garralda;257;132;125
31;Navarra;116;Genevilla;156;85;71
31;Navarra;117;Goizueta;1055;574;481
31;Navarra;118;Goñi;210;115;95
31;Navarra;119;Güesa/Gorza;98;54;44
31;Navarra;120;Guesálaz;463;266;197
31;Navarra;121;Guirguillano;98;55;43
31;Navarra;256;Hiriberri/Villanueva de Aezkoa;182;98;84
31;Navarra;122;Huarte/Uharte;2810;1401;1409
31;Navarra;124;Ibargoiti;204;119;85
31;Navarra;259;Igantzi;595;316;279
31;Navarra;125;Igúzquiza;369;180;189
31;Navarra;126;Imotz;465;252;213
31;Navarra;127;Irañeta;169;98;71
31;Navarra;904;Irurtzun;"";"";""
31;Navarra;128;Isaba/Izaba;607;289;318
31;Navarra;129;Ituren;494;252;242
31;Navarra;130;Iturmendi;369;188;181
31;Navarra;131;Iza;587;324;263
31;Navarra;132;Izagaondoa;166;95;71
31;Navarra;133;Izalzu/Itzaltzu;55;26;29
31;Navarra;134;Jaurrieta;342;179;163
31;Navarra;135;Javier;170;79;91
31;Navarra;136;Juslapeña;391;215;176
31;Navarra;138;Lakuntza;1021;525;496
31;Navarra;139;Lana;240;134;106
31;Navarra;140;Lantz;141;87;54
31;Navarra;141;Lapoblación;196;110;86
31;Navarra;142;Larraga;1907;984;923
31;Navarra;143;Larraona;202;106;96
31;Navarra;144;Larraun;2056;1115;941
31;Navarra;145;Lazagurría;257;135;122
31;Navarra;146;Leache;67;38;29
31;Navarra;147;Legarda;76;39;37
31;Navarra;148;Legaria;185;93;92
31;Navarra;149;Leitza;3148;1628;1520
31;Navarra;908;Lekunberri;"";"";""
31;Navarra;150;Leoz;193;116;77
31;Navarra;151;Lerga;120;62;58
31;Navarra;152;Lerín;2149;1073;1076
31;Navarra;153;Lesaka;2824;1484;1340
31;Navarra;154;Lezáun;297;161;136
31;Navarra;155;Liédena;361;177;184
31;Navarra;156;Lizoáin;233;125;108
31;Navarra;157;Lodosa;4637;2351;2286
31;Navarra;158;Lónguida/Longida;341;184;157
31;Navarra;159;Lumbier;1436;746;690
31;Navarra;160;Luquin;158;86;72
31;Navarra;248;Luzaide/Valcarlos;586;297;289
31;Navarra;161;Mañeru;389;196;193
31;Navarra;162;Marañón;108;59;49
31;Navarra;163;Marcilla;2469;1259;1210
31;Navarra;164;Mélida;944;479;465
31;Navarra;165;Mendavia;3635;1816;1819
31;Navarra;166;Mendaza;485;227;258
31;Navarra;167;Mendigorría;1003;523;480
31;Navarra;168;Metauten;363;184;179
31;Navarra;169;Milagro;2501;1257;1244
31;Navarra;170;Mirafuentes;56;24;32
31;Navarra;171;Miranda de Arga;1025;502;523
31;Navarra;172;Monreal;308;160;148
31;Navarra;173;Monteagudo;1175;583;592
31;Navarra;174;Morentin;128;60;68
31;Navarra;175;Mues;140;69;71
31;Navarra;176;Murchante;2924;1439;1485
31;Navarra;177;Murieta;273;153;120
31;Navarra;178;Murillo el Cuende;588;314;274
31;Navarra;179;Murillo el Fruto;875;445;430
31;Navarra;180;Muruzábal;195;99;96
31;Navarra;181;Navascués;297;185;112
31;Navarra;182;Nazar;50;27;23
31;Navarra;088;Noáin (Valle de Elorz)/Noain (Elortzibar);3692;1813;1879
31;Navarra;183;Obanos;713;345;368
31;Navarra;185;Ochagavía;723;382;341
31;Navarra;184;Oco;95;56;39
31;Navarra;186;Odieta;345;189;156
31;Navarra;187;Oitz;168;104;64
31;Navarra;188;Olaibar;189;102;87
31;Navarra;189;Olazti/Olazagutía;1803;939;864
31;Navarra;190;Olejua;65;32;33
31;Navarra;191;Olite;3062;1526;1536
31;Navarra;194;Ollo;378;215;163
31;Navarra;192;Olóriz;192;107;85
31;Navarra;193;Olza;2406;1230;1176
31;Navarra;195;Orbaitzeta;272;150;122
31;Navarra;196;Orbara;62;30;32
31;Navarra;906;Orcoyen;"";"";""
31;Navarra;197;Orísoain;102;56;46
31;Navarra;198;Oronz;70;38;32
31;Navarra;199;Oroz-Betelu;265;141;124
31;Navarra;211;Orreaga/Roncesvalles;27;15;12
31;Navarra;200;Oteiza;970;495;475
31;Navarra;201;Pamplona/Iruña;183525;88702;94823
31;Navarra;202;Peralta;4620;2283;2337
31;Navarra;203;Petilla de Aragón;60;31;29
31;Navarra;204;Piedramillera;104;53;51
31;Navarra;205;Pitillas;681;341;340
31;Navarra;206;Puente la Reina/Gares;2165;1088;1077
31;Navarra;207;Pueyo;325;165;160
31;Navarra;208;Ribaforada;3091;1569;1522
31;Navarra;209;Romanzado;163;98;65
31;Navarra;210;Roncal/Erronkari;409;211;198
31;Navarra;212;Sada;293;153;140
31;Navarra;213;Saldías;179;94;85
31;Navarra;214;Salinas de Oro;107;57;50
31;Navarra;215;San Adrián;5025;2475;2550
31;Navarra;217;San Martín de Unx;578;306;272
31;Navarra;216;Sangüesa/Zangoza;4640;2362;2278
31;Navarra;219;Sansol;158;80;78
31;Navarra;220;Santacara;1112;563;549
31;Navarra;222;Sarriés/Sartze;105;60;45
31;Navarra;223;Sartaguda;1434;723;711
31;Navarra;224;Sesma;1572;781;791
31;Navarra;225;Sorlada;77;39;38
31;Navarra;226;Sunbilla;766;404;362
31;Navarra;227;Tafalla;10318;5078;5240
31;Navarra;228;Tiebas-Muruarte de Reta;627;327;300
31;Navarra;229;Tirapu;66;36;30
31;Navarra;230;Torralba del Río;187;104;83
31;Navarra;231;Torres del Río;238;115;123
31;Navarra;232;Tudela;27063;13181;13882
31;Navarra;233;Tulebras;100;28;72
31;Navarra;234;Ucar;115;61;54
31;Navarra;123;Uharte-Arakil;859;453;406
31;Navarra;235;Ujué;320;170;150
31;Navarra;236;Ultzama;1652;857;795
31;Navarra;237;Unciti;227;126;101
31;Navarra;238;Unzué;138;69;69
31;Navarra;239;Urdazubi/Urdax;462;235;227
31;Navarra;240;Urdiain;719;377;342
31;Navarra;241;Urraul Alto;147;86;61
31;Navarra;242;Urraul Bajo;296;133;163
31;Navarra;244;Urrotz;235;133;102
31;Navarra;243;Urroz;378;191;187
31;Navarra;245;Urzainqui;125;66;59
31;Navarra;246;Uterga;147;75;72
31;Navarra;247;Uztárroz/Uztarroze;334;164;170
31;Navarra;249;Valtierra;2548;1268;1280
31;Navarra;251;Viana;3470;1769;1701
31;Navarra;252;Vidángoz/Bidankoze;115;56;59
31;Navarra;254;Villafranca;2619;1257;1362
31;Navarra;255;Villamayor de Monjardín;114;67;47
31;Navarra;257;Villatuerta;814;419;395
31;Navarra;258;Villava/Atarrabia;7554;3806;3748
31;Navarra;260;Yerri;1590;841;749
31;Navarra;261;Yesa;323;187;136
31;Navarra;262;Zabalza;144;65;79
31;Navarra;073;Ziordia;392;183;209
31;Navarra;907;Zizur Mayor/Zizur Nagusia;"";"";""
31;Navarra;263;Zubieta;344;204;140
31;Navarra;264;Zugarramurdi;283;151;132
31;Navarra;265;Zúñiga;137;75;62
32;Ourense;001;Allariz;6137;2959;3178
32;Ourense;002;Amoeiro;2655;1264;1391
32;Ourense;003;Arnoia (A);1241;593;648
32;Ourense;004;Avión;4541;2164;2377
32;Ourense;005;Baltar;3025;1513;1512
32;Ourense;006;Bande;4122;1995;2127
32;Ourense;007;Baños de Molgas;4355;2185;2170
32;Ourense;008;Barbadás;4418;2117;2301
32;Ourense;009;Barco de Valdeorras (O);11106;5497;5609
32;Ourense;010;Beade;1237;614;623
32;Ourense;011;Beariz;2068;925;1143
32;Ourense;012;Blancos (Os);2174;1110;1064
32;Ourense;013;Boborás;5191;2445;2746
32;Ourense;014;Bola (A);2284;1110;1174
32;Ourense;015;Bolo (O);2935;1468;1467
32;Ourense;016;Calvos de Randín;2106;1055;1051
32;Ourense;018;Carballeda de Avia;2444;1178;1266
32;Ourense;017;Carballeda de Valdeorras;3302;1697;1605
32;Ourense;019;Carballiño (O);12508;5975;6533
32;Ourense;020;Cartelle;5611;2772;2839
32;Ourense;022;Castrelo de Miño;5211;2610;2601
32;Ourense;021;Castrelo do Val;1972;1000;972
32;Ourense;023;Castro Caldelas;3130;1564;1566
32;Ourense;024;Celanova;7470;3616;3854
32;Ourense;025;Cenlle;2280;1067;1213
32;Ourense;029;Chandrexa de Queixa;1249;662;587
32;Ourense;026;Coles;3537;1738;1799
32;Ourense;027;Cortegada;2161;1044;1117
32;Ourense;028;Cualedro;5706;2892;2814
32;Ourense;030;Entrimo;2573;1209;1364
32;Ourense;031;Esgos;2616;1277;1339
32;Ourense;033;Gomesende;2194;1054;1140
32;Ourense;034;Gudiña (A);2554;1300;1254
32;Ourense;035;Irixo (O);3775;1862;1913
32;Ourense;038;Larouco;868;408;460
32;Ourense;039;Laza;2780;1371;1409
32;Ourense;040;Leiro;2472;1170;1302
32;Ourense;041;Lobeira;2989;1434;1555
32;Ourense;042;Lobios;4941;2389;2552
32;Ourense;043;Maceda;4822;2325;2497
32;Ourense;044;Manzaneda;1866;932;934
32;Ourense;045;Maside;4930;2374;2556
32;Ourense;046;Melón;2173;982;1191
32;Ourense;047;Merca (A);3742;1837;1905
32;Ourense;048;Mezquita (A);2014;1017;997
32;Ourense;049;Montederramo;1741;891;850
32;Ourense;050;Monterrei;4794;2403;2391
32;Ourense;051;Muíños;3466;1703;1763
32;Ourense;052;Nogueira de Ramuín;3486;1665;1821
32;Ourense;053;Oímbra;2082;1050;1032
32;Ourense;054;Ourense;109283;51638;57645
32;Ourense;055;Paderne de Allariz;2206;1034;1172
32;Ourense;056;Padrenda;4833;2345;2488
32;Ourense;057;Parada de Sil;2022;976;1046
32;Ourense;058;Pereiro de Aguiar (O);6329;3088;3241
32;Ourense;059;Peroxa (A);3498;1673;1825
32;Ourense;060;Petín;1466;724;742
32;Ourense;061;Piñor;2116;1049;1067
32;Ourense;063;Pobra de Trives (A);4051;2010;2041
32;Ourense;064;Pontedeva;937;443;494
32;Ourense;062;Porqueira;1902;951;951
32;Ourense;065;Punxín;1223;575;648
32;Ourense;066;Quintela de Leirado;1402;675;727
32;Ourense;067;Rairiz de Veiga;4031;1985;2046
32;Ourense;068;Ramirás;3369;1642;1727
32;Ourense;069;Ribadavia;6876;3336;3540
32;Ourense;071;Riós;4512;2247;2265
32;Ourense;072;Rúa (A);5375;2674;2701
32;Ourense;073;Rubiá;2954;1490;1464
32;Ourense;074;San Amaro;2584;1283;1301
32;Ourense;075;San Cibrao das Viñas;3739;1807;1932
32;Ourense;076;San Cristovo de Cea;5058;2471;2587
32;Ourense;070;San Xoán de Río;1615;797;818
32;Ourense;077;Sandiás;2572;1243;1329
32;Ourense;078;Sarreaus;3996;2003;1993
32;Ourense;079;Taboadela;3161;1528;1633
32;Ourense;080;Teixeira (A);1919;966;953
32;Ourense;081;Toén;3460;1715;1745
32;Ourense;082;Trasmiras;4020;2041;1979
32;Ourense;083;Veiga (A);3002;1473;1529
32;Ourense;084;Verea;2802;1376;1426
32;Ourense;085;Verín;11707;5699;6008
32;Ourense;086;Viana do Bolo;5864;2965;2899
32;Ourense;087;Vilamarín;2444;1187;1257
32;Ourense;088;Vilamartín de Valdeorras;3018;1519;1499
32;Ourense;089;Vilar de Barrio;4237;2153;2084
32;Ourense;090;Vilar de Santos;1856;942;914
32;Ourense;091;Vilardevós;4164;2171;1993
32;Ourense;092;Vilariño de Conso;1206;659;547
32;Ourense;032;Xinzo de Limia;10936;5403;5533
32;Ourense;036;Xunqueira de Ambía;3329;1649;1680
32;Ourense;037;Xunqueira de Espadanedo;1451;702;749
33;Asturias;001;Allande;3187;1642;1545
33;Asturias;002;Aller;19663;9780;9883
33;Asturias;003;Amieva;1120;580;540
33;Asturias;004;Avilés;88429;43178;45251
33;Asturias;005;Belmonte de Miranda;3346;1717;1629
33;Asturias;006;Bimenes;2646;1242;1404
33;Asturias;007;Boal;3250;1631;1619
33;Asturias;008;Cabrales;2617;1320;1297
33;Asturias;009;Cabranes;1581;746;835
33;Asturias;010;Candamo;3128;1516;1612
33;Asturias;012;Cangas de Onís;6430;3234;3196
33;Asturias;011;Cangas del Narcea;20504;10589;9915
33;Asturias;013;Caravia;640;323;317
33;Asturias;014;Carreño;11510;5644;5866
33;Asturias;015;Caso;2297;1176;1121
33;Asturias;016;Castrillón;22548;11040;11508
33;Asturias;017;Castropol;5004;2403;2601
33;Asturias;018;Coaña;4200;2021;2179
33;Asturias;019;Colunga;5176;2518;2658
33;Asturias;020;Corvera de Asturias;17976;8991;8985
33;Asturias;021;Cudillero;7039;3503;3536
33;Asturias;022;Degaña;1797;967;830
33;Asturias;023;Franco (El);4319;2100;2219
33;Asturias;024;Gijón;264948;126714;138234
33;Asturias;025;Gozón;12179;5956;6223
33;Asturias;026;Grado;12585;6129;6456
33;Asturias;027;Grandas de Salime;1614;847;767
33;Asturias;028;Ibias;2759;1464;1295
33;Asturias;029;Illano;877;449;428
33;Asturias;030;Illas;1418;738;680
33;Asturias;031;Langreo;53246;25673;27573
33;Asturias;032;Laviana;15632;7718;7914
33;Asturias;033;Lena;14906;7349;7557
33;Asturias;035;Llanera;10390;5134;5256
33;Asturias;036;Llanes;13961;6670;7291
33;Asturias;037;Mieres;57627;28047;29580
33;Asturias;038;Morcín;3236;1606;1630
33;Asturias;039;Muros de Nalón;2786;1307;1479
33;Asturias;040;Nava;5807;2846;2961
33;Asturias;041;Navia;9240;4458;4782
33;Asturias;042;Noreña;4175;1969;2206
33;Asturias;043;Onís;1335;682;653
33;Asturias;044;Oviedo;194637;91888;102749
33;Asturias;045;Parres;5939;2936;3003
33;Asturias;046;Peñamellera Alta;1031;522;509
33;Asturias;047;Peñamellera Baja;1881;931;950
33;Asturias;048;Pesoz;367;183;184
33;Asturias;049;Piloña;10226;4949;5277
33;Asturias;050;Ponga;968;549;419
33;Asturias;051;Pravia;10188;4898;5290
33;Asturias;052;Proaza;1101;543;558
33;Asturias;053;Quirós;1876;957;919
33;Asturias;054;Regueras (Las);2559;1275;1284
33;Asturias;055;Ribadedeva;2299;1101;1198
33;Asturias;056;Ribadesella;6448;3091;3357
33;Asturias;057;Ribera de Arriba;2212;1095;1117
33;Asturias;058;Riosa;2992;1557;1435
33;Asturias;059;Salas;8517;4220;4297
33;Asturias;061;San Martín de Oscos;695;361;334
33;Asturias;060;San Martín del Rey Aurelio;24884;12114;12770
33;Asturias;063;San Tirso de Abres;762;384;378
33;Asturias;062;Santa Eulalia de Oscos;743;390;353
33;Asturias;064;Santo Adriano;407;194;213
33;Asturias;065;Sariego;1655;808;847
33;Asturias;066;Siero;43647;20851;22796
33;Asturias;067;Sobrescobio;851;430;421
33;Asturias;068;Somiedo;1955;1015;940
33;Asturias;069;Soto del Barco;5010;2402;2608
33;Asturias;070;Tapia de Casariego;4588;2208;2380
33;Asturias;071;Taramundi;1115;539;576
33;Asturias;072;Teverga;2973;1500;1473
33;Asturias;073;Tineo;17097;8656;8441
33;Asturias;034;Valdés;18009;8854;9155
33;Asturias;074;Vegadeo;5100;2445;2655
33;Asturias;075;Villanueva de Oscos;532;275;257
33;Asturias;076;Villaviciosa;15389;7541;7848
33;Asturias;077;Villayón;2366;1211;1155
33;Asturias;078;Yernes y Tameza;225;107;118
34;Palencia;001;Abarca de Campos;52;28;24
34;Palencia;003;Abia de las Torres;245;128;117
34;Palencia;004;Aguilar de Campoo;7660;3788;3872
34;Palencia;005;Alar del Rey;1655;796;859
34;Palencia;006;Alba de Cerrato;149;75;74
34;Palencia;009;Amayuelas de Arriba;73;41;32
34;Palencia;010;Ampudia;852;430;422
34;Palencia;011;Amusco;708;375;333
34;Palencia;012;Antigüedad;477;256;221
34;Palencia;015;Arconada;115;60;55
34;Palencia;017;Astudillo;1511;786;725
34;Palencia;018;Autilla del Pino;333;171;162
34;Palencia;019;Autillo de Campos;220;103;117
34;Palencia;020;Ayuela;124;70;54
34;Palencia;022;Baltanás;1714;892;822
34;Palencia;024;Baquerín de Campos;45;28;17
34;Palencia;025;Bárcena de Campos;74;32;42
34;Palencia;027;Barruelo de Santullán;2364;1122;1242
34;Palencia;028;Báscones de Ojeda;250;125;125
34;Palencia;029;Becerril de Campos;1295;634;661
34;Palencia;031;Belmonte de Campos;75;34;41
34;Palencia;032;Berzosilla;96;49;47
34;Palencia;033;Boada de Campos;29;14;15
34;Palencia;035;Boadilla de Rioseco;230;112;118
34;Palencia;034;Boadilla del Camino;250;126;124
34;Palencia;036;Brañosera;356;180;176
34;Palencia;037;Buenavista de Valdavia;547;263;284
34;Palencia;038;Bustillo de la Vega;440;237;203
34;Palencia;039;Bustillo del Páramo de Carrión;118;60;58
34;Palencia;041;Calahorra de Boedo;171;80;91
34;Palencia;042;Calzada de los Molinos;441;240;201
34;Palencia;045;Capillas;165;78;87
34;Palencia;046;Cardeñosa de Volpejera;76;37;39
34;Palencia;047;Carrión de los Condes;2555;1205;1350
34;Palencia;048;Castil de Vela;137;66;71
34;Palencia;049;Castrejón de la Peña;819;437;382
34;Palencia;050;Castrillo de Don Juan;468;244;224
34;Palencia;051;Castrillo de Onielo;220;109;111
34;Palencia;052;Castrillo de Villavega;379;190;189
34;Palencia;053;Castromocho;333;168;165
34;Palencia;055;Cervatos de la Cueza;447;221;226
34;Palencia;056;Cervera de Pisuerga;3035;1542;1493
34;Palencia;057;Cevico de la Torre;808;408;400
34;Palencia;058;Cevico Navero;368;194;174
34;Palencia;059;Cisneros;704;353;351
34;Palencia;060;Cobos de Cerrato;290;141;149
34;Palencia;061;Collazos de Boedo;194;107;87
34;Palencia;062;Congosto de Valdavia;348;183;165
34;Palencia;063;Cordovilla la Real;178;100;78
34;Palencia;066;Cubillas de Cerrato;132;66;66
34;Palencia;067;Dehesa de Montejo;402;229;173
34;Palencia;068;Dehesa de Romanos;78;42;36
34;Palencia;069;Dueñas;3136;1627;1509
34;Palencia;070;Espinosa de Cerrato;354;179;175
34;Palencia;071;Espinosa de Villagonzalo;349;168;181
34;Palencia;072;Frechilla;315;149;166
34;Palencia;073;Fresno del Río;233;119;114
34;Palencia;074;Frómista;1131;581;550
34;Palencia;076;Fuentes de Nava;991;480;511
34;Palencia;077;Fuentes de Valdepero;259;139;120
34;Palencia;079;Grijota;796;400;396
34;Palencia;080;Guardo;9750;5009;4741
34;Palencia;081;Guaza de Campos;115;59;56
34;Palencia;082;Hérmedes de Cerrato;183;90;93
34;Palencia;083;Herrera de Pisuerga;2944;1491;1453
34;Palencia;084;Herrera de Valdecañas;223;113;110
34;Palencia;086;Hontoria de Cerrato;133;67;66
34;Palencia;087;Hornillos de Cerrato;204;95;109
34;Palencia;088;Husillos;220;117;103
34;Palencia;089;Itero de la Vega;302;165;137
34;Palencia;091;Lagartos;229;124;105
34;Palencia;092;Lantadilla;643;321;322
34;Palencia;094;Ledigos;141;73;68
34;Palencia;903;Loma de Ucieza;452;237;215
34;Palencia;096;Lomas;78;39;39
34;Palencia;098;Magaz de Pisuerga;619;325;294
34;Palencia;099;Manquillos;99;53;46
34;Palencia;100;Mantinos;244;130;114
34;Palencia;101;Marcilla de Campos;119;53;66
34;Palencia;102;Mazariegos;298;162;136
34;Palencia;103;Mazuecos de Valdeginate;170;80;90
34;Palencia;104;Melgar de Yuso;490;264;226
34;Palencia;106;Meneses de Campos;210;111;99
34;Palencia;107;Micieces de Ojeda;142;72;70
34;Palencia;108;Monzón de Campos;967;505;462
34;Palencia;109;Moratinos;125;64;61
34;Palencia;110;Mudá;204;99;105
34;Palencia;112;Nogal de las Huertas;111;58;53
34;Palencia;113;Olea de Boedo;53;22;31
34;Palencia;114;Olmos de Ojeda;497;271;226
34;Palencia;116;Osornillo;125;67;58
34;Palencia;901;Osorno la Mayor;1998;1033;965
34;Palencia;120;Palencia;77464;37277;40187
34;Palencia;121;Palenzuela;417;231;186
34;Palencia;122;Páramo de Boedo;135;70;65
34;Palencia;123;Paredes de Nava;2718;1357;1361
34;Palencia;124;Payo de Ojeda;111;60;51
34;Palencia;125;Pedraza de Campos;185;96;89
34;Palencia;126;Pedrosa de la Vega;427;231;196
34;Palencia;127;Perales;186;96;90
34;Palencia;904;Pernía (La);588;311;277
34;Palencia;129;Pino del Río;304;171;133
34;Palencia;130;Piña de Campos;403;220;183
34;Palencia;131;Población de Arroyo;115;61;54
34;Palencia;132;Población de Campos;259;141;118
34;Palencia;133;Población de Cerrato;160;84;76
34;Palencia;134;Polentinos;166;79;87
34;Palencia;135;Pomar de Valdivia;704;348;356
34;Palencia;136;Poza de la Vega;313;176;137
34;Palencia;137;Pozo de Urama;58;31;27
34;Palencia;139;Prádanos de Ojeda;276;141;135
34;Palencia;140;Puebla de Valdavia (La);233;111;122
34;Palencia;141;Quintana del Puente;369;183;186
34;Palencia;143;Quintanilla de Onsoña;323;177;146
34;Palencia;146;Reinoso de Cerrato;112;60;52
34;Palencia;147;Renedo de la Vega;323;171;152
34;Palencia;149;Requena de Campos;65;33;32
34;Palencia;151;Respenda de la Peña;372;199;173
34;Palencia;152;Revenga de Campos;215;100;115
34;Palencia;154;Revilla de Collazos;117;65;52
34;Palencia;155;Ribas de Campos;256;132;124
34;Palencia;156;Riberos de la Cueza;113;62;51
34;Palencia;157;Saldaña;3087;1606;1481
34;Palencia;158;Salinas de Pisuerga;313;170;143
34;Palencia;159;San Cebrián de Campos;579;335;244
34;Palencia;160;San Cebrián de Mudá;294;145;149
34;Palencia;161;San Cristóbal de Boedo;61;33;28
34;Palencia;163;San Mamés de Campos;158;76;82
34;Palencia;165;San Román de la Cuba;161;86;75
34;Palencia;167;Santa Cecilia del Alcor;197;108;89
34;Palencia;168;Santa Cruz de Boedo;94;47;47
34;Palencia;169;Santervás de la Vega;657;360;297
34;Palencia;170;Santibáñez de Ecla;131;48;83
34;Palencia;171;Santibáñez de la Peña;2113;1035;1078
34;Palencia;174;Santoyo;350;166;184
34;Palencia;175;Serna (La);143;80;63
34;Palencia;177;Soto de Cerrato;267;132;135
34;Palencia;176;Sotobañado y Priorato;239;124;115
34;Palencia;178;Tabanera de Cerrato;223;108;115
34;Palencia;179;Tabanera de Valdavia;74;41;33
34;Palencia;180;Támara de Campos;104;53;51
34;Palencia;181;Tariego de Cerrato;572;287;285
34;Palencia;182;Torquemada;1419;719;700
34;Palencia;184;Torremormojón;97;43;54
34;Palencia;185;Triollo;156;87;69
34;Palencia;186;Valbuena de Pisuerga;91;52;39
34;Palencia;189;Valdeolmillos;108;51;57
34;Palencia;190;Valderrábano;126;66;60
34;Palencia;192;Valde-Ucieza;176;107;69
34;Palencia;196;Valle de Cerrato;171;93;78
34;Palencia;902;Valle del Retortillo;337;165;172
34;Palencia;199;Velilla del Río Carrión;2203;1122;1081
34;Palencia;023;Venta de Baños;7005;3482;3523
34;Palencia;201;Vertavillo;341;180;161
34;Palencia;093;Vid de Ojeda (La);185;103;82
34;Palencia;202;Villabasta de Valdavia;50;22;28
34;Palencia;204;Villacidaler;116;56;60
34;Palencia;205;Villaconancio;116;61;55
34;Palencia;206;Villada;1486;724;762
34;Palencia;208;Villaeles de Valdavia;120;65;55
34;Palencia;210;Villahán;185;104;81
34;Palencia;211;Villaherreros;361;171;190
34;Palencia;213;Villalaco;94;42;52
34;Palencia;214;Villalba de Guardo;269;143;126
34;Palencia;215;Villalcázar de Sirga;270;126;144
34;Palencia;216;Villalcón;121;56;65
34;Palencia;217;Villalobón;257;136;121
34;Palencia;218;Villaluenga de la Vega;850;474;376
34;Palencia;220;Villamartín de Campos;184;91;93
34;Palencia;221;Villamediana;302;158;144
34;Palencia;222;Villameriel;214;108;106
34;Palencia;223;Villamoronta;368;191;177
34;Palencia;224;Villamuera de la Cueza;103;58;45
34;Palencia;225;Villamuriel de Cerrato;3921;2006;1915
34;Palencia;227;Villanueva del Rebollar;128;65;63
34;Palencia;228;Villanuño de Valdavia;155;89;66
34;Palencia;229;Villaprovedo;121;70;51
34;Palencia;230;Villarmentero de Campos;25;11;14
34;Palencia;231;Villarrabé;315;166;149
34;Palencia;232;Villarramiel;1239;626;613
34;Palencia;233;Villasarracino;398;197;201
34;Palencia;234;Villasila de Valdavia;137;76;61
34;Palencia;236;Villaturde;356;177;179
34;Palencia;237;Villaumbrales;993;522;471
34;Palencia;238;Villaviudas;533;271;262
34;Palencia;240;Villerías de Campos;153;83;70
34;Palencia;241;Villodre;55;31;24
34;Palencia;242;Villodrigo;157;81;76
34;Palencia;243;Villoldo;589;304;285
34;Palencia;245;Villota del Páramo;604;337;267
34;Palencia;246;Villovieco;159;85;74
35;Palmas (Las);001;Agaete;5488;2769;2719
35;Palmas (Las);002;Agüimes;16407;8348;8059
35;Palmas (Las);003;Antigua;2749;1522;1227
35;Palmas (Las);004;Arrecife;38931;20034;18897
35;Palmas (Las);005;Artenara;1084;572;512
35;Palmas (Las);006;Arucas;28081;14223;13858
35;Palmas (Las);007;Betancuria;606;317;289
35;Palmas (Las);008;Firgas;5827;2934;2893
35;Palmas (Las);009;Gáldar;21186;10724;10462
35;Palmas (Las);010;Haría;3199;1682;1517
35;Palmas (Las);011;Ingenio;22509;11413;11096
35;Palmas (Las);016;Las Palmas de Gran Canaria;373846;184989;188857
35;Palmas (Las);012;Mogán;10420;5560;4860
35;Palmas (Las);013;Moya;7921;4044;3877
35;Palmas (Las);014;Oliva (La);6224;3359;2865
35;Palmas (Las);015;Pájara;5547;3054;2493
35;Palmas (Las);017;Puerto del Rosario;17533;9702;7831
35;Palmas (Las);018;San Bartolomé;7583;3994;3589
35;Palmas (Las);019;San Bartolomé de Tirajana;32767;17299;15468
35;Palmas (Las);020;San Nicolás de Tolentino;7999;3996;4003
35;Palmas (Las);021;Santa Brígida;14372;7181;7191
35;Palmas (Las);022;Santa Lucía de Tirajana;33631;17183;16448
35;Palmas (Las);023;Santa María de Guía de Gran Canaria;13064;6608;6456
35;Palmas (Las);024;Teguise;8902;4687;4215
35;Palmas (Las);025;Tejeda;2162;1055;1107
35;Palmas (Las);026;Telde;78978;39768;39210
35;Palmas (Las);027;Teror;11110;5554;5556
35;Palmas (Las);028;Tías;8934;4829;4105
35;Palmas (Las);029;Tinajo;3556;1804;1752
35;Palmas (Las);030;Tuineje;7353;3897;3456
35;Palmas (Las);032;Valleseco;4173;2135;2038
35;Palmas (Las);031;Valsequillo de Gran Canaria;6310;3235;3075
35;Palmas (Las);033;Vega de San Mateo;7422;3800;3622
35;Palmas (Las);034;Yaiza;2902;1594;1308
36;Pontevedra;020;Agolada;5008;2442;2566
36;Pontevedra;001;Arbo;5083;2445;2638
36;Pontevedra;003;Baiona;10483;5132;5351
36;Pontevedra;002;Barro;3950;1881;2069
36;Pontevedra;004;Bueu;12547;6158;6389
36;Pontevedra;005;Caldas de Reis;9360;4520;4840
36;Pontevedra;006;Cambados;13535;6674;6861
36;Pontevedra;007;Campo Lameiro;2730;1284;1446
36;Pontevedra;008;Cangas;22939;11340;11599
36;Pontevedra;009;Cañiza (A);8394;4020;4374
36;Pontevedra;010;Catoira;3715;1834;1881
36;Pontevedra;011;Cerdedo;4426;2008;2418
36;Pontevedra;012;Cotobade;5867;2687;3180
36;Pontevedra;013;Covelo;5444;2504;2940
36;Pontevedra;014;Crecente;4099;1926;2173
36;Pontevedra;015;Cuntis;6645;3123;3522
36;Pontevedra;016;Dozón;2803;1418;1385
36;Pontevedra;017;Estrada (A);25548;12021;13527
36;Pontevedra;018;Forcarei;7977;3873;4104
36;Pontevedra;019;Fornelos de Montes;2589;1210;1379
36;Pontevedra;021;Gondomar;10686;5259;5427
36;Pontevedra;022;Grove (O);10860;5389;5471
36;Pontevedra;023;Guarda (A);10305;4973;5332
36;Pontevedra;901;Illa de Arousa (A);"";"";""
36;Pontevedra;024;Lalín;20760;10209;10551
36;Pontevedra;025;Lama (A);4377;1990;2387
36;Pontevedra;026;Marín;24611;12015;12596
36;Pontevedra;027;Meaño;5939;2903;3036
36;Pontevedra;028;Meis;5341;2539;2802
36;Pontevedra;029;Moaña;18393;8920;9473
36;Pontevedra;030;Mondariz;7096;3393;3703
36;Pontevedra;031;Mondariz-Balneario;632;301;331
36;Pontevedra;032;Moraña;5116;2427;2689
36;Pontevedra;033;Mos;13850;6781;7069
36;Pontevedra;034;Neves (As);6506;3089;3417
36;Pontevedra;035;Nigrán;14612;7178;7434
36;Pontevedra;036;Oia;3295;1634;1661
36;Pontevedra;037;Pazos de Borbén;3669;1699;1970
36;Pontevedra;041;Poio;13173;6453;6720
36;Pontevedra;043;Ponte Caldelas;8496;4024;4472
36;Pontevedra;042;Ponteareas;16931;8136;8795
36;Pontevedra;044;Pontecesures;2833;1377;1456
36;Pontevedra;038;Pontevedra;70356;33350;37006
36;Pontevedra;039;Porriño (O);15186;7369;7817
36;Pontevedra;040;Portas;3714;1765;1949
36;Pontevedra;045;Redondela;28028;13627;14401
36;Pontevedra;046;Ribadumia;4202;2031;2171
36;Pontevedra;047;Rodeiro;4843;2529;2314
36;Pontevedra;048;Rosal (O);6089;3003;3086
36;Pontevedra;049;Salceda de Caselas;5928;2901;3027
36;Pontevedra;050;Salvaterra de Miño;9464;4522;4942
36;Pontevedra;051;Sanxenxo;15606;7657;7949
36;Pontevedra;052;Silleda;10480;4998;5482
36;Pontevedra;053;Soutomaior;5249;2521;2728
36;Pontevedra;054;Tomiño;11070;5400;5670
36;Pontevedra;055;Tui;16248;7773;8475
36;Pontevedra;056;Valga;6600;3263;3337
36;Pontevedra;057;Vigo;279986;134151;145835
36;Pontevedra;059;Vila de Cruces;8419;4112;4307
36;Pontevedra;058;Vilaboa;6136;2980;3156
36;Pontevedra;060;Vilagarcía de Arousa;33653;16379;17274
36;Pontevedra;061;Vilanova de Arousa;15947;7828;8119
37;Salamanca;001;Abusejo;360;188;172
37;Salamanca;002;Agallas;320;174;146
37;Salamanca;003;Ahigal de los Aceiteros;248;120;128
37;Salamanca;004;Ahigal de Villarino;57;33;24
37;Salamanca;005;Alameda de Gardón (La);245;120;125
37;Salamanca;006;Alamedilla (La);305;146;159
37;Salamanca;007;Alaraz;769;403;366
37;Salamanca;008;Alba de Tormes;4273;2138;2135
37;Salamanca;009;Alba de Yeltes;379;195;184
37;Salamanca;010;Alberca (La);1125;582;543
37;Salamanca;011;Alberguería de Argañán (La);323;161;162
37;Salamanca;012;Alconada;279;142;137
37;Salamanca;015;Aldea del Obispo;506;255;251
37;Salamanca;013;Aldeacipreste;387;208;179
37;Salamanca;014;Aldeadávila de la Ribera;1850;964;886
37;Salamanca;016;Aldealengua;457;225;232
37;Salamanca;017;Aldeanueva de Figueroa;441;229;212
37;Salamanca;018;Aldeanueva de la Sierra;119;67;52
37;Salamanca;019;Aldearrodrigo;244;128;116
37;Salamanca;020;Aldearrubia;545;279;266
37;Salamanca;021;Aldeaseca de Alba;190;94;96
37;Salamanca;022;Aldeaseca de la Frontera;437;229;208
37;Salamanca;023;Aldeatejada;583;287;296
37;Salamanca;024;Aldeavieja de Tormes;167;85;82
37;Salamanca;025;Aldehuela de la Bóveda;476;240;236
37;Salamanca;026;Aldehuela de Yeltes;406;195;211
37;Salamanca;027;Almenara de Tormes;258;125;133
37;Salamanca;028;Almendra;256;130;126
37;Salamanca;029;Anaya de Alba;424;221;203
37;Salamanca;030;Añover de Tormes;133;67;66
37;Salamanca;031;Arabayona de Mógica;643;340;303
37;Salamanca;032;Arapiles;503;262;241
37;Salamanca;033;Arcediano;134;68;66
37;Salamanca;034;Arco (El);109;60;49
37;Salamanca;035;Armenteros;417;190;227
37;Salamanca;037;Atalaya (La);235;127;108
37;Salamanca;038;Babilafuente;1026;534;492
37;Salamanca;039;Bañobárez;587;301;286
37;Salamanca;040;Barbadillo;652;316;336
37;Salamanca;041;Barbalos;164;79;85
37;Salamanca;042;Barceo;111;57;54
37;Salamanca;044;Barruecopardo;737;370;367
37;Salamanca;045;Bastida (La);55;26;29
37;Salamanca;046;Béjar;17476;8371;9105
37;Salamanca;047;Beleña;131;60;71
37;Salamanca;049;Bermellar;273;137;136
37;Salamanca;050;Berrocal de Huebra;159;76;83
37;Salamanca;051;Berrocal de Salvatierra;187;92;95
37;Salamanca;052;Boada;477;240;237
37;Salamanca;054;Bodón (El);444;227;217
37;Salamanca;055;Bogajo;263;133;130
37;Salamanca;056;Bouza (La);77;42;35
37;Salamanca;057;Bóveda del Río Almar;363;181;182
37;Salamanca;058;Brincones;150;68;82
37;Salamanca;059;Buenamadre;229;113;116
37;Salamanca;060;Buenavista;127;66;61
37;Salamanca;061;Cabaco (El);336;173;163
37;Salamanca;063;Cabeza de Béjar (La);156;79;77
37;Salamanca;065;Cabeza del Caballo;611;318;293
37;Salamanca;062;Cabezabellosa de la Calzada;170;97;73
37;Salamanca;067;Cabrerizos;815;406;409
37;Salamanca;068;Cabrillas;674;313;361
37;Salamanca;069;Calvarrasa de Abajo;1094;545;549
37;Salamanca;070;Calvarrasa de Arriba;628;333;295
37;Salamanca;071;Calzada de Béjar (La);143;69;74
37;Salamanca;072;Calzada de Don Diego;342;173;169
37;Salamanca;073;Calzada de Valdunciel;706;344;362
37;Salamanca;074;Campillo de Azaba;407;198;209
37;Salamanca;077;Campo de Peñaranda (El);492;258;234
37;Salamanca;078;Candelario;1257;601;656
37;Salamanca;079;Canillas de Abajo;171;94;77
37;Salamanca;080;Cantagallo;318;158;160
37;Salamanca;081;Cantalapiedra;1652;829;823
37;Salamanca;082;Cantalpino;1378;728;650
37;Salamanca;083;Cantaracillo;323;163;160
37;Salamanca;085;Carbajosa de la Sagrada;631;308;323
37;Salamanca;086;Carpio de Azaba;126;66;60
37;Salamanca;087;Carrascal de Barregas;374;199;175
37;Salamanca;088;Carrascal del Obispo;295;141;154
37;Salamanca;089;Casafranca;102;45;57
37;Salamanca;090;Casas del Conde (Las);151;67;84
37;Salamanca;091;Casillas de Flores;341;166;175
37;Salamanca;092;Castellanos de Moriscos;363;166;197
37;Salamanca;185;Castellanos de Villiquera;495;254;241
37;Salamanca;096;Castillejo de Martín Viejo;417;214;203
37;Salamanca;097;Castraz;112;58;54
37;Salamanca;098;Cepeda;636;307;329
37;Salamanca;099;Cereceda de la Sierra;137;75;62
37;Salamanca;100;Cerezal de Peñahorcada;194;93;101
37;Salamanca;101;Cerralbo;332;178;154
37;Salamanca;102;Cerro (El);675;333;342
37;Salamanca;103;Cespedosa de Tormes;777;418;359
37;Salamanca;114;Chagarcía Medianero;199;107;92
37;Salamanca;104;Cilleros de la Bastida;65;30;35
37;Salamanca;106;Cipérez;605;302;303
37;Salamanca;107;Ciudad Rodrigo;15985;7702;8283
37;Salamanca;108;Coca de Alba;209;103;106
37;Salamanca;109;Colmenar de Montemayor;391;197;194
37;Salamanca;110;Cordovilla;157;82;75
37;Salamanca;112;Cristóbal;270;142;128
37;Salamanca;113;Cubo de Don Sancho (El);722;380;342
37;Salamanca;115;Dios le Guarde;200;106;94
37;Salamanca;116;Doñinos de Ledesma;115;56;59
37;Salamanca;117;Doñinos de Salamanca;664;344;320
37;Salamanca;118;Ejeme;281;150;131
37;Salamanca;120;Encina de San Silvestre;130;63;67
37;Salamanca;119;Encina (La);319;171;148
37;Salamanca;121;Encinas de Abajo;770;404;366
37;Salamanca;122;Encinas de Arriba;309;154;155
37;Salamanca;123;Encinasola de los Comendadores;398;205;193
37;Salamanca;124;Endrinal;361;186;175
37;Salamanca;125;Escurial de la Sierra;351;163;188
37;Salamanca;126;Espadaña;69;36;33
37;Salamanca;127;Espeja;392;200;192
37;Salamanca;128;Espino de la Orbada;448;227;221
37;Salamanca;129;Florida de Liébana;258;144;114
37;Salamanca;130;Forfoleda;277;132;145
37;Salamanca;131;Frades de la Sierra;350;181;169
37;Salamanca;132;Fregeneda (La);727;345;382
37;Salamanca;133;Fresnedoso;192;97;95
37;Salamanca;134;Fresno Alhándiga;421;224;197
37;Salamanca;135;Fuente de San Esteban (La);1894;950;944
37;Salamanca;136;Fuenteguinaldo;1181;587;594
37;Salamanca;137;Fuenteliante;167;84;83
37;Salamanca;138;Fuenterroble de Salvatierra;305;158;147
37;Salamanca;139;Fuentes de Béjar;313;135;178
37;Salamanca;140;Fuentes de Oñoro;1584;782;802
37;Salamanca;141;Gajates;311;157;154
37;Salamanca;142;Galindo y Perahuy;208;108;100
37;Salamanca;143;Galinduste;684;351;333
37;Salamanca;144;Galisancho;830;433;397
37;Salamanca;145;Gallegos de Argañán;668;342;326
37;Salamanca;146;Gallegos de Solmirón;361;171;190
37;Salamanca;147;Garcibuey;356;199;157
37;Salamanca;148;Garcihernández;698;370;328
37;Salamanca;149;Garcirrey;111;54;57
37;Salamanca;150;Gejuelo del Barro;55;30;25
37;Salamanca;151;Golpejas;261;137;124
37;Salamanca;152;Gomecello;694;338;356
37;Salamanca;154;Guadramiro;298;170;128
37;Salamanca;155;Guijo de Ávila;122;67;55
37;Salamanca;156;Guijuelo;4784;2394;2390
37;Salamanca;157;Herguijuela de Ciudad Rodrigo;209;103;106
37;Salamanca;158;Herguijuela de la Sierra;467;228;239
37;Salamanca;159;Herguijuela del Campo;169;88;81
37;Salamanca;160;Hinojosa de Duero;1016;489;527
37;Salamanca;161;Horcajo de Montemayor;231;117;114
37;Salamanca;162;Horcajo Medianero;544;284;260
37;Salamanca;163;Hoya (La);34;20;14
37;Salamanca;164;Huerta;300;163;137
37;Salamanca;165;Iruelos;89;42;47
37;Salamanca;166;Ituero de Azaba;426;214;212
37;Salamanca;167;Juzbado;263;137;126
37;Salamanca;168;Lagunilla;866;458;408
37;Salamanca;169;Larrodrigo;361;182;179
37;Salamanca;170;Ledesma;2136;1048;1088
37;Salamanca;171;Ledrada;675;335;340
37;Salamanca;172;Linares de Riofrío;1211;606;605
37;Salamanca;173;Lumbrales;2640;1289;1351
37;Salamanca;175;Machacón;599;307;292
37;Salamanca;174;Macotera;2008;1008;1000
37;Salamanca;176;Madroñal;171;89;82
37;Salamanca;177;Maíllo (El);495;246;249
37;Salamanca;178;Malpartida;239;125;114
37;Salamanca;179;Mancera de Abajo;460;236;224
37;Salamanca;180;Manzano (El);125;71;54
37;Salamanca;181;Martiago;537;269;268
37;Salamanca;183;Martín de Yeltes;762;392;370
37;Salamanca;182;Martinamor;115;60;55
37;Salamanca;184;Masueco;591;294;297
37;Salamanca;186;Mata de Ledesma (La);197;90;107
37;Salamanca;187;Matilla de los Caños del Río;781;398;383
37;Salamanca;188;Maya (La);325;173;152
37;Salamanca;189;Membribe de la Sierra;127;67;60
37;Salamanca;190;Mieza;462;235;227
37;Salamanca;191;Milano (El);213;110;103
37;Salamanca;192;Miranda de Azán;124;60;64
37;Salamanca;193;Miranda del Castañar;818;422;396
37;Salamanca;194;Mogarraz;452;217;235
37;Salamanca;195;Molinillo;87;46;41
37;Salamanca;196;Monforte de la Sierra;161;83;78
37;Salamanca;197;Monleón;164;92;72
37;Salamanca;198;Monleras;320;166;154
37;Salamanca;199;Monsagro;278;159;119
37;Salamanca;200;Montejo;257;133;124
37;Salamanca;201;Montemayor del Río;480;249;231
37;Salamanca;202;Monterrubio de Armuña;131;65;66
37;Salamanca;203;Monterrubio de la Sierra;192;102;90
37;Salamanca;204;Morasverdes;543;281;262
37;Salamanca;205;Morille;229;116;113
37;Salamanca;206;Moríñigo;188;96;92
37;Salamanca;207;Moriscos;151;81;70
37;Salamanca;208;Moronta;176;85;91
37;Salamanca;209;Mozárbez;375;182;193
37;Salamanca;211;Narros de Matalayegua;379;206;173
37;Salamanca;213;Nava de Béjar;142;69;73
37;Salamanca;214;Nava de Francia;188;104;84
37;Salamanca;215;Nava de Sotrobal;279;145;134
37;Salamanca;212;Navacarros;104;57;47
37;Salamanca;216;Navales;432;242;190
37;Salamanca;217;Navalmoral de Béjar;100;49;51
37;Salamanca;218;Navamorales;244;128;116
37;Salamanca;219;Navarredonda de la Rinconada;402;200;202
37;Salamanca;221;Navasfrías;895;444;451
37;Salamanca;222;Negrilla de Palencia;138;68;70
37;Salamanca;223;Olmedo de Camaces;209;104;105
37;Salamanca;224;Orbada (La);346;172;174
37;Salamanca;225;Pajares de la Laguna;166;83;83
37;Salamanca;226;Palacios del Arzobispo;287;149;138
37;Salamanca;228;Palaciosrubios;673;348;325
37;Salamanca;229;Palencia de Negrilla;249;120;129
37;Salamanca;230;Parada de Arriba;273;139;134
37;Salamanca;231;Parada de Rubiales;415;204;211
37;Salamanca;232;Paradinas de San Juan;708;388;320
37;Salamanca;233;Pastores;88;48;40
37;Salamanca;234;Payo (El);690;335;355
37;Salamanca;235;Pedraza de Alba;310;173;137
37;Salamanca;236;Pedrosillo de Alba;357;181;176
37;Salamanca;237;Pedrosillo de los Aires;566;304;262
37;Salamanca;238;Pedrosillo el Ralo;162;81;81
37;Salamanca;239;Pedroso de la Armuña (El);418;196;222
37;Salamanca;240;Pelabravo;587;305;282
37;Salamanca;241;Pelarrodríguez;234;129;105
37;Salamanca;242;Pelayos;101;53;48
37;Salamanca;243;Peña (La);230;117;113
37;Salamanca;244;Peñacaballera;269;134;135
37;Salamanca;245;Peñaparda;589;278;311
37;Salamanca;246;Peñaranda de Bracamonte;6396;3136;3260
37;Salamanca;247;Peñarandilla;330;166;164
37;Salamanca;248;Peralejos de Abajo;274;126;148
37;Salamanca;249;Peralejos de Arriba;94;51;43
37;Salamanca;250;Pereña de la Ribera;570;297;273
37;Salamanca;251;Peromingo;158;73;85
37;Salamanca;252;Pinedas;272;140;132
37;Salamanca;253;Pino de Tormes (El);191;103;88
37;Salamanca;254;Pitiegua;333;174;159
37;Salamanca;255;Pizarral;114;51;63
37;Salamanca;256;Poveda de las Cintas;437;240;197
37;Salamanca;257;Pozos de Hinojo;124;61;63
37;Salamanca;258;Puebla de Azaba;470;240;230
37;Salamanca;259;Puebla de San Medel;79;41;38
37;Salamanca;260;Puebla de Yeltes;304;166;138
37;Salamanca;261;Puente del Congosto;467;233;234
37;Salamanca;262;Puertas;149;81;68
37;Salamanca;263;Puerto de Béjar;579;280;299
37;Salamanca;264;Puerto Seguro;135;71;64
37;Salamanca;265;Rágama;394;213;181
37;Salamanca;266;Redonda (La);128;61;67
37;Salamanca;267;Retortillo;315;155;160
37;Salamanca;268;Rinconada de la Sierra (La);218;105;113
37;Salamanca;269;Robleda;725;370;355
37;Salamanca;270;Robliza de Cojos;264;118;146
37;Salamanca;271;Rollán;642;328;314
37;Salamanca;272;Saelices el Chico;227;123;104
37;Salamanca;273;Sagrada (La);240;116;124
37;Salamanca;303;Sahugo (El);387;197;190
37;Salamanca;274;Salamanca;162037;77198;84839
37;Salamanca;275;Saldeana;266;139;127
37;Salamanca;276;Salmoral;502;255;247
37;Salamanca;277;Salvatierra de Tormes;90;41;49
37;Salamanca;278;San Cristóbal de la Cuesta;244;125;119
37;Salamanca;284;San Esteban de la Sierra;536;278;258
37;Salamanca;285;San Felices de los Gallegos;769;398;371
37;Salamanca;286;San Martín del Castañar;415;209;206
37;Salamanca;287;San Miguel de Valero;540;254;286
37;Salamanca;036;San Miguel del Robledo;129;65;64
37;Salamanca;288;San Morales;179;93;86
37;Salamanca;289;San Muñoz;431;227;204
37;Salamanca;291;San Pedro de Rozados;491;248;243
37;Salamanca;290;San Pedro del Valle;309;157;152
37;Salamanca;292;San Pelayo de Guareña;144;74;70
37;Salamanca;280;Sanchón de la Ribera;184;93;91
37;Salamanca;281;Sanchón de la Sagrada;69;33;36
37;Salamanca;282;Sanchotello;418;222;196
37;Salamanca;279;Sancti-Spíritus;1502;749;753
37;Salamanca;283;Sando;267;152;115
37;Salamanca;293;Santa María de Sando;249;139;110
37;Salamanca;294;Santa Marta de Tormes;5737;2869;2868
37;Salamanca;296;Santiago de la Puebla;845;439;406
37;Salamanca;297;Santibáñez de Béjar;806;385;421
37;Salamanca;298;Santibáñez de la Sierra;319;173;146
37;Salamanca;299;Santiz;316;168;148
37;Salamanca;300;Santos (Los);866;466;400
37;Salamanca;301;Sardón de los Frailes;103;59;44
37;Salamanca;302;Saucelle;623;331;292
37;Salamanca;304;Sepulcro-Hilario;347;172;175
37;Salamanca;305;Sequeros;302;137;165
37;Salamanca;306;Serradilla del Arroyo;550;276;274
37;Salamanca;307;Serradilla del Llano;420;222;198
37;Salamanca;309;Sierpe (La);62;31;31
37;Salamanca;310;Sieteiglesias de Tormes;215;112;103
37;Salamanca;311;Sobradillo;461;220;241
37;Salamanca;312;Sorihuela;519;256;263
37;Salamanca;313;Sotoserrano;838;440;398
37;Salamanca;314;Tabera de Abajo;142;73;69
37;Salamanca;315;Tala (La);215;108;107
37;Salamanca;316;Tamames;1195;599;596
37;Salamanca;317;Tarazona de Guareña;500;273;227
37;Salamanca;318;Tardáguila;304;162;142
37;Salamanca;319;Tejado (El);237;110;127
37;Salamanca;320;Tejeda y Segoyuela;175;88;87
37;Salamanca;321;Tenebrón;271;131;140
37;Salamanca;322;Terradillos;1514;756;758
37;Salamanca;323;Topas;848;448;400
37;Salamanca;324;Tordillos;704;349;355
37;Salamanca;325;Tornadizo (El);189;96;93
37;Salamanca;327;Torresmenudas;292;143;149
37;Salamanca;328;Trabanca;291;157;134
37;Salamanca;329;Tremedal de Tormes;70;35;35
37;Salamanca;330;Valdecarros;519;263;256
37;Salamanca;331;Valdefuentes de Sangusín;367;187;180
37;Salamanca;332;Valdehijaderos;157;89;68
37;Salamanca;333;Valdelacasa;376;198;178
37;Salamanca;334;Valdelageve;166;95;71
37;Salamanca;335;Valdelosa;568;275;293
37;Salamanca;336;Valdemierque;75;38;37
37;Salamanca;337;Valderrodrigo;231;113;118
37;Salamanca;338;Valdunciel;144;67;77
37;Salamanca;339;Valero;584;290;294
37;Salamanca;343;Vallejera de Riofrío;64;22;42
37;Salamanca;340;Valsalabroso;296;147;149
37;Salamanca;341;Valverde de Valdelacasa;99;51;48
37;Salamanca;342;Valverdón;277;147;130
37;Salamanca;344;Vecinos;349;170;179
37;Salamanca;345;Vega de Tirados;291;152;139
37;Salamanca;346;Veguillas (Las);381;181;200
37;Salamanca;347;Vellés (La);496;252;244
37;Salamanca;348;Ventosa del Río Almar;191;95;96
37;Salamanca;349;Vídola (La);261;133;128
37;Salamanca;351;Villaflores;599;301;298
37;Salamanca;352;Villagonzalo de Tormes;290;155;135
37;Salamanca;353;Villalba de los Llanos;240;130;110
37;Salamanca;354;Villamayor;1101;555;546
37;Salamanca;355;Villanueva del Conde;366;186;180
37;Salamanca;356;Villar de Argañán;155;78;77
37;Salamanca;357;Villar de Ciervo;513;268;245
37;Salamanca;358;Villar de Gallimazo;341;177;164
37;Salamanca;359;Villar de la Yegua;459;232;227
37;Salamanca;360;Villar de Peralonso;481;237;244
37;Salamanca;361;Villar de Samaniego;178;92;86
37;Salamanca;362;Villares de la Reina;1029;507;522
37;Salamanca;363;Villares de Yeltes;199;102;97
37;Salamanca;364;Villarino de los Aires;1382;685;697
37;Salamanca;365;Villarmayor;266;134;132
37;Salamanca;366;Villarmuerto;99;49;50
37;Salamanca;367;Villasbuenas;405;196;209
37;Salamanca;368;Villasdardo;38;19;19
37;Salamanca;369;Villaseco de los Gamitos;252;127;125
37;Salamanca;370;Villaseco de los Reyes;500;250;250
37;Salamanca;371;Villasrubias;466;243;223
37;Salamanca;372;Villaverde de Guareña;243;126;117
37;Salamanca;373;Villavieja de Yeltes;1584;772;812
37;Salamanca;374;Villoria;1462;731;731
37;Salamanca;375;Villoruela;1122;550;572
37;Salamanca;350;Vilvestre;748;367;381
37;Salamanca;376;Vitigudino;3092;1520;1572
37;Salamanca;377;Yecla de Yeltes;489;247;242
37;Salamanca;378;Zamarra;218;112;106
37;Salamanca;379;Zamayón;214;120;94
37;Salamanca;380;Zarapicos;75;36;39
37;Salamanca;381;Zarza de Pumareda (La);268;147;121
37;Salamanca;382;Zorita de la Frontera;389;208;181
38;Santa Cruz de Tenerife;001;Adeje;10103;5214;4889
38;Santa Cruz de Tenerife;002;Agulo;1336;672;664
38;Santa Cruz de Tenerife;003;Alajeró;1143;611;532
38;Santa Cruz de Tenerife;004;Arafo;4020;1950;2070
38;Santa Cruz de Tenerife;005;Arico;4432;2313;2119
38;Santa Cruz de Tenerife;006;Arona;25018;12886;12132
38;Santa Cruz de Tenerife;007;Barlovento;2598;1310;1288
38;Santa Cruz de Tenerife;008;Breña Alta;5467;2736;2731
38;Santa Cruz de Tenerife;009;Breña Baja;3418;1715;1703
38;Santa Cruz de Tenerife;010;Buenavista del Norte;5483;2780;2703
38;Santa Cruz de Tenerife;011;Candelaria;9641;4813;4828
38;Santa Cruz de Tenerife;012;Fasnia;2319;1160;1159
38;Santa Cruz de Tenerife;013;Frontera;4018;2005;2013
38;Santa Cruz de Tenerife;014;Fuencaliente de la Palma;1822;922;900
38;Santa Cruz de Tenerife;015;Garachico;6282;3109;3173
38;Santa Cruz de Tenerife;016;Garafía;2043;1029;1014
38;Santa Cruz de Tenerife;017;Granadilla de Abona;17073;8731;8342
38;Santa Cruz de Tenerife;018;Guancha (La);5199;2587;2612
38;Santa Cruz de Tenerife;019;Guía de Isora;12675;6267;6408
38;Santa Cruz de Tenerife;020;Güímar;14863;7365;7498
38;Santa Cruz de Tenerife;021;Hermigua;2669;1327;1342
38;Santa Cruz de Tenerife;022;Icod de los Vinos;22449;11129;11320
38;Santa Cruz de Tenerife;024;Llanos de Aridane (Los);17062;8490;8572
38;Santa Cruz de Tenerife;025;Matanza de Acentejo (La);6113;3156;2957
38;Santa Cruz de Tenerife;026;Orotava (La);36581;18107;18474
38;Santa Cruz de Tenerife;027;Paso (El);7154;3552;3602
38;Santa Cruz de Tenerife;028;Puerto de la Cruz;28281;13897;14384
38;Santa Cruz de Tenerife;029;Puntagorda;1692;867;825
38;Santa Cruz de Tenerife;030;Puntallana;2305;1162;1143
38;Santa Cruz de Tenerife;031;Realejos (Los);30072;14815;15257
38;Santa Cruz de Tenerife;032;Rosario (El);7146;3583;3563
38;Santa Cruz de Tenerife;033;San Andrés y Sauces;5492;2735;2757
38;Santa Cruz de Tenerife;023;San Cristóbal de La Laguna;118548;58673;59875
38;Santa Cruz de Tenerife;034;San Juan de la Rambla;4861;2431;2430
38;Santa Cruz de Tenerife;035;San Miguel de Abona;5294;2701;2593
38;Santa Cruz de Tenerife;036;San Sebastián de la Gomera;6010;3038;2972
38;Santa Cruz de Tenerife;037;Santa Cruz de la Palma;18183;8747;9436
38;Santa Cruz de Tenerife;038;Santa Cruz de Tenerife;222892;108780;114112
38;Santa Cruz de Tenerife;039;Santa Úrsula;8915;4467;4448
38;Santa Cruz de Tenerife;040;Santiago del Teide;5325;2713;2612
38;Santa Cruz de Tenerife;041;Sauzal (El);6304;3172;3132
38;Santa Cruz de Tenerife;042;Silos (Los);5623;2744;2879
38;Santa Cruz de Tenerife;043;Tacoronte;18159;9109;9050
38;Santa Cruz de Tenerife;044;Tanque (El);2818;1415;1403
38;Santa Cruz de Tenerife;045;Tazacorte;7049;3548;3501
38;Santa Cruz de Tenerife;046;Tegueste;7618;3826;3792
38;Santa Cruz de Tenerife;047;Tijarafe;2734;1393;1341
38;Santa Cruz de Tenerife;049;Valle Gran Rey;2964;1533;1431
38;Santa Cruz de Tenerife;050;Vallehermoso;3363;1652;1711
38;Santa Cruz de Tenerife;048;Valverde;3687;1832;1855
38;Santa Cruz de Tenerife;051;Victoria de Acentejo (La);7639;3876;3763
38;Santa Cruz de Tenerife;052;Vilaflor;1560;791;769
38;Santa Cruz de Tenerife;053;Villa de Mazo;5112;2559;2553
39;Cantabria;001;Alfoz de Lloredo;2836;1465;1371
39;Cantabria;002;Ampuero;3404;1720;1684
39;Cantabria;003;Anievas;477;239;238
39;Cantabria;004;Arenas de Iguña;2374;1212;1162
39;Cantabria;005;Argoños;652;329;323
39;Cantabria;006;Arnuero;1848;918;930
39;Cantabria;007;Arredondo;788;417;371
39;Cantabria;008;Astillero (El);12517;6210;6307
39;Cantabria;009;Bárcena de Cicero;2334;1189;1145
39;Cantabria;010;Bárcena de Pie de Concha;965;456;509
39;Cantabria;011;Bareyo;1635;839;796
39;Cantabria;012;Cabezón de la Sal;6703;3308;3395
39;Cantabria;013;Cabezón de Liébana;908;469;439
39;Cantabria;014;Cabuérniga;1171;584;587
39;Cantabria;015;Camaleño;1327;688;639
39;Cantabria;016;Camargo;20176;9987;10189
39;Cantabria;027;Campoo de Enmedio;4109;2105;2004
39;Cantabria;017;Campoo de Yuso;916;457;459
39;Cantabria;018;Cartes;2191;1095;1096
39;Cantabria;019;Castañeda;1604;786;818
39;Cantabria;020;Castro-Urdiales;13594;6747;6847
39;Cantabria;021;Cieza;825;403;422
39;Cantabria;022;Cillorigo de Liébana;1266;676;590
39;Cantabria;023;Colindres;5509;2752;2757
39;Cantabria;024;Comillas;2552;1209;1343
39;Cantabria;025;Corrales de Buelna (Los);9817;4887;4930
39;Cantabria;026;Corvera de Toranzo;2264;1128;1136
39;Cantabria;028;Entrambasaguas;2664;1320;1344
39;Cantabria;029;Escalante;757;366;391
39;Cantabria;030;Guriezo;1830;931;899
39;Cantabria;031;Hazas de Cesto;1371;697;674
39;Cantabria;032;Hermandad de Campoo de Suso;1965;1035;930
39;Cantabria;033;Herrerías;888;464;424
39;Cantabria;034;Lamasón;486;257;229
39;Cantabria;035;Laredo;13493;6658;6835
39;Cantabria;036;Liendo;804;404;400
39;Cantabria;037;Liérganes;2391;1178;1213
39;Cantabria;038;Limpias;1202;607;595
39;Cantabria;039;Luena;1253;656;597
39;Cantabria;040;Marina de Cudeyo;4576;2275;2301
39;Cantabria;041;Mazcuerras;1848;950;898
39;Cantabria;042;Medio Cudeyo;5656;2779;2877
39;Cantabria;043;Meruelo;1055;548;507
39;Cantabria;044;Miengo;3012;1496;1516
39;Cantabria;045;Miera;780;383;397
39;Cantabria;046;Molledo;2247;1108;1139
39;Cantabria;047;Noja;1609;801;808
39;Cantabria;048;Penagos;1819;899;920
39;Cantabria;049;Peñarrubia;381;190;191
39;Cantabria;050;Pesaguero;491;268;223
39;Cantabria;051;Pesquera;120;54;66
39;Cantabria;052;Piélagos;9219;4610;4609
39;Cantabria;053;Polaciones;391;226;165
39;Cantabria;054;Polanco;3784;1830;1954
39;Cantabria;055;Potes;1475;736;739
39;Cantabria;056;Puente Viesgo;2500;1261;1239
39;Cantabria;057;Ramales de la Victoria;2471;1244;1227
39;Cantabria;058;Rasines;1105;552;553
39;Cantabria;059;Reinosa;12847;6287;6560
39;Cantabria;060;Reocín;6507;3250;3257
39;Cantabria;061;Ribamontán al Mar;2787;1437;1350
39;Cantabria;062;Ribamontán al Monte;2141;1107;1034
39;Cantabria;063;Rionansa;1783;928;855
39;Cantabria;064;Riotuerto;1695;833;862
39;Cantabria;065;Rozas de Valdearroyo (Las);296;157;139
39;Cantabria;066;Ruente;996;510;486
39;Cantabria;067;Ruesga;1400;704;696
39;Cantabria;068;Ruiloba;790;397;393
39;Cantabria;069;San Felices de Buelna;2385;1193;1192
39;Cantabria;070;San Miguel de Aguayo;185;98;87
39;Cantabria;071;San Pedro del Romeral;957;501;456
39;Cantabria;072;San Roque de Riomiera;638;334;304
39;Cantabria;080;San Vicente de la Barquera;4521;2330;2191
39;Cantabria;073;Santa Cruz de Bezana;4396;2196;2200
39;Cantabria;074;Santa María de Cayón;6062;3059;3003
39;Cantabria;075;Santander;194221;92181;102040
39;Cantabria;076;Santillana del Mar;3832;1874;1958
39;Cantabria;077;Santiurde de Reinosa;420;220;200
39;Cantabria;078;Santiurde de Toranzo;1856;933;923
39;Cantabria;079;Santoña;11211;5496;5715
39;Cantabria;081;Saro;599;313;286
39;Cantabria;082;Selaya;2086;1063;1023
39;Cantabria;083;Soba;1981;1044;937
39;Cantabria;084;Solórzano;1092;560;532
39;Cantabria;085;Suances;5865;2888;2977
39;Cantabria;086;Tojos (Los);420;222;198
39;Cantabria;087;Torrelavega;59997;29291;30706
39;Cantabria;088;Tresviso;94;53;41
39;Cantabria;089;Tudanca;357;198;159
39;Cantabria;090;Udías;866;432;434
39;Cantabria;095;Val de San Vicente;2621;1356;1265
39;Cantabria;091;Valdáliga;2832;1458;1374
39;Cantabria;092;Valdeolea;1947;1011;936
39;Cantabria;093;Valdeprado del Río;429;222;207
39;Cantabria;094;Valderredible;1374;698;676
39;Cantabria;096;Vega de Liébana;1158;601;557
39;Cantabria;097;Vega de Pas;1293;659;634
39;Cantabria;098;Villacarriedo;2097;1055;1042
39;Cantabria;099;Villaescusa;2937;1440;1497
39;Cantabria;100;Villafufre;1194;596;598
39;Cantabria;101;Villaverde de Trucíos;459;248;211
39;Cantabria;102;Voto;2661;1386;1275
40;Segovia;001;Abades;935;472;463
40;Segovia;002;Adrada de Pirón;49;25;24
40;Segovia;003;Adrados;310;143;167
40;Segovia;004;Aguilafuente;822;397;425
40;Segovia;005;Alconada de Maderuelo;68;35;33
40;Segovia;012;Aldea Real;434;230;204
40;Segovia;006;Aldealcorvo;42;20;22
40;Segovia;007;Aldealengua de Pedraza;109;60;49
40;Segovia;008;Aldealengua de Santa María;105;60;45
40;Segovia;009;Aldeanueva de la Serrezuela;56;32;24
40;Segovia;010;Aldeanueva del Codonal;273;132;141
40;Segovia;013;Aldeasoña;173;81;92
40;Segovia;014;Aldehorno;101;58;43
40;Segovia;015;Aldehuela del Codonal;66;26;40
40;Segovia;016;Aldeonte;120;62;58
40;Segovia;017;Anaya;137;75;62
40;Segovia;018;Añe;135;72;63
40;Segovia;019;Arahuetes;52;29;23
40;Segovia;020;Arcones;308;160;148
40;Segovia;021;Arevalillo de Cega;35;19;16
40;Segovia;022;Armuña;343;169;174
40;Segovia;024;Ayllón;1327;667;660
40;Segovia;025;Barbolla;259;136;123
40;Segovia;026;Basardilla;113;58;55
40;Segovia;028;Bercial;180;90;90
40;Segovia;029;Bercimuel;96;42;54
40;Segovia;030;Bernardos;851;413;438
40;Segovia;031;Bernuy de Porreros;352;181;171
40;Segovia;032;Boceguillas;562;283;279
40;Segovia;033;Brieva;59;37;22
40;Segovia;034;Caballar;120;58;62
40;Segovia;035;Cabañas de Polendos;125;62;63
40;Segovia;036;Cabezuela;800;421;379
40;Segovia;037;Calabazas de Fuentidueña;121;61;60
40;Segovia;039;Campo de San Pedro;411;234;177
40;Segovia;040;Cantalejo;3527;1760;1767
40;Segovia;041;Cantimpalos;1371;687;684
40;Segovia;043;Carbonero el Mayor;2480;1249;1231
40;Segovia;044;Carrascal del Río;247;129;118
40;Segovia;045;Casla;151;75;76
40;Segovia;046;Castillejo de Mesleón;140;69;71
40;Segovia;047;Castro de Fuentidueña;130;75;55
40;Segovia;048;Castrojimeno;68;38;30
40;Segovia;049;Castroserna de Abajo;81;46;35
40;Segovia;051;Castroserracín;50;31;19
40;Segovia;052;Cedillo de la Torre;166;84;82
40;Segovia;053;Cerezo de Abajo;188;92;96
40;Segovia;054;Cerezo de Arriba;211;110;101
40;Segovia;065;Chañe;807;421;386
40;Segovia;055;Cilleruelo de San Mamés;69;39;30
40;Segovia;056;Cobos de Fuentidueña;100;44;56
40;Segovia;057;Coca;2117;1046;1071
40;Segovia;058;Codorniz;565;278;287
40;Segovia;059;Collado Hermoso;116;54;62
40;Segovia;060;Condado de Castilnovo;168;94;74
40;Segovia;061;Corral de Ayllón;141;82;59
40;Segovia;902;Cozuelos de Fuentidueña;268;136;132
40;Segovia;062;Cubillo;73;40;33
40;Segovia;063;Cuéllar;9283;4686;4597
40;Segovia;905;Cuevas de Provanco;293;155;138
40;Segovia;068;Domingo García;36;17;19
40;Segovia;069;Donhierro;124;76;48
40;Segovia;070;Duruelo;114;59;55
40;Segovia;071;Encinas;85;42;43
40;Segovia;072;Encinillas;78;39;39
40;Segovia;073;Escalona del Prado;674;335;339
40;Segovia;074;Escarabajosa de Cabezas;434;231;203
40;Segovia;075;Escobar de Polendos;258;125;133
40;Segovia;076;Espinar (El);5258;2658;2600
40;Segovia;077;Espirdo;215;126;89
40;Segovia;078;Fresneda de Cuéllar;294;158;136
40;Segovia;079;Fresno de Cantespino;248;125;123
40;Segovia;080;Fresno de la Fuente;116;61;55
40;Segovia;081;Frumales;294;144;150
40;Segovia;082;Fuente de Santa Cruz;224;115;109
40;Segovia;083;Fuente el Olmo de Fuentidueña;225;114;111
40;Segovia;084;Fuente el Olmo de Íscar;130;71;59
40;Segovia;086;Fuentepelayo;1040;522;518
40;Segovia;087;Fuentepiñel;203;99;104
40;Segovia;088;Fuenterrebollo;529;262;267
40;Segovia;089;Fuentesaúco de Fuentidueña;409;213;196
40;Segovia;091;Fuentesoto;212;104;108
40;Segovia;092;Fuentidueña;248;117;131
40;Segovia;093;Gallegos;114;59;55
40;Segovia;094;Garcillán;358;192;166
40;Segovia;095;Gomezserracín;672;340;332
40;Segovia;097;Grajera;79;38;41
40;Segovia;099;Honrubia de la Cuesta;107;55;52
40;Segovia;100;Hontalbilla;595;309;286
40;Segovia;101;Hontanares de Eresma;141;73;68
40;Segovia;103;Huertos (Los);165;85;80
40;Segovia;104;Ituero y Lama;61;35;26
40;Segovia;105;Juarros de Riomoros;101;50;51
40;Segovia;106;Juarros de Voltoya;330;180;150
40;Segovia;107;Labajos;179;99;80
40;Segovia;108;Laguna de Contreras;242;127;115
40;Segovia;109;Languilla;178;87;91
40;Segovia;110;Lastras de Cuéllar;673;346;327
40;Segovia;111;Lastras del Pozo;107;55;52
40;Segovia;112;Lastrilla (La);470;233;237
40;Segovia;113;Losa (La);281;142;139
40;Segovia;115;Maderuelo;187;93;94
40;Segovia;903;Marazoleja;188;105;83
40;Segovia;118;Marazuela;101;49;52
40;Segovia;119;Martín Miguel;220;108;112
40;Segovia;120;Martín Muñoz de la Dehesa;174;94;80
40;Segovia;121;Martín Muñoz de las Posadas;650;324;326
40;Segovia;122;Marugán;249;124;125
40;Segovia;124;Mata de Cuéllar;330;175;155
40;Segovia;123;Matabuena;257;125;132
40;Segovia;125;Matilla (La);134;72;62
40;Segovia;126;Melque de Cercos;174;83;91
40;Segovia;127;Membibre de la Hoz;104;53;51
40;Segovia;128;Migueláñez;213;105;108
40;Segovia;129;Montejo de Arévalo;360;199;161
40;Segovia;130;Montejo de la Vega de la Serrezuela;225;117;108
40;Segovia;131;Monterrubio;90;42;48
40;Segovia;132;Moral de Hornuez;159;82;77
40;Segovia;134;Mozoncillo;1098;559;539
40;Segovia;135;Muñopedro;488;251;237
40;Segovia;136;Muñoveros;255;132;123
40;Segovia;138;Nava de la Asunción;2642;1361;1281
40;Segovia;139;Navafría;440;233;207
40;Segovia;140;Navalilla;217;107;110
40;Segovia;141;Navalmanzano;1226;623;603
40;Segovia;142;Navares de Ayuso;88;48;40
40;Segovia;143;Navares de Enmedio;213;112;101
40;Segovia;144;Navares de las Cuevas;33;17;16
40;Segovia;145;Navas de Oro;1572;785;787
40;Segovia;904;Navas de Riofrío;231;106;125
40;Segovia;146;Navas de San Antonio;346;180;166
40;Segovia;148;Nieva;396;196;200
40;Segovia;149;Olombrada;961;509;452
40;Segovia;150;Orejana;129;66;63
40;Segovia;151;Ortigosa de Pestaño;102;54;48
40;Segovia;901;Ortigosa del Monte;281;142;139
40;Segovia;152;Otero de Herreros;863;437;426
40;Segovia;154;Pajarejos;52;24;28
40;Segovia;155;Palazuelos de Eresma;1424;740;684
40;Segovia;156;Pedraza;459;224;235
40;Segovia;157;Pelayos del Arroyo;61;33;28
40;Segovia;158;Perosillo;34;21;13
40;Segovia;159;Pinarejos;249;138;111
40;Segovia;160;Pinarnegrillo;225;117;108
40;Segovia;161;Pradales;62;35;27
40;Segovia;162;Prádena;586;298;288
40;Segovia;163;Puebla de Pedraza;107;54;53
40;Segovia;164;Rapariegos;312;166;146
40;Segovia;165;Rebollo;160;89;71
40;Segovia;166;Remondo;404;199;205
40;Segovia;168;Riaguas de San Bartolomé;80;40;40
40;Segovia;170;Riaza;1547;805;742
40;Segovia;171;Ribota;45;25;20
40;Segovia;172;Riofrío de Riaza;61;34;27
40;Segovia;173;Roda de Eresma;106;50;56
40;Segovia;174;Sacramenia;666;350;316
40;Segovia;176;Samboal;744;387;357
40;Segovia;177;San Cristóbal de Cuéllar;300;150;150
40;Segovia;178;San Cristóbal de la Vega;197;98;99
40;Segovia;906;San Cristóbal de Segovia;"";"";""
40;Segovia;181;San Ildefonso;5008;2439;2569
40;Segovia;182;San Martín y Mudrián;367;188;179
40;Segovia;183;San Miguel de Bernuy;239;121;118
40;Segovia;184;San Pedro de Gaíllos;339;177;162
40;Segovia;179;Sanchonuño;769;386;383
40;Segovia;180;Sangarcía;569;298;271
40;Segovia;185;Santa María la Real de Nieva;1712;853;859
40;Segovia;186;Santa Marta del Cerro;61;30;31
40;Segovia;188;Santiuste de Pedraza;144;78;66
40;Segovia;189;Santiuste de San Juan Bautista;924;463;461
40;Segovia;190;Santo Domingo de Pirón;56;27;29
40;Segovia;191;Santo Tomé del Puerto;412;208;204
40;Segovia;192;Sauquillo de Cabezas;284;154;130
40;Segovia;193;Sebúlcor;277;148;129
40;Segovia;194;Segovia;55188;26605;28583
40;Segovia;195;Sepúlveda;1440;725;715
40;Segovia;196;Sequera de Fresno;83;47;36
40;Segovia;198;Sotillo;69;31;38
40;Segovia;199;Sotosalbos;98;47;51
40;Segovia;200;Tabanera la Luenga;90;47;43
40;Segovia;201;Tolocirio;84;40;44
40;Segovia;206;Torre Val de San Pedro;192;100;92
40;Segovia;202;Torreadrada;187;89;98
40;Segovia;203;Torrecaballeros;273;137;136
40;Segovia;204;Torrecilla del Pinar;412;197;215
40;Segovia;205;Torreiglesias;425;223;202
40;Segovia;207;Trescasas;179;97;82
40;Segovia;208;Turégano;1241;615;626
40;Segovia;210;Urueñas;174;98;76
40;Segovia;211;Valdeprados;40;18;22
40;Segovia;212;Valdevacas de Montejo;46;27;19
40;Segovia;213;Valdevacas y Guijar;173;95;78
40;Segovia;218;Valle de Tabladillo;235;121;114
40;Segovia;219;Vallelado;897;450;447
40;Segovia;220;Valleruela de Pedraza;69;41;28
40;Segovia;221;Valleruela de Sepúlveda;92;46;46
40;Segovia;214;Valseca;345;172;173
40;Segovia;215;Valtiendas;255;138;117
40;Segovia;216;Valverde del Majano;511;265;246
40;Segovia;222;Veganzones;353;175;178
40;Segovia;223;Vegas de Matute;288;155;133
40;Segovia;224;Ventosilla y Tejadilla;30;16;14
40;Segovia;225;Villacastín;1631;842;789
40;Segovia;228;Villaverde de Íscar;792;408;384
40;Segovia;229;Villaverde de Montejo;99;51;48
40;Segovia;230;Villeguillo;149;84;65
40;Segovia;231;Yanguas de Eresma;238;105;133
40;Segovia;233;Zarzuela del Monte;555;275;280
40;Segovia;234;Zarzuela del Pinar;677;353;324
41;Sevilla;001;Aguadulce;1978;987;991
41;Sevilla;002;Alanís;2274;1147;1127
41;Sevilla;003;Albaida del Aljarafe;1714;869;845
41;Sevilla;004;Alcalá de Guadaira;52168;25971;26197
41;Sevilla;005;Alcalá del Río;9162;4668;4494
41;Sevilla;006;Alcolea del Río;3541;1730;1811
41;Sevilla;007;Algaba (La);12553;6322;6231
41;Sevilla;008;Algámitas;1500;764;736
41;Sevilla;009;Almadén de la Plata;1921;984;937
41;Sevilla;010;Almensilla;1724;847;877
41;Sevilla;011;Arahal;17767;8795;8972
41;Sevilla;012;Aznalcázar;3189;1600;1589
41;Sevilla;013;Aznalcóllar;5520;2804;2716
41;Sevilla;014;Badolatosa;3246;1652;1594
41;Sevilla;015;Benacazón;4729;2385;2344
41;Sevilla;016;Bollullos de la Mitación;4387;2182;2205
41;Sevilla;017;Bormujos;5001;2468;2533
41;Sevilla;018;Brenes;10220;5134;5086
41;Sevilla;019;Burguillos;3244;1630;1614
41;Sevilla;020;Cabezas de San Juan (Las);15695;8051;7644
41;Sevilla;021;Camas;25944;12741;13203
41;Sevilla;022;Campana (La);5568;2838;2730
41;Sevilla;023;Cantillana;8992;4494;4498
41;Sevilla;901;Cañada Rosal;2810;1414;1396
41;Sevilla;024;Carmona;24515;12298;12217
41;Sevilla;025;Carrión de los Céspedes;2462;1190;1272
41;Sevilla;026;Casariche;5009;2534;2475
41;Sevilla;027;Castilblanco de los Arroyos;4000;2022;1978
41;Sevilla;028;Castilleja de Guzmán;279;143;136
41;Sevilla;029;Castilleja de la Cuesta;14669;7251;7418
41;Sevilla;030;Castilleja del Campo;626;313;313
41;Sevilla;031;Castillo de las Guardas (El);1817;933;884
41;Sevilla;032;Cazalla de la Sierra;5411;2711;2700
41;Sevilla;033;Constantina;7880;3904;3976
41;Sevilla;034;Coria del Río;22436;11219;11217
41;Sevilla;035;Coripe;1809;923;886
41;Sevilla;036;Coronil (El);5205;2659;2546
41;Sevilla;037;Corrales (Los);3938;2039;1899
41;Sevilla;903;Cuervo de Sevilla (El);"";"";""
41;Sevilla;038;Dos Hermanas;72717;35920;36797
41;Sevilla;039;Écija;36673;18113;18560
41;Sevilla;040;Espartinas;2682;1391;1291
41;Sevilla;041;Estepa;10933;5394;5539
41;Sevilla;042;Fuentes de Andalucía;7739;3884;3855
41;Sevilla;043;Garrobo (El);754;372;382
41;Sevilla;044;Gelves;3819;1845;1974
41;Sevilla;045;Gerena;5193;2603;2590
41;Sevilla;046;Gilena;3799;1903;1896
41;Sevilla;047;Gines;5908;2932;2976
41;Sevilla;048;Guadalcanal;3321;1630;1691
41;Sevilla;049;Guillena;7849;3984;3865
41;Sevilla;050;Herrera;5720;2823;2897
41;Sevilla;051;Huévar del Aljarafe;2115;1106;1009
41;Sevilla;052;Lantejuela (La);3297;1709;1588
41;Sevilla;053;Lebrija;29804;15108;14696
41;Sevilla;054;Lora de Estepa;679;341;338
41;Sevilla;055;Lora del Río;19464;9618;9846
41;Sevilla;056;Luisiana (La);4169;2121;2048
41;Sevilla;057;Madroño (El);431;228;203
41;Sevilla;058;Mairena del Alcor;14415;7195;7220
41;Sevilla;059;Mairena del Aljarafe;21993;11133;10860
41;Sevilla;060;Marchena;17835;8772;9063
41;Sevilla;061;Marinaleda;2510;1245;1265
41;Sevilla;062;Martín de la Jara;2761;1440;1321
41;Sevilla;063;Molares (Los);2720;1382;1338
41;Sevilla;064;Montellano;7129;3618;3511
41;Sevilla;065;Morón de la Frontera;29191;14617;14574
41;Sevilla;066;Navas de la Concepción (Las);2154;1072;1082
41;Sevilla;067;Olivares;6463;3306;3157
41;Sevilla;068;Osuna;16957;8368;8589
41;Sevilla;069;Palacios y Villafranca (Los);29703;15069;14634
41;Sevilla;070;Palomares del Río;2299;1185;1114
41;Sevilla;071;Paradas;7184;3612;3572
41;Sevilla;072;Pedrera;4795;2407;2388
41;Sevilla;073;Pedroso (El);2507;1240;1267
41;Sevilla;074;Peñaflor;4097;2083;2014
41;Sevilla;075;Pilas;10640;5183;5457
41;Sevilla;076;Pruna;3782;1966;1816
41;Sevilla;077;Puebla de Cazalla (La);10853;5461;5392
41;Sevilla;078;Puebla de los Infantes (La);3848;1949;1899
41;Sevilla;079;Puebla del Río (La);16321;8259;8062
41;Sevilla;080;Real de la Jara (El);1825;922;903
41;Sevilla;081;Rinconada (La);21166;10727;10439
41;Sevilla;082;Roda de Andalucía (La);4074;2023;2051
41;Sevilla;083;Ronquillo (El);1407;703;704
41;Sevilla;084;Rubio (El);3837;1940;1897
41;Sevilla;085;Salteras;2485;1250;1235
41;Sevilla;086;San Juan de Aznalfarache;21960;10753;11207
41;Sevilla;088;San Nicolás del Puerto;771;403;368
41;Sevilla;087;Sanlúcar la Mayor;9184;4586;4598
41;Sevilla;089;Santiponce;6362;3191;3171
41;Sevilla;090;Saucejo (El);4102;2090;2012
41;Sevilla;091;Sevilla;678218;324532;353686
41;Sevilla;092;Tocina;8714;4319;4395
41;Sevilla;093;Tomares;12012;5956;6056
41;Sevilla;094;Umbrete;4273;2138;2135
41;Sevilla;095;Utrera;43006;21527;21479
41;Sevilla;096;Valencina de la Concepción;4369;2232;2137
41;Sevilla;902;Villafranco del Guadalquivir;"";"";""
41;Sevilla;097;Villamanrique de la Condesa;3566;1782;1784
41;Sevilla;100;Villanueva de San Juan;1765;881;884
41;Sevilla;098;Villanueva del Ariscal;3914;1855;2059
41;Sevilla;099;Villanueva del Río y Minas;5857;2812;3045
41;Sevilla;101;Villaverde del Río;6396;3271;3125
41;Sevilla;102;Viso del Alcor (El);15123;7696;7427
42;Soria;001;Abejar;364;190;174
42;Soria;003;Adradas;130;67;63
42;Soria;004;Ágreda;3635;1750;1885
42;Soria;006;Alconaba;162;91;71
42;Soria;007;Alcubilla de Avellaneda;292;154;138
42;Soria;008;Alcubilla de las Peñas;117;56;61
42;Soria;009;Aldealafuente;169;82;87
42;Soria;010;Aldealices;40;19;21
42;Soria;011;Aldealpozo;33;15;18
42;Soria;012;Aldealseñor;59;31;28
42;Soria;013;Aldehuela de Periáñez;45;24;21
42;Soria;014;Aldehuelas (Las);180;92;88
42;Soria;015;Alentisque;63;35;28
42;Soria;016;Aliud;60;28;32
42;Soria;017;Almajano;202;101;101
42;Soria;018;Almaluez;425;212;213
42;Soria;019;Almarza;673;357;316
42;Soria;020;Almazán;5886;2952;2934
42;Soria;021;Almazul;238;115;123
42;Soria;022;Almenar de Soria;481;245;236
42;Soria;023;Alpanseque;158;82;76
42;Soria;024;Arancón;122;68;54
42;Soria;025;Arcos de Jalón;2335;1173;1162
42;Soria;026;Arenillas;54;28;26
42;Soria;027;Arévalo de la Sierra;155;84;71
42;Soria;028;Ausejo de la Sierra;61;33;28
42;Soria;029;Baraona;313;163;150
42;Soria;030;Barca;202;107;95
42;Soria;031;Barcones;71;39;32
42;Soria;032;Bayubas de Abajo;334;179;155
42;Soria;033;Bayubas de Arriba;102;53;49
42;Soria;034;Beratón;42;31;11
42;Soria;035;Berlanga de Duero;1481;740;741
42;Soria;036;Blacos;88;50;38
42;Soria;037;Bliecos;72;36;36
42;Soria;038;Borjabad;81;42;39
42;Soria;039;Borobia;463;235;228
42;Soria;041;Buberos;59;27;32
42;Soria;042;Buitrago;56;29;27
42;Soria;043;Burgo de Osma-Ciudad de Osma;5025;2446;2579
42;Soria;044;Cabrejas del Campo;93;52;41
42;Soria;045;Cabrejas del Pinar;549;296;253
42;Soria;046;Calatañazor;85;45;40
42;Soria;048;Caltojar;196;99;97
42;Soria;049;Candilichera;261;139;122
42;Soria;050;Cañamaque;74;40;34
42;Soria;051;Carabantes;52;27;25
42;Soria;052;Caracena;9;5;4
42;Soria;053;Carrascosa de Abajo;53;28;25
42;Soria;054;Carrascosa de la Sierra;21;9;12
42;Soria;055;Casarejos;331;168;163
42;Soria;056;Castilfrío de la Sierra;38;19;19
42;Soria;058;Castillejo de Robledo;272;147;125
42;Soria;057;Castilruiz;431;217;214
42;Soria;059;Centenera de Andaluz;42;18;24
42;Soria;060;Cerbón;76;40;36
42;Soria;061;Cidones;361;183;178
42;Soria;062;Cigudosa;109;60;49
42;Soria;063;Cihuela;136;69;67
42;Soria;064;Ciria;103;49;54
42;Soria;065;Cirujales del Río;43;24;19
42;Soria;068;Coscurita;200;113;87
42;Soria;069;Covaleda;2210;1138;1072
42;Soria;070;Cubilla;107;57;50
42;Soria;071;Cubo de la Solana;402;205;197
42;Soria;073;Cueva de Ágreda;148;79;69
42;Soria;075;Dévanos;195;100;95
42;Soria;076;Deza;513;258;255
42;Soria;078;Duruelo de la Sierra;1560;796;764
42;Soria;079;Escobosa de Almazán;53;27;26
42;Soria;080;Espeja de San Marcelino;306;165;141
42;Soria;081;Espejón;261;139;122
42;Soria;082;Estepa de San Juan;20;10;10
42;Soria;083;Frechilla de Almazán;65;36;29
42;Soria;084;Fresno de Caracena;71;39;32
42;Soria;085;Fuentearmegil;468;243;225
42;Soria;086;Fuentecambrón;98;56;42
42;Soria;087;Fuentecantos;50;22;28
42;Soria;088;Fuentelmonge;171;87;84
42;Soria;089;Fuentelsaz de Soria;76;41;35
42;Soria;090;Fuentepinilla;209;106;103
42;Soria;092;Fuentes de Magaña;144;69;75
42;Soria;093;Fuentestrún;98;55;43
42;Soria;094;Garray;329;161;168
42;Soria;095;Golmayo;527;288;239
42;Soria;096;Gómara;667;322;345
42;Soria;097;Gormaz;42;19;23
42;Soria;098;Herrera de Soria;50;27;23
42;Soria;100;Hinojosa del Campo;75;44;31
42;Soria;103;Langa de Duero;1162;604;558
42;Soria;105;Liceras;78;37;41
42;Soria;106;Losilla (La);24;14;10
42;Soria;107;Magaña;124;64;60
42;Soria;108;Maján;32;16;16
42;Soria;110;Matalebreras;165;85;80
42;Soria;111;Matamala de Almazán;523;269;254
42;Soria;113;Medinaceli;849;432;417
42;Soria;115;Miño de Medinaceli;181;83;98
42;Soria;116;Miño de San Esteban;146;79;67
42;Soria;117;Molinos de Duero;209;103;106
42;Soria;118;Momblona;61;35;26
42;Soria;119;Monteagudo de las Vicarías;390;194;196
42;Soria;120;Montejo de Tiermes;315;166;149
42;Soria;121;Montenegro de Cameros;130;70;60
42;Soria;123;Morón de Almazán;386;187;199
42;Soria;124;Muriel de la Fuente;103;56;47
42;Soria;125;Muriel Viejo;113;58;55
42;Soria;127;Nafría de Ucero;115;54;61
42;Soria;128;Narros;65;34;31
42;Soria;129;Navaleno;951;478;473
42;Soria;130;Nepas;110;64;46
42;Soria;131;Nolay;115;64;51
42;Soria;132;Noviercas;295;141;154
42;Soria;134;Ólvega;3214;1663;1551
42;Soria;135;Oncala;149;85;64
42;Soria;139;Pinilla del Campo;33;17;16
42;Soria;140;Portillo de Soria;25;15;10
42;Soria;141;Póveda de Soria (La);171;86;85
42;Soria;142;Pozalmuro;143;70;73
42;Soria;144;Quintana Redonda;747;387;360
42;Soria;145;Quintanas de Gormaz;240;115;125
42;Soria;148;Quiñonería;27;11;16
42;Soria;149;Rábanos (Los);462;251;211
42;Soria;151;Rebollar;52;30;22
42;Soria;152;Recuerda;195;103;92
42;Soria;153;Rello;58;24;34
42;Soria;154;Renieblas;134;70;64
42;Soria;155;Retortillo de Soria;322;174;148
42;Soria;156;Reznos;64;36;28
42;Soria;157;Riba de Escalote (La);45;27;18
42;Soria;158;Rioseco de Soria;178;92;86
42;Soria;159;Rollamienta;47;25;22
42;Soria;160;Royo (El);393;183;210
42;Soria;161;Salduero;234;128;106
42;Soria;162;San Esteban de Gormaz;3657;1871;1786
42;Soria;163;San Felices;113;64;49
42;Soria;164;San Leonardo de Yagüe;2153;1091;1062
42;Soria;165;San Pedro Manrique;534;259;275
42;Soria;166;Santa Cruz de Yanguas;75;45;30
42;Soria;167;Santa María de Huerta;545;261;284
42;Soria;168;Santa María de las Hoyas;253;133;120
42;Soria;171;Serón de Nágima;339;177;162
42;Soria;172;Soliedra;45;27;18
42;Soria;173;Soria;32609;15597;17012
42;Soria;174;Sotillo del Rincón;184;89;95
42;Soria;175;Suellacabras;56;25;31
42;Soria;176;Tajahuerce;55;29;26
42;Soria;177;Tajueco;162;86;76
42;Soria;178;Talveila;259;137;122
42;Soria;181;Tardelcuende;752;361;391
42;Soria;182;Taroda;111;60;51
42;Soria;183;Tejado;270;134;136
42;Soria;184;Torlengua;159;76;83
42;Soria;185;Torreblacos;62;28;34
42;Soria;187;Torrubia de Soria;139;79;60
42;Soria;188;Trévago;95;47;48
42;Soria;189;Ucero;109;58;51
42;Soria;190;Vadillo;183;95;88
42;Soria;191;Valdeavellano de Tera;248;128;120
42;Soria;192;Valdegeña;58;33;25
42;Soria;193;Valdelagua del Cerro;51;25;26
42;Soria;194;Valdemaluque;385;194;191
42;Soria;195;Valdenebro;209;109;100
42;Soria;196;Valdeprado;25;11;14
42;Soria;197;Valderrodilla;156;74;82
42;Soria;198;Valtajeros;42;22;20
42;Soria;200;Velamazán;182;101;81
42;Soria;201;Velilla de la Sierra;15;7;8
42;Soria;202;Velilla de los Ajos;70;39;31
42;Soria;204;Viana de Duero;111;58;53
42;Soria;205;Villaciervos;108;57;51
42;Soria;206;Villanueva de Gormaz;21;11;10
42;Soria;207;Villar del Ala;45;20;25
42;Soria;208;Villar del Campo;54;27;27
42;Soria;209;Villar del Río;215;107;108
42;Soria;211;Villares de Soria (Los);114;54;60
42;Soria;212;Villasayas;138;79;59
42;Soria;213;Villaseca de Arciel;59;32;27
42;Soria;215;Vinuesa;1182;618;564
42;Soria;216;Vizmanos;48;30;18
42;Soria;217;Vozmediano;64;32;32
42;Soria;218;Yanguas;94;47;47
42;Soria;219;Yelo;102;52;50
43;Tarragona;001;Aiguamúrcia;547;286;261
43;Tarragona;002;Albinyana;710;359;351
43;Tarragona;003;Albiol (L');110;58;52
43;Tarragona;004;Alcanar;8044;3934;4110
43;Tarragona;005;Alcover;3530;1770;1760
43;Tarragona;904;Aldea (L');3585;1921;1664
43;Tarragona;006;Aldover;844;406;438
43;Tarragona;007;Aleixar (L');623;313;310
43;Tarragona;008;Alfara de Carles;409;214;195
43;Tarragona;009;Alforja;1091;532;559
43;Tarragona;010;Alió;348;178;170
43;Tarragona;011;Almoster;406;203;203
43;Tarragona;012;Altafulla;1729;864;865
43;Tarragona;013;Ametlla de Mar (L');4336;2180;2156
43;Tarragona;906;Ampolla (L');"";"";""
43;Tarragona;014;Amposta;15682;7813;7869
43;Tarragona;016;Arboç (L');3735;1882;1853
43;Tarragona;015;Arbolí;150;78;72
43;Tarragona;017;Argentera (L');143;72;71
43;Tarragona;018;Arnes;546;278;268
43;Tarragona;019;Ascó;1781;901;880
43;Tarragona;020;Banyeres del Penedès;1583;831;752
43;Tarragona;021;Barberà de la Conca;439;223;216
43;Tarragona;022;Batea;2033;1035;998
43;Tarragona;023;Bellmunt del Priorat;327;154;173
43;Tarragona;024;Bellvei;946;492;454
43;Tarragona;025;Benifallet;995;496;499
43;Tarragona;026;Benissanet;1060;504;556
43;Tarragona;027;Bisbal de Falset (La);312;157;155
43;Tarragona;028;Bisbal del Penedès (La);1363;695;668
43;Tarragona;029;Blancafort;429;209;220
43;Tarragona;030;Bonastre;279;141;138
43;Tarragona;031;Borges del Camp (Les);1387;695;692
43;Tarragona;032;Bot;949;476;473
43;Tarragona;033;Botarell;465;231;234
43;Tarragona;034;Bràfim;574;273;301
43;Tarragona;035;Cabacés;349;178;171
43;Tarragona;036;Cabra del Camp;423;222;201
43;Tarragona;037;Calafell;7396;3711;3685
43;Tarragona;903;Camarles;2915;1458;1457
43;Tarragona;038;Cambrils;15232;7658;7574
43;Tarragona;039;Capafonts;104;52;52
43;Tarragona;040;Capçanes;430;199;231
43;Tarragona;041;Caseres;339;168;171
43;Tarragona;042;Castellvell del Camp;837;422;415
43;Tarragona;043;Catllar (El);1099;564;535
43;Tarragona;045;Colldejou;188;97;91
43;Tarragona;046;Conesa;128;58;70
43;Tarragona;047;Constantí;5657;2916;2741
43;Tarragona;048;Corbera d'Ebre;1134;590;544
43;Tarragona;049;Cornudella de Montsant;921;468;453
43;Tarragona;050;Creixell;898;450;448
43;Tarragona;051;Cunit;2374;1177;1197
43;Tarragona;901;Deltebre;10224;5143;5081
43;Tarragona;053;Duesaigües;208;114;94
43;Tarragona;054;Espluga de Francolí (L');3633;1770;1863
43;Tarragona;055;Falset;2592;1268;1324
43;Tarragona;056;Fatarella (La);1408;713;695
43;Tarragona;057;Febró (La);46;25;21
43;Tarragona;058;Figuera (La);138;67;71
43;Tarragona;059;Figuerola del Camp;232;114;118
43;Tarragona;060;Flix;4992;2506;2486
43;Tarragona;061;Forès;63;30;33
43;Tarragona;062;Freginals;387;189;198
43;Tarragona;063;Galera (La);790;383;407
43;Tarragona;064;Gandesa;2707;1358;1349
43;Tarragona;065;Garcia;580;281;299
43;Tarragona;066;Garidells (Els);185;92;93
43;Tarragona;067;Ginestar;898;456;442
43;Tarragona;068;Godall;771;375;396
43;Tarragona;069;Gratallops;252;122;130
43;Tarragona;070;Guiamets (Els);296;149;147
43;Tarragona;071;Horta de Sant Joan;1339;682;657
43;Tarragona;072;Lloar (El);160;81;79
43;Tarragona;073;Llorac;101;48;53
43;Tarragona;074;Llorenç del Penedès;1307;642;665
43;Tarragona;076;Marçà;609;285;324
43;Tarragona;075;Margalef;153;81;72
43;Tarragona;077;Mas de Barberans;753;371;382
43;Tarragona;078;Masdenverge;935;483;452
43;Tarragona;079;Masllorenç;379;190;189
43;Tarragona;080;Masó (La);274;132;142
43;Tarragona;081;Maspujols;384;194;190
43;Tarragona;082;Masroig (El);554;270;284
43;Tarragona;083;Milà (El);144;63;81
43;Tarragona;084;Miravet;828;431;397
43;Tarragona;085;Molar (El);339;170;169
43;Tarragona;086;Montblanc;5871;2904;2967
43;Tarragona;088;Montbrió del Camp;1428;703;725
43;Tarragona;089;Montferri;152;75;77
43;Tarragona;090;Montmell (El);258;131;127
43;Tarragona;091;Mont-ral;152;84;68
43;Tarragona;092;Mont-roig del Camp;5266;2660;2606
43;Tarragona;093;Móra d'Ebre;4337;2136;2201
43;Tarragona;094;Móra la Nova;2778;1394;1384
43;Tarragona;095;Morell (El);2274;1144;1130
43;Tarragona;096;Morera de Montsant (La);199;97;102
43;Tarragona;097;Nou de Gaià (La);373;201;172
43;Tarragona;098;Nulles;364;172;192
43;Tarragona;100;Pallaresos (Els);563;303;260
43;Tarragona;099;Palma d'Ebre (La);472;226;246
43;Tarragona;101;Passanant;206;113;93
43;Tarragona;102;Paüls;723;361;362
43;Tarragona;103;Perafort;518;271;247
43;Tarragona;104;Perelló (El);3738;1876;1862
43;Tarragona;105;Piles (Les);134;76;58
43;Tarragona;106;Pinell de Brai (El);1206;615;591
43;Tarragona;107;Pira;340;163;177
43;Tarragona;108;Pla de Santa Maria (El);1553;783;770
43;Tarragona;109;Pobla de Mafumet (La);854;419;435
43;Tarragona;110;Pobla de Massaluca (La);490;253;237
43;Tarragona;111;Pobla de Montornès (La);836;434;402
43;Tarragona;112;Poboleda;368;187;181
43;Tarragona;113;Pont d'Armentera (El);628;302;326
43;Tarragona;141;Pontils;127;62;65
43;Tarragona;114;Porrera;455;236;219
43;Tarragona;115;Pradell de la Teixeta;269;135;134
43;Tarragona;116;Prades;539;284;255
43;Tarragona;117;Prat de Comte;227;105;122
43;Tarragona;118;Pratdip;481;235;246
43;Tarragona;119;Puigpelat;441;224;217
43;Tarragona;120;Querol;217;109;108
43;Tarragona;121;Rasquera;896;460;436
43;Tarragona;122;Renau;55;30;25
43;Tarragona;123;Reus;86407;42453;43954
43;Tarragona;124;Riba (La);942;466;476
43;Tarragona;125;Riba-roja d'Ebre;1720;907;813
43;Tarragona;126;Riera de Gaià (La);940;445;495
43;Tarragona;127;Riudecanyes;591;296;295
43;Tarragona;128;Riudecols;950;491;459
43;Tarragona;129;Riudoms;4804;2383;2421
43;Tarragona;130;Rocafort de Queralt;271;144;127
43;Tarragona;131;Roda de Barà;2030;1044;986
43;Tarragona;132;Rodonyà;353;181;172
43;Tarragona;133;Roquetes;5866;2885;2981
43;Tarragona;134;Rourell (El);262;138;124
43;Tarragona;135;Salomó;455;231;224
43;Tarragona;905;Salou;"";"";""
43;Tarragona;136;Sant Carles de la Ràpita;10650;5357;5293
43;Tarragona;137;Sant Jaume dels Domenys;1198;622;576
43;Tarragona;902;Sant Jaume d'Enveja;3475;1767;1708
43;Tarragona;138;Santa Bàrbara;3359;1655;1704
43;Tarragona;139;Santa Coloma de Queralt;2587;1261;1326
43;Tarragona;140;Santa Oliva;1443;747;696
43;Tarragona;142;Sarral;1389;699;690
43;Tarragona;143;Savallà del Comtat;59;27;32
43;Tarragona;144;Secuita (La);1036;515;521
43;Tarragona;145;Selva del Camp (La);3445;1699;1746
43;Tarragona;146;Senan;28;20;8
43;Tarragona;044;Sénia (La);4818;2430;2388
43;Tarragona;147;Solivella;733;338;395
43;Tarragona;148;Tarragona;112360;55333;57027
43;Tarragona;149;Tivenys;1057;517;540
43;Tarragona;150;Tivissa;1845;905;940
43;Tarragona;151;Torre de Fontaubella (La);62;30;32
43;Tarragona;152;Torre de l'Espanyol (La);760;379;381
43;Tarragona;153;Torredembarra;6560;3260;3300
43;Tarragona;154;Torroja del Priorat;149;78;71
43;Tarragona;155;Tortosa;29790;14377;15413
43;Tarragona;156;Ulldecona;5242;2559;2683
43;Tarragona;157;Ulldemolins;547;291;256
43;Tarragona;158;Vallclara;95;46;49
43;Tarragona;159;Vallfogona de Riucorb;116;62;54
43;Tarragona;160;Vallmoll;1068;547;521
43;Tarragona;161;Valls;20283;9998;10285
43;Tarragona;162;Vandellòs i l'Hospitalet de l'Infant;4479;2272;2207
43;Tarragona;163;Vendrell (El);15161;7522;7639
43;Tarragona;164;Vespella de Gaià;93;45;48
43;Tarragona;165;Vilabella;830;395;435
43;Tarragona;175;Vilalba dels Arcs;806;421;385
43;Tarragona;166;Vilallonga del Camp;1171;576;595
43;Tarragona;168;Vilanova de Prades;154;75;79
43;Tarragona;167;Vilanova d'Escornalbou;445;222;223
43;Tarragona;169;Vilaplana;528;273;255
43;Tarragona;170;Vila-rodona;1024;532;492
43;Tarragona;171;Vila-seca;19729;9951;9778
43;Tarragona;172;Vilaverd;382;191;191
43;Tarragona;173;Vilella Alta (La);144;73;71
43;Tarragona;174;Vilella Baixa (La);174;90;84
43;Tarragona;176;Vimbodí;1132;576;556
43;Tarragona;177;Vinebre;450;215;235
43;Tarragona;178;Vinyols i els Arcs;831;447;384
43;Tarragona;052;Xerta;1249;604;645
44;Teruel;001;Ababuj;93;55;38
44;Teruel;002;Abejuela;83;43;40
44;Teruel;003;Aguatón;40;20;20
44;Teruel;004;Aguaviva;641;320;321
44;Teruel;005;Aguilar del Alfambra;108;53;55
44;Teruel;006;Alacón;509;264;245
44;Teruel;007;Alba;352;178;174
44;Teruel;008;Albalate del Arzobispo;2641;1279;1362
44;Teruel;009;Albarracín;1070;532;538
44;Teruel;010;Albentosa;309;155;154
44;Teruel;011;Alcaine;48;26;22
44;Teruel;012;Alcalá de la Selva;493;263;230
44;Teruel;013;Alcañiz;12509;6107;6402
44;Teruel;014;Alcorisa;3256;1638;1618
44;Teruel;016;Alfambra;827;417;410
44;Teruel;017;Aliaga;510;257;253
44;Teruel;021;Allepuz;190;102;88
44;Teruel;022;Alloza;955;462;493
44;Teruel;023;Allueva;10;6;4
44;Teruel;018;Almohaja;53;29;24
44;Teruel;019;Alobras;120;62;58
44;Teruel;020;Alpeñés;34;20;14
44;Teruel;024;Anadón;32;15;17
44;Teruel;025;Andorra;8876;4595;4281
44;Teruel;026;Arcos de las Salinas;187;102;85
44;Teruel;027;Arens de Lledó;277;127;150
44;Teruel;028;Argente;307;150;157
44;Teruel;029;Ariño;977;492;485
44;Teruel;031;Azaila;270;149;121
44;Teruel;032;Bádenas;34;17;17
44;Teruel;033;Báguena;663;321;342
44;Teruel;034;Bañón;240;126;114
44;Teruel;035;Barrachina;206;104;102
44;Teruel;036;Bea;28;18;10
44;Teruel;037;Beceite;707;371;336
44;Teruel;039;Bello;497;227;270
44;Teruel;038;Belmonte de San José;186;95;91
44;Teruel;040;Berge;283;144;139
44;Teruel;041;Bezas;77;40;37
44;Teruel;042;Blancas;265;130;135
44;Teruel;043;Blesa;175;92;83
44;Teruel;044;Bordón;153;82;71
44;Teruel;045;Bronchales;493;249;244
44;Teruel;046;Bueña;151;77;74
44;Teruel;047;Burbáguena;382;171;211
44;Teruel;048;Cabra de Mora;108;53;55
44;Teruel;049;Calaceite;1321;665;656
44;Teruel;050;Calamocha;4377;2183;2194
44;Teruel;051;Calanda;3583;1827;1756
44;Teruel;052;Calomarde;97;49;48
44;Teruel;053;Camañas;174;96;78
44;Teruel;054;Camarena de la Sierra;140;76;64
44;Teruel;055;Camarillas;144;80;64
44;Teruel;056;Caminreal;956;473;483
44;Teruel;059;Cantavieja;786;425;361
44;Teruel;060;Cañada de Benatanduz;79;47;32
44;Teruel;061;Cañada de Verich (La);113;62;51
44;Teruel;062;Cañada Vellida;76;46;30
44;Teruel;063;Cañizar del Olivar;161;82;79
44;Teruel;064;Cascante del Río;156;90;66
44;Teruel;065;Castejón de Tornos;128;62;66
44;Teruel;066;Castel de Cabra;265;135;130
44;Teruel;070;Castellar (El);106;58;48
44;Teruel;071;Castellote;952;474;478
44;Teruel;067;Castelnou;132;73;59
44;Teruel;068;Castelserás;964;508;456
44;Teruel;074;Cedrillas;577;302;275
44;Teruel;075;Celadas;506;261;245
44;Teruel;076;Cella;3117;1582;1535
44;Teruel;077;Cerollera (La);99;54;45
44;Teruel;080;Codoñera (La);380;193;187
44;Teruel;082;Corbalán;86;50;36
44;Teruel;084;Cortes de Aragón;142;71;71
44;Teruel;085;Cosa;142;77;65
44;Teruel;086;Cretas;776;380;396
44;Teruel;087;Crivillén;156;80;76
44;Teruel;088;Cuba (La);90;45;45
44;Teruel;089;Cubla;76;38;38
44;Teruel;090;Cucalón;119;62;57
44;Teruel;092;Cuervo (El);163;78;85
44;Teruel;093;Cuevas de Almudén;130;70;60
44;Teruel;094;Cuevas Labradas;224;115;109
44;Teruel;096;Ejulve;255;141;114
44;Teruel;097;Escorihuela;291;147;144
44;Teruel;099;Escucha;1295;706;589
44;Teruel;100;Estercuel;438;232;206
44;Teruel;101;Ferreruela de Huerva;116;58;58
44;Teruel;102;Fonfría;39;19;20
44;Teruel;103;Formiche Alto;228;118;110
44;Teruel;105;Fórnoles;132;60;72
44;Teruel;106;Fortanete;248;124;124
44;Teruel;107;Foz-Calanda;264;141;123
44;Teruel;108;Fresneda (La);512;260;252
44;Teruel;109;Frías de Albarracín;215;115;100
44;Teruel;110;Fuenferrada;56;28;28
44;Teruel;111;Fuentes Calientes;165;87;78
44;Teruel;112;Fuentes Claras;783;396;387
44;Teruel;113;Fuentes de Rubielos;91;49;42
44;Teruel;114;Fuentespalda;445;228;217
44;Teruel;115;Galve;164;88;76
44;Teruel;116;Gargallo;136;72;64
44;Teruel;117;Gea de Albarracín;510;257;253
44;Teruel;118;Ginebrosa (La);296;162;134
44;Teruel;119;Griegos;179;104;75
44;Teruel;120;Guadalaviar;313;158;155
44;Teruel;121;Gúdar;102;62;40
44;Teruel;122;Híjar;2114;1053;1061
44;Teruel;123;Hinojosa de Jarque;239;129;110
44;Teruel;124;Hoz de la Vieja (La);197;101;96
44;Teruel;125;Huesa del Común;194;96;98
44;Teruel;126;Iglesuela del Cid (La);536;279;257
44;Teruel;127;Jabaloyas;129;61;68
44;Teruel;128;Jarque de la Val;124;67;57
44;Teruel;129;Jatiel;80;37;43
44;Teruel;130;Jorcas;79;47;32
44;Teruel;131;Josa;55;27;28
44;Teruel;132;Lagueruela;93;50;43
44;Teruel;133;Lanzuela;49;28;21
44;Teruel;135;Libros;219;107;112
44;Teruel;136;Lidón;114;54;60
44;Teruel;137;Linares de Mora;364;204;160
44;Teruel;141;Lledó;255;127;128
44;Teruel;138;Loscos;258;135;123
44;Teruel;142;Maicas;21;8;13
44;Teruel;143;Manzanera;547;294;253
44;Teruel;144;Martín del Río;590;310;280
44;Teruel;145;Mas de las Matas;1529;769;760
44;Teruel;146;Mata de los Olmos (La);300;148;152
44;Teruel;147;Mazaleón;669;343;326
44;Teruel;148;Mezquita de Jarque;185;98;87
44;Teruel;149;Mirambel;163;83;80
44;Teruel;150;Miravete de la Sierra;61;33;28
44;Teruel;151;Molinos;412;200;212
44;Teruel;152;Monforte de Moyuela;125;67;58
44;Teruel;153;Monreal del Campo;2324;1161;1163
44;Teruel;154;Monroyo;401;200;201
44;Teruel;155;Montalbán;1958;994;964
44;Teruel;156;Monteagudo del Castillo;108;63;45
44;Teruel;157;Monterde de Albarracín;89;38;51
44;Teruel;158;Mora de Rubielos;1331;678;653
44;Teruel;159;Moscardón;74;36;38
44;Teruel;160;Mosqueruela;775;402;373
44;Teruel;161;Muniesa;908;460;448
44;Teruel;163;Noguera de Albarracín;184;93;91
44;Teruel;164;Nogueras;32;22;10
44;Teruel;165;Nogueruelas;250;125;125
44;Teruel;167;Obón;77;36;41
44;Teruel;168;Odón;320;155;165
44;Teruel;169;Ojos Negros;819;416;403
44;Teruel;171;Olba;244;125;119
44;Teruel;172;Oliete;604;305;299
44;Teruel;173;Olmos (Los);195;107;88
44;Teruel;174;Orihuela del Tremedal;706;337;369
44;Teruel;175;Orrios;231;121;110
44;Teruel;176;Palomar de Arroyos;331;179;152
44;Teruel;177;Pancrudo;257;145;112
44;Teruel;178;Parras de Castellote (Las);119;62;57
44;Teruel;179;Peñarroya de Tastavins;599;295;304
44;Teruel;180;Peracense;102;47;55
44;Teruel;181;Peralejos;122;59;63
44;Teruel;182;Perales del Alfambra;328;180;148
44;Teruel;183;Pitarque;132;67;65
44;Teruel;184;Plou;64;30;34
44;Teruel;185;Pobo (El);194;108;86
44;Teruel;187;Portellada (La);373;198;175
44;Teruel;189;Pozondón;104;53;51
44;Teruel;190;Pozuel del Campo;157;82;75
44;Teruel;191;Puebla de Híjar (La);1319;637;682
44;Teruel;192;Puebla de Valverde (La);512;269;243
44;Teruel;193;Puertomingalvo;171;86;85
44;Teruel;194;Ráfales;274;137;137
44;Teruel;195;Rillo;189;103;86
44;Teruel;196;Riodeva;292;148;144
44;Teruel;197;Ródenas;105;53;52
44;Teruel;198;Royuela;241;136;105
44;Teruel;199;Rubiales;66;34;32
44;Teruel;200;Rubielos de la Cérida;77;38;39
44;Teruel;201;Rubielos de Mora;629;315;314
44;Teruel;203;Salcedillo;9;4;5
44;Teruel;204;Saldón;55;34;21
44;Teruel;205;Samper de Calanda;1221;587;634
44;Teruel;206;San Agustín;215;111;104
44;Teruel;207;San Martín del Río;397;192;205
44;Teruel;208;Santa Cruz de Nogueras;34;19;15
44;Teruel;209;Santa Eulalia;1551;750;801
44;Teruel;210;Sarrión;1105;576;529
44;Teruel;211;Segura de los Baños;85;46;39
44;Teruel;212;Seno;64;32;32
44;Teruel;213;Singra;133;70;63
44;Teruel;215;Terriente;206;111;95
44;Teruel;216;Teruel;28488;13838;14650
44;Teruel;217;Toril y Masegoso;51;28;23
44;Teruel;218;Tormón;62;33;29
44;Teruel;219;Tornos;319;164;155
44;Teruel;220;Torralba de los Sisones;259;130;129
44;Teruel;223;Torre de Arcas;141;66;75
44;Teruel;224;Torre de las Arcas;51;28;23
44;Teruel;225;Torre del Compte;231;106;125
44;Teruel;227;Torre los Negros;114;55;59
44;Teruel;221;Torrecilla de Alcañiz;497;256;241
44;Teruel;222;Torrecilla del Rebollar;217;115;102
44;Teruel;226;Torrelacárcel;370;187;183
44;Teruel;228;Torremocha de Jiloca;216;102;114
44;Teruel;229;Torres de Albarracín;203;106;97
44;Teruel;230;Torrevelilla;238;118;120
44;Teruel;231;Torrijas;83;42;41
44;Teruel;232;Torrijo del Campo;686;343;343
44;Teruel;234;Tramacastiel;148;69;79
44;Teruel;235;Tramacastilla;148;72;76
44;Teruel;236;Tronchón;130;66;64
44;Teruel;237;Urrea de Gaén;724;347;377
44;Teruel;238;Utrillas;4023;2060;1963
44;Teruel;239;Valacloche;33;18;15
44;Teruel;240;Valbona;217;115;102
44;Teruel;241;Valdealgorfa;863;422;441
44;Teruel;243;Valdecuenca;41;23;18
44;Teruel;244;Valdelinares;138;73;65
44;Teruel;245;Valdeltormo;478;246;232
44;Teruel;246;Valderrobres;1867;926;941
44;Teruel;247;Valjunquera;501;251;250
44;Teruel;249;Vallecillo (El);20;9;11
44;Teruel;250;Veguillas de la Sierra;32;17;15
44;Teruel;251;Villafranca del Campo;460;240;220
44;Teruel;252;Villahermosa del Campo;100;53;47
44;Teruel;256;Villanueva del Rebollar de la Sierra;63;30;33
44;Teruel;257;Villar del Cobo;258;132;126
44;Teruel;258;Villar del Salz;152;79;73
44;Teruel;260;Villarluengo;233;116;117
44;Teruel;261;Villarquemado;1089;541;548
44;Teruel;262;Villarroya de los Pinares;222;113;109
44;Teruel;263;Villastar;389;198;191
44;Teruel;264;Villel;420;208;212
44;Teruel;265;Vinaceite;380;204;176
44;Teruel;266;Visiedo;293;155;138
44;Teruel;267;Vivel del Río Martín;159;83;76
44;Teruel;268;Zoma (La);37;20;17
45;Toledo;001;Ajofrín;2161;1111;1050
45;Toledo;002;Alameda de la Sagra;2680;1391;1289
45;Toledo;003;Albarreal de Tajo;574;287;287
45;Toledo;004;Alcabón;544;269;275
45;Toledo;005;Alcañizo;419;220;199
45;Toledo;006;Alcaudete de la Jara;1554;755;799
45;Toledo;007;Alcolea de Tajo;860;415;445
45;Toledo;008;Aldea en Cabo;219;109;110
45;Toledo;009;Aldeanueva de Barbarroya;982;487;495
45;Toledo;010;Aldeanueva de San Bartolomé;842;411;431
45;Toledo;011;Almendral de la Cañada;462;240;222
45;Toledo;012;Almonacid de Toledo;862;418;444
45;Toledo;013;Almorox;2200;1134;1066
45;Toledo;014;Añover de Tajo;4363;2222;2141
45;Toledo;015;Arcicóllar;455;232;223
45;Toledo;016;Argés;1705;866;839
45;Toledo;017;Azután;388;204;184
45;Toledo;018;Barcience;138;71;67
45;Toledo;019;Bargas;5949;3007;2942
45;Toledo;020;Belvís de la Jara;2051;1003;1048
45;Toledo;021;Borox;1952;961;991
45;Toledo;022;Buenaventura;539;276;263
45;Toledo;023;Burguillos de Toledo;682;350;332
45;Toledo;024;Burujón;1255;662;593
45;Toledo;025;Cabañas de la Sagra;896;457;439
45;Toledo;026;Cabañas de Yepes;265;136;129
45;Toledo;027;Cabezamesada;625;316;309
45;Toledo;028;Calera y Chozas;3743;1879;1864
45;Toledo;029;Caleruela;388;193;195
45;Toledo;030;Calzada de Oropesa;724;355;369
45;Toledo;031;Camarena;1923;983;940
45;Toledo;032;Camarenilla;561;280;281
45;Toledo;033;Campillo de la Jara (El);717;364;353
45;Toledo;034;Camuñas;1792;889;903
45;Toledo;035;Cardiel de los Montes;148;70;78
45;Toledo;036;Carmena;841;419;422
45;Toledo;037;Carpio de Tajo (El);2458;1176;1282
45;Toledo;038;Carranque;980;486;494
45;Toledo;039;Carriches;305;147;158
45;Toledo;040;Casar de Escalona (El);947;476;471
45;Toledo;041;Casarrubios del Monte;1808;918;890
45;Toledo;042;Casasbuenas;273;135;138
45;Toledo;043;Castillo de Bayuela;1083;551;532
45;Toledo;045;Cazalegas;1169;584;585
45;Toledo;046;Cebolla;2596;1297;1299
45;Toledo;047;Cedillo del Condado;1018;531;487
45;Toledo;048;Cerralbos (Los);509;251;258
45;Toledo;049;Cervera de los Montes;490;254;236
45;Toledo;056;Chozas de Canales;897;452;445
45;Toledo;057;Chueca;263;131;132
45;Toledo;050;Ciruelos;331;172;159
45;Toledo;051;Cobeja;1612;807;805
45;Toledo;052;Cobisa;262;134;128
45;Toledo;053;Consuegra;10048;4925;5123
45;Toledo;054;Corral de Almaguer;6132;3026;3106
45;Toledo;055;Cuerva;1283;627;656
45;Toledo;058;Domingo Pérez;586;292;294
45;Toledo;059;Dosbarrios;2062;1057;1005
45;Toledo;060;Erustes;208;105;103
45;Toledo;061;Escalona;1829;907;922
45;Toledo;062;Escalonilla;1500;733;767
45;Toledo;063;Espinoso del Rey;669;342;327
45;Toledo;064;Esquivias;3348;1694;1654
45;Toledo;065;Estrella (La);642;337;305
45;Toledo;066;Fuensalida;6637;3352;3285
45;Toledo;067;Gálvez;3227;1634;1593
45;Toledo;068;Garciotum;179;87;92
45;Toledo;069;Gerindote;1660;833;827
45;Toledo;070;Guadamur;1629;838;791
45;Toledo;071;Guardia (La);2572;1277;1295
45;Toledo;072;Herencias (Las);838;428;410
45;Toledo;073;Herreruela de Oropesa;492;252;240
45;Toledo;074;Hinojosa de San Vicente;550;302;248
45;Toledo;075;Hontanar;112;61;51
45;Toledo;076;Hormigos;400;208;192
45;Toledo;077;Huecas;371;193;178
45;Toledo;078;Huerta de Valdecarábanos;1730;844;886
45;Toledo;079;Iglesuela (La);529;269;260
45;Toledo;080;Illán de Vacas;11;7;4
45;Toledo;081;Illescas;7770;3907;3863
45;Toledo;082;Lagartera;2063;997;1066
45;Toledo;083;Layos;264;131;133
45;Toledo;084;Lillo;2993;1472;1521
45;Toledo;085;Lominchar;1011;525;486
45;Toledo;086;Lucillos;520;243;277
45;Toledo;087;Madridejos;10319;5031;5288
45;Toledo;088;Magán;789;392;397
45;Toledo;089;Malpica de Tajo;1825;924;901
45;Toledo;090;Manzaneque;500;242;258
45;Toledo;091;Maqueda;471;247;224
45;Toledo;092;Marjaliza;363;177;186
45;Toledo;093;Marrupe;147;74;73
45;Toledo;094;Mascaraque;533;248;285
45;Toledo;095;Mata (La);1080;530;550
45;Toledo;096;Mazarambroz;1230;604;626
45;Toledo;097;Mejorada;1189;614;575
45;Toledo;098;Menasalbas;3054;1570;1484
45;Toledo;099;Méntrida;1536;783;753
45;Toledo;100;Mesegar de Tajo;274;140;134
45;Toledo;101;Miguel Esteban;4710;2326;2384
45;Toledo;102;Mocejón;3846;1945;1901
45;Toledo;103;Mohedas de la Jara;805;404;401
45;Toledo;104;Montearagón;517;268;249
45;Toledo;105;Montesclaros;526;250;276
45;Toledo;106;Mora;9392;4552;4840
45;Toledo;107;Nambroca;1838;911;927
45;Toledo;108;Nava de Ricomalillo (La);812;422;390
45;Toledo;109;Navahermosa;3781;1945;1836
45;Toledo;110;Navalcán;2640;1350;1290
45;Toledo;111;Navalmoralejo;140;66;74
45;Toledo;112;Navalmorales (Los);2826;1395;1431
45;Toledo;113;Navalucillos (Los);3235;1627;1608
45;Toledo;114;Navamorcuende;837;442;395
45;Toledo;115;Noblejas;2894;1469;1425
45;Toledo;116;Noez;955;482;473
45;Toledo;117;Nombela;916;474;442
45;Toledo;118;Novés;1507;763;744
45;Toledo;119;Numancia de la Sagra;1016;520;496
45;Toledo;120;Nuño Gómez;183;84;99
45;Toledo;121;Ocaña;5640;2779;2861
45;Toledo;122;Olías del Rey;3095;1571;1524
45;Toledo;123;Ontígola;693;346;347
45;Toledo;124;Orgaz;2739;1387;1352
45;Toledo;125;Oropesa;3177;1589;1588
45;Toledo;126;Otero;220;97;123
45;Toledo;127;Palomeque;383;200;183
45;Toledo;128;Pantoja;2030;1049;981
45;Toledo;129;Paredes de Escalona;94;43;51
45;Toledo;130;Parrillas;580;290;290
45;Toledo;131;Pelahustán;445;225;220
45;Toledo;132;Pepino;657;342;315
45;Toledo;133;Polán;3052;1532;1520
45;Toledo;134;Portillo de Toledo;1899;967;932
45;Toledo;135;Puebla de Almoradiel (La);5469;2727;2742
45;Toledo;136;Puebla de Montalbán (La);6390;3195;3195
45;Toledo;137;Pueblanueva (La);2015;1023;992
45;Toledo;138;Puente del Arzobispo (El);1668;803;865
45;Toledo;139;Puerto de San Vicente;373;183;190
45;Toledo;140;Pulgar;1203;591;612
45;Toledo;141;Quero;1537;768;769
45;Toledo;142;Quintanar de la Orden;9054;4500;4554
45;Toledo;143;Quismondo;1332;660;672
45;Toledo;144;Real de San Vicente (El);984;511;473
45;Toledo;145;Recas;2162;1125;1037
45;Toledo;146;Retamoso;202;111;91
45;Toledo;147;Rielves;426;220;206
45;Toledo;148;Robledo del Mazo;659;335;324
45;Toledo;149;Romeral (El);1077;522;555
45;Toledo;150;San Bartolomé de las Abiertas;545;270;275
45;Toledo;151;San Martín de Montalbán;807;404;403
45;Toledo;152;San Martín de Pusa;804;422;382
45;Toledo;153;San Pablo de los Montes;2055;1040;1015
45;Toledo;154;San Román de los Montes;425;211;214
45;Toledo;155;Santa Ana de Pusa;443;229;214
45;Toledo;156;Santa Cruz de la Zarza;4328;2169;2159
45;Toledo;157;Santa Cruz del Retamar;1481;738;743
45;Toledo;158;Santa Olalla;2290;1148;1142
45;Toledo;901;Santo Domingo-Caudilla;857;414;443
45;Toledo;159;Sartajada;146;81;65
45;Toledo;160;Segurilla;1008;491;517
45;Toledo;161;Seseña;2674;1366;1308
45;Toledo;162;Sevilleja de la Jara;1305;669;636
45;Toledo;163;Sonseca;8549;4255;4294
45;Toledo;164;Sotillo de las Palomas;217;110;107
45;Toledo;165;Talavera de la Reina;69215;34023;35192
45;Toledo;166;Tembleque;2220;1101;1119
45;Toledo;167;Toboso (El);2298;1121;1177
45;Toledo;168;Toledo;60671;29523;31148
45;Toledo;169;Torralba de Oropesa;348;158;190
45;Toledo;171;Torre de Esteban Hambrán (La);1288;668;620
45;Toledo;170;Torrecilla de la Jara;348;182;166
45;Toledo;172;Torrico;1025;527;498
45;Toledo;173;Torrijos;9128;4499;4629
45;Toledo;174;Totanés;378;187;191
45;Toledo;175;Turleque;1181;583;598
45;Toledo;176;Ugena;388;202;186
45;Toledo;177;Urda;3216;1589;1627
45;Toledo;179;Valdeverdeja;1013;472;541
45;Toledo;180;Valmojado;2242;1146;1096
45;Toledo;181;Velada;2328;1191;1137
45;Toledo;182;Ventas con Peña Aguilera (Las);1478;746;732
45;Toledo;183;Ventas de Retamosa (Las);542;277;265
45;Toledo;184;Ventas de San Julián (Las);224;108;116
45;Toledo;186;Villa de Don Fadrique (La);4211;2046;2165
45;Toledo;185;Villacañas;8794;4374;4420
45;Toledo;187;Villafranca de los Caballeros;5508;2690;2818
45;Toledo;188;Villaluenga de la Sagra;2531;1267;1264
45;Toledo;189;Villamiel de Toledo;283;140;143
45;Toledo;190;Villaminaya;727;364;363
45;Toledo;191;Villamuelas;768;389;379
45;Toledo;192;Villanueva de Alcardete;3261;1634;1627
45;Toledo;193;Villanueva de Bogas;882;449;433
45;Toledo;194;Villarejo de Montalbán;111;52;59
45;Toledo;195;Villarrubia de Santiago;3044;1507;1537
45;Toledo;196;Villaseca de la Sagra;1613;808;805
45;Toledo;197;Villasequilla;2362;1210;1152
45;Toledo;198;Villatobas;2482;1240;1242
45;Toledo;199;Viso de San Juan (El);492;253;239
45;Toledo;200;Yébenes (Los);6496;3278;3218
45;Toledo;201;Yeles;981;494;487
45;Toledo;202;Yepes;4364;2183;2181
45;Toledo;203;Yuncler;1791;906;885
45;Toledo;204;Yunclillos;576;293;283
45;Toledo;205;Yuncos;2719;1397;1322
46;Valencia/València;001;Ademuz;1393;696;697
46;Valencia/València;002;Ador;1150;576;574
46;Valencia/València;004;Agullent;2084;1004;1080
46;Valencia/València;042;Aielo de Malferit;3855;1893;1962
46;Valencia/València;043;Aielo de Rugat;213;108;105
46;Valencia/València;005;Alaquàs;24603;12210;12393
46;Valencia/València;006;Albaida;5964;2936;3028
46;Valencia/València;007;Albal;9083;4594;4489
46;Valencia/València;008;Albalat de la Ribera;3596;1765;1831
46;Valencia/València;009;Albalat dels Sorells;3607;1773;1834
46;Valencia/València;010;Albalat dels Tarongers;584;289;295
46;Valencia/València;011;Alberic;9172;4524;4648
46;Valencia/València;012;Alborache;891;438;453
46;Valencia/València;013;Alboraya;11885;5835;6050
46;Valencia/València;014;Albuixech;2967;1469;1498
46;Valencia/València;016;Alcàntera de Xúquer;1531;758;773
46;Valencia/València;015;Alcàsser;7281;3655;3626
46;Valencia/València;018;Alcublas;914;467;447
46;Valencia/València;020;Alcúdia de Crespins (L');4303;2132;2171
46;Valencia/València;019;Alcúdia (L');10313;5070;5243
46;Valencia/València;021;Aldaia;22427;11205;11222
46;Valencia/València;022;Alfafar;19896;9776;10120
46;Valencia/València;024;Alfara de Algimia;548;266;282
46;Valencia/València;025;Alfara del Patriarca;2844;1421;1423
46;Valencia/València;026;Alfarp;1321;641;680
46;Valencia/València;027;Alfarrasí;1300;648;652
46;Valencia/València;023;Alfauir;296;146;150
46;Valencia/València;028;Algar de Palancia;395;186;209
46;Valencia/València;029;Algemesí;25240;12398;12842
46;Valencia/València;030;Algimia de Alfara;861;429;432
46;Valencia/València;031;Alginet;12184;6065;6119
46;Valencia/València;032;Almàssera;5595;2703;2892
46;Valencia/València;033;Almiserà;210;103;107
46;Valencia/València;034;Almoines;1941;968;973
46;Valencia/València;035;Almussafes;6249;3114;3135
46;Valencia/València;036;Alpuente;1208;638;570
46;Valencia/València;037;Alquería de la Condesa/Alqueria de la Comtessa (l');1605;768;837
46;Valencia/València;017;Alzira;40657;19803;20854
46;Valencia/València;038;Andilla;174;92;82
46;Valencia/València;039;Anna;2647;1321;1326
46;Valencia/València;040;Antella;1672;833;839
46;Valencia/València;041;Aras de los Olmos;494;266;228
46;Valencia/València;003;Atzeneta d'Albaida;1265;648;617
46;Valencia/València;044;Ayora;5674;2959;2715
46;Valencia/València;046;Barx;972;479;493
46;Valencia/València;045;Barxeta;1636;822;814
46;Valencia/València;047;Bèlgida;690;334;356
46;Valencia/València;048;Bellreguard;3869;1907;1962
46;Valencia/València;049;Bellús;415;208;207
46;Valencia/València;050;Benagéber;154;81;73
46;Valencia/València;051;Benaguasil;9194;4626;4568
46;Valencia/València;052;Benavites;664;320;344
46;Valencia/València;053;Beneixida;576;271;305
46;Valencia/València;054;Benetússer;14067;6960;7107
46;Valencia/València;055;Beniarjó;1269;630;639
46;Valencia/València;056;Beniatjar;253;127;126
46;Valencia/València;057;Benicolet;497;255;242
46;Valencia/València;060;Benifaió;12263;6060;6203
46;Valencia/València;059;Benifairó de la Valldigna;1645;812;833
46;Valencia/València;058;Benifairó de les Valls;1978;998;980
46;Valencia/València;061;Beniflá;172;77;95
46;Valencia/València;062;Benigánim;5406;2736;2670
46;Valencia/València;063;Benimodo;1692;869;823
46;Valencia/València;064;Benimuslem;568;271;297
46;Valencia/València;065;Beniparrell;1455;717;738
46;Valencia/València;066;Benirredrà;944;444;500
46;Valencia/València;067;Benisanó;1739;872;867
46;Valencia/València;068;Benissoda;304;169;135
46;Valencia/València;069;Benisuera;221;103;118
46;Valencia/València;070;Bétera;9441;4684;4757
46;Valencia/València;071;Bicorp;743;374;369
46;Valencia/València;072;Bocairent;4772;2318;2454
46;Valencia/València;073;Bolbaite;1420;723;697
46;Valencia/València;074;Bonrepòs i Mirambell;2294;1124;1170
46;Valencia/València;075;Bufali;220;113;107
46;Valencia/València;076;Bugarra;884;443;441
46;Valencia/València;077;Buñol;9421;4685;4736
46;Valencia/València;078;Burjassot;35182;17192;17990
46;Valencia/València;079;Calles;463;241;222
46;Valencia/València;080;Camporrobles;1552;762;790
46;Valencia/València;081;Canals;12359;6101;6258
46;Valencia/València;082;Canet d'En Berenguer;1519;744;775
46;Valencia/València;083;Carcaixent;20820;10119;10701
46;Valencia/València;084;Càrcer;2058;1007;1051
46;Valencia/València;085;Carlet;14276;7023;7253
46;Valencia/València;086;Carrícola;71;31;40
46;Valencia/València;087;Casas Altas;193;92;101
46;Valencia/València;088;Casas Bajas;384;189;195
46;Valencia/València;089;Casinos;2263;1157;1106
46;Valencia/València;090;Castelló de Rugat;2126;1102;1024
46;Valencia/València;091;Castellonet de la Conquesta;90;46;44
46;Valencia/València;092;Castielfabib;741;389;352
46;Valencia/València;093;Catadau;2230;1130;1100
46;Valencia/València;094;Catarroja;21036;10359;10677
46;Valencia/València;095;Caudete de las Fuentes;997;509;488
46;Valencia/València;096;Cerdà;273;137;136
46;Valencia/València;107;Chella;2590;1284;1306
46;Valencia/València;106;Chelva;2245;1146;1099
46;Valencia/València;108;Chera;630;327;303
46;Valencia/València;109;Cheste;6945;3477;3468
46;Valencia/València;111;Chiva;7424;3716;3708
46;Valencia/València;112;Chulilla;702;347;355
46;Valencia/València;097;Cofrentes;932;480;452
46;Valencia/València;098;Corbera;3255;1589;1666
46;Valencia/València;099;Cortes de Pallás;779;426;353
46;Valencia/València;100;Cotes;390;183;207
46;Valencia/València;105;Cullera;20927;10293;10634
46;Valencia/València;113;Daimús;1218;605;613
46;Valencia/València;114;Domeño;384;198;186
46;Valencia/València;115;Dos Aguas;460;253;207
46;Valencia/València;116;Eliana (L');7805;3873;3932
46;Valencia/València;117;Emperador;182;89;93
46;Valencia/València;118;Enguera;5195;2570;2625
46;Valencia/València;119;Ènova (L');1189;588;601
46;Valencia/València;120;Estivella;1104;513;591
46;Valencia/València;121;Estubeny;161;76;85
46;Valencia/València;122;Faura;2789;1399;1390
46;Valencia/València;123;Favara;1759;862;897
46;Valencia/València;126;Foios;5448;2640;2808
46;Valencia/València;128;Font de la Figuera (La);2234;1101;1133
46;Valencia/València;127;Font d'En Carròs (La);3333;1669;1664
46;Valencia/València;124;Fontanars dels Alforins;988;524;464
46;Valencia/València;125;Fortaleny;1029;514;515
46;Valencia/València;129;Fuenterrobles;798;410;388
46;Valencia/València;131;Gandia;54778;26881;27897
46;Valencia/València;130;Gavarda;1270;628;642
46;Valencia/València;132;Genovés;2211;1102;1109
46;Valencia/València;133;Gestalgar;627;304;323
46;Valencia/València;134;Gilet;1196;585;611
46;Valencia/València;135;Godella;9437;4647;4790
46;Valencia/València;136;Godelleta;1975;971;1004
46;Valencia/València;137;Granja de la Costera (La);385;189;196
46;Valencia/València;138;Guadasequies;388;197;191
46;Valencia/València;139;Guadassuar;5516;2782;2734
46;Valencia/València;140;Guardamar de la Safor;63;34;29
46;Valencia/València;141;Higueruelas;595;313;282
46;Valencia/València;142;Jalance;1304;661;643
46;Valencia/València;144;Jarafuel;1141;593;548
46;Valencia/València;154;Llanera de Ranes;970;485;485
46;Valencia/València;155;Llaurí;1512;742;770
46;Valencia/València;147;Llíria;13834;6801;7033
46;Valencia/València;153;Llocnou de Sant Jeroni;583;275;308
46;Valencia/València;151;Llocnou d'En Fenollet;651;313;338
46;Valencia/València;156;Llombai;2224;1103;1121
46;Valencia/València;157;Llosa de Ranes (La);3607;1834;1773
46;Valencia/València;150;Llutxent;2435;1253;1182
46;Valencia/València;148;Loriguilla;1168;599;569
46;Valencia/València;149;Losa del Obispo;495;234;261
46;Valencia/València;152;Lugar Nuevo de la Corona;122;63;59
46;Valencia/València;158;Macastre;825;401;424
46;Valencia/València;159;Manises;25752;12658;13094
46;Valencia/València;160;Manuel;2486;1204;1282
46;Valencia/València;161;Marines;1203;602;601
46;Valencia/València;162;Masalavés;1539;783;756
46;Valencia/València;163;Massalfassar;1478;724;754
46;Valencia/València;164;Massamagrell;12274;6110;6164
46;Valencia/València;165;Massanassa;8070;3994;4076
46;Valencia/València;166;Meliana;9174;4523;4651
46;Valencia/València;167;Millares;785;398;387
46;Valencia/València;168;Miramar;965;481;484
46;Valencia/València;169;Mislata;38106;18768;19338
46;Valencia/València;170;Mogente/Moixent;4157;2138;2019
46;Valencia/València;171;Moncada;18376;9141;9235
46;Valencia/València;172;Monserrat;2523;1283;1240
46;Valencia/València;173;Montaverner;1698;861;837
46;Valencia/València;174;Montesa;1248;629;619
46;Valencia/València;175;Montichelvo;663;335;328
46;Valencia/València;176;Montroy;1494;759;735
46;Valencia/València;177;Museros;4117;2043;2074
46;Valencia/València;178;Náquera;1738;859;879
46;Valencia/València;179;Navarrés;2840;1419;1421
46;Valencia/València;180;Novelé/Novetlè;585;292;293
46;Valencia/València;181;Oliva;20660;10221;10439
46;Valencia/València;183;Olleria (L');6852;3475;3377
46;Valencia/València;182;Olocau;619;317;302
46;Valencia/València;184;Ontinyent;30268;14938;15330
46;Valencia/València;185;Otos;562;278;284
46;Valencia/València;186;Paiporta;15598;7728;7870
46;Valencia/València;187;Palma de Gandía;1497;743;754
46;Valencia/València;188;Palmera;482;233;249
46;Valencia/València;189;Palomar (El);503;241;262
46;Valencia/València;190;Paterna;48548;24144;24404
46;Valencia/València;191;Pedralba;2101;1069;1032
46;Valencia/València;192;Petrés;666;319;347
46;Valencia/València;193;Picanya;7722;3891;3831
46;Valencia/València;194;Picassent;14737;7398;7339
46;Valencia/València;195;Piles;2054;986;1068
46;Valencia/València;196;Pinet;268;152;116
46;Valencia/València;199;Pobla de Farnals (La);4865;2409;2456
46;Valencia/València;202;Pobla de Vallbona (La);7947;4125;3822
46;Valencia/València;200;Pobla del Duc (La);2642;1304;1338
46;Valencia/València;203;Pobla Llarga (La);4537;2208;2329
46;Valencia/València;197;Polinyà de Xúquer;3104;1540;1564
46;Valencia/València;198;Potríes;968;469;499
46;Valencia/València;205;Puçol;12551;6162;6389
46;Valencia/València;201;Puebla de San Miguel;45;22;23
46;Valencia/València;204;Puig;6474;3224;3250
46;Valencia/València;101;Quart de les Valls;1094;515;579
46;Valencia/València;102;Quart de Poblet;27669;13714;13955
46;Valencia/València;103;Quartell;1348;669;679
46;Valencia/València;104;Quatretonda;2637;1344;1293
46;Valencia/València;206;Quesa;852;426;426
46;Valencia/València;207;Rafelbuñol/Rafelbunyol;4918;2454;2464
46;Valencia/València;208;Rafelcofer;1434;680;754
46;Valencia/València;209;Rafelguaraf;2432;1202;1230
46;Valencia/València;210;Ráfol de Salem;394;181;213
46;Valencia/València;211;Real de Gandía;1956;900;1056
46;Valencia/València;212;Real de Montroi;1848;946;902
46;Valencia/València;213;Requena;18562;9289;9273
46;Valencia/València;214;Riba-roja de Túria;9826;4873;4953
46;Valencia/València;215;Riola;1691;858;833
46;Valencia/València;216;Rocafort;3703;1826;1877
46;Valencia/València;217;Rotglá y Corberá;1054;520;534
46;Valencia/València;218;Rótova;1379;696;683
46;Valencia/València;219;Rugat;198;96;102
46;Valencia/València;220;Sagunto/Sagunt;58135;28450;29685
46;Valencia/València;221;Salem;504;252;252
46;Valencia/València;222;San Juan de Énova;382;183;199
46;Valencia/València;223;Sedaví;8556;4229;4327
46;Valencia/València;224;Segart;160;71;89
46;Valencia/València;225;Sellent;510;264;246
46;Valencia/València;226;Sempere;50;23;27
46;Valencia/València;227;Senyera;831;400;431
46;Valencia/València;228;Serra;1408;697;711
46;Valencia/València;229;Siete Aguas;1211;584;627
46;Valencia/València;230;Silla;16267;8271;7996
46;Valencia/València;231;Simat de la Valldigna;3223;1638;1585
46;Valencia/València;232;Sinarcas;1380;716;664
46;Valencia/València;233;Sollana;4429;2219;2210
46;Valencia/València;234;Sot de Chera;327;172;155
46;Valencia/València;235;Sueca;24868;12219;12649
46;Valencia/València;236;Sumacàrcer;1419;722;697
46;Valencia/València;237;Tavernes Blanques;8502;4182;4320
46;Valencia/València;238;Tavernes de la Valldigna;16418;8161;8257
46;Valencia/València;239;Teresa de Cofrentes;787;412;375
46;Valencia/València;240;Terrateig;229;117;112
46;Valencia/València;241;Titaguas;622;331;291
46;Valencia/València;242;Torrebaja;464;237;227
46;Valencia/València;243;Torrella;167;82;85
46;Valencia/València;244;Torrent;57137;28420;28717
46;Valencia/València;245;Torres Torres;410;195;215
46;Valencia/València;246;Tous;1239;612;627
46;Valencia/València;247;Tuéjar;1463;770;693
46;Valencia/València;248;Turís;4150;2138;2012
46;Valencia/València;249;Utiel;12316;6227;6089
46;Valencia/València;250;Valencia;758738;362247;396491
46;Valencia/València;251;Vallada;2943;1474;1469
46;Valencia/València;252;Vallanca;281;131;150
46;Valencia/València;253;Vallés;117;65;52
46;Valencia/València;254;Venta del Moro;1952;991;961
46;Valencia/València;256;Vilamarxant;4977;2543;2434
46;Valencia/València;255;Villalonga;3655;1832;1823
46;Valencia/València;257;Villanueva de Castellón;7062;3438;3624
46;Valencia/València;258;Villar del Arzobispo;3433;1710;1723
46;Valencia/València;259;Villargordo del Cabriel;852;437;415
46;Valencia/València;260;Vinalesa;2343;1105;1238
46;Valencia/València;145;Xàtiva;25577;12475;13102
46;Valencia/València;143;Xeraco;4622;2306;2316
46;Valencia/València;146;Xeresa;2018;1014;1004
46;Valencia/València;110;Xirivella;25877;12899;12978
46;Valencia/València;261;Yátova;2102;1094;1008
46;Valencia/València;262;Yesa (La);323;164;159
46;Valencia/València;263;Zarra;516;261;255
47;Valladolid;001;Adalia;94;51;43
47;Valladolid;002;Aguasal;31;18;13
47;Valladolid;003;Aguilar de Campos;448;232;216
47;Valladolid;004;Alaejos;1987;1014;973
47;Valladolid;005;Alcazarén;792;423;369
47;Valladolid;006;Aldea de San Miguel;252;125;127
47;Valladolid;007;Aldeamayor de San Martín;1053;525;528
47;Valladolid;008;Almenara de Adaja;49;25;24
47;Valladolid;009;Amusquillo;218;119;99
47;Valladolid;010;Arroyo de la Encomienda;1369;696;673
47;Valladolid;011;Ataquines;1014;520;494
47;Valladolid;012;Bahabón;277;140;137
47;Valladolid;013;Barcial de la Loma;200;101;99
47;Valladolid;014;Barruelo del Valle;89;43;46
47;Valladolid;015;Becilla de Valderaduey;521;257;264
47;Valladolid;016;Benafarces;111;53;58
47;Valladolid;017;Bercero;312;161;151
47;Valladolid;018;Berceruelo;37;20;17
47;Valladolid;019;Berrueces;144;78;66
47;Valladolid;020;Bobadilla del Campo;480;250;230
47;Valladolid;021;Bocigas;127;68;59
47;Valladolid;022;Bocos de Duero;97;42;55
47;Valladolid;023;Boecillo;870;437;433
47;Valladolid;024;Bolaños de Campos;442;223;219
47;Valladolid;025;Brahojos de Medina;225;133;92
47;Valladolid;026;Bustillo de Chaves;130;62;68
47;Valladolid;027;Cabezón de Pisuerga;1537;780;757
47;Valladolid;028;Cabezón de Valderaduey;62;31;31
47;Valladolid;029;Cabreros del Monte;136;67;69
47;Valladolid;030;Campaspero;1802;923;879
47;Valladolid;031;Campillo (El);259;143;116
47;Valladolid;032;Camporredondo;246;132;114
47;Valladolid;033;Canalejas de Peñafiel;375;196;179
47;Valladolid;034;Canillas de Esgueva;167;88;79
47;Valladolid;035;Carpio;1345;710;635
47;Valladolid;036;Casasola de Arión;441;232;209
47;Valladolid;037;Castrejón de Trabancos;305;168;137
47;Valladolid;038;Castrillo de Duero;277;139;138
47;Valladolid;039;Castrillo-Tejeriego;339;178;161
47;Valladolid;040;Castrobol;128;55;73
47;Valladolid;041;Castrodeza;272;141;131
47;Valladolid;042;Castromembibre;110;54;56
47;Valladolid;043;Castromonte;548;283;265
47;Valladolid;044;Castronuevo de Esgueva;290;154;136
47;Valladolid;045;Castronuño;1287;665;622
47;Valladolid;046;Castroponce;242;118;124
47;Valladolid;047;Castroverde de Cerrato;347;187;160
47;Valladolid;048;Ceinos de Campos;300;163;137
47;Valladolid;049;Cervillego de la Cruz;217;103;114
47;Valladolid;050;Cigales;1685;806;879
47;Valladolid;051;Ciguñuela;366;185;181
47;Valladolid;052;Cistérniga;1445;731;714
47;Valladolid;053;Cogeces de Íscar;164;84;80
47;Valladolid;054;Cogeces del Monte;1066;562;504
47;Valladolid;055;Corcos;261;136;125
47;Valladolid;056;Corrales de Duero;177;99;78
47;Valladolid;057;Cubillas de Santa Marta;314;155;159
47;Valladolid;058;Cuenca de Campos;353;176;177
47;Valladolid;059;Curiel de Duero;193;106;87
47;Valladolid;060;Encinas de Esgueva;457;238;219
47;Valladolid;061;Esguevillas de Esgueva;499;259;240
47;Valladolid;062;Fombellida;348;185;163
47;Valladolid;063;Fompedraza;159;90;69
47;Valladolid;064;Fontihoyuelo;55;29;26
47;Valladolid;065;Fresno el Viejo;1474;739;735
47;Valladolid;066;Fuensaldaña;658;341;317
47;Valladolid;067;Fuente el Sol;385;201;184
47;Valladolid;068;Fuente-Olmedo;89;41;48
47;Valladolid;069;Gallegos de Hornija;159;80;79
47;Valladolid;070;Gatón de Campos;73;39;34
47;Valladolid;071;Geria;423;234;189
47;Valladolid;073;Herrín de Campos;243;121;122
47;Valladolid;074;Hornillos de Eresma;171;89;82
47;Valladolid;075;Íscar;5943;3005;2938
47;Valladolid;076;Laguna de Duero;11063;5571;5492
47;Valladolid;077;Langayo;563;288;275
47;Valladolid;079;Llano de Olmedo;111;54;57
47;Valladolid;078;Lomoviejo;311;157;154
47;Valladolid;080;Manzanillo;63;34;29
47;Valladolid;081;Marzales;89;45;44
47;Valladolid;082;Matapozuelos;952;487;465
47;Valladolid;083;Matilla de los Caños;92;49;43
47;Valladolid;084;Mayorga;1691;786;905
47;Valladolid;086;Medina de Rioseco;5058;2486;2572
47;Valladolid;085;Medina del Campo;19965;9842;10123
47;Valladolid;087;Megeces;508;250;258
47;Valladolid;088;Melgar de Abajo;268;119;149
47;Valladolid;089;Melgar de Arriba;350;173;177
47;Valladolid;090;Mojados;2151;1098;1053
47;Valladolid;091;Monasterio de Vega;125;57;68
47;Valladolid;092;Montealegre de Campos;183;97;86
47;Valladolid;093;Montemayor de Pililla;1193;627;566
47;Valladolid;094;Moral de la Reina;287;154;133
47;Valladolid;095;Moraleja de las Panaderas;30;18;12
47;Valladolid;096;Morales de Campos;237;120;117
47;Valladolid;097;Mota del Marqués;513;249;264
47;Valladolid;098;Mucientes;657;326;331
47;Valladolid;099;Mudarra (La);315;167;148
47;Valladolid;100;Muriel;300;144;156
47;Valladolid;101;Nava del Rey;2453;1187;1266
47;Valladolid;102;Nueva Villa de las Torres;462;242;220
47;Valladolid;103;Olivares de Duero;359;193;166
47;Valladolid;104;Olmedo;3711;1824;1887
47;Valladolid;105;Olmos de Esgueva;204;107;97
47;Valladolid;106;Olmos de Peñafiel;110;61;49
47;Valladolid;109;Palazuelo de Vedija;300;151;149
47;Valladolid;110;Parrilla (La);651;320;331
47;Valladolid;111;Pedraja de Portillo (La);1036;505;531
47;Valladolid;112;Pedrajas de San Esteban;3187;1611;1576
47;Valladolid;113;Pedrosa del Rey;297;145;152
47;Valladolid;114;Peñafiel;5233;2649;2584
47;Valladolid;115;Peñaflor de Hornija;522;276;246
47;Valladolid;116;Pesquera de Duero;630;330;300
47;Valladolid;117;Piña de Esgueva;461;241;220
47;Valladolid;118;Piñel de Abajo;299;163;136
47;Valladolid;119;Piñel de Arriba;192;97;95
47;Valladolid;121;Pollos;933;489;444
47;Valladolid;122;Portillo;2624;1330;1294
47;Valladolid;123;Pozal de Gallinas;519;264;255
47;Valladolid;124;Pozaldez;608;293;315
47;Valladolid;125;Pozuelo de la Orden;115;58;57
47;Valladolid;126;Puras;72;37;35
47;Valladolid;127;Quintanilla de Arriba;272;146;126
47;Valladolid;129;Quintanilla de Onésimo;1181;639;542
47;Valladolid;130;Quintanilla de Trigueros;110;57;53
47;Valladolid;128;Quintanilla del Molar;97;46;51
47;Valladolid;131;Rábano;296;159;137
47;Valladolid;132;Ramiro;121;62;59
47;Valladolid;133;Renedo de Esgueva;817;434;383
47;Valladolid;134;Roales de Campos;326;173;153
47;Valladolid;135;Robladillo;108;56;52
47;Valladolid;137;Roturas;46;27;19
47;Valladolid;138;Rubí de Bracamonte;393;209;184
47;Valladolid;139;Rueda;1668;850;818
47;Valladolid;140;Saelices de Mayorga;275;138;137
47;Valladolid;141;Salvador de Zapardiel;240;124;116
47;Valladolid;142;San Cebrián de Mazote;292;154;138
47;Valladolid;143;San Llorente;244;125;119
47;Valladolid;144;San Martín de Valvení;124;71;53
47;Valladolid;145;San Miguel del Arroyo;949;496;453
47;Valladolid;146;San Miguel del Pino;251;131;120
47;Valladolid;147;San Pablo de la Moraleja;207;110;97
47;Valladolid;148;San Pedro de Latarce;750;410;340
47;Valladolid;149;San Pelayo;49;21;28
47;Valladolid;150;San Román de Hornija;558;283;275
47;Valladolid;151;San Salvador;53;28;25
47;Valladolid;156;San Vicente del Palacio;320;164;156
47;Valladolid;152;Santa Eufemia del Arroyo;155;79;76
47;Valladolid;153;Santervás de Campos;212;114;98
47;Valladolid;154;Santibáñez de Valcorba;217;111;106
47;Valladolid;155;Santovenia de Pisuerga;1062;550;512
47;Valladolid;157;Sardón de Duero;639;323;316
47;Valladolid;158;Seca (La);1062;562;500
47;Valladolid;159;Serrada;1048;550;498
47;Valladolid;160;Siete Iglesias de Trabancos;735;371;364
47;Valladolid;161;Simancas;1885;970;915
47;Valladolid;162;Tamariz de Campos;107;53;54
47;Valladolid;163;Tiedra;473;232;241
47;Valladolid;164;Tordehumos;623;319;304
47;Valladolid;165;Tordesillas;7534;3800;3734
47;Valladolid;169;Torre de Esgueva;136;68;68
47;Valladolid;170;Torre de Peñafiel;76;39;37
47;Valladolid;166;Torrecilla de la Abadesa;413;220;193
47;Valladolid;167;Torrecilla de la Orden;440;216;224
47;Valladolid;168;Torrecilla de la Torre;48;28;20
47;Valladolid;171;Torrelobatón;684;332;352
47;Valladolid;172;Torrescárcela;210;107;103
47;Valladolid;173;Traspinedo;790;404;386
47;Valladolid;174;Trigueros del Valle;272;139;133
47;Valladolid;175;Tudela de Duero;4905;2497;2408
47;Valladolid;176;Unión de Campos (La);408;195;213
47;Valladolid;177;Urones de Castroponce;224;127;97
47;Valladolid;178;Urueña;259;136;123
47;Valladolid;179;Valbuena de Duero;576;301;275
47;Valladolid;180;Valdearcos de la Vega;171;87;84
47;Valladolid;181;Valdenebro de los Valles;255;139;116
47;Valladolid;182;Valdestillas;1439;741;698
47;Valladolid;183;Valdunquillo;309;151;158
47;Valladolid;186;Valladolid;333680;161829;171851
47;Valladolid;184;Valoria la Buena;667;350;317
47;Valladolid;185;Valverde de Campos;133;72;61
47;Valladolid;187;Vega de Ruiponce;208;96;112
47;Valladolid;188;Vega de Valdetronco;222;119;103
47;Valladolid;189;Velascálvaro;209;108;101
47;Valladolid;190;Velilla;162;85;77
47;Valladolid;191;Velliza;195;102;93
47;Valladolid;192;Ventosa de la Cuesta;188;99;89
47;Valladolid;193;Viana de Cega;1016;521;495
47;Valladolid;195;Villabáñez;434;224;210
47;Valladolid;196;Villabaruz de Campos;59;25;34
47;Valladolid;197;Villabrágima;1341;689;652
47;Valladolid;198;Villacarralón;159;84;75
47;Valladolid;199;Villacid de Campos;141;77;64
47;Valladolid;200;Villaco;179;102;77
47;Valladolid;203;Villafrades de Campos;179;83;96
47;Valladolid;204;Villafranca de Duero;455;229;226
47;Valladolid;205;Villafrechós;594;299;295
47;Valladolid;206;Villafuerte;190;89;101
47;Valladolid;207;Villagarcía de Campos;487;252;235
47;Valladolid;208;Villagómez la Nueva;118;56;62
47;Valladolid;209;Villalán de Campos;67;33;34
47;Valladolid;210;Villalar de los Comuneros;519;263;256
47;Valladolid;211;Villalba de la Loma;58;30;28
47;Valladolid;212;Villalba de los Alcores;688;352;336
47;Valladolid;213;Villalbarba;186;92;94
47;Valladolid;214;Villalón de Campos;2231;1102;1129
47;Valladolid;215;Villamuriel de Campos;108;51;57
47;Valladolid;216;Villán de Tordesillas;179;92;87
47;Valladolid;217;Villanubla;985;514;471
47;Valladolid;218;Villanueva de Duero;866;447;419
47;Valladolid;219;Villanueva de la Condesa;58;32;26
47;Valladolid;220;Villanueva de los Caballeros;334;168;166
47;Valladolid;221;Villanueva de los Infantes;164;85;79
47;Valladolid;222;Villanueva de San Mancio;106;56;50
47;Valladolid;223;Villardefrades;355;183;172
47;Valladolid;224;Villarmentero de Esgueva;138;67;71
47;Valladolid;225;Villasexmir;147;78;69
47;Valladolid;226;Villavaquerín;259;138;121
47;Valladolid;227;Villavellid;99;50;49
47;Valladolid;228;Villaverde de Medina;670;353;317
47;Valladolid;229;Villavicencio de los Caballeros;419;194;225
47;Valladolid;194;Viloria;433;229;204
47;Valladolid;230;Wamba;401;212;189
47;Valladolid;231;Zaratán;1159;594;565
47;Valladolid;232;Zarza (La);197;99;98
48;Vizcaya;001;Abadiño;7209;3666;3543
48;Vizcaya;002;Abanto y Ciérvana-Abanto Zierbena;9658;4838;4820
48;Vizcaya;911;Ajangiz;"";"";""
48;Vizcaya;912;Alonsotegi;"";"";""
48;Vizcaya;003;Amorebieta-Etxano;15986;8073;7913
48;Vizcaya;004;Amoroto;402;212;190
48;Vizcaya;005;Arakaldo;98;58;40
48;Vizcaya;006;Arantzazu;314;153;161
48;Vizcaya;093;Areatza;1189;561;628
48;Vizcaya;009;Arrankudiaga;748;372;376
48;Vizcaya;914;Arratzu;"";"";""
48;Vizcaya;010;Arrieta;432;228;204
48;Vizcaya;011;Arrigorriaga;9698;4718;4980
48;Vizcaya;023;Artea;633;311;322
48;Vizcaya;008;Artzentales;668;372;296
48;Vizcaya;091;Atxondo;1553;790;763
48;Vizcaya;070;Aulesti;713;396;317
48;Vizcaya;012;Bakio;1272;640;632
48;Vizcaya;090;Balmaseda;7574;3711;3863
48;Vizcaya;013;Barakaldo;111672;55077;56595
48;Vizcaya;014;Barrika;763;371;392
48;Vizcaya;015;Basauri;50941;25469;25472
48;Vizcaya;092;Bedia;1101;544;557
48;Vizcaya;016;Berango;4171;2070;2101
48;Vizcaya;017;Bermeo;18166;9048;9118
48;Vizcaya;018;Berriatua;1085;576;509
48;Vizcaya;019;Berriz;4245;2142;2103
48;Vizcaya;020;Bilbao;383798;184135;199663
48;Vizcaya;021;Busturia;1789;898;891
48;Vizcaya;901;Derio;5044;2532;2512
48;Vizcaya;026;Dima;1010;525;485
48;Vizcaya;027;Durango;22556;11212;11344
48;Vizcaya;028;Ea;837;410;427
48;Vizcaya;031;Elantxobe;561;259;302
48;Vizcaya;032;Elorrio;7526;3802;3724
48;Vizcaya;902;Erandio;25392;12583;12809
48;Vizcaya;033;Ereño;293;146;147
48;Vizcaya;034;Ermua;18634;9583;9051
48;Vizcaya;079;Errigoiti;473;258;215
48;Vizcaya;029;Etxebarri, Anteiglesia de San Esteban-Etxebarri Doneztebeko Elizatea;6776;3405;3371
48;Vizcaya;030;Etxebarria;795;418;377
48;Vizcaya;906;Forua;989;510;479
48;Vizcaya;035;Fruiz;352;185;167
48;Vizcaya;036;Galdakao;28264;14136;14128
48;Vizcaya;037;Galdames;803;425;378
48;Vizcaya;038;Gamiz-Fika;892;477;415
48;Vizcaya;039;Garay;254;132;122
48;Vizcaya;040;Gatika;888;442;446
48;Vizcaya;041;Gautegiz Arteaga;802;393;409
48;Vizcaya;046;Gernika-Lumo;16422;8060;8362
48;Vizcaya;044;Getxo;81795;39632;42163
48;Vizcaya;047;Gizaburuaga;137;72;65
48;Vizcaya;042;Gordexola;1551;781;770
48;Vizcaya;043;Gorliz;2892;1399;1493
48;Vizcaya;045;Güeñes;6145;3021;3124
48;Vizcaya;048;Ibarrangelu;553;249;304
48;Vizcaya;094;Igorre;3911;1968;1943
48;Vizcaya;049;Ispaster;618;334;284
48;Vizcaya;910;Iurreta;5040;2532;2508
48;Vizcaya;050;Izurtza;274;138;136
48;Vizcaya;022;Karrantza Harana/Valle de Carranza;3375;1789;1586
48;Vizcaya;907;Kortezubi;411;216;195
48;Vizcaya;051;Lanestosa;322;166;156
48;Vizcaya;052;Larrabetzu;1497;740;757
48;Vizcaya;053;Laukiz;1012;518;494
48;Vizcaya;054;Leioa;24569;12221;12348
48;Vizcaya;057;Lekeitio;7642;3742;3900
48;Vizcaya;055;Lemoa;2957;1499;1458
48;Vizcaya;056;Lemoiz;801;400;401
48;Vizcaya;081;Lezama;1991;1014;977
48;Vizcaya;903;Loiu;1670;850;820
48;Vizcaya;058;Mallabia;1155;605;550
48;Vizcaya;059;Mañaria;519;273;246
48;Vizcaya;060;Markina-Xemein;5064;2579;2485
48;Vizcaya;061;Maruri-Jatabe;521;259;262
48;Vizcaya;062;Mendata;372;206;166
48;Vizcaya;063;Mendexa;364;186;178
48;Vizcaya;064;Meñaka;406;211;195
48;Vizcaya;066;Morga;352;188;164
48;Vizcaya;068;Mundaka;1695;781;914
48;Vizcaya;069;Mungia;11613;5741;5872
48;Vizcaya;007;Munitibar-Arbatzegi Gerrikaitz;471;251;220
48;Vizcaya;908;Murueta;214;103;111
48;Vizcaya;071;Muskiz;6345;3186;3159
48;Vizcaya;067;Muxika;1517;795;722
48;Vizcaya;909;Nabarniz;242;117;125
48;Vizcaya;073;Ondarroa;10983;5531;5452
48;Vizcaya;075;Orozko;2000;992;1008
48;Vizcaya;083;Ortuella;9081;4466;4615
48;Vizcaya;072;Otxandio;1169;621;548
48;Vizcaya;077;Plentzia;2769;1354;1415
48;Vizcaya;078;Portugalete;57156;28311;28845
48;Vizcaya;082;Santurtzi;51706;25550;26156
48;Vizcaya;084;Sestao;37146;18198;18948
48;Vizcaya;904;Sondika;3525;1716;1809
48;Vizcaya;085;Sopelana;7886;3992;3894
48;Vizcaya;086;Sopuerta;2203;1154;1049
48;Vizcaya;076;Sukarrieta;309;153;156
48;Vizcaya;087;Trucios-Turtzioz;546;265;281
48;Vizcaya;088;Ubide;165;78;87
48;Vizcaya;065;Ugao-Miraballes;4211;2143;2068
48;Vizcaya;089;Urduliz;2506;1257;1249
48;Vizcaya;074;Urduña-Orduña;4165;2101;2064
48;Vizcaya;080;Valle de Trápaga-Trapagaran;13374;6602;6772
48;Vizcaya;095;Zaldibar;3223;1517;1706
48;Vizcaya;096;Zalla;7417;3705;3712
48;Vizcaya;905;Zamudio;3209;1623;1586
48;Vizcaya;097;Zaratamo;1669;845;824
48;Vizcaya;024;Zeanuri;1215;627;588
48;Vizcaya;025;Zeberio;962;497;465
48;Vizcaya;913;Zierbena;"";"";""
49;Zamora;002;Abezames;145;71;74
49;Zamora;003;Alcañices;1280;662;618
49;Zamora;004;Alcubilla de Nogales;275;131;144
49;Zamora;005;Alfaraz de Sayago;297;153;144
49;Zamora;006;Algodre;277;146;131
49;Zamora;007;Almaraz de Duero;528;261;267
49;Zamora;008;Almeida de Sayago;774;403;371
49;Zamora;009;Andavías;586;285;301
49;Zamora;010;Arcenillas;264;134;130
49;Zamora;011;Arcos de la Polvorosa;340;181;159
49;Zamora;012;Argañín;140;66;74
49;Zamora;013;Argujillo;472;248;224
49;Zamora;014;Arquillinos;227;115;112
49;Zamora;015;Arrabalde;491;240;251
49;Zamora;016;Aspariegos;490;224;266
49;Zamora;017;Asturianos;460;225;235
49;Zamora;018;Ayoó de Vidriales;622;307;315
49;Zamora;019;Barcial del Barco;357;192;165
49;Zamora;020;Belver de los Montes;612;315;297
49;Zamora;021;Benavente;14301;6920;7381
49;Zamora;022;Benegiles;517;273;244
49;Zamora;023;Bermillo de Sayago;1807;923;884
49;Zamora;024;Bóveda de Toro (La);1134;588;546
49;Zamora;025;Bretó;321;159;162
49;Zamora;026;Bretocino;378;205;173
49;Zamora;027;Brime de Sog;336;149;187
49;Zamora;028;Brime de Urz;211;108;103
49;Zamora;029;Burganes de Valverde;972;502;470
49;Zamora;030;Bustillo del Oro;218;99;119
49;Zamora;031;Cabañas de Sayago;276;141;135
49;Zamora;032;Calzadilla de Tera;660;318;342
49;Zamora;033;Camarzana de Tera;1273;635;638
49;Zamora;034;Cañizal;737;373;364
49;Zamora;035;Cañizo;417;199;218
49;Zamora;036;Carbajales de Alba;772;373;399
49;Zamora;037;Carbellino;303;158;145
49;Zamora;038;Casaseca de Campeán;222;115;107
49;Zamora;039;Casaseca de las Chanas;439;219;220
49;Zamora;040;Castrillo de la Guareña;203;105;98
49;Zamora;041;Castrogonzalo;637;314;323
49;Zamora;042;Castronuevo;468;242;226
49;Zamora;043;Castroverde de Campos;513;249;264
49;Zamora;044;Cazurra;129;70;59
49;Zamora;046;Cerecinos de Campos;551;289;262
49;Zamora;047;Cerecinos del Carrizal;213;110;103
49;Zamora;048;Cernadilla;211;97;114
49;Zamora;050;Cobreros;968;461;507
49;Zamora;052;Coomonte;404;201;203
49;Zamora;053;Coreses;1352;702;650
49;Zamora;054;Corrales;1523;755;768
49;Zamora;055;Cotanes del Monte;221;117;104
49;Zamora;056;Cubillos;485;257;228
49;Zamora;057;Cubo de Benavente;268;141;127
49;Zamora;058;Cubo de Tierra del Vino (El);478;256;222
49;Zamora;059;Cuelgamures;171;95;76
49;Zamora;061;Entrala;179;90;89
49;Zamora;062;Espadañedo;256;122;134
49;Zamora;063;Faramontanos de Tábara;628;319;309
49;Zamora;064;Fariza;872;433;439
49;Zamora;065;Fermoselle;2144;1041;1103
49;Zamora;066;Ferreras de Abajo;712;365;347
49;Zamora;067;Ferreras de Arriba;709;359;350
49;Zamora;068;Ferreruela;828;433;395
49;Zamora;069;Figueruela de Arriba;693;335;358
49;Zamora;071;Fonfría;1423;713;710
49;Zamora;075;Fresno de la Polvorosa;292;143;149
49;Zamora;076;Fresno de la Ribera;480;271;209
49;Zamora;077;Fresno de Sayago;416;212;204
49;Zamora;078;Friera de Valverde;364;182;182
49;Zamora;079;Fuente Encalada;218;116;102
49;Zamora;080;Fuentelapeña;1153;568;585
49;Zamora;082;Fuentes de Ropel;776;392;384
49;Zamora;081;Fuentesaúco;2045;1001;1044
49;Zamora;083;Fuentesecas;125;59;66
49;Zamora;084;Fuentespreadas;484;256;228
49;Zamora;085;Galende;1562;758;804
49;Zamora;086;Gallegos del Pan;222;112;110
49;Zamora;087;Gallegos del Río;1119;579;540
49;Zamora;088;Gamones;136;76;60
49;Zamora;090;Gema;362;178;184
49;Zamora;091;Granja de Moreruela;474;229;245
49;Zamora;092;Granucillo;362;187;175
49;Zamora;093;Guarrate;483;269;214
49;Zamora;094;Hermisende;615;297;318
49;Zamora;095;Hiniesta (La);446;222;224
49;Zamora;096;Jambrina;339;169;170
49;Zamora;097;Justel;253;131;122
49;Zamora;098;Losacino;434;231;203
49;Zamora;099;Losacio;184;100;84
49;Zamora;100;Lubián;504;242;262
49;Zamora;101;Luelmo;337;171;166
49;Zamora;102;Maderal (El);340;175;165
49;Zamora;103;Madridanos;632;344;288
49;Zamora;104;Mahide;698;352;346
49;Zamora;105;Maire de Castroponce;307;159;148
49;Zamora;107;Malva;318;152;166
49;Zamora;108;Manganeses de la Lampreana;1038;516;522
49;Zamora;109;Manganeses de la Polvorosa;1004;489;515
49;Zamora;110;Manzanal de Arriba;641;313;328
49;Zamora;112;Manzanal de los Infantes;252;120;132
49;Zamora;111;Manzanal del Barco;271;137;134
49;Zamora;113;Matilla de Arzón;376;197;179
49;Zamora;114;Matilla la Seca;102;52;50
49;Zamora;115;Mayalde;308;157;151
49;Zamora;116;Melgar de Tera;674;330;344
49;Zamora;117;Micereces de Tera;756;391;365
49;Zamora;118;Milles de la Polvorosa;322;161;161
49;Zamora;119;Molacillos;373;193;180
49;Zamora;120;Molezuelas de la Carballeda;200;101;99
49;Zamora;121;Mombuey;529;265;264
49;Zamora;122;Monfarracinos;587;311;276
49;Zamora;123;Montamarta;856;402;454
49;Zamora;124;Moral de Sayago;448;236;212
49;Zamora;126;Moraleja de Sayago;321;170;151
49;Zamora;125;Moraleja del Vino;1261;671;590
49;Zamora;128;Morales de Rey;856;435;421
49;Zamora;129;Morales de Toro;1232;607;625
49;Zamora;130;Morales de Valverde;405;197;208
49;Zamora;127;Morales del Vino;1164;617;547
49;Zamora;131;Moralina;410;213;197
49;Zamora;132;Moreruela de los Infanzones;548;287;261
49;Zamora;133;Moreruela de Tábara;660;336;324
49;Zamora;134;Muelas de los Caballeros;301;156;145
49;Zamora;135;Muelas del Pan;1010;510;500
49;Zamora;136;Muga de Sayago;566;274;292
49;Zamora;137;Navianos de Valverde;316;170;146
49;Zamora;138;Olmillos de Castro;632;327;305
49;Zamora;139;Otero de Bodas;353;179;174
49;Zamora;141;Pajares de la Lampreana;604;300;304
49;Zamora;143;Palacios de Sanabria;417;196;221
49;Zamora;142;Palacios del Pan;295;140;155
49;Zamora;145;Pedralba de la Pradería;530;269;261
49;Zamora;146;Pego (El);572;302;270
49;Zamora;147;Peleagonzalo;579;292;287
49;Zamora;148;Peleas de Abajo;230;120;110
49;Zamora;149;Peñausende;688;354;334
49;Zamora;150;Peque;305;140;165
49;Zamora;151;Perdigón (El);949;484;465
49;Zamora;152;Pereruela;950;465;485
49;Zamora;153;Perilla de Castro;400;198;202
49;Zamora;154;Pías;355;186;169
49;Zamora;155;Piedrahita de Castro;188;96;92
49;Zamora;156;Pinilla de Toro;496;239;257
49;Zamora;157;Pino del Oro;286;153;133
49;Zamora;158;Piñero (El);356;181;175
49;Zamora;160;Pobladura de Valderaduey;104;46;58
49;Zamora;159;Pobladura del Valle;423;200;223
49;Zamora;162;Porto;446;221;225
49;Zamora;163;Pozoantiguo;447;232;215
49;Zamora;164;Pozuelo de Tábara;303;152;151
49;Zamora;165;Prado;129;59;70
49;Zamora;166;Puebla de Sanabria;1767;856;911
49;Zamora;167;Pueblica de Valverde;422;211;211
49;Zamora;170;Quintanilla de Urz;165;91;74
49;Zamora;168;Quintanilla del Monte;193;100;93
49;Zamora;169;Quintanilla del Olmo;73;35;38
49;Zamora;171;Quiruelas de Vidriales;1147;563;584
49;Zamora;172;Rabanales;1093;555;538
49;Zamora;173;Rábano de Aliste;683;339;344
49;Zamora;174;Requejo;294;152;142
49;Zamora;175;Revellinos;416;220;196
49;Zamora;176;Riofrío de Aliste;1315;683;632
49;Zamora;177;Rionegro del Puente;526;245;281
49;Zamora;178;Roales;339;171;168
49;Zamora;179;Robleda-Cervantes;525;260;265
49;Zamora;180;Roelos de Sayago;204;103;101
49;Zamora;181;Rosinos de la Requejada;673;330;343
49;Zamora;183;Salce;178;93;85
49;Zamora;184;Samir de los Caños;297;150;147
49;Zamora;185;San Agustín del Pozo;246;132;114
49;Zamora;186;San Cebrián de Castro;501;240;261
49;Zamora;187;San Cristóbal de Entreviñas;1717;874;843
49;Zamora;188;San Esteban del Molar;255;133;122
49;Zamora;189;San Justo;467;224;243
49;Zamora;190;San Martín de Valderaduey;117;55;62
49;Zamora;191;San Miguel de la Ribera;506;258;248
49;Zamora;192;San Miguel del Valle;314;145;169
49;Zamora;193;San Pedro de Ceque;769;389;380
49;Zamora;194;San Pedro de la Nave-Almendra;609;301;308
49;Zamora;208;San Vicente de la Cabeza;811;410;401
49;Zamora;209;San Vitero;866;441;425
49;Zamora;197;Santa Clara de Avedillo;347;168;179
49;Zamora;199;Santa Colomba de las Monjas;373;184;189
49;Zamora;200;Santa Cristina de la Polvorosa;1347;684;663
49;Zamora;201;Santa Croya de Tera;596;291;305
49;Zamora;202;Santa Eufemia del Barco;400;205;195
49;Zamora;203;Santa María de la Vega;611;313;298
49;Zamora;204;Santa María de Valverde;142;81;61
49;Zamora;205;Santibáñez de Tera;728;375;353
49;Zamora;206;Santibáñez de Vidriales;1697;821;876
49;Zamora;207;Santovenia;565;281;284
49;Zamora;210;Sanzoles;834;415;419
49;Zamora;214;Tábara;1062;548;514
49;Zamora;216;Tapioles;283;155;128
49;Zamora;219;Toro;9633;4685;4948
49;Zamora;220;Torre del Valle (La);248;129;119
49;Zamora;221;Torregamones;435;210;225
49;Zamora;222;Torres del Carrizal;609;313;296
49;Zamora;223;Trabazos;1155;587;568
49;Zamora;224;Trefacio;243;118;125
49;Zamora;225;Uña de Quintana;310;160;150
49;Zamora;226;Vadillo de la Guareña;401;200;201
49;Zamora;227;Valcabado;331;169;162
49;Zamora;228;Valdefinjas;123;64;59
49;Zamora;229;Valdescorriel;208;97;111
49;Zamora;230;Vallesa de la Guareña;248;138;110
49;Zamora;231;Vega de Tera;674;321;353
49;Zamora;232;Vega de Villalobos;219;112;107
49;Zamora;233;Vegalatrave;204;109;95
49;Zamora;234;Venialbo;591;308;283
49;Zamora;235;Vezdemarbán;900;428;472
49;Zamora;236;Vidayanes;156;73;83
49;Zamora;237;Videmala;312;150;162
49;Zamora;238;Villabrázaro;528;266;262
49;Zamora;239;Villabuena del Puente;1190;613;577
49;Zamora;240;Villadepera;312;149;163
49;Zamora;241;Villaescusa;486;253;233
49;Zamora;242;Villafáfila;725;360;365
49;Zamora;243;Villaferrueña;217;111;106
49;Zamora;244;Villageriz;85;43;42
49;Zamora;245;Villalazán;450;229;221
49;Zamora;246;Villalba de la Lampreana;388;202;186
49;Zamora;247;Villalcampo;876;427;449
49;Zamora;248;Villalobos;401;188;213
49;Zamora;249;Villalonso;178;80;98
49;Zamora;250;Villalpando;1942;937;1005
49;Zamora;251;Villalube;410;213;197
49;Zamora;252;Villamayor de Campos;789;378;411
49;Zamora;255;Villamor de los Escuderos;685;343;342
49;Zamora;256;Villanázar;466;226;240
49;Zamora;257;Villanueva de Azoague;460;234;226
49;Zamora;258;Villanueva de Campeán;230;115;115
49;Zamora;259;Villanueva de las Peras;262;127;135
49;Zamora;260;Villanueva del Campo;1282;634;648
49;Zamora;263;Villar de Fallaves;148;77;71
49;Zamora;264;Villar del Buey;1059;558;501
49;Zamora;261;Villaralbo;1487;746;741
49;Zamora;262;Villardeciervos;619;288;331
49;Zamora;265;Villardiegua de la Ribera;213;101;112
49;Zamora;266;Villárdiga;139;70;69
49;Zamora;267;Villardondiego;175;92;83
49;Zamora;268;Villarrín de Campos;745;367;378
49;Zamora;269;Villaseco del Pan;414;198;216
49;Zamora;270;Villavendimio;263;142;121
49;Zamora;272;Villaveza de Valverde;185;90;95
49;Zamora;271;Villaveza del Agua;330;174;156
49;Zamora;273;Viñas;374;192;182
49;Zamora;275;Zamora;63436;30213;33223
50;Zaragoza;001;Abanto;303;160;143
50;Zaragoza;002;Acered;356;182;174
50;Zaragoza;003;Agón;244;128;116
50;Zaragoza;004;Aguarón;777;382;395
50;Zaragoza;005;Aguilón;296;150;146
50;Zaragoza;006;Ainzón;1272;645;627
50;Zaragoza;007;Aladrén;50;23;27
50;Zaragoza;008;Alagón;5454;2725;2729
50;Zaragoza;009;Alarba;177;101;76
50;Zaragoza;010;Alberite de San Juan;113;56;57
50;Zaragoza;011;Albeta;146;67;79
50;Zaragoza;012;Alborge;131;60;71
50;Zaragoza;013;Alcalá de Ebro;372;188;184
50;Zaragoza;014;Alcalá de Moncayo;181;106;75
50;Zaragoza;015;Alconchel de Ariza;241;124;117
50;Zaragoza;016;Aldehuela de Liestos;88;46;42
50;Zaragoza;017;Alfajarín;1405;728;677
50;Zaragoza;018;Alfamén;1325;687;638
50;Zaragoza;019;Alforque;90;46;44
50;Zaragoza;020;Alhama de Aragón;1289;631;658
50;Zaragoza;021;Almochuel;54;30;24
50;Zaragoza;022;Almolda (La);756;364;392
50;Zaragoza;023;Almonacid de la Cuba;396;203;193
50;Zaragoza;024;Almonacid de la Sierra;871;449;422
50;Zaragoza;025;Almunia de Doña Godina (La);5160;2604;2556
50;Zaragoza;026;Alpartir;643;346;297
50;Zaragoza;027;Ambel;434;205;229
50;Zaragoza;028;Anento;48;27;21
50;Zaragoza;029;Aniñón;984;527;457
50;Zaragoza;030;Añón de Moncayo;356;205;151
50;Zaragoza;031;Aranda de Moncayo;285;157;128
50;Zaragoza;032;Arándiga;607;299;308
50;Zaragoza;033;Ardisa;88;42;46
50;Zaragoza;034;Ariza;1497;719;778
50;Zaragoza;035;Artieda;110;56;54
50;Zaragoza;036;Asín;118;60;58
50;Zaragoza;037;Atea;295;160;135
50;Zaragoza;038;Ateca;2185;1060;1125
50;Zaragoza;039;Azuara;861;448;413
50;Zaragoza;040;Badules;126;67;59
50;Zaragoza;041;Bagüés;15;6;9
50;Zaragoza;042;Balconchán;40;22;18
50;Zaragoza;043;Bárboles;375;198;177
50;Zaragoza;044;Bardallur;349;173;176
50;Zaragoza;045;Belchite;1733;869;864
50;Zaragoza;046;Belmonte de Gracián;376;208;168
50;Zaragoza;047;Berdejo;37;18;19
50;Zaragoza;048;Berrueco;37;23;14
50;Zaragoza;901;Biel;246;137;109
50;Zaragoza;050;Bijuesca;142;71;71
50;Zaragoza;051;Biota;1414;727;687
50;Zaragoza;052;Bisimbre;157;72;85
50;Zaragoza;053;Boquiñeni;1125;578;547
50;Zaragoza;054;Bordalba;112;60;52
50;Zaragoza;055;Borja;4065;1995;2070
50;Zaragoza;056;Botorrita;460;240;220
50;Zaragoza;057;Brea de Aragón;2084;1028;1056
50;Zaragoza;058;Bubierca;134;64;70
50;Zaragoza;059;Bujaraloz;1133;590;543
50;Zaragoza;060;Bulbuente;302;155;147
50;Zaragoza;061;Bureta;350;184;166
50;Zaragoza;062;Burgo de Ebro (El);1168;575;593
50;Zaragoza;063;Buste (El);153;77;76
50;Zaragoza;064;Cabañas de Ebro;565;283;282
50;Zaragoza;065;Cabolafuente;117;64;53
50;Zaragoza;066;Cadrete;971;506;465
50;Zaragoza;067;Calatayud;17623;8404;9219
50;Zaragoza;068;Calatorao;2802;1436;1366
50;Zaragoza;069;Calcena;100;49;51
50;Zaragoza;070;Calmarza;146;72;74
50;Zaragoza;071;Campillo de Aragón;245;136;109
50;Zaragoza;072;Carenas;263;133;130
50;Zaragoza;073;Cariñena;2932;1483;1449
50;Zaragoza;074;Caspe;8273;4096;4177
50;Zaragoza;075;Castejón de Alarba;150;85;65
50;Zaragoza;076;Castejón de las Armas;185;93;92
50;Zaragoza;077;Castejón de Valdejasa;431;234;197
50;Zaragoza;078;Castiliscar;475;239;236
50;Zaragoza;079;Cervera de la Cañada;396;197;199
50;Zaragoza;080;Cerveruela;4;2;2
50;Zaragoza;081;Cetina;870;443;427
50;Zaragoza;092;Chiprana;454;233;221
50;Zaragoza;093;Chodes;172;83;89
50;Zaragoza;082;Cimballa;149;73;76
50;Zaragoza;083;Cinco Olivas;162;82;80
50;Zaragoza;084;Clarés de Ribota;130;67;63
50;Zaragoza;085;Codo;373;189;184
50;Zaragoza;086;Codos;351;198;153
50;Zaragoza;087;Contamina;79;37;42
50;Zaragoza;088;Cosuenda;472;234;238
50;Zaragoza;089;Cuarte de Huerva;1321;689;632
50;Zaragoza;090;Cubel;295;146;149
50;Zaragoza;091;Cuerlas (Las);105;57;48
50;Zaragoza;094;Daroca;2460;1230;1230
50;Zaragoza;095;Ejea de los Caballeros;15785;8032;7753
50;Zaragoza;096;Embid de Ariza;96;50;46
50;Zaragoza;098;Encinacorba;343;181;162
50;Zaragoza;099;Épila;3770;1908;1862
50;Zaragoza;100;Erla;583;282;301
50;Zaragoza;101;Escatrón;1445;712;733
50;Zaragoza;102;Fabara;1398;735;663
50;Zaragoza;104;Farlete;492;250;242
50;Zaragoza;105;Fayón;444;226;218
50;Zaragoza;106;Fayos (Los);199;102;97
50;Zaragoza;107;Figueruelas;859;425;434
50;Zaragoza;108;Fombuena;13;10;3
50;Zaragoza;109;Frago (El);131;76;55
50;Zaragoza;110;Frasno (El);709;373;336
50;Zaragoza;111;Fréscano;303;147;156
50;Zaragoza;113;Fuendejalón;1000;505;495
50;Zaragoza;114;Fuendetodos;177;99;78
50;Zaragoza;115;Fuentes de Ebro;3783;1966;1817
50;Zaragoza;116;Fuentes de Jiloca;434;225;209
50;Zaragoza;117;Gallocanta;209;110;99
50;Zaragoza;118;Gallur;3186;1601;1585
50;Zaragoza;119;Gelsa;1415;713;702
50;Zaragoza;120;Godojos;99;53;46
50;Zaragoza;121;Gotor;404;211;193
50;Zaragoza;122;Grisel;53;27;26
50;Zaragoza;123;Grisén;500;250;250
50;Zaragoza;124;Herrera de los Navarros;743;383;360
50;Zaragoza;125;Ibdes;634;334;300
50;Zaragoza;126;Illueca;3222;1589;1633
50;Zaragoza;128;Isuerre;62;35;27
50;Zaragoza;129;Jaraba;336;163;173
50;Zaragoza;130;Jarque;630;336;294
50;Zaragoza;131;Jaulín;311;154;157
50;Zaragoza;132;Joyosa (La);352;179;173
50;Zaragoza;133;Lagata;158;83;75
50;Zaragoza;134;Langa del Castillo;225;99;126
50;Zaragoza;135;Layana;195;98;97
50;Zaragoza;136;Lécera;1019;492;527
50;Zaragoza;138;Lechón;66;37;29
50;Zaragoza;137;Leciñena;1511;758;753
50;Zaragoza;139;Letux;504;258;246
50;Zaragoza;140;Litago;205;121;84
50;Zaragoza;141;Lituénigo;129;66;63
50;Zaragoza;142;Lobera de Onsella;74;47;27
50;Zaragoza;143;Longares;908;442;466
50;Zaragoza;144;Longás;30;22;8
50;Zaragoza;146;Lucena de Jalón;304;151;153
50;Zaragoza;147;Luceni;1118;553;565
50;Zaragoza;148;Luesia;495;256;239
50;Zaragoza;149;Luesma;29;15;14
50;Zaragoza;150;Lumpiaque;1069;549;520
50;Zaragoza;151;Luna;1025;536;489
50;Zaragoza;152;Maella;2260;1138;1122
50;Zaragoza;153;Magallón;1389;711;678
50;Zaragoza;154;Mainar;189;99;90
50;Zaragoza;155;Malanquilla;156;78;78
50;Zaragoza;156;Maleján;326;166;160
50;Zaragoza;160;Mallén;2976;1502;1474
50;Zaragoza;157;Malón;535;266;269
50;Zaragoza;159;Maluenda;1130;567;563
50;Zaragoza;161;Manchones;178;91;87
50;Zaragoza;162;Mara;273;142;131
50;Zaragoza;163;María de Huerva;725;363;362
50;Zaragoza;902;Marracos;"";"";""
50;Zaragoza;164;Mediana de Aragón;567;282;285
50;Zaragoza;165;Mequinenza;2786;1397;1389
50;Zaragoza;166;Mesones de Isuela;475;236;239
50;Zaragoza;167;Mezalocha;344;186;158
50;Zaragoza;168;Mianos;44;20;24
50;Zaragoza;169;Miedes de Aragón;610;309;301
50;Zaragoza;170;Monegrillo;591;320;271
50;Zaragoza;171;Moneva;101;45;56
50;Zaragoza;172;Monreal de Ariza;363;188;175
50;Zaragoza;173;Monterde;229;113;116
50;Zaragoza;174;Montón;176;84;92
50;Zaragoza;175;Morata de Jalón;1795;886;909
50;Zaragoza;176;Morata de Jiloca;414;212;202
50;Zaragoza;177;Morés;572;291;281
50;Zaragoza;178;Moros;679;346;333
50;Zaragoza;179;Moyuela;440;229;211
50;Zaragoza;180;Mozota;137;62;75
50;Zaragoza;181;Muel;1270;627;643
50;Zaragoza;182;Muela (La);963;504;459
50;Zaragoza;183;Munébrega;590;303;287
50;Zaragoza;184;Murero;177;98;79
50;Zaragoza;185;Murillo de Gállego;150;83;67
50;Zaragoza;186;Navardún;93;50;43
50;Zaragoza;187;Nigüella;142;70;72
50;Zaragoza;188;Nombrevilla;47;22;25
50;Zaragoza;189;Nonaspe;1154;581;573
50;Zaragoza;190;Novallas;847;413;434
50;Zaragoza;191;Novillas;754;386;368
50;Zaragoza;192;Nuévalos;325;177;148
50;Zaragoza;193;Nuez de Ebro;502;263;239
50;Zaragoza;194;Olvés;211;111;100
50;Zaragoza;195;Orcajo;55;25;30
50;Zaragoza;196;Orera;170;95;75
50;Zaragoza;197;Orés;144;81;63
50;Zaragoza;198;Oseja;20;9;11
50;Zaragoza;199;Osera de Ebro;346;155;191
50;Zaragoza;200;Paniza;780;382;398
50;Zaragoza;201;Paracuellos de Jiloca;546;254;292
50;Zaragoza;202;Paracuellos de la Ribera;388;186;202
50;Zaragoza;203;Pastriz;760;373;387
50;Zaragoza;204;Pedrola;2487;1270;1217
50;Zaragoza;205;Pedrosas (Las);101;51;50
50;Zaragoza;206;Perdiguera;511;266;245
50;Zaragoza;207;Piedratajada;256;124;132
50;Zaragoza;208;Pina de Ebro;2213;1109;1104
50;Zaragoza;209;Pinseque;1359;686;673
50;Zaragoza;210;Pintanos (Los);78;45;33
50;Zaragoza;211;Plasencia de Jalón;399;209;190
50;Zaragoza;212;Pleitas;84;42;42
50;Zaragoza;213;Plenas;173;82;91
50;Zaragoza;214;Pomer;25;10;15
50;Zaragoza;215;Pozuel de Ariza;36;22;14
50;Zaragoza;216;Pozuelo de Aragón;410;217;193
50;Zaragoza;217;Pradilla de Ebro;741;393;348
50;Zaragoza;218;Puebla de Albortón;180;91;89
50;Zaragoza;219;Puebla de Alfindén (La);1435;734;701
50;Zaragoza;220;Puendeluna;66;34;32
50;Zaragoza;221;Purujosa;22;17;5
50;Zaragoza;222;Quinto;2269;1139;1130
50;Zaragoza;223;Remolinos;1324;670;654
50;Zaragoza;224;Retascón;85;47;38
50;Zaragoza;225;Ricla;2217;1166;1051
50;Zaragoza;227;Romanos;169;93;76
50;Zaragoza;228;Rueda de Jalón;406;219;187
50;Zaragoza;229;Ruesca;92;48;44
50;Zaragoza;241;Sabiñán;1103;534;569
50;Zaragoza;230;Sádaba;1924;951;973
50;Zaragoza;231;Salillas de Jalón;432;219;213
50;Zaragoza;232;Salvatierra de Esca;356;190;166
50;Zaragoza;233;Samper del Salz;110;53;57
50;Zaragoza;234;San Martín de la Virgen de Moncayo;325;173;152
50;Zaragoza;235;San Mateo de Gállego;1821;940;881
50;Zaragoza;236;Santa Cruz de Grío;262;148;114
50;Zaragoza;237;Santa Cruz de Moncayo;104;55;49
50;Zaragoza;238;Santa Eulalia de Gállego;133;69;64
50;Zaragoza;239;Santed;91;43;48
50;Zaragoza;240;Sástago;1690;856;834
50;Zaragoza;242;Sediles;110;58;52
50;Zaragoza;243;Sestrica;567;290;277
50;Zaragoza;244;Sierra de Luna;314;160;154
50;Zaragoza;245;Sigüés;191;103;88
50;Zaragoza;246;Sisamón;123;68;55
50;Zaragoza;247;Sobradiel;570;269;301
50;Zaragoza;248;Sos del Rey Católico;982;498;484
50;Zaragoza;249;Tabuenca;543;278;265
50;Zaragoza;250;Talamantes;57;29;28
50;Zaragoza;251;Tarazona;11055;5303;5752
50;Zaragoza;252;Tauste;7212;3608;3604
50;Zaragoza;253;Terrer;803;379;424
50;Zaragoza;254;Tierga;315;167;148
50;Zaragoza;255;Tobed;318;157;161
50;Zaragoza;256;Torralba de los Frailes;132;67;65
50;Zaragoza;257;Torralba de Ribota;270;147;123
50;Zaragoza;258;Torralbilla;85;46;39
50;Zaragoza;259;Torrehermosa;139;72;67
50;Zaragoza;260;Torrelapaja;73;38;35
50;Zaragoza;261;Torrellas;370;181;189
50;Zaragoza;262;Torres de Berrellén;1462;743;719
50;Zaragoza;263;Torrijo de la Cañada;517;278;239
50;Zaragoza;264;Tosos;274;148;126
50;Zaragoza;265;Trasmoz;84;41;43
50;Zaragoza;266;Trasobares;322;170;152
50;Zaragoza;267;Uncastillo;924;461;463
50;Zaragoza;268;Undués de Lerda;46;23;23
50;Zaragoza;269;Urrea de Jalón;417;199;218
50;Zaragoza;270;Urriés;85;47;38
50;Zaragoza;271;Used;501;254;247
50;Zaragoza;272;Utebo;7617;3816;3801
50;Zaragoza;274;Val de San Martín;86;37;49
50;Zaragoza;273;Valdehorna;86;47;39
50;Zaragoza;275;Valmadrid;81;43;38
50;Zaragoza;276;Valpalmas;250;129;121
50;Zaragoza;277;Valtorres;139;67;72
50;Zaragoza;278;Velilla de Ebro;320;161;159
50;Zaragoza;279;Velilla de Jiloca;161;81;80
50;Zaragoza;280;Vera de Moncayo;550;278;272
50;Zaragoza;281;Vierlas;115;58;57
50;Zaragoza;283;Villadoz;110;56;54
50;Zaragoza;284;Villafeliche;270;137;133
50;Zaragoza;285;Villafranca de Ebro;686;335;351
50;Zaragoza;286;Villalba de Perejil;108;54;54
50;Zaragoza;287;Villalengua;529;280;249
50;Zaragoza;288;Villanueva de Gállego;2552;1280;1272
50;Zaragoza;290;Villanueva de Huerva;712;354;358
50;Zaragoza;289;Villanueva de Jiloca;141;75;66
50;Zaragoza;291;Villar de los Navarros;219;107;112
50;Zaragoza;292;Villarreal de Huerva;197;113;84
50;Zaragoza;293;Villarroya de la Sierra;852;427;425
50;Zaragoza;294;Villarroya del Campo;82;45;37
50;Zaragoza;282;Vilueña (La);141;66;75
50;Zaragoza;295;Vistabella;38;18;20
50;Zaragoza;296;Zaida (La);685;341;344
50;Zaragoza;297;Zaragoza;592686;286858;305828
50;Zaragoza;298;Zuera;5324;2702;2622
51;Ceuta;001;Ceuta;68970;34136;34834
52;Melilla;001;Melilla;62569;30099;32470
