01;Álava;001;Alegría-Dulantzi;1259;656;603
01;Álava;002;Amurrio;9753;4854;4899
01;Álava;049;Añana;185;94;91
01;Álava;003;Aramaio;1365;721;644
01;Álava;006;Armiñón;145;75;70
01;Álava;037;Arraia-Maeztu;692;369;323
01;Álava;008;Arrazua-Ubarrundia;761;399;362
01;Álava;004;Artziniega;1317;660;657
01;Álava;009;Asparrena;1544;771;773
01;Álava;010;Ayala/Aiara;2001;995;1006
01;Álava;011;Baños de Ebro/Mañueta;334;182;152
01;Álava;013;Barrundia;586;329;257
01;Álava;014;Berantevilla;406;211;195
01;Álava;016;Bernedo;548;316;232
01;Álava;017;Campezo/Kanpezu;1073;560;513
01;Álava;021;Elburgo/Burgelu;231;128;103
01;Álava;022;Elciego;909;462;447
01;Álava;023;Elvillar/Bilar;352;189;163
01;Álava;056;Harana/Valle de Arana;358;198;160
01;Álava;901;Iruña Oka/Iruña de Oca;1683;886;797
01;Álava;027;Iruraiz-Gauna;417;231;186
01;Álava;019;Kripan;187;96;91
01;Álava;020;Kuartango;362;203;159
01;Álava;028;Labastida/Bastida;1177;627;550
01;Álava;030;Lagrán;195;105;90
01;Álava;031;Laguardia;1409;724;685
01;Álava;032;Lanciego/Lantziego;645;335;310
01;Álava;902;Lantarón;901;509;392
01;Álava;033;Lapuebla de Labarca;864;437;427
01;Álava;058;Legutiano;1324;693;631
01;Álava;034;Leza;172;93;79
01;Álava;036;Llodio;19694;9859;9835
01;Álava;039;Moreda de Álava;289;155;134
01;Álava;041;Navaridas;217;122;95
01;Álava;042;Okondo;810;414;396
01;Álava;043;Oyón/Oion;2246;1133;1113
01;Álava;044;Peñacerrada-Urizaharra;243;134;109
01;Álava;046;Erriberagoitia/Ribera Alta;518;302;216
01;Álava;047;Ribera Baja/Erribera Beitia;499;274;225
01;Álava;051;Salvatierra/Agurain;3876;1940;1936
01;Álava;052;Samaniego;305;150;155
01;Álava;053;San Millán/Donemiliaga;700;382;318
01;Álava;054;Urkabustaiz;821;453;368
01;Álava;055;Valdegovía/Gaubea;896;488;408
01;Álava;057;Villabuena de Álava/Eskuernaga;339;167;172
01;Álava;059;Vitoria-Gasteiz;216527;106454;110073
01;Álava;060;Yécora/Lekora;252;124;128
01;Álava;061;Zalduondo;132;71;61
01;Álava;062;Zambrana;366;194;172
01;Álava;018;Zigoitia;1132;630;502
01;Álava;063;Zuia;1578;796;782
02;Albacete;001;Abengibre;1007;499;508
02;Albacete;002;Alatoz;675;351;324
02;Albacete;003;Albacete;145454;71126;74328
02;Albacete;004;Albatana;874;442;432
02;Albacete;005;Alborea;809;428;381
02;Albacete;006;Alcadozo;779;395;384
02;Albacete;007;Alcalá del Júcar;1512;777;735
02;Albacete;008;Alcaraz;1730;831;899
02;Albacete;009;Almansa;23658;11674;11984
02;Albacete;010;Alpera;2324;1188;1136
02;Albacete;011;Ayna;1003;505;498
02;Albacete;012;Balazote;2223;1121;1102
02;Albacete;014;Ballestero (El);573;283;290
02;Albacete;013;Balsa de Ves;261;146;115
02;Albacete;015;Barrax;1952;981;971
02;Albacete;016;Bienservida;906;461;445
02;Albacete;017;Bogarra;1369;725;644
02;Albacete;018;Bonete;1240;627;613
02;Albacete;019;Bonillo (El);3310;1677;1633
02;Albacete;020;Carcelén;662;352;310
02;Albacete;021;Casas de Juan Núñez;1279;666;613
02;Albacete;022;Casas de Lázaro;451;243;208
02;Albacete;023;Casas de Ves;912;474;438
02;Albacete;024;Casas-Ibáñez;4058;2046;2012
02;Albacete;025;Caudete;8827;4397;4430
02;Albacete;026;Cenizate;1066;555;511
02;Albacete;029;Chinchilla de Monte-Aragón;3190;1650;1540
02;Albacete;027;Corral-Rubio;460;230;230
02;Albacete;028;Cotillas;219;109;110
02;Albacete;030;Elche de la Sierra;3943;1964;1979
02;Albacete;032;Fuensanta;381;192;189
02;Albacete;033;Fuente-Álamo;2447;1243;1204
02;Albacete;034;Fuentealbilla;1805;914;891
02;Albacete;031;Férez;787;395;392
02;Albacete;035;Gineta (La);2065;1006;1059
02;Albacete;036;Golosalvo;119;57;62
02;Albacete;037;Hellín;25978;12871;13107
02;Albacete;038;Herrera (La);395;204;191
02;Albacete;039;Higueruela;1313;661;652
02;Albacete;040;Hoya-Gonzalo;750;377;373
02;Albacete;041;Jorquera;587;314;273
02;Albacete;042;Letur;1387;685;702
02;Albacete;043;Lezuza;1804;947;857
02;Albacete;044;Liétor;1685;867;818
02;Albacete;045;Madrigueras;4503;2274;2229
02;Albacete;046;Mahora;1353;670;683
02;Albacete;047;Masegoso;168;98;70
02;Albacete;048;Minaya;1785;899;886
02;Albacete;049;Molinicos;1397;716;681
02;Albacete;050;Montalvos;145;73;72
02;Albacete;051;Montealegre del Castillo;2115;1066;1049
02;Albacete;052;Motilleja;510;252;258
02;Albacete;053;Munera;4069;2044;2025
02;Albacete;054;Navas de Jorquera;535;274;261
02;Albacete;055;Nerpio;1792;959;833
02;Albacete;056;Ontur;2428;1197;1231
02;Albacete;057;Ossa de Montiel;2790;1387;1403
02;Albacete;058;Paterna del Madera;583;302;281
02;Albacete;060;Peñas de San Pedro;1244;658;586
02;Albacete;059;Peñascosa;418;216;202
02;Albacete;062;Povedilla;721;376;345
02;Albacete;901;Pozo Cañada;"";"";""
02;Albacete;064;Pozo-Lorente;539;260;279
02;Albacete;063;Pozohondo;1852;949;903
02;Albacete;065;Pozuelo;674;349;325
02;Albacete;061;Pétrola;927;474;453
02;Albacete;066;Recueja (La);350;176;174
02;Albacete;067;Riópar;1420;733;687
02;Albacete;068;Robledo;431;227;204
02;Albacete;069;Roda (La);13583;6808;6775
02;Albacete;070;Salobre;622;322;300
02;Albacete;071;San Pedro;1326;672;654
02;Albacete;072;Socovos;2032;1044;988
02;Albacete;073;Tarazona de la Mancha;6010;2999;3011
02;Albacete;074;Tobarra;7435;3731;3704
02;Albacete;075;Valdeganga;1966;994;972
02;Albacete;076;Vianos;489;240;249
02;Albacete;077;Villa de Ves;61;29;32
02;Albacete;078;Villalgordo del Júcar;1329;665;664
02;Albacete;079;Villamalea;3459;1771;1688
02;Albacete;080;Villapalacios;860;433;427
02;Albacete;081;Villarrobledo;22178;10833;11345
02;Albacete;082;Villatoya;193;99;94
02;Albacete;083;Villavaliente;291;152;139
02;Albacete;084;Villaverde de Guadalimar;564;301;263
02;Albacete;085;Viveros;564;302;262
02;Albacete;086;Yeste;4657;2378;2279
03;Alicante/Alacant;001;Adsubia;579;296;283
03;Alicante/Alacant;002;Agost;4023;1998;2025
03;Alicante/Alacant;003;Agres;651;339;312
03;Alicante/Alacant;004;Aigües;558;286;272
03;Alicante/Alacant;005;Albatera;8521;4293;4228
03;Alicante/Alacant;006;Alcalalí;818;410;408
03;Alicante/Alacant;007;Alcocer de Planes;130;55;75
03;Alicante/Alacant;008;Alcoleja;279;134;145
03;Alicante/Alacant;009;Alcoy/Alcoi;60476;29135;31341
03;Alicante/Alacant;010;Alfafara;392;190;202
03;Alicante/Alacant;011;Alfàs del Pi (L');13145;6403;6742
03;Alicante/Alacant;012;Algorfa;1168;590;578
03;Alicante/Alacant;013;Algueña;1428;692;736
03;Alicante/Alacant;014;Alicante/Alacant;272432;130607;141825
03;Alicante/Alacant;015;Almoradí;13499;6809;6690
03;Alicante/Alacant;016;Almudaina;118;62;56
03;Alicante/Alacant;017;Alqueria d'Asnar (L');395;199;196
03;Alicante/Alacant;018;Altea;13976;6872;7104
03;Alicante/Alacant;019;Aspe;16406;8204;8202
03;Alicante/Alacant;020;Balones;178;85;93
03;Alicante/Alacant;021;Banyeres de Mariola;6848;3398;3450
03;Alicante/Alacant;022;Benasau;200;98;102
03;Alicante/Alacant;023;Beneixama;1796;891;905
03;Alicante/Alacant;024;Benejúzar;5067;2518;2549
03;Alicante/Alacant;025;Benferri;982;492;490
03;Alicante/Alacant;026;Beniarbeig;1205;586;619
03;Alicante/Alacant;027;Beniardá;216;101;115
03;Alicante/Alacant;028;Beniarrés;1447;727;720
03;Alicante/Alacant;030;Benidoleig;781;375;406
03;Alicante/Alacant;031;Benidorm;50946;24985;25961
03;Alicante/Alacant;032;Benifallim;151;71;80
03;Alicante/Alacant;033;Benifato;136;67;69
03;Alicante/Alacant;029;Benigembla;382;194;188
03;Alicante/Alacant;034;Benijófar;1621;790;831
03;Alicante/Alacant;035;Benilloba;926;469;457
03;Alicante/Alacant;036;Benillup;95;49;46
03;Alicante/Alacant;037;Benimantell;417;198;219
03;Alicante/Alacant;038;Benimarfull;407;187;220
03;Alicante/Alacant;039;Benimassot;108;56;52
03;Alicante/Alacant;040;Benimeli;331;164;167
03;Alicante/Alacant;041;Benissa;9368;4652;4716
03;Alicante/Alacant;042;Benitachell/Poble Nou de Benitatxell (el);2002;1000;1002
03;Alicante/Alacant;043;Biar;3528;1711;1817
03;Alicante/Alacant;044;Bigastro;4784;2424;2360
03;Alicante/Alacant;045;Bolulla;302;148;154
03;Alicante/Alacant;046;Busot;1502;744;758
03;Alicante/Alacant;048;Callosa d'En Sarrià;6370;3189;3181
03;Alicante/Alacant;049;Callosa de Segura;15150;7547;7603
03;Alicante/Alacant;047;Calp;14819;7418;7401
03;Alicante/Alacant;050;Campello (El);16173;8020;8153
03;Alicante/Alacant;051;Campo de Mirra/Camp de Mirra (el);382;186;196
03;Alicante/Alacant;053;Castalla;7583;3742;3841
03;Alicante/Alacant;054;Castell de Castells;471;235;236
03;Alicante/Alacant;055;Catral;4894;2427;2467
03;Alicante/Alacant;052;Cañada;1096;523;573
03;Alicante/Alacant;056;Cocentaina;10572;5180;5392
03;Alicante/Alacant;057;Confrides;283;164;119
03;Alicante/Alacant;058;Cox;5794;2918;2876
03;Alicante/Alacant;059;Crevillent;23945;12032;11913
03;Alicante/Alacant;061;Daya Nueva;1142;593;549
03;Alicante/Alacant;062;Daya Vieja;168;84;84
03;Alicante/Alacant;064;Dolores;6144;3102;3042
03;Alicante/Alacant;063;Dénia;28629;13955;14674
03;Alicante/Alacant;065;Elche/Elx;191713;94650;97063
03;Alicante/Alacant;066;Elda;52490;25578;26912
03;Alicante/Alacant;067;Facheca;121;65;56
03;Alicante/Alacant;068;Famorca;66;31;35
03;Alicante/Alacant;069;Finestrat;1735;858;877
03;Alicante/Alacant;070;Formentera del Segura;2032;992;1040
03;Alicante/Alacant;072;Gaianes;301;134;167
03;Alicante/Alacant;071;Gata de Gorgos;5008;2485;2523
03;Alicante/Alacant;073;Gorga;258;134;124
03;Alicante/Alacant;074;Granja de Rocamora;2071;1038;1033
03;Alicante/Alacant;075;Guadalest;177;91;86
03;Alicante/Alacant;076;Guardamar del Segura;8490;4231;4259
03;Alicante/Alacant;077;Hondón de las Nieves;1563;770;793
03;Alicante/Alacant;078;Hondón de los Frailes;562;281;281
03;Alicante/Alacant;079;Ibi;21075;10433;10642
03;Alicante/Alacant;080;Jacarilla;1539;772;767
03;Alicante/Alacant;081;Jalón/Xaló;2032;994;1038
03;Alicante/Alacant;083;Jijona/Xixona;7453;3486;3967
03;Alicante/Alacant;082;Jávea/Xàbia;21084;10451;10633
03;Alicante/Alacant;085;Llíber;525;261;264
03;Alicante/Alacant;084;Lorcha/Orxa (L');786;393;393
03;Alicante/Alacant;086;Millena;144;70;74
03;Alicante/Alacant;088;Monforte del Cid;5163;2654;2509
03;Alicante/Alacant;903;Montesinos (Los);2472;1255;1217
03;Alicante/Alacant;089;Monóvar/Monòver;11978;5854;6124
03;Alicante/Alacant;091;Murla;319;136;183
03;Alicante/Alacant;092;Muro de Alcoy;7140;3518;3622
03;Alicante/Alacant;090;Mutxamel;13267;6662;6605
03;Alicante/Alacant;093;Novelda;23190;11428;11762
03;Alicante/Alacant;094;Nucia (la);7303;3613;3690
03;Alicante/Alacant;095;Ondara;5216;2612;2604
03;Alicante/Alacant;096;Onil;6788;3402;3386
03;Alicante/Alacant;097;Orba;1574;761;813
03;Alicante/Alacant;099;Orihuela;50581;24996;25585
03;Alicante/Alacant;098;Orxeta;444;224;220
03;Alicante/Alacant;100;Parcent;785;384;401
03;Alicante/Alacant;101;Pedreguer;5815;2823;2992
03;Alicante/Alacant;102;Pego;10177;5184;4993
03;Alicante/Alacant;103;Penàguila;335;155;180
03;Alicante/Alacant;104;Petrer;27604;13730;13874
03;Alicante/Alacant;902;Pilar de la Horadada;10210;5442;4768
03;Alicante/Alacant;105;Pinoso;6026;2992;3034
03;Alicante/Alacant;106;Planes;809;403;406
03;Alicante/Alacant;901;Poblets (Els);1368;663;705
03;Alicante/Alacant;107;Polop;2009;975;1034
03;Alicante/Alacant;060;Quatretondeta;185;92;93
03;Alicante/Alacant;109;Rafal;3081;1534;1547
03;Alicante/Alacant;111;Redován;5348;2741;2607
03;Alicante/Alacant;112;Relleu;815;405;410
03;Alicante/Alacant;113;Rojales;7048;3455;3593
03;Alicante/Alacant;114;Romana (La);1978;1005;973
03;Alicante/Alacant;110;Ràfol d'Almúnia (El);364;176;188
03;Alicante/Alacant;115;Sagra;389;192;197
03;Alicante/Alacant;116;Salinas;1180;596;584
03;Alicante/Alacant;118;San Fulgencio;3149;1572;1577
03;Alicante/Alacant;904;San Isidro;1253;653;600
03;Alicante/Alacant;120;San Miguel de Salinas;3594;1838;1756
03;Alicante/Alacant;122;San Vicente del Raspeig/Sant Vicent del Raspeig;36291;17940;18351
03;Alicante/Alacant;117;Sanet y Negrals;546;250;296
03;Alicante/Alacant;119;Sant Joan d'Alacant;16299;7982;8317
03;Alicante/Alacant;121;Santa Pola;17600;8704;8896
03;Alicante/Alacant;123;Sax;8581;4313;4268
03;Alicante/Alacant;124;Sella;579;293;286
03;Alicante/Alacant;125;Senija;479;252;227
03;Alicante/Alacant;128;Teulada;8672;4309;4363
03;Alicante/Alacant;129;Tibi;1197;618;579
03;Alicante/Alacant;130;Tollos;43;27;16
03;Alicante/Alacant;131;Tormos;299;143;156
03;Alicante/Alacant;132;Torremanzanas/Torre de les Maçanes (la);727;363;364
03;Alicante/Alacant;133;Torrevieja;38336;18890;19446
03;Alicante/Alacant;127;Tárbena;701;341;360
03;Alicante/Alacant;134;Vall d'Alcalà (La);176;82;94
03;Alicante/Alacant;135;Vall de Ebo;333;171;162
03;Alicante/Alacant;136;Vall de Gallinera;614;319;295
03;Alicante/Alacant;137;Vall de Laguar (La);904;436;468
03;Alicante/Alacant;138;Verger (El);3538;1699;1839
03;Alicante/Alacant;139;Villajoyosa/Vila Joiosa (La);22969;11292;11677
03;Alicante/Alacant;140;Villena;31532;15564;15968
04;Almería;001;Abla;1516;746;770
04;Almería;002;Abrucena;1462;716;746
04;Almería;003;Adra;21016;10521;10495
04;Almería;004;Albánchez;605;303;302
04;Almería;005;Alboloduy;813;385;428
04;Almería;006;Albox;9471;4754;4717
04;Almería;007;Alcolea;849;427;422
04;Almería;008;Alcóntar;603;308;295
04;Almería;009;Alcudia de Monteagud;159;75;84
04;Almería;010;Alhabia;675;328;347
04;Almería;011;Alhama de Almería;3111;1551;1560
04;Almería;012;Alicún;245;118;127
04;Almería;013;Almería;168025;81480;86545
04;Almería;014;Almócita;187;97;90
04;Almería;015;Alsodux;106;53;53
04;Almería;016;Antas;2666;1314;1352
04;Almería;017;Arboleas;1540;781;759
04;Almería;018;Armuña de Almanzora;330;160;170
04;Almería;019;Bacares;278;146;132
04;Almería;020;Bayárcal;334;178;156
04;Almería;021;Bayarque;237;112;125
04;Almería;022;Bédar;550;290;260
04;Almería;023;Beires;141;67;74
04;Almería;024;Benahadux;2740;1300;1440
04;Almería;026;Benitagla;86;45;41
04;Almería;027;Benizalón;324;169;155
04;Almería;028;Bentarique;319;166;153
04;Almería;029;Berja;13197;6295;6902
04;Almería;030;Canjáyar;1728;873;855
04;Almería;031;Cantoria;3206;1611;1595
04;Almería;032;Carboneras;6312;3230;3082
04;Almería;033;Castro de Filabres;181;88;93
04;Almería;036;Chercos;298;156;142
04;Almería;037;Chirivel;1837;912;925
04;Almería;034;Cóbdar;255;128;127
04;Almería;035;Cuevas del Almanzora;9495;4723;4772
04;Almería;038;Dalías;3639;1800;1839
04;Almería;039;Darrical;"";"";""
04;Almería;902;Ejido (El);50170;26335;23835
04;Almería;041;Enix;232;122;110
04;Almería;043;Felix;565;284;281
04;Almería;044;Fines;1716;870;846
04;Almería;045;Fiñana;2607;1281;1326
04;Almería;046;Fondón;918;469;449
04;Almería;047;Gádor;2577;1276;1301
04;Almería;048;Gallardos (Los);1738;874;864
04;Almería;049;Garrucha;5001;2530;2471
04;Almería;050;Gérgal;1063;520;543
04;Almería;051;Huécija;532;269;263
04;Almería;052;Huércal de Almería;5951;3005;2946
04;Almería;053;Huércal-Overa;13839;6811;7028
04;Almería;054;Illar;469;224;245
04;Almería;055;Instinción;545;264;281
04;Almería;056;Laroya;108;57;51
04;Almería;057;Láujar de Andarax;1830;896;934
04;Almería;058;Líjar;502;248;254
04;Almería;059;Lubrín;1780;853;927
04;Almería;060;Lucainena de las Torres;565;283;282
04;Almería;061;Lúcar;786;389;397
04;Almería;062;Macael;5828;2959;2869
04;Almería;063;María;1635;842;793
04;Almería;064;Mojácar;4525;2232;2293
04;Almería;903;Mojonera (La);6561;3530;3031
04;Almería;065;Nacimiento;539;268;271
04;Almería;066;Níjar;15406;8017;7389
04;Almería;067;Ohanes;811;405;406
04;Almería;068;Olula de Castro;178;87;91
04;Almería;069;Olula del Río;5952;2959;2993
04;Almería;070;Oria;2121;1076;1045
04;Almería;071;Padules;491;245;246
04;Almería;072;Partaloa;381;187;194
04;Almería;073;Paterna del Río;363;197;166
04;Almería;074;Pechina;2663;1350;1313
04;Almería;075;Pulpí;5291;2559;2732
04;Almería;076;Purchena;1634;791;843
04;Almería;077;Rágol;384;175;209
04;Almería;078;Rioja;1185;586;599
04;Almería;079;Roquetas de Mar;40582;20862;19720
04;Almería;080;Santa Cruz de Marchena;219;98;121
04;Almería;081;Santa Fe de Mondújar;412;200;212
04;Almería;082;Senés;335;170;165
04;Almería;083;Serón;2673;1298;1375
04;Almería;084;Sierro;495;244;251
04;Almería;085;Somontín;500;249;251
04;Almería;086;Sorbas;2748;1389;1359
04;Almería;087;Suflí;246;125;121
04;Almería;088;Tabernas;3241;1630;1611
04;Almería;089;Taberno;1002;495;507
04;Almería;090;Tahal;368;194;174
04;Almería;091;Terque;430;222;208
04;Almería;092;Tíjola;3796;1855;1941
04;Almería;901;Tres Villas (Las);630;333;297
04;Almería;093;Turre;2151;1054;1097
04;Almería;094;Turrillas;242;126;116
04;Almería;095;Uleila del Campo;969;496;473
04;Almería;096;Urrácal;332;161;171
04;Almería;097;Velefique;312;159;153
04;Almería;098;Vélez-Blanco;2190;1119;1071
04;Almería;099;Vélez-Rubio;6463;3084;3379
04;Almería;100;Vera;6695;3354;3341
04;Almería;101;Viator;3385;1638;1747
04;Almería;102;Vícar;14973;7879;7094
04;Almería;103;Zurgena;2081;1012;1069
05;Ávila;001;Adanero;321;169;152
05;Ávila;002;Adrada (La);1979;1027;952
05;Ávila;005;Albornos;272;152;120
05;Ávila;007;Aldeanueva de Santa Cruz;189;101;88
05;Ávila;008;Aldeaseca;348;179;169
05;Ávila;010;Aldehuela (La);284;139;145
05;Ávila;012;Amavida;199;101;98
05;Ávila;013;Arenal (El);1090;525;565
05;Ávila;014;Arenas de San Pedro;6348;3127;3221
05;Ávila;015;Arevalillo;136;65;71
05;Ávila;016;Arévalo;7414;3595;3819
05;Ávila;017;Aveinte;144;76;68
05;Ávila;018;Avellaneda;38;19;19
05;Ávila;019;Ávila;47650;22927;24723
05;Ávila;021;Barco de Ávila (El);2649;1309;1340
05;Ávila;022;Barraco (El);2025;1030;995
05;Ávila;023;Barromán;256;144;112
05;Ávila;024;Becedas;445;234;211
05;Ávila;025;Becedillas;174;92;82
05;Ávila;026;Bercial de Zapardiel;321;154;167
05;Ávila;027;Berlanas (Las);347;180;167
05;Ávila;029;Bernuy-Zapardiel;245;137;108
05;Ávila;030;Berrocalejo de Aragona;42;22;20
05;Ávila;033;Blascomillán;304;147;157
05;Ávila;034;Blasconuño de Matacabras;24;13;11
05;Ávila;035;Blascosancho;152;73;79
05;Ávila;036;Bohodón (El);206;100;106
05;Ávila;037;Bohoyo;472;240;232
05;Ávila;038;Bonilla de la Sierra;198;108;90
05;Ávila;039;Brabos;70;40;30
05;Ávila;040;Bularros;119;65;54
05;Ávila;041;Burgohondo;1221;627;594
05;Ávila;042;Cabezas de Alambre;238;125;113
05;Ávila;043;Cabezas del Pozo;172;91;81
05;Ávila;044;Cabezas del Villar;501;264;237
05;Ávila;045;Cabizuela;155;79;76
05;Ávila;046;Canales;67;36;31
05;Ávila;047;Candeleda;5137;2641;2496
05;Ávila;048;Cantiveros;197;102;95
05;Ávila;049;Cardeñosa;578;309;269
05;Ávila;051;Carrera (La);292;138;154
05;Ávila;052;Casas del Puerto de Villatoro;109;60;49
05;Ávila;053;Casasola;176;93;83
05;Ávila;054;Casavieja;1644;854;790
05;Ávila;055;Casillas;896;456;440
05;Ávila;056;Castellanos de Zapardiel;147;83;64
05;Ávila;057;Cebreros;3317;1662;1655
05;Ávila;058;Cepeda la Mora;151;79;72
05;Ávila;067;Chamartín;119;67;52
05;Ávila;059;Cillán;153;81;72
05;Ávila;060;Cisla;195;94;101
05;Ávila;061;Colilla (La);201;107;94
05;Ávila;062;Collado de Contreras;274;150;124
05;Ávila;063;Collado del Mirón;87;44;43
05;Ávila;064;Constanzana;194;101;93
05;Ávila;065;Crespos;771;401;370
05;Ávila;066;Cuevas del Valle;659;357;302
05;Ávila;903;Diego del Carpio;319;175;144
05;Ávila;069;Donjimeno;143;76;67
05;Ávila;070;Donvidas;73;37;36
05;Ávila;072;Espinosa de los Caballeros;107;60;47
05;Ávila;073;Flores de Ávila;446;231;215
05;Ávila;074;Fontíveros;1014;519;495
05;Ávila;075;Fresnedilla;111;50;61
05;Ávila;076;Fresno (El);465;238;227
05;Ávila;077;Fuente el Saúz;334;177;157
05;Ávila;078;Fuentes de Año;215;114;101
05;Ávila;079;Gallegos de Altamiros;102;54;48
05;Ávila;080;Gallegos de Sobrinos;109;50;59
05;Ávila;081;Garganta del Villar;80;46;34
05;Ávila;082;Gavilanes;745;423;322
05;Ávila;083;Gemuño;230;108;122
05;Ávila;085;Gil García;68;33;35
05;Ávila;084;Gilbuena;147;81;66
05;Ávila;086;Gimialcón;127;69;58
05;Ávila;087;Gotarrendura;179;66;113
05;Ávila;088;Grandes y San Martín;53;27;26
05;Ávila;089;Guisando;688;368;320
05;Ávila;090;Gutierre-Muñoz;127;64;63
05;Ávila;092;Hernansancho;230;117;113
05;Ávila;093;Herradón de Pinares;488;246;242
05;Ávila;094;Herreros de Suso;238;119;119
05;Ávila;095;Higuera de las Dueñas;322;179;143
05;Ávila;096;Hija de Dios (La);118;66;52
05;Ávila;097;Horcajada (La);839;410;429
05;Ávila;099;Horcajo de las Torres;827;454;373
05;Ávila;100;Hornillo (El);432;222;210
05;Ávila;102;Hoyo de Pinares (El);2455;1254;1201
05;Ávila;101;Hoyocasero;414;215;199
05;Ávila;103;Hoyorredondo;128;68;60
05;Ávila;106;Hoyos de Miguel Muñoz;57;29;28
05;Ávila;104;Hoyos del Collado;50;30;20
05;Ávila;105;Hoyos del Espino;405;225;180
05;Ávila;107;Hurtumpascual;116;64;52
05;Ávila;108;Junciana;100;52;48
05;Ávila;109;Langa;605;312;293
05;Ávila;110;Lanzahíta;912;472;440
05;Ávila;113;Llanos de Tormes (Los);135;71;64
05;Ávila;112;Losar del Barco (El);147;76;71
05;Ávila;114;Madrigal de las Altas Torres;2028;1036;992
05;Ávila;115;Maello;655;322;333
05;Ávila;116;Malpartida de Corneja;228;113;115
05;Ávila;117;Mamblas;284;156;128
05;Ávila;118;Mancera de Arriba;149;73;76
05;Ávila;119;Manjabálago;76;40;36
05;Ávila;120;Marlín;51;28;23
05;Ávila;121;Martiherrero;208;110;98
05;Ávila;122;Martínez;254;133;121
05;Ávila;123;Mediana de Voltoya;109;59;50
05;Ávila;124;Medinilla;235;118;117
05;Ávila;125;Mengamuñoz;73;32;41
05;Ávila;126;Mesegar de Corneja;125;64;61
05;Ávila;127;Mijares;1013;518;495
05;Ávila;128;Mingorría;547;271;276
05;Ávila;129;Mirón (El);263;153;110
05;Ávila;130;Mironcillo;130;73;57
05;Ávila;131;Mirueña de los Infanzones;203;102;101
05;Ávila;132;Mombeltrán;1198;637;561
05;Ávila;133;Monsalupe;92;47;45
05;Ávila;134;Moraleja de Matacabras;71;34;37
05;Ávila;135;Muñana;586;304;282
05;Ávila;136;Muñico;150;80;70
05;Ávila;138;Muñogalindo;452;245;207
05;Ávila;139;Muñogrande;111;58;53
05;Ávila;140;Muñomer del Peco;137;74;63
05;Ávila;141;Muñopepe;101;53;48
05;Ávila;142;Muñosancho;169;75;94
05;Ávila;143;Muñotello;128;69;59
05;Ávila;144;Narrillos del Álamo;172;90;82
05;Ávila;145;Narrillos del Rebollar;79;40;39
05;Ávila;149;Narros de Saldueña;199;110;89
05;Ávila;147;Narros del Castillo;259;142;117
05;Ávila;148;Narros del Puerto;40;22;18
05;Ávila;152;Nava de Arévalo;1007;524;483
05;Ávila;153;Nava del Barco;201;105;96
05;Ávila;151;Navacepedilla de Corneja;148;81;67
05;Ávila;154;Navadijos;64;37;27
05;Ávila;155;Navaescurial;95;54;41
05;Ávila;156;Navahondilla;137;81;56
05;Ávila;157;Navalacruz;328;161;167
05;Ávila;158;Navalmoral;625;317;308
05;Ávila;159;Navalonguilla;456;231;225
05;Ávila;160;Navalosa;527;276;251
05;Ávila;161;Navalperal de Pinares;907;441;466
05;Ávila;162;Navalperal de Tormes;142;77;65
05;Ávila;163;Navaluenga;2009;1018;991
05;Ávila;164;Navaquesera;68;28;40
05;Ávila;165;Navarredonda de Gredos;486;252;234
05;Ávila;166;Navarredondilla;304;149;155
05;Ávila;167;Navarrevisca;402;207;195
05;Ávila;168;Navas del Marqués (Las);4315;2163;2152
05;Ávila;169;Navatalgordo;352;180;172
05;Ávila;170;Navatejares;108;49;59
05;Ávila;171;Neila de San Miguel;127;66;61
05;Ávila;172;Niharra;202;102;100
05;Ávila;173;Ojos-Albos;51;25;26
05;Ávila;174;Orbita;110;54;56
05;Ávila;175;Oso (El);222;125;97
05;Ávila;176;Padiernos;238;123;115
05;Ávila;177;Pajares de Adaja;193;98;95
05;Ávila;178;Palacios de Goda;529;263;266
05;Ávila;179;Papatrigo;337;176;161
05;Ávila;180;Parral (El);132;70;62
05;Ávila;181;Pascualcobo;49;27;22
05;Ávila;182;Pedro Bernardo;1354;700;654
05;Ávila;183;Pedro-Rodríguez;215;101;114
05;Ávila;184;Peguerinos;310;163;147
05;Ávila;185;Peñalba de Ávila;131;75;56
05;Ávila;186;Piedrahíta;2225;1088;1137
05;Ávila;187;Piedralaves;2124;1065;1059
05;Ávila;188;Poveda;90;51;39
05;Ávila;189;Poyales del Hoyo;762;390;372
05;Ávila;190;Pozanco;55;30;25
05;Ávila;191;Pradosegar;176;93;83
05;Ávila;192;Puerto Castilla;148;83;65
05;Ávila;193;Rasueros;371;194;177
05;Ávila;194;Riocabado;202;114;88
05;Ávila;195;Riofrío;330;177;153
05;Ávila;196;Rivilla de Barajas;93;49;44
05;Ávila;197;Salobral;129;65;64
05;Ávila;198;Salvadiós;126;66;60
05;Ávila;199;San Bartolomé de Béjar;82;37;45
05;Ávila;200;San Bartolomé de Corneja;124;65;59
05;Ávila;201;San Bartolomé de Pinares;753;400;353
05;Ávila;206;San Esteban de los Patos;45;25;20
05;Ávila;208;San Esteban de Zapardiel;69;34;35
05;Ávila;207;San Esteban del Valle;921;478;443
05;Ávila;209;San García de Ingelmos;175;94;81
05;Ávila;901;San Juan de Gredos;413;218;195
05;Ávila;210;San Juan de la Encinilla;142;65;77
05;Ávila;211;San Juan de la Nava;698;365;333
05;Ávila;212;San Juan del Molinillo;343;192;151
05;Ávila;213;San Juan del Olmo;180;101;79
05;Ávila;214;San Lorenzo de Tormes;66;33;33
05;Ávila;215;San Martín de la Vega del Alberche;320;180;140
05;Ávila;216;San Martín del Pimpollar;348;191;157
05;Ávila;217;San Miguel de Corneja;114;54;60
05;Ávila;218;San Miguel de Serrezuela;220;116;104
05;Ávila;219;San Pascual;59;36;23
05;Ávila;220;San Pedro del Arroyo;471;243;228
05;Ávila;231;San Vicente de Arévalo;225;113;112
05;Ávila;204;Sanchidrián;802;414;388
05;Ávila;205;Sanchorreja;135;67;68
05;Ávila;222;Santa Cruz de Pinares;213;120;93
05;Ávila;221;Santa Cruz del Valle;654;332;322
05;Ávila;226;Santa María de los Caballeros;161;81;80
05;Ávila;224;Santa María del Arroyo;141;73;68
05;Ávila;225;Santa María del Berrocal;604;283;321
05;Ávila;902;Santa María del Cubillo;398;225;173
05;Ávila;227;Santa María del Tiétar;364;193;171
05;Ávila;228;Santiago del Collado;298;184;114
05;Ávila;904;Santiago del Tormes;290;145;145
05;Ávila;229;Santo Domingo de las Posadas;92;43;49
05;Ávila;230;Santo Tomé de Zabarcos;122;67;55
05;Ávila;232;Serrada (La);137;69;68
05;Ávila;233;Serranillos;438;225;213
05;Ávila;234;Sigeres;81;38;43
05;Ávila;235;Sinlabajos;248;128;120
05;Ávila;236;Solana de Ávila;225;122;103
05;Ávila;237;Solana de Rioalmar;303;162;141
05;Ávila;238;Solosancho;1088;567;521
05;Ávila;239;Sotalbo;267;137;130
05;Ávila;240;Sotillo de la Adrada;3522;1747;1775
05;Ávila;241;Tiemblo (El);3756;1893;1863
05;Ávila;242;Tiñosillos;761;401;360
05;Ávila;243;Tolbaños;135;66;69
05;Ávila;244;Tormellas;110;54;56
05;Ávila;245;Tornadizos de Ávila;356;176;180
05;Ávila;247;Torre (La);446;244;202
05;Ávila;246;Tórtoles;127;66;61
05;Ávila;249;Umbrías;177;93;84
05;Ávila;251;Vadillo de la Sierra;167;92;75
05;Ávila;252;Valdecasa;118;61;57
05;Ávila;253;Vega de Santa María;143;78;65
05;Ávila;254;Velayos;278;136;142
05;Ávila;256;Villaflor;168;88;80
05;Ávila;257;Villafranca de la Sierra;232;127;105
05;Ávila;905;Villanueva de Ávila;552;279;273
05;Ávila;258;Villanueva de Gómez;146;70;76
05;Ávila;259;Villanueva del Aceral;202;92;110
05;Ávila;260;Villanueva del Campillo;216;111;105
05;Ávila;261;Villar de Corneja;83;42;41
05;Ávila;262;Villarejo del Valle;508;262;246
05;Ávila;263;Villatoro;235;136;99
05;Ávila;264;Viñegra de Moraña;98;53;45
05;Ávila;265;Vita;118;72;46
05;Ávila;266;Zapardiel de la Cañada;204;103;101
05;Ávila;267;Zapardiel de la Ribera;146;73;73
06;Badajoz;001;Acedera;1001;527;474
06;Badajoz;002;Aceuchal;5240;2595;2645
06;Badajoz;003;Ahillones;1227;602;625
06;Badajoz;004;Alange;2035;1042;993
06;Badajoz;005;Albuera (La);1788;914;874
06;Badajoz;006;Alburquerque;5660;2843;2817
06;Badajoz;007;Alconchel;2153;1058;1095
06;Badajoz;008;Alconera;746;371;375
06;Badajoz;009;Aljucén;230;125;105
06;Badajoz;010;Almendral;1516;755;761
06;Badajoz;011;Almendralejo;27443;13385;14058
06;Badajoz;012;Arroyo de San Serván;3994;2062;1932
06;Badajoz;013;Atalaya;374;176;198
06;Badajoz;014;Azuaga;9091;4589;4502
06;Badajoz;015;Badajoz;134710;65330;69380
06;Badajoz;016;Barcarrota;3744;1904;1840
06;Badajoz;017;Baterno;411;213;198
06;Badajoz;018;Benquerencia de la Serena;1075;550;525
06;Badajoz;019;Berlanga;2716;1322;1394
06;Badajoz;020;Bienvenida;2366;1222;1144
06;Badajoz;021;Bodonal de la Sierra;1280;663;617
06;Badajoz;022;Burguillos del Cerro;3346;1624;1722
06;Badajoz;023;Cabeza del Buey;6067;2977;3090
06;Badajoz;024;Cabeza la Vaca;1666;819;847
06;Badajoz;025;Calamonte;6003;3011;2992
06;Badajoz;026;Calera de León;1118;560;558
06;Badajoz;027;Calzadilla de los Barros;845;414;431
06;Badajoz;028;Campanario;5777;2809;2968
06;Badajoz;029;Campillo de Llerena;1784;872;912
06;Badajoz;030;Capilla;228;107;121
06;Badajoz;031;Carmonita;680;352;328
06;Badajoz;032;Carrascalejo (El);37;19;18
06;Badajoz;033;Casas de Don Pedro;1766;878;888
06;Badajoz;034;Casas de Reina;254;120;134
06;Badajoz;035;Castilblanco;1428;701;727
06;Badajoz;036;Castuera;7526;3733;3793
06;Badajoz;042;Cheles;1378;690;688
06;Badajoz;037;Codosera (La);2376;1236;1140
06;Badajoz;038;Cordobilla de Lácara;1030;519;511
06;Badajoz;039;Coronada (La);2486;1244;1242
06;Badajoz;040;Corte de Peleas;1283;644;639
06;Badajoz;041;Cristina;573;304;269
06;Badajoz;043;Don Álvaro;672;335;337
06;Badajoz;044;Don Benito;31350;15462;15888
06;Badajoz;045;Entrín Bajo;682;338;344
06;Badajoz;046;Esparragalejo;1552;754;798
06;Badajoz;047;Esparragosa de la Serena;1138;562;576
06;Badajoz;048;Esparragosa de Lares;1235;595;640
06;Badajoz;049;Feria;1426;709;717
06;Badajoz;050;Fregenal de la Sierra;5360;2570;2790
06;Badajoz;051;Fuenlabrada de los Montes;2063;1018;1045
06;Badajoz;052;Fuente de Cantos;5045;2548;2497
06;Badajoz;053;Fuente del Arco;838;418;420
06;Badajoz;054;Fuente del Maestre;6815;3394;3421
06;Badajoz;055;Fuentes de León;2789;1367;1422
06;Badajoz;056;Garbayuela;596;317;279
06;Badajoz;057;Garlitos;784;393;391
06;Badajoz;058;Garrovilla (La);2618;1353;1265
06;Badajoz;059;Granja de Torrehermosa;2637;1316;1321
06;Badajoz;060;Guareña;7393;3718;3675
06;Badajoz;061;Haba (La);1465;741;724
06;Badajoz;062;Helechosa de los Montes;789;428;361
06;Badajoz;063;Herrera del Duque;4018;2031;1987
06;Badajoz;064;Higuera de la Serena;1275;650;625
06;Badajoz;065;Higuera de Llerena;478;236;242
06;Badajoz;066;Higuera de Vargas;2239;1119;1120
06;Badajoz;067;Higuera la Real;2696;1347;1349
06;Badajoz;068;Hinojosa del Valle;605;307;298
06;Badajoz;069;Hornachos;3814;1973;1841
06;Badajoz;070;Jerez de los Caballeros;9409;4693;4716
06;Badajoz;071;Lapa (La);341;173;168
06;Badajoz;073;Llera;1001;512;489
06;Badajoz;074;Llerena;5687;2747;2940
06;Badajoz;072;Lobón;2736;1404;1332
06;Badajoz;075;Magacela;734;377;357
06;Badajoz;076;Maguilla;1155;573;582
06;Badajoz;077;Malcocinado;562;299;263
06;Badajoz;078;Malpartida de la Serena;800;406;394
06;Badajoz;079;Manchita;775;388;387
06;Badajoz;080;Medellín;2452;1234;1218
06;Badajoz;081;Medina de las Torres;1536;773;763
06;Badajoz;082;Mengabril;465;241;224
06;Badajoz;083;Mérida;50471;24660;25811
06;Badajoz;084;Mirandilla;1389;696;693
06;Badajoz;085;Monesterio;5252;2631;2621
06;Badajoz;086;Montemolín;1736;900;836
06;Badajoz;087;Monterrubio de la Serena;3138;1543;1595
06;Badajoz;088;Montijo;15498;7618;7880
06;Badajoz;089;Morera (La);784;387;397
06;Badajoz;090;Nava de Santiago (La);1204;602;602
06;Badajoz;091;Navalvillar de Pela;5055;2542;2513
06;Badajoz;092;Nogales;798;396;402
06;Badajoz;093;Oliva de la Frontera;6002;2993;3009
06;Badajoz;094;Oliva de Mérida;2023;1006;1017
06;Badajoz;095;Olivenza;10558;5220;5338
06;Badajoz;096;Orellana de la Sierra;392;200;192
06;Badajoz;097;Orellana la Vieja;3586;1798;1788
06;Badajoz;098;Palomas;709;380;329
06;Badajoz;099;Parra (La);1401;723;678
06;Badajoz;100;Peñalsordo;1592;757;835
06;Badajoz;101;Peraleda del Zaucejo;682;345;337
06;Badajoz;102;Puebla de Alcocer;1488;733;755
06;Badajoz;103;Puebla de la Calzada;5520;2727;2793
06;Badajoz;104;Puebla de la Reina;868;446;422
06;Badajoz;107;Puebla de Obando;2045;1033;1012
06;Badajoz;108;Puebla de Sancho Pérez;2940;1483;1457
06;Badajoz;105;Puebla del Maestre;960;471;489
06;Badajoz;106;Puebla del Prior;595;298;297
06;Badajoz;902;Pueblonuevo del Guadiana;"";"";""
06;Badajoz;109;Quintana de la Serena;5162;2596;2566
06;Badajoz;110;Reina;237;126;111
06;Badajoz;111;Rena;676;340;336
06;Badajoz;112;Retamal de Llerena;590;303;287
06;Badajoz;113;Ribera del Fresno;3331;1624;1707
06;Badajoz;114;Risco;231;113;118
06;Badajoz;115;Roca de la Sierra (La);1645;813;832
06;Badajoz;116;Salvaleón;2330;1197;1133
06;Badajoz;117;Salvatierra de los Barros;2001;988;1013
06;Badajoz;119;San Pedro de Mérida;810;416;394
06;Badajoz;123;San Vicente de Alcántara;5930;2924;3006
06;Badajoz;118;Sancti-Spíritus;303;145;158
06;Badajoz;120;Santa Amalia;4356;2176;2180
06;Badajoz;121;Santa Marta;4081;2001;2080
06;Badajoz;122;Santos de Maimona (Los);7929;3939;3990
06;Badajoz;124;Segura de León;2325;1155;1170
06;Badajoz;125;Siruela;2528;1248;1280
06;Badajoz;126;Solana de los Barros;2813;1424;1389
06;Badajoz;127;Talarrubias;3731;1842;1889
06;Badajoz;128;Talavera la Real;5338;2703;2635
06;Badajoz;129;Táliga;752;385;367
06;Badajoz;130;Tamurejo;290;144;146
06;Badajoz;131;Torre de Miguel Sesmero;1267;622;645
06;Badajoz;132;Torremayor;1121;554;567
06;Badajoz;133;Torremejía;2030;1029;1001
06;Badajoz;134;Trasierra;701;375;326
06;Badajoz;135;Trujillanos;1316;689;627
06;Badajoz;136;Usagre;2124;1071;1053
06;Badajoz;137;Valdecaballeros;1475;743;732
06;Badajoz;901;Valdelacalzada;2580;1331;1249
06;Badajoz;138;Valdetorres;1394;709;685
06;Badajoz;139;Valencia de las Torres;875;441;434
06;Badajoz;140;Valencia del Mombuey;839;408;431
06;Badajoz;141;Valencia del Ventoso;2417;1180;1237
06;Badajoz;146;Valle de la Serena;1633;803;830
06;Badajoz;147;Valle de Matamoros;522;256;266
06;Badajoz;148;Valle de Santa Ana;1271;644;627
06;Badajoz;142;Valverde de Burguillos;390;198;192
06;Badajoz;143;Valverde de Leganés;3745;1892;1853
06;Badajoz;144;Valverde de Llerena;864;417;447
06;Badajoz;145;Valverde de Mérida;1150;576;574
06;Badajoz;149;Villafranca de los Barros;12444;6147;6297
06;Badajoz;150;Villagarcía de la Torre;1036;526;510
06;Badajoz;151;Villagonzalo;1504;725;779
06;Badajoz;152;Villalba de los Barros;1757;900;857
06;Badajoz;153;Villanueva de la Serena;23745;11719;12026
06;Badajoz;154;Villanueva del Fresno;3332;1671;1661
06;Badajoz;156;Villar de Rena;1720;914;806
06;Badajoz;155;Villar del Rey;2336;1197;1139
06;Badajoz;157;Villarta de los Montes;707;348;359
06;Badajoz;158;Zafra;15001;7196;7805
06;Badajoz;159;Zahínos;3096;1551;1545
06;Badajoz;160;Zalamea de la Serena;4712;2322;2390
06;Badajoz;162;Zarza (La);3622;1838;1784
06;Badajoz;161;Zarza-Capilla;526;278;248
07;Balears (Illes);002;Alaior;7046;3490;3556
07;Balears (Illes);001;Alaró;3834;1834;2000
07;Balears (Illes);003;Alcúdia;10581;5345;5236
07;Balears (Illes);004;Algaida;3542;1766;1776
07;Balears (Illes);005;Andratx;8333;4164;4169
07;Balears (Illes);901;Ariany;772;379;393
07;Balears (Illes);006;Artà;5936;2963;2973
07;Balears (Illes);007;Banyalbufar;503;264;239
07;Balears (Illes);008;Binissalem;5019;2424;2595
07;Balears (Illes);009;Búger;951;470;481
07;Balears (Illes);010;Bunyola;4338;2144;2194
07;Balears (Illes);011;Calvià;32587;16293;16294
07;Balears (Illes);012;Campanet;2277;1115;1162
07;Balears (Illes);013;Campos;6944;3478;3466
07;Balears (Illes);014;Capdepera;6752;3374;3378
07;Balears (Illes);064;Castell (Es);6005;3017;2988
07;Balears (Illes);015;Ciutadella de Menorca;21785;10853;10932
07;Balears (Illes);016;Consell;2210;1090;1120
07;Balears (Illes);017;Costitx;849;415;434
07;Balears (Illes);018;Deyá;625;311;314
07;Balears (Illes);026;Eivissa;31582;15728;15854
07;Balears (Illes);019;Escorca;275;148;127
07;Balears (Illes);020;Esporles;3811;1900;1911
07;Balears (Illes);021;Estellencs;338;176;162
07;Balears (Illes);022;Felanitx;14600;7268;7332
07;Balears (Illes);023;Ferreries;3921;2050;1871
07;Balears (Illes);024;Formentera;5859;2966;2893
07;Balears (Illes);025;Fornalutx;580;290;290
07;Balears (Illes);027;Inca;21103;10425;10678
07;Balears (Illes);028;Lloret de Vistalegre;837;415;422
07;Balears (Illes);029;Lloseta;4529;2231;2298
07;Balears (Illes);030;Llubí;1893;926;967
07;Balears (Illes);031;Llucmajor;21771;10804;10967
07;Balears (Illes);032;Maó;22358;10878;11480
07;Balears (Illes);033;Manacor;30177;14988;15189
07;Balears (Illes);034;Mancor de la Vall;936;453;483
07;Balears (Illes);035;Maria de la Salut;1733;861;872
07;Balears (Illes);036;Marratxí;18084;9101;8983
07;Balears (Illes);037;Mercadal (Es);2723;1353;1370
07;Balears (Illes);902;Migjorn Gran (Es);1126;576;550
07;Balears (Illes);038;Montuïri;2235;1105;1130
07;Balears (Illes);039;Muro;6028;2979;3049
07;Balears (Illes);040;Palma de Mallorca;319181;154748;164433
07;Balears (Illes);041;Petra;2571;1244;1327
07;Balears (Illes);044;Pobla (Sa);10064;5169;4895
07;Balears (Illes);042;Pollença;13450;6713;6737
07;Balears (Illes);043;Porreres;4226;2102;2124
07;Balears (Illes);045;Puigpunyent;1163;576;587
07;Balears (Illes);059;Salines (Ses);3240;1642;1598
07;Balears (Illes);046;Sant Antoni de Portmany;14849;7507;7342
07;Balears (Illes);049;Sant Joan;1662;826;836
07;Balears (Illes);050;Sant Joan de Labritja;3943;1991;1952
07;Balears (Illes);048;Sant Josep de sa Talaia;13364;6815;6549
07;Balears (Illes);051;Sant Llorenç des Cardassar;5594;2793;2801
07;Balears (Illes);052;Sant Lluís;4106;2058;2048
07;Balears (Illes);053;Santa Eugènia;1114;548;566
07;Balears (Illes);054;Santa Eulalia del Río;20306;10274;10032
07;Balears (Illes);055;Santa Margalida;7107;3532;3575
07;Balears (Illes);056;Santa María del Camí;4558;2243;2315
07;Balears (Illes);057;Santanyí;7974;4026;3948
07;Balears (Illes);058;Selva;2918;1425;1493
07;Balears (Illes);047;Sencelles;1969;1009;960
07;Balears (Illes);060;Sineu;2616;1278;1338
07;Balears (Illes);061;Sóller;11207;5565;5642
07;Balears (Illes);062;Son Servera;8065;4061;4004
07;Balears (Illes);063;Valldemossa;1599;779;820
07;Balears (Illes);065;Vilafranca de Bonany;2249;1101;1148
08;Barcelona;001;Abrera;7373;3791;3582
08;Barcelona;002;Aguilar de Segarra;211;104;107
08;Barcelona;014;Aiguafreda;2150;1047;1103
08;Barcelona;003;Alella;7889;3901;3988
08;Barcelona;004;Alpens;273;150;123
08;Barcelona;005;Ametlla del Vallès (L');5041;2477;2564
08;Barcelona;006;Arenys de Mar;12238;5904;6334
08;Barcelona;007;Arenys de Munt;5759;2837;2922
08;Barcelona;008;Argençola;163;79;84
08;Barcelona;009;Argentona;8959;4476;4483
08;Barcelona;010;Artés;4271;2123;2148
08;Barcelona;011;Avià;1813;919;894
08;Barcelona;012;Avinyó;2000;990;1010
08;Barcelona;013;Avinyonet del Penedès;1187;622;565
08;Barcelona;015;Badalona;209606;103498;106108
08;Barcelona;904;Badia del Vallès;16085;8110;7975
08;Barcelona;016;Bagà;2096;1014;1082
08;Barcelona;017;Balenyà;3119;1554;1565
08;Barcelona;018;Balsareny;3268;1613;1655
08;Barcelona;252;Barberà del Vallès;26112;13109;13003
08;Barcelona;019;Barcelona;1505581;703231;802350
08;Barcelona;020;Begues;3580;1812;1768
08;Barcelona;021;Bellprat;89;50;39
08;Barcelona;022;Berga;14173;6910;7263
08;Barcelona;023;Bigues i Riells;4629;2414;2215
08;Barcelona;024;Borredà;457;221;236
08;Barcelona;025;Bruc (El);928;483;445
08;Barcelona;026;Brull (El);191;104;87
08;Barcelona;027;Cabanyes (Les);505;268;237
08;Barcelona;029;Cabrera de Mar;3561;1809;1752
08;Barcelona;028;Cabrera d'Igualada;384;217;167
08;Barcelona;030;Cabrils;4112;1992;2120
08;Barcelona;031;Calaf;3055;1499;1556
08;Barcelona;034;Calders;698;365;333
08;Barcelona;033;Caldes de Montbui;12673;6261;6412
08;Barcelona;032;Caldes d'Estrac;1808;858;950
08;Barcelona;035;Calella;12187;5800;6387
08;Barcelona;037;Calldetenes;1872;950;922
08;Barcelona;038;Callús;1334;658;676
08;Barcelona;036;Calonge de Segarra;188;99;89
08;Barcelona;039;Campins;262;129;133
08;Barcelona;040;Canet de Mar;9613;4708;4905
08;Barcelona;041;Canovelles;13106;6599;6507
08;Barcelona;042;Cànoves i Samalús;1659;843;816
08;Barcelona;043;Canyelles;1534;810;724
08;Barcelona;044;Capellades;4974;2425;2549
08;Barcelona;045;Capolat;68;41;27
08;Barcelona;046;Cardedeu;11317;5630;5687
08;Barcelona;047;Cardona;5720;2775;2945
08;Barcelona;048;Carme;677;349;328
08;Barcelona;049;Casserres;1628;783;845
08;Barcelona;057;Castell de l'Areny;48;30;18
08;Barcelona;052;Castellar de n'Hug;175;87;88
08;Barcelona;050;Castellar del Riu;98;55;43
08;Barcelona;051;Castellar del Vallès;16224;8106;8118
08;Barcelona;053;Castellbell i el Vilar;2604;1294;1310
08;Barcelona;054;Castellbisbal;6702;3437;3265
08;Barcelona;055;Castellcir;335;188;147
08;Barcelona;056;Castelldefels;41194;20529;20665
08;Barcelona;058;Castellet i la Gornal;1308;658;650
08;Barcelona;060;Castellfollit de Riubregós;239;119;120
08;Barcelona;059;Castellfollit del Boix;364;178;186
08;Barcelona;061;Castellgalí;853;440;413
08;Barcelona;062;Castellnou de Bages;415;217;198
08;Barcelona;063;Castellolí;432;222;210
08;Barcelona;064;Castellterçol;2013;977;1036
08;Barcelona;065;Castellví de la Marca;1459;738;721
08;Barcelona;066;Castellví de Rosanes;996;515;481
08;Barcelona;067;Centelles;5728;2836;2892
08;Barcelona;268;Cercs;1483;727;756
08;Barcelona;266;Cerdanyola del Vallès;51305;25710;25595
08;Barcelona;068;Cervelló;7682;3870;3812
08;Barcelona;069;Collbató;1712;922;790
08;Barcelona;070;Collsuspina;262;134;128
08;Barcelona;071;Copons;271;130;141
08;Barcelona;072;Corbera de Llobregat;8246;4179;4067
08;Barcelona;073;Cornellà de Llobregat;80329;39415;40914
08;Barcelona;074;Cubelles;5390;2709;2681
08;Barcelona;075;Dosrius;2538;1304;1234
08;Barcelona;076;Esparreguera;15548;7835;7713
08;Barcelona;077;Esplugues de Llobregat;46304;22823;23481
08;Barcelona;078;Espunyola (L');282;145;137
08;Barcelona;079;Estany (L');390;185;205
08;Barcelona;134;Figaró-Montmany;777;409;368
08;Barcelona;080;Fígols;53;29;24
08;Barcelona;082;Fogars de la Selva;642;329;313
08;Barcelona;081;Fogars de Montclús;309;165;144
08;Barcelona;083;Folgueroles;1404;707;697
08;Barcelona;084;Fonollosa;852;434;418
08;Barcelona;085;Font-rubí;1225;630;595
08;Barcelona;086;Franqueses del Vallès (Les);11156;5581;5575
08;Barcelona;090;Gaià;164;88;76
08;Barcelona;087;Gallifa;157;84;73
08;Barcelona;088;Garriga (La);10929;5277;5652
08;Barcelona;089;Gavà;38813;19352;19461
08;Barcelona;091;Gelida;4220;2093;2127
08;Barcelona;092;Gironella;5001;2421;2580
08;Barcelona;093;Gisclareny;33;18;15
08;Barcelona;094;Granada (La);1325;634;691
08;Barcelona;095;Granera;59;37;22
08;Barcelona;096;Granollers;51600;25183;26417
08;Barcelona;097;Gualba;737;388;349
08;Barcelona;099;Guardiola de Berguedà;1003;507;496
08;Barcelona;100;Gurb;1852;943;909
08;Barcelona;101;Hospitalet de Llobregat (L');248521;121667;126854
08;Barcelona;162;Hostalets de Pierola (Els);1209;627;582
08;Barcelona;102;Igualada;32526;15774;16752
08;Barcelona;103;Jorba;575;272;303
08;Barcelona;104;Llacuna (La);811;417;394
08;Barcelona;105;Llagosta (La);11554;5739;5815
08;Barcelona;107;Lliçà d'Amunt;8530;4440;4090
08;Barcelona;108;Lliçà de Vall;4757;2440;2317
08;Barcelona;106;Llinars del Vallès;6468;3262;3206
08;Barcelona;109;Lluçà;281;154;127
08;Barcelona;110;Malgrat de Mar;13012;6442;6570
08;Barcelona;111;Malla;255;122;133
08;Barcelona;112;Manlleu;17172;8507;8665
08;Barcelona;113;Manresa;64067;30728;33339
08;Barcelona;242;Marganell;213;95;118
08;Barcelona;114;Martorell;18916;9501;9415
08;Barcelona;115;Martorelles;4912;2482;2430
08;Barcelona;116;Masies de Roda (Les);632;313;319
08;Barcelona;117;Masies de Voltregà (Les);2608;1272;1336
08;Barcelona;118;Masnou (El);20794;10011;10783
08;Barcelona;119;Masquefa;3764;1905;1859
08;Barcelona;120;Matadepera;6362;3192;3170
08;Barcelona;121;Mataró;103265;50636;52629
08;Barcelona;122;Mediona;1304;668;636
08;Barcelona;138;Moià;3846;1884;1962
08;Barcelona;123;Molins de Rei;18960;9322;9638
08;Barcelona;124;Mollet del Vallès;44170;22067;22103
08;Barcelona;128;Monistrol de Calders;614;299;315
08;Barcelona;127;Monistrol de Montserrat;2487;1251;1236
08;Barcelona;125;Montcada i Reixac;26886;13242;13644
08;Barcelona;130;Montclar;120;60;60
08;Barcelona;131;Montesquiu;850;421;429
08;Barcelona;126;Montgat;7783;3827;3956
08;Barcelona;132;Montmajor;488;249;239
08;Barcelona;133;Montmaneu;201;110;91
08;Barcelona;135;Montmeló;8059;4007;4052
08;Barcelona;136;Montornès del Vallès;12098;6052;6046
08;Barcelona;137;Montseny;286;150;136
08;Barcelona;129;Muntanyola;266;144;122
08;Barcelona;139;Mura;218;119;99
08;Barcelona;140;Navarcles;5312;2617;2695
08;Barcelona;141;Navàs;5792;2850;2942
08;Barcelona;142;Nou de Berguedà (La);151;80;71
08;Barcelona;143;Òdena;2667;1324;1343
08;Barcelona;145;Olèrdola;2058;1051;1007
08;Barcelona;146;Olesa de Bonesvalls;785;413;372
08;Barcelona;147;Olesa de Montserrat;16356;8227;8129
08;Barcelona;148;Olivella;1051;578;473
08;Barcelona;149;Olost;1199;586;613
08;Barcelona;144;Olvan;922;449;473
08;Barcelona;150;Orís;237;120;117
08;Barcelona;151;Oristà;662;328;334
08;Barcelona;152;Orpí;147;77;70
08;Barcelona;153;Òrrius;419;216;203
08;Barcelona;154;Pacs del Penedès;635;319;316
08;Barcelona;155;Palafolls;4612;2311;2301
08;Barcelona;156;Palau-solità i Plegamans;10393;5303;5090
08;Barcelona;157;Pallejà;7001;3501;3500
08;Barcelona;905;Palma de Cervelló (La);"";"";""
08;Barcelona;158;Papiol (El);3427;1700;1727
08;Barcelona;159;Parets del Vallès;13513;6824;6689
08;Barcelona;160;Perafita;336;167;169
08;Barcelona;161;Piera;8031;4089;3942
08;Barcelona;163;Pineda de Mar;18585;9279;9306
08;Barcelona;164;Pla del Penedès (El);917;459;458
08;Barcelona;165;Pobla de Claramunt (La);1657;840;817
08;Barcelona;166;Pobla de Lillet (La);1527;749;778
08;Barcelona;167;Polinyà;4246;2172;2074
08;Barcelona;182;Pont de Vilomara i Rocafort (El);2483;1263;1220
08;Barcelona;168;Pontons;299;160;139
08;Barcelona;169;Prat de Llobregat (El);62514;31227;31287
08;Barcelona;171;Prats de Lluçanès;2741;1348;1393
08;Barcelona;170;Prats de Rei (Els);558;274;284
08;Barcelona;230;Premià de Dalt;8043;4041;4002
08;Barcelona;172;Premià de Mar;25529;12735;12794
08;Barcelona;174;Puigdàlber;319;147;172
08;Barcelona;175;Puig-reig;4436;2137;2299
08;Barcelona;176;Pujalt;185;95;90
08;Barcelona;177;Quar (La);60;31;29
08;Barcelona;178;Rajadell;345;182;163
08;Barcelona;179;Rellinars;343;174;169
08;Barcelona;180;Ripollet;29155;14575;14580
08;Barcelona;181;Roca del Vallès (La);6953;3481;3472
08;Barcelona;183;Roda de Ter;5076;2448;2628
08;Barcelona;184;Rubí;55728;27890;27838
08;Barcelona;185;Rubió;118;61;57
08;Barcelona;901;Rupit i Pruit;343;173;170
08;Barcelona;187;Sabadell;184859;89881;94978
08;Barcelona;188;Sagàs;159;85;74
08;Barcelona;190;Saldes;346;190;156
08;Barcelona;191;Sallent;7287;3526;3761
08;Barcelona;194;Sant Adrià de Besòs;32830;16212;16618
08;Barcelona;195;Sant Agustí de Lluçanès;107;55;52
08;Barcelona;196;Sant Andreu de la Barca;18854;9602;9252
08;Barcelona;197;Sant Andreu de Llavaneres;6418;3183;3235
08;Barcelona;198;Sant Antoni de Vilamajor;3063;1528;1535
08;Barcelona;199;Sant Bartomeu del Grau;1224;657;567
08;Barcelona;200;Sant Boi de Llobregat;78632;39121;39511
08;Barcelona;201;Sant Boi de Lluçanès;554;275;279
08;Barcelona;203;Sant Cebrià de Vallalta;1470;780;690
08;Barcelona;202;Sant Celoni;12840;6382;6458
08;Barcelona;204;Sant Climent de Llobregat;2719;1342;1377
08;Barcelona;205;Sant Cugat del Vallès;50529;24904;25625
08;Barcelona;206;Sant Cugat Sesgarrigues;734;384;350
08;Barcelona;207;Sant Esteve de Palautordera;1324;668;656
08;Barcelona;208;Sant Esteve Sesrovires;4682;2517;2165
08;Barcelona;210;Sant Feliu de Codines;4115;2010;2105
08;Barcelona;211;Sant Feliu de Llobregat;35958;17753;18205
08;Barcelona;212;Sant Feliu Sasserra;648;318;330
08;Barcelona;209;Sant Fost de Campsentelles;5854;2965;2889
08;Barcelona;213;Sant Fruitós de Bages;5330;2662;2668
08;Barcelona;215;Sant Hipòlit de Voltregà;2947;1439;1508
08;Barcelona;193;Sant Iscle de Vallalta;725;383;342
08;Barcelona;216;Sant Jaume de Frontanyà;30;16;14
08;Barcelona;218;Sant Joan de Vilatorrada;8676;4351;4325
08;Barcelona;217;Sant Joan Despí;27338;13496;13842
08;Barcelona;903;Sant Julià de Cerdanyola;219;117;102
08;Barcelona;220;Sant Julià de Vilatorta;2141;1044;1097
08;Barcelona;221;Sant Just Desvern;13682;6611;7071
08;Barcelona;222;Sant Llorenç d'Hortons;1422;715;707
08;Barcelona;223;Sant Llorenç Savall;2027;987;1040
08;Barcelona;225;Sant Martí d'Albars;129;66;63
08;Barcelona;224;Sant Martí de Centelles;687;352;335
08;Barcelona;226;Sant Martí de Tous;952;471;481
08;Barcelona;227;Sant Martí Sarroca;2457;1240;1217
08;Barcelona;228;Sant Martí Sesgueioles;355;176;179
08;Barcelona;229;Sant Mateu de Bages;513;262;251
08;Barcelona;231;Sant Pere de Ribes;20213;10189;10024
08;Barcelona;232;Sant Pere de Riudebitlles;2082;1018;1064
08;Barcelona;233;Sant Pere de Torelló;2169;1046;1123
08;Barcelona;234;Sant Pere de Vilamajor;2178;1129;1049
08;Barcelona;189;Sant Pere Sallavinera;164;82;82
08;Barcelona;235;Sant Pol de Mar;3170;1623;1547
08;Barcelona;236;Sant Quintí de Mediona;1617;802;815
08;Barcelona;237;Sant Quirze de Besora;2005;973;1032
08;Barcelona;238;Sant Quirze del Vallès;11287;5620;5667
08;Barcelona;239;Sant Quirze Safaja;305;167;138
08;Barcelona;240;Sant Sadurní d'Anoia;9343;4651;4692
08;Barcelona;241;Sant Sadurní d'Osormort;76;42;34
08;Barcelona;098;Sant Salvador de Guardiola;1786;905;881
08;Barcelona;262;Sant Vicenç de Castellet;7386;3536;3850
08;Barcelona;264;Sant Vicenç de Montalt;2638;1334;1304
08;Barcelona;265;Sant Vicenç de Torelló;1729;825;904
08;Barcelona;263;Sant Vicenç dels Horts;23504;11809;11695
08;Barcelona;243;Santa Cecilia de Voltregà;198;111;87
08;Barcelona;244;Santa Coloma de Cervelló;3668;1825;1843
08;Barcelona;245;Santa Coloma de Gramenet;120958;60170;60788
08;Barcelona;246;Santa Eugènia de Berga;1938;997;941
08;Barcelona;247;Santa Eulàlia de Riuprimer;859;444;415
08;Barcelona;248;Santa Eulàlia de Ronçana;4178;2110;2068
08;Barcelona;249;Santa Fe del Penedès;261;126;135
08;Barcelona;250;Santa Margarida de Montbui;9216;4595;4621
08;Barcelona;251;Santa Margarida i els Monjos;4088;2091;1997
08;Barcelona;253;Santa Maria de Besora;175;88;87
08;Barcelona;254;Santa Maria de Corcó;2049;1032;1017
08;Barcelona;256;Santa Maria de Martorelles;692;335;357
08;Barcelona;255;Santa Maria de Merlès;169;83;86
08;Barcelona;257;Santa Maria de Miralles;94;45;49
08;Barcelona;259;Santa Maria de Palautordera;5795;2916;2879
08;Barcelona;258;Santa Maria d'Oló;988;501;487
08;Barcelona;260;Santa Perpètua de Mogoda;18233;9195;9038
08;Barcelona;261;Santa Susanna;1660;830;830
08;Barcelona;192;Santpedor;5156;2531;2625
08;Barcelona;267;Sentmenat;5363;2654;2709
08;Barcelona;269;Seva;2376;1211;1165
08;Barcelona;270;Sitges;17600;3693;13907
08;Barcelona;271;Sobremunt;95;47;48
08;Barcelona;272;Sora;181;96;85
08;Barcelona;273;Subirats;2376;1208;1168
08;Barcelona;274;Súria;6265;3069;3196
08;Barcelona;276;Tagamanent;195;108;87
08;Barcelona;277;Talamanca;79;42;37
08;Barcelona;278;Taradell;4854;2405;2449
08;Barcelona;275;Tavèrnoles;250;119;131
08;Barcelona;280;Tavertet;141;75;66
08;Barcelona;281;Teià;4847;2444;2403
08;Barcelona;279;Terrassa;165654;80719;84935
08;Barcelona;282;Tiana;5385;2678;2707
08;Barcelona;283;Tona;5799;2859;2940
08;Barcelona;284;Tordera;9181;4650;4531
08;Barcelona;285;Torelló;12031;5857;6174
08;Barcelona;286;Torre de Claramunt (La);2098;1089;1009
08;Barcelona;287;Torrelavit;1161;588;573
08;Barcelona;288;Torrelles de Foix;1702;901;801
08;Barcelona;289;Torrelles de Llobregat;3216;1623;1593
08;Barcelona;290;Ullastrell;1021;521;500
08;Barcelona;291;Vacarisses;2084;1093;991
08;Barcelona;292;Vallbona d'Anoia;1046;534;512
08;Barcelona;293;Vallcebre;285;155;130
08;Barcelona;294;Vallgorguina;1186;606;580
08;Barcelona;295;Vallirana;8914;4517;4397
08;Barcelona;296;Vallromanes;1127;583;544
08;Barcelona;297;Veciana;154;82;72
08;Barcelona;298;Vic;30739;14784;15955
08;Barcelona;299;Vilada;538;278;260
08;Barcelona;301;Viladecans;54840;27643;27197
08;Barcelona;300;Viladecavalls;5155;2593;2562
08;Barcelona;305;Vilafranca del Penedès;28925;14169;14756
08;Barcelona;306;Vilalba Sasserra;326;171;155
08;Barcelona;303;Vilanova de Sau;304;142;162
08;Barcelona;302;Vilanova del Camí;10056;5067;4989
08;Barcelona;902;Vilanova del Vallès;2169;1098;1071
08;Barcelona;307;Vilanova i la Geltrú;50244;24682;25562
08;Barcelona;214;Vilassar de Dalt;7264;3588;3676
08;Barcelona;219;Vilassar de Mar;16024;7892;8132
08;Barcelona;304;Vilobí del Penedès;852;438;414
08;Barcelona;308;Viver i Serrateix;184;98;86
09;Burgos;001;Abajas;34;16;18
09;Burgos;003;Adrada de Haza;295;157;138
09;Burgos;006;Aguas Cándidas;90;51;39
09;Burgos;007;Aguilar de Bureba;93;51;42
09;Burgos;009;Albillos;158;89;69
09;Burgos;010;Alcocero de Mola;57;34;23
09;Burgos;011;Alfoz de Bricia;136;63;73
09;Burgos;907;Alfoz de Quintanadueñas;601;316;285
09;Burgos;012;Alfoz de Santa Gadea;152;81;71
09;Burgos;013;Altable;61;38;23
09;Burgos;014;Altos (Los);236;138;98
09;Burgos;016;Ameyugo;60;32;28
09;Burgos;017;Anguix;155;77;78
09;Burgos;018;Aranda de Duero;29641;14765;14876
09;Burgos;019;Arandilla;191;110;81
09;Burgos;020;Arauzo de Miel;391;214;177
09;Burgos;021;Arauzo de Salce;78;45;33
09;Burgos;022;Arauzo de Torre;112;61;51
09;Burgos;023;Arcos;242;132;110
09;Burgos;024;Arenillas de Riopisuerga;239;128;111
09;Burgos;025;Arija;244;116;128
09;Burgos;026;Arlanzón;425;230;195
09;Burgos;027;Arraya de Oca;54;27;27
09;Burgos;029;Atapuerca;207;105;102
09;Burgos;030;Ausines (Los);130;73;57
09;Burgos;032;Avellanosa de Muñó;167;86;81
09;Burgos;033;Bahabón de Esgueva;141;82;59
09;Burgos;034;Balbases (Los);388;201;187
09;Burgos;035;Baños de Valdearados;491;270;221
09;Burgos;036;Bañuelos de Bureba;47;29;18
09;Burgos;037;Barbadillo de Herreros;156;85;71
09;Burgos;038;Barbadillo del Mercado;178;100;78
09;Burgos;039;Barbadillo del Pez;117;62;55
09;Burgos;041;Barrio de Muñó;35;21;14
09;Burgos;043;Barrios de Bureba (Los);282;152;130
09;Burgos;044;Barrios de Colina;74;41;33
09;Burgos;045;Basconcillos del Tozo;393;210;183
09;Burgos;046;Bascuñana;74;42;32
09;Burgos;047;Belbimbre;74;41;33
09;Burgos;048;Belorado;2092;1042;1050
09;Burgos;050;Berberana;85;41;44
09;Burgos;051;Berlangas de Roa;277;142;135
09;Burgos;052;Berzosa de Bureba;53;31;22
09;Burgos;054;Bozoó;107;58;49
09;Burgos;055;Brazacorta;106;59;47
09;Burgos;056;Briviesca;6105;3033;3072
09;Burgos;057;Bugedo;100;72;28
09;Burgos;058;Buniel;169;91;78
09;Burgos;059;Burgos;161984;78133;83851
09;Burgos;060;Busto de Bureba;252;131;121
09;Burgos;061;Cabañes de Esgueva;279;146;133
09;Burgos;062;Cabezón de la Sierra;75;34;41
09;Burgos;063;Cabia;243;129;114
09;Burgos;064;Caleruega;431;230;201
09;Burgos;065;Campillo de Aranda;196;104;92
09;Burgos;066;Campolara;105;57;48
09;Burgos;067;Canicosa de la Sierra;635;326;309
09;Burgos;068;Cantabrana;58;31;27
09;Burgos;070;Carazo;47;26;21
09;Burgos;071;Carcedo de Bureba;36;19;17
09;Burgos;072;Carcedo de Burgos;142;81;61
09;Burgos;073;Cardeñadijo;478;246;232
09;Burgos;074;Cardeñajimeno;400;213;187
09;Burgos;075;Cardeñuela Riopico;72;35;37
09;Burgos;076;Carrias;52;35;17
09;Burgos;077;Cascajares de Bureba;62;35;27
09;Burgos;078;Cascajares de la Sierra;22;9;13
09;Burgos;079;Castellanos de Castro;71;39;32
09;Burgos;083;Castil de Peones;34;17;17
09;Burgos;082;Castildelgado;80;40;40
09;Burgos;084;Castrillo de la Reina;302;184;118
09;Burgos;085;Castrillo de la Vega;593;319;274
09;Burgos;088;Castrillo de Riopisuerga;96;51;45
09;Burgos;086;Castrillo del Val;382;214;168
09;Burgos;090;Castrillo Matajudíos;81;41;40
09;Burgos;091;Castrojeriz;1041;535;506
09;Burgos;093;Cayuela;122;71;51
09;Burgos;094;Cebrecos;78;47;31
09;Burgos;095;Celada del Camino;92;42;50
09;Burgos;098;Cerezo de Río Tirón;791;420;371
09;Burgos;100;Cerratón de Juarros;72;39;33
09;Burgos;101;Ciadoncha;135;79;56
09;Burgos;102;Cillaperlata;74;40;34
09;Burgos;103;Cilleruelo de Abajo;339;189;150
09;Burgos;104;Cilleruelo de Arriba;93;50;43
09;Burgos;105;Ciruelos de Cervera;171;89;82
09;Burgos;108;Cogollos;221;121;100
09;Burgos;109;Condado de Treviño;915;514;401
09;Burgos;110;Contreras;121;77;44
09;Burgos;112;Coruña del Conde;164;90;74
09;Burgos;113;Covarrubias;634;331;303
09;Burgos;114;Cubillo del Campo;73;41;32
09;Burgos;115;Cubo de Bureba;127;64;63
09;Burgos;117;Cueva de Roa (La);118;67;51
09;Burgos;119;Cuevas de San Clemente;66;31;35
09;Burgos;120;Encío;60;32;28
09;Burgos;122;Espinosa de Cervera;117;70;47
09;Burgos;124;Espinosa de los Monteros;2236;1143;1093
09;Burgos;123;Espinosa del Camino;47;24;23
09;Burgos;125;Estépar;851;455;396
09;Burgos;127;Fontioso;90;49;41
09;Burgos;128;Frandovínez;95;52;43
09;Burgos;129;Fresneda de la Sierra Tirón;103;57;46
09;Burgos;130;Fresneña;120;66;54
09;Burgos;131;Fresnillo de las Dueñas;301;155;146
09;Burgos;132;Fresno de Río Tirón;268;154;114
09;Burgos;133;Fresno de Rodilla;37;21;16
09;Burgos;134;Frías;312;167;145
09;Burgos;135;Fuentebureba;80;38;42
09;Burgos;136;Fuentecén;289;158;131
09;Burgos;137;Fuentelcésped;198;94;104
09;Burgos;138;Fuentelisendo;115;57;58
09;Burgos;139;Fuentemolinos;127;73;54
09;Burgos;140;Fuentenebro;207;111;96
09;Burgos;141;Fuentespina;597;318;279
09;Burgos;143;Galbarros;33;23;10
09;Burgos;144;Gallega (La);98;57;41
09;Burgos;148;Grijalba;134;65;69
09;Burgos;149;Grisaleña;51;32;19
09;Burgos;151;Gumiel de Izán;629;336;293
09;Burgos;152;Gumiel de Mercado;401;216;185
09;Burgos;154;Hacinas;213;116;97
09;Burgos;155;Haza;44;21;23
09;Burgos;159;Hontanas;77;41;36
09;Burgos;160;Hontangas;153;88;65
09;Burgos;162;Hontoria de la Cantera;124;64;60
09;Burgos;164;Hontoria de Valdearados;234;143;91
09;Burgos;163;Hontoria del Pinar;920;491;429
09;Burgos;166;Hormazas (Las);148;80;68
09;Burgos;167;Hornillos del Camino;77;43;34
09;Burgos;168;Horra (La);458;239;219
09;Burgos;169;Hortigüela;125;80;45
09;Burgos;170;Hoyales de Roa;313;153;160
09;Burgos;172;Huérmeces;153;85;68
09;Burgos;173;Huerta de Arriba;195;101;94
09;Burgos;174;Huerta de Rey;1181;621;560
09;Burgos;175;Humada;237;137;100
09;Burgos;176;Hurones;61;39;22
09;Burgos;177;Ibeas de Juarros;979;537;442
09;Burgos;178;Ibrillos;100;58;42
09;Burgos;179;Iglesiarrubia;67;35;32
09;Burgos;180;Iglesias;187;102;85
09;Burgos;181;Isar;436;203;233
09;Burgos;182;Itero del Castillo;128;68;60
09;Burgos;183;Jaramillo de la Fuente;33;20;13
09;Burgos;184;Jaramillo Quemado;17;13;4
09;Burgos;189;Junta de Traslaloma;208;111;97
09;Burgos;190;Junta de Villalba de Losa;96;47;49
09;Burgos;191;Jurisdicción de Lara;82;47;35
09;Burgos;192;Jurisdicción de San Zadornil;102;51;51
09;Burgos;194;Lerma;2530;1262;1268
09;Burgos;195;Llano de Bureba;61;35;26
09;Burgos;196;Madrigal del Monte;192;104;88
09;Burgos;197;Madrigalejo del Monte;170;94;76
09;Burgos;198;Mahamud;168;84;84
09;Burgos;199;Mambrilla de Castrejón;159;82;77
09;Burgos;200;Mambrillas de Lara;80;40;40
09;Burgos;201;Mamolar;78;41;37
09;Burgos;202;Manciles;51;28;23
09;Burgos;206;Mazuela;89;48;41
09;Burgos;208;Mecerreyes;311;161;150
09;Burgos;209;Medina de Pomar;5026;2518;2508
09;Burgos;211;Melgar de Fernamental;2038;1041;997
09;Burgos;213;Merindad de Cuesta-Urria;509;289;220
09;Burgos;214;Merindad de Montija;972;531;441
09;Burgos;906;Merindad de Río Ubierna;1245;634;611
09;Burgos;215;Merindad de Sotoscueva;599;318;281
09;Burgos;216;Merindad de Valdeporres;528;274;254
09;Burgos;217;Merindad de Valdivielso;573;297;276
09;Burgos;218;Milagros;454;242;212
09;Burgos;219;Miranda de Ebro;35397;17483;17914
09;Burgos;220;Miraveche;116;65;51
09;Burgos;221;Modúbar de la Emparedada;250;137;113
09;Burgos;223;Monasterio de la Sierra;37;22;15
09;Burgos;224;Monasterio de Rodilla;229;126;103
09;Burgos;225;Moncalvillo;132;78;54
09;Burgos;226;Monterrubio de la Demanda;90;49;41
09;Burgos;227;Montorio;166;82;84
09;Burgos;228;Moradillo de Roa;224;120;104
09;Burgos;229;Nava de Roa;275;145;130
09;Burgos;230;Navas de Bureba;52;26;26
09;Burgos;231;Nebreda;108;67;41
09;Burgos;232;Neila;232;111;121
09;Burgos;235;Olmedillo de Roa;221;117;104
09;Burgos;236;Olmillos de Muñó;46;25;21
09;Burgos;238;Oña;1674;837;837
09;Burgos;239;Oquillas;78;41;37
09;Burgos;241;Orbaneja Riopico;137;75;62
09;Burgos;242;Padilla de Abajo;104;61;43
09;Burgos;243;Padilla de Arriba;134;71;63
09;Burgos;244;Padrones de Bureba;79;43;36
09;Burgos;246;Palacios de la Sierra;913;477;436
09;Burgos;247;Palacios de Riopisuerga;31;16;15
09;Burgos;248;Palazuelos de la Sierra;64;32;32
09;Burgos;249;Palazuelos de Muñó;73;41;32
09;Burgos;250;Pampliega;427;214;213
09;Burgos;251;Pancorbo;509;265;244
09;Burgos;253;Pardilla;123;67;56
09;Burgos;255;Partido de la Sierra en Tobalina;83;49;34
09;Burgos;256;Pedrosa de Duero;587;305;282
09;Burgos;259;Pedrosa de Río Úrbel;284;158;126
09;Burgos;257;Pedrosa del Páramo;120;68;52
09;Burgos;258;Pedrosa del Príncipe;301;158;143
09;Burgos;261;Peñaranda de Duero;611;326;285
09;Burgos;262;Peral de Arlanza;256;131;125
09;Burgos;265;Piérnigas;47;30;17
09;Burgos;266;Pineda de la Sierra;125;68;57
09;Burgos;267;Pineda Trasmonte;191;100;91
09;Burgos;268;Pinilla de los Barruecos;137;72;65
09;Burgos;269;Pinilla de los Moros;49;32;17
09;Burgos;270;Pinilla Trasmonte;233;128;105
09;Burgos;272;Poza de la Sal;381;192;189
09;Burgos;273;Prádanos de Bureba;74;41;33
09;Burgos;274;Pradoluengo;1732;842;890
09;Burgos;275;Presencio;291;154;137
09;Burgos;276;Puebla de Arganzón (La);275;152;123
09;Burgos;277;Puentedura;128;69;59
09;Burgos;279;Quemada;260;145;115
09;Burgos;281;Quintana del Pidio;200;107;93
09;Burgos;280;Quintanabureba;36;20;16
09;Burgos;283;Quintanaélez;108;52;56
09;Burgos;287;Quintanaortuño;127;65;62
09;Burgos;288;Quintanapalla;123;66;57
09;Burgos;289;Quintanar de la Sierra;2154;1112;1042
09;Burgos;292;Quintanavides;90;43;47
09;Burgos;294;Quintanilla de la Mata;170;94;76
09;Burgos;901;Quintanilla del Agua y Tordueles;599;315;284
09;Burgos;295;Quintanilla del Coco;119;60;59
09;Burgos;298;Quintanilla San García;113;54;59
09;Burgos;301;Quintanilla Vivar;361;181;180
09;Burgos;297;Quintanillas (Las);344;181;163
09;Burgos;302;Rabanera del Pinar;140;74;66
09;Burgos;303;Rábanos;93;57;36
09;Burgos;304;Rabé de las Calzadas;182;97;85
09;Burgos;306;Rebolledo de la Torre;168;91;77
09;Burgos;307;Redecilla del Camino;150;88;62
09;Burgos;308;Redecilla del Campo;96;50;46
09;Burgos;309;Regumiel de la Sierra;510;256;254
09;Burgos;310;Reinoso;26;18;8
09;Burgos;311;Retuerta;82;46;36
09;Burgos;314;Revilla del Campo;134;66;68
09;Burgos;316;Revilla Vallejera;179;101;78
09;Burgos;312;Revilla y Ahedo (La);126;69;57
09;Burgos;315;Revillarruz;146;76;70
09;Burgos;317;Rezmondo;24;11;13
09;Burgos;318;Riocavado de la Sierra;76;40;36
09;Burgos;321;Roa;2299;1177;1122
09;Burgos;323;Rojas;102;57;45
09;Burgos;325;Royuela de Río Franco;352;196;156
09;Burgos;326;Rubena;156;79;77
09;Burgos;327;Rublacedo de Abajo;41;21;20
09;Burgos;328;Rucandio;118;60;58
09;Burgos;329;Salas de Bureba;173;97;76
09;Burgos;330;Salas de los Infantes;2091;1044;1047
09;Burgos;332;Saldaña de Burgos;107;57;50
09;Burgos;334;Salinillas de Bureba;71;39;32
09;Burgos;335;San Adrián de Juarros;47;24;23
09;Burgos;337;San Juan del Monte;171;90;81
09;Burgos;338;San Mamés de Burgos;171;97;74
09;Burgos;339;San Martín de Rubiales;272;140;132
09;Burgos;340;San Millán de Lara;81;52;29
09;Burgos;360;San Vicente del Valle;42;27;15
09;Burgos;343;Santa Cecilia;132;73;59
09;Burgos;345;Santa Cruz de la Salceda;200;111;89
09;Burgos;346;Santa Cruz del Valle Urbión;132;79;53
09;Burgos;347;Santa Gadea del Cid;190;101;89
09;Burgos;348;Santa Inés;209;111;98
09;Burgos;350;Santa María del Campo;725;373;352
09;Burgos;351;Santa María del Invierno;61;37;24
09;Burgos;352;Santa María del Mercadillo;193;111;82
09;Burgos;353;Santa María Rivarredonda;137;76;61
09;Burgos;354;Santa Olalla de Bureba;40;16;24
09;Burgos;355;Santibáñez de Esgueva;173;86;87
09;Burgos;356;Santibáñez del Val;62;38;24
09;Burgos;358;Santo Domingo de Silos;313;198;115
09;Burgos;361;Sargentes de la Lora;175;99;76
09;Burgos;362;Sarracín;176;102;74
09;Burgos;363;Sasamón;1543;835;708
09;Burgos;365;Sequera de Haza (La);68;39;29
09;Burgos;366;Solarana;117;66;51
09;Burgos;368;Sordillos;40;24;16
09;Burgos;369;Sotillo de la Ribera;632;351;281
09;Burgos;372;Sotragero;155;84;71
09;Burgos;373;Sotresgudo;765;412;353
09;Burgos;374;Susinos del Páramo;106;48;58
09;Burgos;375;Tamarón;51;32;19
09;Burgos;377;Tardajos;676;364;312
09;Burgos;378;Tejada;51;30;21
09;Burgos;380;Terradillos de Esgueva;130;65;65
09;Burgos;381;Tinieblas de la Sierra;47;22;25
09;Burgos;382;Tobar;52;29;23
09;Burgos;384;Tordómar;416;233;183
09;Burgos;386;Torrecilla del Monte;75;42;33
09;Burgos;387;Torregalindo;144;83;61
09;Burgos;388;Torrelara;32;17;15
09;Burgos;389;Torrepadre;143;77;66
09;Burgos;390;Torresandino;826;444;382
09;Burgos;391;Tórtoles de Esgueva;563;316;247
09;Burgos;392;Tosantos;74;38;36
09;Burgos;394;Trespaderne;1126;588;538
09;Burgos;395;Tubilla del Agua;159;107;52
09;Burgos;396;Tubilla del Lago;206;109;97
09;Burgos;398;Úrbel del Castillo;102;57;45
09;Burgos;400;Vadocondes;460;238;222
09;Burgos;403;Valdeande;153;86;67
09;Burgos;405;Valdezate;212;111;101
09;Burgos;406;Valdorros;125;71;54
09;Burgos;408;Vallarta de Bureba;73;41;32
09;Burgos;904;Valle de las Navas;650;359;291
09;Burgos;908;Valle de Losa;691;396;295
09;Burgos;409;Valle de Manzanedo;122;66;56
09;Burgos;410;Valle de Mena;3338;1705;1633
09;Burgos;411;Valle de Oca;222;109;113
09;Burgos;902;Valle de Santibáñez;643;325;318
09;Burgos;905;Valle de Sedano;523;279;244
09;Burgos;412;Valle de Tobalina;1111;584;527
09;Burgos;413;Valle de Valdebezana;759;413;346
09;Burgos;414;Valle de Valdelaguna;251;135;116
09;Burgos;415;Valle de Valdelucio;371;199;172
09;Burgos;416;Valle de Zamanzas;76;46;30
09;Burgos;417;Vallejera;62;34;28
09;Burgos;418;Valles de Palenzuela;108;55;53
09;Burgos;419;Valluércanes;125;68;57
09;Burgos;407;Valmala;33;15;18
09;Burgos;422;Vid de Bureba (La);47;23;24
09;Burgos;421;Vid y Barrios (La);345;194;151
09;Burgos;423;Vileña;42;26;16
09;Burgos;427;Villadiego;2050;1122;928
09;Burgos;428;Villaescusa de Roa;184;105;79
09;Burgos;429;Villaescusa la Sombría;61;35;26
09;Burgos;430;Villaespasa;32;16;16
09;Burgos;431;Villafranca Montes de Oca;205;105;100
09;Burgos;432;Villafruela;311;176;135
09;Burgos;433;Villagalijo;77;49;28
09;Burgos;434;Villagonzalo Pedernales;707;351;356
09;Burgos;437;Villahoz;425;216;209
09;Burgos;438;Villalba de Duero;559;299;260
09;Burgos;439;Villalbilla de Burgos;679;368;311
09;Burgos;440;Villalbilla de Gumiel;136;77;59
09;Burgos;441;Villaldemiro;85;45;40
09;Burgos;442;Villalmanzo;502;275;227
09;Burgos;443;Villamayor de los Montes;266;131;135
09;Burgos;444;Villamayor de Treviño;116;65;51
09;Burgos;445;Villambistia;83;48;35
09;Burgos;446;Villamedianilla;28;13;15
09;Burgos;447;Villamiel de la Sierra;42;24;18
09;Burgos;448;Villangómez;336;184;152
09;Burgos;449;Villanueva de Argaño;122;64;58
09;Burgos;450;Villanueva de Carazo;23;14;9
09;Burgos;451;Villanueva de Gumiel;310;160;150
09;Burgos;454;Villanueva de Teba;73;41;32
09;Burgos;455;Villaquirán de la Puebla;72;40;32
09;Burgos;456;Villaquirán de los Infantes;192;96;96
09;Burgos;903;Villarcayo de Merindad de Castilla la Vieja;3798;1906;1892
09;Burgos;458;Villariezo;167;89;78
09;Burgos;460;Villasandino;266;132;134
09;Burgos;463;Villasur de Herreros;301;171;130
09;Burgos;464;Villatuelda;78;42;36
09;Burgos;466;Villaverde del Monte;201;107;94
09;Burgos;467;Villaverde-Mogina;134;82;52
09;Burgos;471;Villayerno Morquillas;135;69;66
09;Burgos;472;Villazopeque;95;54;41
09;Burgos;473;Villegas;135;73;62
09;Burgos;476;Villoruebo;52;33;19
09;Burgos;424;Viloria de Rioja;72;40;32
09;Burgos;425;Vilviestre del Pinar;789;411;378
09;Burgos;478;Vizcaínos;67;35;32
09;Burgos;480;Zael;154;80;74
09;Burgos;482;Zarzosa de Río Pisuerga;62;36;26
09;Burgos;483;Zazuar;246;128;118
09;Burgos;485;Zuñeda;87;45;42
10;Cáceres;001;Abadía;278;156;122
10;Cáceres;002;Abertura;510;275;235
10;Cáceres;003;Acebo;788;419;369
10;Cáceres;004;Acehúche;966;486;480
10;Cáceres;005;Aceituna;732;376;356
10;Cáceres;006;Ahigal;1684;869;815
10;Cáceres;903;Alagón del Río;"";"";""
10;Cáceres;007;Albalá del Caudillo;832;400;432
10;Cáceres;008;Alcántara;1829;937;892
10;Cáceres;009;Alcollarín;364;172;192
10;Cáceres;010;Alcuéscar;3110;1613;1497
10;Cáceres;012;Aldea del Cano;760;376;384
10;Cáceres;013;Aldea del Obispo (La);415;220;195
10;Cáceres;011;Aldeacentenera;1002;509;493
10;Cáceres;014;Aldeanueva de la Vera;2526;1251;1275
10;Cáceres;015;Aldeanueva del Camino;906;467;439
10;Cáceres;016;Aldehuela de Jerte;388;220;168
10;Cáceres;017;Alía;1371;682;689
10;Cáceres;018;Aliseda;2373;1188;1185
10;Cáceres;019;Almaraz;1433;744;689
10;Cáceres;020;Almoharín;2003;994;1009
10;Cáceres;021;Arroyo de la Luz;6446;3228;3218
10;Cáceres;023;Arroyomolinos;1085;549;536
10;Cáceres;022;Arroyomolinos de la Vera;604;300;304
10;Cáceres;024;Baños de Montemayor;712;361;351
10;Cáceres;025;Barrado;565;291;274
10;Cáceres;026;Belvís de Monroy;598;308;290
10;Cáceres;027;Benquerencia;104;62;42
10;Cáceres;028;Berrocalejo;131;59;72
10;Cáceres;029;Berzocana;660;336;324
10;Cáceres;030;Bohonal de Ibor;620;319;301
10;Cáceres;031;Botija;182;80;102
10;Cáceres;032;Brozas;2407;1203;1204
10;Cáceres;033;Cabañas del Castillo;575;292;283
10;Cáceres;034;Cabezabellosa;498;250;248
10;Cáceres;035;Cabezuela del Valle;2414;1250;1164
10;Cáceres;036;Cabrero;455;239;216
10;Cáceres;037;Cáceres;78614;37864;40750
10;Cáceres;038;Cachorrilla;100;47;53
10;Cáceres;039;Cadalso;592;308;284
10;Cáceres;040;Calzadilla;535;275;260
10;Cáceres;041;Caminomorisco;1297;690;607
10;Cáceres;042;Campillo de Deleitosa;144;70;74
10;Cáceres;043;Campo Lugar;1221;613;608
10;Cáceres;044;Cañamero;1959;1011;948
10;Cáceres;045;Cañaveral;1533;754;779
10;Cáceres;046;Carbajo;283;150;133
10;Cáceres;047;Carcaboso;1145;660;485
10;Cáceres;048;Carrascalejo;437;221;216
10;Cáceres;049;Casar de Cáceres;4641;2323;2318
10;Cáceres;050;Casar de Palomero;1353;679;674
10;Cáceres;051;Casares de las Hurdes;798;401;397
10;Cáceres;052;Casas de Don Antonio;235;110;125
10;Cáceres;053;Casas de Don Gómez;371;193;178
10;Cáceres;056;Casas de Millán;812;422;390
10;Cáceres;057;Casas de Miravete;163;87;76
10;Cáceres;054;Casas del Castañar;741;369;372
10;Cáceres;055;Casas del Monte;926;479;447
10;Cáceres;058;Casatejada;1277;638;639
10;Cáceres;059;Casillas de Coria;539;249;290
10;Cáceres;060;Castañar de Ibor;1388;710;678
10;Cáceres;061;Ceclavín;2149;1134;1015
10;Cáceres;062;Cedillo;545;281;264
10;Cáceres;063;Cerezo;238;112;126
10;Cáceres;064;Cilleros;2206;1112;1094
10;Cáceres;065;Collado;231;124;107
10;Cáceres;066;Conquista de la Sierra;183;87;96
10;Cáceres;067;Coria;11811;5934;5877
10;Cáceres;068;Cuacos de Yuste;933;498;435
10;Cáceres;069;Cumbre (La);1167;579;588
10;Cáceres;070;Deleitosa;953;476;477
10;Cáceres;071;Descargamaría;268;138;130
10;Cáceres;072;Eljas;1260;638;622
10;Cáceres;073;Escurial;947;474;473
10;Cáceres;075;Fresnedoso de Ibor;448;226;222
10;Cáceres;076;Galisteo;2002;1012;990
10;Cáceres;077;Garciaz;1038;532;506
10;Cáceres;078;Garganta (La);604;337;267
10;Cáceres;079;Garganta la Olla;1068;560;508
10;Cáceres;080;Gargantilla;501;267;234
10;Cáceres;081;Gargüera;202;103;99
10;Cáceres;082;Garrovillas de Alconétar;2488;1196;1292
10;Cáceres;083;Garvín;122;70;52
10;Cáceres;084;Gata;1950;979;971
10;Cáceres;085;Gordo (El);304;150;154
10;Cáceres;086;Granja (La);432;243;189
10;Cáceres;087;Guadalupe;2414;1198;1216
10;Cáceres;088;Guijo de Coria;297;157;140
10;Cáceres;089;Guijo de Galisteo;1836;936;900
10;Cáceres;090;Guijo de Granadilla;761;374;387
10;Cáceres;091;Guijo de Santa Bárbara;501;250;251
10;Cáceres;092;Herguijuela;445;218;227
10;Cáceres;093;Hernán-Pérez;496;258;238
10;Cáceres;094;Herrera de Alcántara;340;170;170
10;Cáceres;095;Herreruela;477;251;226
10;Cáceres;096;Hervás;3934;1917;2017
10;Cáceres;097;Higuera;120;65;55
10;Cáceres;098;Hinojal;446;212;234
10;Cáceres;099;Holguera;847;422;425
10;Cáceres;100;Hoyos;1001;512;489
10;Cáceres;101;Huélaga;208;107;101
10;Cáceres;102;Ibahernando;761;373;388
10;Cáceres;103;Jaraicejo;672;327;345
10;Cáceres;104;Jaraíz de la Vera;6768;3446;3322
10;Cáceres;105;Jarandilla de la Vera;3228;1620;1608
10;Cáceres;106;Jarilla;199;106;93
10;Cáceres;107;Jerte;1377;719;658
10;Cáceres;108;Ladrillar;327;180;147
10;Cáceres;109;Logrosán;2629;1332;1297
10;Cáceres;110;Losar de la Vera;3007;1514;1493
10;Cáceres;111;Madrigal de la Vera;1521;872;649
10;Cáceres;112;Madrigalejo;2247;1105;1142
10;Cáceres;113;Madroñera;3165;1584;1581
10;Cáceres;114;Majadas;1237;686;551
10;Cáceres;115;Malpartida de Cáceres;4361;2189;2172
10;Cáceres;116;Malpartida de Plasencia;4191;2043;2148
10;Cáceres;117;Marchagaz;398;194;204
10;Cáceres;118;Mata de Alcántara;398;201;197
10;Cáceres;119;Membrío;907;430;477
10;Cáceres;120;Mesas de Ibor;202;110;92
10;Cáceres;121;Miajadas;9629;4817;4812
10;Cáceres;122;Millanes;253;143;110
10;Cáceres;123;Mirabel;861;422;439
10;Cáceres;124;Mohedas de Granadilla;1163;588;575
10;Cáceres;125;Monroy;1253;666;587
10;Cáceres;126;Montánchez;2233;1102;1131
10;Cáceres;127;Montehermoso;5211;2639;2572
10;Cáceres;128;Moraleja;8355;4138;4217
10;Cáceres;129;Morcillo;505;253;252
10;Cáceres;130;Navaconcejo;2176;1103;1073
10;Cáceres;131;Navalmoral de la Mata;14874;7402;7472
10;Cáceres;132;Navalvillar de Ibor;553;288;265
10;Cáceres;133;Navas del Madroño;1575;793;782
10;Cáceres;134;Navezuelas;755;395;360
10;Cáceres;135;Nuñomoral;2013;1064;949
10;Cáceres;136;Oliva de Plasencia;327;164;163
10;Cáceres;137;Palomero;580;295;285
10;Cáceres;138;Pasarón de la Vera;714;357;357
10;Cáceres;139;Pedroso de Acim;147;78;69
10;Cáceres;140;Peraleda de la Mata;1454;727;727
10;Cáceres;141;Peraleda de San Román;431;211;220
10;Cáceres;142;Perales del Puerto;1026;508;518
10;Cáceres;143;Pescueza;224;105;119
10;Cáceres;144;Pesga (La);1290;732;558
10;Cáceres;145;Piedras Albas;226;107;119
10;Cáceres;146;Pinofranqueado;1793;975;818
10;Cáceres;147;Piornal;1560;774;786
10;Cáceres;148;Plasencia;36465;17841;18624
10;Cáceres;149;Plasenzuela;514;235;279
10;Cáceres;150;Portaje;416;204;212
10;Cáceres;151;Portezuelo;328;159;169
10;Cáceres;152;Pozuelo de Zarzón;649;312;337
10;Cáceres;153;Puerto de Santa Cruz;440;212;228
10;Cáceres;154;Rebollar;251;129;122
10;Cáceres;155;Riolobos;1567;833;734
10;Cáceres;156;Robledillo de Gata;174;92;82
10;Cáceres;157;Robledillo de la Vera;367;180;187
10;Cáceres;158;Robledillo de Trujillo;462;247;215
10;Cáceres;159;Robledollano;453;246;207
10;Cáceres;160;Romangordo;197;94;103
10;Cáceres;901;Rosalejo;1854;1045;809
10;Cáceres;161;Ruanes;112;58;54
10;Cáceres;162;Salorino;852;421;431
10;Cáceres;163;Salvatierra de Santiago;434;223;211
10;Cáceres;164;San Martín de Trevejo;1018;518;500
10;Cáceres;165;Santa Ana;397;199;198
10;Cáceres;166;Santa Cruz de la Sierra;375;193;182
10;Cáceres;167;Santa Cruz de Paniagua;467;250;217
10;Cáceres;168;Santa Marta de Magasca;382;192;190
10;Cáceres;169;Santiago de Alcántara;789;391;398
10;Cáceres;170;Santiago del Campo;340;173;167
10;Cáceres;171;Santibáñez el Alto;535;274;261
10;Cáceres;172;Santibáñez el Bajo;1013;526;487
10;Cáceres;173;Saucedilla;617;313;304
10;Cáceres;174;Segura de Toro;220;119;101
10;Cáceres;175;Serradilla;1974;1002;972
10;Cáceres;176;Serrejón;525;274;251
10;Cáceres;177;Sierra de Fuentes;1677;860;817
10;Cáceres;178;Talaván;1033;514;519
10;Cáceres;179;Talaveruela de la Vera;468;219;249
10;Cáceres;180;Talayuela;7005;3913;3092
10;Cáceres;181;Tejeda de Tiétar;1025;554;471
10;Cáceres;182;Toril;224;143;81
10;Cáceres;183;Tornavacas;1341;712;629
10;Cáceres;184;Torno (El);980;505;475
10;Cáceres;187;Torre de Don Miguel;654;329;325
10;Cáceres;188;Torre de Santa María;765;380;385
10;Cáceres;185;Torrecilla de los Ángeles;706;358;348
10;Cáceres;186;Torrecillas de la Tiesa;1266;640;626
10;Cáceres;190;Torrejón el Rubio;726;377;349
10;Cáceres;189;Torrejoncillo;3633;1775;1858
10;Cáceres;191;Torremenga;585;326;259
10;Cáceres;192;Torremocha;1254;597;657
10;Cáceres;193;Torreorgaz;1571;803;768
10;Cáceres;194;Torrequemada;615;293;322
10;Cáceres;195;Trujillo;9070;4366;4704
10;Cáceres;196;Valdastillas;419;209;210
10;Cáceres;197;Valdecañas de Tajo;140;77;63
10;Cáceres;198;Valdefuentes;1583;796;787
10;Cáceres;199;Valdehúncar;178;87;91
10;Cáceres;200;Valdelacasa de Tajo;583;277;306
10;Cáceres;201;Valdemorales;282;140;142
10;Cáceres;202;Valdeobispo;843;413;430
10;Cáceres;203;Valencia de Alcántara;6226;3047;3179
10;Cáceres;204;Valverde de la Vera;564;292;272
10;Cáceres;205;Valverde del Fresno;2630;1336;1294
10;Cáceres;902;Vegaviana;"";"";""
10;Cáceres;206;Viandar de la Vera;333;156;177
10;Cáceres;207;Villa del Campo;672;332;340
10;Cáceres;208;Villa del Rey;183;97;86
10;Cáceres;209;Villamesías;393;196;197
10;Cáceres;210;Villamiel;849;486;363
10;Cáceres;211;Villanueva de la Sierra;615;294;321
10;Cáceres;212;Villanueva de la Vera;2003;1000;1003
10;Cáceres;214;Villar de Plasencia;303;151;152
10;Cáceres;213;Villar del Pedroso;856;429;427
10;Cáceres;215;Villasbuenas de Gata;518;266;252
10;Cáceres;216;Zarza de Granadilla;1862;959;903
10;Cáceres;217;Zarza de Montánchez;660;326;334
10;Cáceres;218;Zarza la Mayor;1732;863;869
10;Cáceres;219;Zorita;2025;996;1029
11;Cádiz;001;Alcalá de los Gazules;5578;2894;2684
11;Cádiz;002;Alcalá del Valle;5277;2711;2566
11;Cádiz;003;Algar;1833;993;840
11;Cádiz;004;Algeciras;101972;50124;51848
11;Cádiz;005;Algodonales;5680;2923;2757
11;Cádiz;006;Arcos de la Frontera;27897;14007;13890
11;Cádiz;007;Barbate;21916;10922;10994
11;Cádiz;008;Barrios (Los);16083;8118;7965
11;Cádiz;901;Benalup-Casas Viejas;6179;3144;3035
11;Cádiz;009;Benaocaz;592;297;295
11;Cádiz;010;Bornos;8062;4011;4051
11;Cádiz;011;Bosque (El);1833;949;884
11;Cádiz;013;Castellar de la Frontera;2428;1244;1184
11;Cádiz;015;Chiclana de la Frontera;55494;28163;27331
11;Cádiz;016;Chipiona;15989;8078;7911
11;Cádiz;014;Conil de la Frontera;17089;8675;8414
11;Cádiz;012;Cádiz;143129;68727;74402
11;Cádiz;017;Espera;3957;2072;1885
11;Cádiz;018;Gastor (El);2015;1064;951
11;Cádiz;019;Grazalema;2256;1163;1093
11;Cádiz;020;Jerez de la Frontera;181602;88706;92896
11;Cádiz;021;Jimena de la Frontera;8948;4565;4383
11;Cádiz;022;Línea de la Concepción (La);59629;29058;30571
11;Cádiz;023;Medina-Sidonia;10872;5639;5233
11;Cádiz;024;Olvera;8884;4462;4422
11;Cádiz;025;Paterna de Rivera;5121;2659;2462
11;Cádiz;026;Prado del Rey;5785;2895;2890
11;Cádiz;028;Puerto Real;33415;16819;16596
11;Cádiz;029;Puerto Serrano;6677;3413;3264
11;Cádiz;027;Puerto de Santa María (El);73728;36783;36945
11;Cádiz;030;Rota;24704;12478;12226
11;Cádiz;031;San Fernando;84014;41453;42561
11;Cádiz;902;San José del Valle;4322;2227;2095
11;Cádiz;033;San Roque;22322;11194;11128
11;Cádiz;032;Sanlúcar de Barrameda;61382;30718;30664
11;Cádiz;034;Setenil de las Bodegas;3130;1597;1533
11;Cádiz;035;Tarifa;15118;7642;7476
11;Cádiz;036;Torre Alháquime;988;504;484
11;Cádiz;037;Trebujena;6927;3592;3335
11;Cádiz;038;Ubrique;17960;8933;9027
11;Cádiz;039;Vejer de la Frontera;12731;6447;6284
11;Cádiz;040;Villaluenga del Rosario;451;244;207
11;Cádiz;041;Villamartín;11963;6004;5959
11;Cádiz;042;Zahara;1552;809;743
12;Castellón/Castelló;003;Albocàsser;1374;664;710
12;Castellón/Castelló;004;Alcalà de Xivert;4902;2422;2480
12;Castellón/Castelló;005;Alcora (L');8788;4473;4315
12;Castellón/Castelló;006;Alcudia de Veo;177;82;95
12;Castellón/Castelló;007;Alfondeguilla;919;453;466
12;Castellón/Castelló;008;Algimia de Almonacid;288;162;126
12;Castellón/Castelló;009;Almazora/Almassora;16465;8134;8331
12;Castellón/Castelló;010;Almedíjar;283;136;147
12;Castellón/Castelló;011;Almenara;5001;2468;2533
12;Castellón/Castelló;901;Alquerías del Niño Perdido;3531;1720;1811
12;Castellón/Castelló;012;Altura;3144;1582;1562
12;Castellón/Castelló;013;Arañuel;142;74;68
12;Castellón/Castelló;014;Ares del Maestre;266;128;138
12;Castellón/Castelló;015;Argelita;117;57;60
12;Castellón/Castelló;016;Artana;1869;928;941
12;Castellón/Castelló;001;Atzeneta del Maestrat;1465;741;724
12;Castellón/Castelló;017;Ayódar;223;122;101
12;Castellón/Castelló;018;Azuébar;351;173;178
12;Castellón/Castelló;002;Aín;155;79;76
12;Castellón/Castelló;020;Barracas;166;91;75
12;Castellón/Castelló;022;Bejís;362;201;161
12;Castellón/Castelló;024;Benafer;148;81;67
12;Castellón/Castelló;025;Benafigos;218;119;99
12;Castellón/Castelló;026;Benasal;1416;687;729
12;Castellón/Castelló;027;Benicarló;19350;9557;9793
12;Castellón/Castelló;028;Benicasim/Benicàssim;10702;5445;5257
12;Castellón/Castelló;029;Benlloch;863;443;420
12;Castellón/Castelló;021;Betxí;5314;2701;2613
12;Castellón/Castelló;031;Borriol;3284;1660;1624
12;Castellón/Castelló;032;Borriana/Burriana;26097;12677;13420
12;Castellón/Castelló;033;Cabanes;2366;1158;1208
12;Castellón/Castelló;036;Canet lo Roig;914;436;478
12;Castellón/Castelló;037;Castell de Cabres;22;10;12
12;Castellón/Castelló;038;Castellfort;235;124;111
12;Castellón/Castelló;039;Castellnovo;1026;491;535
12;Castellón/Castelló;040;Castellón de la Plana/Castelló de la Plana;137741;67015;70726
12;Castellón/Castelló;041;Castillo de Villamalefa;130;64;66
12;Castellón/Castelló;042;Catí;897;462;435
12;Castellón/Castelló;043;Caudiel;707;350;357
12;Castellón/Castelló;044;Cervera del Maestre;730;348;382
12;Castellón/Castelló;052;Chert/Xert;920;449;471
12;Castellón/Castelló;053;Chilches/Xilxes;2222;1134;1088
12;Castellón/Castelló;055;Chodos/Xodos;159;84;75
12;Castellón/Castelló;056;Chóvar;393;199;194
12;Castellón/Castelló;045;Cinctorres;551;253;298
12;Castellón/Castelló;046;Cirat;281;148;133
12;Castellón/Castelló;048;Cortes de Arenoso;410;224;186
12;Castellón/Castelló;049;Costur;469;238;231
12;Castellón/Castelló;050;Coves de Vinromà (les);1866;935;931
12;Castellón/Castelló;051;Culla;811;411;400
12;Castellón/Castelló;034;Càlig;1755;854;901
12;Castellón/Castelló;057;Eslida;766;364;402
12;Castellón/Castelló;058;Espadilla;78;37;41
12;Castellón/Castelló;059;Fanzara;269;128;141
12;Castellón/Castelló;060;Figueroles;548;273;275
12;Castellón/Castelló;061;Forcall;540;262;278
12;Castellón/Castelló;063;Fuente la Reina;29;13;16
12;Castellón/Castelló;064;Fuentes de Ayódar;105;58;47
12;Castellón/Castelló;065;Gaibiel;205;108;97
12;Castellón/Castelló;066;Gatova;"";"";""
12;Castellón/Castelló;067;Geldo;704;351;353
12;Castellón/Castelló;068;Herbés;106;54;52
12;Castellón/Castelló;069;Higueras;41;25;16
12;Castellón/Castelló;070;Jana (La);823;418;405
12;Castellón/Castelló;071;Jérica;1574;801;773
12;Castellón/Castelló;074;Llosa (La);932;471;461
12;Castellón/Castelló;072;Lucena del Cid;1581;792;789
12;Castellón/Castelló;073;Ludiente;232;117;115
12;Castellón/Castelló;075;Mata de Morella (La);196;96;100
12;Castellón/Castelló;076;Matet;139;71;68
12;Castellón/Castelló;077;Moncofa;3724;1897;1827
12;Castellón/Castelló;079;Montanejos;408;209;199
12;Castellón/Castelló;078;Montán;340;175;165
12;Castellón/Castelló;080;Morella;2719;1309;1410
12;Castellón/Castelló;081;Navajas;508;256;252
12;Castellón/Castelló;082;Nules;11490;5733;5757
12;Castellón/Castelló;083;Olocau del Rey;149;81;68
12;Castellón/Castelló;084;Onda;18909;9536;9373
12;Castellón/Castelló;085;Oropesa del Mar/Orpesa;3044;1555;1489
12;Castellón/Castelló;087;Palanques;23;13;10
12;Castellón/Castelló;088;Pavías;58;36;22
12;Castellón/Castelló;089;Peníscola/Peñíscola;4047;2037;2010
12;Castellón/Castelló;090;Pina de Montalgrao;167;88;79
12;Castellón/Castelló;094;Pobla Tornesa (La);532;260;272
12;Castellón/Castelló;093;Pobla de Benifassà (La);217;110;107
12;Castellón/Castelló;091;Portell de Morella;265;130;135
12;Castellón/Castelló;092;Puebla de Arenoso;173;86;87
12;Castellón/Castelló;095;Ribesalbes;1283;640;643
12;Castellón/Castelló;096;Rossell;1148;589;559
12;Castellón/Castelló;097;Sacañet;119;67;52
12;Castellón/Castelló;098;Salzadella (La);797;391;406
12;Castellón/Castelló;101;San Rafael del Río;462;234;228
12;Castellón/Castelló;902;Sant Joan de Moró;1683;854;829
12;Castellón/Castelló;099;Sant Jordi/San Jorge;577;280;297
12;Castellón/Castelló;100;Sant Mateu;1780;890;890
12;Castellón/Castelló;102;Santa Magdalena de Pulpis;693;350;343
12;Castellón/Castelló;103;Sarratella;96;52;44
12;Castellón/Castelló;104;Segorbe;7710;3747;3963
12;Castellón/Castelló;105;Sierra Engarcerán;1084;570;514
12;Castellón/Castelló;106;Soneja;1387;703;684
12;Castellón/Castelló;107;Sot de Ferrer;405;206;199
12;Castellón/Castelló;108;Sueras/Suera;548;274;274
12;Castellón/Castelló;109;Tales;763;366;397
12;Castellón/Castelló;110;Teresa;368;188;180
12;Castellón/Castelló;112;Todolella;136;81;55
12;Castellón/Castelló;113;Toga;94;45;49
12;Castellón/Castelló;115;Toro (El);356;187;169
12;Castellón/Castelló;116;Torralba del Pinar;67;31;36
12;Castellón/Castelló;120;Torre d'en Doménech (La);238;118;120
12;Castellón/Castelló;119;Torre d'En Besora (La);210;106;104
12;Castellón/Castelló;117;Torreblanca;4590;2291;2299
12;Castellón/Castelló;118;Torrechiva;68;40;28
12;Castellón/Castelló;114;Torás;259;135;124
12;Castellón/Castelló;121;Traiguera;1586;816;770
12;Castellón/Castelló;111;Tírig;567;285;282
12;Castellón/Castelló;122;Useras/Useres (Les);1027;520;507
12;Castellón/Castelló;124;Vall d'Alba;1856;935;921
12;Castellón/Castelló;126;Vall d'Uixó (La);28823;14306;14517
12;Castellón/Castelló;125;Vall de Almonacid;292;150;142
12;Castellón/Castelló;123;Vallat;46;22;24
12;Castellón/Castelló;127;Vallibona;102;61;41
12;Castellón/Castelló;128;Vilafamés;1427;766;661
12;Castellón/Castelló;132;Vilanova d'Alcolea;632;320;312
12;Castellón/Castelló;134;Vilar de Canes;188;93;95
12;Castellón/Castelló;129;Villafranca del Cid;2680;1290;1390
12;Castellón/Castelló;130;Villahermosa del Río;456;254;202
12;Castellón/Castelló;131;Villamalur;149;84;65
12;Castellón/Castelló;133;Villanueva de Viver;88;46;42
12;Castellón/Castelló;135;Vila-real;40124;19959;20165
12;Castellón/Castelló;136;Villavieja;3401;1686;1715
12;Castellón/Castelló;137;Villores;66;33;33
12;Castellón/Castelló;138;Vinaròs;21592;10513;11079
12;Castellón/Castelló;139;Vistabella del Maestrazgo;473;233;240
12;Castellón/Castelló;140;Viver;1237;636;601
12;Castellón/Castelló;141;Zorita del Maestrazgo;135;68;67
12;Castellón/Castelló;142;Zucaina;218;123;95
13;Ciudad Real;001;Abenójar;1810;904;906
13;Ciudad Real;002;Agudo;2132;1078;1054
13;Ciudad Real;003;Alamillo;685;346;339
13;Ciudad Real;004;Albaladejo;1697;864;833
13;Ciudad Real;005;Alcázar de San Juan;26022;12681;13341
13;Ciudad Real;006;Alcoba;770;405;365
13;Ciudad Real;007;Alcolea de Calatrava;1644;820;824
13;Ciudad Real;008;Alcubillas;722;344;378
13;Ciudad Real;009;Aldea del Rey;2222;1091;1131
13;Ciudad Real;010;Alhambra;1298;660;638
13;Ciudad Real;011;Almadén;7410;3549;3861
13;Ciudad Real;012;Almadenejos;606;324;282
13;Ciudad Real;013;Almagro;8278;3996;4282
13;Ciudad Real;014;Almedina;749;378;371
13;Ciudad Real;015;Almodóvar del Campo;7599;3748;3851
13;Ciudad Real;016;Almuradiel;1030;473;557
13;Ciudad Real;017;Anchuras;451;249;202
13;Ciudad Real;903;Arenales de San Gregorio;"";"";""
13;Ciudad Real;018;Arenas de San Juan;1065;531;534
13;Ciudad Real;019;Argamasilla de Alba;6667;3293;3374
13;Ciudad Real;020;Argamasilla de Calatrava;5536;2806;2730
13;Ciudad Real;021;Arroba de los Montes;649;333;316
13;Ciudad Real;022;Ballesteros de Calatrava;572;272;300
13;Ciudad Real;023;Bolaños de Calatrava;10618;5302;5316
13;Ciudad Real;024;Brazatortas;1241;622;619
13;Ciudad Real;025;Cabezarados;393;206;187
13;Ciudad Real;026;Cabezarrubias del Puerto;671;345;326
13;Ciudad Real;027;Calzada de Calatrava;4852;2385;2467
13;Ciudad Real;028;Campo de Criptana;13829;6791;7038
13;Ciudad Real;029;Cañada de Calatrava;89;49;40
13;Ciudad Real;030;Caracuel de Calatrava;174;96;78
13;Ciudad Real;031;Carrión de Calatrava;2627;1297;1330
13;Ciudad Real;032;Carrizosa;1729;866;863
13;Ciudad Real;033;Castellar de Santiago;2244;1088;1156
13;Ciudad Real;038;Chillón;2389;1155;1234
13;Ciudad Real;034;Ciudad Real;61138;28872;32266
13;Ciudad Real;035;Corral de Calatrava;1331;674;657
13;Ciudad Real;036;Cortijos (Los);1094;535;559
13;Ciudad Real;037;Cózar;1348;653;695
13;Ciudad Real;039;Daimiel;17045;8379;8666
13;Ciudad Real;040;Fernán Caballero;1044;498;546
13;Ciudad Real;041;Fontanarejo;380;200;180
13;Ciudad Real;042;Fuencaliente;1308;688;620
13;Ciudad Real;043;Fuenllana;331;152;179
13;Ciudad Real;044;Fuente el Fresno;3444;1698;1746
13;Ciudad Real;045;Granátula de Calatrava;1003;479;524
13;Ciudad Real;046;Guadalmez;1070;550;520
13;Ciudad Real;047;Herencia;7041;3520;3521
13;Ciudad Real;048;Hinojosas de Calatrava;787;382;405
13;Ciudad Real;049;Horcajo de los Montes;1113;561;552
13;Ciudad Real;050;Labores (Las);699;347;352
13;Ciudad Real;904;Llanos del Caudillo;"";"";""
13;Ciudad Real;051;Luciana;448;229;219
13;Ciudad Real;052;Malagón;8059;3969;4090
13;Ciudad Real;053;Manzanares;18222;8917;9305
13;Ciudad Real;054;Membrilla;6600;3294;3306
13;Ciudad Real;055;Mestanza;968;467;501
13;Ciudad Real;056;Miguelturra;9252;4632;4620
13;Ciudad Real;057;Montiel;1721;865;856
13;Ciudad Real;058;Moral de Calatrava;5202;2543;2659
13;Ciudad Real;059;Navalpino;326;160;166
13;Ciudad Real;060;Navas de Estena;433;235;198
13;Ciudad Real;061;Pedro Muñoz;7213;3590;3623
13;Ciudad Real;062;Picón;636;333;303
13;Ciudad Real;063;Piedrabuena;5036;2567;2469
13;Ciudad Real;064;Poblete;784;395;389
13;Ciudad Real;065;Porzuna;3984;2019;1965
13;Ciudad Real;066;Pozuelo de Calatrava;2532;1248;1284
13;Ciudad Real;067;Pozuelos de Calatrava (Los);589;293;296
13;Ciudad Real;068;Puebla de Don Rodrigo;1331;702;629
13;Ciudad Real;069;Puebla del Príncipe;1094;552;542
13;Ciudad Real;070;Puerto Lápice;1049;522;527
13;Ciudad Real;071;Puertollano;50778;24708;26070
13;Ciudad Real;072;Retuerta del Bullaque;1049;543;506
13;Ciudad Real;901;Robledo (El);1131;596;535
13;Ciudad Real;902;Ruidera;610;321;289
13;Ciudad Real;073;Saceruela;765;410;355
13;Ciudad Real;074;San Carlos del Valle;1251;626;625
13;Ciudad Real;075;San Lorenzo de Calatrava;310;161;149
13;Ciudad Real;076;Santa Cruz de los Cáñamos;677;342;335
13;Ciudad Real;077;Santa Cruz de Mudela;4843;2367;2476
13;Ciudad Real;078;Socuéllamos;11189;5486;5703
13;Ciudad Real;080;Solana del Pino;554;280;274
13;Ciudad Real;079;Solana (La);14960;7491;7469
13;Ciudad Real;081;Terrinches;972;472;500
13;Ciudad Real;082;Tomelloso;29255;14349;14906
13;Ciudad Real;083;Torralba de Calatrava;2914;1447;1467
13;Ciudad Real;084;Torre de Juan Abad;1468;719;749
13;Ciudad Real;085;Torrenueva;3252;1650;1602
13;Ciudad Real;086;Valdemanco del Esteras;337;165;172
13;Ciudad Real;087;Valdepeñas;26331;12662;13669
13;Ciudad Real;088;Valenzuela de Calatrava;819;400;419
13;Ciudad Real;089;Villahermosa;2719;1296;1423
13;Ciudad Real;090;Villamanrique;1695;832;863
13;Ciudad Real;091;Villamayor de Calatrava;656;329;327
13;Ciudad Real;092;Villanueva de la Fuente;2748;1353;1395
13;Ciudad Real;093;Villanueva de los Infantes;5801;2781;3020
13;Ciudad Real;094;Villanueva de San Carlos;498;245;253
13;Ciudad Real;095;Villar del Pozo;102;56;46
13;Ciudad Real;096;Villarrubia de los Ojos;9608;4786;4822
13;Ciudad Real;097;Villarta de San Juan;2957;1495;1462
13;Ciudad Real;098;Viso del Marqués;3100;1537;1563
14;Córdoba;001;Adamuz;4440;2257;2183
14;Córdoba;002;Aguilar de la Frontera;13397;6631;6766
14;Córdoba;003;Alcaracejos;1474;737;737
14;Córdoba;004;Almedinilla;2554;1269;1285
14;Córdoba;005;Almodóvar del Río;7155;3540;3615
14;Córdoba;006;Añora;1628;802;826
14;Córdoba;007;Baena;20057;9912;10145
14;Córdoba;008;Belalcázar;3879;1870;2009
14;Córdoba;009;Belmez;4057;1936;2121
14;Córdoba;010;Benamejí;4735;2378;2357
14;Córdoba;011;Blázquez (Los);712;361;351
14;Córdoba;012;Bujalance;8204;4023;4181
14;Córdoba;013;Cabra;20819;10130;10689
14;Córdoba;015;Carcabuey;2887;1443;1444
14;Córdoba;016;Cardeña;1966;997;969
14;Córdoba;017;Carlota (La);10295;5161;5134
14;Córdoba;018;Carpio (El);4394;2146;2248
14;Córdoba;019;Castro del Río;8015;3902;4113
14;Córdoba;014;Cañete de las Torres;3424;1695;1729
14;Córdoba;020;Conquista;512;261;251
14;Córdoba;021;Córdoba;309961;149284;160677
14;Córdoba;023;Dos Torres;2515;1236;1279
14;Córdoba;022;Doña Mencía;5047;2518;2529
14;Córdoba;024;Encinas Reales;2341;1146;1195
14;Córdoba;025;Espejo;4023;1993;2030
14;Córdoba;026;Espiel;2451;1217;1234
14;Córdoba;027;Fernán-Núñez;9494;4742;4752
14;Córdoba;029;Fuente Obejuna;6107;3120;2987
14;Córdoba;030;Fuente Palmera;9695;4886;4809
14;Córdoba;028;Fuente la Lancha;430;214;216
14;Córdoba;031;Fuente-Tójar;844;389;455
14;Córdoba;032;Granjuela (La);512;267;245
14;Córdoba;033;Guadalcázar;1167;593;574
14;Córdoba;034;Guijo (El);413;212;201
14;Córdoba;035;Hinojosa del Duque;7995;3868;4127
14;Córdoba;036;Hornachuelos;5056;2540;2516
14;Córdoba;037;Iznájar;5200;2621;2579
14;Córdoba;038;Lucena;35564;17677;17887
14;Córdoba;039;Luque;3397;1695;1702
14;Córdoba;040;Montalbán de Córdoba;4563;2285;2278
14;Córdoba;041;Montemayor;3809;1916;1893
14;Córdoba;042;Montilla;22792;11213;11579
14;Córdoba;043;Montoro;9489;4648;4841
14;Córdoba;044;Monturque;1935;970;965
14;Córdoba;045;Moriles;3796;1891;1905
14;Córdoba;046;Nueva Carteya;5659;2844;2815
14;Córdoba;047;Obejo;1493;754;739
14;Córdoba;048;Palenciana;1560;778;782
14;Córdoba;049;Palma del Río;18948;9468;9480
14;Córdoba;050;Pedro Abad;2919;1458;1461
14;Córdoba;051;Pedroche;1848;920;928
14;Córdoba;052;Peñarroya-Pueblonuevo;13606;6498;7108
14;Córdoba;053;Posadas;7164;3574;3590
14;Córdoba;054;Pozoblanco;16223;7786;8437
14;Córdoba;055;Priego de Córdoba;22196;10858;11338
14;Córdoba;056;Puente Genil;27918;13661;14257
14;Córdoba;057;Rambla (La);7229;3612;3617
14;Córdoba;058;Rute;10083;4983;5100
14;Córdoba;059;San Sebastián de los Ballesteros;834;429;405
14;Córdoba;061;Santa Eufemia;1185;603;582
14;Córdoba;060;Santaella;5869;2954;2915
14;Córdoba;062;Torrecampo;1417;698;719
14;Córdoba;063;Valenzuela;1486;714;772
14;Córdoba;064;Valsequillo;474;230;244
14;Córdoba;065;Victoria (La);1767;869;898
14;Córdoba;066;Villa del Río;7149;3642;3507
14;Córdoba;067;Villafranca de Córdoba;3748;1928;1820
14;Córdoba;068;Villaharta;614;309;305
14;Córdoba;069;Villanueva de Córdoba;10069;4913;5156
14;Córdoba;070;Villanueva del Duque;1833;854;979
14;Córdoba;071;Villanueva del Rey;1241;642;599
14;Córdoba;072;Villaralto;1559;750;809
14;Córdoba;073;Villaviciosa de Córdoba;3832;1961;1871
14;Córdoba;074;Viso (El);3153;1516;1637
14;Córdoba;075;Zuheros;899;446;453
15;Coruña (A);001;Abegondo;5451;2724;2727
15;Coruña (A);002;Ames;14189;6868;7321
15;Coruña (A);003;Aranga;2448;1219;1229
15;Coruña (A);004;Ares;4662;2307;2355
15;Coruña (A);005;Arteixo;21290;10677;10613
15;Coruña (A);006;Arzúa;6947;3409;3538
15;Coruña (A);007;Baña (A);5578;2681;2897
15;Coruña (A);008;Bergondo;5817;2830;2987
15;Coruña (A);009;Betanzos;12296;5801;6495
15;Coruña (A);010;Boimorto;2691;1355;1336
15;Coruña (A);011;Boiro;17845;8671;9174
15;Coruña (A);012;Boqueixón;4275;2108;2167
15;Coruña (A);013;Brión;6275;3014;3261
15;Coruña (A);014;Cabana de Bergantiños;5804;2888;2916
15;Coruña (A);015;Cabanas;3249;1582;1667
15;Coruña (A);016;Camariñas;7105;3517;3588
15;Coruña (A);017;Cambre;16401;8062;8339
15;Coruña (A);018;Capela (A);1619;794;825
15;Coruña (A);019;Carballo;27497;13352;14145
15;Coruña (A);901;Cariño;5199;2539;2660
15;Coruña (A);020;Carnota;5930;2859;3071
15;Coruña (A);021;Carral;5212;2537;2675
15;Coruña (A);022;Cedeira;7699;3791;3908
15;Coruña (A);023;Cee;7326;3537;3789
15;Coruña (A);024;Cerceda;5658;2763;2895
15;Coruña (A);025;Cerdido;1707;819;888
15;Coruña (A);026;Cesuras;2733;1362;1371
15;Coruña (A);027;Coirós;1553;764;789
15;Coruña (A);028;Corcubión;1949;943;1006
15;Coruña (A);029;Coristanco;8240;4088;4152
15;Coruña (A);030;A Coruña;243134;113548;129586
15;Coruña (A);031;Culleredo;18743;9220;9523
15;Coruña (A);032;Curtis;4523;2208;2315
15;Coruña (A);033;Dodro;3313;1606;1707
15;Coruña (A);034;Dumbría;4755;2306;2449
15;Coruña (A);035;Fene;14912;7355;7557
15;Coruña (A);036;Ferrol;82548;38561;43987
15;Coruña (A);037;Fisterra;5295;2659;2636
15;Coruña (A);038;Frades;3150;1583;1567
15;Coruña (A);039;Irixoa;1768;871;897
15;Coruña (A);041;Laracha (A);10706;5246;5460
15;Coruña (A);040;Laxe;3541;1743;1798
15;Coruña (A);042;Lousame;4329;2091;2238
15;Coruña (A);043;Malpica de Bergantiños;7377;3619;3758
15;Coruña (A);045;Mazaricos;6648;3226;3422
15;Coruña (A);044;Mañón;2034;1000;1034
15;Coruña (A);046;Melide;8439;4167;4272
15;Coruña (A);047;Mesía;3489;1739;1750
15;Coruña (A);048;Miño;4870;2289;2581
15;Coruña (A);049;Moeche;1583;759;824
15;Coruña (A);050;Monfero;2758;1413;1345
15;Coruña (A);051;Mugardos;6110;2953;3157
15;Coruña (A);053;Muros;10855;5194;5661
15;Coruña (A);052;Muxía;6422;3126;3296
15;Coruña (A);054;Narón;31086;15040;16046
15;Coruña (A);055;Neda;6214;3006;3208
15;Coruña (A);056;Negreira;6595;3153;3442
15;Coruña (A);057;Noia;14473;6933;7540
15;Coruña (A);058;Oleiros;24102;11673;12429
15;Coruña (A);059;Ordes;11861;5782;6079
15;Coruña (A);060;Oroso;4732;2333;2399
15;Coruña (A);061;Ortigueira;8748;4201;4547
15;Coruña (A);062;Outes;8948;4281;4667
15;Coruña (A);063;Oza dos Ríos;3240;1572;1668
15;Coruña (A);064;Paderne;2758;1311;1447
15;Coruña (A);065;Padrón;9548;4592;4956
15;Coruña (A);066;Pino (O);5004;2495;2509
15;Coruña (A);067;Pobra do Caramiñal (A);10082;4822;5260
15;Coruña (A);068;Ponteceso;7423;3716;3707
15;Coruña (A);069;Pontedeume;8893;4281;4612
15;Coruña (A);070;Pontes de García Rodríguez (As);12473;6299;6174
15;Coruña (A);071;Porto do Son;10416;5103;5313
15;Coruña (A);072;Rianxo;12147;5949;6198
15;Coruña (A);073;Ribeira;26413;13017;13396
15;Coruña (A);074;Rois;5295;2541;2754
15;Coruña (A);075;Sada;10296;5072;5224
15;Coruña (A);076;San Sadurniño;3503;1713;1790
15;Coruña (A);077;Santa Comba;10960;5400;5560
15;Coruña (A);078;Santiago de Compostela;93584;43972;49612
15;Coruña (A);079;Santiso;2319;1192;1127
15;Coruña (A);080;Sobrado;2609;1344;1265
15;Coruña (A);081;Somozas (As);1506;747;759
15;Coruña (A);082;Teo;13960;6827;7133
15;Coruña (A);083;Toques;1668;866;802
15;Coruña (A);084;Tordoia;5205;2495;2710
15;Coruña (A);085;Touro;5077;2493;2584
15;Coruña (A);086;Trazo;3912;1933;1979
15;Coruña (A);088;Val do Dubra;5091;2494;2597
15;Coruña (A);087;Valdoviño;6769;3329;3440
15;Coruña (A);089;Vedra;5101;2446;2655
15;Coruña (A);091;Vilarmaior;1412;714;698
15;Coruña (A);090;Vilasantar;1707;873;834
15;Coruña (A);092;Vimianzo;8937;4370;4567
15;Coruña (A);093;Zas;6311;3046;3265
16;Cuenca;001;Abia de la Obispalía;88;48;40
16;Cuenca;002;Acebrón (El);279;142;137
16;Cuenca;003;Alarcón;204;101;103
16;Cuenca;004;Albaladejo del Cuende;413;216;197
16;Cuenca;005;Albalate de las Nogueras;383;211;172
16;Cuenca;006;Albendea;190;94;96
16;Cuenca;007;Alberca de Záncara (La);1728;855;873
16;Cuenca;008;Alcalá de la Vega;164;89;75
16;Cuenca;009;Alcantud;129;69;60
16;Cuenca;011;Alcohujate;53;30;23
16;Cuenca;012;Alconchel de la Estrella;223;114;109
16;Cuenca;010;Alcázar del Rey;266;128;138
16;Cuenca;013;Algarra;36;18;18
16;Cuenca;014;Aliaguilla;880;464;416
16;Cuenca;015;Almarcha (La);631;318;313
16;Cuenca;016;Almendros;349;178;171
16;Cuenca;017;Almodóvar del Pinar;510;261;249
16;Cuenca;018;Almonacid del Marquesado;581;300;281
16;Cuenca;019;Altarejos;332;170;162
16;Cuenca;020;Arandilla del Arroyo;54;24;30
16;Cuenca;905;Arcas del Villar;595;296;299
16;Cuenca;022;Arcos de la Sierra;121;64;57
16;Cuenca;024;Arguisuelas;205;106;99
16;Cuenca;025;Arrancacepas;38;20;18
16;Cuenca;026;Atalaya del Cañavate;129;66;63
16;Cuenca;027;Barajas de Melo;703;345;358
16;Cuenca;029;Barchín del Hoyo;136;77;59
16;Cuenca;030;Bascuñana de San Pedro;41;22;19
16;Cuenca;031;Beamud;104;59;45
16;Cuenca;032;Belinchón;340;174;166
16;Cuenca;033;Belmonte;2471;1165;1306
16;Cuenca;034;Belmontejo;276;136;140
16;Cuenca;035;Beteta;402;197;205
16;Cuenca;036;Boniches;227;118;109
16;Cuenca;038;Buciegas;85;43;42
16;Cuenca;039;Buenache de Alarcón;630;322;308
16;Cuenca;040;Buenache de la Sierra;104;65;39
16;Cuenca;041;Buendía;543;267;276
16;Cuenca;042;Campillo de Altobuey;1672;826;846
16;Cuenca;043;Campillos-Paravientos;147;81;66
16;Cuenca;044;Campillos-Sierra;94;49;45
16;Cuenca;901;Campos del Paraíso;1142;537;605
16;Cuenca;045;Canalejas del Arroyo;313;164;149
16;Cuenca;055;Carboneras de Guadazaón;1004;534;470
16;Cuenca;056;Cardenete;689;353;336
16;Cuenca;057;Carrascosa;116;70;46
16;Cuenca;058;Carrascosa de Haro;155;79;76
16;Cuenca;060;Casas de Benítez;1096;524;572
16;Cuenca;061;Casas de Fernando Alonso;1340;659;681
16;Cuenca;062;Casas de Garcimolina;34;16;18
16;Cuenca;063;Casas de Guijarro;154;77;77
16;Cuenca;064;Casas de Haro;890;447;443
16;Cuenca;065;Casas de los Pinos;510;244;266
16;Cuenca;066;Casasimarro;3061;1559;1502
16;Cuenca;067;Castejón;241;119;122
16;Cuenca;068;Castillejo de Iniesta;200;109;91
16;Cuenca;070;Castillejo-Sierra;54;25;29
16;Cuenca;072;Castillo de Garcimuñoz;228;116;112
16;Cuenca;071;Castillo-Albaráñez;33;17;16
16;Cuenca;047;Cañada Juncosa;353;185;168
16;Cuenca;046;Cañada del Hoyo;369;193;176
16;Cuenca;048;Cañamares;582;304;278
16;Cuenca;049;Cañavate (El);270;130;140
16;Cuenca;050;Cañaveras;407;202;205
16;Cuenca;051;Cañaveruelas;251;126;125
16;Cuenca;052;Cañete;816;401;415
16;Cuenca;053;Cañizares;614;320;294
16;Cuenca;073;Cervera del Llano;314;153;161
16;Cuenca;023;Chillarón de Cuenca;343;179;164
16;Cuenca;081;Chumillas;46;29;17
16;Cuenca;074;Cierva (La);57;30;27
16;Cuenca;078;Cuenca;44558;21401;23157
16;Cuenca;079;Cueva del Hierro;44;25;19
16;Cuenca;082;Enguídanos;529;272;257
16;Cuenca;083;Fresneda de Altarejos;92;51;41
16;Cuenca;084;Fresneda de la Sierra;76;38;38
16;Cuenca;085;Frontera (La);213;108;105
16;Cuenca;086;Fuente de Pedro Naharro;1205;600;605
16;Cuenca;087;Fuentelespino de Haro;326;178;148
16;Cuenca;088;Fuentelespino de Moya;143;74;69
16;Cuenca;904;Fuentenava de Jábaga;277;146;131
16;Cuenca;089;Fuentes;504;264;240
16;Cuenca;091;Fuertescusa;118;61;57
16;Cuenca;092;Gabaldón;178;101;77
16;Cuenca;093;Garaballa;144;79;65
16;Cuenca;094;Gascueña;155;73;82
16;Cuenca;095;Graja de Campalbo;145;79;66
16;Cuenca;096;Graja de Iniesta;351;190;161
16;Cuenca;097;Henarejos;281;132;149
16;Cuenca;098;Herrumblar (El);773;399;374
16;Cuenca;099;Hinojosa (La);352;169;183
16;Cuenca;100;Hinojosos (Los);1108;548;560
16;Cuenca;101;Hito (El);237;120;117
16;Cuenca;102;Honrubia;1611;790;821
16;Cuenca;103;Hontanaya;472;234;238
16;Cuenca;104;Hontecillas;94;46;48
16;Cuenca;106;Horcajo de Santiago;3553;1763;1790
16;Cuenca;108;Huelves;71;29;42
16;Cuenca;110;Huerta de la Obispalía;153;84;69
16;Cuenca;111;Huerta del Marquesado;216;121;95
16;Cuenca;112;Huete;2278;1160;1118
16;Cuenca;107;Huélamo;157;80;77
16;Cuenca;109;Huérguina;89;45;44
16;Cuenca;113;Iniesta;3786;1847;1939
16;Cuenca;115;Laguna del Marquesado;78;42;36
16;Cuenca;116;Lagunaseca;113;53;60
16;Cuenca;117;Landete;1589;789;800
16;Cuenca;118;Ledaña;1968;969;999
16;Cuenca;119;Leganiel;234;119;115
16;Cuenca;121;Majadas (Las);374;182;192
16;Cuenca;122;Mariana;318;156;162
16;Cuenca;123;Masegosa;128;69;59
16;Cuenca;124;Mesas (Las);2503;1280;1223
16;Cuenca;125;Minglanilla;2304;1172;1132
16;Cuenca;126;Mira;1118;568;550
16;Cuenca;128;Monreal del Llano;85;43;42
16;Cuenca;129;Montalbanejo;204;92;112
16;Cuenca;130;Montalbo;737;388;349
16;Cuenca;131;Monteagudo de las Salinas;118;68;50
16;Cuenca;132;Mota de Altarejos;58;36;22
16;Cuenca;133;Mota del Cuervo;5411;2669;2742
16;Cuenca;134;Motilla del Palancar;4946;2469;2477
16;Cuenca;135;Moya;278;151;127
16;Cuenca;137;Narboneta;113;55;58
16;Cuenca;139;Olivares de Júcar;567;292;275
16;Cuenca;140;Olmeda de la Cuesta;49;27;22
16;Cuenca;141;Olmeda del Rey;247;116;131
16;Cuenca;142;Olmedilla de Alarcón;183;93;90
16;Cuenca;143;Olmedilla de Eliz;34;18;16
16;Cuenca;145;Osa de la Vega;663;334;329
16;Cuenca;147;Pajaroncillo;97;48;49
16;Cuenca;146;Pajarón;139;71;68
16;Cuenca;148;Palomares del Campo;1008;493;515
16;Cuenca;149;Palomera;153;71;82
16;Cuenca;150;Paracuellos;154;70;84
16;Cuenca;151;Paredes;82;43;39
16;Cuenca;152;Parra de las Vegas (La);61;31;30
16;Cuenca;153;Pedernoso (El);1358;683;675
16;Cuenca;154;Pedroñeras (Las);6382;3252;3130
16;Cuenca;155;Peral (El);722;368;354
16;Cuenca;156;Peraleja (La);153;76;77
16;Cuenca;157;Pesquera (La);270;141;129
16;Cuenca;158;Picazo (El);722;356;366
16;Cuenca;159;Pinarejo;423;221;202
16;Cuenca;160;Pineda de Gigüela;159;86;73
16;Cuenca;161;Piqueras del Castillo;81;47;34
16;Cuenca;162;Portalrubio de Guadamejud;94;45;49
16;Cuenca;163;Portilla;93;48;45
16;Cuenca;165;Poyatos;116;66;50
16;Cuenca;166;Pozoamargo;319;150;169
16;Cuenca;908;Pozorrubielos de la Mancha;288;144;144
16;Cuenca;167;Pozorrubio;523;249;274
16;Cuenca;169;Pozuelo (El);104;56;48
16;Cuenca;170;Priego;1013;524;489
16;Cuenca;171;Provencio (El);2569;1285;1284
16;Cuenca;172;Puebla de Almenara;576;300;276
16;Cuenca;173;Puebla de Don Francisco;372;183;189
16;Cuenca;174;Puebla del Salvador;299;164;135
16;Cuenca;175;Quintanar del Rey;6086;3102;2984
16;Cuenca;176;Rada de Haro;65;32;33
16;Cuenca;177;Reíllo;146;75;71
16;Cuenca;181;Rozalén del Monte;124;58;66
16;Cuenca;185;Saceda-Trasierra;99;58;41
16;Cuenca;186;Saelices;704;349;355
16;Cuenca;187;Salinas del Manzano;119;69;50
16;Cuenca;188;Salmeroncillos;182;92;90
16;Cuenca;189;Salvacañete;340;183;157
16;Cuenca;190;San Clemente;6289;3080;3209
16;Cuenca;191;San Lorenzo de la Parrilla;1492;757;735
16;Cuenca;192;San Martín de Boniches;109;55;54
16;Cuenca;193;San Pedro Palmiches;109;58;51
16;Cuenca;194;Santa Cruz de Moya;430;217;213
16;Cuenca;196;Santa María de los Llanos;865;441;424
16;Cuenca;195;Santa María del Campo Rus;795;404;391
16;Cuenca;197;Santa María del Val;118;62;56
16;Cuenca;198;Sisante;1791;898;893
16;Cuenca;199;Solera de Gabaldón;42;23;19
16;Cuenca;909;Sotorribas;958;471;487
16;Cuenca;202;Talayuelas;1124;580;544
16;Cuenca;203;Tarancón;11189;5494;5695
16;Cuenca;205;Tejadillos;178;92;86
16;Cuenca;206;Tinajas;372;203;169
16;Cuenca;209;Torralba;191;97;94
16;Cuenca;211;Torrejoncillo del Rey;737;349;388
16;Cuenca;212;Torrubia del Campo;366;170;196
16;Cuenca;213;Torrubia del Castillo;44;22;22
16;Cuenca;215;Tragacete;378;211;167
16;Cuenca;216;Tresjuncos;518;264;254
16;Cuenca;217;Tribaldos;134;62;72
16;Cuenca;204;Tébar;412;221;191
16;Cuenca;218;Uclés;293;136;157
16;Cuenca;219;Uña;139;68;71
16;Cuenca;906;Valdecolmenas (Los);127;68;59
16;Cuenca;224;Valdemeca;110;57;53
16;Cuenca;225;Valdemorillo de la Sierra;108;57;51
16;Cuenca;227;Valdemoro-Sierra;164;95;69
16;Cuenca;228;Valdeolivas;284;151;133
16;Cuenca;902;Valdetórtola;146;80;66
16;Cuenca;903;Valeras (Las);1418;702;716
16;Cuenca;231;Valhermoso de la Fuente;60;27;33
16;Cuenca;234;Valsalobre;56;29;27
16;Cuenca;236;Valverde de Júcar;1383;694;689
16;Cuenca;237;Valverdejo;148;79;69
16;Cuenca;238;Vara de Rey;714;353;361
16;Cuenca;239;Vega del Codorno;233;123;110
16;Cuenca;240;Vellisca;186;91;95
16;Cuenca;242;Villaconejos de Trabaque;534;273;261
16;Cuenca;243;Villaescusa de Haro;623;317;306
16;Cuenca;244;Villagarcía del Llano;981;481;500
16;Cuenca;245;Villalba de la Sierra;553;289;264
16;Cuenca;246;Villalba del Rey;712;364;348
16;Cuenca;247;Villalgordo del Marquesado;141;70;71
16;Cuenca;248;Villalpardo;1101;547;554
16;Cuenca;249;Villamayor de Santiago;2736;1359;1377
16;Cuenca;250;Villanueva de Guadamejud;132;62;70
16;Cuenca;251;Villanueva de la Jara;2465;1243;1222
16;Cuenca;253;Villar de Cañas;447;217;230
16;Cuenca;254;Villar de Domingo García;276;140;136
16;Cuenca;263;Villar de Olalla;863;447;416
16;Cuenca;255;Villar de la Encina;241;120;121
16;Cuenca;258;Villar del Humo;493;262;231
16;Cuenca;259;Villar del Infantado;57;33;24
16;Cuenca;910;Villar y Velasco;131;72;59
16;Cuenca;264;Villarejo de Fuentes;815;388;427
16;Cuenca;265;Villarejo de la Peñuela;36;17;19
16;Cuenca;266;Villarejo-Periesteban;548;277;271
16;Cuenca;269;Villares del Saz;743;374;369
16;Cuenca;270;Villarrubio;266;137;129
16;Cuenca;271;Villarta;794;411;383
16;Cuenca;272;Villas de la Ventosa;392;209;183
16;Cuenca;273;Villaverde y Pasaconsol;432;213;219
16;Cuenca;275;Vindel;25;16;9
16;Cuenca;274;Víllora;252;125;127
16;Cuenca;276;Yémeda;29;13;16
16;Cuenca;277;Zafra de Záncara;217;108;109
16;Cuenca;278;Zafrilla;139;64;75
16;Cuenca;279;Zarza de Tajo;268;123;145
16;Cuenca;280;Zarzuela;292;144;148
17;Girona;001;Agullana;622;325;297
17;Girona;002;Aiguaviva;455;230;225
17;Girona;003;Albanyà;131;69;62
17;Girona;004;Albons;528;273;255
17;Girona;006;Alp;1105;570;535
17;Girona;007;Amer;2241;1108;1133
17;Girona;008;Anglès;4752;2394;2358
17;Girona;009;Arbúcies;4814;2401;2413
17;Girona;010;Argelaguer;365;201;164
17;Girona;011;Armentera (L');749;374;375
17;Girona;012;Avinyonet de Puigventós;537;271;266
17;Girona;015;Banyoles;14748;7218;7530
17;Girona;016;Bàscara;778;404;374
17;Girona;013;Begur;3179;1601;1578
17;Girona;018;Bellcaire d'Empordà;502;251;251
17;Girona;019;Besalú;1991;966;1025
17;Girona;020;Bescanó;3063;1536;1527
17;Girona;021;Beuda;130;73;57
17;Girona;022;Bisbal d'Empordà (La);8107;3954;4153
17;Girona;234;Biure;211;105;106
17;Girona;023;Blanes;28826;14463;14363
17;Girona;029;Boadella d'Empordà;227;113;114
17;Girona;024;Bolvir;247;123;124
17;Girona;025;Bordils;1386;696;690
17;Girona;026;Borrassà;489;239;250
17;Girona;027;Breda;3254;1664;1590
17;Girona;028;Brunyola;405;207;198
17;Girona;031;Cabanelles;220;122;98
17;Girona;030;Cabanes;783;394;389
17;Girona;032;Cadaqués;1878;908;970
17;Girona;033;Caldes de Malavella;3752;1888;1864
17;Girona;034;Calonge;6226;3126;3100
17;Girona;035;Camós;618;314;304
17;Girona;036;Campdevànol;3342;1636;1706
17;Girona;037;Campelles;123;63;60
17;Girona;038;Campllong;293;147;146
17;Girona;039;Camprodon;2344;1169;1175
17;Girona;040;Canet d'Adri;519;266;253
17;Girona;041;Cantallops;257;129;128
17;Girona;042;Capmany;397;200;197
17;Girona;044;Cassà de la Selva;7445;3693;3752
17;Girona;046;Castellfollit de la Roca;981;475;506
17;Girona;047;Castelló d'Empúries;5283;2699;2584
17;Girona;048;Castell-Platja d'Aro;5785;2925;2860
17;Girona;189;Cellera de Ter (La);2019;996;1023
17;Girona;049;Celrà;2450;1186;1264
17;Girona;050;Cervià de Ter;643;318;325
17;Girona;051;Cistella;211;105;106
17;Girona;054;Colera;493;238;255
17;Girona;055;Colomers;202;100;102
17;Girona;057;Corçà;1110;567;543
17;Girona;056;Cornellà del Terri;1862;931;931
17;Girona;058;Crespià;205;99;106
17;Girona;901;Cruïlles, Monells i Sant Sadurní de l'Heura;1071;525;546
17;Girona;060;Darnius;525;279;246
17;Girona;061;Das;151;84;67
17;Girona;062;Escala (L');5942;2955;2987
17;Girona;063;Espinelves;180;93;87
17;Girona;064;Espolla;376;191;185
17;Girona;065;Esponellà;392;198;194
17;Girona;005;Far d'Empordà (El);401;201;200
17;Girona;066;Figueres;33600;16292;17308
17;Girona;067;Flaçà;840;419;421
17;Girona;068;Foixà;315;155;160
17;Girona;069;Fontanals de Cerdanya;374;189;185
17;Girona;070;Fontanilles;126;69;57
17;Girona;071;Fontcoberta;1076;547;529
17;Girona;902;Forallac;1642;794;848
17;Girona;073;Fornells de la Selva;1392;682;710
17;Girona;074;Fortià;494;239;255
17;Girona;075;Garrigàs;310;165;145
17;Girona;076;Garrigoles;147;80;67
17;Girona;077;Garriguella;658;333;325
17;Girona;078;Ger;330;174;156
17;Girona;079;Girona;71858;34515;37343
17;Girona;080;Gombrèn;235;109;126
17;Girona;081;Gualta;259;130;129
17;Girona;082;Guils de Cerdanya;319;160;159
17;Girona;083;Hostalric;2865;1407;1458
17;Girona;084;Isòvol;205;112;93
17;Girona;085;Jafre;338;172;166
17;Girona;086;Jonquera (La);2490;1241;1249
17;Girona;087;Juià;256;117;139
17;Girona;088;Lladó;492;244;248
17;Girona;089;Llagostera;5565;2803;2762
17;Girona;090;Llambilles;435;217;218
17;Girona;091;Llanars;449;231;218
17;Girona;092;Llançà;3930;1964;1966
17;Girona;093;Llers;873;443;430
17;Girona;094;Llívia;975;513;462
17;Girona;095;Lloret de Mar;17875;8913;8962
17;Girona;096;Llosses (Les);270;146;124
17;Girona;102;Maçanet de Cabrenys;628;329;299
17;Girona;103;Maçanet de la Selva;3472;1763;1709
17;Girona;097;Madremanya;185;79;106
17;Girona;098;Maià de Montcal;329;166;163
17;Girona;100;Masarac;244;119;125
17;Girona;101;Massanes;492;254;238
17;Girona;099;Meranges;73;43;30
17;Girona;105;Mieres;318;166;152
17;Girona;106;Mollet de Peralada;180;98;82
17;Girona;107;Molló;338;173;165
17;Girona;109;Montagut i Oix;801;412;389
17;Girona;110;Mont-ras;1541;821;720
17;Girona;111;Navata;663;326;337
17;Girona;112;Ogassa;243;142;101
17;Girona;114;Olot;27644;13310;14334
17;Girona;115;Ordis;287;151;136
17;Girona;116;Osor;480;260;220
17;Girona;117;Palafrugell;17564;8787;8777
17;Girona;118;Palamós;14420;7102;7318
17;Girona;119;Palau de Santa Eulàlia;85;48;37
17;Girona;121;Palau-sator;286;146;140
17;Girona;120;Palau-saverdera;797;404;393
17;Girona;122;Palmerola;"";"";""
17;Girona;123;Palol de Revardit;367;190;177
17;Girona;124;Pals;1822;935;887
17;Girona;125;Pardines;134;66;68
17;Girona;126;Parlavà;328;173;155
17;Girona;128;Pau;415;204;211
17;Girona;129;Pedret i Marzà;114;57;57
17;Girona;130;Pera (La);370;192;178
17;Girona;132;Peralada;1188;608;580
17;Girona;133;Planes d'Hostoles (Les);1745;862;883
17;Girona;134;Planoles;269;146;123
17;Girona;135;Pont de Molins;450;241;209
17;Girona;136;Pontós;211;117;94
17;Girona;137;Porqueres;3383;1660;1723
17;Girona;140;Port de la Selva (El);782;378;404
17;Girona;138;Portbou;1590;797;793
17;Girona;139;Preses (Les);1320;644;676
17;Girona;141;Puigcerdà;6580;3323;3257
17;Girona;142;Quart;2183;1118;1065
17;Girona;043;Queralbs;200;111;89
17;Girona;143;Rabós;137;66;71
17;Girona;144;Regencós;290;161;129
17;Girona;145;Ribes de Freser;2125;1031;1094
17;Girona;146;Riells i Viabrea;1686;883;803
17;Girona;147;Ripoll;10953;5332;5621
17;Girona;148;Riudarenes;1257;644;613
17;Girona;149;Riudaura;390;196;194
17;Girona;150;Riudellots de la Selva;1489;750;739
17;Girona;151;Riumors;191;93;98
17;Girona;152;Roses;12022;6033;5989
17;Girona;153;Rupià;192;103;89
17;Girona;154;Sales de Llierca;65;38;27
17;Girona;155;Salt;21678;10740;10938
17;Girona;157;Sant Andreu Salou;143;70;73
17;Girona;183;Sant Aniol de Finestres;251;133;118
17;Girona;158;Sant Climent Sescebes;428;216;212
17;Girona;159;Sant Feliu de Buixalleu;695;374;321
17;Girona;160;Sant Feliu de Guíxols;17850;8724;9126
17;Girona;161;Sant Feliu de Pallerols;1137;555;582
17;Girona;162;Sant Ferriol;177;99;78
17;Girona;163;Sant Gregori;2214;1158;1056
17;Girona;164;Sant Hilari Sacalm;4873;2464;2409
17;Girona;165;Sant Jaume de Llierca;711;351;360
17;Girona;167;Sant Joan de les Abadesses;3734;1839;1895
17;Girona;168;Sant Joan de Mollet;351;171;180
17;Girona;185;Sant Joan les Fonts;2777;1387;1390
17;Girona;166;Sant Jordi Desvalls;602;306;296
17;Girona;169;Sant Julià de Ramis;1959;982;977
17;Girona;903;Sant Julià del Llor i Bonmatí;925;471;454
17;Girona;171;Sant Llorenç de la Muga;127;64;63
17;Girona;172;Sant Martí de Llémena;396;205;191
17;Girona;173;Sant Martí Vell;171;88;83
17;Girona;174;Sant Miquel de Campmajor;219;123;96
17;Girona;175;Sant Miquel de Fluvià;539;275;264
17;Girona;176;Sant Mori;144;72;72
17;Girona;177;Sant Pau de Segúries;659;327;332
17;Girona;178;Sant Pere Pescador;1379;747;632
17;Girona;180;Santa Coloma de Farners;8594;4375;4219
17;Girona;181;Santa Cristina d'Aro;2650;1380;1270
17;Girona;182;Santa Llogaia d'Àlguema;305;160;145
17;Girona;184;Santa Pau;1448;745;703
17;Girona;186;Sarrià de Ter;3139;1532;1607
17;Girona;187;Saus, Camallera i Llampaies;688;336;352
17;Girona;188;Selva de Mar (La);189;98;91
17;Girona;190;Serinyà;791;411;380
17;Girona;191;Serra de Daró;180;91;89
17;Girona;192;Setcases;158;81;77
17;Girona;193;Sils;2848;1440;1408
17;Girona;052;Siurana;158;73;85
17;Girona;194;Susqueda;89;49;40
17;Girona;195;Tallada d'Empordà (La);326;169;157
17;Girona;196;Terrades;183;86;97
17;Girona;197;Torrent;173;86;87
17;Girona;198;Torroella de Fluvià;300;165;135
17;Girona;199;Torroella de Montgrí;8020;4065;3955
17;Girona;200;Tortellà;709;358;351
17;Girona;201;Toses;141;84;57
17;Girona;202;Tossa de Mar;4016;1984;2032
17;Girona;204;Ullà;803;419;384
17;Girona;205;Ullastret;243;127;116
17;Girona;203;Ultramort;194;107;87
17;Girona;206;Urús;163;86;77
17;Girona;014;Vajol (La);68;35;33
17;Girona;208;Vall de Bianya (La);1129;556;573
17;Girona;207;Vall d'en Bas (La);2501;1285;1216
17;Girona;170;Vallfogona de Ripollès;217;112;105
17;Girona;209;Vall-llobrega;324;147;177
17;Girona;210;Ventalló;571;296;275
17;Girona;211;Verges;1127;555;572
17;Girona;212;Vidrà;163;82;81
17;Girona;213;Vidreres;4302;2162;2140
17;Girona;214;Vilabertran;775;388;387
17;Girona;215;Vilablareix;1535;766;769
17;Girona;217;Viladamat;408;210;198
17;Girona;216;Viladasens;193;98;95
17;Girona;218;Vilademuls;736;371;365
17;Girona;220;Viladrau;861;434;427
17;Girona;221;Vilafant;3636;1822;1814
17;Girona;223;Vilajuïga;894;443;451
17;Girona;224;Vilallonga de Ter;423;227;196
17;Girona;225;Vilamacolum;246;120;126
17;Girona;226;Vilamalla;615;319;296
17;Girona;227;Vilamaniscle;123;64;59
17;Girona;228;Vilanant;295;157;138
17;Girona;230;Vila-sacra;344;165;179
17;Girona;222;Vilaür;115;67;48
17;Girona;233;Vilobí d'Onyar;2153;1118;1035
17;Girona;232;Vilopriu;158;78;80
18;Granada;001;Agrón;425;222;203
18;Granada;002;Alamedilla;953;483;470
18;Granada;003;Albolote;12693;6357;6336
18;Granada;004;Albondón;1060;520;540
18;Granada;005;Albuñán;486;243;243
18;Granada;006;Albuñol;5482;2749;2733
18;Granada;007;Albuñuelas;1258;649;609
18;Granada;010;Aldeire;789;400;389
18;Granada;011;Alfacar;4255;2154;2101
18;Granada;012;Algarinejo;5269;2693;2576
18;Granada;013;Alhama de Granada;5894;2949;2945
18;Granada;014;Alhendín;4157;2098;2059
18;Granada;015;Alicún de Ortega;727;389;338
18;Granada;016;Almegíjar;430;217;213
18;Granada;017;Almuñécar;20997;10367;10630
18;Granada;904;Alpujarra de la Sierra;1204;613;591
18;Granada;018;Alquife;962;474;488
18;Granada;020;Arenas del Rey;2028;1048;980
18;Granada;021;Armilla;13211;6511;6700
18;Granada;022;Atarfe;10477;5173;5304
18;Granada;023;Baza;20113;9838;10275
18;Granada;024;Beas de Granada;959;501;458
18;Granada;025;Beas de Guadix;389;205;184
18;Granada;027;Benalúa;3339;1663;1676
18;Granada;028;Benalúa de las Villas;1379;686;693
18;Granada;029;Benamaurel;2431;1228;1203
18;Granada;030;Bérchules;808;425;383
18;Granada;032;Bubión;376;182;194
18;Granada;033;Busquístar;349;189;160
18;Granada;034;Cacín;820;414;406
18;Granada;035;Cádiar;1703;883;820
18;Granada;036;Cájar;2828;1322;1506
18;Granada;114;Calahorra (La);927;455;472
18;Granada;037;Calicasas;602;304;298
18;Granada;038;Campotéjar;1452;738;714
18;Granada;039;Caniles;5116;2498;2618
18;Granada;040;Cáñar;305;148;157
18;Granada;042;Capileira;560;272;288
18;Granada;043;Carataunas;191;99;92
18;Granada;044;Cástaras;314;166;148
18;Granada;045;Castilléjar;2114;1045;1069
18;Granada;046;Castril;2848;1448;1400
18;Granada;047;Cenes de la Vega;4515;2301;2214
18;Granada;059;Chauchina;4058;1995;2063
18;Granada;061;Chimeneas;1537;770;767
18;Granada;062;Churriana de la Vega;6435;3186;3249
18;Granada;048;Cijuela;1523;747;776
18;Granada;049;Cogollos de Guadix;768;402;366
18;Granada;050;Cogollos de la Vega;2020;1028;992
18;Granada;051;Colomera;1692;867;825
18;Granada;053;Cortes de Baza;2765;1420;1345
18;Granada;054;Cortes y Graena;1013;520;493
18;Granada;912;Cuevas del Campo;2256;1124;1132
18;Granada;056;Cúllar;5078;2533;2545
18;Granada;057;Cúllar Vega;3080;1535;1545
18;Granada;063;Darro;1521;751;770
18;Granada;064;Dehesas de Guadix;694;350;344
18;Granada;066;Deifontes;2415;1206;1209
18;Granada;067;Diezma;945;496;449
18;Granada;068;Dílar;1511;744;767
18;Granada;069;Dólar;643;315;328
18;Granada;070;Dúdar;296;153;143
18;Granada;071;Dúrcal;5774;2857;2917
18;Granada;072;Escúzar;857;429;428
18;Granada;074;Ferreira;375;179;196
18;Granada;076;Fonelas;1286;647;639
18;Granada;078;Freila;1034;526;508
18;Granada;079;Fuente Vaqueros;3969;1967;2002
18;Granada;905;Gabias (Las);7906;3951;3955
18;Granada;082;Galera;1378;685;693
18;Granada;083;Gobernador;390;198;192
18;Granada;084;Gójar;3340;1702;1638
18;Granada;085;Gor;1165;577;588
18;Granada;086;Gorafe;581;281;300
18;Granada;087;Granada;241471;112719;128752
18;Granada;088;Guadahortuna;2303;1181;1122
18;Granada;089;Guadix;20322;10060;10262
18;Granada;906;Guajares (Los);1361;693;668
18;Granada;093;Gualchos;2968;1496;1472
18;Granada;094;Güejar Sierra;2698;1369;1329
18;Granada;095;Güevéjar;1438;716;722
18;Granada;096;Huélago;644;336;308
18;Granada;097;Huéneja;1277;627;650
18;Granada;098;Huéscar;8013;3957;4056
18;Granada;099;Huétor de Santillán;1649;857;792
18;Granada;100;Huétor Tájar;8298;4126;4172
18;Granada;101;Huétor Vega;8297;4152;4145
18;Granada;102;Illora;10664;5357;5307
18;Granada;103;Itrabo;1029;505;524
18;Granada;105;Iznalloz;6451;3264;3187
18;Granada;107;Jayena;1395;707;688
18;Granada;108;Jerez del Marquesado;1174;590;584
18;Granada;109;Jete;752;362;390
18;Granada;111;Jun;1623;819;804
18;Granada;112;Juviles;187;95;92
18;Granada;115;Láchar;2434;1228;1206
18;Granada;116;Lanjarón;3877;1918;1959
18;Granada;117;Lanteira;669;337;332
18;Granada;119;Lecrín;2375;1173;1202
18;Granada;120;Lentegí;347;160;187
18;Granada;121;Lobras;181;88;93
18;Granada;122;Loja;20143;9969;10174
18;Granada;123;Lugros;412;209;203
18;Granada;124;Lújar;562;298;264
18;Granada;126;Malahá (La);1576;797;779
18;Granada;127;Maracena;14331;7139;7192
18;Granada;128;Marchal;439;209;230
18;Granada;132;Moclín;4618;2283;2335
18;Granada;133;Molvízar;2670;1307;1363
18;Granada;134;Monachil;4831;2436;2395
18;Granada;135;Montefrío;7030;3522;3508
18;Granada;136;Montejícar;2888;1458;1430
18;Granada;137;Montillana;1396;704;692
18;Granada;138;Moraleda de Zafayona;2722;1390;1332
18;Granada;909;Morelábor;917;466;451
18;Granada;140;Motril;50025;24668;25357
18;Granada;141;Murtas;852;438;414
18;Granada;903;Nevada;1369;700;669
18;Granada;143;Nigüelas;1154;586;568
18;Granada;144;Nívar;641;330;311
18;Granada;145;Ogíjares;8123;4084;4039
18;Granada;146;Orce;1427;718;709
18;Granada;147;Órgiva;5039;2531;2508
18;Granada;148;Otívar;1096;547;549
18;Granada;149;Otura;3828;1908;1920
18;Granada;150;Padul;6632;3321;3311
18;Granada;151;Pampaneira;337;172;165
18;Granada;152;Pedro Martínez;1499;755;744
18;Granada;153;Peligros;7380;3653;3727
18;Granada;154;Peza (La);1450;764;686
18;Granada;910;Pinar (El);1253;630;623
18;Granada;157;Pinos Genil;1186;619;567
18;Granada;158;Pinos Puente;13215;6640;6575
18;Granada;159;Píñar;1397;724;673
18;Granada;161;Polícar;254;133;121
18;Granada;162;Polopos;1264;655;609
18;Granada;163;Pórtugos;444;216;228
18;Granada;164;Puebla de Don Fadrique;2569;1283;1286
18;Granada;165;Pulianas;3599;1833;1766
18;Granada;167;Purullena;2068;1014;1054
18;Granada;168;Quéntar;1108;551;557
18;Granada;170;Rubite;410;217;193
18;Granada;171;Salar;2783;1380;1403
18;Granada;173;Salobreña;10053;5010;5043
18;Granada;174;Santa Cruz del Comercio;555;292;263
18;Granada;175;Santa Fe;12387;6083;6304
18;Granada;176;Soportújar;288;153;135
18;Granada;177;Sorvilán;679;344;335
18;Granada;901;Taha (La);830;414;416
18;Granada;178;Torre-Cardela;1225;613;612
18;Granada;179;Torvizcón;972;490;482
18;Granada;180;Trevélez;793;417;376
18;Granada;181;Turón;361;205;156
18;Granada;182;Ugíjar;2572;1278;1294
18;Granada;907;Valle del Zalabí;2417;1193;1224
18;Granada;902;Valle (El);1377;669;708
18;Granada;183;Válor;1001;506;495
18;Granada;911;Vegas del Genil;2758;1391;1367
18;Granada;184;Vélez de Benaudalla;2563;1252;1311
18;Granada;185;Ventas de Huelma;675;327;348
18;Granada;908;Villamena;1010;474;536
18;Granada;187;Villanueva de las Torres;965;505;460
18;Granada;188;Villanueva Mesía;1897;941;956
18;Granada;189;Víznar;743;388;355
18;Granada;192;Zafarraya;2213;1143;1070
18;Granada;913;Zagra;1215;600;615
18;Granada;193;Zubia (La);12407;6101;6306
18;Granada;194;Zújar;2887;1469;1418
19;Guadalajara;001;Abánades;115;62;53
19;Guadalajara;002;Ablanque;158;79;79
19;Guadalajara;003;Adobes;43;22;21
19;Guadalajara;004;Alaminos;86;40;46
19;Guadalajara;005;Alarilla;122;67;55
19;Guadalajara;006;Albalate de Zorita;1002;533;469
19;Guadalajara;007;Albares;497;243;254
19;Guadalajara;008;Albendiego;47;27;20
19;Guadalajara;009;Alcocer;299;153;146
19;Guadalajara;010;Alcolea de las Peñas;32;17;15
19;Guadalajara;011;Alcolea del Pinar;397;197;200
19;Guadalajara;013;Alcoroches;202;111;91
19;Guadalajara;015;Aldeanueva de Guadalajara;101;44;57
19;Guadalajara;016;Algar de Mesa;83;45;38
19;Guadalajara;017;Algora;117;64;53
19;Guadalajara;018;Alhóndiga;241;136;105
19;Guadalajara;019;Alique;27;8;19
19;Guadalajara;020;Almadrones;90;54;36
19;Guadalajara;021;Almoguera;899;469;430
19;Guadalajara;022;Almonacid de Zorita;921;446;475
19;Guadalajara;023;Alocén;147;67;80
19;Guadalajara;024;Alovera;1444;745;699
19;Guadalajara;027;Alustante;261;140;121
19;Guadalajara;031;Angón;47;26;21
19;Guadalajara;032;Anguita;299;156;143
19;Guadalajara;033;Anquela del Ducado;98;51;47
19;Guadalajara;034;Anquela del Pedregal;26;16;10
19;Guadalajara;036;Aranzueque;367;184;183
19;Guadalajara;037;Arbancón;225;121;104
19;Guadalajara;038;Arbeteta;54;28;26
19;Guadalajara;039;Argecilla;113;68;45
19;Guadalajara;040;Armallones;60;37;23
19;Guadalajara;041;Armuña de Tajuña;111;60;51
19;Guadalajara;042;Arroyo de las Fraguas;47;25;22
19;Guadalajara;043;Atanzón;106;60;46
19;Guadalajara;044;Atienza;489;254;235
19;Guadalajara;045;Auñón;260;138;122
19;Guadalajara;046;Azuqueca de Henares;17505;8876;8629
19;Guadalajara;047;Baides;93;50;43
19;Guadalajara;048;Baños de Tajo;31;20;11
19;Guadalajara;049;Bañuelos;30;17;13
19;Guadalajara;050;Barriopedro;36;15;21
19;Guadalajara;051;Berninches;115;66;49
19;Guadalajara;052;Bodera (La);60;33;27
19;Guadalajara;053;Brihuega;2916;1483;1433
19;Guadalajara;054;Budia;282;152;130
19;Guadalajara;055;Bujalaro;85;46;39
19;Guadalajara;057;Bustares;105;58;47
19;Guadalajara;058;Cabanillas del Campo;2287;1176;1111
19;Guadalajara;059;Campillo de Dueñas;142;85;57
19;Guadalajara;060;Campillo de Ranas;128;68;60
19;Guadalajara;061;Campisábalos;61;29;32
19;Guadalajara;064;Canredondo;108;54;54
19;Guadalajara;065;Cantalojas;155;83;72
19;Guadalajara;066;Cañizar;108;53;55
19;Guadalajara;067;Cardoso de la Sierra (El);96;62;34
19;Guadalajara;070;Casa de Uceda;116;61;55
19;Guadalajara;071;Casar (El);2742;1422;1320
19;Guadalajara;073;Casas de San Galindo;39;23;16
19;Guadalajara;074;Caspueñas;83;49;34
19;Guadalajara;075;Castejón de Henares;120;65;55
19;Guadalajara;076;Castellar de la Muela;50;22;28
19;Guadalajara;078;Castilforte;54;32;22
19;Guadalajara;079;Castilnuevo;11;5;6
19;Guadalajara;080;Cendejas de Enmedio;126;62;64
19;Guadalajara;081;Cendejas de la Torre;102;59;43
19;Guadalajara;082;Centenera;74;40;34
19;Guadalajara;103;Checa;420;224;196
19;Guadalajara;104;Chequilla;16;8;8
19;Guadalajara;106;Chillarón del Rey;126;66;60
19;Guadalajara;105;Chiloeches;1091;566;525
19;Guadalajara;086;Cifuentes;2299;1156;1143
19;Guadalajara;087;Cincovillas;39;21;18
19;Guadalajara;088;Ciruelas;86;44;42
19;Guadalajara;089;Ciruelos del Pinar;59;31;28
19;Guadalajara;090;Cobeta;122;64;58
19;Guadalajara;091;Cogollor;59;32;27
19;Guadalajara;092;Cogolludo;603;337;266
19;Guadalajara;095;Condemios de Abajo;29;17;12
19;Guadalajara;096;Condemios de Arriba;176;88;88
19;Guadalajara;097;Congostrina;37;15;22
19;Guadalajara;098;Copernal;29;17;12
19;Guadalajara;099;Corduente;470;257;213
19;Guadalajara;102;Cubillo de Uceda (El);134;65;69
19;Guadalajara;107;Driebes;366;191;175
19;Guadalajara;108;Durón;108;53;55
19;Guadalajara;109;Embid;68;37;31
19;Guadalajara;110;Escamilla;132;57;75
19;Guadalajara;111;Escariche;204;107;97
19;Guadalajara;112;Escopete;61;19;42
19;Guadalajara;113;Espinosa de Henares;604;302;302
19;Guadalajara;114;Esplegares;63;36;27
19;Guadalajara;115;Establés;47;26;21
19;Guadalajara;116;Estriégana;27;17;10
19;Guadalajara;117;Fontanar;931;475;456
19;Guadalajara;118;Fuembellida;17;10;7
19;Guadalajara;119;Fuencemillán;123;64;59
19;Guadalajara;120;Fuentelahiguera de Albatages;164;85;79
19;Guadalajara;121;Fuentelencina;176;99;77
19;Guadalajara;122;Fuentelsaz;142;69;73
19;Guadalajara;123;Fuentelviejo;78;38;40
19;Guadalajara;124;Fuentenovilla;222;124;98
19;Guadalajara;125;Gajanejos;89;47;42
19;Guadalajara;126;Galápagos;225;114;111
19;Guadalajara;127;Galve de Sorbe;162;77;85
19;Guadalajara;129;Gascueña de Bornova;48;25;23
19;Guadalajara;130;Guadalajara;68721;33769;34952
19;Guadalajara;132;Henche;79;41;38
19;Guadalajara;133;Heras de Ayuso;129;65;64
19;Guadalajara;134;Herrería;42;18;24
19;Guadalajara;135;Hiendelaencina;139;71;68
19;Guadalajara;136;Hijes;26;14;12
19;Guadalajara;138;Hita;295;163;132
19;Guadalajara;139;Hombrados;48;26;22
19;Guadalajara;142;Hontoba;187;96;91
19;Guadalajara;143;Horche;1407;712;695
19;Guadalajara;145;Hortezuela de Océn;79;41;38
19;Guadalajara;146;Huerce (La);40;22;18
19;Guadalajara;147;Huérmeces del Cerro;66;39;27
19;Guadalajara;148;Huertahernando;74;45;29
19;Guadalajara;150;Hueva;143;71;72
19;Guadalajara;151;Humanes;1223;627;596
19;Guadalajara;152;Illana;684;357;327
19;Guadalajara;153;Iniéstola;18;11;7
19;Guadalajara;154;Inviernas (Las);87;48;39
19;Guadalajara;155;Irueste;68;37;31
19;Guadalajara;156;Jadraque;1272;635;637
19;Guadalajara;157;Jirueque;73;40;33
19;Guadalajara;159;Ledanca;143;75;68
19;Guadalajara;160;Loranca de Tajuña;312;171;141
19;Guadalajara;161;Lupiana;277;147;130
19;Guadalajara;162;Luzaga;124;61;63
19;Guadalajara;163;Luzón;88;43;45
19;Guadalajara;165;Majaelrayo;57;31;26
19;Guadalajara;166;Málaga del Fresno;221;114;107
19;Guadalajara;167;Malaguilla;157;94;63
19;Guadalajara;168;Mandayona;462;217;245
19;Guadalajara;169;Mantiel;69;36;33
19;Guadalajara;170;Maranchón;245;132;113
19;Guadalajara;171;Marchamalo;"";"";""
19;Guadalajara;172;Masegoso de Tajuña;100;49;51
19;Guadalajara;173;Matarrubia;55;34;21
19;Guadalajara;174;Matillas;216;111;105
19;Guadalajara;175;Mazarete;79;38;41
19;Guadalajara;176;Mazuecos;387;197;190
19;Guadalajara;177;Medranda;134;66;68
19;Guadalajara;178;Megina;87;44;43
19;Guadalajara;179;Membrillera;104;49;55
19;Guadalajara;181;Miedes de Atienza;101;51;50
19;Guadalajara;182;Mierla (La);27;15;12
19;Guadalajara;184;Millana;118;60;58
19;Guadalajara;183;Milmarcos;114;61;53
19;Guadalajara;185;Miñosa (La);48;27;21
19;Guadalajara;186;Mirabueno;121;64;57
19;Guadalajara;187;Miralrío;85;50;35
19;Guadalajara;188;Mochales;121;57;64
19;Guadalajara;189;Mohernando;139;81;58
19;Guadalajara;190;Molina de Aragón;3432;1760;1672
19;Guadalajara;191;Monasterio;19;8;11
19;Guadalajara;192;Mondéjar;2065;1029;1036
19;Guadalajara;193;Montarrón;59;33;26
19;Guadalajara;194;Moratilla de los Meleros;111;58;53
19;Guadalajara;195;Morenilla;53;34;19
19;Guadalajara;196;Muduex;122;63;59
19;Guadalajara;197;Navas de Jadraque (Las);26;16;10
19;Guadalajara;198;Negredo;23;10;13
19;Guadalajara;199;Ocentejo;52;23;29
19;Guadalajara;200;Olivar (El);114;56;58
19;Guadalajara;201;Olmeda de Cobeta;75;29;46
19;Guadalajara;202;Olmeda de Jadraque (La);19;9;10
19;Guadalajara;203;Ordial (El);48;20;28
19;Guadalajara;204;Orea;273;148;125
19;Guadalajara;208;Pálmaces de Jadraque;65;34;31
19;Guadalajara;209;Pardos;63;31;32
19;Guadalajara;210;Paredes de Sigüenza;68;36;32
19;Guadalajara;211;Pareja;469;232;237
19;Guadalajara;212;Pastrana;1161;590;571
19;Guadalajara;213;Pedregal (El);110;61;49
19;Guadalajara;214;Peñalén;147;79;68
19;Guadalajara;215;Peñalver;246;142;104
19;Guadalajara;216;Peralejos de las Truchas;176;92;84
19;Guadalajara;217;Peralveche;79;42;37
19;Guadalajara;218;Pinilla de Jadraque;92;47;45
19;Guadalajara;219;Pinilla de Molina;26;17;9
19;Guadalajara;220;Pioz;366;195;171
19;Guadalajara;221;Piqueras;60;34;26
19;Guadalajara;222;Pobo de Dueñas (El);180;97;83
19;Guadalajara;223;Poveda de la Sierra;207;107;100
19;Guadalajara;224;Pozo de Almoguera;207;106;101
19;Guadalajara;225;Pozo de Guadalajara;379;200;179
19;Guadalajara;226;Prádena de Atienza;38;23;15
19;Guadalajara;227;Prados Redondos;86;51;35
19;Guadalajara;228;Puebla de Beleña;41;26;15
19;Guadalajara;229;Puebla de Valles;67;37;30
19;Guadalajara;230;Quer;102;49;53
19;Guadalajara;231;Rebollosa de Jadraque;39;21;18
19;Guadalajara;232;Recuenco (El);93;48;45
19;Guadalajara;233;Renera;64;34;30
19;Guadalajara;234;Retiendas;51;25;26
19;Guadalajara;235;Riba de Saelices;183;100;83
19;Guadalajara;237;Rillo de Gallo;66;38;28
19;Guadalajara;238;Riofrío del Llano;75;44;31
19;Guadalajara;239;Robledillo de Mohernando;174;89;85
19;Guadalajara;240;Robledo de Corpes;73;38;35
19;Guadalajara;241;Romanillos de Atienza;70;42;28
19;Guadalajara;242;Romanones;143;82;61
19;Guadalajara;243;Rueda de la Sierra;70;38;32
19;Guadalajara;244;Sacecorbo;134;79;55
19;Guadalajara;245;Sacedón;1538;769;769
19;Guadalajara;246;Saelices de la Sal;68;34;34
19;Guadalajara;247;Salmerón;285;152;133
19;Guadalajara;248;San Andrés del Congosto;84;44;40
19;Guadalajara;249;San Andrés del Rey;42;17;25
19;Guadalajara;250;Santiuste;29;14;15
19;Guadalajara;251;Saúca;70;36;34
19;Guadalajara;252;Sayatón;172;92;80
19;Guadalajara;254;Selas;57;26;31
19;Guadalajara;901;Semillas;35;16;19
19;Guadalajara;255;Setiles;160;88;72
19;Guadalajara;256;Sienes;91;51;40
19;Guadalajara;257;Sigüenza;4801;2407;2394
19;Guadalajara;258;Solanillos del Extremo;127;66;61
19;Guadalajara;259;Somolinos;40;20;20
19;Guadalajara;260;Sotillo (El);50;30;20
19;Guadalajara;261;Sotodosos;64;31;33
19;Guadalajara;262;Tamajón;226;111;115
19;Guadalajara;263;Taragudo;31;18;13
19;Guadalajara;264;Taravilla;72;37;35
19;Guadalajara;265;Tartanedo;207;103;104
19;Guadalajara;266;Tendilla;361;188;173
19;Guadalajara;267;Terzaga;35;22;13
19;Guadalajara;268;Tierzo;43;23;20
19;Guadalajara;269;Toba (La);116;66;50
19;Guadalajara;271;Tordellego;76;38;38
19;Guadalajara;270;Tordelrábano;16;8;8
19;Guadalajara;272;Tordesilos;141;74;67
19;Guadalajara;274;Torija;365;178;187
19;Guadalajara;279;Torre del Burgo;66;36;30
19;Guadalajara;277;Torrecuadrada de Molina;17;11;6
19;Guadalajara;278;Torrecuadradilla;72;44;28
19;Guadalajara;280;Torrejón del Rey;974;509;465
19;Guadalajara;281;Torremocha de Jadraque;16;12;4
19;Guadalajara;282;Torremocha del Campo;326;180;146
19;Guadalajara;283;Torremocha del Pinar;73;34;39
19;Guadalajara;284;Torremochuela;14;7;7
19;Guadalajara;285;Torrubia;45;24;21
19;Guadalajara;286;Tórtola de Henares;384;197;187
19;Guadalajara;287;Tortuera;238;123;115
19;Guadalajara;288;Tortuero;43;25;18
19;Guadalajara;289;Traíd;62;29;33
19;Guadalajara;290;Trijueque;526;279;247
19;Guadalajara;291;Trillo;1447;741;706
19;Guadalajara;293;Uceda;824;411;413
19;Guadalajara;294;Ujados;36;20;16
19;Guadalajara;296;Utande;60;37;23
19;Guadalajara;297;Valdarachas;30;12;18
19;Guadalajara;298;Valdearenas;66;34;32
19;Guadalajara;299;Valdeavellano;97;52;45
19;Guadalajara;300;Valdeaveruelo;229;125;104
19;Guadalajara;301;Valdeconcha;46;26;20
19;Guadalajara;302;Valdegrudas;58;31;27
19;Guadalajara;303;Valdelcubo;68;40;28
19;Guadalajara;304;Valdenuño Fernández;141;72;69
19;Guadalajara;305;Valdepeñas de la Sierra;237;132;105
19;Guadalajara;306;Valderrebollo;36;20;16
19;Guadalajara;307;Valdesotos;44;19;25
19;Guadalajara;308;Valfermoso de Tajuña;109;57;52
19;Guadalajara;309;Valhermoso;35;20;15
19;Guadalajara;310;Valtablado del Río;15;10;5
19;Guadalajara;311;Valverde de los Arroyos;100;55;45
19;Guadalajara;314;Viana de Jadraque;61;36;25
19;Guadalajara;317;Villanueva de Alcorón;301;167;134
19;Guadalajara;318;Villanueva de Argecilla;40;21;19
19;Guadalajara;319;Villanueva de la Torre;322;163;159
19;Guadalajara;321;Villares de Jadraque;54;26;28
19;Guadalajara;322;Villaseca de Henares;75;36;39
19;Guadalajara;323;Villaseca de Uceda;64;35;29
19;Guadalajara;324;Villel de Mesa;261;136;125
19;Guadalajara;325;Viñuelas;118;70;48
19;Guadalajara;326;Yebes;169;122;47
19;Guadalajara;327;Yebra;562;288;274
19;Guadalajara;329;Yélamos de Abajo;102;49;53
19;Guadalajara;330;Yélamos de Arriba;153;78;75
19;Guadalajara;331;Yunquera de Henares;2005;1016;989
19;Guadalajara;332;Yunta (La);177;88;89
19;Guadalajara;333;Zaorejas;195;111;84
19;Guadalajara;334;Zarzuela de Jadraque;28;13;15
19;Guadalajara;335;Zorita de los Canes;111;62;49
20;Guipúzcoa;001;Abaltzisketa;265;155;110
20;Guipúzcoa;002;Aduna;308;165;143
20;Guipúzcoa;016;Aia;1651;925;726
20;Guipúzcoa;003;Aizarnazabal;543;293;250
20;Guipúzcoa;004;Albiztur;288;158;130
20;Guipúzcoa;005;Alegia;1639;835;804
20;Guipúzcoa;006;Alkiza;255;146;109
20;Guipúzcoa;906;Altzaga;97;50;47
20;Guipúzcoa;007;Altzo;330;178;152
20;Guipúzcoa;008;Amezketa;1006;533;473
20;Guipúzcoa;009;Andoain;14371;7193;7178
20;Guipúzcoa;010;Anoeta;1749;903;846
20;Guipúzcoa;011;Antzuola;1920;987;933
20;Guipúzcoa;012;Arama;158;77;81
20;Guipúzcoa;013;Aretxabaleta;5975;3056;2919
20;Guipúzcoa;055;Arrasate/Mondragón;24185;12093;12092
20;Guipúzcoa;014;Asteasu;1172;634;538
20;Guipúzcoa;903;Astigarraga;3201;1584;1617
20;Guipúzcoa;015;Ataun;1574;811;763
20;Guipúzcoa;017;Azkoitia;10231;5066;5165
20;Guipúzcoa;018;Azpeitia;13606;6826;6780
20;Guipúzcoa;904;Baliarrain;84;41;43
20;Guipúzcoa;019;Beasain;12297;6150;6147
20;Guipúzcoa;020;Beizama;163;92;71
20;Guipúzcoa;021;Belauntza;295;160;135
20;Guipúzcoa;022;Berastegi;951;513;438
20;Guipúzcoa;074;Bergara;15141;7531;7610
20;Guipúzcoa;023;Berrobi;552;300;252
20;Guipúzcoa;024;Bidegoyan;414;235;179
20;Guipúzcoa;029;Deba;5032;2555;2477
20;Guipúzcoa;069;Donostia/San Sebastián;178229;83416;94813
20;Guipúzcoa;030;Eibar;29747;14594;15153
20;Guipúzcoa;031;Elduain;221;119;102
20;Guipúzcoa;033;Elgeta;984;503;481
20;Guipúzcoa;032;Elgoibar;10869;5423;5446
20;Guipúzcoa;067;Errenteria;39376;19431;19945
20;Guipúzcoa;066;Errezil;638;345;293
20;Guipúzcoa;034;Eskoriatza;3987;2072;1915
20;Guipúzcoa;035;Ezkio-Itsaso;537;285;252
20;Guipúzcoa;038;Gabiria;436;242;194
20;Guipúzcoa;037;Gaintza;132;80;52
20;Guipúzcoa;907;Gaztelu;148;88;60
20;Guipúzcoa;039;Getaria;2345;1184;1161
20;Guipúzcoa;040;Hernani;18787;9338;9449
20;Guipúzcoa;041;Hernialde;302;151;151
20;Guipúzcoa;036;Hondarribia;14546;7250;7296
20;Guipúzcoa;042;Ibarra;4380;2278;2102
20;Guipúzcoa;043;Idiazabal;2032;1037;995
20;Guipúzcoa;044;Ikaztegieta;379;199;180
20;Guipúzcoa;045;Irún;55196;26943;28253
20;Guipúzcoa;046;Irura;745;380;365
20;Guipúzcoa;047;Itsasondo;609;304;305
20;Guipúzcoa;048;Larraul;136;81;55
20;Guipúzcoa;902;Lasarte-Oria;17750;8837;8913
20;Guipúzcoa;049;Lazkao;4847;2492;2355
20;Guipúzcoa;050;Leaburu;356;190;166
20;Guipúzcoa;051;Legazpi;9126;4675;4451
20;Guipúzcoa;052;Legorreta;1423;716;707
20;Guipúzcoa;068;Leintz-Gatzaga;254;139;115
20;Guipúzcoa;053;Lezo;5798;2877;2921
20;Guipúzcoa;054;Lizartza;621;326;295
20;Guipúzcoa;901;Mendaro;1284;661;623
20;Guipúzcoa;057;Mutiloa;158;81;77
20;Guipúzcoa;056;Mutriku;4743;2355;2388
20;Guipúzcoa;063;Oiartzun;9003;4525;4478
20;Guipúzcoa;058;Olaberria;985;509;476
20;Guipúzcoa;076;Ordizia;9066;4421;4645
20;Guipúzcoa;905;Orendain;150;85;65
20;Guipúzcoa;060;Orexa;80;42;38
20;Guipúzcoa;061;Orio;4294;2169;2125
20;Guipúzcoa;062;Ormaiztegi;1173;587;586
20;Guipúzcoa;059;Oñati;10634;5322;5312
20;Guipúzcoa;064;Pasaia;17255;8409;8846
20;Guipúzcoa;070;Segura;1263;623;640
20;Guipúzcoa;065;Soraluze/Placencia de las Armas;4337;2165;2172
20;Guipúzcoa;071;Tolosa;18066;8673;9393
20;Guipúzcoa;072;Urnieta;5295;2700;2595
20;Guipúzcoa;077;Urretxu;6283;3137;3146
20;Guipúzcoa;073;Usurbil;5282;2714;2568
20;Guipúzcoa;075;Villabona;5408;2746;2662
20;Guipúzcoa;078;Zaldibia;1550;811;739
20;Guipúzcoa;079;Zarautz;19716;9716;10000
20;Guipúzcoa;025;Zegama;1312;669;643
20;Guipúzcoa;026;Zerain;236;118;118
20;Guipúzcoa;027;Zestoa;3182;1646;1536
20;Guipúzcoa;028;Zizurkil;2660;1357;1303
20;Guipúzcoa;081;Zumaia;8305;4153;4152
20;Guipúzcoa;080;Zumarraga;10330;5170;5160
21;Huelva;001;Alájar;774;391;383
21;Huelva;002;Aljaraque;9743;4882;4861
21;Huelva;003;Almendro (El);880;454;426
21;Huelva;004;Almonaster la Real;2016;980;1036
21;Huelva;005;Almonte;16902;8470;8432
21;Huelva;006;Alosno;4861;2346;2515
21;Huelva;007;Aracena;6683;3279;3404
21;Huelva;008;Aroche;3542;1755;1787
21;Huelva;009;Arroyomolinos de León;1163;591;572
21;Huelva;010;Ayamonte;16891;8287;8604
21;Huelva;011;Beas;4165;2083;2082
21;Huelva;012;Berrocal;416;207;209
21;Huelva;013;Bollullos Par del Condado;12634;6279;6355
21;Huelva;014;Bonares;5056;2563;2493
21;Huelva;015;Cabezas Rubias;973;500;473
21;Huelva;016;Cala;1450;724;726
21;Huelva;017;Calañas;4928;2432;2496
21;Huelva;018;Campillo (El);2446;1180;1266
21;Huelva;019;Campofrío;866;443;423
21;Huelva;020;Cañaveral de León;514;249;265
21;Huelva;021;Cartaya;11809;5886;5923
21;Huelva;022;Castaño del Robledo;207;110;97
21;Huelva;023;Cerro de Andévalo (El);2762;1344;1418
21;Huelva;030;Chucena;1943;984;959
21;Huelva;024;Corteconcepción;680;341;339
21;Huelva;025;Cortegana;5137;2554;2583
21;Huelva;026;Cortelazor;326;164;162
21;Huelva;027;Cumbres de Enmedio;63;32;31
21;Huelva;028;Cumbres de San Bartolomé;575;287;288
21;Huelva;029;Cumbres Mayores;2161;1058;1103
21;Huelva;031;Encinasola;1865;916;949
21;Huelva;032;Escacena del Campo;2159;1071;1088
21;Huelva;033;Fuenteheridos;658;335;323
21;Huelva;034;Galaroza;1586;771;815
21;Huelva;035;Gibraleón;10868;5485;5383
21;Huelva;036;Granada de Río-Tinto (La);224;114;110
21;Huelva;037;Granado (El);664;363;301
21;Huelva;038;Higuera de la Sierra;1271;643;628
21;Huelva;039;Hinojales;440;218;222
21;Huelva;040;Hinojos;3529;1790;1739
21;Huelva;041;Huelva;139991;67662;72329
21;Huelva;042;Isla Cristina;17761;8895;8866
21;Huelva;043;Jabugo;2590;1299;1291
21;Huelva;044;Lepe;18565;9487;9078
21;Huelva;045;Linares de la Sierra;300;146;154
21;Huelva;046;Lucena del Puerto;2191;1124;1067
21;Huelva;047;Manzanilla;2519;1252;1267
21;Huelva;048;Marines (Los);320;161;159
21;Huelva;049;Minas de Riotinto;5056;2404;2652
21;Huelva;050;Moguer;13749;6972;6777
21;Huelva;051;Nava (La);321;166;155
21;Huelva;052;Nerva;6544;3174;3370
21;Huelva;053;Niebla;3814;1932;1882
21;Huelva;054;Palma del Condado (La);9614;4755;4859
21;Huelva;055;Palos de la Frontera;7009;3563;3446
21;Huelva;056;Paterna del Campo;3914;1994;1920
21;Huelva;057;Paymogo;1247;608;639
21;Huelva;058;Puebla de Guzmán;3228;1625;1603
21;Huelva;059;Puerto Moral;242;120;122
21;Huelva;060;Punta Umbría;11523;5870;5653
21;Huelva;061;Rociana del Condado;6310;3222;3088
21;Huelva;062;Rosal de la Frontera;1880;896;984
21;Huelva;063;San Bartolomé de la Torre;2909;1485;1424
21;Huelva;064;San Juan del Puerto;5910;2959;2951
21;Huelva;066;San Silvestre de Guzmán;648;318;330
21;Huelva;065;Sanlúcar de Guadiana;393;197;196
21;Huelva;067;Santa Ana la Real;495;236;259
21;Huelva;068;Santa Bárbara de Casa;1377;684;693
21;Huelva;069;Santa Olalla del Cala;2278;1147;1131
21;Huelva;070;Trigueros;7229;3602;3627
21;Huelva;071;Valdelarco;279;133;146
21;Huelva;072;Valverde del Camino;12510;6081;6429
21;Huelva;073;Villablanca;2052;1066;986
21;Huelva;074;Villalba del Alcor;3587;1778;1809
21;Huelva;075;Villanueva de las Cruces;428;198;230
21;Huelva;076;Villanueva de los Castillejos;2677;1314;1363
21;Huelva;077;Villarrasa;2082;1063;1019
21;Huelva;078;Zalamea la Real;3489;1715;1774
21;Huelva;079;Zufre;1097;569;528
22;Huesca;001;Abiego;290;147;143
22;Huesca;002;Abizanda;140;73;67
22;Huesca;003;Adahuesca;158;83;75
22;Huesca;004;Agüero;157;81;76
22;Huesca;907;Aínsa-Sobrarbe;1557;804;753
22;Huesca;006;Aisa;363;199;164
22;Huesca;007;Albalate de Cinca;1090;542;548
22;Huesca;008;Albalatillo;270;136;134
22;Huesca;009;Albelda;962;489;473
22;Huesca;011;Albero Alto;100;53;47
22;Huesca;012;Albero Bajo;119;64;55
22;Huesca;013;Alberuela de Tubo;388;193;195
22;Huesca;014;Alcalá de Gurrea;342;166;176
22;Huesca;015;Alcalá del Obispo;355;180;175
22;Huesca;016;Alcampell;950;474;476
22;Huesca;017;Alcolea de Cinca;1237;623;614
22;Huesca;018;Alcubierre;467;248;219
22;Huesca;019;Alerre;181;94;87
22;Huesca;020;Alfántega;128;65;63
22;Huesca;021;Almudévar;2373;1220;1153
22;Huesca;022;Almunia de San Juan;709;355;354
22;Huesca;023;Almuniente;619;321;298
22;Huesca;024;Alquézar;304;157;147
22;Huesca;025;Altorricón;1448;750;698
22;Huesca;027;Angüés;429;234;195
22;Huesca;028;Ansó;527;262;265
22;Huesca;029;Antillón;161;78;83
22;Huesca;032;Aragüés del Puerto;138;82;56
22;Huesca;035;Arén;398;205;193
22;Huesca;036;Argavieso;127;73;54
22;Huesca;037;Arguis;57;30;27
22;Huesca;039;Ayerbe;1116;576;540
22;Huesca;040;Azanuy-Alins;203;97;106
22;Huesca;041;Azara;224;111;113
22;Huesca;042;Azlor;166;83;83
22;Huesca;043;Baélls;157;89;68
22;Huesca;044;Bailo;321;186;135
22;Huesca;045;Baldellou;156;83;73
22;Huesca;046;Ballobar;1084;544;540
22;Huesca;047;Banastás;177;94;83
22;Huesca;048;Barbastro;14462;7027;7435
22;Huesca;049;Barbués;119;61;58
22;Huesca;050;Barbuñales;109;55;54
22;Huesca;051;Bárcabo;120;66;54
22;Huesca;052;Belver de Cinca;1397;728;669
22;Huesca;053;Benabarre;1166;600;566
22;Huesca;054;Benasque;1312;693;619
22;Huesca;055;Berbegal;476;241;235
22;Huesca;057;Bielsa;461;239;222
22;Huesca;058;Bierge;224;128;96
22;Huesca;059;Biescas;1243;651;592
22;Huesca;060;Binaced;1597;815;782
22;Huesca;061;Binéfar;8115;4053;4062
22;Huesca;062;Bisaurri;220;123;97
22;Huesca;063;Biscarrués;227;123;104
22;Huesca;064;Blecua y Torres;178;95;83
22;Huesca;066;Boltaña;846;437;409
22;Huesca;067;Bonansa;74;38;36
22;Huesca;068;Borau;76;39;37
22;Huesca;069;Broto;511;261;250
22;Huesca;072;Caldearenas;260;144;116
22;Huesca;074;Campo;360;171;189
22;Huesca;075;Camporrélls;254;130;124
22;Huesca;076;Canal de Berdún;433;239;194
22;Huesca;077;Candasnos;569;295;274
22;Huesca;078;Canfranc;526;290;236
22;Huesca;079;Capdesaso;177;81;96
22;Huesca;080;Capella;402;204;198
22;Huesca;081;Casbas de Huesca;308;164;144
22;Huesca;083;Castejón de Monegros;723;360;363
22;Huesca;084;Castejón de Sos;532;275;257
22;Huesca;082;Castejón del Puente;400;210;190
22;Huesca;085;Castelflorite;152;79;73
22;Huesca;086;Castiello de Jaca;160;82;78
22;Huesca;087;Castigaleu;104;59;45
22;Huesca;088;Castillazuelo;233;110;123
22;Huesca;089;Castillonroy;423;207;216
22;Huesca;094;Chalamera;166;94;72
22;Huesca;095;Chía;115;64;51
22;Huesca;096;Chimillas;177;96;81
22;Huesca;090;Colungo;124;65;59
22;Huesca;099;Esplús;797;380;417
22;Huesca;102;Estada;185;95;90
22;Huesca;103;Estadilla;928;477;451
22;Huesca;105;Estopiñán del Castillo;188;98;90
22;Huesca;106;Fago;40;25;15
22;Huesca;107;Fanlo;118;70;48
22;Huesca;109;Fiscal;229;124;105
22;Huesca;110;Fonz;1123;572;551
22;Huesca;111;Foradada del Toscar;252;120;132
22;Huesca;112;Fraga;11804;5900;5904
22;Huesca;113;Fueva (La);626;331;295
22;Huesca;114;Gistaín;181;106;75
22;Huesca;115;Grado (El);571;296;275
22;Huesca;116;Grañén;2006;1018;988
22;Huesca;117;Graus;3232;1633;1599
22;Huesca;119;Gurrea de Gállego;1871;956;915
22;Huesca;122;Hoz de Jaca;76;32;44
22;Huesca;908;Hoz y Costean;268;143;125
22;Huesca;124;Huerto;275;153;122
22;Huesca;125;Huesca;45485;21904;23581
22;Huesca;126;Ibieca;105;53;52
22;Huesca;127;Igriés;185;94;91
22;Huesca;128;Ilche;284;150;134
22;Huesca;129;Isábena;257;132;125
22;Huesca;130;Jaca;11197;5537;5660
22;Huesca;131;Jasa;124;67;57
22;Huesca;133;Labuerda;165;87;78
22;Huesca;135;Laluenga;265;138;127
22;Huesca;136;Lalueza;1267;678;589
22;Huesca;137;Lanaja;1605;839;766
22;Huesca;139;Laperdiguera;102;51;51
22;Huesca;141;Lascellas-Ponzano;164;84;80
22;Huesca;142;Lascuarre;170;91;79
22;Huesca;143;Laspaúles;284;156;128
22;Huesca;144;Laspuña;268;144;124
22;Huesca;149;Loarre;396;211;185
22;Huesca;150;Loporzano;524;271;253
22;Huesca;151;Loscorrales;129;68;61
22;Huesca;905;Lupiñén-Ortilla;360;195;165
22;Huesca;155;Monesma y Cajigar;106;56;50
22;Huesca;156;Monflorite-Lascasas;192;105;87
22;Huesca;157;Montanuy;306;170;136
22;Huesca;158;Monzón;14539;7307;7232
22;Huesca;160;Naval;302;151;151
22;Huesca;162;Novales;189;95;94
22;Huesca;163;Nueno;215;118;97
22;Huesca;164;Olvena;55;24;31
22;Huesca;165;Ontiñena;656;332;324
22;Huesca;167;Osso de Cinca;750;405;345
22;Huesca;168;Palo;26;14;12
22;Huesca;170;Panticosa;647;324;323
22;Huesca;172;Peñalba;812;406;406
22;Huesca;173;Peñas de Riglos (Las);276;156;120
22;Huesca;174;Peralta de Alcofea;727;361;366
22;Huesca;175;Peralta de Calasanz;292;153;139
22;Huesca;176;Peraltilla;171;92;79
22;Huesca;177;Perarrúa;135;65;70
22;Huesca;178;Pertusa;149;77;72
22;Huesca;181;Piracés;101;64;37
22;Huesca;182;Plan;306;167;139
22;Huesca;184;Poleñino;252;126;126
22;Huesca;186;Pozán de Vero;254;122;132
22;Huesca;187;Puebla de Castro (La);306;160;146
22;Huesca;188;Puente de Montañana;129;60;69
22;Huesca;902;Puente la Reina de Jaca;241;125;116
22;Huesca;189;Puértolas;213;120;93
22;Huesca;190;Pueyo de Araguás (El);163;100;63
22;Huesca;193;Pueyo de Santa Cruz;359;185;174
22;Huesca;195;Quicena;135;71;64
22;Huesca;197;Robres;690;357;333
22;Huesca;199;Sabiñánigo;8637;4376;4261
22;Huesca;200;Sahún;311;168;143
22;Huesca;201;Salas Altas;389;197;192
22;Huesca;202;Salas Bajas;173;77;96
22;Huesca;203;Salillas;128;67;61
22;Huesca;204;Sallent de Gállego;1016;537;479
22;Huesca;205;San Esteban de Litera;634;317;317
22;Huesca;207;San Juan de Plan;162;90;72
22;Huesca;903;San Miguel del Cinca;903;473;430
22;Huesca;206;Sangarrén;283;140;143
22;Huesca;208;Santa Cilia;204;109;95
22;Huesca;209;Santa Cruz de la Serós;155;89;66
22;Huesca;906;Santa María de Dulcis;210;107;103
22;Huesca;212;Santaliestra y San Quílez;97;56;41
22;Huesca;213;Sariñena;4026;2001;2025
22;Huesca;214;Secastilla;163;71;92
22;Huesca;215;Seira;210;107;103
22;Huesca;217;Sena;596;313;283
22;Huesca;218;Senés de Alcubierre;60;31;29
22;Huesca;220;Sesa;268;136;132
22;Huesca;221;Sesué;123;64;59
22;Huesca;222;Siétamo;373;207;166
22;Huesca;223;Sopeira;105;53;52
22;Huesca;904;Sotonera (La);1108;589;519
22;Huesca;225;Tamarite de Litera;3838;1913;1925
22;Huesca;226;Tardienta;1063;550;513
22;Huesca;227;Tella-Sin;267;137;130
22;Huesca;228;Tierz;180;91;89
22;Huesca;229;Tolva;209;110;99
22;Huesca;230;Torla;330;174;156
22;Huesca;232;Torralba de Aragón;133;62;71
22;Huesca;233;Torre la Ribera;120;65;55
22;Huesca;234;Torrente de Cinca;1121;555;566
22;Huesca;235;Torres de Alcanadre;139;80;59
22;Huesca;236;Torres de Barbués;365;185;180
22;Huesca;239;Tramaced;105;63;42
22;Huesca;242;Valfarta;101;56;45
22;Huesca;243;Valle de Bardají;56;29;27
22;Huesca;901;Valle de Hecho;980;514;466
22;Huesca;244;Valle de Lierp;60;31;29
22;Huesca;245;Velilla de Cinca;489;244;245
22;Huesca;909;Vencillón;480;245;235
22;Huesca;246;Veracruz;116;62;54
22;Huesca;247;Viacamp y Litera;33;22;11
22;Huesca;248;Vicién;116;64;52
22;Huesca;249;Villanova;104;56;48
22;Huesca;250;Villanúa;332;167;165
22;Huesca;251;Villanueva de Sigena;495;249;246
22;Huesca;252;Yebra de Basa;162;97;65
22;Huesca;253;Yésero;61;33;28
22;Huesca;254;Zaidín;1688;842;846
23;Jaén;001;Albanchez de Mágina;1496;766;730
23;Jaén;002;Alcalá la Real;21493;10626;10867
23;Jaén;003;Alcaudete;11346;5626;5720
23;Jaén;004;Aldeaquemada;613;317;296
23;Jaén;005;Andújar;38254;18938;19316
23;Jaén;006;Arjona;5683;2876;2807
23;Jaén;007;Arjonilla;3996;1998;1998
23;Jaén;008;Arquillos;1892;941;951
23;Jaén;905;Arroyo del Ojanco;"";"";""
23;Jaén;009;Baeza;15635;7665;7970
23;Jaén;010;Bailén;17414;8905;8509
23;Jaén;011;Baños de la Encina;2747;1399;1348
23;Jaén;012;Beas de Segura;8092;4115;3977
23;Jaén;902;Bedmar y Garcíez;3220;1631;1589
23;Jaén;014;Begíjar;3176;1601;1575
23;Jaén;015;Bélmez de la Moraleda;2067;1062;1005
23;Jaén;016;Benatae;581;310;271
23;Jaén;017;Cabra del Santo Cristo;2249;1151;1098
23;Jaén;018;Cambil;3221;1694;1527
23;Jaén;019;Campillo de Arenas;2250;1144;1106
23;Jaén;020;Canena;2142;1042;1100
23;Jaén;021;Carboneros;696;344;352
23;Jaén;901;Cárcheles;1550;770;780
23;Jaén;024;Carolina (La);14674;7198;7476
23;Jaén;025;Castellar;3654;1842;1812
23;Jaén;026;Castillo de Locubín;5366;2628;2738
23;Jaén;027;Cazalilla;821;399;422
23;Jaén;028;Cazorla;8527;4156;4371
23;Jaén;029;Chiclana de Segura;1488;736;752
23;Jaén;030;Chilluévar;1781;881;900
23;Jaén;031;Escañuela;976;488;488
23;Jaén;032;Espelúy;805;391;414
23;Jaén;033;Frailes;1872;955;917
23;Jaén;034;Fuensanta de Martos;3377;1681;1696
23;Jaén;035;Fuerte del Rey;1165;576;589
23;Jaén;037;Génave;719;373;346
23;Jaén;038;Guardia de Jaén (La);2093;1089;1004
23;Jaén;039;Guarromán;2825;1403;1422
23;Jaén;041;Higuera de Calatrava;706;366;340
23;Jaén;042;Hinojares;502;245;257
23;Jaén;043;Hornos;741;365;376
23;Jaén;044;Huelma;6051;3082;2969
23;Jaén;045;Huesa;2702;1365;1337
23;Jaén;046;Ibros;3036;1525;1511
23;Jaén;047;Iruela (La);2031;1036;995
23;Jaén;048;Iznatoraf;1204;593;611
23;Jaén;049;Jabalquinto;2583;1284;1299
23;Jaén;050;Jaén;107184;51658;55526
23;Jaén;051;Jamilena;3289;1673;1616
23;Jaén;052;Jimena;1589;769;820
23;Jaén;053;Jódar;12115;5991;6124
23;Jaén;040;Lahiguera;1921;937;984
23;Jaén;054;Larva;531;270;261
23;Jaén;055;Linares;58410;28516;29894
23;Jaén;056;Lopera;3996;1973;2023
23;Jaén;057;Lupión;1092;521;571
23;Jaén;058;Mancha Real;8970;4594;4376
23;Jaén;059;Marmolejo;7666;3849;3817
23;Jaén;060;Martos;22391;10793;11598
23;Jaén;061;Mengíbar;8535;4291;4244
23;Jaén;062;Montizón;2017;1032;985
23;Jaén;063;Navas de San Juan;5285;2628;2657
23;Jaén;064;Noalejo;2294;1145;1149
23;Jaén;065;Orcera;2261;1135;1126
23;Jaén;066;Peal de Becerro;5280;2611;2669
23;Jaén;067;Pegalajar;3137;1615;1522
23;Jaén;069;Porcuna;6974;3473;3501
23;Jaén;070;Pozo Alcón;6010;3049;2961
23;Jaén;071;Puente de Génave;2048;1036;1012
23;Jaén;072;Puerta de Segura (La);2745;1368;1377
23;Jaén;073;Quesada;6181;3018;3163
23;Jaén;074;Rus;3793;1903;1890
23;Jaén;075;Sabiote;4186;2088;2098
23;Jaén;076;Santa Elena;1043;556;487
23;Jaén;077;Santiago de Calatrava;931;466;465
23;Jaén;904;Santiago-Pontones;4640;2345;2295
23;Jaén;079;Santisteban del Puerto;5074;2577;2497
23;Jaén;080;Santo Tomé;2462;1233;1229
23;Jaén;081;Segura de la Sierra;2186;1093;1093
23;Jaén;082;Siles;2777;1384;1393
23;Jaén;084;Sorihuela del Guadalimar;1269;649;620
23;Jaén;086;Torre del Campo;12675;6347;6328
23;Jaén;085;Torreblascopedro;3044;1509;1535
23;Jaén;087;Torredonjimeno;13773;6775;6998
23;Jaén;088;Torreperogil;7538;3712;3826
23;Jaén;090;Torres;1854;956;898
23;Jaén;091;Torres de Albánchez;1055;528;527
23;Jaén;092;Úbeda;32524;15865;16659
23;Jaén;093;Valdepeñas de Jaén;4573;2305;2268
23;Jaén;094;Vilches;5086;2543;2543
23;Jaén;095;Villacarrillo;11152;5600;5552
23;Jaén;096;Villanueva de la Reina;3331;1660;1671
23;Jaén;097;Villanueva del Arzobispo;8628;4297;4331
23;Jaén;098;Villardompardo;1257;616;641
23;Jaén;099;Villares (Los);4860;2434;2426
23;Jaén;101;Villarrodrigo;588;290;298
23;Jaén;903;Villatorres;4060;2018;2042
24;León;001;Acebedo;291;156;135
24;León;002;Algadefe;382;196;186
24;León;003;Alija del Infantado;1006;503;503
24;León;004;Almanza;776;411;365
24;León;005;Antigua (La);638;336;302
24;León;006;Ardón;697;364;333
24;León;007;Arganza;967;476;491
24;León;008;Astorga;12387;5863;6524
24;León;009;Balboa;484;257;227
24;León;010;Bañeza (La);10312;5010;5302
24;León;011;Barjas;411;219;192
24;León;012;Barrios de Luna (Los);348;174;174
24;León;014;Bembibre;11063;5490;5573
24;León;015;Benavides;3077;1570;1507
24;León;016;Benuza;728;383;345
24;León;017;Bercianos del Páramo;869;431;438
24;León;018;Bercianos del Real Camino;226;114;112
24;León;019;Berlanga del Bierzo;449;215;234
24;León;020;Boca de Huérgano;597;331;266
24;León;021;Boñar;2621;1284;1337
24;León;022;Borrenes;530;270;260
24;León;023;Brazuelo;345;167;178
24;León;024;Burgo Ranero (El);994;521;473
24;León;025;Burón;394;209;185
24;León;026;Bustillo del Páramo;1944;969;975
24;León;027;Cabañas Raras;1287;653;634
24;León;028;Cabreros del Río;632;325;307
24;León;029;Cabrillanes;1165;567;598
24;León;030;Cacabelos;4844;2427;2417
24;León;031;Calzada del Coto;306;167;139
24;León;032;Campazas;179;90;89
24;León;033;Campo de Villavidel;350;182;168
24;León;034;Camponaraya;3084;1497;1587
24;León;036;Candín;428;234;194
24;León;037;Cármenes;441;225;216
24;León;038;Carracedelo;3530;1731;1799
24;León;039;Carrizo;2755;1378;1377
24;León;040;Carrocera;643;318;325
24;León;041;Carucedo;641;309;332
24;León;042;Castilfalé;106;55;51
24;León;043;Castrillo de Cabrera;203;99;104
24;León;044;Castrillo de la Valduerna;245;107;138
24;León;046;Castrocalbón;1406;711;695
24;León;047;Castrocontrigo;1177;581;596
24;León;049;Castropodame;1870;943;927
24;León;050;Castrotierra de Valmadrigal;164;83;81
24;León;051;Cea;773;399;374
24;León;052;Cebanico;267;143;124
24;León;053;Cebrones del Río;729;368;361
24;León;065;Chozas de Abajo;2170;1104;1066
24;León;054;Cimanes de la Vega;704;345;359
24;León;055;Cimanes del Tejar;1073;529;544
24;León;056;Cistierna;4440;2169;2271
24;León;057;Congosto;1765;847;918
24;León;058;Corbillos de los Oteros;316;163;153
24;León;059;Corullón;1245;617;628
24;León;060;Crémenes;1194;570;624
24;León;061;Cuadros;1654;773;881
24;León;062;Cubillas de los Oteros;227;115;112
24;León;063;Cubillas de Rueda;628;318;310
24;León;064;Cubillos del Sil;1498;783;715
24;León;066;Destriana;903;439;464
24;León;067;Encinedo;1067;543;524
24;León;068;Ercina (La);726;358;368
24;León;069;Escobar de Campos;80;48;32
24;León;070;Fabero;6019;3004;3015
24;León;071;Folgoso de la Ribera;1401;690;711
24;León;073;Fresno de la Vega;723;358;365
24;León;074;Fuentes de Carbajal;142;71;71
24;León;076;Garrafe de Torío;1101;558;543
24;León;077;Gordaliza del Pino;369;186;183
24;León;078;Gordoncillo;642;321;321
24;León;079;Gradefes;1379;663;716
24;León;080;Grajal de Campos;303;131;172
24;León;081;Gusendos de los Oteros;234;117;117
24;León;082;Hospital de Órbigo;1145;560;585
24;León;083;Igüeña;2079;1090;989
24;León;084;Izagre;279;140;139
24;León;086;Joarilla de las Matas;458;237;221
24;León;087;Laguna Dalga;961;480;481
24;León;088;Laguna de Negrillos;1598;810;788
24;León;089;León;139809;65340;74469
24;León;092;Llamas de la Ribera;1273;645;628
24;León;090;Lucillo;544;271;273
24;León;091;Luyego;1007;479;528
24;León;093;Magaz de Cepeda;552;263;289
24;León;094;Mansilla de las Mulas;1773;891;882
24;León;095;Mansilla Mayor;412;203;209
24;León;096;Maraña;180;93;87
24;León;097;Matadeón de los Oteros;313;162;151
24;León;098;Matallana de Torío;1732;864;868
24;León;099;Matanza;311;156;155
24;León;100;Molinaseca;767;390;377
24;León;101;Murias de Paredes;703;326;377
24;León;102;Noceda del Bierzo;970;485;485
24;León;103;Oencia;531;282;249
24;León;104;Omañas (Las);470;236;234
24;León;105;Onzonilla;1447;712;735
24;León;106;Oseja de Sajambre;347;192;155
24;León;107;Pajares de los Oteros;383;197;186
24;León;108;Palacios de la Valduerna;561;268;293
24;León;109;Palacios del Sil;1523;760;763
24;León;110;Páramo del Sil;1890;958;932
24;León;112;Peranzanes;355;198;157
24;León;113;Pobladura de Pelayo García;598;311;287
24;León;114;Pola de Gordón (La);5277;2549;2728
24;León;115;Ponferrada;61469;29981;31488
24;León;116;Posada de Valdeón;496;265;231
24;León;117;Pozuelo del Páramo;679;354;325
24;León;118;Prado de la Guzpeña;173;93;80
24;León;119;Priaranza del Bierzo;1004;515;489
24;León;120;Prioro;475;245;230
24;León;121;Puebla de Lillo;690;368;322
24;León;122;Puente de Domingo Flórez;1936;1008;928
24;León;123;Quintana del Castillo;1156;607;549
24;León;124;Quintana del Marco;567;289;278
24;León;125;Quintana y Congosto;841;423;418
24;León;127;Regueras de Arriba;412;212;200
24;León;129;Reyero;162;88;74
24;León;130;Riaño;512;285;227
24;León;131;Riego de la Vega;1163;567;596
24;León;132;Riello;1064;547;517
24;León;133;Rioseco de Tapia;591;316;275
24;León;134;Robla (La);5214;2606;2608
24;León;136;Roperuelos del Páramo;845;420;425
24;León;137;Sabero;1989;986;1003
24;León;139;Sahagún;3223;1547;1676
24;León;141;San Adrián del Valle;172;82;90
24;León;142;San Andrés del Rabanedo;23487;11426;12061
24;León;144;San Cristóbal de la Polantera;1136;576;560
24;León;145;San Emiliano;1021;528;493
24;León;146;San Esteban de Nogales;362;169;193
24;León;148;San Justo de la Vega;2289;1157;1132
24;León;149;San Millán de los Caballeros;195;99;96
24;León;150;San Pedro Bercianos;400;199;201
24;León;143;Sancedo;601;299;302
24;León;151;Santa Colomba de Curueño;666;316;350
24;León;152;Santa Colomba de Somoza;472;234;238
24;León;153;Santa Cristina de Valmadrigal;386;195;191
24;León;154;Santa Elena de Jamuz;1427;725;702
24;León;155;Santa María de la Isla;733;385;348
24;León;158;Santa María de Ordás;461;232;229
24;León;156;Santa María del Monte de Cea;405;197;208
24;León;157;Santa María del Páramo;3170;1538;1632
24;León;159;Santa Marina del Rey;2639;1309;1330
24;León;160;Santas Martas;1051;551;500
24;León;161;Santiago Millas;354;181;173
24;León;162;Santovenia de la Valdoncina;1578;778;800
24;León;163;Sariegos;2352;1185;1167
24;León;164;Sena de Luna;512;255;257
24;León;165;Sobrado;550;277;273
24;León;166;Soto de la Vega;2034;1027;1007
24;León;167;Soto y Amío;1087;528;559
24;León;168;Toral de los Guzmanes;692;356;336
24;León;169;Toreno;4392;2260;2132
24;León;170;Torre del Bierzo;3271;1641;1630
24;León;171;Trabadelo;606;322;284
24;León;172;Truchas;814;407;407
24;León;173;Turcia;1380;685;695
24;León;174;Urdiales del Páramo;745;385;360
24;León;185;Val de San Lorenzo;790;383;407
24;León;175;Valdefresno;1658;837;821
24;León;176;Valdefuentes del Páramo;455;236;219
24;León;177;Valdelugueros;448;248;200
24;León;178;Valdemora;127;60;67
24;León;179;Valdepiélago;403;205;198
24;León;180;Valdepolo;1618;838;780
24;León;181;Valderas;2267;1159;1108
24;León;182;Valderrey;666;323;343
24;León;183;Valderrueda;1341;667;674
24;León;184;Valdesamario;296;148;148
24;León;187;Valdevimbre;1252;633;619
24;León;188;Valencia de Don Juan;3934;1951;1983
24;León;191;Vallecillo;177;92;85
24;León;189;Valverde de la Virgen;4208;2101;2107
24;León;190;Valverde-Enrique;238;115;123
24;León;193;Vecilla (La);459;238;221
24;León;196;Vega de Espinareda;3052;1543;1509
24;León;197;Vega de Infanzones;877;429;448
24;León;198;Vega de Valcarce;950;484;466
24;León;194;Vegacervera;363;191;172
24;León;199;Vegaquemada;561;260;301
24;León;201;Vegas del Condado;1399;722;677
24;León;202;Villablino;14956;7547;7409
24;León;203;Villabraz;164;87;77
24;León;205;Villadangos del Páramo;1016;511;505
24;León;206;Villadecanes;2371;1204;1167
24;León;207;Villademor de la Vega;481;257;224
24;León;209;Villafranca del Bierzo;3941;1952;1989
24;León;210;Villagatón;881;458;423
24;León;211;Villamandos;461;217;244
24;León;901;Villamanín;1342;663;679
24;León;212;Villamañán;1428;714;714
24;León;213;Villamartín de Don Sancho;208;109;99
24;León;214;Villamejil;1020;510;510
24;León;215;Villamol;251;127;124
24;León;216;Villamontán de la Valduerna;1135;571;564
24;León;217;Villamoratiel de las Matas;185;105;80
24;León;218;Villanueva de las Manzanas;644;311;333
24;León;219;Villaobispo de Otero;742;378;364
24;León;902;Villaornate y Castro;576;309;267
24;León;221;Villaquejida;1101;578;523
24;León;222;Villaquilambre;7389;3724;3665
24;León;223;Villarejo de Órbigo;3579;1742;1837
24;León;224;Villares de Órbigo;1002;509;493
24;León;225;Villasabariego;1228;615;613
24;León;226;Villaselán;333;179;154
24;León;227;Villaturiel;1807;936;871
24;León;228;Villazala;1060;546;514
24;León;229;Villazanzo de Valderaduey;715;386;329
24;León;230;Zotes del Páramo;697;356;341
25;Lleida;001;Abella de la Conca;182;98;84
25;Lleida;002;Àger;542;289;253
25;Lleida;003;Agramunt;4950;2511;2439
25;Lleida;038;Aitona;2184;1085;1099
25;Lleida;004;Alamús (Els);679;340;339
25;Lleida;005;Alàs i Cerc;410;222;188
25;Lleida;006;Albagés (L');512;266;246
25;Lleida;007;Albatàrrec;1069;533;536
25;Lleida;008;Albesa;1486;729;757
25;Lleida;009;Albi (L');776;395;381
25;Lleida;010;Alcanó;272;136;136
25;Lleida;011;Alcarràs;4786;2382;2404
25;Lleida;012;Alcoletge;1709;865;844
25;Lleida;013;Alfarràs;2922;1433;1489
25;Lleida;014;Alfés;334;178;156
25;Lleida;015;Algerri;518;252;266
25;Lleida;016;Alguaire;2824;1432;1392
25;Lleida;017;Alins;288;149;139
25;Lleida;019;Almacelles;5520;2787;2733
25;Lleida;020;Almatret;488;245;243
25;Lleida;021;Almenar;3443;1762;1681
25;Lleida;022;Alòs de Balaguer;177;102;75
25;Lleida;023;Alpicat;3600;1787;1813
25;Lleida;024;Alt Àneu;394;216;178
25;Lleida;027;Anglesola;1242;629;613
25;Lleida;029;Arbeca;2359;1198;1161
25;Lleida;031;Arres;64;34;30
25;Lleida;032;Arsèguel;104;54;50
25;Lleida;033;Artesa de Lleida;1243;624;619
25;Lleida;034;Artesa de Segre;3123;1601;1522
25;Lleida;036;Aspa;248;124;124
25;Lleida;037;Avellanes i Santa Linya (Les);483;256;227
25;Lleida;039;Baix Pallars;340;193;147
25;Lleida;040;Balaguer;13188;6455;6733
25;Lleida;041;Barbens;754;389;365
25;Lleida;042;Baronia de Rialb (La);247;130;117
25;Lleida;044;Bassella;335;168;167
25;Lleida;045;Bausen;67;39;28
25;Lleida;046;Belianes;558;269;289
25;Lleida;170;Bellaguarda;363;183;180
25;Lleida;047;Bellcaire d'Urgell;1346;640;706
25;Lleida;048;Bell-lloc d'Urgell;2106;1041;1065
25;Lleida;049;Bellmunt d'Urgell;233;117;116
25;Lleida;050;Bellpuig;3956;1966;1990
25;Lleida;051;Bellver de Cerdanya;1598;838;760
25;Lleida;052;Bellvís;2171;1063;1108
25;Lleida;053;Benavent de Segrià;852;448;404
25;Lleida;055;Biosca;268;135;133
25;Lleida;057;Bòrdes (Es);207;111;96
25;Lleida;058;Borges Blanques (Les);5181;2568;2613
25;Lleida;059;Bossòst;821;415;406
25;Lleida;056;Bovera;408;209;199
25;Lleida;060;Cabanabona;100;48;52
25;Lleida;061;Cabó;120;67;53
25;Lleida;062;Camarasa;893;448;445
25;Lleida;063;Canejan;100;53;47
25;Lleida;904;Castell de Mur;149;79;70
25;Lleida;064;Castellar de la Ribera;149;67;82
25;Lleida;067;Castelldans;943;472;471
25;Lleida;068;Castellnou de Seana;726;375;351
25;Lleida;069;Castelló de Farfanya;592;300;292
25;Lleida;070;Castellserà;1126;548;578
25;Lleida;071;Cava;56;33;23
25;Lleida;072;Cervera;7272;3586;3686
25;Lleida;073;Cervià de les Garrigues;844;441;403
25;Lleida;074;Ciutadilla;226;117;109
25;Lleida;075;Clariana de Cardener;148;76;72
25;Lleida;076;Cogul (El);228;116;112
25;Lleida;077;Coll de Nargó;614;328;286
25;Lleida;163;Coma i la Pedra (La);234;144;90
25;Lleida;161;Conca de Dalt;421;222;199
25;Lleida;078;Corbins;1051;530;521
25;Lleida;079;Cubells;358;181;177
25;Lleida;081;Espluga Calba (L');442;228;214
25;Lleida;082;Espot;276;147;129
25;Lleida;088;Estamariu;131;70;61
25;Lleida;085;Estaràs;179;97;82
25;Lleida;086;Esterri d'Àneu;632;308;324
25;Lleida;087;Esterri de Cardós;72;39;33
25;Lleida;089;Farrera;86;47;39
25;Lleida;908;Fígols i Alinyà;307;167;140
25;Lleida;092;Floresta (La);174;92;82
25;Lleida;093;Fondarella;686;347;339
25;Lleida;094;Foradada;189;112;77
25;Lleida;096;Fuliola (La);1255;628;627
25;Lleida;097;Fulleda;115;60;55
25;Lleida;098;Gavet de la Conca;324;158;166
25;Lleida;912;Gimenells i el Pla de la Font;1122;591;531
25;Lleida;099;Golmés;1275;617;658
25;Lleida;100;Gósol;207;114;93
25;Lleida;101;Granadella (La);831;427;404
25;Lleida;102;Granja d'Escarp (La);1108;587;521
25;Lleida;103;Granyanella;127;63;64
25;Lleida;105;Granyena de les Garrigues;168;86;82
25;Lleida;104;Granyena de Segarra;162;83;79
25;Lleida;109;Guimerà;375;188;187
25;Lleida;903;Guingueta d'Àneu (La);290;147;143
25;Lleida;110;Guissona;3060;1561;1499
25;Lleida;111;Guixers;151;92;59
25;Lleida;115;Isona i Conca Dellà;1270;668;602
25;Lleida;112;Ivars de Noguera;334;167;167
25;Lleida;113;Ivars d'Urgell;1699;859;840
25;Lleida;114;Ivorra;156;84;72
25;Lleida;910;Josa i Tuixén;139;76;63
25;Lleida;118;Juncosa;594;327;267
25;Lleida;119;Juneda;3002;1520;1482
25;Lleida;121;Les;687;345;342
25;Lleida;122;Linyola;2391;1185;1206
25;Lleida;123;Lladorre;207;106;101
25;Lleida;124;Lladurs;250;133;117
25;Lleida;125;Llardecans;639;329;310
25;Lleida;126;Llavorsí;286;145;141
25;Lleida;120;Lleida;112207;54637;57570
25;Lleida;127;Lles de Cerdanya;299;166;133
25;Lleida;128;Llimiana;139;74;65
25;Lleida;129;Llobera;240;125;115
25;Lleida;133;Maials;1005;500;505
25;Lleida;130;Maldà;289;148;141
25;Lleida;131;Massalcoreig;649;312;337
25;Lleida;132;Massoteres;184;96;88
25;Lleida;134;Menàrguens;817;416;401
25;Lleida;135;Miralcamp;1239;592;647
25;Lleida;137;Mollerussa;9477;4703;4774
25;Lleida;136;Molsosa (La);135;69;66
25;Lleida;139;Montellà i Martinet;500;250;250
25;Lleida;140;Montferrer i Castellbò;728;394;334
25;Lleida;138;Montgai;794;403;391
25;Lleida;142;Montoliu de Lleida;500;246;254
25;Lleida;141;Montoliu de Segarra;202;108;94
25;Lleida;143;Montornès de Segarra;101;45;56
25;Lleida;145;Nalec;104;49;55
25;Lleida;025;Naut Aran;1435;750;685
25;Lleida;146;Navès;277;133;144
25;Lleida;148;Odèn;280;158;122
25;Lleida;149;Oliana;1877;956;921
25;Lleida;150;Oliola;199;112;87
25;Lleida;151;Olius;520;264;256
25;Lleida;152;Oluges (Les);192;102;90
25;Lleida;153;Omellons (Els);266;134;132
25;Lleida;154;Omells de na Gaia (Els);153;84;69
25;Lleida;155;Organyà;993;511;482
25;Lleida;156;Os de Balaguer;761;403;358
25;Lleida;157;Ossó de Sió;210;106;104
25;Lleida;158;Palau d'Anglesola (El);1630;824;806
25;Lleida;164;Penelles;549;303;246
25;Lleida;165;Peramola;379;203;176
25;Lleida;166;Pinell de Solsonès;228;121;107
25;Lleida;167;Pinós;317;175;142
25;Lleida;911;Plans de Sió (Els);620;325;295
25;Lleida;168;Poal (El);625;331;294
25;Lleida;169;Pobla de Cérvoles (La);218;124;94
25;Lleida;171;Pobla de Segur (La);2912;1404;1508
25;Lleida;030;Pont de Bar (El);145;78;67
25;Lleida;173;Pont de Suert (El);2079;1045;1034
25;Lleida;172;Ponts;2368;1189;1179
25;Lleida;174;Portella (La);580;312;268
25;Lleida;175;Prats i Sansor;187;103;84
25;Lleida;176;Preixana;431;217;214
25;Lleida;177;Preixens;518;250;268
25;Lleida;179;Prullans;218;113;105
25;Lleida;180;Puiggròs;255;135;120
25;Lleida;181;Puigverd d'Agramunt;218;116;102
25;Lleida;182;Puigverd de Lleida;1010;499;511
25;Lleida;183;Rialp;535;280;255
25;Lleida;905;Ribera d'Ondara;531;269;262
25;Lleida;185;Ribera d'Urgellet;748;390;358
25;Lleida;186;Riner;278;142;136
25;Lleida;913;Riu de Cerdanya;81;39;42
25;Lleida;189;Rosselló;1784;868;916
25;Lleida;190;Salàs de Pallars;334;171;163
25;Lleida;191;Sanaüja;465;228;237
25;Lleida;196;Sant Esteve de la Sarga;113;69;44
25;Lleida;192;Sant Guim de Freixenet;1047;507;540
25;Lleida;197;Sant Guim de la Plana;194;102;92
25;Lleida;193;Sant Llorenç de Morunys;896;454;442
25;Lleida;902;Sant Martí de Riucorb;718;365;353
25;Lleida;194;Sant Ramon;554;270;284
25;Lleida;201;Sarroca de Bellera;145;79;66
25;Lleida;200;Sarroca de Lleida;489;247;242
25;Lleida;202;Senterada;116;61;55
25;Lleida;035;Sentiu de Sió (La);481;231;250
25;Lleida;204;Seròs;1780;939;841
25;Lleida;203;Seu d'Urgell (La);10661;5196;5465
25;Lleida;205;Sidamon;476;238;238
25;Lleida;206;Soleràs (El);420;212;208
25;Lleida;207;Solsona;7172;3593;3579
25;Lleida;208;Soriguera;298;155;143
25;Lleida;209;Sort;1715;854;861
25;Lleida;210;Soses;1531;795;736
25;Lleida;211;Sudanell;731;394;337
25;Lleida;212;Sunyer;305;152;153
25;Lleida;215;Talarn;362;187;175
25;Lleida;216;Talavera;290;152;138
25;Lleida;217;Tàrrega;12181;5863;6318
25;Lleida;218;Tarrés;109;58;51
25;Lleida;219;Tarroja de Segarra;187;97;90
25;Lleida;220;Térmens;1395;704;691
25;Lleida;221;Tírvia;122;65;57
25;Lleida;222;Tiurana;23;16;7
25;Lleida;223;Torà;1174;596;578
25;Lleida;224;Torms (Els);195;108;87
25;Lleida;225;Tornabous;822;422;400
25;Lleida;227;Torre de Cabdella (La);658;327;331
25;Lleida;226;Torrebesses;337;165;172
25;Lleida;228;Torrefarrera;1609;821;788
25;Lleida;907;Torrefeta i Florejacs;660;327;333
25;Lleida;230;Torregrossa;2238;1101;1137
25;Lleida;231;Torrelameu;577;311;266
25;Lleida;232;Torres de Segre;1805;914;891
25;Lleida;233;Torre-serona;295;147;148
25;Lleida;234;Tremp;5357;2641;2716
25;Lleida;043;Vall de Boí (La);793;445;348
25;Lleida;901;Vall de Cardós;324;166;158
25;Lleida;238;Vallbona de les Monges;259;129;130
25;Lleida;240;Vallfogona de Balaguer;1443;727;716
25;Lleida;906;Valls d'Aguilar (Les);296;158;138
25;Lleida;239;Valls de Valira (Les);736;398;338
25;Lleida;909;Vansa i Fórnols (La);171;87;84
25;Lleida;242;Verdú;991;477;514
25;Lleida;243;Vielha e Mijaran;3896;1955;1941
25;Lleida;244;Vilagrassa;431;228;203
25;Lleida;245;Vilaller;618;327;291
25;Lleida;247;Vilamòs;148;73;75
25;Lleida;248;Vilanova de Bellpuig;1163;576;587
25;Lleida;254;Vilanova de la Barca;923;456;467
25;Lleida;249;Vilanova de l'Aguda;270;141;129
25;Lleida;250;Vilanova de Meià;478;252;226
25;Lleida;251;Vilanova de Segrià;749;382;367
25;Lleida;252;Vila-sana;530;260;270
25;Lleida;253;Vilosell (El);195;86;109
25;Lleida;255;Vinaixa;639;311;328
26;Rioja (La);001;Ábalos;271;147;124
26;Rioja (La);002;Agoncillo;879;460;419
26;Rioja (La);003;Aguilar del Río Alhama;699;358;341
26;Rioja (La);004;Ajamil de Cameros;75;50;25
26;Rioja (La);005;Albelda de Iregua;2218;1125;1093
26;Rioja (La);006;Alberite;2005;998;1007
26;Rioja (La);007;Alcanadre;808;416;392
26;Rioja (La);008;Aldeanueva de Ebro;2486;1284;1202
26;Rioja (La);009;Alesanco;505;259;246
26;Rioja (La);010;Alesón;143;71;72
26;Rioja (La);011;Alfaro;9098;4568;4530
26;Rioja (La);012;Almarza de Cameros;38;24;14
26;Rioja (La);013;Anguciana;313;160;153
26;Rioja (La);014;Anguiano;608;333;275
26;Rioja (La);015;Arenzana de Abajo;318;166;152
26;Rioja (La);016;Arenzana de Arriba;40;22;18
26;Rioja (La);017;Arnedillo;444;211;233
26;Rioja (La);018;Arnedo;12796;6387;6409
26;Rioja (La);019;Arrúbal;425;220;205
26;Rioja (La);020;Ausejo;725;394;331
26;Rioja (La);021;Autol;3368;1718;1650
26;Rioja (La);022;Azofra;355;192;163
26;Rioja (La);023;Badarán;739;391;348
26;Rioja (La);024;Bañares;427;214;213
26;Rioja (La);026;Baños de Río Tobía;1808;924;884
26;Rioja (La);025;Baños de Rioja;110;64;46
26;Rioja (La);027;Berceo;222;131;91
26;Rioja (La);028;Bergasa;184;98;86
26;Rioja (La);029;Bergasillas Bajera;30;17;13
26;Rioja (La);030;Bezares;31;19;12
26;Rioja (La);031;Bobadilla;167;96;71
26;Rioja (La);032;Brieva de Cameros;72;42;30
26;Rioja (La);033;Briñas;198;99;99
26;Rioja (La);034;Briones;810;429;381
26;Rioja (La);035;Cabezón de Cameros;34;24;10
26;Rioja (La);036;Calahorra;18801;9092;9709
26;Rioja (La);037;Camprovín;227;122;105
26;Rioja (La);038;Canales de la Sierra;95;51;44
26;Rioja (La);039;Canillas de Río Tuerto;69;33;36
26;Rioja (La);040;Cañas;117;54;63
26;Rioja (La);041;Cárdenas;249;124;125
26;Rioja (La);042;Casalarreina;870;439;431
26;Rioja (La);043;Castañares de Rioja;483;249;234
26;Rioja (La);044;Castroviejo;61;31;30
26;Rioja (La);045;Cellorigo;20;11;9
26;Rioja (La);046;Cenicero;2088;1060;1028
26;Rioja (La);047;Cervera del Río Alhama;3121;1622;1499
26;Rioja (La);048;Cidamón;47;25;22
26;Rioja (La);049;Cihuri;157;84;73
26;Rioja (La);050;Cirueña;130;76;54
26;Rioja (La);051;Clavijo;199;103;96
26;Rioja (La);052;Cordovín;218;112;106
26;Rioja (La);053;Corera;251;122;129
26;Rioja (La);054;Cornago;579;316;263
26;Rioja (La);055;Corporales;63;32;31
26;Rioja (La);056;Cuzcurrita de Río Tirón;475;257;218
26;Rioja (La);057;Daroca de Rioja;56;34;22
26;Rioja (La);058;Enciso;174;107;67
26;Rioja (La);059;Entrena;1132;585;547
26;Rioja (La);060;Estollo;154;85;69
26;Rioja (La);061;Ezcaray;1822;966;856
26;Rioja (La);062;Foncea;125;64;61
26;Rioja (La);063;Fonzaleche;166;100;66
26;Rioja (La);064;Fuenmayor;2179;1086;1093
26;Rioja (La);065;Galbárruli;72;39;33
26;Rioja (La);066;Galilea;293;155;138
26;Rioja (La);067;Gallinero de Cameros;29;19;10
26;Rioja (La);068;Gimileo;93;44;49
26;Rioja (La);069;Grañón;420;220;200
26;Rioja (La);070;Grávalos;282;143;139
26;Rioja (La);071;Haro;9150;4515;4635
26;Rioja (La);072;Herce;321;167;154
26;Rioja (La);073;Herramélluri;174;93;81
26;Rioja (La);074;Hervías;192;98;94
26;Rioja (La);075;Hormilla;483;250;233
26;Rioja (La);076;Hormilleja;178;89;89
26;Rioja (La);077;Hornillos de Cameros;25;13;12
26;Rioja (La);078;Hornos de Moncalvillo;99;48;51
26;Rioja (La);079;Huércanos;877;448;429
26;Rioja (La);080;Igea;792;423;369
26;Rioja (La);081;Jalón de Cameros;36;20;16
26;Rioja (La);082;Laguna de Cameros;174;100;74
26;Rioja (La);083;Lagunilla del Jubera;357;192;165
26;Rioja (La);084;Lardero;3421;1719;1702
26;Rioja (La);086;Ledesma de la Cogolla;21;14;7
26;Rioja (La);087;Leiva;291;140;151
26;Rioja (La);088;Leza de Río Leza;33;22;11
26;Rioja (La);089;Logroño;125617;60344;65273
26;Rioja (La);091;Lumbreras;173;106;67
26;Rioja (La);092;Manjarrés;148;84;64
26;Rioja (La);093;Mansilla de la Sierra;53;36;17
26;Rioja (La);094;Manzanares de Rioja;125;68;57
26;Rioja (La);095;Matute;172;82;90
26;Rioja (La);096;Medrano;217;118;99
26;Rioja (La);098;Munilla;118;61;57
26;Rioja (La);099;Murillo de Río Leza;1519;771;748
26;Rioja (La);100;Muro de Aguas;73;43;30
26;Rioja (La);101;Muro en Cameros;43;28;15
26;Rioja (La);102;Nájera;7055;3520;3535
26;Rioja (La);103;Nalda;859;452;407
26;Rioja (La);104;Navajún;19;12;7
26;Rioja (La);105;Navarrete;1988;1015;973
26;Rioja (La);106;Nestares;73;39;34
26;Rioja (La);107;Nieva de Cameros;119;62;57
26;Rioja (La);109;Ochánduri;103;52;51
26;Rioja (La);108;Ocón;339;193;146
26;Rioja (La);110;Ojacastro;232;137;95
26;Rioja (La);111;Ollauri;313;174;139
26;Rioja (La);112;Ortigosa de Cameros;327;171;156
26;Rioja (La);113;Pazuengos;50;32;18
26;Rioja (La);114;Pedroso;118;65;53
26;Rioja (La);115;Pinillos;30;16;14
26;Rioja (La);117;Pradejón;2820;1472;1348
26;Rioja (La);118;Pradillo;97;54;43
26;Rioja (La);119;Préjano;208;104;104
26;Rioja (La);120;Quel;1892;986;906
26;Rioja (La);121;Rabanera;52;36;16
26;Rioja (La);122;Rasillo de Cameros (El);123;65;58
26;Rioja (La);123;Redal (El);207;100;107
26;Rioja (La);124;Ribafrecha;1022;557;465
26;Rioja (La);125;Rincón de Soto;2562;1366;1196
26;Rioja (La);126;Robres del Castillo;17;11;6
26;Rioja (La);127;Rodezno;327;180;147
26;Rioja (La);128;Sajazarra;146;75;71
26;Rioja (La);129;San Asensio;1259;655;604
26;Rioja (La);130;San Millán de la Cogolla;276;171;105
26;Rioja (La);131;San Millán de Yécora;56;34;22
26;Rioja (La);132;San Román de Cameros;174;95;79
26;Rioja (La);139;San Torcuato;100;56;44
26;Rioja (La);142;San Vicente de la Sonsierra;1096;558;538
26;Rioja (La);134;Santa Coloma;148;92;56
26;Rioja (La);135;Santa Engracia del Jubera;218;129;89
26;Rioja (La);136;Santa Eulalia Bajera;103;59;44
26;Rioja (La);138;Santo Domingo de la Calzada;5646;2836;2810
26;Rioja (La);140;Santurde de Rioja;313;156;157
26;Rioja (La);141;Santurdejo;207;116;91
26;Rioja (La);143;Sojuela;87;51;36
26;Rioja (La);144;Sorzano;238;123;115
26;Rioja (La);145;Sotés;235;135;100
26;Rioja (La);146;Soto en Cameros;140;75;65
26;Rioja (La);147;Terroba;32;17;15
26;Rioja (La);148;Tirgo;268;137;131
26;Rioja (La);149;Tobía;61;36;25
26;Rioja (La);150;Tormantos;220;118;102
26;Rioja (La);153;Torre en Cameros;14;11;3
26;Rioja (La);151;Torrecilla en Cameros;558;300;258
26;Rioja (La);152;Torrecilla sobre Alesanco;88;45;43
26;Rioja (La);154;Torremontalbo;15;9;6
26;Rioja (La);155;Treviana;268;143;125
26;Rioja (La);157;Tricio;336;175;161
26;Rioja (La);158;Tudelilla;448;228;220
26;Rioja (La);160;Uruñuela;748;385;363
26;Rioja (La);161;Valdemadera;15;10;5
26;Rioja (La);162;Valgañón;173;98;75
26;Rioja (La);163;Ventosa;130;71;59
26;Rioja (La);164;Ventrosa;92;41;51
26;Rioja (La);165;Viguera;380;223;157
26;Rioja (La);166;Villalba de Rioja;158;93;65
26;Rioja (La);167;Villalobar de Rioja;134;81;53
26;Rioja (La);168;Villamediana de Iregua;2003;1031;972
26;Rioja (La);169;Villanueva de Cameros;125;66;59
26;Rioja (La);170;Villar de Arnedo (El);670;322;348
26;Rioja (La);171;Villar de Torre;316;166;150
26;Rioja (La);172;Villarejo;50;31;19
26;Rioja (La);173;Villarroya;9;4;5
26;Rioja (La);174;Villarta-Quintana;221;111;110
26;Rioja (La);175;Villavelayo;76;44;32
26;Rioja (La);176;Villaverde de Rioja;103;58;45
26;Rioja (La);177;Villoslada de Cameros;379;219;160
26;Rioja (La);178;Viniegra de Abajo;124;66;58
26;Rioja (La);179;Viniegra de Arriba;54;34;20
26;Rioja (La);180;Zarratón;268;141;127
26;Rioja (La);181;Zarzosa;17;12;5
26;Rioja (La);183;Zorraquín;49;30;19
27;Lugo;001;Abadín;3582;1686;1896
27;Lugo;002;Alfoz;2506;1210;1296
27;Lugo;003;Antas de Ulla;2856;1357;1499
27;Lugo;004;Baleira;2002;1033;969
27;Lugo;901;Baralla;3450;1770;1680
27;Lugo;005;Barreiros;3536;1706;1830
27;Lugo;006;Becerreá;3796;1926;1870
27;Lugo;007;Begonte;3903;1931;1972
27;Lugo;008;Bóveda;2141;1050;1091
27;Lugo;902;Burela;7915;3928;3987
27;Lugo;009;Carballedo;3363;1665;1698
27;Lugo;010;Castro de Rei;5778;2906;2872
27;Lugo;011;Castroverde;3612;1843;1769
27;Lugo;012;Cervantes;2329;1271;1058
27;Lugo;013;Cervo;5086;2550;2536
27;Lugo;016;Chantada;10002;4931;5071
27;Lugo;014;Corgo (O);4394;2205;2189
27;Lugo;015;Cospeito;6045;2973;3072
27;Lugo;017;Folgoso do Courel;1669;854;815
27;Lugo;018;Fonsagrada (A);5682;2978;2704
27;Lugo;019;Foz;9520;4538;4982
27;Lugo;020;Friol;4910;2451;2459
27;Lugo;022;Guitiriz;6473;3216;3257
27;Lugo;023;Guntín;3663;1828;1835
27;Lugo;024;Incio (O);2674;1321;1353
27;Lugo;026;Láncara;3377;1755;1622
27;Lugo;027;Lourenzá;2931;1413;1518
27;Lugo;028;Lugo;86620;40753;45867
27;Lugo;029;Meira;1828;897;931
27;Lugo;030;Mondoñedo;5242;2417;2825
27;Lugo;031;Monforte de Lemos;19933;9542;10391
27;Lugo;032;Monterroso;4285;2124;2161
27;Lugo;033;Muras;1186;580;606
27;Lugo;034;Navia de Suarna;2073;1113;960
27;Lugo;035;Negueira de Muñiz;297;156;141
27;Lugo;037;Nogais (As);1662;856;806
27;Lugo;038;Ourol;1638;796;842
27;Lugo;039;Outeiro de Rei;4126;2086;2040
27;Lugo;040;Palas de Rei;4386;2149;2237
27;Lugo;041;Pantón;3637;1729;1908
27;Lugo;042;Paradela;2752;1370;1382
27;Lugo;043;Páramo (O);1934;994;940
27;Lugo;044;Pastoriza (A);4177;2092;2085
27;Lugo;045;Pedrafita do Cebreiro;1669;891;778
27;Lugo;047;Pobra do Brollón (A);2753;1340;1413
27;Lugo;046;Pol;2258;1110;1148
27;Lugo;048;Pontenova (A);3484;1700;1784
27;Lugo;049;Portomarín;2141;1055;1086
27;Lugo;050;Quiroga;4458;2170;2288
27;Lugo;056;Rábade;1589;793;796
27;Lugo;051;Ribadeo;8872;4159;4713
27;Lugo;052;Ribas de Sil;1529;726;803
27;Lugo;053;Ribeira de Piquín;939;457;482
27;Lugo;054;Riotorto;2018;994;1024
27;Lugo;055;Samos;2203;1158;1045
27;Lugo;057;Sarria;12942;6326;6616
27;Lugo;058;Saviñao (O);5246;2553;2693
27;Lugo;059;Sober;3250;1573;1677
27;Lugo;060;Taboada;4344;2104;2240
27;Lugo;061;Trabada;1770;846;924
27;Lugo;062;Triacastela;942;464;478
27;Lugo;063;Valadouro (O);2524;1250;1274
27;Lugo;064;Vicedo (O);2460;1208;1252
27;Lugo;065;Vilalba;15645;7655;7990
27;Lugo;066;Viveiro;15298;7379;7919
27;Lugo;021;Xermade;2847;1398;1449
27;Lugo;025;Xove;3599;1798;1801
28;Madrid;001;Acebeda (La);47;26;21
28;Madrid;002;Ajalvir;1817;942;875
28;Madrid;003;Alameda del Valle;162;89;73
28;Madrid;004;Álamo (El);4028;2170;1858
28;Madrid;005;Alcalá de Henares;163831;81672;82159
28;Madrid;006;Alcobendas;86146;42468;43678
28;Madrid;007;Alcorcón;143970;71274;72696
28;Madrid;008;Aldea del Fresno;1308;677;631
28;Madrid;009;Algete;13476;6860;6616
28;Madrid;010;Alpedrete;5824;2927;2897
28;Madrid;011;Ambite;303;147;156
28;Madrid;012;Anchuelo;592;325;267
28;Madrid;013;Aranjuez;38680;18649;20031
28;Madrid;014;Arganda del Rey;29767;14714;15053
28;Madrid;015;Arroyomolinos;3017;1532;1485
28;Madrid;016;Atazar (El);95;51;44
28;Madrid;017;Batres;730;377;353
28;Madrid;018;Becerril de la Sierra;2878;1491;1387
28;Madrid;019;Belmonte de Tajo;1131;570;561
28;Madrid;021;Berrueco (El);343;182;161
28;Madrid;020;Berzosa del Lozoya;100;48;52
28;Madrid;022;Boadilla del Monte;18914;9614;9300
28;Madrid;023;Boalo (El);2685;1364;1321
28;Madrid;024;Braojos;147;80;67
28;Madrid;025;Brea de Tajo;480;244;236
28;Madrid;026;Brunete;4354;2166;2188
28;Madrid;027;Buitrago del Lozoya;1404;700;704
28;Madrid;028;Bustarviejo;1371;702;669
28;Madrid;029;Cabanillas de la Sierra;432;222;210
28;Madrid;030;Cabrera (La);1517;758;759
28;Madrid;031;Cadalso de los Vidrios;2249;1159;1090
28;Madrid;032;Camarma de Esteruelas;2235;1116;1119
28;Madrid;033;Campo Real;2555;1289;1266
28;Madrid;034;Canencia;458;238;220
28;Madrid;035;Carabaña;1005;499;506
28;Madrid;036;Casarrubuelos;668;358;310
28;Madrid;037;Cenicientos;1854;914;940
28;Madrid;038;Cercedilla;5328;2636;2692
28;Madrid;039;Cervera de Buitrago;96;57;39
28;Madrid;051;Chapinería;1235;626;609
28;Madrid;052;Chinchón;3856;1905;1951
28;Madrid;040;Ciempozuelos;12934;6548;6386
28;Madrid;041;Cobeña;2339;1189;1150
28;Madrid;046;Collado Mediano;3631;1834;1797
28;Madrid;047;Collado Villalba;39295;19607;19688
28;Madrid;043;Colmenar de Oreja;5510;2695;2815
28;Madrid;042;Colmenar del Arroyo;853;400;453
28;Madrid;045;Colmenar Viejo;29682;14721;14961
28;Madrid;044;Colmenarejo;3795;1923;1872
28;Madrid;048;Corpa;365;186;179
28;Madrid;049;Coslada;73732;36614;37118
28;Madrid;050;Cubas de la Sagra;1397;684;713
28;Madrid;053;Daganzo de Arriba;3041;1530;1511
28;Madrid;054;Escorial (El);9444;4717;4727
28;Madrid;055;Estremera;1047;540;507
28;Madrid;056;Fresnedillas de la Oliva;677;341;336
28;Madrid;057;Fresno de Torote;538;291;247
28;Madrid;058;Fuenlabrada;167458;84331;83127
28;Madrid;059;Fuente el Saz de Jarama;3372;1743;1629
28;Madrid;060;Fuentidueña de Tajo;1432;699;733
28;Madrid;061;Galapagar;18995;9600;9395
28;Madrid;062;Garganta de los Montes;322;161;161
28;Madrid;063;Gargantilla del Lozoya y Pinilla de Buitrago;227;137;90
28;Madrid;064;Gascones;100;54;46
28;Madrid;065;Getafe;143629;71342;72287
28;Madrid;066;Griñón;4083;2083;2000
28;Madrid;067;Guadalix de la Sierra;2646;1371;1275
28;Madrid;068;Guadarrama;8251;4043;4208
28;Madrid;069;Hiruela (La);53;27;26
28;Madrid;070;Horcajo de la Sierra-Aoslos;136;76;60
28;Madrid;071;Horcajuelo de la Sierra;81;37;44
28;Madrid;072;Hoyo de Manzanares;5017;2535;2482
28;Madrid;073;Humanes de Madrid;8756;4477;4279
28;Madrid;074;Leganés;173163;86270;86893
28;Madrid;075;Loeches;2838;1400;1438
28;Madrid;076;Lozoya;442;227;215
28;Madrid;901;Lozoyuela-Navas-Sieteiglesias;628;334;294
28;Madrid;078;Madarcos;26;14;12
28;Madrid;079;Madrid;2881506;1346168;1535338
28;Madrid;080;Majadahonda;41642;20239;21403
28;Madrid;082;Manzanares el Real;3363;1764;1599
28;Madrid;083;Meco;4689;2386;2303
28;Madrid;084;Mejorada del Campo;15186;7642;7544
28;Madrid;085;Miraflores de la Sierra;3495;1761;1734
28;Madrid;086;Molar (El);3552;1884;1668
28;Madrid;087;Molinos (Los);3084;1483;1601
28;Madrid;088;Montejo de la Sierra;262;127;135
28;Madrid;089;Moraleja de Enmedio;2680;1335;1345
28;Madrid;090;Moralzarzal;4149;2130;2019
28;Madrid;091;Morata de Tajuña;5412;2666;2746
28;Madrid;092;Móstoles;195311;96877;98434
28;Madrid;093;Navacerrada;1741;857;884
28;Madrid;094;Navalafuente;481;261;220
28;Madrid;095;Navalagamella;994;507;487
28;Madrid;096;Navalcarnero;11458;5807;5651
28;Madrid;097;Navarredonda y San Mamés;96;50;46
28;Madrid;099;Navas del Rey;1501;791;710
28;Madrid;100;Nuevo Baztán;2743;1422;1321
28;Madrid;101;Olmeda de las Fuentes;146;81;65
28;Madrid;102;Orusco de Tajuña;650;336;314
28;Madrid;104;Paracuellos de Jarama;5557;2857;2700
28;Madrid;106;Parla;71396;35719;35677
28;Madrid;107;Patones;362;187;175
28;Madrid;108;Pedrezuela;1274;662;612
28;Madrid;109;Pelayos de la Presa;1277;634;643
28;Madrid;110;Perales de Tajuña;2024;979;1045
28;Madrid;111;Pezuela de las Torres;524;269;255
28;Madrid;112;Pinilla del Valle;163;92;71
28;Madrid;113;Pinto;26316;13172;13144
28;Madrid;114;Piñuécar-Gandullas;157;75;82
28;Madrid;115;Pozuelo de Alarcón;62010;30278;31732
28;Madrid;116;Pozuelo del Rey;236;125;111
28;Madrid;117;Prádena del Rincón;100;54;46
28;Madrid;118;Puebla de la Sierra;77;44;33
28;Madrid;902;Puentes Viejas;412;217;195
28;Madrid;119;Quijorna;890;481;409
28;Madrid;120;Rascafría;1404;728;676
28;Madrid;121;Redueña;159;77;82
28;Madrid;122;Ribatejada;335;181;154
28;Madrid;123;Rivas-Vaciamadrid;24777;12413;12364
28;Madrid;124;Robledillo de la Jara;78;40;38
28;Madrid;125;Robledo de Chavela;2014;1004;1010
28;Madrid;126;Robregordo;86;41;45
28;Madrid;127;Rozas de Madrid (Las);47922;23449;24473
28;Madrid;128;Rozas de Puerto Real;306;163;143
28;Madrid;129;San Agustín del Guadalix;5307;2685;2622
28;Madrid;130;San Fernando de Henares;31677;15903;15774
28;Madrid;131;San Lorenzo de El Escorial;10995;5327;5668
28;Madrid;132;San Martín de la Vega;9661;4928;4733
28;Madrid;133;San Martín de Valdeiglesias;6034;2980;3054
28;Madrid;134;San Sebastián de los Reyes;57791;28783;29008
28;Madrid;135;Santa María de la Alameda;770;423;347
28;Madrid;136;Santorcaz;557;295;262
28;Madrid;137;Santos de la Humosa (Los);898;456;442
28;Madrid;138;Serna del Monte (La);100;53;47
28;Madrid;140;Serranillos del Valle;778;406;372
28;Madrid;141;Sevilla la Nueva;2936;1539;1397
28;Madrid;143;Somosierra;93;50;43
28;Madrid;144;Soto del Real;4368;2225;2143
28;Madrid;145;Talamanca de Jarama;1356;668;688
28;Madrid;146;Tielmes;1974;1001;973
28;Madrid;147;Titulcia;962;485;477
28;Madrid;148;Torrejón de Ardoz;91186;42881;48305
28;Madrid;149;Torrejón de la Calzada;3608;1818;1790
28;Madrid;150;Torrejón de Velasco;1608;847;761
28;Madrid;151;Torrelaguna;2558;1229;1329
28;Madrid;152;Torrelodones;11100;5469;5631
28;Madrid;153;Torremocha de Jarama;341;167;174
28;Madrid;154;Torres de la Alameda;4131;2084;2047
28;Madrid;903;Tres Cantos;30970;15373;15597
28;Madrid;155;Valdaracete;640;313;327
28;Madrid;156;Valdeavero;553;286;267
28;Madrid;157;Valdelaguna;524;282;242
28;Madrid;158;Valdemanco;518;279;239
28;Madrid;159;Valdemaqueda;561;284;277
28;Madrid;160;Valdemorillo;4722;2418;2304
28;Madrid;161;Valdemoro;23146;11596;11550
28;Madrid;162;Valdeolmos-Alalpardo;1661;868;793
28;Madrid;163;Valdepiélagos;310;161;149
28;Madrid;164;Valdetorres de Jarama;1738;902;836
28;Madrid;165;Valdilecha;1833;929;904
28;Madrid;166;Valverde de Alcalá;266;142;124
28;Madrid;167;Velilla de San Antonio;5137;2612;2525
28;Madrid;168;Vellón (El);1072;553;519
28;Madrid;169;Venturada;639;337;302
28;Madrid;171;Villa del Prado;3809;1925;1884
28;Madrid;170;Villaconejos;2850;1454;1396
28;Madrid;172;Villalbilla;3524;1855;1669
28;Madrid;173;Villamanrique de Tajo;602;296;306
28;Madrid;174;Villamanta;1485;749;736
28;Madrid;175;Villamantilla;345;181;164
28;Madrid;176;Villanueva de la Cañada;9124;4524;4600
28;Madrid;178;Villanueva de Perales;430;239;191
28;Madrid;177;Villanueva del Pardillo;3412;1744;1668
28;Madrid;179;Villar del Olmo;1168;598;570
28;Madrid;180;Villarejo de Salvanés;5435;2691;2744
28;Madrid;181;Villaviciosa de Odón;17853;8881;8972
28;Madrid;182;Villavieja del Lozoya;172;81;91
28;Madrid;183;Zarzalejo;1028;530;498
29;Málaga;001;Alameda;4961;2450;2511
29;Málaga;002;Alcaucín;1509;763;746
29;Málaga;003;Alfarnate;1451;744;707
29;Málaga;004;Alfarnatejo;405;217;188
29;Málaga;005;Algarrobo;4794;2387;2407
29;Málaga;006;Algatocín;972;489;483
29;Málaga;007;Alhaurín de la Torre;19024;9431;9593
29;Málaga;008;Alhaurín el Grande;16838;8418;8420
29;Málaga;009;Almáchar;1956;991;965
29;Málaga;010;Almargen;2145;449;1696
29;Málaga;011;Almogía;4159;2133;2026
29;Málaga;012;Álora;12633;6316;6317
29;Málaga;013;Alozaina;2188;1144;1044
29;Málaga;014;Alpandeire;311;158;153
29;Málaga;015;Antequera;40239;19643;20596
29;Málaga;016;Árchez;333;166;167
29;Málaga;017;Archidona;8168;4060;4108
29;Málaga;018;Ardales;2977;1473;1504
29;Málaga;019;Arenas;1224;653;571
29;Málaga;020;Arriate;3415;1632;1783
29;Málaga;021;Atajate;176;96;80
29;Málaga;022;Benadalid;253;130;123
29;Málaga;023;Benahavís;1710;836;874
29;Málaga;024;Benalauría;509;270;239
29;Málaga;025;Benalmádena;28479;13956;14523
29;Málaga;026;Benamargosa;1558;795;763
29;Málaga;027;Benamocarra;2795;1400;1395
29;Málaga;028;Benaoján;1684;823;861
29;Málaga;029;Benarrabá;602;321;281
29;Málaga;030;Borge (El);1032;528;504
29;Málaga;031;Burgo (El);2051;1058;993
29;Málaga;032;Campillos;7638;3835;3803
29;Málaga;033;Canillas de Aceituno;2269;1129;1140
29;Málaga;034;Canillas de Albaida;667;357;310
29;Málaga;035;Cañete la Real;2233;1157;1076
29;Málaga;036;Carratraca;852;417;435
29;Málaga;037;Cartajima;254;134;120
29;Málaga;038;Cártama;12752;6423;6329
29;Málaga;039;Casabermeja;2982;1557;1425
29;Málaga;040;Casarabonela;2552;1296;1256
29;Málaga;041;Casares;3144;1656;1488
29;Málaga;042;Coín;17450;8705;8745
29;Málaga;043;Colmenar;3149;1550;1599
29;Málaga;044;Comares;1395;715;680
29;Málaga;045;Cómpeta;2681;1355;1326
29;Málaga;046;Cortes de la Frontera;3628;1805;1823
29;Málaga;047;Cuevas Bajas;1501;723;778
29;Málaga;049;Cuevas de San Marcos;4073;2009;2064
29;Málaga;048;Cuevas del Becerro;1999;1023;976
29;Málaga;050;Cútar;611;307;304
29;Málaga;051;Estepona;39178;19432;19746
29;Málaga;052;Faraján;302;155;147
29;Málaga;053;Frigiliana;2155;1055;1100
29;Málaga;054;Fuengirola;44924;22056;22868
29;Málaga;055;Fuente de Piedra;2065;990;1075
29;Málaga;056;Gaucín;1677;866;811
29;Málaga;057;Genalguacil;583;299;284
29;Málaga;058;Guaro;2020;1016;1004
29;Málaga;059;Humilladero;2564;1302;1262
29;Málaga;060;Igualeja;930;461;469
29;Málaga;061;Istán;1303;649;654
29;Málaga;062;Iznate;758;383;375
29;Málaga;063;Jimera de Líbar;422;195;227
29;Málaga;064;Jubrique;849;416;433
29;Málaga;065;Júzcar;217;119;98
29;Málaga;066;Macharaviaya;325;175;150
29;Málaga;067;Málaga;528079;252877;275202
29;Málaga;068;Manilva;5428;2762;2666
29;Málaga;069;Marbella;98377;48532;49845
29;Málaga;070;Mijas;37490;18721;18769
29;Málaga;071;Moclinejo;1029;519;510
29;Málaga;072;Mollina;3359;1634;1725
29;Málaga;073;Monda;1637;815;822
29;Málaga;074;Montejaque;1009;495;514
29;Málaga;075;Nerja;15326;7541;7785
29;Málaga;076;Ojén;1961;1030;931
29;Málaga;077;Parauta;230;120;110
29;Málaga;079;Periana;3417;1771;1646
29;Málaga;080;Pizarra;6602;3197;3405
29;Málaga;081;Pujerra;313;175;138
29;Málaga;082;Rincón de la Victoria;20629;10281;10348
29;Málaga;083;Riogordo;2680;1371;1309
29;Málaga;084;Ronda;33806;16554;17252
29;Málaga;085;Salares;219;107;112
29;Málaga;086;Sayalonga;1147;598;549
29;Málaga;087;Sedella;498;268;230
29;Málaga;088;Sierra de Yeguas;3175;1577;1598
29;Málaga;089;Teba;4371;2231;2140
29;Málaga;090;Tolox;2512;1299;1213
29;Málaga;901;Torremolinos;37235;18310;18925
29;Málaga;091;Torrox;11691;5793;5898
29;Málaga;092;Totalán;613;313;300
29;Málaga;093;Valle de Abdalajís;3049;1491;1558
29;Málaga;094;Vélez-Málaga;53816;26748;27068
29;Málaga;095;Villanueva de Algaidas;4143;2046;2097
29;Málaga;098;Villanueva de Tapia;1613;821;792
29;Málaga;096;Villanueva del Rosario;3326;1618;1708
29;Málaga;097;Villanueva del Trabuco;4697;2378;2319
29;Málaga;099;Viñuela;1189;593;596
29;Málaga;100;Yunquera;3261;1689;1572
30;Murcia;001;Abanilla;6065;3005;3060
30;Murcia;002;Abarán;12095;6002;6093
30;Murcia;003;Águilas;26197;13055;13142
30;Murcia;004;Albudeite;1348;673;675
30;Murcia;005;Alcantarilla;32667;16052;16615
30;Murcia;902;Alcázares (Los);6134;3057;3077
30;Murcia;006;Aledo;1005;511;494
30;Murcia;007;Alguazas;6933;3440;3493
30;Murcia;008;Alhama de Murcia;15471;7729;7742
30;Murcia;009;Archena;14176;7066;7110
30;Murcia;010;Beniel;7906;3927;3979
30;Murcia;011;Blanca;5703;2816;2887
30;Murcia;012;Bullas;10613;5343;5270
30;Murcia;013;Calasparra;8934;4493;4441
30;Murcia;014;Campos del Río;2009;978;1031
30;Murcia;015;Caravaca de la Cruz;21924;10864;11060
30;Murcia;016;Cartagena;175628;86656;88972
30;Murcia;017;Cehegín;14037;7051;6986
30;Murcia;018;Ceutí;7041;3561;3480
30;Murcia;019;Cieza;31637;15482;16155
30;Murcia;020;Fortuna;6502;3310;3192
30;Murcia;021;Fuente Álamo de Murcia;9451;4771;4680
30;Murcia;022;Jumilla;20420;10148;10272
30;Murcia;023;Librilla;3823;1888;1935
30;Murcia;024;Lorca;69930;34607;35323
30;Murcia;025;Lorquí;5482;2724;2758
30;Murcia;026;Mazarrón;16829;8560;8269
30;Murcia;027;Molina de Segura;42008;20854;21154
30;Murcia;028;Moratalla;8574;4357;4217
30;Murcia;029;Mula;13518;6713;6805
30;Murcia;030;Murcia;349040;169669;179371
30;Murcia;031;Ojós;594;293;301
30;Murcia;032;Pliego;3383;1729;1654
30;Murcia;033;Puerto Lumbreras;10585;5175;5410
30;Murcia;034;Ricote;1604;783;821
30;Murcia;035;San Javier;17523;8923;8600
30;Murcia;036;San Pedro del Pinatar;14487;7147;7340
30;Murcia;901;Santomera;10306;5174;5132
30;Murcia;037;Torre-Pacheco;21301;11633;9668
30;Murcia;038;Torres de Cotillas (Las);15380;7705;7675
30;Murcia;039;Totana;21666;10882;10784
30;Murcia;040;Ulea;971;479;492
30;Murcia;041;Unión (La);14188;7061;7127
30;Murcia;042;Villanueva del Río Segura;1458;705;753
30;Murcia;043;Yecla;28522;14292;14230
31;Navarra;001;Abáigar;94;50;44
31;Navarra;002;Abárzuza;517;256;261
31;Navarra;003;Abaurregaina/Abaurrea Alta;185;109;76
31;Navarra;004;Abaurrepea/Abaurrea Baja;45;32;13
31;Navarra;005;Aberin;353;186;167
31;Navarra;006;Ablitas;2255;1155;1100
31;Navarra;007;Adiós;128;63;65
31;Navarra;008;Aguilar de Codés;108;59;49
31;Navarra;009;Aibar/Oibar;929;475;454
31;Navarra;011;Allín;817;428;389
31;Navarra;012;Allo;1028;515;513
31;Navarra;010;Altsasu/Alsasua;7037;3550;3487
31;Navarra;013;Améscoa Baja;827;439;388
31;Navarra;014;Ancín/Antzin;265;133;132
31;Navarra;015;Andosilla;2505;1246;1259
31;Navarra;016;Ansoáin/Antsoain;6027;3075;2952
31;Navarra;017;Anue;431;254;177
31;Navarra;018;Añorbe;395;220;175
31;Navarra;019;Aoiz/Agoitz;1861;925;936
31;Navarra;020;Araitz;606;356;250
31;Navarra;025;Arakil;872;462;410
31;Navarra;021;Aranarache/Aranaratxe;91;45;46
31;Navarra;023;Aranguren;3241;1714;1527
31;Navarra;024;Arano;141;73;68
31;Navarra;022;Arantza;703;390;313
31;Navarra;026;Aras;228;121;107
31;Navarra;027;Arbizu;925;485;440
31;Navarra;028;Arce/Artzi;303;168;135
31;Navarra;029;Arcos (Los);1326;654;672
31;Navarra;030;Arellano;205;109;96
31;Navarra;031;Areso;307;157;150
31;Navarra;032;Arguedas;2257;1128;1129
31;Navarra;033;Aria;68;42;26
31;Navarra;034;Aribe;67;32;35
31;Navarra;035;Armañanzas;97;52;45
31;Navarra;036;Arróniz;1196;627;569
31;Navarra;037;Arruazu;104;57;47
31;Navarra;038;Artajona;1637;858;779
31;Navarra;039;Artazu;84;47;37
31;Navarra;040;Atez;208;128;80
31;Navarra;058;Auritz/Burguete;328;149;179
31;Navarra;041;Ayegui/Aiegi;832;431;401
31;Navarra;042;Azagra;3507;1737;1770
31;Navarra;043;Azuelo;60;28;32
31;Navarra;044;Bakaiku;365;202;163
31;Navarra;901;Barañain;20182;9921;10261
31;Navarra;045;Barásoain;456;225;231
31;Navarra;046;Barbarin;106;49;57
31;Navarra;047;Bargota;386;190;196
31;Navarra;048;Barillas;189;89;100
31;Navarra;049;Basaburua;685;398;287
31;Navarra;050;Baztan;7741;3935;3806
31;Navarra;137;Beintza-Labaien;300;164;136
31;Navarra;051;Beire;342;167;175
31;Navarra;052;Belascoáin;102;51;51
31;Navarra;250;Bera;3507;1783;1724
31;Navarra;053;Berbinzana;720;362;358
31;Navarra;905;Beriáin;2431;1208;1223
31;Navarra;902;Berrioplano;1038;520;518
31;Navarra;903;Berriozar;5412;2776;2636
31;Navarra;054;Bertizarana;637;319;318
31;Navarra;055;Betelu;340;185;155
31;Navarra;253;Bidaurreta;101;64;37
31;Navarra;056;Biurrun-Olcoz;176;96;80
31;Navarra;057;Buñuel;2383;1157;1226
31;Navarra;059;Burgui/Burgi;238;133;105
31;Navarra;060;Burlada/Burlata;15860;7815;8045
31;Navarra;061;Busto (El);102;54;48
31;Navarra;062;Cabanillas;1465;751;714
31;Navarra;063;Cabredo;128;66;62
31;Navarra;064;Cadreita;1869;915;954
31;Navarra;065;Caparroso;2286;1122;1164
31;Navarra;066;Cárcar;1239;600;639
31;Navarra;067;Carcastillo;2655;1333;1322
31;Navarra;068;Cascante;3548;1748;1800
31;Navarra;069;Cáseda;1067;524;543
31;Navarra;070;Castejón;3179;1581;1598
31;Navarra;071;Castillonuevo;27;16;11
31;Navarra;072;Cintruénigo;5475;2710;2765
31;Navarra;074;Cirauqui/Zirauki;450;249;201
31;Navarra;075;Ciriza;53;20;33
31;Navarra;076;Cizur;1091;564;527
31;Navarra;077;Corella;6458;3219;3239
31;Navarra;078;Cortes;3207;1634;1573
31;Navarra;079;Desojo;144;83;61
31;Navarra;080;Dicastillo;703;370;333
31;Navarra;081;Donamaria;382;193;189
31;Navarra;221;Doneztebe/Santesteban;1297;638;659
31;Navarra;083;Echarri;51;27;24
31;Navarra;086;Egüés;9541;4773;4768
31;Navarra;087;Elgorriaga;199;102;97
31;Navarra;089;Enériz/Eneritz;182;92;90
31;Navarra;090;Eratsun;189;118;71
31;Navarra;091;Ergoiena;482;275;207
31;Navarra;092;Erro;797;433;364
31;Navarra;094;Eslava;184;90;94
31;Navarra;095;Esparza de Salazar/Espartza Zaraitzu;116;61;55
31;Navarra;096;Espronceda;181;103;78
31;Navarra;097;Estella/Lizarra;12535;6021;6514
31;Navarra;098;Esteribar;1452;769;683
31;Navarra;099;Etayo;94;51;43
31;Navarra;082;Etxalar;812;423;389
31;Navarra;084;Etxarri-Aranatz;2309;1193;1116
31;Navarra;085;Etxauri;375;193;182
31;Navarra;100;Eulate;404;209;195
31;Navarra;101;Ezcabarte;1140;610;530
31;Navarra;093;Ezcároz/Ezkaroze;356;192;164
31;Navarra;102;Ezkurra;252;155;97
31;Navarra;103;Ezprogui;65;32;33
31;Navarra;104;Falces;2595;1274;1321
31;Navarra;105;Fitero;2034;1017;1017
31;Navarra;106;Fontellas;646;327;319
31;Navarra;107;Funes;2142;1100;1042
31;Navarra;108;Fustiñana;2311;1166;1145
31;Navarra;109;Galar;1066;569;497
31;Navarra;110;Gallipienzo;161;92;69
31;Navarra;111;Gallués/Galoze;120;74;46
31;Navarra;112;Garaioa;131;71;60
31;Navarra;113;Garde;202;108;94
31;Navarra;114;Garínoain;331;174;157
31;Navarra;115;Garralda;219;113;106
31;Navarra;116;Genevilla;127;67;60
31;Navarra;117;Goizueta;923;496;427
31;Navarra;118;Goñi;201;112;89
31;Navarra;119;Güesa/Gorza;78;45;33
31;Navarra;120;Guesálaz/Gesalatz;474;276;198
31;Navarra;121;Guirguillano;76;42;34
31;Navarra;256;Hiriberri/Villanueva de Aezkoa;155;86;69
31;Navarra;122;Huarte/Uharte;2793;1407;1386
31;Navarra;124;Ibargoiti;224;127;97
31;Navarra;259;Igantzi;587;305;282
31;Navarra;125;Igúzquiza;342;168;174
31;Navarra;126;Imotz;410;230;180
31;Navarra;127;Irañeta;159;84;75
31;Navarra;904;Irurtzun;1974;1005;969
31;Navarra;128;Isaba/Izaba;538;271;267
31;Navarra;129;Ituren;456;231;225
31;Navarra;130;Iturmendi;364;188;176
31;Navarra;131;Iza/Itza;632;323;309
31;Navarra;132;Izagaondoa;166;100;66
31;Navarra;133;Izalzu/Itzaltzu;50;28;22
31;Navarra;134;Jaurrieta;264;140;124
31;Navarra;135;Javier;137;60;77
31;Navarra;136;Juslapeña;464;256;208
31;Navarra;138;Lakuntza;1007;522;485
31;Navarra;139;Lana;219;129;90
31;Navarra;140;Lantz;119;75;44
31;Navarra;141;Lapoblación;176;97;79
31;Navarra;142;Larraga;1889;994;895
31;Navarra;143;Larraona;159;82;77
31;Navarra;144;Larraun;1099;611;488
31;Navarra;145;Lazagurría;236;126;110
31;Navarra;146;Leache;49;29;20
31;Navarra;147;Legarda;76;46;30
31;Navarra;148;Legaria;136;72;64
31;Navarra;149;Leitza;3026;1578;1448
31;Navarra;908;Lekunberri;838;429;409
31;Navarra;150;Leoz/Leotz;265;162;103
31;Navarra;151;Lerga;87;46;41
31;Navarra;152;Lerín;1923;960;963
31;Navarra;153;Lesaka;2760;1449;1311
31;Navarra;154;Lezáun;281;159;122
31;Navarra;155;Liédena;322;152;170
31;Navarra;156;Lizoáin-Arriasgoiti;237;135;102
31;Navarra;157;Lodosa;4589;2326;2263
31;Navarra;158;Lónguida/Longida;294;155;139
31;Navarra;159;Lumbier;1405;749;656
31;Navarra;160;Luquin;132;73;59
31;Navarra;248;Luzaide/Valcarlos;466;233;233
31;Navarra;161;Mañeru;374;186;188
31;Navarra;162;Marañón;72;39;33
31;Navarra;163;Marcilla;2454;1251;1203
31;Navarra;164;Mélida;827;425;402
31;Navarra;165;Mendavia;3543;1755;1788
31;Navarra;166;Mendaza;379;183;196
31;Navarra;167;Mendigorría;894;459;435
31;Navarra;168;Metauten;296;162;134
31;Navarra;169;Milagro;2586;1260;1326
31;Navarra;170;Mirafuentes;55;30;25
31;Navarra;171;Miranda de Arga;999;502;497
31;Navarra;172;Monreal;291;157;134
31;Navarra;173;Monteagudo;1172;595;577
31;Navarra;174;Morentin;111;53;58
31;Navarra;175;Mues;110;60;50
31;Navarra;176;Murchante;3059;1513;1546
31;Navarra;177;Murieta;272;151;121
31;Navarra;178;Murillo el Cuende;659;354;305
31;Navarra;179;Murillo el Fruto;755;375;380
31;Navarra;180;Muruzábal;214;109;105
31;Navarra;181;Navascués;220;134;86
31;Navarra;182;Nazar;57;31;26
31;Navarra;088;Noáin (Valle de Elorz)/Noain (Elortzibar);3879;1938;1941
31;Navarra;183;Obanos;759;364;395
31;Navarra;185;Ochagavía/Otsagabia;680;349;331
31;Navarra;184;Oco;87;51;36
31;Navarra;186;Odieta;334;180;154
31;Navarra;187;Oitz;157;91;66
31;Navarra;188;Olaibar;170;92;78
31;Navarra;189;Olazti/Olazagutía;1630;837;793
31;Navarra;190;Olejua;55;26;29
31;Navarra;191;Olite/Erriberri;3109;1557;1552
31;Navarra;194;Ollo;355;202;153
31;Navarra;192;Olóriz/Oloritz;169;94;75
31;Navarra;193;Cendea de Olza/Oltza Zendea;1311;669;642
31;Navarra;195;Orbaitzeta;242;133;109
31;Navarra;196;Orbara;62;33;29
31;Navarra;906;Orcoyen;1260;650;610
31;Navarra;197;Orísoain;93;52;41
31;Navarra;198;Oronz/Orontze;56;31;25
31;Navarra;199;Oroz-Betelu/Orotz-Betelu;231;126;105
31;Navarra;211;Orreaga/Roncesvalles;31;17;14
31;Navarra;200;Oteiza;916;480;436
31;Navarra;201;Pamplona/Iruña;171150;81377;89773
31;Navarra;202;Peralta/Azkoien;4628;2296;2332
31;Navarra;203;Petilla de Aragón;54;28;26
31;Navarra;204;Piedramillera;73;43;30
31;Navarra;205;Pitillas;593;303;290
31;Navarra;206;Puente la Reina/Gares;2094;1034;1060
31;Navarra;207;Pueyo;324;170;154
31;Navarra;208;Ribaforada;3189;1638;1551
31;Navarra;209;Romanzado;162;94;68
31;Navarra;210;Roncal/Erronkari;363;180;183
31;Navarra;212;Sada;249;135;114
31;Navarra;213;Saldías;155;84;71
31;Navarra;214;Salinas de Oro/Jaitz;108;64;44
31;Navarra;215;San Adrián;5340;2595;2745
31;Navarra;217;San Martín de Unx;486;264;222
31;Navarra;216;Sangüesa/Zangoza;4558;2343;2215
31;Navarra;219;Sansol;124;63;61
31;Navarra;220;Santacara;1048;533;515
31;Navarra;222;Sarriés/Sartze;83;48;35
31;Navarra;223;Sartaguda;1342;679;663
31;Navarra;224;Sesma;1390;678;712
31;Navarra;225;Sorlada;51;26;25
31;Navarra;226;Sunbilla;683;356;327
31;Navarra;227;Tafalla;10159;4996;5163
31;Navarra;228;Tiebas-Muruarte de Reta;582;311;271
31;Navarra;229;Tirapu;69;38;31
31;Navarra;230;Torralba del Río;152;83;69
31;Navarra;231;Torres del Río;185;87;98
31;Navarra;232;Tudela;27188;13190;13998
31;Navarra;233;Tulebras;100;33;67
31;Navarra;234;Ucar;119;68;51
31;Navarra;123;Uharte-Arakil;751;396;355
31;Navarra;235;Ujué;252;130;122
31;Navarra;236;Ultzama;1641;830;811
31;Navarra;237;Unciti;236;135;101
31;Navarra;238;Unzué;135;79;56
31;Navarra;239;Urdazubi/Urdax;396;188;208
31;Navarra;240;Urdiain;638;327;311
31;Navarra;241;Urraul Alto;154;89;65
31;Navarra;242;Urraul Bajo;274;127;147
31;Navarra;244;Urrotz;214;121;93
31;Navarra;243;Urroz;355;184;171
31;Navarra;245;Urzainqui/Urzainki;112;59;53
31;Navarra;246;Uterga;141;67;74
31;Navarra;247;Uztárroz/Uztarroze;282;141;141
31;Navarra;249;Valtierra;2423;1178;1245
31;Navarra;251;Viana;3389;1725;1664
31;Navarra;252;Vidángoz/Bidankoze;114;60;54
31;Navarra;254;Villafranca;2520;1225;1295
31;Navarra;255;Villamayor de Monjardín;119;67;52
31;Navarra;257;Villatuerta;767;389;378
31;Navarra;258;Villava/Atarrabia;9006;4467;4539
31;Navarra;260;Valle de Yerri/Deierri;1486;790;696
31;Navarra;261;Yesa;255;145;110
31;Navarra;262;Zabalza/Zabaltza;150;69;81
31;Navarra;073;Ziordia;373;174;199
31;Navarra;907;Zizur Mayor/Zizur Nagusia;9397;4697;4700
31;Navarra;263;Zubieta;308;179;129
31;Navarra;264;Zugarramurdi;239;123;116
31;Navarra;265;Zúñiga;126;71;55
32;Ourense;001;Allariz;5107;2447;2660
32;Ourense;002;Amoeiro;2264;1103;1161
32;Ourense;003;Arnoia (A);1148;539;609
32;Ourense;004;Avión;2953;1299;1654
32;Ourense;005;Baltar;1332;660;672
32;Ourense;006;Bande;2679;1270;1409
32;Ourense;007;Baños de Molgas;2258;1119;1139
32;Ourense;008;Barbadás;5576;2680;2896
32;Ourense;009;Barco de Valdeorras (O);12157;6065;6092
32;Ourense;010;Beade;585;281;304
32;Ourense;011;Beariz;1671;768;903
32;Ourense;012;Blancos (Os);1243;620;623
32;Ourense;013;Boborás;3560;1627;1933
32;Ourense;014;Bola (A);1621;761;860
32;Ourense;015;Bolo (O);1549;758;791
32;Ourense;016;Calvos de Randín;1346;664;682
32;Ourense;018;Carballeda de Avia;1754;841;913
32;Ourense;017;Carballeda de Valdeorras;2341;1173;1168
32;Ourense;019;Carballiño (O);12170;5764;6406
32;Ourense;020;Cartelle;4055;1950;2105
32;Ourense;022;Castrelo de Miño;2099;1007;1092
32;Ourense;021;Castrelo do Val;1308;644;664
32;Ourense;023;Castro Caldelas;2001;1009;992
32;Ourense;024;Celanova;5959;2816;3143
32;Ourense;025;Cenlle;1744;812;932
32;Ourense;029;Chandrexa de Queixa;928;506;422
32;Ourense;026;Coles;3064;1505;1559
32;Ourense;027;Cortegada;1468;711;757
32;Ourense;028;Cualedro;2475;1239;1236
32;Ourense;030;Entrimo;1510;677;833
32;Ourense;031;Esgos;1376;666;710
32;Ourense;033;Gomesende;1218;560;658
32;Ourense;034;Gudiña (A);1826;925;901
32;Ourense;035;Irixo (O);2259;1041;1218
32;Ourense;038;Larouco;625;292;333
32;Ourense;039;Laza;2112;1053;1059
32;Ourense;040;Leiro;2052;978;1074
32;Ourense;041;Lobeira;1249;602;647
32;Ourense;042;Lobios;2715;1297;1418
32;Ourense;043;Maceda;3366;1612;1754
32;Ourense;044;Manzaneda;1343;691;652
32;Ourense;045;Maside;3364;1573;1791
32;Ourense;046;Melón;1631;716;915
32;Ourense;047;Merca (A);2441;1175;1266
32;Ourense;048;Mezquita (A);1581;804;777
32;Ourense;049;Montederramo;1367;701;666
32;Ourense;050;Monterrei;3465;1727;1738
32;Ourense;051;Muíños;2122;1014;1108
32;Ourense;052;Nogueira de Ramuín;2676;1251;1425
32;Ourense;053;Oímbra;2002;995;1007
32;Ourense;054;Ourense;107965;50698;57267
32;Ourense;055;Paderne de Allariz;1756;837;919
32;Ourense;056;Padrenda;2745;1318;1427
32;Ourense;057;Parada de Sil;895;426;469
32;Ourense;058;Pereiro de Aguiar (O);4673;2285;2388
32;Ourense;059;Peroxa (A);2599;1225;1374
32;Ourense;060;Petín;1181;564;617
32;Ourense;061;Piñor;1641;816;825
32;Ourense;063;Pobra de Trives (A);2986;1488;1498
32;Ourense;064;Pontedeva;751;348;403
32;Ourense;062;Porqueira;1196;572;624
32;Ourense;065;Punxín;985;467;518
32;Ourense;066;Quintela de Leirado;1014;475;539
32;Ourense;067;Rairiz de Veiga;1952;955;997
32;Ourense;068;Ramirás;2100;969;1131
32;Ourense;069;Ribadavia;5568;2680;2888
32;Ourense;071;Riós;2364;1192;1172
32;Ourense;072;Rúa (A);5009;2453;2556
32;Ourense;073;Rubiá;1887;932;955
32;Ourense;074;San Amaro;1603;776;827
32;Ourense;075;San Cibrao das Viñas;3423;1646;1777
32;Ourense;076;San Cristovo de Cea;3313;1608;1705
32;Ourense;070;San Xoán de Río;1084;514;570
32;Ourense;077;Sandiás;1691;789;902
32;Ourense;078;Sarreaus;2023;1001;1022
32;Ourense;079;Taboadela;1746;874;872
32;Ourense;080;Teixeira (A);624;293;331
32;Ourense;081;Toén;2597;1317;1280
32;Ourense;082;Trasmiras;1874;911;963
32;Ourense;083;Veiga (A);1473;736;737
32;Ourense;084;Verea;1478;701;777
32;Ourense;085;Verín;12441;6079;6362
32;Ourense;086;Viana do Bolo;4286;2114;2172
32;Ourense;087;Vilamarín;2260;1104;1156
32;Ourense;088;Vilamartín de Valdeorras;2514;1235;1279
32;Ourense;089;Vilar de Barrio;2158;1073;1085
32;Ourense;090;Vilar de Santos;1039;511;528
32;Ourense;091;Vilardevós;2994;1500;1494
32;Ourense;092;Vilariño de Conso;847;465;382
32;Ourense;032;Xinzo de Limia;9511;4718;4793
32;Ourense;036;Xunqueira de Ambía;2103;1028;1075
32;Ourense;037;Xunqueira de Espadanedo;1106;528;578
33;Asturias;001;Allande;2558;1309;1249
33;Asturias;002;Aller;15985;7896;8089
33;Asturias;003;Amieva;947;502;445
33;Asturias;004;Avilés;84835;40876;43959
33;Asturias;005;Belmonte de Miranda;2397;1227;1170
33;Asturias;006;Bimenes;2225;1055;1170
33;Asturias;007;Boal;2656;1310;1346
33;Asturias;008;Cabrales;2318;1186;1132
33;Asturias;009;Cabranes;1289;639;650
33;Asturias;010;Candamo;2644;1270;1374
33;Asturias;012;Cangas de Onís;6211;3030;3181
33;Asturias;011;Cangas del Narcea;17812;9042;8770
33;Asturias;013;Caravia;559;282;277
33;Asturias;014;Carreño;10587;5141;5446
33;Asturias;015;Caso;2052;1079;973
33;Asturias;016;Castrillón;22457;10900;11557
33;Asturias;017;Castropol;4467;2130;2337
33;Asturias;018;Coaña;3780;1840;1940
33;Asturias;019;Colunga;4571;2239;2332
33;Asturias;020;Corvera de Asturias;16396;8058;8338
33;Asturias;021;Cudillero;6176;3028;3148
33;Asturias;022;Degaña;1565;827;738
33;Asturias;023;Franco (El);4159;2032;2127
33;Asturias;024;Gijón;265491;126181;139310
33;Asturias;025;Gozón;11372;5534;5838
33;Asturias;026;Grado;11844;5710;6134
33;Asturias;027;Grandas de Salime;1366;698;668
33;Asturias;028;Ibias;2222;1202;1020
33;Asturias;029;Illano;666;354;312
33;Asturias;030;Illas;1188;625;563
33;Asturias;031;Langreo;50001;23925;26076
33;Asturias;032;Laviana;14862;7222;7640
33;Asturias;033;Lena;14066;6861;7205
33;Asturias;035;Llanera;11528;5671;5857
33;Asturias;036;Llanes;13015;6243;6772
33;Asturias;037;Mieres;50760;24363;26397
33;Asturias;038;Morcín;2996;1468;1528
33;Asturias;039;Muros de Nalón;2397;1125;1272
33;Asturias;040;Nava;5666;2787;2879
33;Asturias;041;Navia;9149;4401;4748
33;Asturias;042;Noreña;4230;2016;2214
33;Asturias;043;Onís;906;456;450
33;Asturias;044;Oviedo;199549;93036;106513
33;Asturias;045;Parres;5539;2699;2840
33;Asturias;046;Peñamellera Alta;760;373;387
33;Asturias;047;Peñamellera Baja;1639;814;825
33;Asturias;048;Pesoz;265;132;133
33;Asturias;049;Piloña;9147;4416;4731
33;Asturias;050;Ponga;776;456;320
33;Asturias;051;Pravia;9548;4597;4951
33;Asturias;052;Proaza;942;479;463
33;Asturias;053;Quirós;1688;881;807
33;Asturias;054;Regueras (Las);2215;1097;1118
33;Asturias;055;Ribadedeva;1892;923;969
33;Asturias;056;Ribadesella;6241;2974;3267
33;Asturias;057;Ribera de Arriba;2041;1001;1040
33;Asturias;058;Riosa;2635;1345;1290
33;Asturias;059;Salas;7280;3548;3732
33;Asturias;061;San Martín de Oscos;546;283;263
33;Asturias;060;San Martín del Rey Aurelio;21758;10445;11313
33;Asturias;063;San Tirso de Abres;662;325;337
33;Asturias;062;Santa Eulalia de Oscos;594;300;294
33;Asturias;064;Santo Adriano;348;181;167
33;Asturias;065;Sariego;1426;706;720
33;Asturias;066;Siero;46664;22599;24065
33;Asturias;067;Sobrescobio;794;411;383
33;Asturias;068;Somiedo;1625;858;767
33;Asturias;069;Soto del Barco;4426;2098;2328
33;Asturias;070;Tapia de Casariego;4407;2096;2311
33;Asturias;071;Taramundi;948;461;487
33;Asturias;072;Teverga;2298;1196;1102
33;Asturias;073;Tineo;13273;6680;6593
33;Asturias;034;Valdés;15740;7704;8036
33;Asturias;074;Vegadeo;4910;2338;2572
33;Asturias;075;Villanueva de Oscos;418;213;205
33;Asturias;076;Villaviciosa;14223;6976;7247
33;Asturias;077;Villayón;2017;1036;981
33;Asturias;078;Yernes y Tameza;229;113;116
34;Palencia;001;Abarca de Campos;48;25;23
34;Palencia;003;Abia de las Torres;222;111;111
34;Palencia;004;Aguilar de Campoo;7734;3799;3935
34;Palencia;005;Alar del Rey;1335;633;702
34;Palencia;006;Alba de Cerrato;111;50;61
34;Palencia;009;Amayuelas de Arriba;44;26;18
34;Palencia;010;Ampudia;696;362;334
34;Palencia;011;Amusco;610;335;275
34;Palencia;012;Antigüedad;439;237;202
34;Palencia;015;Arconada;77;40;37
34;Palencia;017;Astudillo;1310;678;632
34;Palencia;018;Autilla del Pino;243;128;115
34;Palencia;019;Autillo de Campos;195;89;106
34;Palencia;020;Ayuela;84;51;33
34;Palencia;022;Baltanás;1597;824;773
34;Palencia;024;Baquerín de Campos;38;23;15
34;Palencia;025;Bárcena de Campos;67;29;38
34;Palencia;027;Barruelo de Santullán;1970;933;1037
34;Palencia;028;Báscones de Ojeda;224;112;112
34;Palencia;029;Becerril de Campos;1149;562;587
34;Palencia;031;Belmonte de Campos;52;24;28
34;Palencia;032;Berzosilla;75;34;41
34;Palencia;033;Boada de Campos;28;16;12
34;Palencia;035;Boadilla de Rioseco;192;97;95
34;Palencia;034;Boadilla del Camino;192;104;88
34;Palencia;036;Brañosera;295;154;141
34;Palencia;037;Buenavista de Valdavia;459;229;230
34;Palencia;038;Bustillo de la Vega;376;201;175
34;Palencia;039;Bustillo del Páramo de Carrión;101;54;47
34;Palencia;041;Calahorra de Boedo;143;71;72
34;Palencia;042;Calzada de los Molinos;393;208;185
34;Palencia;045;Capillas;124;59;65
34;Palencia;046;Cardeñosa de Volpejera;57;31;26
34;Palencia;047;Carrión de los Condes;2485;1165;1320
34;Palencia;048;Castil de Vela;111;53;58
34;Palencia;049;Castrejón de la Peña;652;343;309
34;Palencia;050;Castrillo de Don Juan;350;196;154
34;Palencia;051;Castrillo de Onielo;194;93;101
34;Palencia;052;Castrillo de Villavega;312;163;149
34;Palencia;053;Castromocho;273;140;133
34;Palencia;055;Cervatos de la Cueza;396;210;186
34;Palencia;056;Cervera de Pisuerga;2770;1400;1370
34;Palencia;057;Cevico de la Torre;707;347;360
34;Palencia;058;Cevico Navero;306;161;145
34;Palencia;059;Cisneros;646;310;336
34;Palencia;060;Cobos de Cerrato;265;127;138
34;Palencia;061;Collazos de Boedo;171;94;77
34;Palencia;062;Congosto de Valdavia;293;168;125
34;Palencia;063;Cordovilla la Real;129;75;54
34;Palencia;066;Cubillas de Cerrato;101;50;51
34;Palencia;067;Dehesa de Montejo;246;140;106
34;Palencia;068;Dehesa de Romanos;53;28;25
34;Palencia;069;Dueñas;2912;1488;1424
34;Palencia;070;Espinosa de Cerrato;276;144;132
34;Palencia;071;Espinosa de Villagonzalo;277;141;136
34;Palencia;072;Frechilla;276;131;145
34;Palencia;073;Fresno del Río;202;104;98
34;Palencia;074;Frómista;1027;509;518
34;Palencia;076;Fuentes de Nava;842;421;421
34;Palencia;077;Fuentes de Valdepero;243;132;111
34;Palencia;079;Grijota;812;403;409
34;Palencia;080;Guardo;8762;4440;4322
34;Palencia;081;Guaza de Campos;83;38;45
34;Palencia;082;Hérmedes de Cerrato;149;71;78
34;Palencia;083;Herrera de Pisuerga;2732;1357;1375
34;Palencia;084;Herrera de Valdecañas;206;102;104
34;Palencia;086;Hontoria de Cerrato;128;64;64
34;Palencia;087;Hornillos de Cerrato;140;65;75
34;Palencia;088;Husillos;225;124;101
34;Palencia;089;Itero de la Vega;247;127;120
34;Palencia;091;Lagartos;175;94;81
34;Palencia;092;Lantadilla;552;264;288
34;Palencia;094;Ledigos;112;58;54
34;Palencia;903;Loma de Ucieza;347;184;163
34;Palencia;096;Lomas;57;28;29
34;Palencia;098;Magaz de Pisuerga;724;375;349
34;Palencia;099;Manquillos;77;41;36
34;Palencia;100;Mantinos;204;102;102
34;Palencia;101;Marcilla de Campos;77;34;43
34;Palencia;102;Mazariegos;289;156;133
34;Palencia;103;Mazuecos de Valdeginate;141;72;69
34;Palencia;104;Melgar de Yuso;405;220;185
34;Palencia;106;Meneses de Campos;162;85;77
34;Palencia;107;Micieces de Ojeda;108;56;52
34;Palencia;108;Monzón de Campos;788;412;376
34;Palencia;109;Moratinos;95;50;45
34;Palencia;110;Mudá;133;67;66
34;Palencia;112;Nogal de las Huertas;75;43;32
34;Palencia;113;Olea de Boedo;47;22;25
34;Palencia;114;Olmos de Ojeda;356;198;158
34;Palencia;116;Osornillo;108;57;51
34;Palencia;901;Osorno la Mayor;1717;924;793
34;Palencia;120;Palencia;79745;38123;41622
34;Palencia;121;Palenzuela;336;179;157
34;Palencia;122;Páramo de Boedo;118;62;56
34;Palencia;123;Paredes de Nava;2507;1234;1273
34;Palencia;124;Payo de Ojeda;97;57;40
34;Palencia;125;Pedraza de Campos;142;74;68
34;Palencia;126;Pedrosa de la Vega;406;217;189
34;Palencia;127;Perales;125;66;59
34;Palencia;904;Pernía (La);482;265;217
34;Palencia;129;Pino del Río;271;157;114
34;Palencia;130;Piña de Campos;312;169;143
34;Palencia;131;Población de Arroyo;95;51;44
34;Palencia;132;Población de Campos;207;114;93
34;Palencia;133;Población de Cerrato;129;68;61
34;Palencia;134;Polentinos;93;49;44
34;Palencia;135;Pomar de Valdivia;533;275;258
34;Palencia;136;Poza de la Vega;282;156;126
34;Palencia;137;Pozo de Urama;44;25;19
34;Palencia;139;Prádanos de Ojeda;263;139;124
34;Palencia;140;Puebla de Valdavia (La);165;83;82
34;Palencia;141;Quintana del Puente;269;137;132
34;Palencia;143;Quintanilla de Onsoña;263;152;111
34;Palencia;146;Reinoso de Cerrato;86;50;36
34;Palencia;147;Renedo de la Vega;273;156;117
34;Palencia;149;Requena de Campos;58;29;29
34;Palencia;151;Respenda de la Peña;287;152;135
34;Palencia;152;Revenga de Campos;188;90;98
34;Palencia;154;Revilla de Collazos;92;50;42
34;Palencia;155;Ribas de Campos;205;107;98
34;Palencia;156;Riberos de la Cueza;93;51;42
34;Palencia;157;Saldaña;3200;1614;1586
34;Palencia;158;Salinas de Pisuerga;287;157;130
34;Palencia;159;San Cebrián de Campos;544;312;232
34;Palencia;160;San Cebrián de Mudá;211;102;109
34;Palencia;161;San Cristóbal de Boedo;49;29;20
34;Palencia;163;San Mamés de Campos;120;49;71
34;Palencia;165;San Román de la Cuba;128;65;63
34;Palencia;167;Santa Cecilia del Alcor;171;94;77
34;Palencia;168;Santa Cruz de Boedo;69;38;31
34;Palencia;169;Santervás de la Vega;570;310;260
34;Palencia;170;Santibáñez de Ecla;105;43;62
34;Palencia;171;Santibáñez de la Peña;1590;802;788
34;Palencia;174;Santoyo;295;145;150
34;Palencia;175;Serna (La);130;76;54
34;Palencia;177;Soto de Cerrato;236;120;116
34;Palencia;176;Sotobañado y Priorato;194;105;89
34;Palencia;178;Tabanera de Cerrato;175;89;86
34;Palencia;179;Tabanera de Valdavia;56;23;33
34;Palencia;180;Támara de Campos;104;52;52
34;Palencia;181;Tariego de Cerrato;563;294;269
34;Palencia;182;Torquemada;1240;631;609
34;Palencia;184;Torremormojón;78;42;36
34;Palencia;185;Triollo;97;53;44
34;Palencia;186;Valbuena de Pisuerga;75;43;32
34;Palencia;189;Valdeolmillos;92;49;43
34;Palencia;190;Valderrábano;81;49;32
34;Palencia;192;Valde-Ucieza;126;72;54
34;Palencia;196;Valle de Cerrato;137;77;60
34;Palencia;902;Valle del Retortillo;228;111;117
34;Palencia;199;Velilla del Río Carrión;1903;973;930
34;Palencia;023;Venta de Baños;6410;3119;3291
34;Palencia;201;Vertavillo;246;136;110
34;Palencia;093;Vid de Ojeda (La);141;82;59
34;Palencia;202;Villabasta de Valdavia;42;18;24
34;Palencia;204;Villacidaler;81;41;40
34;Palencia;205;Villaconancio;94;53;41
34;Palencia;206;Villada;1320;645;675
34;Palencia;208;Villaeles de Valdavia;87;48;39
34;Palencia;210;Villahán;151;81;70
34;Palencia;211;Villaherreros;289;138;151
34;Palencia;213;Villalaco;87;36;51
34;Palencia;214;Villalba de Guardo;243;130;113
34;Palencia;215;Villalcázar de Sirga;239;113;126
34;Palencia;216;Villalcón;88;42;46
34;Palencia;217;Villalobón;275;140;135
34;Palencia;218;Villaluenga de la Vega;665;373;292
34;Palencia;220;Villamartín de Campos;172;91;81
34;Palencia;221;Villamediana;246;126;120
34;Palencia;222;Villameriel;164;88;76
34;Palencia;223;Villamoronta;342;184;158
34;Palencia;224;Villamuera de la Cueza;72;43;29
34;Palencia;225;Villamuriel de Cerrato;4491;2302;2189
34;Palencia;227;Villanueva del Rebollar;108;54;54
34;Palencia;228;Villanuño de Valdavia;129;71;58
34;Palencia;229;Villaprovedo;106;61;45
34;Palencia;230;Villarmentero de Campos;16;10;6
34;Palencia;231;Villarrabé;295;147;148
34;Palencia;232;Villarramiel;1110;558;552
34;Palencia;233;Villasarracino;288;147;141
34;Palencia;234;Villasila de Valdavia;119;66;53
34;Palencia;236;Villaturde;270;129;141
34;Palencia;237;Villaumbrales;896;468;428
34;Palencia;238;Villaviudas;478;231;247
34;Palencia;240;Villerías de Campos;129;71;58
34;Palencia;241;Villodre;48;28;20
34;Palencia;242;Villodrigo;133;67;66
34;Palencia;243;Villoldo;504;266;238
34;Palencia;245;Villota del Páramo;467;271;196
34;Palencia;246;Villovieco;134;67;67
35;Palmas (Las);001;Agaete;5712;2916;2796
35;Palmas (Las);002;Agüimes;19305;9802;9503
35;Palmas (Las);003;Antigua;3617;1942;1675
35;Palmas (Las);004;Arrecife;40770;20737;20033
35;Palmas (Las);005;Artenara;1247;640;607
35;Palmas (Las);006;Arucas;30390;15241;15149
35;Palmas (Las);007;Betancuria;619;322;297
35;Palmas (Las);008;Firgas;6575;3307;3268
35;Palmas (Las);009;Gáldar;21987;11026;10961
35;Palmas (Las);010;Haría;3779;1943;1836
35;Palmas (Las);011;Ingenio;23496;11902;11594
35;Palmas (Las);016;Las Palmas de Gran Canaria;352641;171964;180677
35;Palmas (Las);012;Mogán;11607;6076;5531
35;Palmas (Las);013;Moya;8613;4367;4246
35;Palmas (Las);014;Oliva (La);8500;4527;3973
35;Palmas (Las);015;Pájara;8556;4707;3849
35;Palmas (Las);017;Puerto del Rosario;19367;10165;9202
35;Palmas (Las);018;San Bartolomé;10127;5289;4838
35;Palmas (Las);019;San Bartolomé de Tirajana;37162;19138;18024
35;Palmas (Las);020;San Nicolás de Tolentino;8091;4074;4017
35;Palmas (Las);021;Santa Brígida;17143;8517;8626
35;Palmas (Las);022;Santa Lucía de Tirajana;41769;21222;20547
35;Palmas (Las);023;Santa María de Guía de Gran Canaria;13544;6757;6787
35;Palmas (Las);024;Teguise;10874;5566;5308
35;Palmas (Las);025;Tejeda;2445;1247;1198
35;Palmas (Las);026;Telde;83733;41907;41826
35;Palmas (Las);027;Teror;11459;5755;5704
35;Palmas (Las);028;Tías;11534;5935;5599
35;Palmas (Las);029;Tinajo;3964;2035;1929
35;Palmas (Las);030;Tuineje;8361;4398;3963
35;Palmas (Las);032;Valleseco;4219;2150;2069
35;Palmas (Las);031;Valsequillo de Gran Canaria;7710;3945;3765
35;Palmas (Las);033;Vega de San Mateo;7146;3684;3462
35;Palmas (Las);034;Yaiza;3801;2057;1744
36;Pontevedra;020;Agolada;4457;2176;2281
36;Pontevedra;001;Arbo;4459;2178;2281
36;Pontevedra;003;Baiona;10443;5107;5336
36;Pontevedra;002;Barro;3540;1694;1846
36;Pontevedra;004;Bueu;12484;6111;6373
36;Pontevedra;005;Caldas de Reis;9369;4501;4868
36;Pontevedra;006;Cambados;12918;6269;6649
36;Pontevedra;007;Campo Lameiro;2384;1131;1253
36;Pontevedra;008;Cangas;23235;11468;11767
36;Pontevedra;009;Cañiza (A);7245;3401;3844
36;Pontevedra;010;Catoira;3541;1723;1818
36;Pontevedra;011;Cerdedo;2684;1162;1522
36;Pontevedra;012;Cotobade;5012;2293;2719
36;Pontevedra;013;Covelo;4224;1956;2268
36;Pontevedra;014;Crecente;2979;1352;1627
36;Pontevedra;015;Cuntis;5733;2642;3091
36;Pontevedra;016;Dozón;2279;1104;1175
36;Pontevedra;017;Estrada (A);22369;10532;11837
36;Pontevedra;018;Forcarei;5064;2389;2675
36;Pontevedra;019;Fornelos de Montes;2343;1063;1280
36;Pontevedra;021;Gondomar;11190;5485;5705
36;Pontevedra;022;Grove (O);10985;5464;5521
36;Pontevedra;023;Guarda (A);9919;4799;5120
36;Pontevedra;901;Illa de Arousa (A);4828;2363;2465
36;Pontevedra;024;Lalín;20090;9723;10367
36;Pontevedra;025;Lama (A);2956;1345;1611
36;Pontevedra;026;Marín;25344;12526;12818
36;Pontevedra;027;Meaño;5451;2595;2856
36;Pontevedra;028;Meis;5001;2325;2676
36;Pontevedra;029;Moaña;17673;8556;9117
36;Pontevedra;030;Mondariz;5915;2770;3145
36;Pontevedra;031;Mondariz-Balneario;635;296;339
36;Pontevedra;032;Moraña;4402;2093;2309
36;Pontevedra;033;Mos;13704;6654;7050
36;Pontevedra;034;Neves (As);5027;2374;2653
36;Pontevedra;035;Nigrán;15422;7540;7882
36;Pontevedra;036;Oia;2956;1468;1488
36;Pontevedra;037;Pazos de Borbén;3202;1488;1714
36;Pontevedra;041;Poio;13802;6688;7114
36;Pontevedra;043;Ponte Caldelas;6648;3137;3511
36;Pontevedra;042;Ponteareas;17136;8152;8984
36;Pontevedra;044;Pontecesures;2963;1471;1492
36;Pontevedra;038;Pontevedra;73871;34924;38947
36;Pontevedra;039;Porriño (O);15812;7617;8195
36;Pontevedra;040;Portas;3218;1510;1708
36;Pontevedra;045;Redondela;28768;13910;14858
36;Pontevedra;046;Ribadumia;4205;2051;2154
36;Pontevedra;047;Rodeiro;4455;2280;2175
36;Pontevedra;048;Rosal (O);5807;2797;3010
36;Pontevedra;049;Salceda de Caselas;6009;2921;3088
36;Pontevedra;050;Salvaterra de Miño;8589;4110;4479
36;Pontevedra;051;Sanxenxo;15964;7827;8137
36;Pontevedra;052;Silleda;9339;4490;4849
36;Pontevedra;053;Soutomaior;5239;2509;2730
36;Pontevedra;054;Tomiño;10652;5188;5464
36;Pontevedra;055;Tui;15756;7494;8262
36;Pontevedra;056;Valga;6288;3060;3228
36;Pontevedra;057;Vigo;283110;134369;148741
36;Pontevedra;059;Vila de Cruces;7370;3604;3766
36;Pontevedra;058;Vilaboa;5731;2805;2926
36;Pontevedra;060;Vilagarcía de Arousa;33724;16318;17406
36;Pontevedra;061;Vilanova de Arousa;10380;5033;5347
37;Salamanca;001;Abusejo;270;131;139
37;Salamanca;002;Agallas;184;96;88
37;Salamanca;003;Ahigal de los Aceiteros;214;110;104
37;Salamanca;004;Ahigal de Villarino;48;25;23
37;Salamanca;005;Alameda de Gardón (La);179;85;94
37;Salamanca;006;Alamedilla (La);220;113;107
37;Salamanca;007;Alaraz;688;355;333
37;Salamanca;008;Alba de Tormes;4609;2266;2343
37;Salamanca;009;Alba de Yeltes;305;147;158
37;Salamanca;010;Alberca (La);1105;571;534
37;Salamanca;011;Alberguería de Argañán (La);207;106;101
37;Salamanca;012;Alconada;230;113;117
37;Salamanca;015;Aldea del Obispo;416;216;200
37;Salamanca;013;Aldeacipreste;249;137;112
37;Salamanca;014;Aldeadávila de la Ribera;1697;864;833
37;Salamanca;016;Aldealengua;477;240;237
37;Salamanca;017;Aldeanueva de Figueroa;353;177;176
37;Salamanca;018;Aldeanueva de la Sierra;105;49;56
37;Salamanca;019;Aldearrodrigo;220;112;108
37;Salamanca;020;Aldearrubia;517;275;242
37;Salamanca;021;Aldeaseca de Alba;141;68;73
37;Salamanca;022;Aldeaseca de la Frontera;370;184;186
37;Salamanca;023;Aldeatejada;583;282;301
37;Salamanca;024;Aldeavieja de Tormes;142;71;71
37;Salamanca;025;Aldehuela de la Bóveda;395;194;201
37;Salamanca;026;Aldehuela de Yeltes;341;169;172
37;Salamanca;027;Almenara de Tormes;253;127;126
37;Salamanca;028;Almendra;204;106;98
37;Salamanca;029;Anaya de Alba;330;181;149
37;Salamanca;030;Añover de Tormes;119;63;56
37;Salamanca;031;Arabayona de Mógica;546;293;253
37;Salamanca;032;Arapiles;513;253;260
37;Salamanca;033;Arcediano;106;54;52
37;Salamanca;034;Arco (El);110;57;53
37;Salamanca;035;Armenteros;344;170;174
37;Salamanca;037;Atalaya (La);160;85;75
37;Salamanca;038;Babilafuente;1008;531;477
37;Salamanca;039;Bañobárez;464;234;230
37;Salamanca;040;Barbadillo;580;278;302
37;Salamanca;041;Barbalos;117;60;57
37;Salamanca;042;Barceo;73;39;34
37;Salamanca;044;Barruecopardo;595;302;293
37;Salamanca;045;Bastida (La);43;23;20
37;Salamanca;046;Béjar;16165;7672;8493
37;Salamanca;047;Beleña;153;86;67
37;Salamanca;049;Bermellar;220;103;117
37;Salamanca;050;Berrocal de Huebra;129;62;67
37;Salamanca;051;Berrocal de Salvatierra;147;74;73
37;Salamanca;052;Boada;463;236;227
37;Salamanca;054;Bodón (El);350;183;167
37;Salamanca;055;Bogajo;217;116;101
37;Salamanca;056;Bouza (La);66;31;35
37;Salamanca;057;Bóveda del Río Almar;300;160;140
37;Salamanca;058;Brincones;115;55;60
37;Salamanca;059;Buenamadre;175;94;81
37;Salamanca;060;Buenavista;86;45;41
37;Salamanca;061;Cabaco (El);287;143;144
37;Salamanca;063;Cabeza de Béjar (La);114;58;56
37;Salamanca;065;Cabeza del Caballo;494;254;240
37;Salamanca;062;Cabezabellosa de la Calzada;146;76;70
37;Salamanca;067;Cabrerizos;1546;775;771
37;Salamanca;068;Cabrillas;560;265;295
37;Salamanca;069;Calvarrasa de Abajo;1004;497;507
37;Salamanca;070;Calvarrasa de Arriba;642;332;310
37;Salamanca;071;Calzada de Béjar (La);104;53;51
37;Salamanca;072;Calzada de Don Diego;263;135;128
37;Salamanca;073;Calzada de Valdunciel;649;321;328
37;Salamanca;074;Campillo de Azaba;268;133;135
37;Salamanca;077;Campo de Peñaranda (El);427;222;205
37;Salamanca;078;Candelario;1123;551;572
37;Salamanca;079;Canillas de Abajo;117;67;50
37;Salamanca;080;Cantagallo;291;140;151
37;Salamanca;081;Cantalapiedra;1385;682;703
37;Salamanca;082;Cantalpino;1179;637;542
37;Salamanca;083;Cantaracillo;282;144;138
37;Salamanca;085;Carbajosa de la Sagrada;1292;646;646
37;Salamanca;086;Carpio de Azaba;114;60;54
37;Salamanca;087;Carrascal de Barregas;417;217;200
37;Salamanca;088;Carrascal del Obispo;258;125;133
37;Salamanca;089;Casafranca;84;37;47
37;Salamanca;090;Casas del Conde (Las);90;42;48
37;Salamanca;091;Casillas de Flores;282;129;153
37;Salamanca;092;Castellanos de Moriscos;358;170;188
37;Salamanca;185;Castellanos de Villiquera;592;310;282
37;Salamanca;096;Castillejo de Martín Viejo;336;174;162
37;Salamanca;097;Castraz;70;43;27
37;Salamanca;098;Cepeda;531;256;275
37;Salamanca;099;Cereceda de la Sierra;105;57;48
37;Salamanca;100;Cerezal de Peñahorcada;144;76;68
37;Salamanca;101;Cerralbo;264;140;124
37;Salamanca;102;Cerro (El);578;305;273
37;Salamanca;103;Cespedosa de Tormes;668;350;318
37;Salamanca;114;Chagarcía Medianero;158;85;73
37;Salamanca;104;Cilleros de la Bastida;49;24;25
37;Salamanca;106;Cipérez;469;233;236
37;Salamanca;107;Ciudad Rodrigo;14553;6991;7562
37;Salamanca;108;Coca de Alba;157;70;87
37;Salamanca;109;Colmenar de Montemayor;296;166;130
37;Salamanca;110;Cordovilla;144;81;63
37;Salamanca;112;Cristóbal;247;128;119
37;Salamanca;113;Cubo de Don Sancho (El);599;318;281
37;Salamanca;115;Dios le Guarde;172;97;75
37;Salamanca;116;Doñinos de Ledesma;101;52;49
37;Salamanca;117;Doñinos de Salamanca;703;364;339
37;Salamanca;118;Ejeme;206;111;95
37;Salamanca;120;Encina de San Silvestre;125;65;60
37;Salamanca;119;Encina (La);221;119;102
37;Salamanca;121;Encinas de Abajo;688;359;329
37;Salamanca;122;Encinas de Arriba;292;141;151
37;Salamanca;123;Encinasola de los Comendadores;311;160;151
37;Salamanca;124;Endrinal;309;168;141
37;Salamanca;125;Escurial de la Sierra;308;152;156
37;Salamanca;126;Espadaña;52;26;26
37;Salamanca;127;Espeja;301;154;147
37;Salamanca;128;Espino de la Orbada;371;190;181
37;Salamanca;129;Florida de Liébana;254;137;117
37;Salamanca;130;Forfoleda;250;127;123
37;Salamanca;131;Frades de la Sierra;291;150;141
37;Salamanca;132;Fregeneda (La);594;286;308
37;Salamanca;133;Fresnedoso;126;56;70
37;Salamanca;134;Fresno Alhándiga;346;182;164
37;Salamanca;135;Fuente de San Esteban (La);1544;783;761
37;Salamanca;136;Fuenteguinaldo;992;501;491
37;Salamanca;137;Fuenteliante;160;73;87
37;Salamanca;138;Fuenterroble de Salvatierra;288;146;142
37;Salamanca;139;Fuentes de Béjar;323;134;189
37;Salamanca;140;Fuentes de Oñoro;1442;690;752
37;Salamanca;141;Gajates;271;135;136
37;Salamanca;142;Galindo y Perahuy;250;134;116
37;Salamanca;143;Galinduste;568;277;291
37;Salamanca;144;Galisancho;597;327;270
37;Salamanca;145;Gallegos de Argañán;422;219;203
37;Salamanca;146;Gallegos de Solmirón;202;98;104
37;Salamanca;147;Garcibuey;298;169;129
37;Salamanca;148;Garcihernández;598;322;276
37;Salamanca;149;Garcirrey;113;56;57
37;Salamanca;150;Gejuelo del Barro;51;29;22
37;Salamanca;151;Golpejas;219;112;107
37;Salamanca;152;Gomecello;564;287;277
37;Salamanca;154;Guadramiro;235;136;99
37;Salamanca;155;Guijo de Ávila;113;62;51
37;Salamanca;156;Guijuelo;5050;2511;2539
37;Salamanca;157;Herguijuela de Ciudad Rodrigo;158;83;75
37;Salamanca;158;Herguijuela de la Sierra;326;164;162
37;Salamanca;159;Herguijuela del Campo;126;58;68
37;Salamanca;160;Hinojosa de Duero;870;432;438
37;Salamanca;161;Horcajo de Montemayor;205;103;102
37;Salamanca;162;Horcajo Medianero;383;190;193
37;Salamanca;163;Hoya (La);25;19;6
37;Salamanca;164;Huerta;274;147;127
37;Salamanca;165;Iruelos;67;27;40
37;Salamanca;166;Ituero de Azaba;300;162;138
37;Salamanca;167;Juzbado;175;89;86
37;Salamanca;168;Lagunilla;669;356;313
37;Salamanca;169;Larrodrigo;325;170;155
37;Salamanca;170;Ledesma;1989;969;1020
37;Salamanca;171;Ledrada;592;299;293
37;Salamanca;172;Linares de Riofrío;1038;526;512
37;Salamanca;173;Lumbrales;2234;1106;1128
37;Salamanca;175;Machacón;544;274;270
37;Salamanca;174;Macotera;1745;882;863
37;Salamanca;176;Madroñal;176;92;84
37;Salamanca;177;Maíllo (El);455;229;226
37;Salamanca;178;Malpartida;168;93;75
37;Salamanca;179;Mancera de Abajo;378;188;190
37;Salamanca;180;Manzano (El);101;55;46
37;Salamanca;181;Martiago;391;204;187
37;Salamanca;183;Martín de Yeltes;579;294;285
37;Salamanca;182;Martinamor;81;42;39
37;Salamanca;184;Masueco;488;244;244
37;Salamanca;186;Mata de Ledesma (La);152;73;79
37;Salamanca;187;Matilla de los Caños del Río;672;350;322
37;Salamanca;188;Maya (La);263;140;123
37;Salamanca;189;Membribe de la Sierra;102;54;48
37;Salamanca;190;Mieza;357;175;182
37;Salamanca;191;Milano (El);199;106;93
37;Salamanca;192;Miranda de Azán;300;133;167
37;Salamanca;193;Miranda del Castañar;636;331;305
37;Salamanca;194;Mogarraz;368;173;195
37;Salamanca;195;Molinillo;72;33;39
37;Salamanca;196;Monforte de la Sierra;126;71;55
37;Salamanca;197;Monleón;135;78;57
37;Salamanca;198;Monleras;273;138;135
37;Salamanca;199;Monsagro;241;136;105
37;Salamanca;200;Montejo;246;132;114
37;Salamanca;201;Montemayor del Río;368;196;172
37;Salamanca;202;Monterrubio de Armuña;386;191;195
37;Salamanca;203;Monterrubio de la Sierra;164;89;75
37;Salamanca;204;Morasverdes;460;229;231
37;Salamanca;205;Morille;183;98;85
37;Salamanca;206;Moríñigo;146;75;71
37;Salamanca;207;Moriscos;143;72;71
37;Salamanca;208;Moronta;138;73;65
37;Salamanca;209;Mozárbez;394;203;191
37;Salamanca;211;Narros de Matalayegua;308;166;142
37;Salamanca;213;Nava de Béjar;123;62;61
37;Salamanca;214;Nava de Francia;153;80;73
37;Salamanca;215;Nava de Sotrobal;203;107;96
37;Salamanca;212;Navacarros;125;67;58
37;Salamanca;216;Navales;406;230;176
37;Salamanca;217;Navalmoral de Béjar;77;34;43
37;Salamanca;218;Navamorales;193;104;89
37;Salamanca;219;Navarredonda de la Rinconada;272;131;141
37;Salamanca;221;Navasfrías;719;356;363
37;Salamanca;222;Negrilla de Palencia;140;67;73
37;Salamanca;223;Olmedo de Camaces;184;88;96
37;Salamanca;224;Orbada (La);289;148;141
37;Salamanca;225;Pajares de la Laguna;148;73;75
37;Salamanca;226;Palacios del Arzobispo;249;127;122
37;Salamanca;228;Palaciosrubios;568;302;266
37;Salamanca;229;Palencia de Negrilla;208;103;105
37;Salamanca;230;Parada de Arriba;255;138;117
37;Salamanca;231;Parada de Rubiales;352;184;168
37;Salamanca;232;Paradinas de San Juan;660;353;307
37;Salamanca;233;Pastores;64;35;29
37;Salamanca;234;Payo (El);503;239;264
37;Salamanca;235;Pedraza de Alba;299;159;140
37;Salamanca;236;Pedrosillo de Alba;283;142;141
37;Salamanca;237;Pedrosillo de los Aires;456;245;211
37;Salamanca;238;Pedrosillo el Ralo;148;73;75
37;Salamanca;239;Pedroso de la Armuña (El);325;159;166
37;Salamanca;240;Pelabravo;732;372;360
37;Salamanca;241;Pelarrodríguez;207;119;88
37;Salamanca;242;Pelayos;81;41;40
37;Salamanca;243;Peña (La);163;74;89
37;Salamanca;244;Peñacaballera;226;106;120
37;Salamanca;245;Peñaparda;499;243;256
37;Salamanca;246;Peñaranda de Bracamonte;6159;3011;3148
37;Salamanca;247;Peñarandilla;282;142;140
37;Salamanca;248;Peralejos de Abajo;207;99;108
37;Salamanca;249;Peralejos de Arriba;75;41;34
37;Salamanca;250;Pereña de la Ribera;556;282;274
37;Salamanca;251;Peromingo;165;79;86
37;Salamanca;252;Pinedas;203;104;99
37;Salamanca;253;Pino de Tormes (El);179;90;89
37;Salamanca;254;Pitiegua;273;132;141
37;Salamanca;255;Pizarral;91;44;47
37;Salamanca;256;Poveda de las Cintas;356;193;163
37;Salamanca;257;Pozos de Hinojo;88;47;41
37;Salamanca;258;Puebla de Azaba;303;156;147
37;Salamanca;259;Puebla de San Medel;75;40;35
37;Salamanca;260;Puebla de Yeltes;261;143;118
37;Salamanca;261;Puente del Congosto;358;175;183
37;Salamanca;262;Puertas;106;58;48
37;Salamanca;263;Puerto de Béjar;509;234;275
37;Salamanca;264;Puerto Seguro;117;59;58
37;Salamanca;265;Rágama;318;163;155
37;Salamanca;266;Redonda (La);121;57;64
37;Salamanca;267;Retortillo;251;118;133
37;Salamanca;268;Rinconada de la Sierra (La);172;86;86
37;Salamanca;269;Robleda;581;311;270
37;Salamanca;270;Robliza de Cojos;198;101;97
37;Salamanca;271;Rollán;604;311;293
37;Salamanca;272;Saelices el Chico;189;101;88
37;Salamanca;273;Sagrada (La);194;99;95
37;Salamanca;303;Sahugo (El);289;152;137
37;Salamanca;274;Salamanca;158457;74404;84053
37;Salamanca;275;Saldeana;193;107;86
37;Salamanca;276;Salmoral;350;171;179
37;Salamanca;277;Salvatierra de Tormes;65;33;32
37;Salamanca;278;San Cristóbal de la Cuesta;341;174;167
37;Salamanca;284;San Esteban de la Sierra;463;235;228
37;Salamanca;285;San Felices de los Gallegos;660;330;330
37;Salamanca;286;San Martín del Castañar;284;144;140
37;Salamanca;287;San Miguel de Valero;451;238;213
37;Salamanca;036;San Miguel del Robledo;100;47;53
37;Salamanca;288;San Morales;206;110;96
37;Salamanca;289;San Muñoz;371;185;186
37;Salamanca;291;San Pedro de Rozados;367;183;184
37;Salamanca;290;San Pedro del Valle;131;64;67
37;Salamanca;292;San Pelayo de Guareña;108;55;53
37;Salamanca;280;Sanchón de la Ribera;127;68;59
37;Salamanca;281;Sanchón de la Sagrada;56;31;25
37;Salamanca;282;Sanchotello;324;164;160
37;Salamanca;279;Sancti-Spíritus;1215;630;585
37;Salamanca;283;Sando;201;106;95
37;Salamanca;293;Santa María de Sando;195;103;92
37;Salamanca;294;Santa Marta de Tormes;9884;4918;4966
37;Salamanca;296;Santiago de la Puebla;586;302;284
37;Salamanca;297;Santibáñez de Béjar;699;346;353
37;Salamanca;298;Santibáñez de la Sierra;258;142;116
37;Salamanca;299;Santiz;285;145;140
37;Salamanca;300;Santos (Los);777;401;376
37;Salamanca;301;Sardón de los Frailes;102;55;47
37;Salamanca;302;Saucelle;483;240;243
37;Salamanca;304;Sepulcro-Hilario;303;156;147
37;Salamanca;305;Sequeros;270;115;155
37;Salamanca;306;Serradilla del Arroyo;447;225;222
37;Salamanca;307;Serradilla del Llano;277;142;135
37;Salamanca;309;Sierpe (La);58;32;26
37;Salamanca;310;Sieteiglesias de Tormes;178;87;91
37;Salamanca;311;Sobradillo;374;181;193
37;Salamanca;312;Sorihuela;391;190;201
37;Salamanca;313;Sotoserrano;738;388;350
37;Salamanca;314;Tabera de Abajo;115;59;56
37;Salamanca;315;Tala (La);145;77;68
37;Salamanca;316;Tamames;1040;531;509
37;Salamanca;317;Tarazona de Guareña;437;235;202
37;Salamanca;318;Tardáguila;267;142;125
37;Salamanca;319;Tejado (El);178;86;92
37;Salamanca;320;Tejeda y Segoyuela;124;63;61
37;Salamanca;321;Tenebrón;237;121;116
37;Salamanca;322;Terradillos;3002;1518;1484
37;Salamanca;323;Topas;708;359;349
37;Salamanca;324;Tordillos;577;291;286
37;Salamanca;325;Tornadizo (El);145;73;72
37;Salamanca;327;Torresmenudas;240;117;123
37;Salamanca;328;Trabanca;256;130;126
37;Salamanca;329;Tremedal de Tormes;49;24;25
37;Salamanca;330;Valdecarros;466;242;224
37;Salamanca;331;Valdefuentes de Sangusín;332;167;165
37;Salamanca;332;Valdehijaderos;119;65;54
37;Salamanca;333;Valdelacasa;360;194;166
37;Salamanca;334;Valdelageve;135;71;64
37;Salamanca;335;Valdelosa;484;232;252
37;Salamanca;336;Valdemierque;71;36;35
37;Salamanca;337;Valderrodrigo;196;93;103
37;Salamanca;338;Valdunciel;127;60;67
37;Salamanca;339;Valero;464;229;235
37;Salamanca;343;Vallejera de Riofrío;53;24;29
37;Salamanca;340;Valsalabroso;232;122;110
37;Salamanca;341;Valverde de Valdelacasa;75;38;37
37;Salamanca;342;Valverdón;273;138;135
37;Salamanca;344;Vecinos;296;145;151
37;Salamanca;345;Vega de Tirados;227;117;110
37;Salamanca;346;Veguillas (Las);312;151;161
37;Salamanca;347;Vellés (La);472;239;233
37;Salamanca;348;Ventosa del Río Almar;170;82;88
37;Salamanca;349;Vídola (La);191;97;94
37;Salamanca;351;Villaflores;477;236;241
37;Salamanca;352;Villagonzalo de Tormes;249;132;117
37;Salamanca;353;Villalba de los Llanos;196;108;88
37;Salamanca;354;Villamayor;2490;1297;1193
37;Salamanca;355;Villanueva del Conde;263;140;123
37;Salamanca;356;Villar de Argañán;109;55;54
37;Salamanca;357;Villar de Ciervo;409;211;198
37;Salamanca;358;Villar de Gallimazo;221;107;114
37;Salamanca;359;Villar de la Yegua;319;144;175
37;Salamanca;360;Villar de Peralonso;356;167;189
37;Salamanca;361;Villar de Samaniego;126;66;60
37;Salamanca;362;Villares de la Reina;2397;1195;1202
37;Salamanca;363;Villares de Yeltes;173;77;96
37;Salamanca;364;Villarino de los Aires;1125;553;572
37;Salamanca;365;Villarmayor;243;127;116
37;Salamanca;366;Villarmuerto;65;37;28
37;Salamanca;367;Villasbuenas;323;162;161
37;Salamanca;368;Villasdardo;26;12;14
37;Salamanca;369;Villaseco de los Gamitos;208;107;101
37;Salamanca;370;Villaseco de los Reyes;461;238;223
37;Salamanca;371;Villasrubias;388;209;179
37;Salamanca;372;Villaverde de Guareña;198;98;100
37;Salamanca;373;Villavieja de Yeltes;1132;563;569
37;Salamanca;374;Villoria;1400;695;705
37;Salamanca;375;Villoruela;1015;507;508
37;Salamanca;350;Vilvestre;626;305;321
37;Salamanca;376;Vitigudino;3159;1554;1605
37;Salamanca;377;Yecla de Yeltes;363;178;185
37;Salamanca;378;Zamarra;161;83;78
37;Salamanca;379;Zamayón;205;117;88
37;Salamanca;380;Zarapicos;66;37;29
37;Salamanca;381;Zarza de Pumareda (La);201;114;87
37;Salamanca;382;Zorita de la Frontera;293;161;132
38;Santa Cruz de Tenerife;001;Adeje;13605;6833;6772
38;Santa Cruz de Tenerife;002;Agulo;1090;538;552
38;Santa Cruz de Tenerife;003;Alajeró;1206;636;570
38;Santa Cruz de Tenerife;004;Arafo;4536;2198;2338
38;Santa Cruz de Tenerife;005;Arico;5053;2586;2467
38;Santa Cruz de Tenerife;006;Arona;26312;13161;13151
38;Santa Cruz de Tenerife;007;Barlovento;2408;1207;1201
38;Santa Cruz de Tenerife;008;Breña Alta;5784;2869;2915
38;Santa Cruz de Tenerife;009;Breña Baja;3737;1852;1885
38;Santa Cruz de Tenerife;010;Buenavista del Norte;5469;2782;2687
38;Santa Cruz de Tenerife;011;Candelaria;12681;6265;6416
38;Santa Cruz de Tenerife;012;Fasnia;2378;1195;1183
38;Santa Cruz de Tenerife;013;Frontera;4218;2141;2077
38;Santa Cruz de Tenerife;014;Fuencaliente de la Palma;1728;876;852
38;Santa Cruz de Tenerife;015;Garachico;5497;2702;2795
38;Santa Cruz de Tenerife;016;Garafía;1754;891;863
38;Santa Cruz de Tenerife;017;Granadilla de Abona;17321;8665;8656
38;Santa Cruz de Tenerife;018;Guancha (La);5140;2558;2582
38;Santa Cruz de Tenerife;019;Guía de Isora;11958;5810;6148
38;Santa Cruz de Tenerife;020;Güímar;13761;6753;7008
38;Santa Cruz de Tenerife;021;Hermigua;2057;1056;1001
38;Santa Cruz de Tenerife;022;Icod de los Vinos;22079;10833;11246
38;Santa Cruz de Tenerife;024;Llanos de Aridane (Los);17774;8773;9001
38;Santa Cruz de Tenerife;025;Matanza de Acentejo (La);6377;3241;3136
38;Santa Cruz de Tenerife;026;Orotava (La);35775;17704;18071
38;Santa Cruz de Tenerife;027;Paso (El);7192;3630;3562
38;Santa Cruz de Tenerife;901;Pinar de el Hierro (El);"";"";""
38;Santa Cruz de Tenerife;028;Puerto de la Cruz;24050;11713;12337
38;Santa Cruz de Tenerife;029;Puntagorda;1785;879;906
38;Santa Cruz de Tenerife;030;Puntallana;2025;1004;1021
38;Santa Cruz de Tenerife;031;Realejos (Los);32469;16112;16357
38;Santa Cruz de Tenerife;032;Rosario (El);11544;5780;5764
38;Santa Cruz de Tenerife;033;San Andrés y Sauces;5339;2696;2643
38;Santa Cruz de Tenerife;023;San Cristóbal de La Laguna;127945;62703;65242
38;Santa Cruz de Tenerife;034;San Juan de la Rambla;4645;2297;2348
38;Santa Cruz de Tenerife;035;San Miguel de Abona;5722;2871;2851
38;Santa Cruz de Tenerife;036;San Sebastián de la Gomera;6100;3061;3039
38;Santa Cruz de Tenerife;037;Santa Cruz de la Palma;15445;7434;8011
38;Santa Cruz de Tenerife;038;Santa Cruz de Tenerife;211930;101429;110501
38;Santa Cruz de Tenerife;039;Santa Úrsula;9943;4937;5006
38;Santa Cruz de Tenerife;040;Santiago del Teide;8069;4091;3978
38;Santa Cruz de Tenerife;041;Sauzal (El);6912;3420;3492
38;Santa Cruz de Tenerife;042;Silos (Los);5230;2589;2641
38;Santa Cruz de Tenerife;043;Tacoronte;20026;10024;10002
38;Santa Cruz de Tenerife;044;Tanque (El);3242;1623;1619
38;Santa Cruz de Tenerife;045;Tazacorte;6371;3186;3185
38;Santa Cruz de Tenerife;046;Tegueste;8744;4345;4399
38;Santa Cruz de Tenerife;047;Tijarafe;2607;1319;1288
38;Santa Cruz de Tenerife;049;Valle Gran Rey;3627;1845;1782
38;Santa Cruz de Tenerife;050;Vallehermoso;2710;1364;1346
38;Santa Cruz de Tenerife;048;Valverde;3461;1718;1743
38;Santa Cruz de Tenerife;051;Victoria de Acentejo (La);7566;3757;3809
38;Santa Cruz de Tenerife;052;Vilaflor;1506;759;747
38;Santa Cruz de Tenerife;053;Villa de Mazo;4249;2121;2128
39;Cantabria;001;Alfoz de Lloredo;2608;1332;1276
39;Cantabria;002;Ampuero;3424;1726;1698
39;Cantabria;003;Anievas;394;201;193
39;Cantabria;004;Arenas de Iguña;2085;1046;1039
39;Cantabria;005;Argoños;805;409;396
39;Cantabria;006;Arnuero;1739;876;863
39;Cantabria;007;Arredondo;645;353;292
39;Cantabria;008;Astillero (El);12920;6238;6682
39;Cantabria;009;Bárcena de Cicero;2237;1136;1101
39;Cantabria;010;Bárcena de Pie de Concha;932;450;482
39;Cantabria;011;Bareyo;1654;841;813
39;Cantabria;012;Cabezón de la Sal;7089;3496;3593
39;Cantabria;013;Cabezón de Liébana;732;399;333
39;Cantabria;014;Cabuérniga;1119;568;551
39;Cantabria;015;Camaleño;1091;567;524
39;Cantabria;016;Camargo;22788;11154;11634
39;Cantabria;027;Campoo de Enmedio;3866;1963;1903
39;Cantabria;017;Campoo de Yuso;772;379;393
39;Cantabria;018;Cartes;2804;1390;1414
39;Cantabria;019;Castañeda;1481;732;749
39;Cantabria;020;Castro-Urdiales;16795;8388;8407
39;Cantabria;021;Cieza;707;348;359
39;Cantabria;022;Cillorigo de Liébana;1135;602;533
39;Cantabria;023;Colindres;6140;3071;3069
39;Cantabria;024;Comillas;2330;1097;1233
39;Cantabria;025;Corrales de Buelna (Los);10491;5243;5248
39;Cantabria;026;Corvera de Toranzo;2141;1077;1064
39;Cantabria;028;Entrambasaguas;2446;1220;1226
39;Cantabria;029;Escalante;743;378;365
39;Cantabria;030;Guriezo;1707;895;812
39;Cantabria;031;Hazas de Cesto;1280;643;637
39;Cantabria;032;Hermandad de Campoo de Suso;1856;998;858
39;Cantabria;033;Herrerías;744;413;331
39;Cantabria;034;Lamasón;410;230;180
39;Cantabria;035;Laredo;13155;6379;6776
39;Cantabria;036;Liendo;828;427;401
39;Cantabria;037;Liérganes;2258;1098;1160
39;Cantabria;038;Limpias;1261;625;636
39;Cantabria;039;Luena;1010;528;482
39;Cantabria;040;Marina de Cudeyo;4640;2314;2326
39;Cantabria;041;Mazcuerras;1872;997;875
39;Cantabria;042;Medio Cudeyo;6030;2962;3068
39;Cantabria;043;Meruelo;1028;514;514
39;Cantabria;044;Miengo;3466;1720;1746
39;Cantabria;045;Miera;548;276;272
39;Cantabria;046;Molledo;1984;949;1035
39;Cantabria;047;Noja;1865;939;926
39;Cantabria;048;Penagos;1635;813;822
39;Cantabria;049;Peñarrubia;286;145;141
39;Cantabria;050;Pesaguero;403;212;191
39;Cantabria;051;Pesquera;100;49;51
39;Cantabria;052;Piélagos;11075;5490;5585
39;Cantabria;053;Polaciones;291;173;118
39;Cantabria;054;Polanco;3631;1760;1871
39;Cantabria;055;Potes;1579;774;805
39;Cantabria;056;Puente Viesgo;2314;1156;1158
39;Cantabria;057;Ramales de la Victoria;2239;1158;1081
39;Cantabria;058;Rasines;983;506;477
39;Cantabria;059;Reinosa;11656;5656;6000
39;Cantabria;060;Reocín;6843;3410;3433
39;Cantabria;061;Ribamontán al Mar;3457;1761;1696
39;Cantabria;062;Ribamontán al Monte;2006;1027;979
39;Cantabria;063;Rionansa;1495;830;665
39;Cantabria;064;Riotuerto;1537;740;797
39;Cantabria;065;Rozas de Valdearroyo (Las);289;149;140
39;Cantabria;066;Ruente;953;495;458
39;Cantabria;067;Ruesga;1246;641;605
39;Cantabria;068;Ruiloba;703;354;349
39;Cantabria;069;San Felices de Buelna;2176;1049;1127
39;Cantabria;070;San Miguel de Aguayo;156;82;74
39;Cantabria;071;San Pedro del Romeral;668;339;329
39;Cantabria;072;San Roque de Riomiera;527;298;229
39;Cantabria;080;San Vicente de la Barquera;4417;2248;2169
39;Cantabria;073;Santa Cruz de Bezana;7239;3596;3643
39;Cantabria;074;Santa María de Cayón;6265;3134;3131
39;Cantabria;075;Santander;184165;86385;97780
39;Cantabria;076;Santillana del Mar;3860;1901;1959
39;Cantabria;077;Santiurde de Reinosa;347;184;163
39;Cantabria;078;Santiurde de Toranzo;1675;848;827
39;Cantabria;079;Santoña;11657;5948;5709
39;Cantabria;081;Saro;534;269;265
39;Cantabria;082;Selaya;1963;990;973
39;Cantabria;083;Soba;1711;898;813
39;Cantabria;084;Solórzano;1003;513;490
39;Cantabria;085;Suances;6237;3070;3167
39;Cantabria;086;Tojos (Los);394;214;180
39;Cantabria;087;Torrelavega;57493;27730;29763
39;Cantabria;088;Tresviso;60;35;25
39;Cantabria;089;Tudanca;264;157;107
39;Cantabria;090;Udías;839;420;419
39;Cantabria;095;Val de San Vicente;2551;1293;1258
39;Cantabria;091;Valdáliga;2595;1334;1261
39;Cantabria;092;Valdeolea;1560;800;760
39;Cantabria;093;Valdeprado del Río;306;155;151
39;Cantabria;094;Valderredible;1159;609;550
39;Cantabria;096;Vega de Liébana;1035;553;482
39;Cantabria;097;Vega de Pas;1009;511;498
39;Cantabria;098;Villacarriedo;1760;929;831
39;Cantabria;099;Villaescusa;3018;1464;1554
39;Cantabria;100;Villafufre;1116;582;534
39;Cantabria;101;Villaverde de Trucíos;372;191;181
39;Cantabria;102;Voto;2230;1151;1079
40;Segovia;001;Abades;860;434;426
40;Segovia;002;Adrada de Pirón;61;34;27
40;Segovia;003;Adrados;230;116;114
40;Segovia;004;Aguilafuente;785;376;409
40;Segovia;005;Alconada de Maderuelo;59;34;25
40;Segovia;012;Aldea Real;409;218;191
40;Segovia;006;Aldealcorvo;33;16;17
40;Segovia;007;Aldealengua de Pedraza;101;57;44
40;Segovia;008;Aldealengua de Santa María;94;50;44
40;Segovia;009;Aldeanueva de la Serrezuela;57;35;22
40;Segovia;010;Aldeanueva del Codonal;216;109;107
40;Segovia;013;Aldeasoña;117;54;63
40;Segovia;014;Aldehorno;82;42;40
40;Segovia;015;Aldehuela del Codonal;59;28;31
40;Segovia;016;Aldeonte;92;46;46
40;Segovia;017;Anaya;135;68;67
40;Segovia;018;Añe;122;66;56
40;Segovia;019;Arahuetes;44;24;20
40;Segovia;020;Arcones;254;134;120
40;Segovia;021;Arevalillo de Cega;38;19;19
40;Segovia;022;Armuña;274;148;126
40;Segovia;024;Ayllón;1199;607;592
40;Segovia;025;Barbolla;231;122;109
40;Segovia;026;Basardilla;101;50;51
40;Segovia;028;Bercial;133;62;71
40;Segovia;029;Bercimuel;72;33;39
40;Segovia;030;Bernardos;753;378;375
40;Segovia;031;Bernuy de Porreros;325;169;156
40;Segovia;032;Boceguillas;575;295;280
40;Segovia;033;Brieva;69;42;27
40;Segovia;034;Caballar;102;47;55
40;Segovia;035;Cabañas de Polendos;117;60;57
40;Segovia;036;Cabezuela;732;389;343
40;Segovia;037;Calabazas de Fuentidueña;78;38;40
40;Segovia;039;Campo de San Pedro;405;228;177
40;Segovia;040;Cantalejo;3442;1742;1700
40;Segovia;041;Cantimpalos;1291;664;627
40;Segovia;043;Carbonero el Mayor;2327;1181;1146
40;Segovia;044;Carrascal del Río;214;115;99
40;Segovia;045;Casla;156;81;75
40;Segovia;046;Castillejo de Mesleón;131;66;65
40;Segovia;047;Castro de Fuentidueña;93;51;42
40;Segovia;048;Castrojimeno;49;29;20
40;Segovia;049;Castroserna de Abajo;59;35;24
40;Segovia;051;Castroserracín;57;33;24
40;Segovia;052;Cedillo de la Torre;135;68;67
40;Segovia;053;Cerezo de Abajo;177;84;93
40;Segovia;054;Cerezo de Arriba;208;108;100
40;Segovia;065;Chañe;738;390;348
40;Segovia;055;Cilleruelo de San Mamés;54;25;29
40;Segovia;056;Cobos de Fuentidueña;69;29;40
40;Segovia;057;Coca;2002;986;1016
40;Segovia;058;Codorniz;504;244;260
40;Segovia;059;Collado Hermoso;143;69;74
40;Segovia;060;Condado de Castilnovo;142;80;62
40;Segovia;061;Corral de Ayllón;111;59;52
40;Segovia;902;Cozuelos de Fuentidueña;202;104;98
40;Segovia;062;Cubillo;58;35;23
40;Segovia;063;Cuéllar;9059;4612;4447
40;Segovia;905;Cuevas de Provanco;219;117;102
40;Segovia;068;Domingo García;45;22;23
40;Segovia;069;Donhierro;109;61;48
40;Segovia;070;Duruelo;136;71;65
40;Segovia;071;Encinas;72;34;38
40;Segovia;072;Encinillas;76;43;33
40;Segovia;073;Escalona del Prado;589;309;280
40;Segovia;074;Escarabajosa de Cabezas;381;201;180
40;Segovia;075;Escobar de Polendos;227;117;110
40;Segovia;076;Espinar (El);6044;3083;2961
40;Segovia;077;Espirdo;216;123;93
40;Segovia;078;Fresneda de Cuéllar;250;133;117
40;Segovia;079;Fresno de Cantespino;242;128;114
40;Segovia;080;Fresno de la Fuente;75;39;36
40;Segovia;081;Frumales;227;117;110
40;Segovia;082;Fuente de Santa Cruz;198;98;100
40;Segovia;083;Fuente el Olmo de Fuentidueña;155;77;78
40;Segovia;084;Fuente el Olmo de Íscar;118;65;53
40;Segovia;086;Fuentepelayo;979;494;485
40;Segovia;087;Fuentepiñel;198;98;100
40;Segovia;088;Fuenterrebollo;453;235;218
40;Segovia;089;Fuentesaúco de Fuentidueña;339;178;161
40;Segovia;091;Fuentesoto;171;91;80
40;Segovia;092;Fuentidueña;185;95;90
40;Segovia;093;Gallegos;116;63;53
40;Segovia;094;Garcillán;360;188;172
40;Segovia;095;Gomezserracín;664;340;324
40;Segovia;097;Grajera;99;53;46
40;Segovia;099;Honrubia de la Cuesta;84;38;46
40;Segovia;100;Hontalbilla;452;232;220
40;Segovia;101;Hontanares de Eresma;162;88;74
40;Segovia;103;Huertos (Los);166;78;88
40;Segovia;104;Ituero y Lama;92;54;38
40;Segovia;105;Juarros de Riomoros;74;40;34
40;Segovia;106;Juarros de Voltoya;307;165;142
40;Segovia;107;Labajos;157;88;69
40;Segovia;108;Laguna de Contreras;179;97;82
40;Segovia;109;Languilla;132;78;54
40;Segovia;110;Lastras de Cuéllar;583;309;274
40;Segovia;111;Lastras del Pozo;79;41;38
40;Segovia;112;Lastrilla (La);1456;728;728
40;Segovia;113;Losa (La);380;200;180
40;Segovia;115;Maderuelo;156;81;75
40;Segovia;903;Marazoleja;158;92;66
40;Segovia;118;Marazuela;86;44;42
40;Segovia;119;Martín Miguel;207;101;106
40;Segovia;120;Martín Muñoz de la Dehesa;195;106;89
40;Segovia;121;Martín Muñoz de las Posadas;531;265;266
40;Segovia;122;Marugán;299;155;144
40;Segovia;124;Mata de Cuéllar;331;186;145
40;Segovia;123;Matabuena;218;112;106
40;Segovia;125;Matilla (La);120;63;57
40;Segovia;126;Melque de Cercos;129;62;67
40;Segovia;127;Membibre de la Hoz;80;41;39
40;Segovia;128;Migueláñez;178;87;91
40;Segovia;129;Montejo de Arévalo;305;167;138
40;Segovia;130;Montejo de la Vega de la Serrezuela;201;106;95
40;Segovia;131;Monterrubio;67;34;33
40;Segovia;132;Moral de Hornuez;112;60;52
40;Segovia;134;Mozoncillo;1037;536;501
40;Segovia;135;Muñopedro;403;205;198
40;Segovia;136;Muñoveros;206;109;97
40;Segovia;138;Nava de la Asunción;2662;1357;1305
40;Segovia;139;Navafría;381;203;178
40;Segovia;140;Navalilla;164;80;84
40;Segovia;141;Navalmanzano;1148;589;559
40;Segovia;142;Navares de Ayuso;87;44;43
40;Segovia;143;Navares de Enmedio;171;93;78
40;Segovia;144;Navares de las Cuevas;22;11;11
40;Segovia;145;Navas de Oro;1478;753;725
40;Segovia;904;Navas de Riofrío;268;130;138
40;Segovia;146;Navas de San Antonio;289;151;138
40;Segovia;148;Nieva;376;201;175
40;Segovia;149;Olombrada;821;437;384
40;Segovia;150;Orejana;117;64;53
40;Segovia;151;Ortigosa de Pestaño;86;46;40
40;Segovia;901;Ortigosa del Monte;333;168;165
40;Segovia;152;Otero de Herreros;803;387;416
40;Segovia;154;Pajarejos;47;22;25
40;Segovia;155;Palazuelos de Eresma;2681;1344;1337
40;Segovia;156;Pedraza;447;238;209
40;Segovia;157;Pelayos del Arroyo;49;24;25
40;Segovia;158;Perosillo;33;21;12
40;Segovia;159;Pinarejos;205;115;90
40;Segovia;160;Pinarnegrillo;202;102;100
40;Segovia;161;Pradales;73;38;35
40;Segovia;162;Prádena;576;307;269
40;Segovia;163;Puebla de Pedraza;89;46;43
40;Segovia;164;Rapariegos;269;136;133
40;Segovia;165;Rebollo;135;73;62
40;Segovia;166;Remondo;373;179;194
40;Segovia;168;Riaguas de San Bartolomé;79;41;38
40;Segovia;170;Riaza;1661;882;779
40;Segovia;171;Ribota;34;21;13
40;Segovia;172;Riofrío de Riaza;56;30;26
40;Segovia;173;Roda de Eresma;107;54;53
40;Segovia;174;Sacramenia;582;299;283
40;Segovia;176;Samboal;616;315;301
40;Segovia;177;San Cristóbal de Cuéllar;241;119;122
40;Segovia;178;San Cristóbal de la Vega;164;82;82
40;Segovia;906;San Cristóbal de Segovia;"";"";""
40;Segovia;181;San Ildefonso;5166;2504;2662
40;Segovia;182;San Martín y Mudrián;301;154;147
40;Segovia;183;San Miguel de Bernuy;179;91;88
40;Segovia;184;San Pedro de Gaíllos;361;180;181
40;Segovia;179;Sanchonuño;753;373;380
40;Segovia;180;Sangarcía;465;241;224
40;Segovia;185;Santa María la Real de Nieva;1496;754;742
40;Segovia;186;Santa Marta del Cerro;53;27;26
40;Segovia;188;Santiuste de Pedraza;109;61;48
40;Segovia;189;Santiuste de San Juan Bautista;776;399;377
40;Segovia;190;Santo Domingo de Pirón;58;27;31
40;Segovia;191;Santo Tomé del Puerto;334;179;155
40;Segovia;192;Sauquillo de Cabezas;256;140;116
40;Segovia;193;Sebúlcor;289;156;133
40;Segovia;194;Segovia;54012;25951;28061
40;Segovia;195;Sepúlveda;1330;685;645
40;Segovia;196;Sequera de Fresno;53;28;25
40;Segovia;198;Sotillo;46;21;25
40;Segovia;199;Sotosalbos;111;62;49
40;Segovia;200;Tabanera la Luenga;76;40;36
40;Segovia;201;Tolocirio;65;29;36
40;Segovia;206;Torre Val de San Pedro;197;107;90
40;Segovia;202;Torreadrada;140;70;70
40;Segovia;203;Torrecaballeros;456;240;216
40;Segovia;204;Torrecilla del Pinar;330;161;169
40;Segovia;205;Torreiglesias;389;204;185
40;Segovia;207;Trescasas;267;133;134
40;Segovia;208;Turégano;1113;556;557
40;Segovia;210;Urueñas;120;65;55
40;Segovia;211;Valdeprados;62;31;31
40;Segovia;212;Valdevacas de Montejo;32;19;13
40;Segovia;213;Valdevacas y Guijar;147;77;70
40;Segovia;218;Valle de Tabladillo;170;88;82
40;Segovia;219;Vallelado;856;433;423
40;Segovia;220;Valleruela de Pedraza;78;43;35
40;Segovia;221;Valleruela de Sepúlveda;79;38;41
40;Segovia;214;Valseca;310;163;147
40;Segovia;215;Valtiendas;201;111;90
40;Segovia;216;Valverde del Majano;493;255;238
40;Segovia;222;Veganzones;288;144;144
40;Segovia;223;Vegas de Matute;252;144;108
40;Segovia;224;Ventosilla y Tejadilla;29;19;10
40;Segovia;225;Villacastín;1538;781;757
40;Segovia;228;Villaverde de Íscar;756;386;370
40;Segovia;229;Villaverde de Montejo;69;37;32
40;Segovia;230;Villeguillo;133;76;57
40;Segovia;231;Yanguas de Eresma;190;93;97
40;Segovia;233;Zarzuela del Monte;532;268;264
40;Segovia;234;Zarzuela del Pinar;614;325;289
41;Sevilla;001;Aguadulce;1966;996;970
41;Sevilla;002;Alanís;2047;1024;1023
41;Sevilla;003;Albaida del Aljarafe;1814;917;897
41;Sevilla;004;Alcalá de Guadaira;56244;27852;28392
41;Sevilla;005;Alcalá del Río;9274;4720;4554
41;Sevilla;006;Alcolea del Río;3385;1662;1723
41;Sevilla;007;Algaba (La);12784;6445;6339
41;Sevilla;008;Algámitas;1377;721;656
41;Sevilla;009;Almadén de la Plata;1716;857;859
41;Sevilla;010;Almensilla;2703;1371;1332
41;Sevilla;011;Arahal;18252;9034;9218
41;Sevilla;012;Aznalcázar;3431;1721;1710
41;Sevilla;013;Aznalcóllar;5756;2932;2824
41;Sevilla;014;Badolatosa;3130;1621;1509
41;Sevilla;015;Benacazón;4937;2507;2430
41;Sevilla;016;Bollullos de la Mitación;5012;2521;2491
41;Sevilla;017;Bormujos;7521;3757;3764
41;Sevilla;018;Brenes;10509;5289;5220
41;Sevilla;019;Burguillos;3485;1740;1745
41;Sevilla;020;Cabezas de San Juan (Las);15632;8056;7576
41;Sevilla;021;Camas;25499;12416;13083
41;Sevilla;022;Campana (La);5212;2632;2580
41;Sevilla;023;Cantillana;8929;4503;4426
41;Sevilla;901;Cañada Rosal;2948;1465;1483
41;Sevilla;024;Carmona;25326;12730;12596
41;Sevilla;025;Carrión de los Céspedes;2271;1079;1192
41;Sevilla;026;Casariche;5118;2589;2529
41;Sevilla;027;Castilblanco de los Arroyos;4394;2195;2199
41;Sevilla;028;Castilleja de Guzmán;829;423;406
41;Sevilla;029;Castilleja de la Cuesta;15862;7801;8061
41;Sevilla;030;Castilleja del Campo;625;308;317
41;Sevilla;031;Castillo de las Guardas (El);1606;814;792
41;Sevilla;032;Cazalla de la Sierra;5242;2626;2616
41;Sevilla;033;Constantina;7246;3565;3681
41;Sevilla;034;Coria del Río;23517;11797;11720
41;Sevilla;035;Coripe;1560;790;770
41;Sevilla;036;Coronil (El);5140;2616;2524
41;Sevilla;037;Corrales (Los);4137;2105;2032
41;Sevilla;903;Cuervo de Sevilla (El);7625;3865;3760
41;Sevilla;038;Dos Hermanas;92506;45887;46619
41;Sevilla;039;Écija;37113;18235;18878
41;Sevilla;040;Espartinas;4408;2241;2167
41;Sevilla;041;Estepa;11654;5744;5910
41;Sevilla;042;Fuentes de Andalucía;7447;3683;3764
41;Sevilla;043;Garrobo (El);780;385;395
41;Sevilla;044;Gelves;5245;2594;2651
41;Sevilla;045;Gerena;5421;2722;2699
41;Sevilla;046;Gilena;3834;1947;1887
41;Sevilla;047;Gines;9025;4459;4566
41;Sevilla;048;Guadalcanal;3067;1516;1551
41;Sevilla;049;Guillena;8257;4189;4068
41;Sevilla;050;Herrera;5979;2949;3030
41;Sevilla;051;Huévar del Aljarafe;2283;1175;1108
41;Sevilla;052;Lantejuela (La);3488;1797;1691
41;Sevilla;053;Lebrija;23924;12102;11822
41;Sevilla;054;Lora de Estepa;752;374;378
41;Sevilla;055;Lora del Río;18855;9298;9557
41;Sevilla;056;Luisiana (La);4349;2223;2126
41;Sevilla;057;Madroño (El);376;186;190
41;Sevilla;058;Mairena del Alcor;16249;8073;8176
41;Sevilla;059;Mairena del Aljarafe;31793;15941;15852
41;Sevilla;060;Marchena;18018;8859;9159
41;Sevilla;061;Marinaleda;2616;1290;1326
41;Sevilla;062;Martín de la Jara;2802;1470;1332
41;Sevilla;063;Molares (Los);2675;1341;1334
41;Sevilla;064;Montellano;6943;3507;3436
41;Sevilla;065;Morón de la Frontera;28232;14041;14191
41;Sevilla;066;Navas de la Concepción (Las);1899;947;952
41;Sevilla;067;Olivares;7687;3888;3799
41;Sevilla;068;Osuna;17306;8548;8758
41;Sevilla;069;Palacios y Villafranca (Los);32114;16247;15867
41;Sevilla;070;Palomares del Río;3493;1775;1718
41;Sevilla;071;Paradas;6897;3463;3434
41;Sevilla;072;Pedrera;5003;2496;2507
41;Sevilla;073;Pedroso (El);2422;1193;1229
41;Sevilla;074;Peñaflor;3895;1984;1911
41;Sevilla;075;Pilas;11155;5513;5642
41;Sevilla;076;Pruna;3354;1719;1635
41;Sevilla;077;Puebla de Cazalla (La);10834;5456;5378
41;Sevilla;078;Puebla de los Infantes (La);3464;1747;1717
41;Sevilla;079;Puebla del Río (La);10660;5312;5348
41;Sevilla;080;Real de la Jara (El);1752;858;894
41;Sevilla;081;Rinconada (La);26942;13579;13363
41;Sevilla;082;Roda de Andalucía (La);4194;2074;2120
41;Sevilla;083;Ronquillo (El);1437;719;718
41;Sevilla;084;Rubio (El);3710;1864;1846
41;Sevilla;085;Salteras;2913;1448;1465
41;Sevilla;086;San Juan de Aznalfarache;20563;9934;10629
41;Sevilla;088;San Nicolás del Puerto;702;359;343
41;Sevilla;087;Sanlúcar la Mayor;10655;5272;5383
41;Sevilla;089;Santiponce;6841;3428;3413
41;Sevilla;090;Saucejo (El);4170;2086;2084
41;Sevilla;091;Sevilla;701927;335437;366490
41;Sevilla;092;Tocina;8811;4384;4427
41;Sevilla;093;Tomares;17028;8410;8618
41;Sevilla;094;Umbrete;4818;2408;2410
41;Sevilla;095;Utrera;45947;23014;22933
41;Sevilla;096;Valencina de la Concepción;6127;3088;3039
41;Sevilla;902;Villafranco del Guadalquivir;6053;3032;3021
41;Sevilla;097;Villamanrique de la Condesa;3777;1871;1906
41;Sevilla;100;Villanueva de San Juan;1571;779;792
41;Sevilla;098;Villanueva del Ariscal;4472;2172;2300
41;Sevilla;099;Villanueva del Río y Minas;5549;2675;2874
41;Sevilla;101;Villaverde del Río;6633;3378;3255
41;Sevilla;102;Viso del Alcor (El);15918;8063;7855
42;Soria;001;Abejar;358;190;168
42;Soria;003;Adradas;100;53;47
42;Soria;004;Ágreda;3399;1673;1726
42;Soria;006;Alconaba;174;100;74
42;Soria;007;Alcubilla de Avellaneda;229;116;113
42;Soria;008;Alcubilla de las Peñas;92;47;45
42;Soria;009;Aldealafuente;155;77;78
42;Soria;010;Aldealices;31;15;16
42;Soria;011;Aldealpozo;31;14;17
42;Soria;012;Aldealseñor;49;30;19
42;Soria;013;Aldehuela de Periáñez;26;17;9
42;Soria;014;Aldehuelas (Las);121;68;53
42;Soria;015;Alentisque;43;19;24
42;Soria;016;Aliud;43;20;23
42;Soria;017;Almajano;187;94;93
42;Soria;018;Almaluez;317;165;152
42;Soria;019;Almarza;632;342;290
42;Soria;020;Almazán;5871;2915;2956
42;Soria;021;Almazul;170;87;83
42;Soria;022;Almenar de Soria;393;204;189
42;Soria;023;Alpanseque;113;59;54
42;Soria;024;Arancón;112;61;51
42;Soria;025;Arcos de Jalón;1964;979;985
42;Soria;026;Arenillas;47;25;22
42;Soria;027;Arévalo de la Sierra;108;58;50
42;Soria;028;Ausejo de la Sierra;53;26;27
42;Soria;029;Baraona;246;133;113
42;Soria;030;Barca;147;85;62
42;Soria;031;Barcones;50;26;24
42;Soria;032;Bayubas de Abajo;285;151;134
42;Soria;033;Bayubas de Arriba;91;45;46
42;Soria;034;Beratón;36;29;7
42;Soria;035;Berlanga de Duero;1169;598;571
42;Soria;036;Blacos;65;37;28
42;Soria;037;Bliecos;55;31;24
42;Soria;038;Borjabad;64;34;30
42;Soria;039;Borobia;388;190;198
42;Soria;041;Buberos;50;23;27
42;Soria;042;Buitrago;49;24;25
42;Soria;043;Burgo de Osma-Ciudad de Osma;5042;2487;2555
42;Soria;044;Cabrejas del Campo;92;52;40
42;Soria;045;Cabrejas del Pinar;488;260;228
42;Soria;046;Calatañazor;75;43;32
42;Soria;048;Caltojar;137;74;63
42;Soria;049;Candilichera;226;111;115
42;Soria;050;Cañamaque;44;26;18
42;Soria;051;Carabantes;40;21;19
42;Soria;052;Caracena;22;15;7
42;Soria;053;Carrascosa de Abajo;44;22;22
42;Soria;054;Carrascosa de la Sierra;15;8;7
42;Soria;055;Casarejos;268;134;134
42;Soria;056;Castilfrío de la Sierra;32;20;12
42;Soria;058;Castillejo de Robledo;211;112;99
42;Soria;057;Castilruiz;337;169;168
42;Soria;059;Centenera de Andaluz;32;11;21
42;Soria;060;Cerbón;53;29;24
42;Soria;061;Cidones;336;184;152
42;Soria;062;Cigudosa;79;47;32
42;Soria;063;Cihuela;103;48;55
42;Soria;064;Ciria;100;46;54
42;Soria;065;Cirujales del Río;44;23;21
42;Soria;068;Coscurita;153;86;67
42;Soria;069;Covaleda;2051;1051;1000
42;Soria;070;Cubilla;80;41;39
42;Soria;071;Cubo de la Solana;261;143;118
42;Soria;073;Cueva de Ágreda;106;56;50
42;Soria;075;Dévanos;141;74;67
42;Soria;076;Deza;394;197;197
42;Soria;078;Duruelo de la Sierra;1473;740;733
42;Soria;079;Escobosa de Almazán;43;24;19
42;Soria;080;Espeja de San Marcelino;262;146;116
42;Soria;081;Espejón;234;118;116
42;Soria;082;Estepa de San Juan;15;8;7
42;Soria;083;Frechilla de Almazán;51;27;24
42;Soria;084;Fresno de Caracena;54;30;24
42;Soria;085;Fuentearmegil;366;195;171
42;Soria;086;Fuentecambrón;82;44;38
42;Soria;087;Fuentecantos;52;25;27
42;Soria;088;Fuentelmonge;145;74;71
42;Soria;089;Fuentelsaz de Soria;59;23;36
42;Soria;090;Fuentepinilla;164;88;76
42;Soria;092;Fuentes de Magaña;102;49;53
42;Soria;093;Fuentestrún;76;43;33
42;Soria;094;Garray;362;186;176
42;Soria;095;Golmayo;588;328;260
42;Soria;096;Gómara;518;260;258
42;Soria;097;Gormaz;22;11;11
42;Soria;098;Herrera de Soria;28;17;11
42;Soria;100;Hinojosa del Campo;56;34;22
42;Soria;103;Langa de Duero;949;511;438
42;Soria;105;Liceras;66;34;32
42;Soria;106;Losilla (La);21;13;8
42;Soria;107;Magaña;100;52;48
42;Soria;108;Maján;18;9;9
42;Soria;110;Matalebreras;126;62;64
42;Soria;111;Matamala de Almazán;426;214;212
42;Soria;113;Medinaceli;729;366;363
42;Soria;115;Miño de Medinaceli;121;57;64
42;Soria;116;Miño de San Esteban;97;55;42
42;Soria;117;Molinos de Duero;193;102;91
42;Soria;118;Momblona;43;25;18
42;Soria;119;Monteagudo de las Vicarías;309;151;158
42;Soria;120;Montejo de Tiermes;251;144;107
42;Soria;121;Montenegro de Cameros;118;64;54
42;Soria;123;Morón de Almazán;287;134;153
42;Soria;124;Muriel de la Fuente;81;50;31
42;Soria;125;Muriel Viejo;86;43;43
42;Soria;127;Nafría de Ucero;90;47;43
42;Soria;128;Narros;56;28;28
42;Soria;129;Navaleno;945;474;471
42;Soria;130;Nepas;86;52;34
42;Soria;131;Nolay;96;50;46
42;Soria;132;Noviercas;254;120;134
42;Soria;134;Ólvega;3283;1699;1584
42;Soria;135;Oncala;107;62;45
42;Soria;139;Pinilla del Campo;26;15;11
42;Soria;140;Portillo de Soria;23;12;11
42;Soria;141;Póveda de Soria (La);121;64;57
42;Soria;142;Pozalmuro;99;48;51
42;Soria;144;Quintana Redonda;573;303;270
42;Soria;145;Quintanas de Gormaz;197;100;97
42;Soria;148;Quiñonería;15;5;10
42;Soria;149;Rábanos (Los);408;241;167
42;Soria;151;Rebollar;49;27;22
42;Soria;152;Recuerda;113;57;56
42;Soria;153;Rello;42;20;22
42;Soria;154;Renieblas;122;62;60
42;Soria;155;Retortillo de Soria;258;137;121
42;Soria;156;Reznos;51;28;23
42;Soria;157;Riba de Escalote (La);33;20;13
42;Soria;158;Rioseco de Soria;147;74;73
42;Soria;159;Rollamienta;49;28;21
42;Soria;160;Royo (El);365;176;189
42;Soria;161;Salduero;191;102;89
42;Soria;162;San Esteban de Gormaz;3361;1716;1645
42;Soria;163;San Felices;79;40;39
42;Soria;164;San Leonardo de Yagüe;2093;1068;1025
42;Soria;165;San Pedro Manrique;475;251;224
42;Soria;166;Santa Cruz de Yanguas;56;33;23
42;Soria;167;Santa María de Huerta;471;239;232
42;Soria;168;Santa María de las Hoyas;210;110;100
42;Soria;171;Serón de Nágima;284;153;131
42;Soria;172;Soliedra;46;28;18
42;Soria;173;Soria;33882;16132;17750
42;Soria;174;Sotillo del Rincón;212;105;107
42;Soria;175;Suellacabras;41;24;17
42;Soria;176;Tajahuerce;48;23;25
42;Soria;177;Tajueco;130;68;62
42;Soria;178;Talveila;211;110;101
42;Soria;181;Tardelcuende;674;333;341
42;Soria;182;Taroda;82;41;41
42;Soria;183;Tejado;230;113;117
42;Soria;184;Torlengua;114;58;56
42;Soria;185;Torreblacos;40;20;20
42;Soria;187;Torrubia de Soria;101;56;45
42;Soria;188;Trévago;79;32;47
42;Soria;189;Ucero;112;55;57
42;Soria;190;Vadillo;154;81;73
42;Soria;191;Valdeavellano de Tera;251;125;126
42;Soria;192;Valdegeña;52;28;24
42;Soria;193;Valdelagua del Cerro;31;16;15
42;Soria;194;Valdemaluque;304;149;155
42;Soria;195;Valdenebro;161;85;76
42;Soria;196;Valdeprado;17;8;9
42;Soria;197;Valderrodilla;131;66;65
42;Soria;198;Valtajeros;28;15;13
42;Soria;200;Velamazán;150;86;64
42;Soria;201;Velilla de la Sierra;25;11;14
42;Soria;202;Velilla de los Ajos;44;27;17
42;Soria;204;Viana de Duero;79;46;33
42;Soria;205;Villaciervos;102;59;43
42;Soria;206;Villanueva de Gormaz;19;12;7
42;Soria;207;Villar del Ala;58;27;31
42;Soria;208;Villar del Campo;39;19;20
42;Soria;209;Villar del Río;186;93;93
42;Soria;211;Villares de Soria (Los);125;61;64
42;Soria;212;Villasayas;106;64;42
42;Soria;213;Villaseca de Arciel;46;26;20
42;Soria;215;Vinuesa;1092;577;515
42;Soria;216;Vizmanos;46;31;15
42;Soria;217;Vozmediano;51;27;24
42;Soria;218;Yanguas;107;52;55
42;Soria;219;Yelo;67;34;33
43;Tarragona;001;Aiguamúrcia;627;313;314
43;Tarragona;002;Albinyana;1184;603;581
43;Tarragona;003;Albiol (L');144;73;71
43;Tarragona;004;Alcanar;7711;3812;3899
43;Tarragona;005;Alcover;3664;1861;1803
43;Tarragona;904;Aldea (L');3533;1792;1741
43;Tarragona;006;Aldover;795;376;419
43;Tarragona;007;Aleixar (L');685;337;348
43;Tarragona;008;Alfara de Carles;382;201;181
43;Tarragona;009;Alforja;1179;605;574
43;Tarragona;010;Alió;355;180;175
43;Tarragona;011;Almoster;716;362;354
43;Tarragona;012;Altafulla;2778;1419;1359
43;Tarragona;013;Ametlla de Mar (L');4537;2263;2274
43;Tarragona;906;Ampolla (L');1701;840;861
43;Tarragona;014;Amposta;15951;7896;8055
43;Tarragona;016;Arboç (L');3427;1772;1655
43;Tarragona;015;Arbolí;131;65;66
43;Tarragona;017;Argentera (L');139;77;62
43;Tarragona;018;Arnes;511;266;245
43;Tarragona;019;Ascó;1711;863;848
43;Tarragona;020;Banyeres del Penedès;1595;826;769
43;Tarragona;021;Barberà de la Conca;394;198;196
43;Tarragona;022;Batea;1973;997;976
43;Tarragona;023;Bellmunt del Priorat;307;151;156
43;Tarragona;024;Bellvei;1273;673;600
43;Tarragona;025;Benifallet;886;447;439
43;Tarragona;026;Benissanet;1016;519;497
43;Tarragona;027;Bisbal de Falset (La);245;121;124
43;Tarragona;028;Bisbal del Penedès (La);1747;909;838
43;Tarragona;029;Blancafort;390;198;192
43;Tarragona;030;Bonastre;328;162;166
43;Tarragona;031;Borges del Camp (Les);1476;749;727
43;Tarragona;032;Bot;858;434;424
43;Tarragona;033;Botarell;530;264;266
43;Tarragona;034;Bràfim;567;276;291
43;Tarragona;035;Cabacés;337;177;160
43;Tarragona;036;Cabra del Camp;508;275;233
43;Tarragona;037;Calafell;10576;5338;5238
43;Tarragona;903;Camarles;2944;1463;1481
43;Tarragona;038;Cambrils;18385;9114;9271
43;Tarragona;039;Capafonts;118;61;57
43;Tarragona;040;Capçanes;411;190;221
43;Tarragona;041;Caseres;326;160;166
43;Tarragona;042;Castellvell del Camp;1088;554;534
43;Tarragona;043;Catllar (El);1945;1019;926
43;Tarragona;045;Colldejou;193;105;88
43;Tarragona;046;Conesa;107;56;51
43;Tarragona;047;Constantí;5135;2672;2463
43;Tarragona;048;Corbera d'Ebre;1070;557;513
43;Tarragona;049;Cornudella de Montsant;865;437;428
43;Tarragona;050;Creixell;1565;788;777
43;Tarragona;051;Cunit;4849;2506;2343
43;Tarragona;901;Deltebre;10164;5088;5076
43;Tarragona;053;Duesaigües;214;131;83
43;Tarragona;054;Espluga de Francolí (L');3665;1797;1868
43;Tarragona;055;Falset;2461;1236;1225
43;Tarragona;056;Fatarella (La);1276;636;640
43;Tarragona;057;Febró (La);56;32;24
43;Tarragona;058;Figuera (La);119;60;59
43;Tarragona;059;Figuerola del Camp;263;132;131
43;Tarragona;060;Flix;4316;2158;2158
43;Tarragona;061;Forès;67;32;35
43;Tarragona;062;Freginals;347;176;171
43;Tarragona;063;Galera (La);734;366;368
43;Tarragona;064;Gandesa;2646;1319;1327
43;Tarragona;065;Garcia;533;268;265
43;Tarragona;066;Garidells (Els);154;75;79
43;Tarragona;067;Ginestar;829;423;406
43;Tarragona;068;Godall;732;371;361
43;Tarragona;069;Gratallops;218;114;104
43;Tarragona;070;Guiamets (Els);298;147;151
43;Tarragona;071;Horta de Sant Joan;1245;664;581
43;Tarragona;072;Lloar (El);129;68;61
43;Tarragona;073;Llorac;119;57;62
43;Tarragona;074;Llorenç del Penedès;1460;708;752
43;Tarragona;076;Marçà;610;293;317
43;Tarragona;075;Margalef;131;69;62
43;Tarragona;077;Mas de Barberans;711;364;347
43;Tarragona;078;Masdenverge;927;472;455
43;Tarragona;079;Masllorenç;421;209;212
43;Tarragona;080;Masó (La);256;120;136
43;Tarragona;081;Maspujols;451;229;222
43;Tarragona;082;Masroig (El);524;254;270
43;Tarragona;083;Milà (El);147;70;77
43;Tarragona;084;Miravet;806;416;390
43;Tarragona;085;Molar (El);277;146;131
43;Tarragona;086;Montblanc;5901;2936;2965
43;Tarragona;088;Montbrió del Camp;1424;709;715
43;Tarragona;089;Montferri;158;83;75
43;Tarragona;090;Montmell (El);404;221;183
43;Tarragona;091;Mont-ral;137;74;63
43;Tarragona;092;Mont-roig del Camp;6197;3147;3050
43;Tarragona;093;Móra d'Ebre;4832;2403;2429
43;Tarragona;094;Móra la Nova;2703;1342;1361
43;Tarragona;095;Morell (El);2293;1145;1148
43;Tarragona;096;Morera de Montsant (La);169;93;76
43;Tarragona;097;Nou de Gaià (La);367;177;190
43;Tarragona;098;Nulles;340;157;183
43;Tarragona;100;Pallaresos (Els);2287;1187;1100
43;Tarragona;099;Palma d'Ebre (La);418;200;218
43;Tarragona;101;Passanant;182;107;75
43;Tarragona;102;Paüls;640;329;311
43;Tarragona;103;Perafort;537;274;263
43;Tarragona;104;Perelló (El);2145;1086;1059
43;Tarragona;105;Piles (Les);168;95;73
43;Tarragona;106;Pinell de Brai (El);1081;552;529
43;Tarragona;107;Pira;387;189;198
43;Tarragona;108;Pla de Santa Maria (El);1603;829;774
43;Tarragona;109;Pobla de Mafumet (La);1068;530;538
43;Tarragona;110;Pobla de Massaluca (La);436;224;212
43;Tarragona;111;Pobla de Montornès (La);1204;640;564
43;Tarragona;112;Poboleda;335;172;163
43;Tarragona;113;Pont d'Armentera (El);564;278;286
43;Tarragona;141;Pontils;137;69;68
43;Tarragona;114;Porrera;431;226;205
43;Tarragona;115;Pradell de la Teixeta;219;116;103
43;Tarragona;116;Prades;519;262;257
43;Tarragona;117;Prat de Comte;190;89;101
43;Tarragona;118;Pratdip;491;240;251
43;Tarragona;119;Puigpelat;539;274;265
43;Tarragona;120;Querol;249;140;109
43;Tarragona;121;Rasquera;805;411;394
43;Tarragona;122;Renau;55;28;27
43;Tarragona;123;Reus;89034;43545;45489
43;Tarragona;124;Riba (La);785;406;379
43;Tarragona;125;Riba-roja d'Ebre;1425;740;685
43;Tarragona;126;Riera de Gaià (La);877;439;438
43;Tarragona;127;Riudecanyes;653;327;326
43;Tarragona;128;Riudecols;1004;516;488
43;Tarragona;129;Riudoms;5068;2549;2519
43;Tarragona;130;Rocafort de Queralt;272;146;126
43;Tarragona;131;Roda de Barà;2978;1625;1353
43;Tarragona;132;Rodonyà;396;205;191
43;Tarragona;133;Roquetes;6215;3092;3123
43;Tarragona;134;Rourell (El);252;135;117
43;Tarragona;135;Salomó;383;192;191
43;Tarragona;905;Salou;11499;5816;5683
43;Tarragona;136;Sant Carles de la Ràpita;10976;5442;5534
43;Tarragona;137;Sant Jaume dels Domenys;1359;699;660
43;Tarragona;902;Sant Jaume d'Enveja;3323;1672;1651
43;Tarragona;138;Santa Bàrbara;3226;1607;1619
43;Tarragona;139;Santa Coloma de Queralt;2568;1238;1330
43;Tarragona;140;Santa Oliva;1972;996;976
43;Tarragona;142;Sarral;1403;723;680
43;Tarragona;143;Savallà del Comtat;73;36;37
43;Tarragona;144;Secuita (La);1091;543;548
43;Tarragona;145;Selva del Camp (La);3949;1987;1962
43;Tarragona;146;Senan;31;19;12
43;Tarragona;044;Sénia (La);5029;2545;2484
43;Tarragona;147;Solivella;631;304;327
43;Tarragona;148;Tarragona;112795;55158;57637
43;Tarragona;149;Tivenys;936;464;472
43;Tarragona;150;Tivissa;1763;870;893
43;Tarragona;151;Torre de Fontaubella (La);102;46;56
43;Tarragona;152;Torre de l'Espanyol (La);663;345;318
43;Tarragona;153;Torredembarra;9554;4721;4833
43;Tarragona;154;Torroja del Priorat;130;75;55
43;Tarragona;155;Tortosa;29600;14339;15261
43;Tarragona;156;Ulldecona;5208;2575;2633
43;Tarragona;157;Ulldemolins;499;259;240
43;Tarragona;158;Vallclara;105;53;52
43;Tarragona;159;Vallfogona de Riucorb;132;71;61
43;Tarragona;160;Vallmoll;1058;543;515
43;Tarragona;161;Valls;20098;9842;10256
43;Tarragona;162;Vandellòs i l'Hospitalet de l'Infant;4270;2149;2121
43;Tarragona;163;Vendrell (El);20002;9992;10010
43;Tarragona;164;Vespella de Gaià;172;97;75
43;Tarragona;165;Vilabella;818;406;412
43;Tarragona;175;Vilalba dels Arcs;774;412;362
43;Tarragona;166;Vilallonga del Camp;1205;605;600
43;Tarragona;168;Vilanova de Prades;143;77;66
43;Tarragona;167;Vilanova d'Escornalbou;463;230;233
43;Tarragona;169;Vilaplana;527;272;255
43;Tarragona;170;Vila-rodona;1008;537;471
43;Tarragona;171;Vila-seca;12498;6285;6213
43;Tarragona;172;Vilaverd;360;182;178
43;Tarragona;173;Vilella Alta (La);130;68;62
43;Tarragona;174;Vilella Baixa (La);172;91;81
43;Tarragona;176;Vimbodí i Poblet;1023;527;496
43;Tarragona;177;Vinebre;445;218;227
43;Tarragona;178;Vinyols i els Arcs;1113;580;533
43;Tarragona;052;Xerta;1218;600;618
44;Teruel;001;Ababuj;86;48;38
44;Teruel;002;Abejuela;61;37;24
44;Teruel;003;Aguatón;26;10;16
44;Teruel;004;Aguaviva;622;309;313
44;Teruel;005;Aguilar del Alfambra;84;42;42
44;Teruel;006;Alacón;470;244;226
44;Teruel;007;Alba;286;145;141
44;Teruel;008;Albalate del Arzobispo;2379;1170;1209
44;Teruel;009;Albarracín;1041;535;506
44;Teruel;010;Albentosa;272;135;137
44;Teruel;011;Alcaine;56;31;25
44;Teruel;012;Alcalá de la Selva;453;235;218
44;Teruel;013;Alcañiz;12823;6330;6493
44;Teruel;014;Alcorisa;3296;1650;1646
44;Teruel;016;Alfambra;682;348;334
44;Teruel;017;Aliaga;422;224;198
44;Teruel;021;Allepuz;144;73;71
44;Teruel;022;Alloza;817;394;423
44;Teruel;023;Allueva;14;9;5
44;Teruel;018;Almohaja;31;20;11
44;Teruel;019;Alobras;94;53;41
44;Teruel;020;Alpeñés;31;18;13
44;Teruel;024;Anadón;19;10;9
44;Teruel;025;Andorra;8174;4228;3946
44;Teruel;026;Arcos de las Salinas;163;82;81
44;Teruel;027;Arens de Lledó;240;113;127
44;Teruel;028;Argente;269;141;128
44;Teruel;029;Ariño;916;453;463
44;Teruel;031;Azaila;184;99;85
44;Teruel;032;Bádenas;25;12;13
44;Teruel;033;Báguena;524;266;258
44;Teruel;034;Bañón;180;96;84
44;Teruel;035;Barrachina;170;87;83
44;Teruel;036;Bea;46;25;21
44;Teruel;037;Beceite;654;332;322
44;Teruel;039;Bello;408;188;220
44;Teruel;038;Belmonte de San José;159;85;74
44;Teruel;040;Berge;223;117;106
44;Teruel;041;Bezas;69;35;34
44;Teruel;042;Blancas;196;104;92
44;Teruel;043;Blesa;156;93;63
44;Teruel;044;Bordón;145;79;66
44;Teruel;045;Bronchales;441;237;204
44;Teruel;046;Bueña;107;61;46
44;Teruel;047;Burbáguena;332;156;176
44;Teruel;048;Cabra de Mora;106;60;46
44;Teruel;049;Calaceite;1232;620;612
44;Teruel;050;Calamocha;4016;1997;2019
44;Teruel;051;Calanda;3531;1781;1750
44;Teruel;052;Calomarde;87;41;46
44;Teruel;053;Camañas;142;81;61
44;Teruel;054;Camarena de la Sierra;171;91;80
44;Teruel;055;Camarillas;124;69;55
44;Teruel;056;Caminreal;817;405;412
44;Teruel;059;Cantavieja;726;379;347
44;Teruel;060;Cañada de Benatanduz;65;41;24
44;Teruel;061;Cañada de Verich (La);110;61;49
44;Teruel;062;Cañada Vellida;61;40;21
44;Teruel;063;Cañizar del Olivar;128;67;61
44;Teruel;064;Cascante del Río;128;80;48
44;Teruel;065;Castejón de Tornos;109;58;51
44;Teruel;066;Castel de Cabra;183;97;86
44;Teruel;070;Castellar (El);105;55;50
44;Teruel;071;Castellote;744;379;365
44;Teruel;067;Castelnou;104;55;49
44;Teruel;068;Castelserás;870;461;409
44;Teruel;074;Cedrillas;544;282;262
44;Teruel;075;Celadas;422;227;195
44;Teruel;076;Cella;2953;1513;1440
44;Teruel;077;Cerollera (La);84;45;39
44;Teruel;080;Codoñera (La);352;180;172
44;Teruel;082;Corbalán;70;41;29
44;Teruel;084;Cortes de Aragón;134;68;66
44;Teruel;085;Cosa;106;58;48
44;Teruel;086;Cretas;631;321;310
44;Teruel;087;Crivillén;133;70;63
44;Teruel;088;Cuba (La);66;33;33
44;Teruel;089;Cubla;56;29;27
44;Teruel;090;Cucalón;80;45;35
44;Teruel;092;Cuervo (El);131;68;63
44;Teruel;093;Cuevas de Almudén;106;59;47
44;Teruel;094;Cuevas Labradas;173;94;79
44;Teruel;096;Ejulve;224;114;110
44;Teruel;097;Escorihuela;236;118;118
44;Teruel;099;Escucha;1146;611;535
44;Teruel;100;Estercuel;373;187;186
44;Teruel;101;Ferreruela de Huerva;84;46;38
44;Teruel;102;Fonfría;33;19;14
44;Teruel;103;Formiche Alto;196;108;88
44;Teruel;105;Fórnoles;101;46;55
44;Teruel;106;Fortanete;195;98;97
44;Teruel;107;Foz-Calanda;240;131;109
44;Teruel;108;Fresneda (La);418;213;205
44;Teruel;109;Frías de Albarracín;179;94;85
44;Teruel;110;Fuenferrada;50;27;23
44;Teruel;111;Fuentes Calientes;142;80;62
44;Teruel;112;Fuentes Claras;665;332;333
44;Teruel;113;Fuentes de Rubielos;86;44;42
44;Teruel;114;Fuentespalda;365;183;182
44;Teruel;115;Galve;142;75;67
44;Teruel;116;Gargallo;131;72;59
44;Teruel;117;Gea de Albarracín;473;242;231
44;Teruel;118;Ginebrosa (La);262;146;116
44;Teruel;119;Griegos;143;84;59
44;Teruel;120;Guadalaviar;288;145;143
44;Teruel;121;Gúdar;76;46;30
44;Teruel;122;Híjar;1949;976;973
44;Teruel;123;Hinojosa de Jarque;183;97;86
44;Teruel;124;Hoz de la Vieja (La);139;73;66
44;Teruel;125;Huesa del Común;136;78;58
44;Teruel;126;Iglesuela del Cid (La);486;251;235
44;Teruel;127;Jabaloyas;94;50;44
44;Teruel;128;Jarque de la Val;102;56;46
44;Teruel;129;Jatiel;70;35;35
44;Teruel;130;Jorcas;52;34;18
44;Teruel;131;Josa;45;25;20
44;Teruel;132;Lagueruela;70;37;33
44;Teruel;133;Lanzuela;30;19;11
44;Teruel;135;Libros;166;86;80
44;Teruel;136;Lidón;83;39;44
44;Teruel;137;Linares de Mora;307;171;136
44;Teruel;141;Lledó;210;112;98
44;Teruel;138;Loscos;214;113;101
44;Teruel;142;Maicas;25;13;12
44;Teruel;143;Manzanera;481;261;220
44;Teruel;144;Martín del Río;491;250;241
44;Teruel;145;Mas de las Matas;1478;750;728
44;Teruel;146;Mata de los Olmos (La);276;131;145
44;Teruel;147;Mazaleón;600;309;291
44;Teruel;148;Mezquita de Jarque;143;75;68
44;Teruel;149;Mirambel;146;82;64
44;Teruel;150;Miravete de la Sierra;51;30;21
44;Teruel;151;Molinos;342;175;167
44;Teruel;152;Monforte de Moyuela;84;49;35
44;Teruel;153;Monreal del Campo;2301;1144;1157
44;Teruel;154;Monroyo;381;204;177
44;Teruel;155;Montalbán;1594;809;785
44;Teruel;156;Monteagudo del Castillo;69;40;29
44;Teruel;157;Monterde de Albarracín;74;35;39
44;Teruel;158;Mora de Rubielos;1378;715;663
44;Teruel;159;Moscardón;56;30;26
44;Teruel;160;Mosqueruela;695;368;327
44;Teruel;161;Muniesa;745;385;360
44;Teruel;163;Noguera de Albarracín;185;93;92
44;Teruel;164;Nogueras;22;16;6
44;Teruel;165;Nogueruelas;211;113;98
44;Teruel;167;Obón;54;27;27
44;Teruel;168;Odón;265;124;141
44;Teruel;169;Ojos Negros;587;305;282
44;Teruel;171;Olba;198;101;97
44;Teruel;172;Oliete;490;249;241
44;Teruel;173;Olmos (Los);152;84;68
44;Teruel;174;Orihuela del Tremedal;612;306;306
44;Teruel;175;Orrios;194;103;91
44;Teruel;176;Palomar de Arroyos;264;151;113
44;Teruel;177;Pancrudo;183;99;84
44;Teruel;178;Parras de Castellote (Las);94;50;44
44;Teruel;179;Peñarroya de Tastavins;538;275;263
44;Teruel;180;Peracense;117;63;54
44;Teruel;181;Peralejos;96;50;46
44;Teruel;182;Perales del Alfambra;299;163;136
44;Teruel;183;Pitarque;113;55;58
44;Teruel;184;Plou;52;28;24
44;Teruel;185;Pobo (El);156;85;71
44;Teruel;187;Portellada (La);328;171;157
44;Teruel;189;Pozondón;85;44;41
44;Teruel;190;Pozuel del Campo;113;61;52
44;Teruel;191;Puebla de Híjar (La);1117;550;567
44;Teruel;192;Puebla de Valverde (La);488;254;234
44;Teruel;193;Puertomingalvo;139;74;65
44;Teruel;194;Ráfales;211;105;106
44;Teruel;195;Rillo;144;78;66
44;Teruel;196;Riodeva;228;111;117
44;Teruel;197;Ródenas;93;44;49
44;Teruel;198;Royuela;241;140;101
44;Teruel;199;Rubiales;61;34;27
44;Teruel;200;Rubielos de la Cérida;60;29;31
44;Teruel;201;Rubielos de Mora;617;311;306
44;Teruel;203;Salcedillo;8;4;4
44;Teruel;204;Saldón;43;25;18
44;Teruel;205;Samper de Calanda;1002;477;525
44;Teruel;206;San Agustín;157;82;75
44;Teruel;207;San Martín del Río;307;147;160
44;Teruel;208;Santa Cruz de Nogueras;28;17;11
44;Teruel;209;Santa Eulalia;1241;601;640
44;Teruel;210;Sarrión;1025;540;485
44;Teruel;211;Segura de los Baños;52;27;25
44;Teruel;212;Seno;53;26;27
44;Teruel;213;Singra;99;51;48
44;Teruel;215;Terriente;176;102;74
44;Teruel;216;Teruel;29320;14134;15186
44;Teruel;217;Toril y Masegoso;36;20;16
44;Teruel;218;Tormón;41;21;20
44;Teruel;219;Tornos;257;138;119
44;Teruel;220;Torralba de los Sisones;221;112;109
44;Teruel;223;Torre de Arcas;111;53;58
44;Teruel;224;Torre de las Arcas;38;22;16
44;Teruel;225;Torre del Compte;179;85;94
44;Teruel;227;Torre los Negros;95;47;48
44;Teruel;221;Torrecilla de Alcañiz;441;230;211
44;Teruel;222;Torrecilla del Rebollar;182;98;84
44;Teruel;226;Torrelacárcel;304;157;147
44;Teruel;228;Torremocha de Jiloca;171;82;89
44;Teruel;229;Torres de Albarracín;159;81;78
44;Teruel;230;Torrevelilla;205;101;104
44;Teruel;231;Torrijas;80;38;42
44;Teruel;232;Torrijo del Campo;576;293;283
44;Teruel;234;Tramacastiel;116;57;59
44;Teruel;235;Tramacastilla;135;63;72
44;Teruel;236;Tronchón;97;51;46
44;Teruel;237;Urrea de Gaén;628;309;319
44;Teruel;238;Utrillas;3329;1711;1618
44;Teruel;239;Valacloche;22;13;9
44;Teruel;240;Valbona;184;99;85
44;Teruel;241;Valdealgorfa;753;371;382
44;Teruel;243;Valdecuenca;38;21;17
44;Teruel;244;Valdelinares;129;72;57
44;Teruel;245;Valdeltormo;384;199;185
44;Teruel;246;Valderrobres;1914;985;929
44;Teruel;247;Valjunquera;443;225;218
44;Teruel;249;Vallecillo (El);43;26;17
44;Teruel;250;Veguillas de la Sierra;27;16;11
44;Teruel;251;Villafranca del Campo;407;205;202
44;Teruel;252;Villahermosa del Campo;69;40;29
44;Teruel;256;Villanueva del Rebollar de la Sierra;51;29;22
44;Teruel;257;Villar del Cobo;231;115;116
44;Teruel;258;Villar del Salz;112;60;52
44;Teruel;260;Villarluengo;205;114;91
44;Teruel;261;Villarquemado;1003;502;501
44;Teruel;262;Villarroya de los Pinares;203;100;103
44;Teruel;263;Villastar;346;185;161
44;Teruel;264;Villel;329;169;160
44;Teruel;265;Vinaceite;304;158;146
44;Teruel;266;Visiedo;212;95;117
44;Teruel;267;Vivel del Río Martín;95;52;43
44;Teruel;268;Zoma (La);33;18;15
45;Toledo;001;Ajofrín;2155;1114;1041
45;Toledo;002;Alameda de la Sagra;2823;1483;1340
45;Toledo;003;Albarreal de Tajo;605;299;306
45;Toledo;004;Alcabón;609;312;297
45;Toledo;005;Alcañizo;332;174;158
45;Toledo;006;Alcaudete de la Jara;1893;886;1007
45;Toledo;007;Alcolea de Tajo;798;396;402
45;Toledo;008;Aldea en Cabo;183;97;86
45;Toledo;009;Aldeanueva de Barbarroya;837;426;411
45;Toledo;010;Aldeanueva de San Bartolomé;623;308;315
45;Toledo;011;Almendral de la Cañada;405;211;194
45;Toledo;012;Almonacid de Toledo;785;405;380
45;Toledo;013;Almorox;2199;1129;1070
45;Toledo;014;Añover de Tajo;4608;2408;2200
45;Toledo;015;Arcicóllar;589;287;302
45;Toledo;016;Argés;2266;1116;1150
45;Toledo;017;Azután;372;190;182
45;Toledo;018;Barcience;113;57;56
45;Toledo;019;Bargas;6639;3299;3340
45;Toledo;020;Belvís de la Jara;1751;845;906
45;Toledo;021;Borox;2163;1077;1086
45;Toledo;022;Buenaventura;548;264;284
45;Toledo;023;Burguillos de Toledo;848;429;419
45;Toledo;024;Burujón;1268;654;614
45;Toledo;025;Cabañas de la Sagra;1212;625;587
45;Toledo;026;Cabañas de Yepes;258;133;125
45;Toledo;027;Cabezamesada;503;259;244
45;Toledo;028;Calera y Chozas;3767;1892;1875
45;Toledo;029;Caleruela;321;166;155
45;Toledo;030;Calzada de Oropesa;621;309;312
45;Toledo;031;Camarena;2215;1121;1094
45;Toledo;032;Camarenilla;525;263;262
45;Toledo;033;Campillo de la Jara (El);545;292;253
45;Toledo;034;Camuñas;1745;882;863
45;Toledo;035;Cardiel de los Montes;135;74;61
45;Toledo;036;Carmena;820;416;404
45;Toledo;037;Carpio de Tajo (El);2320;1134;1186
45;Toledo;038;Carranque;1434;735;699
45;Toledo;039;Carriches;296;145;151
45;Toledo;040;Casar de Escalona (El);909;447;462
45;Toledo;041;Casarrubios del Monte;2671;1374;1297
45;Toledo;042;Casasbuenas;229;114;115
45;Toledo;043;Castillo de Bayuela;1001;501;500
45;Toledo;045;Cazalegas;1161;583;578
45;Toledo;046;Cebolla;2789;1384;1405
45;Toledo;047;Cedillo del Condado;1227;603;624
45;Toledo;048;Cerralbos (Los);457;227;230
45;Toledo;049;Cervera de los Montes;406;210;196
45;Toledo;056;Chozas de Canales;1023;513;510
45;Toledo;057;Chueca;271;139;132
45;Toledo;050;Ciruelos;328;180;148
45;Toledo;051;Cobeja;1746;872;874
45;Toledo;052;Cobisa;1185;613;572
45;Toledo;053;Consuegra;10081;5000;5081
45;Toledo;054;Corral de Almaguer;5744;2877;2867
45;Toledo;055;Cuerva;1276;627;649
45;Toledo;058;Domingo Pérez;509;247;262
45;Toledo;059;Dosbarrios;2069;1036;1033
45;Toledo;060;Erustes;198;104;94
45;Toledo;061;Escalona;2072;1053;1019
45;Toledo;062;Escalonilla;1452;706;746
45;Toledo;063;Espinoso del Rey;645;333;312
45;Toledo;064;Esquivias;3800;1910;1890
45;Toledo;065;Estrella (La);433;228;205
45;Toledo;066;Fuensalida;7594;3826;3768
45;Toledo;067;Gálvez;3086;1561;1525
45;Toledo;068;Garciotum;158;73;85
45;Toledo;069;Gerindote;1835;934;901
45;Toledo;070;Guadamur;1593;820;773
45;Toledo;071;Guardia (La);2423;1199;1224
45;Toledo;072;Herencias (Las);728;374;354
45;Toledo;073;Herreruela de Oropesa;435;209;226
45;Toledo;074;Hinojosa de San Vicente;482;265;217
45;Toledo;075;Hontanar;105;58;47
45;Toledo;076;Hormigos;395;193;202
45;Toledo;077;Huecas;416;215;201
45;Toledo;078;Huerta de Valdecarábanos;1683;829;854
45;Toledo;079;Iglesuela (La);459;228;231
45;Toledo;080;Illán de Vacas;4;3;1
45;Toledo;081;Illescas;9930;4977;4953
45;Toledo;082;Lagartera;1891;922;969
45;Toledo;083;Layos;277;137;140
45;Toledo;084;Lillo;2885;1443;1442
45;Toledo;085;Lominchar;1116;579;537
45;Toledo;086;Lucillos;512;251;261
45;Toledo;087;Madridejos;10461;5153;5308
45;Toledo;088;Magán;1122;562;560
45;Toledo;089;Malpica de Tajo;1827;928;899
45;Toledo;090;Manzaneque;453;227;226
45;Toledo;091;Maqueda;496;247;249
45;Toledo;092;Marjaliza;328;161;167
45;Toledo;093;Marrupe;124;62;62
45;Toledo;094;Mascaraque;493;232;261
45;Toledo;095;Mata (La);988;486;502
45;Toledo;096;Mazarambroz;1210;600;610
45;Toledo;097;Mejorada;1091;550;541
45;Toledo;098;Menasalbas;2978;1556;1422
45;Toledo;099;Méntrida;1984;993;991
45;Toledo;100;Mesegar de Tajo;236;117;119
45;Toledo;101;Miguel Esteban;4684;2328;2356
45;Toledo;102;Mocejón;4124;2101;2023
45;Toledo;103;Mohedas de la Jara;633;324;309
45;Toledo;104;Montearagón;449;233;216
45;Toledo;105;Montesclaros;465;232;233
45;Toledo;106;Mora;9339;4596;4743
45;Toledo;107;Nambroca;2508;1259;1249
45;Toledo;108;Nava de Ricomalillo (La);742;375;367
45;Toledo;109;Navahermosa;3893;1993;1900
45;Toledo;110;Navalcán;2362;1240;1122
45;Toledo;111;Navalmoralejo;85;38;47
45;Toledo;112;Navalmorales (Los);2669;1332;1337
45;Toledo;113;Navalucillos (Los);2776;1395;1381
45;Toledo;114;Navamorcuende;735;381;354
45;Toledo;115;Noblejas;3010;1526;1484
45;Toledo;116;Noez;818;414;404
45;Toledo;117;Nombela;955;495;460
45;Toledo;118;Novés;1560;794;766
45;Toledo;119;Numancia de la Sagra;2222;1153;1069
45;Toledo;120;Nuño Gómez;176;88;88
45;Toledo;121;Ocaña;6103;3018;3085
45;Toledo;122;Olías del Rey;4125;2066;2059
45;Toledo;123;Ontígola;1175;636;539
45;Toledo;124;Orgaz;2664;1336;1328
45;Toledo;125;Oropesa;2736;1361;1375
45;Toledo;126;Otero;213;103;110
45;Toledo;127;Palomeque;485;254;231
45;Toledo;128;Pantoja;2344;1200;1144
45;Toledo;129;Paredes de Escalona;111;57;54
45;Toledo;130;Parrillas;441;217;224
45;Toledo;131;Pelahustán;374;195;179
45;Toledo;132;Pepino;821;421;400
45;Toledo;133;Polán;3294;1676;1618
45;Toledo;134;Portillo de Toledo;1942;998;944
45;Toledo;135;Puebla de Almoradiel (La);5374;2696;2678
45;Toledo;136;Puebla de Montalbán (La);6988;3489;3499
45;Toledo;137;Pueblanueva (La);2007;1021;986
45;Toledo;138;Puente del Arzobispo (El);1582;758;824
45;Toledo;139;Puerto de San Vicente;288;140;148
45;Toledo;140;Pulgar;1235;628;607
45;Toledo;141;Quero;1353;679;674
45;Toledo;142;Quintanar de la Orden;9389;4659;4730
45;Toledo;143;Quismondo;1313;656;657
45;Toledo;144;Real de San Vicente (El);1006;514;492
45;Toledo;145;Recas;2580;1345;1235
45;Toledo;146;Retamoso;174;93;81
45;Toledo;147;Rielves;493;250;243
45;Toledo;148;Robledo del Mazo;518;272;246
45;Toledo;149;Romeral (El);913;453;460
45;Toledo;150;San Bartolomé de las Abiertas;493;262;231
45;Toledo;151;San Martín de Montalbán;741;363;378
45;Toledo;152;San Martín de Pusa;797;399;398
45;Toledo;153;San Pablo de los Montes;2098;1053;1045
45;Toledo;154;San Román de los Montes;685;357;328
45;Toledo;155;Santa Ana de Pusa;399;209;190
45;Toledo;156;Santa Cruz de la Zarza;4440;2229;2211
45;Toledo;157;Santa Cruz del Retamar;1616;819;797
45;Toledo;158;Santa Olalla;2478;1261;1217
45;Toledo;901;Santo Domingo-Caudilla;791;389;402
45;Toledo;159;Sartajada;103;63;40
45;Toledo;160;Segurilla;918;463;455
45;Toledo;161;Seseña;3866;2018;1848
45;Toledo;162;Sevilleja de la Jara;1075;565;510
45;Toledo;163;Sonseca;9261;4664;4597
45;Toledo;164;Sotillo de las Palomas;226;117;109
45;Toledo;165;Talavera de la Reina;72208;35254;36954
45;Toledo;166;Tembleque;2115;1068;1047
45;Toledo;167;Toboso (El);2062;1008;1054
45;Toledo;168;Toledo;66989;32233;34756
45;Toledo;169;Torralba de Oropesa;282;135;147
45;Toledo;171;Torre de Esteban Hambrán (La);1467;754;713
45;Toledo;170;Torrecilla de la Jara;286;147;139
45;Toledo;172;Torrico;914;465;449
45;Toledo;173;Torrijos;9975;4898;5077
45;Toledo;174;Totanés;359;186;173
45;Toledo;175;Turleque;1000;501;499
45;Toledo;176;Ugena;1204;642;562
45;Toledo;177;Urda;2996;1493;1503
45;Toledo;179;Valdeverdeja;821;376;445
45;Toledo;180;Valmojado;2355;1208;1147
45;Toledo;181;Velada;2366;1223;1143
45;Toledo;182;Ventas con Peña Aguilera (Las);1411;723;688
45;Toledo;183;Ventas de Retamosa (Las);752;389;363
45;Toledo;184;Ventas de San Julián (Las);235;107;128
45;Toledo;186;Villa de Don Fadrique (La);4153;2055;2098
45;Toledo;185;Villacañas;9352;4628;4724
45;Toledo;187;Villafranca de los Caballeros;5286;2616;2670
45;Toledo;188;Villaluenga de la Sagra;2629;1318;1311
45;Toledo;189;Villamiel de Toledo;466;230;236
45;Toledo;190;Villaminaya;656;328;328
45;Toledo;191;Villamuelas;750;370;380
45;Toledo;192;Villanueva de Alcardete;3301;1657;1644
45;Toledo;193;Villanueva de Bogas;849;421;428
45;Toledo;194;Villarejo de Montalbán;97;49;48
45;Toledo;195;Villarrubia de Santiago;2901;1443;1458
45;Toledo;196;Villaseca de la Sagra;1598;804;794
45;Toledo;197;Villasequilla;2357;1223;1134
45;Toledo;198;Villatobas;2267;1142;1125
45;Toledo;199;Viso de San Juan (El);1065;563;502
45;Toledo;200;Yébenes (Los);6313;3149;3164
45;Toledo;201;Yeles;1606;847;759
45;Toledo;202;Yepes;4381;2220;2161
45;Toledo;203;Yuncler;1990;1004;986
45;Toledo;204;Yunclillos;587;298;289
45;Toledo;205;Yuncos;3421;1772;1649
46;Valencia/València;001;Ademuz;1199;601;598
46;Valencia/València;002;Ador;1125;570;555
46;Valencia/València;004;Agullent;2204;1064;1140
46;Valencia/València;042;Aielo de Malferit;3953;1949;2004
46;Valencia/València;043;Aielo de Rugat;193;101;92
46;Valencia/València;005;Alaquàs;25925;12869;13056
46;Valencia/València;006;Albaida;5782;2844;2938
46;Valencia/València;007;Albal;11239;5586;5653
46;Valencia/València;008;Albalat de la Ribera;3492;1696;1796
46;Valencia/València;009;Albalat dels Sorells;3516;1706;1810
46;Valencia/València;010;Albalat dels Tarongers;664;348;316
46;Valencia/València;011;Alberic;9131;4479;4652
46;Valencia/València;012;Alborache;897;456;441
46;Valencia/València;013;Alboraya;14628;7245;7383
46;Valencia/València;014;Albuixech;3049;1495;1554
46;Valencia/València;016;Alcàntera de Xúquer;1459;720;739
46;Valencia/València;015;Alcàsser;7375;3722;3653
46;Valencia/València;018;Alcublas;857;460;397
46;Valencia/València;020;Alcúdia de Crespins (L');4126;2038;2088
46;Valencia/València;019;Alcúdia (L');10455;5155;5300
46;Valencia/València;021;Aldaia;24094;12088;12006
46;Valencia/València;022;Alfafar;19430;9573;9857
46;Valencia/València;024;Alfara de Algimia;499;247;252
46;Valencia/València;025;Alfara del Patriarca;2726;1334;1392
46;Valencia/València;026;Alfarp;1303;636;667
46;Valencia/València;027;Alfarrasí;1225;594;631
46;Valencia/València;023;Alfauir;356;184;172
46;Valencia/València;028;Algar de Palancia;416;206;210
46;Valencia/València;029;Algemesí;24894;12283;12611
46;Valencia/València;030;Algimia de Alfara;819;409;410
46;Valencia/València;031;Alginet;12062;6009;6053
46;Valencia/València;032;Almàssera;5523;2664;2859
46;Valencia/València;033;Almiserà;240;114;126
46;Valencia/València;034;Almoines;1725;854;871
46;Valencia/València;035;Almussafes;7030;3519;3511
46;Valencia/València;036;Alpuente;958;492;466
46;Valencia/València;037;Alquería de la Condesa/Alqueria de la Comtessa (l');1457;688;769
46;Valencia/València;017;Alzira;40390;19709;20681
46;Valencia/València;038;Andilla;311;173;138
46;Valencia/València;039;Anna;2574;1293;1281
46;Valencia/València;040;Antella;1533;763;770
46;Valencia/València;041;Aras de los Olmos;397;222;175
46;Valencia/València;003;Atzeneta d'Albaida;1232;629;603
46;Valencia/València;044;Ayora;5501;2814;2687
46;Valencia/València;046;Barx;1180;570;610
46;Valencia/València;045;Barxeta;1612;814;798
46;Valencia/València;047;Bèlgida;674;325;349
46;Valencia/València;048;Bellreguard;3760;1876;1884
46;Valencia/València;049;Bellús;391;194;197
46;Valencia/València;050;Benagéber;157;86;71
46;Valencia/València;051;Benaguasil;9151;4609;4542
46;Valencia/València;052;Benavites;650;313;337
46;Valencia/València;053;Beneixida;651;309;342
46;Valencia/València;054;Benetússer;13771;6834;6937
46;Valencia/València;055;Beniarjó;1170;568;602
46;Valencia/València;056;Beniatjar;240;121;119
46;Valencia/València;057;Benicolet;489;251;238
46;Valencia/València;904;Benicull de Xúquer;"";"";""
46;Valencia/València;060;Benifaió;12120;5974;6146
46;Valencia/València;059;Benifairó de la Valldigna;1634;807;827
46;Valencia/València;058;Benifairó de les Valls;1966;973;993
46;Valencia/València;061;Beniflá;157;70;87
46;Valencia/València;062;Benigánim;5439;2767;2672
46;Valencia/València;063;Benimodo;1760;905;855
46;Valencia/València;064;Benimuslem;551;271;280
46;Valencia/València;065;Beniparrell;1578;808;770
46;Valencia/València;066;Benirredrà;1035;493;542
46;Valencia/València;067;Benisanó;1695;870;825
46;Valencia/València;068;Benissoda;298;166;132
46;Valencia/València;069;Benisuera;191;89;102
46;Valencia/València;070;Bétera;12376;6142;6234
46;Valencia/València;071;Bicorp;696;341;355
46;Valencia/València;072;Bocairent;4586;2261;2325
46;Valencia/València;073;Bolbaite;1432;729;703
46;Valencia/València;074;Bonrepòs i Mirambell;2355;1153;1202
46;Valencia/València;075;Bufali;216;104;112
46;Valencia/València;076;Bugarra;836;417;419
46;Valencia/València;077;Buñol;9358;4631;4727
46;Valencia/València;078;Burjassot;34426;16699;17727
46;Valencia/València;079;Calles;434;232;202
46;Valencia/València;080;Camporrobles;1379;699;680
46;Valencia/València;081;Canals;12857;6370;6487
46;Valencia/València;082;Canet d'En Berenguer;2244;1081;1163
46;Valencia/València;083;Carcaixent;20722;10107;10615
46;Valencia/València;084;Càrcer;2034;983;1051
46;Valencia/València;085;Carlet;14056;6879;7177
46;Valencia/València;086;Carrícola;78;37;41
46;Valencia/València;087;Casas Altas;163;87;76
46;Valencia/València;088;Casas Bajas;300;161;139
46;Valencia/València;089;Casinos;2316;1206;1110
46;Valencia/València;090;Castelló de Rugat;2052;1051;1001
46;Valencia/València;091;Castellonet de la Conquesta;147;78;69
46;Valencia/València;092;Castielfabib;536;289;247
46;Valencia/València;093;Catadau;2273;1114;1159
46;Valencia/València;094;Catarroja;20463;10052;10411
46;Valencia/València;095;Caudete de las Fuentes;812;410;402
46;Valencia/València;096;Cerdà;293;145;148
46;Valencia/València;107;Chella;2525;1247;1278
46;Valencia/València;106;Chelva;2174;1096;1078
46;Valencia/València;108;Chera;567;289;278
46;Valencia/València;109;Cheste;6834;3451;3383
46;Valencia/València;111;Chiva;9060;4525;4535
46;Valencia/València;112;Chulilla;739;365;374
46;Valencia/València;097;Cofrentes;990;487;503
46;Valencia/València;098;Corbera;3099;1491;1608
46;Valencia/València;099;Cortes de Pallás;645;337;308
46;Valencia/València;100;Cotes;372;170;202
46;Valencia/València;105;Cullera;20397;10047;10350
46;Valencia/València;113;Daimús;1438;721;717
46;Valencia/València;114;Domeño;491;253;238
46;Valencia/València;115;Dos Aguas;389;219;170
46;Valencia/València;116;Eliana (L');12067;6066;6001
46;Valencia/València;117;Emperador;192;94;98
46;Valencia/València;118;Enguera;4698;2321;2377
46;Valencia/València;119;Ènova (L');1060;538;522
46;Valencia/València;120;Estivella;1076;500;576
46;Valencia/València;121;Estubeny;142;63;79
46;Valencia/València;122;Faura;2819;1413;1406
46;Valencia/València;123;Favara;1723;830;893
46;Valencia/València;126;Foios;5265;2555;2710
46;Valencia/València;128;Font de la Figuera (La);2130;1078;1052
46;Valencia/València;127;Font d'En Carròs (La);3171;1576;1595
46;Valencia/València;124;Fontanars dels Alforins;972;504;468
46;Valencia/València;125;Fortaleny;995;508;487
46;Valencia/València;129;Fuenterrobles;719;372;347
46;Valencia/València;131;Gandia;57518;28075;29443
46;Valencia/València;902;Gátova;"";"";""
46;Valencia/València;130;Gavarda;1244;600;644
46;Valencia/València;132;Genovés;2323;1158;1165
46;Valencia/València;133;Gestalgar;660;327;333
46;Valencia/València;134;Gilet;1480;735;745
46;Valencia/València;135;Godella;10758;5257;5501
46;Valencia/València;136;Godelleta;2144;1046;1098
46;Valencia/València;137;Granja de la Costera (La);357;169;188
46;Valencia/València;138;Guadasequies;390;203;187
46;Valencia/València;139;Guadassuar;5362;2672;2690
46;Valencia/València;140;Guardamar de la Safor;70;38;32
46;Valencia/València;141;Higueruelas;559;291;268
46;Valencia/València;142;Jalance;1103;563;540
46;Valencia/València;144;Jarafuel;950;501;449
46;Valencia/València;154;Llanera de Ranes;1013;518;495
46;Valencia/València;155;Llaurí;1288;643;645
46;Valencia/València;147;Llíria;15800;7885;7915
46;Valencia/València;153;Llocnou de Sant Jeroni;555;276;279
46;Valencia/València;151;Llocnou d'En Fenollet;722;352;370
46;Valencia/València;156;Llombai;2228;1121;1107
46;Valencia/València;157;Llosa de Ranes (La);3686;1902;1784
46;Valencia/València;150;Llutxent;2378;1205;1173
46;Valencia/València;148;Loriguilla;1003;509;494
46;Valencia/València;149;Losa del Obispo;462;226;236
46;Valencia/València;152;Lugar Nuevo de la Corona;106;49;57
46;Valencia/València;158;Macastre;1000;490;510
46;Valencia/València;159;Manises;24140;11799;12341
46;Valencia/València;160;Manuel;2425;1176;1249
46;Valencia/València;161;Marines;1341;700;641
46;Valencia/València;162;Masalavés;1470;747;723
46;Valencia/València;163;Massalfassar;1351;665;686
46;Valencia/València;164;Massamagrell;12499;6157;6342
46;Valencia/València;165;Massanassa;7649;3717;3932
46;Valencia/València;166;Meliana;9163;4462;4701
46;Valencia/València;167;Millares;676;331;345
46;Valencia/València;168;Miramar;1114;542;572
46;Valencia/València;169;Mislata;40348;19710;20638
46;Valencia/València;170;Mogente/Moixent;4237;2141;2096
46;Valencia/València;171;Moncada;18404;9118;9286
46;Valencia/València;172;Monserrat;2958;1514;1444
46;Valencia/València;173;Montaverner;1662;837;825
46;Valencia/València;174;Montesa;1258;629;629
46;Valencia/València;175;Montichelvo;601;306;295
46;Valencia/València;176;Montroy;1514;771;743
46;Valencia/València;177;Museros;4161;2074;2087
46;Valencia/València;178;Náquera;2377;1193;1184
46;Valencia/València;179;Navarrés;2748;1381;1367
46;Valencia/València;180;Novelé/Novetlè;664;318;346
46;Valencia/València;181;Oliva;20577;10128;10449
46;Valencia/València;183;Olleria (L');7005;3582;3423
46;Valencia/València;182;Olocau;786;393;393
46;Valencia/València;184;Ontinyent;31343;15444;15899
46;Valencia/València;185;Otos;524;263;261
46;Valencia/València;186;Paiporta;17490;8692;8798
46;Valencia/València;187;Palma de Gandía;1520;742;778
46;Valencia/València;188;Palmera;544;271;273
46;Valencia/València;189;Palomar (El);493;244;249
46;Valencia/València;190;Paterna;46380;22933;23447
46;Valencia/València;191;Pedralba;2085;1072;1013
46;Valencia/València;192;Petrés;741;361;380
46;Valencia/València;193;Picanya;8741;4364;4377
46;Valencia/València;194;Picassent;15555;7886;7669
46;Valencia/València;195;Piles;1946;951;995
46;Valencia/València;196;Pinet;228;119;109
46;Valencia/València;199;Pobla de Farnals (La);5191;2600;2591
46;Valencia/València;202;Pobla de Vallbona (La);10563;5399;5164
46;Valencia/València;200;Pobla del Duc (La);2435;1192;1243
46;Valencia/València;203;Pobla Llarga (La);4339;2108;2231
46;Valencia/València;197;Polinyà de Xúquer;3031;1512;1519
46;Valencia/València;198;Potríes;939;462;477
46;Valencia/València;205;Puçol;13930;6827;7103
46;Valencia/València;201;Puebla de San Miguel;80;43;37
46;Valencia/València;204;Puig;7039;3458;3581
46;Valencia/València;101;Quart de les Valls;1083;516;567
46;Valencia/València;102;Quart de Poblet;26666;13152;13514
46;Valencia/València;103;Quartell;1366;670;696
46;Valencia/València;104;Quatretonda;2511;1287;1224
46;Valencia/València;206;Quesa;791;397;394
46;Valencia/València;207;Rafelbuñol/Rafelbunyol;5273;2576;2697
46;Valencia/València;208;Rafelcofer;1403;663;740
46;Valencia/València;209;Rafelguaraf;2453;1202;1251
46;Valencia/València;210;Ráfol de Salem;372;176;196
46;Valencia/València;211;Real de Gandía;1790;856;934
46;Valencia/València;212;Real ;1814;927;887
46;Valencia/València;213;Requena;18829;9459;9370
46;Valencia/València;214;Riba-roja de Túria;11671;5801;5870
46;Valencia/València;215;Riola;1584;781;803
46;Valencia/València;216;Rocafort;4629;2261;2368
46;Valencia/València;217;Rotglá y Corberá;1016;512;504
46;Valencia/València;218;Rótova;1331;673;658
46;Valencia/València;219;Rugat;194;96;98
46;Valencia/València;220;Sagunto/Sagunt;56607;27546;29061
46;Valencia/València;221;Salem;469;236;233
46;Valencia/València;903;San Antonio de Benagéber;2142;1136;1006
46;Valencia/València;222;San Juan de Énova;358;162;196
46;Valencia/València;223;Sedaví;8276;4041;4235
46;Valencia/València;224;Segart;168;78;90
46;Valencia/València;225;Sellent;479;253;226
46;Valencia/València;226;Sempere;31;17;14
46;Valencia/València;227;Senyera;920;438;482
46;Valencia/València;228;Serra;1712;860;852
46;Valencia/València;229;Siete Aguas;1062;542;520
46;Valencia/València;230;Silla;15880;8000;7880
46;Valencia/València;231;Simat de la Valldigna;3120;1584;1536
46;Valencia/València;232;Sinarcas;1270;664;606
46;Valencia/València;233;Sollana;4451;2151;2300
46;Valencia/València;234;Sot de Chera;275;140;135
46;Valencia/València;235;Sueca;24893;12226;12667
46;Valencia/València;236;Sumacàrcer;1375;691;684
46;Valencia/València;237;Tavernes Blanques;8409;4122;4287
46;Valencia/València;238;Tavernes de la Valldigna;16247;8071;8176
46;Valencia/València;239;Teresa de Cofrentes;728;369;359
46;Valencia/València;240;Terrateig;206;106;100
46;Valencia/València;241;Titaguas;554;302;252
46;Valencia/València;242;Torrebaja;450;228;222
46;Valencia/València;243;Torrella;196;98;98
46;Valencia/València;244;Torrent;62562;31017;31545
46;Valencia/València;245;Torres Torres;415;206;209
46;Valencia/València;246;Tous;1182;582;600
46;Valencia/València;247;Tuéjar;1311;687;624
46;Valencia/València;248;Turís;4560;2337;2223
46;Valencia/València;249;Utiel;11843;5887;5956
46;Valencia/València;250;Valencia;739412;351211;388201
46;Valencia/València;251;Vallada;2972;1496;1476
46;Valencia/València;252;Vallanca;236;113;123
46;Valencia/València;253;Vallés;101;55;46
46;Valencia/València;254;Venta del Moro;1601;814;787
46;Valencia/València;256;Vilamarxant;5813;2948;2865
46;Valencia/València;255;Villalonga;3649;1823;1826
46;Valencia/València;257;Villanueva de Castellón;7030;3478;3552
46;Valencia/València;258;Villar del Arzobispo;3494;1745;1749
46;Valencia/València;259;Villargordo del Cabriel;694;355;339
46;Valencia/València;260;Vinalesa;2295;1091;1204
46;Valencia/València;145;Xàtiva;24878;12077;12801
46;Valencia/València;143;Xeraco;4754;2355;2399
46;Valencia/València;146;Xeresa;1878;950;928
46;Valencia/València;110;Xirivella;25947;12831;13116
46;Valencia/València;261;Yátova;2013;1046;967
46;Valencia/València;262;Yesa (La);287;144;143
46;Valencia/València;263;Zarra;416;220;196
47;Valladolid;001;Adalia;87;44;43
47;Valladolid;002;Aguasal;25;13;12
47;Valladolid;003;Aguilar de Campos;380;200;180
47;Valladolid;004;Alaejos;1677;868;809
47;Valladolid;005;Alcazarén;721;385;336
47;Valladolid;006;Aldea de San Miguel;231;116;115
47;Valladolid;007;Aldeamayor de San Martín;1364;692;672
47;Valladolid;008;Almenara de Adaja;26;13;13
47;Valladolid;009;Amusquillo;183;98;85
47;Valladolid;010;Arroyo de la Encomienda;2609;1348;1261
47;Valladolid;011;Ataquines;895;467;428
47;Valladolid;012;Bahabón;206;101;105
47;Valladolid;013;Barcial de la Loma;168;84;84
47;Valladolid;014;Barruelo del Valle;75;40;35
47;Valladolid;015;Becilla de Valderaduey;442;235;207
47;Valladolid;016;Benafarces;113;55;58
47;Valladolid;017;Bercero;292;154;138
47;Valladolid;018;Berceruelo;44;23;21
47;Valladolid;019;Berrueces;100;56;44
47;Valladolid;020;Bobadilla del Campo;407;210;197
47;Valladolid;021;Bocigas;151;74;77
47;Valladolid;022;Bocos de Duero;77;33;44
47;Valladolid;023;Boecillo;1429;740;689
47;Valladolid;024;Bolaños de Campos;386;198;188
47;Valladolid;025;Brahojos de Medina;185;105;80
47;Valladolid;026;Bustillo de Chaves;97;47;50
47;Valladolid;027;Cabezón de Pisuerga;1757;900;857
47;Valladolid;028;Cabezón de Valderaduey;59;33;26
47;Valladolid;029;Cabreros del Monte;99;55;44
47;Valladolid;030;Campaspero;1504;778;726
47;Valladolid;031;Campillo (El);251;142;109
47;Valladolid;032;Camporredondo;213;119;94
47;Valladolid;033;Canalejas de Peñafiel;299;150;149
47;Valladolid;034;Canillas de Esgueva;137;73;64
47;Valladolid;035;Carpio;1226;647;579
47;Valladolid;036;Casasola de Arión;386;210;176
47;Valladolid;037;Castrejón de Trabancos;277;147;130
47;Valladolid;038;Castrillo de Duero;217;104;113
47;Valladolid;039;Castrillo-Tejeriego;279;145;134
47;Valladolid;040;Castrobol;89;41;48
47;Valladolid;041;Castrodeza;247;135;112
47;Valladolid;042;Castromembibre;90;47;43
47;Valladolid;043;Castromonte;464;238;226
47;Valladolid;044;Castronuevo de Esgueva;304;161;143
47;Valladolid;045;Castronuño;1097;552;545
47;Valladolid;046;Castroponce;207;107;100
47;Valladolid;047;Castroverde de Cerrato;271;156;115
47;Valladolid;048;Ceinos de Campos;275;147;128
47;Valladolid;049;Cervillego de la Cruz;156;80;76
47;Valladolid;050;Cigales;2772;1338;1434
47;Valladolid;051;Ciguñuela;379;199;180
47;Valladolid;052;Cistérniga;2725;1421;1304
47;Valladolid;053;Cogeces de Íscar;154;81;73
47;Valladolid;054;Cogeces del Monte;971;523;448
47;Valladolid;055;Corcos;272;140;132
47;Valladolid;056;Corrales de Duero;141;83;58
47;Valladolid;057;Cubillas de Santa Marta;272;149;123
47;Valladolid;058;Cuenca de Campos;303;150;153
47;Valladolid;059;Curiel de Duero;126;71;55
47;Valladolid;060;Encinas de Esgueva;390;208;182
47;Valladolid;061;Esguevillas de Esgueva;436;222;214
47;Valladolid;062;Fombellida;297;150;147
47;Valladolid;063;Fompedraza;145;79;66
47;Valladolid;064;Fontihoyuelo;47;29;18
47;Valladolid;065;Fresno el Viejo;1301;668;633
47;Valladolid;066;Fuensaldaña;951;454;497
47;Valladolid;067;Fuente el Sol;311;161;150
47;Valladolid;068;Fuente-Olmedo;67;35;32
47;Valladolid;069;Gallegos de Hornija;154;77;77
47;Valladolid;070;Gatón de Campos;45;28;17
47;Valladolid;071;Geria;473;254;219
47;Valladolid;073;Herrín de Campos;217;102;115
47;Valladolid;074;Hornillos de Eresma;151;79;72
47;Valladolid;075;Íscar;6125;3080;3045
47;Valladolid;076;Laguna de Duero;14915;7537;7378
47;Valladolid;077;Langayo;473;250;223
47;Valladolid;079;Llano de Olmedo;104;54;50
47;Valladolid;078;Lomoviejo;262;128;134
47;Valladolid;080;Manzanillo;71;36;35
47;Valladolid;081;Marzales;77;38;39
47;Valladolid;082;Matapozuelos;1001;505;496
47;Valladolid;083;Matilla de los Caños;94;55;39
47;Valladolid;084;Mayorga;1720;824;896
47;Valladolid;086;Medina de Rioseco;5001;2445;2556
47;Valladolid;085;Medina del Campo;20023;9842;10181
47;Valladolid;087;Megeces;471;232;239
47;Valladolid;088;Melgar de Abajo;187;95;92
47;Valladolid;089;Melgar de Arriba;307;153;154
47;Valladolid;090;Mojados;2443;1223;1220
47;Valladolid;091;Monasterio de Vega;89;47;42
47;Valladolid;092;Montealegre de Campos;176;98;78
47;Valladolid;093;Montemayor de Pililla;1054;554;500
47;Valladolid;094;Moral de la Reina;240;121;119
47;Valladolid;095;Moraleja de las Panaderas;31;19;12
47;Valladolid;096;Morales de Campos;200;100;100
47;Valladolid;097;Mota del Marqués;450;213;237
47;Valladolid;098;Mucientes;618;310;308
47;Valladolid;099;Mudarra (La);274;148;126
47;Valladolid;100;Muriel;222;109;113
47;Valladolid;101;Nava del Rey;2287;1116;1171
47;Valladolid;102;Nueva Villa de las Torres;421;233;188
47;Valladolid;103;Olivares de Duero;349;191;158
47;Valladolid;104;Olmedo;3502;1698;1804
47;Valladolid;105;Olmos de Esgueva;189;105;84
47;Valladolid;106;Olmos de Peñafiel;90;46;44
47;Valladolid;109;Palazuelo de Vedija;248;129;119
47;Valladolid;110;Parrilla (La);658;318;340
47;Valladolid;111;Pedraja de Portillo (La);1117;561;556
47;Valladolid;112;Pedrajas de San Esteban;3227;1635;1592
47;Valladolid;113;Pedrosa del Rey;243;131;112
47;Valladolid;114;Peñafiel;5132;2584;2548
47;Valladolid;115;Peñaflor de Hornija;476;255;221
47;Valladolid;116;Pesquera de Duero;535;286;249
47;Valladolid;117;Piña de Esgueva;417;216;201
47;Valladolid;118;Piñel de Abajo;217;113;104
47;Valladolid;119;Piñel de Arriba;156;76;80
47;Valladolid;121;Pollos;827;425;402
47;Valladolid;122;Portillo;2549;1293;1256
47;Valladolid;123;Pozal de Gallinas;502;264;238
47;Valladolid;124;Pozaldez;524;258;266
47;Valladolid;125;Pozuelo de la Orden;78;44;34
47;Valladolid;126;Puras;59;28;31
47;Valladolid;127;Quintanilla de Arriba;229;122;107
47;Valladolid;129;Quintanilla de Onésimo;1145;603;542
47;Valladolid;130;Quintanilla de Trigueros;97;50;47
47;Valladolid;128;Quintanilla del Molar;83;34;49
47;Valladolid;131;Rábano;253;127;126
47;Valladolid;132;Ramiro;83;47;36
47;Valladolid;133;Renedo de Esgueva;961;495;466
47;Valladolid;134;Roales de Campos;261;132;129
47;Valladolid;135;Robladillo;107;53;54
47;Valladolid;137;Roturas;28;16;12
47;Valladolid;138;Rubí de Bracamonte;352;184;168
47;Valladolid;139;Rueda;1495;764;731
47;Valladolid;140;Saelices de Mayorga;195;101;94
47;Valladolid;141;Salvador de Zapardiel;207;112;95
47;Valladolid;142;San Cebrián de Mazote;239;129;110
47;Valladolid;143;San Llorente;211;112;99
47;Valladolid;144;San Martín de Valvení;119;69;50
47;Valladolid;145;San Miguel del Arroyo;817;426;391
47;Valladolid;146;San Miguel del Pino;231;124;107
47;Valladolid;147;San Pablo de la Moraleja;194;106;88
47;Valladolid;148;San Pedro de Latarce;666;359;307
47;Valladolid;149;San Pelayo;39;20;19
47;Valladolid;150;San Román de Hornija;458;226;232
47;Valladolid;151;San Salvador;52;27;25
47;Valladolid;156;San Vicente del Palacio;255;132;123
47;Valladolid;152;Santa Eufemia del Arroyo;135;66;69
47;Valladolid;153;Santervás de Campos;172;91;81
47;Valladolid;154;Santibáñez de Valcorba;241;128;113
47;Valladolid;155;Santovenia de Pisuerga;1930;972;958
47;Valladolid;157;Sardón de Duero;641;328;313
47;Valladolid;158;Seca (La);1066;576;490
47;Valladolid;159;Serrada;1027;526;501
47;Valladolid;160;Siete Iglesias de Trabancos;641;332;309
47;Valladolid;161;Simancas;3038;1552;1486
47;Valladolid;162;Tamariz de Campos;108;57;51
47;Valladolid;163;Tiedra;409;201;208
47;Valladolid;164;Tordehumos;569;289;280
47;Valladolid;165;Tordesillas;7999;4045;3954
47;Valladolid;169;Torre de Esgueva;113;57;56
47;Valladolid;170;Torre de Peñafiel;45;26;19
47;Valladolid;166;Torrecilla de la Abadesa;389;201;188
47;Valladolid;167;Torrecilla de la Orden;385;191;194
47;Valladolid;168;Torrecilla de la Torre;39;23;16
47;Valladolid;171;Torrelobatón;582;284;298
47;Valladolid;172;Torrescárcela;178;94;84
47;Valladolid;173;Traspinedo;821;419;402
47;Valladolid;174;Trigueros del Valle;279;142;137
47;Valladolid;175;Tudela de Duero;6010;3096;2914
47;Valladolid;176;Unión de Campos (La);318;156;162
47;Valladolid;177;Urones de Castroponce;157;88;69
47;Valladolid;178;Urueña;204;101;103
47;Valladolid;179;Valbuena de Duero;529;276;253
47;Valladolid;180;Valdearcos de la Vega;151;75;76
47;Valladolid;181;Valdenebro de los Valles;244;125;119
47;Valladolid;182;Valdestillas;1563;790;773
47;Valladolid;183;Valdunquillo;235;110;125
47;Valladolid;186;Valladolid;319946;154066;165880
47;Valladolid;184;Valoria la Buena;651;339;312
47;Valladolid;185;Valverde de Campos;117;62;55
47;Valladolid;187;Vega de Ruiponce;146;70;76
47;Valladolid;188;Vega de Valdetronco;196;104;92
47;Valladolid;189;Velascálvaro;197;102;95
47;Valladolid;190;Velilla;155;81;74
47;Valladolid;191;Velliza;167;95;72
47;Valladolid;192;Ventosa de la Cuesta;164;88;76
47;Valladolid;193;Viana de Cega;1404;712;692
47;Valladolid;195;Villabáñez;494;264;230
47;Valladolid;196;Villabaruz de Campos;56;27;29
47;Valladolid;197;Villabrágima;1234;637;597
47;Valladolid;198;Villacarralón;118;59;59
47;Valladolid;199;Villacid de Campos;112;60;52
47;Valladolid;200;Villaco;136;80;56
47;Valladolid;203;Villafrades de Campos;117;53;64
47;Valladolid;204;Villafranca de Duero;389;196;193
47;Valladolid;205;Villafrechós;532;273;259
47;Valladolid;206;Villafuerte;155;75;80
47;Valladolid;207;Villagarcía de Campos;453;243;210
47;Valladolid;208;Villagómez la Nueva;106;49;57
47;Valladolid;209;Villalán de Campos;58;27;31
47;Valladolid;210;Villalar de los Comuneros;502;242;260
47;Valladolid;211;Villalba de la Loma;48;26;22
47;Valladolid;212;Villalba de los Alcores;566;297;269
47;Valladolid;213;Villalbarba;173;85;88
47;Valladolid;214;Villalón de Campos;2168;1050;1118
47;Valladolid;215;Villamuriel de Campos;97;48;49
47;Valladolid;216;Villán de Tordesillas;188;93;95
47;Valladolid;217;Villanubla;921;480;441
47;Valladolid;218;Villanueva de Duero;957;490;467
47;Valladolid;219;Villanueva de la Condesa;44;26;18
47;Valladolid;220;Villanueva de los Caballeros;286;137;149
47;Valladolid;221;Villanueva de los Infantes;155;81;74
47;Valladolid;222;Villanueva de San Mancio;106;58;48
47;Valladolid;223;Villardefrades;239;122;117
47;Valladolid;224;Villarmentero de Esgueva;136;68;68
47;Valladolid;225;Villasexmir;125;65;60
47;Valladolid;226;Villavaquerín;231;122;109
47;Valladolid;227;Villavellid;72;39;33
47;Valladolid;228;Villaverde de Medina;595;320;275
47;Valladolid;229;Villavicencio de los Caballeros;336;153;183
47;Valladolid;194;Viloria;385;206;179
47;Valladolid;230;Wamba;388;209;179
47;Valladolid;231;Zaratán;1243;644;599
47;Valladolid;232;Zarza (La);165;84;81
48;Vizcaya;001;Abadiño;6820;3420;3400
48;Vizcaya;002;Abanto y Ciérvana-Abanto Zierbena;8812;4364;4448
48;Vizcaya;911;Ajangiz;401;203;198
48;Vizcaya;912;Alonsotegi;2829;1376;1453
48;Vizcaya;003;Amorebieta-Etxano;16207;8105;8102
48;Vizcaya;004;Amoroto;370;196;174
48;Vizcaya;005;Arakaldo;92;53;39
48;Vizcaya;006;Arantzazu;270;129;141
48;Vizcaya;093;Areatza;1049;468;581
48;Vizcaya;009;Arrankudiaga;740;356;384
48;Vizcaya;914;Arratzu;390;194;196
48;Vizcaya;010;Arrieta;472;233;239
48;Vizcaya;011;Arrigorriaga;10502;5167;5335
48;Vizcaya;023;Artea;595;283;312
48;Vizcaya;008;Artzentales;644;350;294
48;Vizcaya;091;Atxondo;1488;745;743
48;Vizcaya;070;Aulesti;643;333;310
48;Vizcaya;012;Bakio;1490;756;734
48;Vizcaya;090;Balmaseda;7106;3419;3687
48;Vizcaya;013;Barakaldo;98649;48261;50388
48;Vizcaya;014;Barrika;1076;546;530
48;Vizcaya;015;Basauri;48107;23824;24283
48;Vizcaya;092;Bedia;988;498;490
48;Vizcaya;016;Berango;4690;2329;2361
48;Vizcaya;017;Bermeo;16989;8336;8653
48;Vizcaya;018;Berriatua;955;493;462
48;Vizcaya;019;Berriz;4113;2072;2041
48;Vizcaya;020;Bilbao;358467;170187;188280
48;Vizcaya;021;Busturia;1667;838;829
48;Vizcaya;901;Derio;4666;2306;2360
48;Vizcaya;026;Dima;1050;534;516
48;Vizcaya;027;Durango;24260;11898;12362
48;Vizcaya;028;Ea;813;392;421
48;Vizcaya;031;Elantxobe;484;212;272
48;Vizcaya;032;Elorrio;7233;3629;3604
48;Vizcaya;902;Erandio;23207;11405;11802
48;Vizcaya;033;Ereño;266;133;133
48;Vizcaya;034;Ermua;17334;8838;8496
48;Vizcaya;079;Errigoiti;452;255;197
48;Vizcaya;029;Etxebarri, Anteiglesia de San Esteban-Etxebarri Doneztebeko Elizatea;6438;3259;3179
48;Vizcaya;030;Etxebarria;793;409;384
48;Vizcaya;906;Forua;979;494;485
48;Vizcaya;035;Fruiz;314;155;159
48;Vizcaya;036;Galdakao;29418;14594;14824
48;Vizcaya;037;Galdames;780;403;377
48;Vizcaya;038;Gamiz-Fika;1022;520;502
48;Vizcaya;039;Garay;240;120;120
48;Vizcaya;040;Gatika;1177;601;576
48;Vizcaya;041;Gautegiz Arteaga;811;402;409
48;Vizcaya;046;Gernika-Lumo;15485;7523;7962
48;Vizcaya;044;Getxo;82974;39706;43268
48;Vizcaya;047;Gizaburuaga;131;65;66
48;Vizcaya;042;Gordexola;1463;723;740
48;Vizcaya;043;Gorliz;3808;1899;1909
48;Vizcaya;045;Güeñes;5870;2900;2970
48;Vizcaya;048;Ibarrangelu;517;246;271
48;Vizcaya;094;Igorre;3940;1976;1964
48;Vizcaya;049;Ispaster;615;325;290
48;Vizcaya;910;Iurreta;4420;2190;2230
48;Vizcaya;050;Izurtza;273;138;135
48;Vizcaya;022;Karrantza Harana/Valle de Carranza;3081;1622;1459
48;Vizcaya;907;Kortezubi;357;190;167
48;Vizcaya;051;Lanestosa;296;151;145
48;Vizcaya;052;Larrabetzu;1552;779;773
48;Vizcaya;053;Laukiz;919;474;445
48;Vizcaya;054;Leioa;27308;13499;13809
48;Vizcaya;057;Lekeitio;7466;3680;3786
48;Vizcaya;055;Lemoa;2466;1222;1244
48;Vizcaya;056;Lemoiz;877;458;419
48;Vizcaya;081;Lezama;2053;1030;1023
48;Vizcaya;903;Loiu;1661;854;807
48;Vizcaya;058;Mallabia;1079;570;509
48;Vizcaya;059;Mañaria;476;251;225
48;Vizcaya;060;Markina-Xemein;4692;2333;2359
48;Vizcaya;061;Maruri-Jatabe;582;286;296
48;Vizcaya;062;Mendata;322;175;147
48;Vizcaya;063;Mendexa;341;181;160
48;Vizcaya;064;Meñaka;476;244;232
48;Vizcaya;066;Morga;381;206;175
48;Vizcaya;068;Mundaka;1783;836;947
48;Vizcaya;069;Mungia;13216;6499;6717
48;Vizcaya;007;Munitibar-Arbatzegi Gerrikaitz;394;212;182
48;Vizcaya;908;Murueta;221;117;104
48;Vizcaya;071;Muskiz;6123;3003;3120
48;Vizcaya;067;Muxika;1387;716;671
48;Vizcaya;909;Nabarniz;236;114;122
48;Vizcaya;073;Ondarroa;10114;5069;5045
48;Vizcaya;075;Orozko;1922;962;960
48;Vizcaya;083;Ortuella;8778;4286;4492
48;Vizcaya;072;Otxandio;1018;534;484
48;Vizcaya;077;Plentzia;3286;1585;1701
48;Vizcaya;078;Portugalete;53498;26196;27302
48;Vizcaya;082;Santurtzi;48962;24033;24929
48;Vizcaya;084;Sestao;33732;16435;17297
48;Vizcaya;904;Sondika;3694;1773;1921
48;Vizcaya;085;Sopelana;9815;4885;4930
48;Vizcaya;086;Sopuerta;2271;1146;1125
48;Vizcaya;076;Sukarrieta;330;168;162
48;Vizcaya;087;Trucios-Turtzioz;530;265;265
48;Vizcaya;088;Ubide;163;81;82
48;Vizcaya;065;Ugao-Miraballes;4150;2084;2066
48;Vizcaya;089;Urduliz;2825;1403;1422
48;Vizcaya;074;Urduña-Orduña;3882;1979;1903
48;Vizcaya;080;Valle de Trápaga-Trapagaran;12673;6239;6434
48;Vizcaya;095;Zaldibar;2944;1413;1531
48;Vizcaya;096;Zalla;7582;3738;3844
48;Vizcaya;905;Zamudio;2953;1482;1471
48;Vizcaya;097;Zaratamo;1614;820;794
48;Vizcaya;024;Zeanuri;1160;600;560
48;Vizcaya;025;Zeberio;929;482;447
48;Vizcaya;913;Zierbena;1170;617;553
48;Vizcaya;915;Ziortza-Bolibar;"";"";""
49;Zamora;002;Abezames;115;58;57
49;Zamora;003;Alcañices;1205;595;610
49;Zamora;004;Alcubilla de Nogales;214;103;111
49;Zamora;005;Alfaraz de Sayago;222;118;104
49;Zamora;006;Algodre;217;112;105
49;Zamora;007;Almaraz de Duero;484;240;244
49;Zamora;008;Almeida de Sayago;683;348;335
49;Zamora;009;Andavías;514;251;263
49;Zamora;010;Arcenillas;286;144;142
49;Zamora;011;Arcos de la Polvorosa;309;164;145
49;Zamora;012;Argañín;110;47;63
49;Zamora;013;Argujillo;394;209;185
49;Zamora;014;Arquillinos;199;102;97
49;Zamora;015;Arrabalde;402;193;209
49;Zamora;016;Aspariegos;392;191;201
49;Zamora;017;Asturianos;355;176;179
49;Zamora;018;Ayoó de Vidriales;498;244;254
49;Zamora;019;Barcial del Barco;306;171;135
49;Zamora;020;Belver de los Montes;515;269;246
49;Zamora;021;Benavente;16272;7917;8355
49;Zamora;022;Benegiles;433;228;205
49;Zamora;023;Bermillo de Sayago;1526;795;731
49;Zamora;024;Bóveda de Toro (La);1011;513;498
49;Zamora;025;Bretó;263;138;125
49;Zamora;026;Bretocino;334;181;153
49;Zamora;027;Brime de Sog;263;122;141
49;Zamora;028;Brime de Urz;167;92;75
49;Zamora;029;Burganes de Valverde;915;472;443
49;Zamora;030;Bustillo del Oro;164;84;80
49;Zamora;031;Cabañas de Sayago;197;92;105
49;Zamora;032;Calzadilla de Tera;528;252;276
49;Zamora;033;Camarzana de Tera;1083;541;542
49;Zamora;034;Cañizal;643;344;299
49;Zamora;035;Cañizo;334;169;165
49;Zamora;036;Carbajales de Alba;707;343;364
49;Zamora;037;Carbellino;277;139;138
49;Zamora;038;Casaseca de Campeán;164;86;78
49;Zamora;039;Casaseca de las Chanas;369;185;184
49;Zamora;040;Castrillo de la Guareña;172;85;87
49;Zamora;041;Castrogonzalo;538;288;250
49;Zamora;042;Castronuevo;352;179;173
49;Zamora;043;Castroverde de Campos;428;214;214
49;Zamora;044;Cazurra;102;56;46
49;Zamora;046;Cerecinos de Campos;436;225;211
49;Zamora;047;Cerecinos del Carrizal;165;89;76
49;Zamora;048;Cernadilla;166;78;88
49;Zamora;050;Cobreros;851;424;427
49;Zamora;052;Coomonte;346;180;166
49;Zamora;053;Coreses;1213;621;592
49;Zamora;054;Corrales;1186;568;618
49;Zamora;055;Cotanes del Monte;177;93;84
49;Zamora;056;Cubillos;402;202;200
49;Zamora;057;Cubo de Benavente;192;104;88
49;Zamora;058;Cubo de Tierra del Vino (El);484;247;237
49;Zamora;059;Cuelgamures;147;80;67
49;Zamora;061;Entrala;164;85;79
49;Zamora;062;Espadañedo;222;112;110
49;Zamora;063;Faramontanos de Tábara;501;251;250
49;Zamora;064;Fariza;727;367;360
49;Zamora;065;Fermoselle;1686;840;846
49;Zamora;066;Ferreras de Abajo;632;307;325
49;Zamora;067;Ferreras de Arriba;544;279;265
49;Zamora;068;Ferreruela;690;361;329
49;Zamora;069;Figueruela de Arriba;571;278;293
49;Zamora;071;Fonfría;1191;603;588
49;Zamora;075;Fresno de la Polvorosa;224;105;119
49;Zamora;076;Fresno de la Ribera;434;237;197
49;Zamora;077;Fresno de Sayago;287;145;142
49;Zamora;078;Friera de Valverde;292;150;142
49;Zamora;079;Fuente Encalada;160;81;79
49;Zamora;080;Fuentelapeña;1064;544;520
49;Zamora;082;Fuentes de Ropel;608;316;292
49;Zamora;081;Fuentesaúco;1858;932;926
49;Zamora;083;Fuentesecas;88;42;46
49;Zamora;084;Fuentespreadas;428;236;192
49;Zamora;085;Galende;1379;677;702
49;Zamora;086;Gallegos del Pan;174;90;84
49;Zamora;087;Gallegos del Río;898;472;426
49;Zamora;088;Gamones;104;59;45
49;Zamora;090;Gema;284;141;143
49;Zamora;091;Granja de Moreruela;394;190;204
49;Zamora;092;Granucillo;276;138;138
49;Zamora;093;Guarrate;389;213;176
49;Zamora;094;Hermisende;460;246;214
49;Zamora;095;Hiniesta (La);391;188;203
49;Zamora;096;Jambrina;277;136;141
49;Zamora;097;Justel;188;99;89
49;Zamora;098;Losacino;373;201;172
49;Zamora;099;Losacio;175;93;82
49;Zamora;100;Lubián;405;197;208
49;Zamora;101;Luelmo;265;136;129
49;Zamora;102;Maderal (El);313;161;152
49;Zamora;103;Madridanos;573;288;285
49;Zamora;104;Mahide;584;300;284
49;Zamora;105;Maire de Castroponce;251;129;122
49;Zamora;107;Malva;237;119;118
49;Zamora;108;Manganeses de la Lampreana;815;412;403
49;Zamora;109;Manganeses de la Polvorosa;887;441;446
49;Zamora;110;Manzanal de Arriba;477;239;238
49;Zamora;112;Manzanal de los Infantes;184;98;86
49;Zamora;111;Manzanal del Barco;207;110;97
49;Zamora;113;Matilla de Arzón;274;149;125
49;Zamora;114;Matilla la Seca;69;35;34
49;Zamora;115;Mayalde;243;123;120
49;Zamora;116;Melgar de Tera;610;303;307
49;Zamora;117;Micereces de Tera;667;340;327
49;Zamora;118;Milles de la Polvorosa;293;143;150
49;Zamora;119;Molacillos;307;161;146
49;Zamora;120;Molezuelas de la Carballeda;118;58;60
49;Zamora;121;Mombuey;481;238;243
49;Zamora;122;Monfarracinos;590;313;277
49;Zamora;123;Montamarta;718;344;374
49;Zamora;124;Moral de Sayago;401;215;186
49;Zamora;126;Moraleja de Sayago;299;161;138
49;Zamora;125;Moraleja del Vino;1276;667;609
49;Zamora;128;Morales de Rey;777;376;401
49;Zamora;129;Morales de Toro;1123;569;554
49;Zamora;130;Morales de Valverde;319;154;165
49;Zamora;127;Morales del Vino;1513;781;732
49;Zamora;131;Moralina;389;199;190
49;Zamora;132;Moreruela de los Infanzones;491;257;234
49;Zamora;133;Moreruela de Tábara;558;289;269
49;Zamora;134;Muelas de los Caballeros;251;132;119
49;Zamora;135;Muelas del Pan;930;453;477
49;Zamora;136;Muga de Sayago;520;256;264
49;Zamora;137;Navianos de Valverde;264;143;121
49;Zamora;138;Olmillos de Castro;448;231;217
49;Zamora;139;Otero de Bodas;279;150;129
49;Zamora;141;Pajares de la Lampreana;527;267;260
49;Zamora;143;Palacios de Sanabria;354;171;183
49;Zamora;142;Palacios del Pan;260;116;144
49;Zamora;145;Pedralba de la Pradería;312;150;162
49;Zamora;146;Pego (El);480;240;240
49;Zamora;147;Peleagonzalo;468;239;229
49;Zamora;148;Peleas de Abajo;253;123;130
49;Zamora;149;Peñausende;603;305;298
49;Zamora;150;Peque;230;115;115
49;Zamora;151;Perdigón (El);792;404;388
49;Zamora;152;Pereruela;756;377;379
49;Zamora;153;Perilla de Castro;268;134;134
49;Zamora;154;Pías;252;126;126
49;Zamora;155;Piedrahita de Castro;161;84;77
49;Zamora;156;Pinilla de Toro;395;199;196
49;Zamora;157;Pino del Oro;238;127;111
49;Zamora;158;Piñero (El);317;169;148
49;Zamora;160;Pobladura de Valderaduey;84;40;44
49;Zamora;159;Pobladura del Valle;329;162;167
49;Zamora;162;Porto;338;183;155
49;Zamora;163;Pozoantiguo;359;178;181
49;Zamora;164;Pozuelo de Tábara;246;119;127
49;Zamora;165;Prado;109;56;53
49;Zamora;166;Puebla de Sanabria;1708;824;884
49;Zamora;167;Pueblica de Valverde;334;169;165
49;Zamora;170;Quintanilla de Urz;142;75;67
49;Zamora;168;Quintanilla del Monte;154;69;85
49;Zamora;169;Quintanilla del Olmo;65;29;36
49;Zamora;171;Quiruelas de Vidriales;1006;477;529
49;Zamora;172;Rabanales;894;459;435
49;Zamora;173;Rábano de Aliste;513;256;257
49;Zamora;174;Requejo;222;106;116
49;Zamora;175;Revellinos;350;190;160
49;Zamora;176;Riofrío de Aliste;1126;586;540
49;Zamora;177;Rionegro del Puente;407;200;207
49;Zamora;178;Roales;403;207;196
49;Zamora;179;Robleda-Cervantes;455;211;244
49;Zamora;180;Roelos de Sayago;172;91;81
49;Zamora;181;Rosinos de la Requejada;534;255;279
49;Zamora;183;Salce;155;85;70
49;Zamora;184;Samir de los Caños;254;133;121
49;Zamora;185;San Agustín del Pozo;221;117;104
49;Zamora;186;San Cebrián de Castro;410;191;219
49;Zamora;187;San Cristóbal de Entreviñas;1643;835;808
49;Zamora;188;San Esteban del Molar;190;103;87
49;Zamora;189;San Justo;388;186;202
49;Zamora;190;San Martín de Valderaduey;104;47;57
49;Zamora;191;San Miguel de la Ribera;422;213;209
49;Zamora;192;San Miguel del Valle;244;113;131
49;Zamora;193;San Pedro de Ceque;726;361;365
49;Zamora;194;San Pedro de la Nave-Almendra;535;266;269
49;Zamora;208;San Vicente de la Cabeza;648;342;306
49;Zamora;209;San Vitero;759;397;362
49;Zamora;197;Santa Clara de Avedillo;255;124;131
49;Zamora;199;Santa Colomba de las Monjas;348;178;170
49;Zamora;200;Santa Cristina de la Polvorosa;1292;662;630
49;Zamora;201;Santa Croya de Tera;504;253;251
49;Zamora;202;Santa Eufemia del Barco;305;166;139
49;Zamora;203;Santa María de la Vega;509;268;241
49;Zamora;204;Santa María de Valverde;109;52;57
49;Zamora;205;Santibáñez de Tera;589;297;292
49;Zamora;206;Santibáñez de Vidriales;1405;702;703
49;Zamora;207;Santovenia;441;212;229
49;Zamora;210;Sanzoles;716;368;348
49;Zamora;214;Tábara;980;500;480
49;Zamora;216;Tapioles;251;135;116
49;Zamora;219;Toro;9622;4676;4946
49;Zamora;220;Torre del Valle (La);195;105;90
49;Zamora;221;Torregamones;347;171;176
49;Zamora;222;Torres del Carrizal;539;276;263
49;Zamora;223;Trabazos;966;490;476
49;Zamora;224;Trefacio;255;119;136
49;Zamora;225;Uña de Quintana;230;117;113
49;Zamora;226;Vadillo de la Guareña;374;195;179
49;Zamora;227;Valcabado;355;182;173
49;Zamora;228;Valdefinjas;98;56;42
49;Zamora;229;Valdescorriel;193;96;97
49;Zamora;230;Vallesa de la Guareña;196;107;89
49;Zamora;231;Vega de Tera;539;255;284
49;Zamora;232;Vega de Villalobos;170;78;92
49;Zamora;233;Vegalatrave;166;88;78
49;Zamora;234;Venialbo;554;287;267
49;Zamora;235;Vezdemarbán;729;356;373
49;Zamora;236;Vidayanes;121;58;63
49;Zamora;237;Videmala;219;108;111
49;Zamora;238;Villabrázaro;395;203;192
49;Zamora;239;Villabuena del Puente;1003;523;480
49;Zamora;240;Villadepera;292;140;152
49;Zamora;241;Villaescusa;390;199;191
49;Zamora;242;Villafáfila;673;332;341
49;Zamora;243;Villaferrueña;162;84;78
49;Zamora;244;Villageriz;73;38;35
49;Zamora;245;Villalazán;398;195;203
49;Zamora;246;Villalba de la Lampreana;336;175;161
49;Zamora;247;Villalcampo;721;350;371
49;Zamora;248;Villalobos;329;155;174
49;Zamora;249;Villalonso;138;67;71
49;Zamora;250;Villalpando;1752;860;892
49;Zamora;251;Villalube;333;168;165
49;Zamora;252;Villamayor de Campos;561;286;275
49;Zamora;255;Villamor de los Escuderos;595;298;297
49;Zamora;256;Villanázar;383;180;203
49;Zamora;257;Villanueva de Azoague;387;194;193
49;Zamora;258;Villanueva de Campeán;196;98;98
49;Zamora;259;Villanueva de las Peras;193;97;96
49;Zamora;260;Villanueva del Campo;1114;550;564
49;Zamora;263;Villar de Fallaves;111;60;51
49;Zamora;264;Villar del Buey;897;486;411
49;Zamora;261;Villaralbo;1586;786;800
49;Zamora;262;Villardeciervos;532;246;286
49;Zamora;265;Villardiegua de la Ribera;177;85;92
49;Zamora;266;Villárdiga;118;60;58
49;Zamora;267;Villardondiego;137;74;63
49;Zamora;268;Villarrín de Campos;663;340;323
49;Zamora;269;Villaseco del Pan;343;169;174
49;Zamora;270;Villavendimio;213;116;97
49;Zamora;272;Villaveza de Valverde;151;77;74
49;Zamora;271;Villaveza del Agua;277;144;133
49;Zamora;273;Viñas;298;150;148
49;Zamora;275;Zamora;64421;30569;33852
50;Zaragoza;001;Abanto;189;101;88
50;Zaragoza;002;Acered;283;145;138
50;Zaragoza;003;Agón;198;107;91
50;Zaragoza;004;Aguarón;716;354;362
50;Zaragoza;005;Aguilón;267;131;136
50;Zaragoza;006;Ainzón;1236;624;612
50;Zaragoza;007;Aladrén;59;33;26
50;Zaragoza;008;Alagón;5552;2765;2787
50;Zaragoza;009;Alarba;160;92;68
50;Zaragoza;010;Alberite de San Juan;105;55;50
50;Zaragoza;011;Albeta;122;56;66
50;Zaragoza;012;Alborge;136;68;68
50;Zaragoza;013;Alcalá de Ebro;299;144;155
50;Zaragoza;014;Alcalá de Moncayo;151;80;71
50;Zaragoza;015;Alconchel de Ariza;171;95;76
50;Zaragoza;016;Aldehuela de Liestos;61;32;29
50;Zaragoza;017;Alfajarín;1460;748;712
50;Zaragoza;018;Alfamén;1307;683;624
50;Zaragoza;019;Alforque;90;47;43
50;Zaragoza;020;Alhama de Aragón;1204;584;620
50;Zaragoza;021;Almochuel;43;23;20
50;Zaragoza;022;Almolda (La);712;351;361
50;Zaragoza;023;Almonacid de la Cuba;350;175;175
50;Zaragoza;024;Almonacid de la Sierra;854;443;411
50;Zaragoza;025;Almunia de Doña Godina (La);5383;2751;2632
50;Zaragoza;026;Alpartir;622;326;296
50;Zaragoza;027;Ambel;359;165;194
50;Zaragoza;028;Anento;74;46;28
50;Zaragoza;029;Aniñón;901;473;428
50;Zaragoza;030;Añón de Moncayo;315;185;130
50;Zaragoza;031;Aranda de Moncayo;239;127;112
50;Zaragoza;032;Arándiga;524;268;256
50;Zaragoza;033;Ardisa;82;43;39
50;Zaragoza;034;Ariza;1334;686;648
50;Zaragoza;035;Artieda;103;57;46
50;Zaragoza;036;Asín;101;48;53
50;Zaragoza;037;Atea;245;137;108
50;Zaragoza;038;Ateca;2044;1005;1039
50;Zaragoza;039;Azuara;725;380;345
50;Zaragoza;040;Badules;116;59;57
50;Zaragoza;041;Bagüés;34;20;14
50;Zaragoza;042;Balconchán;30;15;15
50;Zaragoza;043;Bárboles;329;174;155
50;Zaragoza;044;Bardallur;308;151;157
50;Zaragoza;045;Belchite;1625;831;794
50;Zaragoza;046;Belmonte de Gracián;302;163;139
50;Zaragoza;047;Berdejo;51;28;23
50;Zaragoza;048;Berrueco;41;23;18
50;Zaragoza;901;Biel;200;111;89
50;Zaragoza;050;Bijuesca;135;77;58
50;Zaragoza;051;Biota;1261;643;618
50;Zaragoza;052;Bisimbre;135;60;75
50;Zaragoza;053;Boquiñeni;1006;512;494
50;Zaragoza;054;Bordalba;98;56;42
50;Zaragoza;055;Borja;3999;1951;2048
50;Zaragoza;056;Botorrita;471;251;220
50;Zaragoza;057;Brea de Aragón;2022;1006;1016
50;Zaragoza;058;Bubierca;106;51;55
50;Zaragoza;059;Bujaraloz;1018;539;479
50;Zaragoza;060;Bulbuente;253;140;113
50;Zaragoza;061;Bureta;327;163;164
50;Zaragoza;062;Burgo de Ebro (El);1493;756;737
50;Zaragoza;063;Buste (El);114;61;53
50;Zaragoza;064;Cabañas de Ebro;517;270;247
50;Zaragoza;065;Cabolafuente;99;54;45
50;Zaragoza;066;Cadrete;1367;727;640
50;Zaragoza;067;Calatayud;16569;7912;8657
50;Zaragoza;068;Calatorao;2719;1404;1315
50;Zaragoza;069;Calcena;95;51;44
50;Zaragoza;070;Calmarza;99;50;49
50;Zaragoza;071;Campillo de Aragón;200;112;88
50;Zaragoza;072;Carenas;241;119;122
50;Zaragoza;073;Cariñena;2893;1475;1418
50;Zaragoza;074;Caspe;7750;3795;3955
50;Zaragoza;075;Castejón de Alarba;122;67;55
50;Zaragoza;076;Castejón de las Armas;143;70;73
50;Zaragoza;077;Castejón de Valdejasa;341;178;163
50;Zaragoza;078;Castiliscar;409;205;204
50;Zaragoza;079;Cervera de la Cañada;354;171;183
50;Zaragoza;080;Cerveruela;6;5;1
50;Zaragoza;081;Cetina;736;364;372
50;Zaragoza;092;Chiprana;390;192;198
50;Zaragoza;093;Chodes;126;61;65
50;Zaragoza;082;Cimballa;135;70;65
50;Zaragoza;083;Cinco Olivas;130;63;67
50;Zaragoza;084;Clarés de Ribota;99;52;47
50;Zaragoza;085;Codo;282;137;145
50;Zaragoza;086;Codos;290;170;120
50;Zaragoza;087;Contamina;56;30;26
50;Zaragoza;088;Cosuenda;422;217;205
50;Zaragoza;089;Cuarte de Huerva;1746;908;838
50;Zaragoza;090;Cubel;242;119;123
50;Zaragoza;091;Cuerlas (Las);101;52;49
50;Zaragoza;094;Daroca;2309;1138;1171
50;Zaragoza;095;Ejea de los Caballeros;14734;7501;7233
50;Zaragoza;096;Embid de Ariza;65;34;31
50;Zaragoza;098;Encinacorba;325;174;151
50;Zaragoza;099;Épila;3959;2045;1914
50;Zaragoza;100;Erla;479;226;253
50;Zaragoza;101;Escatrón;1209;586;623
50;Zaragoza;102;Fabara;1239;654;585
50;Zaragoza;104;Farlete;463;230;233
50;Zaragoza;105;Fayón;392;204;188
50;Zaragoza;106;Fayos (Los);194;105;89
50;Zaragoza;107;Figueruelas;997;504;493
50;Zaragoza;108;Fombuena;21;15;6
50;Zaragoza;109;Frago (El);99;61;38
50;Zaragoza;110;Frasno (El);555;291;264
50;Zaragoza;111;Fréscano;261;128;133
50;Zaragoza;113;Fuendejalón;908;463;445
50;Zaragoza;114;Fuendetodos;145;79;66
50;Zaragoza;115;Fuentes de Ebro;3771;1948;1823
50;Zaragoza;116;Fuentes de Jiloca;370;192;178
50;Zaragoza;117;Gallocanta;186;94;92
50;Zaragoza;118;Gallur;2948;1486;1462
50;Zaragoza;119;Gelsa;1238;628;610
50;Zaragoza;120;Godojos;71;35;36
50;Zaragoza;121;Gotor;384;204;180
50;Zaragoza;122;Grisel;68;37;31
50;Zaragoza;123;Grisén;478;241;237
50;Zaragoza;124;Herrera de los Navarros;590;312;278
50;Zaragoza;125;Ibdes;589;300;289
50;Zaragoza;126;Illueca;3310;1627;1683
50;Zaragoza;128;Isuerre;64;36;28
50;Zaragoza;129;Jaraba;316;164;152
50;Zaragoza;130;Jarque;581;311;270
50;Zaragoza;131;Jaulín;309;158;151
50;Zaragoza;132;Joyosa (La);363;187;176
50;Zaragoza;133;Lagata;154;81;73
50;Zaragoza;134;Langa del Castillo;190;90;100
50;Zaragoza;135;Layana;153;75;78
50;Zaragoza;136;Lécera;860;419;441
50;Zaragoza;138;Lechón;53;32;21
50;Zaragoza;137;Leciñena;1387;690;697
50;Zaragoza;139;Letux;498;253;245
50;Zaragoza;140;Litago;181;105;76
50;Zaragoza;141;Lituénigo;117;57;60
50;Zaragoza;142;Lobera de Onsella;57;34;23
50;Zaragoza;143;Longares;861;440;421
50;Zaragoza;144;Longás;41;26;15
50;Zaragoza;146;Lucena de Jalón;264;133;131
50;Zaragoza;147;Luceni;1063;528;535
50;Zaragoza;148;Luesia;425;220;205
50;Zaragoza;149;Luesma;23;13;10
50;Zaragoza;150;Lumpiaque;945;491;454
50;Zaragoza;151;Luna;932;492;440
50;Zaragoza;152;Maella;2027;1028;999
50;Zaragoza;153;Magallón;1218;659;559
50;Zaragoza;154;Mainar;184;99;85
50;Zaragoza;155;Malanquilla;129;67;62
50;Zaragoza;156;Maleján;311;164;147
50;Zaragoza;160;Mallén;2935;1502;1433
50;Zaragoza;157;Malón;479;244;235
50;Zaragoza;159;Maluenda;1012;486;526
50;Zaragoza;161;Manchones;157;76;81
50;Zaragoza;162;Mara;216;112;104
50;Zaragoza;163;María de Huerva;868;420;448
50;Zaragoza;902;Marracos;130;66;64
50;Zaragoza;164;Mediana de Aragón;506;255;251
50;Zaragoza;165;Mequinenza;2544;1260;1284
50;Zaragoza;166;Mesones de Isuela;388;191;197
50;Zaragoza;167;Mezalocha;316;171;145
50;Zaragoza;168;Mianos;39;22;17
50;Zaragoza;169;Miedes de Aragón;521;269;252
50;Zaragoza;170;Monegrillo;551;301;250
50;Zaragoza;171;Moneva;111;54;57
50;Zaragoza;172;Monreal de Ariza;317;163;154
50;Zaragoza;173;Monterde;223;112;111
50;Zaragoza;174;Montón;145;72;73
50;Zaragoza;175;Morata de Jalón;1546;768;778
50;Zaragoza;176;Morata de Jiloca;355;190;165
50;Zaragoza;177;Morés;507;267;240
50;Zaragoza;178;Moros;533;265;268
50;Zaragoza;179;Moyuela;356;180;176
50;Zaragoza;180;Mozota;116;58;58
50;Zaragoza;181;Muel;1135;570;565
50;Zaragoza;182;Muela (La);1136;593;543
50;Zaragoza;183;Munébrega;483;253;230
50;Zaragoza;184;Murero;143;82;61
50;Zaragoza;185;Murillo de Gállego;137;81;56
50;Zaragoza;186;Navardún;61;32;29
50;Zaragoza;187;Nigüella;119;65;54
50;Zaragoza;188;Nombrevilla;33;15;18
50;Zaragoza;189;Nonaspe;1087;544;543
50;Zaragoza;190;Novallas;758;366;392
50;Zaragoza;191;Novillas;699;356;343
50;Zaragoza;192;Nuévalos;300;174;126
50;Zaragoza;193;Nuez de Ebro;563;298;265
50;Zaragoza;194;Olvés;171;90;81
50;Zaragoza;195;Orcajo;46;23;23
50;Zaragoza;196;Orera;133;66;67
50;Zaragoza;197;Orés;104;62;42
50;Zaragoza;198;Oseja;56;32;24
50;Zaragoza;199;Osera de Ebro;345;167;178
50;Zaragoza;200;Paniza;711;348;363
50;Zaragoza;201;Paracuellos de Jiloca;495;221;274
50;Zaragoza;202;Paracuellos de la Ribera;314;149;165
50;Zaragoza;203;Pastriz;936;457;479
50;Zaragoza;204;Pedrola;2574;1316;1258
50;Zaragoza;205;Pedrosas (Las);100;45;55
50;Zaragoza;206;Perdiguera;447;236;211
50;Zaragoza;207;Piedratajada;194;98;96
50;Zaragoza;208;Pina de Ebro;2208;1093;1115
50;Zaragoza;209;Pinseque;1470;725;745
50;Zaragoza;210;Pintanos (Los);84;42;42
50;Zaragoza;211;Plasencia de Jalón;370;201;169
50;Zaragoza;212;Pleitas;69;40;29
50;Zaragoza;213;Plenas;161;81;80
50;Zaragoza;214;Pomer;15;8;7
50;Zaragoza;215;Pozuel de Ariza;25;18;7
50;Zaragoza;216;Pozuelo de Aragón;350;192;158
50;Zaragoza;217;Pradilla de Ebro;659;345;314
50;Zaragoza;218;Puebla de Albortón;158;82;76
50;Zaragoza;219;Puebla de Alfindén (La);1633;845;788
50;Zaragoza;220;Puendeluna;58;35;23
50;Zaragoza;221;Purujosa;39;29;10
50;Zaragoza;222;Quinto;2154;1086;1068
50;Zaragoza;223;Remolinos;1257;634;623
50;Zaragoza;224;Retascón;79;46;33
50;Zaragoza;225;Ricla;1838;976;862
50;Zaragoza;227;Romanos;147;85;62
50;Zaragoza;228;Rueda de Jalón;371;189;182
50;Zaragoza;229;Ruesca;92;47;45
50;Zaragoza;241;Sabiñán;980;473;507
50;Zaragoza;230;Sádaba;1683;851;832
50;Zaragoza;231;Salillas de Jalón;365;194;171
50;Zaragoza;232;Salvatierra de Esca;289;148;141
50;Zaragoza;233;Samper del Salz;144;72;72
50;Zaragoza;234;San Martín de la Virgen de Moncayo;311;161;150
50;Zaragoza;235;San Mateo de Gállego;2036;1042;994
50;Zaragoza;236;Santa Cruz de Grío;234;128;106
50;Zaragoza;237;Santa Cruz de Moncayo;107;52;55
50;Zaragoza;238;Santa Eulalia de Gállego;133;62;71
50;Zaragoza;239;Santed;78;37;41
50;Zaragoza;240;Sástago;1479;739;740
50;Zaragoza;242;Sediles;107;55;52
50;Zaragoza;243;Sestrica;486;246;240
50;Zaragoza;244;Sierra de Luna;263;132;131
50;Zaragoza;245;Sigüés;181;96;85
50;Zaragoza;246;Sisamón;85;50;35
50;Zaragoza;247;Sobradiel;610;296;314
50;Zaragoza;248;Sos del Rey Católico;813;405;408
50;Zaragoza;249;Tabuenca;484;264;220
50;Zaragoza;250;Talamantes;68;37;31
50;Zaragoza;251;Tarazona;10287;4966;5321
50;Zaragoza;252;Tauste;6998;3466;3532
50;Zaragoza;253;Terrer;672;322;350
50;Zaragoza;254;Tierga;260;143;117
50;Zaragoza;255;Tobed;285;140;145
50;Zaragoza;256;Torralba de los Frailes;109;53;56
50;Zaragoza;257;Torralba de Ribota;230;129;101
50;Zaragoza;258;Torralbilla;71;36;35
50;Zaragoza;259;Torrehermosa;122;65;57
50;Zaragoza;260;Torrelapaja;44;22;22
50;Zaragoza;261;Torrellas;321;160;161
50;Zaragoza;262;Torres de Berrellén;1404;700;704
50;Zaragoza;263;Torrijo de la Cañada;414;214;200
50;Zaragoza;264;Tosos;206;107;99
50;Zaragoza;265;Trasmoz;67;35;32
50;Zaragoza;266;Trasobares;238;125;113
50;Zaragoza;267;Uncastillo;920;450;470
50;Zaragoza;268;Undués de Lerda;58;36;22
50;Zaragoza;269;Urrea de Jalón;345;174;171
50;Zaragoza;270;Urriés;84;52;32
50;Zaragoza;271;Used;389;212;177
50;Zaragoza;272;Utebo;9488;4793;4695
50;Zaragoza;274;Val de San Martín;75;35;40
50;Zaragoza;273;Valdehorna;59;30;29
50;Zaragoza;275;Valmadrid;62;33;29
50;Zaragoza;276;Valpalmas;198;100;98
50;Zaragoza;277;Valtorres;100;48;52
50;Zaragoza;278;Velilla de Ebro;281;141;140
50;Zaragoza;279;Velilla de Jiloca;122;61;61
50;Zaragoza;280;Vera de Moncayo;481;246;235
50;Zaragoza;281;Vierlas;103;50;53
50;Zaragoza;283;Villadoz;87;47;40
50;Zaragoza;284;Villafeliche;235;118;117
50;Zaragoza;285;Villafranca de Ebro;672;321;351
50;Zaragoza;286;Villalba de Perejil;115;61;54
50;Zaragoza;287;Villalengua;434;229;205
50;Zaragoza;903;Villamayor de Gállego;"";"";""
50;Zaragoza;288;Villanueva de Gállego;2860;1451;1409
50;Zaragoza;290;Villanueva de Huerva;590;302;288
50;Zaragoza;289;Villanueva de Jiloca;116;57;59
50;Zaragoza;291;Villar de los Navarros;149;75;74
50;Zaragoza;292;Villarreal de Huerva;188;105;83
50;Zaragoza;293;Villarroya de la Sierra;708;363;345
50;Zaragoza;294;Villarroya del Campo;90;43;47
50;Zaragoza;282;Vilueña (La);96;41;55
50;Zaragoza;295;Vistabella;34;19;15
50;Zaragoza;296;Zaida (La);614;307;307
50;Zaragoza;297;Zaragoza;603367;290375;312992
50;Zaragoza;298;Zuera;5404;2775;2629
51;Ceuta;001;Ceuta;72117;36102;36015
52;Melilla;001;Melilla;60108;30569;29539
