01;Álava;001;Alegría-Dulantzi;1012;517;495
01;Álava;002;Amurrio;9758;4893;4865
01;Álava;049;Añana;194;100;94
01;Álava;003;Aramaio;1360;716;644
01;Álava;006;Armiñón;153;74;79
01;Álava;037;Arraia-Maeztu;811;428;383
01;Álava;008;Arrazua-Ubarrundia;631;339;292
01;Álava;004;Artziniega;1189;583;606
01;Álava;009;Asparrena;1555;779;776
01;Álava;010;Ayala/Aiara;2126;1043;1083
01;Álava;011;Baños de Ebro/Mañueta;353;186;167
01;Álava;013;Barrundia;598;336;262
01;Álava;014;Berantevilla;423;212;211
01;Álava;016;Bernedo;594;333;261
01;Álava;017;Campezo/Kanpezu;1185;625;560
01;Álava;021;Elburgo/Burgelu;207;111;96
01;Álava;022;Elciego;915;460;455
01;Álava;023;Elvillar/Bilar;382;198;184
01;Álava;056;Harana/Valle de Arana;425;230;195
01;Álava;901;Iruña Oka/Iruña de Oca;1575;823;752
01;Álava;027;Iruraiz-Gauna;467;249;218
01;Álava;019;Kripan;205;109;96
01;Álava;020;Kuartango;352;199;153
01;Álava;028;Labastida;978;530;448
01;Álava;030;Lagrán;205;111;94
01;Álava;031;Laguardia;1507;785;722
01;Álava;032;Lanciego/Lantziego;622;335;287
01;Álava;902;Lantarón;856;439;417
01;Álava;033;Lapuebla de Labarca;840;423;417
01;Álava;058;Legutiano;1283;708;575
01;Álava;034;Leza;201;107;94
01;Álava;036;Llodio;20895;10627;10268
01;Álava;039;Moreda de Álava;283;152;131
01;Álava;041;Navaridas;222;118;104
01;Álava;042;Okondo;785;422;363
01;Álava;043;Oyón/Oion;2263;1137;1126
01;Álava;044;Peñacerrada-Urizaharra;244;136;108
01;Álava;046;Ribera Alta;540;315;225
01;Álava;047;Ribera Baja/Erribera Beitia;388;210;178
01;Álava;051;Salvatierra/Agurain;3665;1841;1824
01;Álava;052;Samaniego;297;149;148
01;Álava;053;San Millán/Donemiliaga;774;411;363
01;Álava;054;Urkabustaiz;890;453;437
01;Álava;055;Valdegovía;867;489;378
01;Álava;057;Villabuena de Álava/Eskuernaga;358;185;173
01;Álava;059;Vitoria-Gasteiz;206706;102494;104212
01;Álava;060;Yécora/Lekora;254;128;126
01;Álava;061;Zalduondo;122;64;58
01;Álava;062;Zambrana;341;182;159
01;Álava;018;Zigoitia;790;429;361
01;Álava;063;Zuia;1247;619;628
02;Albacete;001;Abengibre;1121;563;558
02;Albacete;002;Alatoz;800;413;387
02;Albacete;003;Albacete;126634;62248;64386
02;Albacete;004;Albatana;949;479;470
02;Albacete;005;Alborea;887;451;436
02;Albacete;006;Alcadozo;911;464;447
02;Albacete;007;Alcalá del Júcar;1791;910;881
02;Albacete;008;Alcaraz;2092;1027;1065
02;Albacete;009;Almansa;22331;10910;11421
02;Albacete;010;Alpera;2368;1211;1157
02;Albacete;011;Ayna;1422;717;705
02;Albacete;012;Balazote;2259;1125;1134
02;Albacete;014;Ballestero (El);745;373;372
02;Albacete;013;Balsa de Ves;296;146;150
02;Albacete;015;Barrax;2085;1037;1048
02;Albacete;016;Bienservida;1213;633;580
02;Albacete;017;Bogarra;1748;925;823
02;Albacete;018;Bonete;1309;661;648
02;Albacete;019;Bonillo (El);3386;1683;1703
02;Albacete;020;Carcelén;862;428;434
02;Albacete;021;Casas de Juan Núñez;1340;683;657
02;Albacete;022;Casas de Lázaro;541;284;257
02;Albacete;023;Casas de Ves;1320;674;646
02;Albacete;024;Casas-Ibáñez;3923;1974;1949
02;Albacete;025;Caudete;8371;4169;4202
02;Albacete;026;Cenizate;1121;571;550
02;Albacete;029;Chinchilla de Monte-Aragón;3542;1829;1713
02;Albacete;027;Corral-Rubio;558;290;268
02;Albacete;028;Cotillas;302;157;145
02;Albacete;030;Elche de la Sierra;4090;1993;2097
02;Albacete;032;Fuensanta;454;220;234
02;Albacete;033;Fuente-Álamo;2552;1300;1252
02;Albacete;034;Fuentealbilla;1902;975;927
02;Albacete;031;Férez;987;487;500
02;Albacete;035;Gineta (La);2361;1139;1222
02;Albacete;036;Golosalvo;151;70;81
02;Albacete;037;Hellín;25021;12334;12687
02;Albacete;038;Herrera (La);482;256;226
02;Albacete;039;Higueruela;1395;694;701
02;Albacete;040;Hoya-Gonzalo;807;416;391
02;Albacete;041;Jorquera;779;409;370
02;Albacete;042;Letur;1786;909;877
02;Albacete;043;Lezuza;2197;1115;1082
02;Albacete;044;Liétor;2031;1048;983
02;Albacete;045;Madrigueras;4523;2275;2248
02;Albacete;046;Mahora;1482;730;752
02;Albacete;047;Masegoso;321;179;142
02;Albacete;048;Minaya;2072;1050;1022
02;Albacete;049;Molinicos;1921;989;932
02;Albacete;050;Montalvos;166;86;80
02;Albacete;051;Montealegre del Castillo;2221;1105;1116
02;Albacete;052;Motilleja;548;267;281
02;Albacete;053;Munera;4304;2205;2099
02;Albacete;054;Navas de Jorquera;622;324;298
02;Albacete;055;Nerpio;2370;1241;1129
02;Albacete;056;Ontur;2797;1360;1437
02;Albacete;057;Ossa de Montiel;2878;1467;1411
02;Albacete;058;Paterna del Madera;707;372;335
02;Albacete;060;Peñas de San Pedro;1508;790;718
02;Albacete;059;Peñascosa;563;292;271
02;Albacete;061;Pétrola;1196;602;594
02;Albacete;062;Povedilla;819;424;395
02;Albacete;064;Pozo-Lorente;549;269;280
02;Albacete;063;Pozohondo;2167;1101;1066
02;Albacete;065;Pozuelo;714;354;360
02;Albacete;066;Recueja (La);461;232;229
02;Albacete;067;Riópar;1456;743;713
02;Albacete;068;Robledo;512;271;241
02;Albacete;069;Roda (La);12888;6452;6436
02;Albacete;070;Salobre;727;382;345
02;Albacete;071;San Pedro;1449;745;704
02;Albacete;072;Socovos;2368;1201;1167
02;Albacete;073;Tarazona de la Mancha;6028;3021;3007
02;Albacete;074;Tobarra;7661;3790;3871
02;Albacete;075;Valdeganga;2364;1187;1177
02;Albacete;076;Vianos;571;295;276
02;Albacete;077;Villa de Ves;47;24;23
02;Albacete;078;Villalgordo del Júcar;1328;657;671
02;Albacete;079;Villamalea;3430;1803;1627
02;Albacete;080;Villapalacios;1081;535;546
02;Albacete;081;Villarrobledo;21170;10451;10719
02;Albacete;082;Villatoya;241;132;109
02;Albacete;083;Villavaliente;366;188;178
02;Albacete;084;Villaverde de Guadalimar;737;403;334
02;Albacete;085;Viveros;697;358;339
02;Albacete;086;Yeste;5218;2711;2507
03;Alicante/Alacant;001;Adsubia;549;275;274
03;Alicante/Alacant;002;Agost;3850;1931;1919
03;Alicante/Alacant;003;Agres;717;370;347
03;Alicante/Alacant;004;Aigües;350;168;182
03;Alicante/Alacant;005;Albatera;8950;4499;4451
03;Alicante/Alacant;006;Alcalalí;645;327;318
03;Alicante/Alacant;007;Alcocer de Planes;111;51;60
03;Alicante/Alacant;008;Alcoleja;338;154;184
03;Alicante/Alacant;009;Alcoy/Alcoi;65267;31466;33801
03;Alicante/Alacant;010;Alfafara;398;194;204
03;Alicante/Alacant;011;Alfàs del Pi (L');7672;3753;3919
03;Alicante/Alacant;012;Algorfa;1125;566;559
03;Alicante/Alacant;013;Algueña;1533;745;788
03;Alicante/Alacant;014;Alicante/Alacant;264115;127712;136403
03;Alicante/Alacant;015;Almoradí;14468;7292;7176
03;Alicante/Alacant;016;Almudaina;140;62;78
03;Alicante/Alacant;017;Alquería d'Asnar (L');404;203;201
03;Alicante/Alacant;018;Altea;12589;6230;6359
03;Alicante/Alacant;019;Aspe;15918;7886;8032
03;Alicante/Alacant;020;Balones;171;74;97
03;Alicante/Alacant;021;Banyeres de Mariola;7055;3493;3562
03;Alicante/Alacant;022;Benasau;230;113;117
03;Alicante/Alacant;023;Beneixama;1865;924;941
03;Alicante/Alacant;024;Benejúzar;4559;2275;2284
03;Alicante/Alacant;025;Benferri;956;476;480
03;Alicante/Alacant;026;Beniarbeig;1214;595;619
03;Alicante/Alacant;027;Beniardá;250;118;132
03;Alicante/Alacant;028;Beniarrés;1568;778;790
03;Alicante/Alacant;030;Benidoleig;783;371;412
03;Alicante/Alacant;031;Benidorm;40196;20023;20173
03;Alicante/Alacant;032;Benifallim;194;97;97
03;Alicante/Alacant;033;Benifato;125;62;63
03;Alicante/Alacant;029;Benigembla;373;183;190
03;Alicante/Alacant;034;Benijófar;1410;660;750
03;Alicante/Alacant;035;Benilloba;936;478;458
03;Alicante/Alacant;036;Benillup;78;41;37
03;Alicante/Alacant;037;Benimantell;432;209;223
03;Alicante/Alacant;038;Benimarfull;401;187;214
03;Alicante/Alacant;039;Benimassot;111;54;57
03;Alicante/Alacant;040;Benimeli;347;171;176
03;Alicante/Alacant;041;Benissa;7642;3801;3841
03;Alicante/Alacant;042;Benitachell/Poble Nou de Benitatxell (el);1611;802;809
03;Alicante/Alacant;043;Biar;3418;1657;1761
03;Alicante/Alacant;044;Bigastro;4426;2263;2163
03;Alicante/Alacant;045;Bolulla;272;135;137
03;Alicante/Alacant;046;Busot;769;381;388
03;Alicante/Alacant;048;Callosa d'En Sarrià;7854;3885;3969
03;Alicante/Alacant;049;Callosa de Segura;15383;7682;7701
03;Alicante/Alacant;047;Calpe/Calp;11210;5576;5634
03;Alicante/Alacant;050;Campello (El);10446;5174;5272
03;Alicante/Alacant;051;Campo de Mirra/Camp de Mirra (el);404;194;210
03;Alicante/Alacant;053;Castalla;7194;3559;3635
03;Alicante/Alacant;054;Castell de Castells;583;290;293
03;Alicante/Alacant;055;Catral;4496;2248;2248
03;Alicante/Alacant;052;Cañada;1051;506;545
03;Alicante/Alacant;056;Cocentaina;10496;5144;5352
03;Alicante/Alacant;057;Confrides;321;174;147
03;Alicante/Alacant;058;Cox;5458;2780;2678
03;Alicante/Alacant;059;Crevillent;22269;11249;11020
03;Alicante/Alacant;061;Daya Nueva;1230;608;622
03;Alicante/Alacant;062;Daya Vieja;244;121;123
03;Alicante/Alacant;064;Dolores;5751;2872;2879
03;Alicante/Alacant;063;Dénia;24895;12236;12659
03;Alicante/Alacant;065;Elche/Elx;182683;90592;92091
03;Alicante/Alacant;066;Elda;57039;28005;29034
03;Alicante/Alacant;067;Facheca;142;74;68
03;Alicante/Alacant;068;Famorca;78;33;45
03;Alicante/Alacant;069;Finestrat;1184;598;586
03;Alicante/Alacant;070;Formentera del Segura;1939;958;981
03;Alicante/Alacant;072;Gaianes;331;160;171
03;Alicante/Alacant;071;Gata de Gorgos;5120;2562;2558
03;Alicante/Alacant;073;Gorga;300;151;149
03;Alicante/Alacant;074;Granja de Rocamora;1895;968;927
03;Alicante/Alacant;075;Guadalest;169;88;81
03;Alicante/Alacant;076;Guardamar del Segura;6516;3183;3333
03;Alicante/Alacant;077;Hondón de las Nieves;1516;751;765
03;Alicante/Alacant;078;Hondón de los Frailes;553;278;275
03;Alicante/Alacant;079;Ibi;20746;10298;10448
03;Alicante/Alacant;080;Jacarilla;1426;713;713
03;Alicante/Alacant;081;Jalón/Xaló;1813;888;925
03;Alicante/Alacant;083;Jijona/Xixona;7654;3630;4024
03;Alicante/Alacant;082;Jávea/Xàbia;14092;6936;7156
03;Alicante/Alacant;085;Llíber;439;218;221
03;Alicante/Alacant;084;Lorcha/Orxa (L');906;459;447
03;Alicante/Alacant;086;Millena;132;66;66
03;Alicante/Alacant;088;Monforte del Cid;4919;2531;2388
03;Alicante/Alacant;903;Montesinos (Los);"";"";""
03;Alicante/Alacant;089;Monóvar/Monòver;12021;5832;6189
03;Alicante/Alacant;091;Murla;355;153;202
03;Alicante/Alacant;092;Muro de Alcoy;6474;3250;3224
03;Alicante/Alacant;090;Mutxamel;9024;4548;4476
03;Alicante/Alacant;093;Novelda;21966;10820;11146
03;Alicante/Alacant;094;Nucia (la);5640;2783;2857
03;Alicante/Alacant;095;Ondara;4748;2341;2407
03;Alicante/Alacant;096;Onil;6685;3335;3350
03;Alicante/Alacant;097;Orba;1532;730;802
03;Alicante/Alacant;099;Orihuela;46379;22664;23715
03;Alicante/Alacant;098;Orxeta;462;228;234
03;Alicante/Alacant;100;Parcent;670;340;330
03;Alicante/Alacant;101;Pedreguer;5719;2780;2939
03;Alicante/Alacant;102;Pego;9447;4688;4759
03;Alicante/Alacant;103;Penàguila;378;185;193
03;Alicante/Alacant;104;Petrer;23046;11477;11569
03;Alicante/Alacant;902;Pilar de la Horadada;7289;3668;3621
03;Alicante/Alacant;105;Pinoso;5621;2789;2832
03;Alicante/Alacant;106;Planes;822;412;410
03;Alicante/Alacant;901;Poblets (Els);1137;548;589
03;Alicante/Alacant;107;Polop;2018;980;1038
03;Alicante/Alacant;060;Quatretondeta;217;105;112
03;Alicante/Alacant;109;Rafal;2604;1291;1313
03;Alicante/Alacant;111;Redován;4943;2518;2425
03;Alicante/Alacant;112;Relleu;837;422;415
03;Alicante/Alacant;113;Rojales;5203;2620;2583
03;Alicante/Alacant;114;Romana (La);1993;1018;975
03;Alicante/Alacant;110;Ràfol d'Almúnia (El);369;180;189
03;Alicante/Alacant;115;Sagra;385;185;200
03;Alicante/Alacant;116;Salinas;1102;577;525
03;Alicante/Alacant;118;San Fulgencio;1620;808;812
03;Alicante/Alacant;904;San Isidro;"";"";""
03;Alicante/Alacant;120;San Miguel de Salinas;2475;1269;1206
03;Alicante/Alacant;122;San Vicente del Raspeig/Sant Vicent del Raspeig;27129;13470;13659
03;Alicante/Alacant;117;Sanet y Negrals;550;249;301
03;Alicante/Alacant;119;Sant Joan d'Alacant;13086;6446;6640
03;Alicante/Alacant;121;Santa Pola;14244;7099;7145
03;Alicante/Alacant;123;Sax;8199;4105;4094
03;Alicante/Alacant;124;Sella;611;313;298
03;Alicante/Alacant;125;Senija;441;223;218
03;Alicante/Alacant;128;Teulada;5235;2553;2682
03;Alicante/Alacant;129;Tibi;1043;524;519
03;Alicante/Alacant;130;Tollos;48;30;18
03;Alicante/Alacant;131;Tormos;245;129;116
03;Alicante/Alacant;132;Torremanzanas/Torre de les Maçanes (la);741;350;391
03;Alicante/Alacant;133;Torrevieja;20718;10109;10609
03;Alicante/Alacant;127;Tárbena;699;357;342
03;Alicante/Alacant;134;Vall d'Alcalà (La);156;77;79
03;Alicante/Alacant;135;Vall de Ebo;378;191;187
03;Alicante/Alacant;136;Vall de Gallinera;786;392;394
03;Alicante/Alacant;137;Vall de Laguar (La);994;493;501
03;Alicante/Alacant;138;Verger (El);3684;1789;1895
03;Alicante/Alacant;139;Villajoyosa/Vila Joiosa (La);23134;11406;11728
03;Alicante/Alacant;140;Villena;30818;15276;15542
04;Almería;001;Abla;1706;830;876
04;Almería;002;Abrucena;1543;766;777
04;Almería;003;Adra;20038;10029;10009
04;Almería;004;Albánchez;814;398;416
04;Almería;005;Alboloduy;981;456;525
04;Almería;006;Albox;10485;5312;5173
04;Almería;007;Alcolea;860;428;432
04;Almería;008;Alcóntar;683;348;335
04;Almería;009;Alcudia de Monteagud;204;91;113
04;Almería;010;Alhabia;865;431;434
04;Almería;011;Alhama de Almería;3100;1546;1554
04;Almería;012;Alicún;244;109;135
04;Almería;013;Almería;159330;77407;81923
04;Almería;014;Almócita;217;109;108
04;Almería;015;Alsodux;132;56;76
04;Almería;016;Antas;2564;1279;1285
04;Almería;017;Arboleas;1537;750;787
04;Almería;018;Armuña de Almanzora;370;177;193
04;Almería;019;Bacares;336;181;155
04;Almería;020;Bayárcal;437;232;205
04;Almería;021;Bayarque;255;123;132
04;Almería;022;Bédar;560;293;267
04;Almería;023;Beires;169;77;92
04;Almería;024;Benahadux;2120;1027;1093
04;Almería;026;Benitagla;116;58;58
04;Almería;027;Benizalón;419;212;207
04;Almería;028;Bentarique;345;177;168
04;Almería;029;Berja;11931;5893;6038
04;Almería;030;Canjáyar;2077;1033;1044
04;Almería;031;Cantoria;3387;1698;1689
04;Almería;032;Carboneras;5901;3068;2833
04;Almería;033;Castro de Filabres;156;77;79
04;Almería;036;Chercos;352;175;177
04;Almería;037;Chirivel;2054;1037;1017
04;Almería;034;Cóbdar;300;156;144
04;Almería;035;Cuevas del Almanzora;9125;4546;4579
04;Almería;038;Dalías;3636;1798;1838
04;Almería;039;Darrical;415;208;207
04;Almería;902;Ejido (El);40014;20337;19677
04;Almería;041;Enix;242;113;129
04;Almería;043;Felix;659;301;358
04;Almería;044;Fines;1569;789;780
04;Almería;045;Fiñana;2761;1341;1420
04;Almería;046;Fondón;1002;512;490
04;Almería;047;Gádor;2551;1242;1309
04;Almería;048;Gallardos (Los);1698;858;840
04;Almería;049;Garrucha;4018;2050;1968
04;Almería;050;Gérgal;1210;595;615
04;Almería;051;Huécija;584;288;296
04;Almería;052;Huércal de Almería;3878;1915;1963
04;Almería;053;Huércal-Overa;13131;6488;6643
04;Almería;054;Illar;532;244;288
04;Almería;055;Instinción;651;318;333
04;Almería;056;Laroya;155;81;74
04;Almería;057;Láujar de Andarax;1870;917;953
04;Almería;058;Líjar;562;284;278
04;Almería;059;Lubrín;2182;1057;1125
04;Almería;060;Lucainena de las Torres;664;326;338
04;Almería;061;Lúcar;815;409;406
04;Almería;062;Macael;5761;2920;2841
04;Almería;063;María;1865;972;893
04;Almería;064;Mojácar;3612;1811;1801
04;Almería;903;Mojonera (La);5450;2757;2693
04;Almería;065;Nacimiento;559;281;278
04;Almería;066;Níjar;12765;6515;6250
04;Almería;067;Ohanes;931;461;470
04;Almería;068;Olula de Castro;239;128;111
04;Almería;069;Olula del Río;5311;2654;2657
04;Almería;070;Oria;2645;1326;1319
04;Almería;071;Padules;574;301;273
04;Almería;072;Partaloa;464;230;234
04;Almería;073;Paterna del Río;416;205;211
04;Almería;074;Pechina;2142;1054;1088
04;Almería;075;Pulpí;4472;2229;2243
04;Almería;076;Purchena;1862;929;933
04;Almería;077;Rágol;473;234;239
04;Almería;078;Rioja;1173;573;600
04;Almería;079;Roquetas de Mar;26314;13218;13096
04;Almería;080;Santa Cruz de Marchena;257;120;137
04;Almería;081;Santa Fe de Mondújar;433;214;219
04;Almería;082;Senés;485;252;233
04;Almería;083;Serón;3197;1586;1611
04;Almería;084;Sierro;707;365;342
04;Almería;085;Somontín;557;284;273
04;Almería;086;Sorbas;3066;1546;1520
04;Almería;087;Suflí;262;135;127
04;Almería;088;Tabernas;3213;1604;1609
04;Almería;089;Taberno;1019;505;514
04;Almería;090;Tahal;585;294;291
04;Almería;091;Terque;512;252;260
04;Almería;092;Tíjola;3517;1782;1735
04;Almería;901;Tres Villas (Las);718;385;333
04;Almería;093;Turre;2104;1024;1080
04;Almería;094;Turrillas;286;152;134
04;Almería;095;Uleila del Campo;1042;526;516
04;Almería;096;Urrácal;385;188;197
04;Almería;097;Velefique;441;220;221
04;Almería;098;Vélez-Blanco;2554;1299;1255
04;Almería;099;Vélez-Rubio;6696;3246;3450
04;Almería;100;Vera;5793;2828;2965
04;Almería;101;Viator;2733;1346;1387
04;Almería;102;Vícar;10962;5630;5332
04;Almería;103;Zurgena;2173;1067;1106
05;Ávila;001;Adanero;407;219;188
05;Ávila;002;Adrada (La);1871;965;906
05;Ávila;005;Albornos;320;168;152
05;Ávila;007;Aldeanueva de Santa Cruz;250;133;117
05;Ávila;008;Aldeaseca;434;218;216
05;Ávila;010;Aldehuela (La);323;168;155
05;Ávila;012;Amavida;231;114;117
05;Ávila;013;Arenal (El);1169;586;583
05;Ávila;014;Arenas de San Pedro;6864;3451;3413
05;Ávila;015;Arevalillo;208;100;108
05;Ávila;016;Arévalo;7151;3479;3672
05;Ávila;017;Aveinte;173;86;87
05;Ávila;018;Avellaneda;78;36;42
05;Ávila;019;Ávila;46259;22405;23854
05;Ávila;021;Barco de Ávila (El);2703;1342;1361
05;Ávila;022;Barraco (El);2223;1127;1096
05;Ávila;023;Barromán;353;184;169
05;Ávila;024;Becedas;676;335;341
05;Ávila;025;Becedillas;231;124;107
05;Ávila;026;Bercial de Zapardiel;394;195;199
05;Ávila;027;Berlanas (Las);392;191;201
05;Ávila;029;Bernuy-Zapardiel;315;166;149
05;Ávila;030;Berrocalejo de Aragona;39;19;20
05;Ávila;033;Blascomillán;393;188;205
05;Ávila;034;Blasconuño de Matacabras;37;19;18
05;Ávila;035;Blascosancho;196;103;93
05;Ávila;036;Bohodón (El);242;130;112
05;Ávila;037;Bohoyo;610;334;276
05;Ávila;038;Bonilla de la Sierra;284;149;135
05;Ávila;039;Brabos;95;48;47
05;Ávila;040;Bularros;157;85;72
05;Ávila;041;Burgohondo;1487;753;734
05;Ávila;042;Cabezas de Alambre;316;163;153
05;Ávila;043;Cabezas del Pozo;256;127;129
05;Ávila;044;Cabezas del Villar;672;366;306
05;Ávila;045;Cabizuela;162;84;78
05;Ávila;046;Canales;99;48;51
05;Ávila;047;Candeleda;5463;2793;2670
05;Ávila;048;Cantiveros;266;135;131
05;Ávila;049;Cardeñosa;637;336;301
05;Ávila;051;Carrera (La);377;190;187
05;Ávila;052;Casas del Puerto de Villatoro;145;80;65
05;Ávila;053;Casasola;249;127;122
05;Ávila;054;Casavieja;1711;872;839
05;Ávila;055;Casillas;1026;515;511
05;Ávila;056;Castellanos de Zapardiel;195;114;81
05;Ávila;057;Cebreros;3426;1716;1710
05;Ávila;058;Cepeda la Mora;198;104;94
05;Ávila;067;Chamartín;136;75;61
05;Ávila;059;Cillán;178;85;93
05;Ávila;060;Cisla;260;128;132
05;Ávila;061;Colilla (La);251;126;125
05;Ávila;062;Collado de Contreras;356;191;165
05;Ávila;063;Collado del Mirón;133;67;66
05;Ávila;064;Constanzana;238;132;106
05;Ávila;065;Crespos;847;443;404
05;Ávila;066;Cuevas del Valle;711;379;332
05;Ávila;903;Diego del Carpio;461;246;215
05;Ávila;069;Donjimeno;172;89;83
05;Ávila;070;Donvidas;100;48;52
05;Ávila;072;Espinosa de los Caballeros;138;75;63
05;Ávila;073;Flores de Ávila;562;293;269
05;Ávila;074;Fontíveros;1179;600;579
05;Ávila;075;Fresnedilla;163;76;87
05;Ávila;076;Fresno (El);454;231;223
05;Ávila;077;Fuente el Saúz;401;195;206
05;Ávila;078;Fuentes de Año;272;140;132
05;Ávila;079;Gallegos de Altamiros;144;79;65
05;Ávila;080;Gallegos de Sobrinos;132;65;67
05;Ávila;081;Garganta del Villar;117;65;52
05;Ávila;082;Gavilanes;841;439;402
05;Ávila;083;Gemuño;298;148;150
05;Ávila;085;Gil García;108;52;56
05;Ávila;084;Gilbuena;224;121;103
05;Ávila;086;Gimialcón;169;88;81
05;Ávila;087;Gotarrendura;221;78;143
05;Ávila;088;Grandes y San Martín;89;42;47
05;Ávila;089;Guisando;798;408;390
05;Ávila;090;Gutierre-Muñoz;158;76;82
05;Ávila;092;Hernansancho;276;135;141
05;Ávila;093;Herradón de Pinares;506;261;245
05;Ávila;094;Herreros de Suso;394;195;199
05;Ávila;095;Higuera de las Dueñas;327;170;157
05;Ávila;096;Hija de Dios (La);177;97;80
05;Ávila;097;Horcajada (La);1078;542;536
05;Ávila;099;Horcajo de las Torres;1022;558;464
05;Ávila;100;Hornillo (El);576;287;289
05;Ávila;102;Hoyo de Pinares (El);2712;1379;1333
05;Ávila;101;Hoyocasero;527;279;248
05;Ávila;103;Hoyorredondo;200;95;105
05;Ávila;106;Hoyos de Miguel Muñoz;86;48;38
05;Ávila;104;Hoyos del Collado;62;39;23
05;Ávila;105;Hoyos del Espino;416;214;202
05;Ávila;107;Hurtumpascual;189;95;94
05;Ávila;108;Junciana;115;59;56
05;Ávila;109;Langa;657;345;312
05;Ávila;110;Lanzahíta;1003;511;492
05;Ávila;113;Llanos de Tormes (Los);200;103;97
05;Ávila;112;Losar del Barco (El);228;127;101
05;Ávila;114;Madrigal de las Altas Torres;2299;1185;1114
05;Ávila;115;Maello;716;362;354
05;Ávila;116;Malpartida de Corneja;314;153;161
05;Ávila;117;Mamblas;342;179;163
05;Ávila;118;Mancera de Arriba;236;121;115
05;Ávila;119;Manjabálago;120;64;56
05;Ávila;120;Marlín;52;27;25
05;Ávila;121;Martiherrero;239;120;119
05;Ávila;122;Martínez;303;159;144
05;Ávila;123;Mediana de Voltoya;123;68;55
05;Ávila;124;Medinilla;356;177;179
05;Ávila;125;Mengamuñoz;88;42;46
05;Ávila;126;Mesegar de Corneja;164;79;85
05;Ávila;127;Mijares;1164;597;567
05;Ávila;128;Mingorría;603;306;297
05;Ávila;129;Mirón (El);389;207;182
05;Ávila;130;Mironcillo;158;92;66
05;Ávila;131;Mirueña de los Infanzones;297;142;155
05;Ávila;132;Mombeltrán;1372;728;644
05;Ávila;133;Monsalupe;144;74;70
05;Ávila;134;Moraleja de Matacabras;91;43;48
05;Ávila;135;Muñana;665;348;317
05;Ávila;136;Muñico;209;111;98
05;Ávila;138;Muñogalindo;476;254;222
05;Ávila;139;Muñogrande;126;68;58
05;Ávila;140;Muñomer del Peco;141;83;58
05;Ávila;141;Muñopepe;120;59;61
05;Ávila;142;Muñosancho;225;102;123
05;Ávila;143;Muñotello;176;98;78
05;Ávila;144;Narrillos del Álamo;217;117;100
05;Ávila;145;Narrillos del Rebollar;111;56;55
05;Ávila;149;Narros de Saldueña;268;137;131
05;Ávila;147;Narros del Castillo;349;186;163
05;Ávila;148;Narros del Puerto;67;37;30
05;Ávila;152;Nava de Arévalo;1226;645;581
05;Ávila;153;Nava del Barco;264;125;139
05;Ávila;151;Navacepedilla de Corneja;184;94;90
05;Ávila;154;Navadijos;100;51;49
05;Ávila;155;Navaescurial;132;76;56
05;Ávila;156;Navahondilla;178;83;95
05;Ávila;157;Navalacruz;397;197;200
05;Ávila;158;Navalmoral;753;378;375
05;Ávila;159;Navalonguilla;602;301;301
05;Ávila;160;Navalosa;616;308;308
05;Ávila;161;Navalperal de Pinares;998;484;514
05;Ávila;162;Navalperal de Tormes;197;95;102
05;Ávila;163;Navaluenga;2179;1109;1070
05;Ávila;164;Navaquesera;128;66;62
05;Ávila;165;Navarredonda de Gredos;543;280;263
05;Ávila;166;Navarredondilla;354;172;182
05;Ávila;167;Navarrevisca;448;239;209
05;Ávila;168;Navas del Marqués (Las);4207;2120;2087
05;Ávila;169;Navatalgordo;1224;630;594
05;Ávila;170;Navatejares;203;95;108
05;Ávila;171;Neila de San Miguel;174;92;82
05;Ávila;172;Niharra;235;120;115
05;Ávila;173;Ojos-Albos;41;21;20
05;Ávila;174;Orbita;121;66;55
05;Ávila;175;Oso (El);285;150;135
05;Ávila;176;Padiernos;332;180;152
05;Ávila;177;Pajares de Adaja;240;124;116
05;Ávila;178;Palacios de Goda;633;302;331
05;Ávila;179;Papatrigo;411;201;210
05;Ávila;180;Parral (El);197;97;100
05;Ávila;181;Pascualcobo;79;40;39
05;Ávila;182;Pedro Bernardo;1935;1004;931
05;Ávila;183;Pedro-Rodríguez;266;130;136
05;Ávila;184;Peguerinos;428;222;206
05;Ávila;185;Peñalba de Ávila;173;97;76
05;Ávila;186;Piedrahíta;2424;1182;1242
05;Ávila;187;Piedralaves;2185;1095;1090
05;Ávila;188;Poveda;116;60;56
05;Ávila;189;Poyales del Hoyo;896;453;443
05;Ávila;190;Pozanco;79;44;35
05;Ávila;191;Pradosegar;222;117;105
05;Ávila;192;Puerto Castilla;202;95;107
05;Ávila;193;Rasueros;497;261;236
05;Ávila;194;Riocabado;255;144;111
05;Ávila;195;Riofrío;412;225;187
05;Ávila;196;Rivilla de Barajas;126;66;60
05;Ávila;197;Salobral;142;70;72
05;Ávila;198;Salvadiós;158;85;73
05;Ávila;199;San Bartolomé de Béjar;132;57;75
05;Ávila;200;San Bartolomé de Corneja;176;93;83
05;Ávila;201;San Bartolomé de Pinares;872;471;401
05;Ávila;206;San Esteban de los Patos;65;35;30
05;Ávila;208;San Esteban de Zapardiel;132;65;67
05;Ávila;207;San Esteban del Valle;1123;574;549
05;Ávila;209;San García de Ingelmos;240;125;115
05;Ávila;901;San Juan de Gredos;563;282;281
05;Ávila;210;San Juan de la Encinilla;183;83;100
05;Ávila;211;San Juan de la Nava;791;406;385
05;Ávila;212;San Juan del Molinillo;634;336;298
05;Ávila;213;San Juan del Olmo;254;135;119
05;Ávila;214;San Lorenzo de Tormes;95;44;51
05;Ávila;215;San Martín de la Vega del Alberche;377;211;166
05;Ávila;216;San Martín del Pimpollar;325;171;154
05;Ávila;217;San Miguel de Corneja;138;71;67
05;Ávila;218;San Miguel de Serrezuela;296;155;141
05;Ávila;219;San Pascual;80;40;40
05;Ávila;220;San Pedro del Arroyo;547;281;266
05;Ávila;231;San Vicente de Arévalo;262;132;130
05;Ávila;204;Sanchidrián;889;444;445
05;Ávila;205;Sanchorreja;165;87;78
05;Ávila;222;Santa Cruz de Pinares;267;155;112
05;Ávila;221;Santa Cruz del Valle;738;361;377
05;Ávila;226;Santa María de los Caballeros;236;118;118
05;Ávila;224;Santa María del Arroyo;170;80;90
05;Ávila;225;Santa María del Berrocal;789;385;404
05;Ávila;902;Santa María del Cubillo;483;264;219
05;Ávila;227;Santa María del Tiétar;381;192;189
05;Ávila;228;Santiago del Collado;371;218;153
05;Ávila;904;Santiago del Tormes;455;233;222
05;Ávila;229;Santo Domingo de las Posadas;115;58;57
05;Ávila;230;Santo Tomé de Zabarcos;150;79;71
05;Ávila;232;Serrada (La);166;88;78
05;Ávila;233;Serranillos;587;305;282
05;Ávila;234;Sigeres;95;42;53
05;Ávila;235;Sinlabajos;307;158;149
05;Ávila;236;Solana de Ávila;350;183;167
05;Ávila;237;Solana de Rioalmar;376;197;179
05;Ávila;238;Solosancho;1405;730;675
05;Ávila;239;Sotalbo;306;164;142
05;Ávila;240;Sotillo de la Adrada;3404;1722;1682
05;Ávila;241;Tiemblo (El);3869;1931;1938
05;Ávila;242;Tiñosillos;797;419;378
05;Ávila;243;Tolbaños;196;98;98
05;Ávila;244;Tormellas;152;75;77
05;Ávila;245;Tornadizos de Ávila;348;173;175
05;Ávila;247;Torre (La);581;310;271
05;Ávila;246;Tórtoles;186;99;87
05;Ávila;249;Umbrías;240;120;120
05;Ávila;251;Vadillo de la Sierra;221;129;92
05;Ávila;252;Valdecasa;159;83;76
05;Ávila;253;Vega de Santa María;170;91;79
05;Ávila;254;Velayos;342;169;173
05;Ávila;256;Villaflor;216;109;107
05;Ávila;257;Villafranca de la Sierra;302;163;139
05;Ávila;905;Villanueva de Ávila;"";"";""
05;Ávila;258;Villanueva de Gómez;211;103;108
05;Ávila;259;Villanueva del Aceral;261;123;138
05;Ávila;260;Villanueva del Campillo;274;143;131
05;Ávila;261;Villar de Corneja;123;58;65
05;Ávila;262;Villarejo del Valle;512;262;250
05;Ávila;263;Villatoro;282;150;132
05;Ávila;264;Viñegra de Moraña;101;57;44
05;Ávila;265;Vita;142;77;65
05;Ávila;266;Zapardiel de la Cañada;279;136;143
05;Ávila;267;Zapardiel de la Ribera;167;87;80
06;Badajoz;001;Acedera;1082;579;503
06;Badajoz;002;Aceuchal;5157;2582;2575
06;Badajoz;003;Ahillones;1395;691;704
06;Badajoz;004;Alange;2012;1046;966
06;Badajoz;005;Albuera (La);1800;906;894
06;Badajoz;006;Alburquerque;5525;2809;2716
06;Badajoz;007;Alconchel;2761;1378;1383
06;Badajoz;008;Alconera;857;441;416
06;Badajoz;009;Aljucén;223;125;98
06;Badajoz;010;Almendral;1535;756;779
06;Badajoz;011;Almendralejo;25356;12335;13021
06;Badajoz;012;Arroyo de San Serván;3780;1934;1846
06;Badajoz;013;Atalaya;386;191;195
06;Badajoz;014;Azuaga;10290;5094;5196
06;Badajoz;015;Badajoz;124616;60395;64221
06;Badajoz;016;Barcarrota;4349;2169;2180
06;Badajoz;017;Baterno;491;247;244
06;Badajoz;018;Benquerencia de la Serena;1396;694;702
06;Badajoz;019;Berlanga;2972;1483;1489
06;Badajoz;020;Bienvenida;2671;1342;1329
06;Badajoz;021;Bodonal de la Sierra;1567;785;782
06;Badajoz;022;Burguillos del Cerro;3370;1669;1701
06;Badajoz;023;Cabeza del Buey;6768;3329;3439
06;Badajoz;024;Cabeza la Vaca;1896;927;969
06;Badajoz;025;Calamonte;5562;2762;2800
06;Badajoz;026;Calera de León;1226;627;599
06;Badajoz;027;Calzadilla de los Barros;855;427;428
06;Badajoz;028;Campanario;6102;2921;3181
06;Badajoz;029;Campillo de Llerena;1870;928;942
06;Badajoz;030;Capilla;266;126;140
06;Badajoz;031;Carmonita;777;410;367
06;Badajoz;032;Carrascalejo (El);27;14;13
06;Badajoz;033;Casas de Don Pedro;1947;943;1004
06;Badajoz;034;Casas de Reina;328;148;180
06;Badajoz;035;Castilblanco;1839;927;912
06;Badajoz;036;Castuera;8293;4116;4177
06;Badajoz;042;Cheles;1429;719;710
06;Badajoz;037;Codosera (La);2740;1414;1326
06;Badajoz;038;Cordobilla de Lácara;1111;577;534
06;Badajoz;039;Coronada (La);2651;1331;1320
06;Badajoz;040;Corte de Peleas;1342;689;653
06;Badajoz;041;Cristina;554;295;259
06;Badajoz;043;Don Álvaro;604;302;302
06;Badajoz;044;Don Benito;29534;14817;14717
06;Badajoz;045;Entrín Bajo;698;341;357
06;Badajoz;046;Esparragalejo;1374;707;667
06;Badajoz;047;Esparragosa de la Serena;1205;596;609
06;Badajoz;048;Esparragosa de Lares;1412;690;722
06;Badajoz;049;Feria;1711;842;869
06;Badajoz;050;Fregenal de la Sierra;5971;2889;3082
06;Badajoz;051;Fuenlabrada de los Montes;2319;1157;1162
06;Badajoz;052;Fuente de Cantos;5139;2582;2557
06;Badajoz;053;Fuente del Arco;995;507;488
06;Badajoz;054;Fuente del Maestre;7021;3508;3513
06;Badajoz;055;Fuentes de León;3021;1435;1586
06;Badajoz;056;Garbayuela;634;334;300
06;Badajoz;057;Garlitos;960;481;479
06;Badajoz;058;Garrovilla (La);2729;1417;1312
06;Badajoz;059;Granja de Torrehermosa;2969;1459;1510
06;Badajoz;060;Guareña;7801;3911;3890
06;Badajoz;061;Haba (La);1891;916;975
06;Badajoz;062;Helechosa de los Montes;938;486;452
06;Badajoz;063;Herrera del Duque;4209;2105;2104
06;Badajoz;064;Higuera de la Serena;1407;700;707
06;Badajoz;065;Higuera de Llerena;652;309;343
06;Badajoz;066;Higuera de Vargas;3101;1546;1555
06;Badajoz;067;Higuera la Real;2925;1477;1448
06;Badajoz;068;Hinojosa del Valle;750;401;349
06;Badajoz;069;Hornachos;4136;2106;2030
06;Badajoz;070;Jerez de los Caballeros;9338;4655;4683
06;Badajoz;071;Lapa (La);377;188;189
06;Badajoz;073;Llera;1157;589;568
06;Badajoz;074;Llerena;5794;2782;3012
06;Badajoz;072;Lobón;2753;1432;1321
06;Badajoz;075;Magacela;983;504;479
06;Badajoz;076;Maguilla;1413;707;706
06;Badajoz;077;Malcocinado;728;385;343
06;Badajoz;078;Malpartida de la Serena;1068;532;536
06;Badajoz;079;Manchita;774;404;370
06;Badajoz;080;Medellín;2615;1327;1288
06;Badajoz;081;Medina de las Torres;1994;992;1002
06;Badajoz;082;Mengabril;535;275;260
06;Badajoz;083;Mérida;52991;25799;27192
06;Badajoz;084;Mirandilla;1355;680;675
06;Badajoz;085;Monesterio;5235;2610;2625
06;Badajoz;086;Montemolín;2008;1006;1002
06;Badajoz;087;Monterrubio de la Serena;3660;1797;1863
06;Badajoz;088;Montijo;14919;7321;7598
06;Badajoz;089;Morera (La);807;408;399
06;Badajoz;090;Nava de Santiago (La);1253;628;625
06;Badajoz;091;Navalvillar de Pela;5243;2635;2608
06;Badajoz;092;Nogales;804;412;392
06;Badajoz;093;Oliva de la Frontera;7034;3435;3599
06;Badajoz;094;Oliva de Mérida;2361;1179;1182
06;Badajoz;095;Olivenza;10601;5217;5384
06;Badajoz;096;Orellana de la Sierra;515;254;261
06;Badajoz;097;Orellana la Vieja;4377;2194;2183
06;Badajoz;098;Palomas;721;370;351
06;Badajoz;099;Parra (La);1445;743;702
06;Badajoz;100;Peñalsordo;1993;957;1036
06;Badajoz;101;Peraleda del Zaucejo;864;413;451
06;Badajoz;102;Puebla de Alcocer;1849;926;923
06;Badajoz;103;Puebla de la Calzada;5678;2847;2831
06;Badajoz;104;Puebla de la Reina;974;492;482
06;Badajoz;107;Puebla de Obando;2232;1135;1097
06;Badajoz;108;Puebla de Sancho Pérez;3076;1516;1560
06;Badajoz;105;Puebla del Maestre;1221;588;633
06;Badajoz;106;Puebla del Prior;654;344;310
06;Badajoz;109;Quintana de la Serena;5087;2525;2562
06;Badajoz;110;Reina;278;140;138
06;Badajoz;111;Rena;691;362;329
06;Badajoz;112;Retamal de Llerena;732;367;365
06;Badajoz;113;Ribera del Fresno;3651;1749;1902
06;Badajoz;114;Risco;278;142;136
06;Badajoz;115;Roca de la Sierra (La);1757;879;878
06;Badajoz;116;Salvaleón;2528;1306;1222
06;Badajoz;117;Salvatierra de los Barros;2078;1040;1038
06;Badajoz;119;San Pedro de Mérida;777;410;367
06;Badajoz;123;San Vicente de Alcántara;6244;3082;3162
06;Badajoz;118;Sancti-Spíritus;419;201;218
06;Badajoz;120;Santa Amalia;4321;2184;2137
06;Badajoz;121;Santa Marta;4125;2081;2044
06;Badajoz;122;Santos de Maimona (Los);7675;3841;3834
06;Badajoz;124;Segura de León;2537;1266;1271
06;Badajoz;125;Siruela;2761;1349;1412
06;Badajoz;126;Solana de los Barros;2810;1446;1364
06;Badajoz;127;Talarrubias;4053;1970;2083
06;Badajoz;128;Talavera la Real;5302;2686;2616
06;Badajoz;129;Táliga;821;427;394
06;Badajoz;130;Tamurejo;333;159;174
06;Badajoz;131;Torre de Miguel Sesmero;1356;664;692
06;Badajoz;132;Torremayor;1164;580;584
06;Badajoz;133;Torremejía;1928;981;947
06;Badajoz;134;Trasierra;740;390;350
06;Badajoz;135;Trujillanos;968;497;471
06;Badajoz;136;Usagre;2277;1160;1117
06;Badajoz;137;Valdecaballeros;1807;903;904
06;Badajoz;901;Valdelacalzada;"";"";""
06;Badajoz;138;Valdetorres;1490;748;742
06;Badajoz;139;Valencia de las Torres;1022;512;510
06;Badajoz;140;Valencia del Mombuey;1026;504;522
06;Badajoz;141;Valencia del Ventoso;2664;1328;1336
06;Badajoz;146;Valle de la Serena;2045;1002;1043
06;Badajoz;147;Valle de Matamoros;702;344;358
06;Badajoz;148;Valle de Santa Ana;1401;719;682
06;Badajoz;142;Valverde de Burguillos;403;197;206
06;Badajoz;143;Valverde de Leganés;3661;1852;1809
06;Badajoz;144;Valverde de Llerena;1001;491;510
06;Badajoz;145;Valverde de Mérida;1159;596;563
06;Badajoz;149;Villafranca de los Barros;12714;6243;6471
06;Badajoz;150;Villagarcía de la Torre;1180;603;577
06;Badajoz;151;Villagonzalo;1627;773;854
06;Badajoz;152;Villalba de los Barros;1764;872;892
06;Badajoz;153;Villanueva de la Serena;24371;12019;12352
06;Badajoz;154;Villanueva del Fresno;4084;2018;2066
06;Badajoz;156;Villar de Rena;2047;1080;967
06;Badajoz;155;Villar del Rey;2491;1279;1212
06;Badajoz;157;Villarta de los Montes;932;449;483
06;Badajoz;158;Zafra;14074;6728;7346
06;Badajoz;159;Zahínos;3221;1606;1615
06;Badajoz;160;Zalamea de la Serena;5898;2885;3013
06;Badajoz;162;Zarza (La);3712;1877;1835
06;Badajoz;161;Zarza-Capilla;757;371;386
07;Balears (Illes);002;Alaior;6356;3130;3226
07;Balears (Illes);001;Alaró;3627;1737;1890
07;Balears (Illes);003;Alcúdia;7938;3965;3973
07;Balears (Illes);004;Algaida;3150;1566;1584
07;Balears (Illes);005;Andratx;6795;3346;3449
07;Balears (Illes);901;Ariany;921;451;470
07;Balears (Illes);006;Artà;5926;2926;3000
07;Balears (Illes);007;Banyalbufar;453;224;229
07;Balears (Illes);008;Binissalem;4695;2285;2410
07;Balears (Illes);009;Búger;1016;496;520
07;Balears (Illes);010;Bunyola;3812;1886;1926
07;Balears (Illes);011;Calvià;21148;10965;10183
07;Balears (Illes);012;Campanet;2231;1108;1123
07;Balears (Illes);013;Campos;6605;3304;3301
07;Balears (Illes);014;Capdepera;6939;3519;3420
07;Balears (Illes);064;Castell (Es);5591;2815;2776
07;Balears (Illes);015;Ciutadella de Menorca;20715;10373;10342
07;Balears (Illes);016;Consell;2044;1007;1037
07;Balears (Illes);017;Costitx;763;363;400
07;Balears (Illes);018;Deyá;530;259;271
07;Balears (Illes);026;Eivissa;32314;16452;15862
07;Balears (Illes);019;Escorca;245;150;95
07;Balears (Illes);020;Esporles;3100;1526;1574
07;Balears (Illes);021;Estellencs;328;166;162
07;Balears (Illes);022;Felanitx;14368;7168;7200
07;Balears (Illes);023;Ferreries;3614;1939;1675
07;Balears (Illes);024;Formentera;5081;2608;2473
07;Balears (Illes);025;Fornalutx;561;281;280
07;Balears (Illes);027;Inca;22118;10973;11145
07;Balears (Illes);028;Lloret de Vistalegre;819;402;417
07;Balears (Illes);029;Lloseta;4509;2237;2272
07;Balears (Illes);030;Llubí;1953;962;991
07;Balears (Illes);031;Llucmajor;17319;8651;8668
07;Balears (Illes);032;Mahón;23983;11834;12149
07;Balears (Illes);033;Manacor;27898;13770;14128
07;Balears (Illes);034;Mancor de la Vall;948;460;488
07;Balears (Illes);035;Maria de la Salut;1887;926;961
07;Balears (Illes);036;Marratxí;11547;5822;5725
07;Balears (Illes);037;Mercadal (Es);3419;1739;1680
07;Balears (Illes);902;Migjorn Gran (Es);"";"";""
07;Balears (Illes);038;Montuïri;2131;1021;1110
07;Balears (Illes);039;Muro;5973;2950;3023
07;Balears (Illes);040;Palma de Mallorca;320692;157038;163654
07;Balears (Illes);041;Petra;2629;1259;1370
07;Balears (Illes);044;Pobla (Sa);10343;5123;5220
07;Balears (Illes);042;Pollença;12514;6241;6273
07;Balears (Illes);043;Porreres;4463;2217;2246
07;Balears (Illes);045;Puigpunyent;1126;567;559
07;Balears (Illes);059;Salines (Ses);3093;1564;1529
07;Balears (Illes);046;Sant Antoni de Portmany;14333;7210;7123
07;Balears (Illes);049;Sant Joan;1734;848;886
07;Balears (Illes);050;Sant Joan de Labritja;3727;1841;1886
07;Balears (Illes);048;Sant Josep de sa Talaia;10099;5189;4910
07;Balears (Illes);051;Sant Llorenç des Cardassar;4531;2284;2247
07;Balears (Illes);052;Sant Lluís;3190;1604;1586
07;Balears (Illes);053;Santa Eugènia;929;454;475
07;Balears (Illes);054;Santa Eulalia del Río;16924;8615;8309
07;Balears (Illes);055;Santa Margalida;5789;2935;2854
07;Balears (Illes);056;Santa María del Camí;4139;2057;2082
07;Balears (Illes);057;Santanyí;7133;3629;3504
07;Balears (Illes);058;Selva;3032;1495;1537
07;Balears (Illes);047;Sencelles;1587;762;825
07;Balears (Illes);060;Sineu;2643;1312;1331
07;Balears (Illes);061;Sóller;10378;5063;5315
07;Balears (Illes);062;Son Servera;7020;3591;3429
07;Balears (Illes);063;Valldemossa;1370;656;714
07;Balears (Illes);065;Vilafranca de Bonany;2179;1070;1109
08;Barcelona;001;Abrera;5026;2583;2443
08;Barcelona;002;Aguilar de Segarra;212;105;107
08;Barcelona;014;Aiguafreda;2048;1002;1046
08;Barcelona;003;Alella;6170;3030;3140
08;Barcelona;004;Alpens;249;133;116
08;Barcelona;005;Ametlla del Vallès (L');3051;1488;1563
08;Barcelona;006;Arenys de Mar;10917;5281;5636
08;Barcelona;007;Arenys de Munt;4796;2313;2483
08;Barcelona;008;Argençola;193;103;90
08;Barcelona;009;Argentona;7804;3900;3904
08;Barcelona;010;Artés;4110;2000;2110
08;Barcelona;011;Avià;1805;921;884
08;Barcelona;012;Avinyó;2033;995;1038
08;Barcelona;013;Avinyonet del Penedès;1194;602;592
08;Barcelona;015;Badalona;225292;112327;112965
08;Barcelona;904;Badia del Vallès;"";"";""
08;Barcelona;016;Bagà;2147;1078;1069
08;Barcelona;017;Balenyà;3228;1651;1577
08;Barcelona;018;Balsareny;3448;1686;1762
08;Barcelona;252;Barberà del Vallès;31184;16185;14999
08;Barcelona;019;Barcelona;1712350;812260;900090
08;Barcelona;020;Begues;1819;867;952
08;Barcelona;021;Bellprat;90;47;43
08;Barcelona;022;Berga;14014;6824;7190
08;Barcelona;023;Bigues i Riells;2423;1238;1185
08;Barcelona;024;Borredà;446;211;235
08;Barcelona;025;Bruc (El);738;380;358
08;Barcelona;026;Brull (El);176;94;82
08;Barcelona;027;Cabanyes (Les);386;207;179
08;Barcelona;029;Cabrera de Mar;2564;1281;1283
08;Barcelona;028;Cabrera d'Igualada;261;142;119
08;Barcelona;030;Cabrils;2626;1279;1347
08;Barcelona;031;Calaf;3166;1559;1607
08;Barcelona;034;Calders;530;279;251
08;Barcelona;033;Caldes de Montbui;10833;5366;5467
08;Barcelona;032;Caldes d'Estrac;1448;713;735
08;Barcelona;035;Calella;11763;5525;6238
08;Barcelona;037;Calldetenes;1457;739;718
08;Barcelona;038;Callús;1511;728;783
08;Barcelona;036;Calonge de Segarra;203;109;94
08;Barcelona;039;Campins;192;92;100
08;Barcelona;040;Canet de Mar;8756;4293;4463
08;Barcelona;041;Canovelles;12906;6482;6424
08;Barcelona;042;Cànoves i Samalús;806;400;406
08;Barcelona;043;Canyelles;641;348;293
08;Barcelona;044;Capellades;4940;2422;2518
08;Barcelona;045;Capolat;110;59;51
08;Barcelona;046;Cardedeu;8612;4281;4331
08;Barcelona;047;Cardona;6674;3259;3415
08;Barcelona;048;Carme;705;365;340
08;Barcelona;049;Casserres;1791;874;917
08;Barcelona;057;Castell de l'Areny;53;28;25
08;Barcelona;052;Castellar de n'Hug;181;97;84
08;Barcelona;050;Castellar del Riu;63;36;27
08;Barcelona;051;Castellar del Vallès;12641;6286;6355
08;Barcelona;053;Castellbell i el Vilar;3306;1612;1694
08;Barcelona;054;Castellbisbal;4477;2323;2154
08;Barcelona;055;Castellcir;234;128;106
08;Barcelona;056;Castelldefels;31114;15596;15518
08;Barcelona;058;Castellet i la Gornal;1090;553;537
08;Barcelona;060;Castellfollit de Riubregós;272;136;136
08;Barcelona;059;Castellfollit del Boix;318;153;165
08;Barcelona;061;Castellgalí;703;354;349
08;Barcelona;062;Castellnou de Bages;147;78;69
08;Barcelona;063;Castellolí;430;208;222
08;Barcelona;064;Castellterçol;1981;949;1032
08;Barcelona;065;Castellví de la Marca;1426;706;720
08;Barcelona;066;Castellví de Rosanes;533;270;263
08;Barcelona;067;Centelles;5706;2812;2894
08;Barcelona;268;Cercs;1764;879;885
08;Barcelona;266;Cerdanyola del Vallès;55642;27902;27740
08;Barcelona;068;Cervelló;4931;2490;2441
08;Barcelona;069;Collbató;935;470;465
08;Barcelona;070;Collsuspina;214;110;104
08;Barcelona;071;Copons;305;151;154
08;Barcelona;072;Corbera de Llobregat;4581;2317;2264
08;Barcelona;073;Cornellà de Llobregat;86713;42957;43756
08;Barcelona;074;Cubelles;2831;1443;1388
08;Barcelona;075;Dosrius;1086;575;511
08;Barcelona;076;Esparreguera;11915;5988;5927
08;Barcelona;077;Esplugues de Llobregat;48856;24317;24539
08;Barcelona;078;Espunyola (L');307;162;145
08;Barcelona;079;Estany (L');388;181;207
08;Barcelona;134;Figaró-Montmany;614;316;298
08;Barcelona;080;Fígols;30;15;15
08;Barcelona;082;Fogars de la Selva;366;182;184
08;Barcelona;081;Fogars de Montclús;267;135;132
08;Barcelona;083;Folgueroles;1093;539;554
08;Barcelona;084;Fonollosa;660;331;329
08;Barcelona;085;Font-rubí;1119;577;542
08;Barcelona;086;Franqueses del Vallès (Les);9886;4984;4902
08;Barcelona;090;Gaià;148;77;71
08;Barcelona;087;Gallifa;86;44;42
08;Barcelona;088;Garriga (La);9060;4384;4676
08;Barcelona;089;Gavà;35289;17676;17613
08;Barcelona;091;Gelida;3862;1925;1937
08;Barcelona;092;Gironella;5290;2531;2759
08;Barcelona;093;Gisclareny;31;16;15
08;Barcelona;094;Granada (La);1211;592;619
08;Barcelona;095;Granera;59;35;24
08;Barcelona;096;Granollers;50000;24621;25379
08;Barcelona;097;Gualba;587;297;290
08;Barcelona;099;Guardiola de Berguedà;1240;599;641
08;Barcelona;100;Gurb;1715;890;825
08;Barcelona;101;Hospitalet de Llobregat (L');277407;137191;140216
08;Barcelona;162;Hostalets de Pierola (Els);850;429;421
08;Barcelona;102;Igualada;31752;15461;16291
08;Barcelona;103;Jorba;522;264;258
08;Barcelona;104;Llacuna (La);755;390;365
08;Barcelona;105;Llagosta (La);12162;6062;6100
08;Barcelona;107;Lliçà d'Amunt;4598;2324;2274
08;Barcelona;108;Lliçà de Vall;2723;1414;1309
08;Barcelona;106;Llinars del Vallès;5293;2690;2603
08;Barcelona;109;Lluçà;292;162;130
08;Barcelona;110;Malgrat de Mar;11274;5566;5708
08;Barcelona;111;Malla;255;119;136
08;Barcelona;112;Manlleu;16509;8173;8336
08;Barcelona;113;Manresa;65676;31678;33998
08;Barcelona;242;Marganell;218;85;133
08;Barcelona;114;Martorell;16445;8223;8222
08;Barcelona;115;Martorelles;4874;2421;2453
08;Barcelona;116;Masies de Roda (Les);630;307;323
08;Barcelona;117;Masies de Voltregà (Les);2474;1212;1262
08;Barcelona;118;Masnou (El);17422;8396;9026
08;Barcelona;119;Masquefa;2561;1270;1291
08;Barcelona;120;Matadepera;4074;2072;2002
08;Barcelona;121;Mataró;101352;49766;51586
08;Barcelona;122;Mediona;993;510;483
08;Barcelona;138;Moià;3234;1570;1664
08;Barcelona;123;Molins de Rei;18395;9060;9335
08;Barcelona;124;Mollet del Vallès;39402;19658;19744
08;Barcelona;128;Monistrol de Calders;612;307;305
08;Barcelona;127;Monistrol de Montserrat;2556;1259;1297
08;Barcelona;125;Montcada i Reixac;26916;13364;13552
08;Barcelona;130;Montclar;257;112;145
08;Barcelona;131;Montesquiu;867;414;453
08;Barcelona;126;Montgat;7376;3645;3731
08;Barcelona;132;Montmajor;694;344;350
08;Barcelona;133;Montmaneu;272;158;114
08;Barcelona;135;Montmeló;7248;3611;3637
08;Barcelona;136;Montornès del Vallès;10718;5375;5343
08;Barcelona;137;Montseny;273;141;132
08;Barcelona;129;Muntanyola;172;99;73
08;Barcelona;139;Mura;187;102;85
08;Barcelona;140;Navarcles;5151;2566;2585
08;Barcelona;141;Navàs;5374;2630;2744
08;Barcelona;142;Nou de Berguedà (La);139;77;62
08;Barcelona;143;Òdena;2545;1301;1244
08;Barcelona;145;Olèrdola;1552;813;739
08;Barcelona;146;Olesa de Bonesvalls;349;182;167
08;Barcelona;147;Olesa de Montserrat;14635;7278;7357
08;Barcelona;148;Olivella;237;119;118
08;Barcelona;149;Olost;962;472;490
08;Barcelona;144;Olvan;1079;515;564
08;Barcelona;150;Orís;231;119;112
08;Barcelona;151;Oristà;900;449;451
08;Barcelona;152;Orpí;144;73;71
08;Barcelona;153;Òrrius;356;188;168
08;Barcelona;154;Pacs del Penedès;396;210;186
08;Barcelona;155;Palafolls;3224;1609;1615
08;Barcelona;156;Palau-solità i Plegamans;6315;3260;3055
08;Barcelona;157;Pallejà;6213;3081;3132
08;Barcelona;905;Palma de Cervelló (La);"";"";""
08;Barcelona;158;Papiol (El);3134;1538;1596
08;Barcelona;159;Parets del Vallès;10475;5261;5214
08;Barcelona;160;Perafita;348;166;182
08;Barcelona;161;Piera;5567;2793;2774
08;Barcelona;163;Pineda de Mar;15228;7628;7600
08;Barcelona;164;Pla del Penedès (El);1012;511;501
08;Barcelona;165;Pobla de Claramunt (La);1672;837;835
08;Barcelona;166;Pobla de Lillet (La);1842;914;928
08;Barcelona;167;Polinyà;3133;1569;1564
08;Barcelona;182;Pont de Vilomara i Rocafort (El);2212;1093;1119
08;Barcelona;168;Pontons;227;120;107
08;Barcelona;169;Prat de Llobregat (El);64959;32741;32218
08;Barcelona;171;Prats de Lluçanès;2528;1270;1258
08;Barcelona;170;Prats de Rei (Els);566;274;292
08;Barcelona;230;Premià de Dalt;5867;2952;2915
08;Barcelona;172;Premià de Mar;21720;10914;10806
08;Barcelona;174;Puigdàlber;308;149;159
08;Barcelona;175;Puig-reig;5027;2480;2547
08;Barcelona;176;Pujalt;176;91;85
08;Barcelona;177;Quar (La);38;18;20
08;Barcelona;178;Rajadell;268;141;127
08;Barcelona;179;Rellinars;202;97;105
08;Barcelona;180;Ripollet;26408;13176;13232
08;Barcelona;181;Roca del Vallès (La);5571;2787;2784
08;Barcelona;183;Roda de Ter;4762;2294;2468
08;Barcelona;184;Rubí;50012;25183;24829
08;Barcelona;185;Rubió;121;63;58
08;Barcelona;901;Rupit i Pruit;362;182;180
08;Barcelona;187;Sabadell;190962;93551;97411
08;Barcelona;188;Sagàs;247;129;118
08;Barcelona;190;Saldes;331;188;143
08;Barcelona;191;Sallent;7803;3773;4030
08;Barcelona;194;Sant Adrià de Besòs;34813;17330;17483
08;Barcelona;195;Sant Agustí de Lluçanès;126;68;58
08;Barcelona;196;Sant Andreu de la Barca;15154;7657;7497
08;Barcelona;197;Sant Andreu de Llavaneres;4076;2042;2034
08;Barcelona;198;Sant Antoni de Vilamajor;1965;968;997
08;Barcelona;199;Sant Bartomeu del Grau;1112;585;527
08;Barcelona;200;Sant Boi de Llobregat;78369;39355;39014
08;Barcelona;201;Sant Boi de Lluçanès;532;268;264
08;Barcelona;203;Sant Cebrià de Vallalta;765;405;360
08;Barcelona;202;Sant Celoni;12463;6197;6266
08;Barcelona;204;Sant Climent de Llobregat;2189;1088;1101
08;Barcelona;205;Sant Cugat del Vallès;38470;18958;19512
08;Barcelona;206;Sant Cugat Sesgarrigues;720;362;358
08;Barcelona;207;Sant Esteve de Palautordera;1100;567;533
08;Barcelona;208;Sant Esteve Sesrovires;2221;1137;1084
08;Barcelona;210;Sant Feliu de Codines;3472;1679;1793
08;Barcelona;211;Sant Feliu de Llobregat;37822;18827;18995
08;Barcelona;212;Sant Feliu Sasserra;661;325;336
08;Barcelona;209;Sant Fost de Campsentelles;4425;2252;2173
08;Barcelona;213;Sant Fruitós de Bages;4736;2368;2368
08;Barcelona;215;Sant Hipòlit de Voltregà;2961;1421;1540
08;Barcelona;193;Sant Iscle de Vallalta;497;259;238
08;Barcelona;216;Sant Jaume de Frontanyà;28;17;11
08;Barcelona;218;Sant Joan de Vilatorrada;7872;3931;3941
08;Barcelona;217;Sant Joan Despí;24576;12330;12246
08;Barcelona;903;Sant Julià de Cerdanyola;"";"";""
08;Barcelona;220;Sant Julià de Vilatorta;1760;861;899
08;Barcelona;221;Sant Just Desvern;12078;5831;6247
08;Barcelona;222;Sant Llorenç d'Hortons;977;496;481
08;Barcelona;223;Sant Llorenç Savall;1878;872;1006
08;Barcelona;225;Sant Martí d'Albars;134;75;59
08;Barcelona;224;Sant Martí de Centelles;667;335;332
08;Barcelona;226;Sant Martí de Tous;1001;502;499
08;Barcelona;227;Sant Martí Sarroca;2397;1199;1198
08;Barcelona;228;Sant Martí Sesgueioles;384;195;189
08;Barcelona;229;Sant Mateu de Bages;590;300;290
08;Barcelona;231;Sant Pere de Ribes;13258;6687;6571
08;Barcelona;232;Sant Pere de Riudebitlles;2176;1066;1110
08;Barcelona;233;Sant Pere de Torelló;2024;940;1084
08;Barcelona;234;Sant Pere de Vilamajor;969;509;460
08;Barcelona;189;Sant Pere Sallavinera;183;93;90
08;Barcelona;235;Sant Pol de Mar;2491;1225;1266
08;Barcelona;236;Sant Quintí de Mediona;1568;788;780
08;Barcelona;237;Sant Quirze de Besora;2060;990;1070
08;Barcelona;238;Sant Quirze del Vallès;8108;3999;4109
08;Barcelona;239;Sant Quirze Safaja;254;123;131
08;Barcelona;240;Sant Sadurní d'Anoia;9078;4553;4525
08;Barcelona;241;Sant Sadurní d'Osormort;82;40;42
08;Barcelona;098;Sant Salvador de Guardiola;1000;515;485
08;Barcelona;262;Sant Vicenç de Castellet;7633;3676;3957
08;Barcelona;264;Sant Vicenç de Montalt;1681;844;837
08;Barcelona;265;Sant Vicenç de Torelló;1729;825;904
08;Barcelona;263;Sant Vicenç dels Horts;20899;10457;10442
08;Barcelona;243;Santa Cecilia de Voltregà;189;107;82
08;Barcelona;244;Santa Coloma de Cervelló;2835;1411;1424
08;Barcelona;245;Santa Coloma de Gramenet;135690;67907;67783
08;Barcelona;246;Santa Eugènia de Berga;1482;761;721
08;Barcelona;247;Santa Eulàlia de Riuprimer;854;434;420
08;Barcelona;248;Santa Eulàlia de Ronçana;2800;1428;1372
08;Barcelona;249;Santa Fe del Penedès;187;86;101
08;Barcelona;250;Santa Margarida de Montbui;9318;4685;4633
08;Barcelona;251;Santa Margarida i els Monjos;3672;1906;1766
08;Barcelona;253;Santa Maria de Besora;204;100;104
08;Barcelona;254;Santa Maria de Corcó;2000;978;1022
08;Barcelona;256;Santa Maria de Martorelles;431;219;212
08;Barcelona;255;Santa Maria de Merlès;263;133;130
08;Barcelona;257;Santa Maria de Miralles;114;58;56
08;Barcelona;259;Santa Maria de Palautordera;4664;2372;2292
08;Barcelona;258;Santa Maria d'Oló;1056;537;519
08;Barcelona;260;Santa Perpètua de Mogoda;16416;8313;8103
08;Barcelona;261;Santa Susanna;788;391;397
08;Barcelona;192;Santpedor;4222;2040;2182
08;Barcelona;267;Sentmenat;4182;2087;2095
08;Barcelona;269;Seva;1701;853;848
08;Barcelona;270;Sitges;13161;6427;6734
08;Barcelona;271;Sobremunt;83;42;41
08;Barcelona;272;Sora;227;119;108
08;Barcelona;273;Subirats;2146;1090;1056
08;Barcelona;274;Súria;6625;3291;3334
08;Barcelona;276;Tagamanent;143;73;70
08;Barcelona;277;Talamanca;68;37;31
08;Barcelona;278;Taradell;4446;2206;2240
08;Barcelona;275;Tavèrnoles;213;105;108
08;Barcelona;280;Tavertet;109;56;53
08;Barcelona;281;Teià;3327;1680;1647
08;Barcelona;279;Terrassa;161625;79130;82495
08;Barcelona;282;Tiana;4450;2258;2192
08;Barcelona;283;Tona;5471;2722;2749
08;Barcelona;284;Tordera;8093;4065;4028
08;Barcelona;285;Torelló;11561;5679;5882
08;Barcelona;286;Torre de Claramunt (La);1578;820;758
08;Barcelona;287;Torrelavit;1178;605;573
08;Barcelona;288;Torrelles de Foix;1160;619;541
08;Barcelona;289;Torrelles de Llobregat;2103;1077;1026
08;Barcelona;290;Ullastrell;909;455;454
08;Barcelona;291;Vacarisses;745;380;365
08;Barcelona;292;Vallbona d'Anoia;1041;522;519
08;Barcelona;293;Vallcebre;327;174;153
08;Barcelona;294;Vallgorguina;695;343;352
08;Barcelona;295;Vallirana;5825;2916;2909
08;Barcelona;296;Vallromanes;507;256;251
08;Barcelona;297;Veciana;190;100;90
08;Barcelona;298;Vic;28919;13827;15092
08;Barcelona;299;Vilada;611;311;300
08;Barcelona;301;Viladecans;47165;23874;23291
08;Barcelona;300;Viladecavalls;2960;1507;1453
08;Barcelona;305;Vilafranca del Penedès;27508;13404;14104
08;Barcelona;306;Vilalba Sasserra;296;155;141
08;Barcelona;303;Vilanova de Sau;329;158;171
08;Barcelona;302;Vilanova del Camí;9007;4519;4488
08;Barcelona;902;Vilanova del Vallès;1292;634;658
08;Barcelona;307;Vilanova i la Geltrú;46848;23198;23650
08;Barcelona;214;Vilassar de Dalt;6622;3248;3374
08;Barcelona;219;Vilassar de Mar;11714;5804;5910
08;Barcelona;304;Vilobí del Penedès;771;387;384
08;Barcelona;308;Viver i Serrateix;222;118;104
09;Burgos;001;Abajas;56;29;27
09;Burgos;003;Adrada de Haza;331;179;152
09;Burgos;006;Aguas Cándidas;130;73;57
09;Burgos;007;Aguilar de Bureba;124;68;56
09;Burgos;009;Albillos;167;97;70
09;Burgos;010;Alcocero de Mola;68;40;28
09;Burgos;011;Alfoz de Bricia;164;79;85
09;Burgos;907;Alfoz de Quintanadueñas;465;233;232
09;Burgos;012;Alfoz de Santa Gadea;165;88;77
09;Burgos;013;Altable;78;45;33
09;Burgos;014;Altos (Los);329;190;139
09;Burgos;016;Ameyugo;71;46;25
09;Burgos;017;Anguix;197;102;95
09;Burgos;018;Aranda de Duero;29211;14726;14485
09;Burgos;019;Arandilla;238;143;95
09;Burgos;020;Arauzo de Miel;481;262;219
09;Burgos;021;Arauzo de Salce;101;60;41
09;Burgos;022;Arauzo de Torre;139;78;61
09;Burgos;023;Arcos;280;156;124
09;Burgos;024;Arenillas de Riopisuerga;245;138;107
09;Burgos;025;Arija;327;148;179
09;Burgos;026;Arlanzón;440;225;215
09;Burgos;027;Arraya de Oca;50;26;24
09;Burgos;029;Atapuerca;179;83;96
09;Burgos;030;Ausines (Los);139;75;64
09;Burgos;032;Avellanosa de Muñó;232;124;108
09;Burgos;033;Bahabón de Esgueva;198;114;84
09;Burgos;034;Balbases (Los);443;234;209
09;Burgos;035;Baños de Valdearados;619;346;273
09;Burgos;036;Bañuelos de Bureba;60;40;20
09;Burgos;037;Barbadillo de Herreros;162;78;84
09;Burgos;038;Barbadillo del Mercado;225;111;114
09;Burgos;039;Barbadillo del Pez;141;78;63
09;Burgos;041;Barrio de Muñó;44;23;21
09;Burgos;043;Barrios de Bureba (Los);365;187;178
09;Burgos;044;Barrios de Colina;78;44;34
09;Burgos;045;Basconcillos del Tozo;513;268;245
09;Burgos;046;Bascuñana;97;53;44
09;Burgos;047;Belbimbre;88;44;44
09;Burgos;048;Belorado;2168;1099;1069
09;Burgos;050;Berberana;114;61;53
09;Burgos;051;Berlangas de Roa;371;186;185
09;Burgos;052;Berzosa de Bureba;61;34;27
09;Burgos;054;Bozoó;102;53;49
09;Burgos;055;Brazacorta;105;55;50
09;Burgos;056;Briviesca;5428;2717;2711
09;Burgos;057;Bugedo;118;84;34
09;Burgos;058;Buniel;167;89;78
09;Burgos;059;Burgos;161538;78739;82799
09;Burgos;060;Busto de Bureba;383;198;185
09;Burgos;061;Cabañes de Esgueva;345;171;174
09;Burgos;062;Cabezón de la Sierra;57;25;32
09;Burgos;063;Cabia;234;137;97
09;Burgos;064;Caleruega;475;258;217
09;Burgos;065;Campillo de Aranda;215;115;100
09;Burgos;066;Campolara;108;59;49
09;Burgos;067;Canicosa de la Sierra;745;371;374
09;Burgos;068;Cantabrana;79;43;36
09;Burgos;070;Carazo;54;29;25
09;Burgos;071;Carcedo de Bureba;50;27;23
09;Burgos;072;Carcedo de Burgos;108;64;44
09;Burgos;073;Cardeñadijo;350;193;157
09;Burgos;074;Cardeñajimeno;323;174;149
09;Burgos;075;Cardeñuela Riopico;59;31;28
09;Burgos;076;Carrias;68;43;25
09;Burgos;077;Cascajares de Bureba;76;42;34
09;Burgos;078;Cascajares de la Sierra;35;18;17
09;Burgos;079;Castellanos de Castro;82;47;35
09;Burgos;083;Castil de Peones;58;29;29
09;Burgos;082;Castildelgado;101;51;50
09;Burgos;084;Castrillo de la Reina;385;225;160
09;Burgos;085;Castrillo de la Vega;702;361;341
09;Burgos;088;Castrillo de Riopisuerga;123;70;53
09;Burgos;086;Castrillo del Val;139;87;52
09;Burgos;090;Castrillo Matajudíos;85;46;39
09;Burgos;091;Castrojeriz;1211;606;605
09;Burgos;093;Cayuela;129;76;53
09;Burgos;094;Cebrecos;86;46;40
09;Burgos;095;Celada del Camino;102;47;55
09;Burgos;098;Cerezo de Río Tirón;959;502;457
09;Burgos;100;Cerratón de Juarros;75;40;35
09;Burgos;101;Ciadoncha;151;80;71
09;Burgos;102;Cillaperlata;100;54;46
09;Burgos;103;Cilleruelo de Abajo;427;232;195
09;Burgos;104;Cilleruelo de Arriba;106;59;47
09;Burgos;105;Ciruelos de Cervera;216;109;107
09;Burgos;108;Cogollos;219;120;99
09;Burgos;109;Condado de Treviño;1047;570;477
09;Burgos;110;Contreras;104;62;42
09;Burgos;112;Coruña del Conde;208;116;92
09;Burgos;113;Covarrubias;722;371;351
09;Burgos;114;Cubillo del Campo;74;41;33
09;Burgos;115;Cubo de Bureba;168;84;84
09;Burgos;117;Cueva de Roa (La);156;90;66
09;Burgos;119;Cuevas de San Clemente;104;47;57
09;Burgos;120;Encío;58;33;25
09;Burgos;122;Espinosa de Cervera;128;79;49
09;Burgos;124;Espinosa de los Monteros;2465;1274;1191
09;Burgos;123;Espinosa del Camino;62;32;30
09;Burgos;125;Estépar;1013;532;481
09;Burgos;127;Fontioso;116;62;54
09;Burgos;128;Frandovínez;95;51;44
09;Burgos;129;Fresneda de la Sierra Tirón;134;66;68
09;Burgos;130;Fresneña;167;91;76
09;Burgos;131;Fresnillo de las Dueñas;355;187;168
09;Burgos;132;Fresno de Río Tirón;315;179;136
09;Burgos;133;Fresno de Rodilla;37;20;17
09;Burgos;134;Frías;337;176;161
09;Burgos;135;Fuentebureba;142;68;74
09;Burgos;136;Fuentecén;372;209;163
09;Burgos;137;Fuentelcésped;279;136;143
09;Burgos;138;Fuentelisendo;158;87;71
09;Burgos;139;Fuentemolinos;162;89;73
09;Burgos;140;Fuentenebro;228;127;101
09;Burgos;141;Fuentespina;599;315;284
09;Burgos;143;Galbarros;33;22;11
09;Burgos;144;Gallega (La);105;59;46
09;Burgos;148;Grijalba;184;87;97
09;Burgos;149;Grisaleña;80;48;32
09;Burgos;151;Gumiel de Izán;743;394;349
09;Burgos;152;Gumiel de Mercado;523;272;251
09;Burgos;154;Hacinas;231;124;107
09;Burgos;155;Haza;48;27;21
09;Burgos;159;Hontanas;102;58;44
09;Burgos;160;Hontangas;193;105;88
09;Burgos;162;Hontoria de la Cantera;167;77;90
09;Burgos;164;Hontoria de Valdearados;306;178;128
09;Burgos;163;Hontoria del Pinar;1080;584;496
09;Burgos;166;Hormazas (Las);185;94;91
09;Burgos;167;Hornillos del Camino;108;54;54
09;Burgos;168;Horra (La);559;292;267
09;Burgos;169;Hortigüela;127;74;53
09;Burgos;170;Hoyales de Roa;396;192;204
09;Burgos;172;Huérmeces;173;98;75
09;Burgos;173;Huerta de Arriba;241;124;117
09;Burgos;174;Huerta de Rey;1314;690;624
09;Burgos;175;Humada;349;201;148
09;Burgos;176;Hurones;71;42;29
09;Burgos;177;Ibeas de Juarros;853;452;401
09;Burgos;178;Ibrillos;129;71;58
09;Burgos;179;Iglesiarrubia;76;41;35
09;Burgos;180;Iglesias;237;122;115
09;Burgos;181;Isar;493;233;260
09;Burgos;182;Itero del Castillo;160;76;84
09;Burgos;183;Jaramillo de la Fuente;41;19;22
09;Burgos;184;Jaramillo Quemado;25;14;11
09;Burgos;189;Junta de Traslaloma;244;130;114
09;Burgos;190;Junta de Villalba de Losa;111;61;50
09;Burgos;191;Jurisdicción de Lara;65;35;30
09;Burgos;192;Jurisdicción de San Zadornil;92;50;42
09;Burgos;194;Lerma;2622;1311;1311
09;Burgos;195;Llano de Bureba;81;44;37
09;Burgos;196;Madrigal del Monte;198;95;103
09;Burgos;197;Madrigalejo del Monte;171;94;77
09;Burgos;198;Mahamud;199;98;101
09;Burgos;199;Mambrilla de Castrejón;188;96;92
09;Burgos;200;Mambrillas de Lara;89;47;42
09;Burgos;201;Mamolar;113;63;50
09;Burgos;202;Manciles;52;27;25
09;Burgos;206;Mazuela;99;50;49
09;Burgos;208;Mecerreyes;382;181;201
09;Burgos;209;Medina de Pomar;5405;2687;2718
09;Burgos;211;Melgar de Fernamental;2236;1124;1112
09;Burgos;213;Merindad de Cuesta-Urria;655;362;293
09;Burgos;214;Merindad de Montija;1100;582;518
09;Burgos;431;Villafranca Montes de Oca;236;124;112
09;Burgos;432;Villafruela;374;194;180
09;Burgos;433;Villagalijo;84;47;37
09;Burgos;434;Villagonzalo Pedernales;489;246;243
09;Burgos;437;Villahoz;505;247;258
09;Burgos;438;Villalba de Duero;544;293;251
09;Burgos;439;Villalbilla de Burgos;514;286;228
09;Burgos;440;Villalbilla de Gumiel;167;90;77
09;Burgos;441;Villaldemiro;96;45;51
09;Burgos;442;Villalmanzo;479;260;219
09;Burgos;443;Villamayor de los Montes;325;162;163
09;Burgos;444;Villamayor de Treviño;132;76;56
09;Burgos;445;Villambistia;102;56;46
09;Burgos;446;Villamedianilla;40;18;22
09;Burgos;447;Villamiel de la Sierra;42;25;17
09;Burgos;448;Villangómez;426;216;210
09;Burgos;449;Villanueva de Argaño;124;71;53
09;Burgos;450;Villanueva de Carazo;28;18;10
09;Burgos;451;Villanueva de Gumiel;339;181;158
09;Burgos;454;Villanueva de Teba;99;55;44
09;Burgos;455;Villaquirán de la Puebla;72;40;32
09;Burgos;456;Villaquirán de los Infantes;244;125;119
09;Burgos;903;Villarcayo de Merindad de Castilla la Vieja;4481;2220;2261
09;Burgos;458;Villariezo;145;78;67
09;Burgos;460;Villasandino;351;181;170
09;Burgos;463;Villasur de Herreros;304;156;148
09;Burgos;464;Villatuelda;96;54;42
09;Burgos;466;Villaverde del Monte;255;139;116
09;Burgos;467;Villaverde-Mogina;157;89;68
09;Burgos;471;Villayerno Morquillas;134;64;70
09;Burgos;472;Villazopeque;102;57;45
09;Burgos;473;Villegas;160;78;82
09;Burgos;476;Villoruebo;38;26;12
09;Burgos;424;Viloria de Rioja;87;45;42
09;Burgos;425;Vilviestre del Pinar;927;467;460
09;Burgos;478;Vizcaínos;64;33;31
09;Burgos;480;Zael;175;85;90
09;Burgos;482;Zarzosa de Río Pisuerga;79;39;40
09;Burgos;483;Zazuar;360;189;171
09;Burgos;485;Zuñeda;124;67;57
09;Burgos;906;Merindad de Río Ubierna;1029;553;476
09;Burgos;215;Merindad de Sotoscueva;764;390;374
09;Burgos;216;Merindad de Valdeporres;604;313;291
09;Burgos;217;Merindad de Valdivielso;706;355;351
09;Burgos;218;Milagros;456;233;223
09;Burgos;219;Miranda de Ebro;36272;18134;18138
09;Burgos;220;Miraveche;155;81;74
09;Burgos;221;Modúbar de la Emparedada;204;112;92
09;Burgos;223;Monasterio de la Sierra;30;16;14
09;Burgos;224;Monasterio de Rodilla;219;113;106
09;Burgos;225;Moncalvillo;168;94;74
09;Burgos;226;Monterrubio de la Demanda;107;63;44
09;Burgos;227;Montorio;194;90;104
09;Burgos;228;Moradillo de Roa;254;131;123
09;Burgos;229;Nava de Roa;373;182;191
09;Burgos;230;Navas de Bureba;60;31;29
09;Burgos;231;Nebreda;158;98;60
09;Burgos;232;Neila;256;129;127
09;Burgos;235;Olmedillo de Roa;329;165;164
09;Burgos;236;Olmillos de Muñó;59;31;28
09;Burgos;238;Oña;1740;906;834
09;Burgos;239;Oquillas;77;42;35
09;Burgos;241;Orbaneja Riopico;126;68;58
09;Burgos;242;Padilla de Abajo;142;78;64
09;Burgos;243;Padilla de Arriba;157;83;74
09;Burgos;244;Padrones de Bureba;105;56;49
09;Burgos;246;Palacios de la Sierra;1017;517;500
09;Burgos;247;Palacios de Riopisuerga;56;27;29
09;Burgos;248;Palazuelos de la Sierra;78;42;36
09;Burgos;249;Palazuelos de Muñó;91;50;41
09;Burgos;250;Pampliega;459;242;217
09;Burgos;251;Pancorbo;631;316;315
09;Burgos;253;Pardilla;125;61;64
09;Burgos;255;Partido de la Sierra en Tobalina;91;55;36
09;Burgos;256;Pedrosa de Duero;681;365;316
09;Burgos;259;Pedrosa de Río Úrbel;345;177;168
09;Burgos;257;Pedrosa del Páramo;123;68;55
09;Burgos;258;Pedrosa del Príncipe;340;181;159
09;Burgos;261;Peñaranda de Duero;729;380;349
09;Burgos;262;Peral de Arlanza;295;157;138
09;Burgos;265;Piérnigas;51;31;20
09;Burgos;266;Pineda de la Sierra;118;66;52
09;Burgos;267;Pineda Trasmonte;241;124;117
09;Burgos;268;Pinilla de los Barruecos;199;105;94
09;Burgos;269;Pinilla de los Moros;60;38;22
09;Burgos;270;Pinilla Trasmonte;318;160;158
09;Burgos;272;Poza de la Sal;538;249;289
09;Burgos;273;Prádanos de Bureba;97;58;39
09;Burgos;274;Pradoluengo;1771;865;906
09;Burgos;275;Presencio;355;195;160
09;Burgos;276;Puebla de Arganzón (La);317;165;152
09;Burgos;277;Puentedura;166;90;76
09;Burgos;279;Quemada;286;157;129
09;Burgos;281;Quintana del Pidio;228;123;105
09;Burgos;280;Quintanabureba;70;44;26
09;Burgos;283;Quintanaélez;147;78;69
09;Burgos;287;Quintanaortuño;134;65;69
09;Burgos;288;Quintanapalla;169;91;78
09;Burgos;289;Quintanar de la Sierra;2895;1481;1414
09;Burgos;292;Quintanavides;89;41;48
09;Burgos;294;Quintanilla de la Mata;192;108;84
09;Burgos;901;Quintanilla del Agua y Tordueles;717;364;353
09;Burgos;295;Quintanilla del Coco;150;82;68
09;Burgos;298;Quintanilla San García;167;89;78
09;Burgos;301;Quintanilla Vivar;270;124;146
09;Burgos;297;Quintanillas (Las);368;192;176
09;Burgos;302;Rabanera del Pinar;240;107;133
09;Burgos;303;Rábanos;65;36;29
09;Burgos;304;Rabé de las Calzadas;158;89;69
09;Burgos;306;Rebolledo de la Torre;211;105;106
09;Burgos;307;Redecilla del Camino;151;85;66
09;Burgos;308;Redecilla del Campo;118;63;55
09;Burgos;309;Regumiel de la Sierra;600;304;296
09;Burgos;310;Reinoso;35;23;12
09;Burgos;311;Retuerta;82;43;39
09;Burgos;314;Revilla del Campo;163;84;79
09;Burgos;316;Revilla Vallejera;182;103;79
09;Burgos;312;Revilla y Ahedo (La);138;72;66
09;Burgos;315;Revillarruz;178;91;87
09;Burgos;317;Rezmondo;27;14;13
09;Burgos;318;Riocavado de la Sierra;74;40;34
09;Burgos;321;Roa;2510;1283;1227
09;Burgos;323;Rojas;106;55;51
09;Burgos;325;Royuela de Río Franco;458;251;207
09;Burgos;326;Rubena;184;95;89
09;Burgos;327;Rublacedo de Abajo;43;21;22
09;Burgos;328;Rucandio;126;63;63
09;Burgos;329;Salas de Bureba;215;120;95
09;Burgos;330;Salas de los Infantes;2151;1106;1045
09;Burgos;332;Saldaña de Burgos;78;40;38
09;Burgos;334;Salinillas de Bureba;80;51;29
09;Burgos;335;San Adrián de Juarros;39;18;21
09;Burgos;337;San Juan del Monte;246;129;117
09;Burgos;338;San Mamés de Burgos;144;77;67
09;Burgos;339;San Martín de Rubiales;400;217;183
09;Burgos;340;San Millán de Lara;121;68;53
09;Burgos;360;San Vicente del Valle;37;19;18
09;Burgos;343;Santa Cecilia;139;74;65
09;Burgos;345;Santa Cruz de la Salceda;222;111;111
09;Burgos;346;Santa Cruz del Valle Urbión;159;97;62
09;Burgos;347;Santa Gadea del Cid;208;109;99
09;Burgos;348;Santa Inés;255;138;117
09;Burgos;350;Santa María del Campo;831;439;392
09;Burgos;351;Santa María del Invierno;74;44;30
09;Burgos;352;Santa María del Mercadillo;243;137;106
09;Burgos;353;Santa María Rivarredonda;179;94;85
09;Burgos;354;Santa Olalla de Bureba;50;22;28
09;Burgos;355;Santibáñez de Esgueva;219;113;106
09;Burgos;356;Santibáñez del Val;87;50;37
09;Burgos;358;Santo Domingo de Silos;361;237;124
09;Burgos;361;Sargentes de la Lora;222;115;107
09;Burgos;362;Sarracín;159;80;79
09;Burgos;363;Sasamón;1786;949;837
09;Burgos;365;Sequera de Haza (La);81;49;32
09;Burgos;366;Solarana;150;76;74
09;Burgos;368;Sordillos;48;28;20
09;Burgos;369;Sotillo de la Ribera;591;326;265
09;Burgos;372;Sotragero;130;76;54
09;Burgos;373;Sotresgudo;932;496;436
09;Burgos;374;Susinos del Páramo;83;39;44
09;Burgos;375;Tamarón;58;30;28
09;Burgos;377;Tardajos;692;364;328
09;Burgos;378;Tejada;61;32;29
09;Burgos;380;Terradillos de Esgueva;145;76;69
09;Burgos;381;Tinieblas de la Sierra;27;16;11
09;Burgos;382;Tobar;68;37;31
09;Burgos;384;Tordómar;447;245;202
09;Burgos;386;Torrecilla del Monte;92;46;46
09;Burgos;387;Torregalindo;196;108;88
09;Burgos;388;Torrelara;17;9;8
09;Burgos;389;Torrepadre;233;123;110
09;Burgos;390;Torresandino;896;476;420
09;Burgos;391;Tórtoles de Esgueva;690;366;324
09;Burgos;392;Tosantos;89;43;46
09;Burgos;394;Trespaderne;1233;659;574
09;Burgos;395;Tubilla del Agua;179;102;77
09;Burgos;396;Tubilla del Lago;252;125;127
09;Burgos;398;Úrbel del Castillo;154;80;74
09;Burgos;400;Vadocondes;570;287;283
09;Burgos;403;Valdeande;227;116;111
09;Burgos;405;Valdezate;268;143;125
09;Burgos;406;Valdorros;113;60;53
09;Burgos;408;Vallarta de Bureba;109;60;49
09;Burgos;904;Valle de las Navas;677;375;302
09;Burgos;908;Valle de Losa;792;433;359
09;Burgos;409;Valle de Manzanedo;148;75;73
09;Burgos;410;Valle de Mena;5011;2559;2452
09;Burgos;411;Valle de Oca;225;116;109
09;Burgos;902;Valle de Santibáñez;748;395;353
09;Burgos;905;Valle de Sedano;486;251;235
09;Burgos;412;Valle de Tobalina;1128;604;524
09;Burgos;413;Valle de Valdebezana;973;512;461
09;Burgos;414;Valle de Valdelaguna;311;155;156
09;Burgos;415;Valle de Valdelucio;452;239;213
09;Burgos;416;Valle de Zamanzas;55;30;25
09;Burgos;417;Vallejera;68;38;30
09;Burgos;418;Valles de Palenzuela;117;62;55
09;Burgos;419;Valluércanes;182;105;77
09;Burgos;407;Valmala;40;19;21
09;Burgos;422;Vid de Bureba (La);56;30;26
09;Burgos;421;Vid y Barrios (La);430;244;186
09;Burgos;423;Vileña;47;26;21
09;Burgos;427;Villadiego;2598;1355;1243
09;Burgos;428;Villaescusa de Roa;222;120;102
09;Burgos;429;Villaescusa la Sombría;82;44;38
09;Burgos;430;Villaespasa;41;24;17
10;Cáceres;001;Abadía;355;200;155
10;Cáceres;002;Abertura;533;269;264
10;Cáceres;003;Acebo;923;466;457
10;Cáceres;004;Acehúche;1079;535;544
10;Cáceres;005;Aceituna;822;426;396
10;Cáceres;006;Ahigal;2007;1028;979
10;Cáceres;007;Albalá del Caudillo;1088;531;557
10;Cáceres;008;Alcántara;2250;1125;1125
10;Cáceres;009;Alcollarín;412;201;211
10;Cáceres;010;Alcuéscar;3453;1846;1607
10;Cáceres;012;Aldea del Cano;859;408;451
10;Cáceres;013;Aldea del Obispo (La);519;268;251
10;Cáceres;011;Aldeacentenera;1093;534;559
10;Cáceres;014;Aldeanueva de la Vera;2842;1429;1413
10;Cáceres;015;Aldeanueva del Camino;1058;503;555
10;Cáceres;016;Aldehuela de Jerte;457;256;201
10;Cáceres;017;Alía;1939;943;996
10;Cáceres;018;Aliseda;2598;1302;1296
10;Cáceres;019;Almaraz;1377;696;681
10;Cáceres;020;Almoharín;2237;1108;1129
10;Cáceres;021;Arroyo de la Luz;6688;3320;3368
10;Cáceres;023;Arroyomolinos;1208;609;599
10;Cáceres;022;Arroyomolinos de la Vera;748;380;368
10;Cáceres;024;Baños de Montemayor;842;393;449
10;Cáceres;025;Barrado;634;303;331
10;Cáceres;026;Belvís de Monroy;533;262;271
10;Cáceres;027;Benquerencia;124;69;55
10;Cáceres;028;Berrocalejo;149;68;81
10;Cáceres;029;Berzocana;775;401;374
10;Cáceres;030;Bohonal de Ibor;784;427;357
10;Cáceres;031;Botija;225;106;119
10;Cáceres;032;Brozas;2646;1309;1337
10;Cáceres;033;Cabañas del Castillo;753;396;357
10;Cáceres;034;Cabezabellosa;688;346;342
10;Cáceres;035;Cabezuela del Valle;2571;1306;1265
10;Cáceres;036;Cabrero;548;304;244
10;Cáceres;037;Cáceres;72680;34801;37879
10;Cáceres;038;Cachorrilla;136;58;78
10;Cáceres;039;Cadalso;707;365;342
10;Cáceres;040;Calzadilla;678;317;361
10;Cáceres;041;Caminomorisco;1548;805;743
10;Cáceres;042;Campillo de Deleitosa;187;95;92
10;Cáceres;043;Campo Lugar;1457;736;721
10;Cáceres;044;Cañamero;2170;1115;1055
10;Cáceres;045;Cañaveral;1913;908;1005
10;Cáceres;046;Carbajo;295;154;141
10;Cáceres;047;Carcaboso;1369;727;642
10;Cáceres;048;Carrascalejo;530;254;276
10;Cáceres;049;Casar de Cáceres;4072;2066;2006
10;Cáceres;050;Casar de Palomero;1696;857;839
10;Cáceres;051;Casares de las Hurdes;1116;588;528
10;Cáceres;052;Casas de Don Antonio;263;124;139
10;Cáceres;053;Casas de Don Gómez;477;237;240
10;Cáceres;056;Casas de Millán;907;465;442
10;Cáceres;057;Casas de Miravete;190;99;91
10;Cáceres;054;Casas del Castañar;787;388;399
10;Cáceres;055;Casas del Monte;1006;518;488
10;Cáceres;058;Casatejada;1462;720;742
10;Cáceres;059;Casillas de Coria;763;367;396
10;Cáceres;060;Castañar de Ibor;1583;803;780
10;Cáceres;061;Ceclavín;2556;1300;1256
10;Cáceres;062;Cedillo;628;315;313
10;Cáceres;063;Cerezo;283;134;149
10;Cáceres;064;Cilleros;2546;1278;1268
10;Cáceres;065;Collado;544;292;252
10;Cáceres;066;Conquista de la Sierra;215;107;108
10;Cáceres;067;Coria;11311;5662;5649
10;Cáceres;068;Cuacos de Yuste;1059;558;501
10;Cáceres;069;Cumbre (La);1339;664;675
10;Cáceres;070;Deleitosa;1136;549;587
10;Cáceres;071;Descargamaría;323;169;154
10;Cáceres;072;Eljas;1612;812;800
10;Cáceres;073;Escurial;1061;531;530
10;Cáceres;075;Fresnedoso de Ibor;560;293;267
10;Cáceres;076;Galisteo;2382;1205;1177
10;Cáceres;077;Garciaz;1205;604;601
10;Cáceres;078;Garganta (La);710;371;339
10;Cáceres;079;Garganta la Olla;1307;672;635
10;Cáceres;080;Gargantilla;601;307;294
10;Cáceres;081;Gargüera;286;145;141
10;Cáceres;082;Garrovillas de Alconétar;2733;1295;1438
10;Cáceres;083;Garvín;153;86;67
10;Cáceres;084;Gata;2315;1143;1172
10;Cáceres;085;Gordo (El);408;196;212
10;Cáceres;086;Granja (La);488;255;233
10;Cáceres;087;Guadalupe;2712;1333;1379
10;Cáceres;088;Guijo de Coria;397;203;194
10;Cáceres;089;Guijo de Galisteo;1947;1009;938
10;Cáceres;090;Guijo de Granadilla;873;422;451
10;Cáceres;091;Guijo de Santa Bárbara;679;346;333
10;Cáceres;092;Herguijuela;579;283;296
10;Cáceres;093;Hernán-Pérez;541;284;257
10;Cáceres;094;Herrera de Alcántara;448;222;226
10;Cáceres;095;Herreruela;593;297;296
10;Cáceres;096;Hervás;3815;1860;1955
10;Cáceres;097;Higuera;144;70;74
10;Cáceres;098;Hinojal;505;247;258
10;Cáceres;099;Holguera;950;472;478
10;Cáceres;100;Hoyos;1048;526;522
10;Cáceres;101;Huélaga;231;121;110
10;Cáceres;102;Ibahernando;916;459;457
10;Cáceres;103;Jaraicejo;843;411;432
10;Cáceres;104;Jaraíz de la Vera;7726;3834;3892
10;Cáceres;105;Jarandilla de la Vera;3257;1649;1608
10;Cáceres;106;Jarilla;228;108;120
10;Cáceres;107;Jerte;1465;771;694
10;Cáceres;108;Ladrillar;638;329;309
10;Cáceres;109;Logrosán;3170;1545;1625
10;Cáceres;110;Losar de la Vera;3193;1591;1602
10;Cáceres;111;Madrigal de la Vera;1906;991;915
10;Cáceres;112;Madrigalejo;2754;1371;1383
10;Cáceres;113;Madroñera;3457;1704;1753
10;Cáceres;114;Majadas;1186;592;594
10;Cáceres;115;Malpartida de Cáceres;3698;1830;1868
10;Cáceres;116;Malpartida de Plasencia;4461;2239;2222
10;Cáceres;117;Marchagaz;464;222;242
10;Cáceres;118;Mata de Alcántara;440;219;221
10;Cáceres;119;Membrío;1026;490;536
10;Cáceres;120;Mesas de Ibor;228;126;102
10;Cáceres;121;Miajadas;9418;4696;4722
10;Cáceres;122;Millanes;259;141;118
10;Cáceres;123;Mirabel;956;495;461
10;Cáceres;124;Mohedas de Granadilla;1305;675;630
10;Cáceres;125;Monroy;1372;689;683
10;Cáceres;126;Montánchez;2702;1344;1358
10;Cáceres;127;Montehermoso;5423;2733;2690
10;Cáceres;128;Moraleja;8525;4309;4216
10;Cáceres;129;Morcillo;581;268;313
10;Cáceres;130;Navaconcejo;2233;1146;1087
10;Cáceres;131;Navalmoral de la Mata;14661;7244;7417
10;Cáceres;132;Navalvillar de Ibor;660;337;323
10;Cáceres;133;Navas del Madroño;1777;890;887
10;Cáceres;134;Navezuelas;873;477;396
10;Cáceres;135;Nuñomoral;2345;1259;1086
10;Cáceres;136;Oliva de Plasencia;418;209;209
10;Cáceres;137;Palomero;662;343;319
10;Cáceres;138;Pasarón de la Vera;778;390;388
10;Cáceres;139;Pedroso de Acim;206;112;94
10;Cáceres;140;Peraleda de la Mata;1593;796;797
10;Cáceres;141;Peraleda de San Román;515;262;253
10;Cáceres;142;Perales del Puerto;1061;522;539
10;Cáceres;143;Pescueza;286;140;146
10;Cáceres;144;Pesga (La);1528;790;738
10;Cáceres;145;Piedras Albas;298;135;163
10;Cáceres;146;Pinofranqueado;2025;1063;962
10;Cáceres;147;Piornal;1694;851;843
10;Cáceres;148;Plasencia;34055;16788;17267
10;Cáceres;149;Plasenzuela;530;264;266
10;Cáceres;150;Portaje;526;261;265
10;Cáceres;151;Portezuelo;361;176;185
10;Cáceres;152;Pozuelo de Zarzón;732;356;376
10;Cáceres;153;Puerto de Santa Cruz;484;232;252
10;Cáceres;154;Rebollar;292;154;138
10;Cáceres;155;Riolobos;1861;981;880
10;Cáceres;156;Robledillo de Gata;251;132;119
10;Cáceres;157;Robledillo de la Vera;514;261;253
10;Cáceres;158;Robledillo de Trujillo;601;309;292
10;Cáceres;159;Robledollano;553;298;255
10;Cáceres;160;Romangordo;207;101;106
10;Cáceres;901;Rosalejo;"";"";""
10;Cáceres;161;Ruanes;109;55;54
10;Cáceres;162;Salorino;1065;505;560
10;Cáceres;163;Salvatierra de Santiago;543;282;261
10;Cáceres;164;San Martín de Trevejo;968;489;479
10;Cáceres;165;Santa Ana;444;226;218
10;Cáceres;166;Santa Cruz de la Sierra;423;214;209
10;Cáceres;167;Santa Cruz de Paniagua;596;310;286
10;Cáceres;168;Santa Marta de Magasca;436;222;214
10;Cáceres;169;Santiago de Alcántara;1083;557;526
10;Cáceres;170;Santiago del Campo;382;199;183
10;Cáceres;171;Santibáñez el Alto;705;371;334
10;Cáceres;172;Santibáñez el Bajo;1152;623;529
10;Cáceres;173;Saucedilla;543;283;260
10;Cáceres;174;Segura de Toro;234;126;108
10;Cáceres;175;Serradilla;2378;1187;1191
10;Cáceres;176;Serrejón;541;270;271
10;Cáceres;177;Sierra de Fuentes;1557;766;791
10;Cáceres;178;Talaván;1051;511;540
10;Cáceres;179;Talaveruela de la Vera;582;269;313
10;Cáceres;180;Talayuela;7883;4046;3837
10;Cáceres;181;Tejeda de Tiétar;1180;628;552
10;Cáceres;182;Toril;323;166;157
10;Cáceres;183;Tornavacas;1560;803;757
10;Cáceres;184;Torno (El);1248;646;602
10;Cáceres;187;Torre de Don Miguel;838;422;416
10;Cáceres;188;Torre de Santa María;847;428;419
10;Cáceres;185;Torrecilla de los Ángeles;770;402;368
10;Cáceres;186;Torrecillas de la Tiesa;1364;675;689
10;Cáceres;190;Torrejón el Rubio;866;449;417
10;Cáceres;189;Torrejoncillo;3989;1937;2052
10;Cáceres;191;Torremenga;593;309;284
10;Cáceres;192;Torremocha;1481;720;761
10;Cáceres;193;Torreorgaz;1482;745;737
10;Cáceres;194;Torrequemada;663;310;353
10;Cáceres;195;Trujillo;9257;4423;4834
10;Cáceres;196;Valdastillas;474;230;244
10;Cáceres;197;Valdecañas de Tajo;167;92;75
10;Cáceres;198;Valdefuentes;1714;841;873
10;Cáceres;199;Valdehúncar;180;89;91
10;Cáceres;200;Valdelacasa de Tajo;1051;500;551
10;Cáceres;201;Valdemorales;294;153;141
10;Cáceres;202;Valdeobispo;948;476;472
10;Cáceres;203;Valencia de Alcántara;7400;3678;3722
10;Cáceres;204;Valverde de la Vera;790;393;397
10;Cáceres;205;Valverde del Fresno;2867;1454;1413
10;Cáceres;206;Viandar de la Vera;479;241;238
10;Cáceres;207;Villa del Campo;787;391;396
10;Cáceres;208;Villa del Rey;223;112;111
10;Cáceres;209;Villamesías;504;239;265
10;Cáceres;210;Villamiel;893;447;446
10;Cáceres;211;Villanueva de la Sierra;851;412;439
10;Cáceres;212;Villanueva de la Vera;2140;1078;1062
10;Cáceres;214;Villar de Plasencia;392;190;202
10;Cáceres;213;Villar del Pedroso;1063;537;526
10;Cáceres;215;Villasbuenas de Gata;616;310;306
10;Cáceres;216;Zarza de Granadilla;1929;994;935
10;Cáceres;217;Zarza de Montánchez;837;423;414
10;Cáceres;218;Zarza la Mayor;1909;932;977
10;Cáceres;219;Zorita;2637;1299;1338
11;Cádiz;001;Alcalá de los Gazules;5885;3071;2814
11;Cádiz;002;Alcalá del Valle;5342;2709;2633
11;Cádiz;003;Algar;2177;1153;1024
11;Cádiz;004;Algeciras;100766;49796;50970
11;Cádiz;005;Algodonales;6023;3152;2871
11;Cádiz;006;Arcos de la Frontera;27453;13835;13618
11;Cádiz;007;Barbate;22673;11407;11266
11;Cádiz;008;Barrios (Los);13389;6857;6532
11;Cádiz;901;Benalup-Casas Viejas;"";"";""
11;Cádiz;009;Benaocaz;514;253;261
11;Cádiz;010;Bornos;8155;4110;4045
11;Cádiz;011;Bosque (El);1803;911;892
11;Cádiz;013;Castellar de la Frontera;2292;1186;1106
11;Cádiz;015;Chiclana de la Frontera;43807;22343;21464
11;Cádiz;016;Chipiona;14330;7339;6991
11;Cádiz;014;Conil de la Frontera;15070;7757;7313
11;Cádiz;012;Cádiz;156886;75764;81122
11;Cádiz;017;Espera;4167;2179;1988
11;Cádiz;018;Gastor (El);2326;1225;1101
11;Cádiz;019;Grazalema;2325;1201;1124
11;Cádiz;020;Jerez de la Frontera;184595;90952;93643
11;Cádiz;021;Jimena de la Frontera;8797;4570;4227
11;Cádiz;022;Línea de la Concepción (La);61286;29900;31386
11;Cádiz;023;Medina-Sidonia;16517;8520;7997
11;Cádiz;024;Olvera;9302;4725;4577
11;Cádiz;025;Paterna de Rivera;4914;2558;2356
11;Cádiz;026;Prado del Rey;5498;2756;2742
11;Cádiz;028;Puerto Real;30317;15175;15142
11;Cádiz;029;Puerto Serrano;6298;3198;3100
11;Cádiz;027;Puerto de Santa María (El);63714;31926;31788
11;Cádiz;030;Rota;22359;11322;11037
11;Cádiz;031;San Fernando;82862;41000;41862
11;Cádiz;902;San José del Valle;"";"";""
11;Cádiz;033;San Roque;21822;10947;10875
11;Cádiz;032;Sanlúcar de Barrameda;55613;27956;27657
11;Cádiz;034;Setenil de las Bodegas;3312;1681;1631
11;Cádiz;035;Tarifa;14735;7466;7269
11;Cádiz;036;Torre Alháquime;1059;530;529
11;Cádiz;037;Trebujena;6989;3568;3421
11;Cádiz;038;Ubrique;18075;8977;9098
11;Cádiz;039;Vejer de la Frontera;13219;6768;6451
11;Cádiz;040;Villaluenga del Rosario;480;253;227
11;Cádiz;041;Villamartín;12305;6119;6186
11;Cádiz;042;Zahara;1688;871;817
12;Castellón/Castelló;002;Aín;138;69;69
12;Castellón/Castelló;003;Albocàsser;1553;756;797
12;Castellón/Castelló;004;Alcalà de Xivert;4757;2369;2388
12;Castellón/Castelló;005;Alcora (L');8349;4227;4122
12;Castellón/Castelló;006;Alcudia de Veo;198;92;106
12;Castellón/Castelló;007;Alfondeguilla;926;469;457
12;Castellón/Castelló;008;Algimia de Almonacid;379;201;178
12;Castellón/Castelló;009;Almazora/Almassora;15754;7827;7927
12;Castellón/Castelló;010;Almedíjar;309;152;157
12;Castellón/Castelló;011;Almenara;5107;2549;2558
12;Castellón/Castelló;901;Alquerías del Niño Perdido;3672;1802;1870
12;Castellón/Castelló;012;Altura;3102;1535;1567
12;Castellón/Castelló;013;Arañuel;124;55;69
12;Castellón/Castelló;014;Ares del Maestre;375;191;184
12;Castellón/Castelló;015;Argelita;108;54;54
12;Castellón/Castelló;016;Artana;2022;1015;1007
12;Castellón/Castelló;001;Atzeneta del Maestrat;1676;845;831
12;Castellón/Castelló;017;Ayódar;237;122;115
12;Castellón/Castelló;018;Azuébar;410;199;211
12;Castellón/Castelló;020;Barracas;193;103;90
12;Castellón/Castelló;022;Bejís;486;246;240
12;Castellón/Castelló;024;Benafer;129;71;58
12;Castellón/Castelló;025;Benafigos;288;156;132
12;Castellón/Castelló;026;Benasal;1531;740;791
12;Castellón/Castelló;027;Benicarló;17860;8710;9150
12;Castellón/Castelló;028;Benicasim/Benicàssim;6156;3079;3077
12;Castellón/Castelló;029;Benlloch;1006;515;491
12;Castellón/Castelló;021;Betxí;5228;2664;2564
12;Castellón/Castelló;031;Borriol;2520;1263;1257
12;Castellón/Castelló;032;Burriana;25942;12729;13213
12;Castellón/Castelló;033;Cabanes;2633;1282;1351
12;Castellón/Castelló;034;Càlig;1807;887;920
12;Castellón/Castelló;036;Canet lo Roig;1098;542;556
12;Castellón/Castelló;037;Castell de Cabres;29;14;15
12;Castellón/Castelló;038;Castellfort;305;156;149
12;Castellón/Castelló;039;Castellnovo;1116;562;554
12;Castellón/Castelló;040;Castellón de la Plana/Castelló de la Plana;134021;65734;68287
12;Castellón/Castelló;041;Castillo de Villamalefa;166;82;84
12;Castellón/Castelló;042;Catí;979;503;476
12;Castellón/Castelló;043;Caudiel;711;360;351
12;Castellón/Castelló;044;Cervera del Maestre;837;409;428
12;Castellón/Castelló;052;Chert/Xert;1107;536;571
12;Castellón/Castelló;053;Chilches/Xilxes;2175;1085;1090
12;Castellón/Castelló;055;Chodos/Xodos;153;85;68
12;Castellón/Castelló;056;Chóvar;423;220;203
12;Castellón/Castelló;045;Cinctorres;641;291;350
12;Castellón/Castelló;046;Cirat;380;189;191
12;Castellón/Castelló;048;Cortes de Arenoso;409;222;187
12;Castellón/Castelló;049;Costur;487;249;238
12;Castellón/Castelló;050;Coves de Vinromà (les);2038;1021;1017
12;Castellón/Castelló;051;Culla;1039;517;522
12;Castellón/Castelló;057;Eslida;866;429;437
12;Castellón/Castelló;058;Espadilla;53;21;32
12;Castellón/Castelló;059;Fanzara;290;139;151
12;Castellón/Castelló;060;Figueroles;599;296;303
12;Castellón/Castelló;061;Forcall;662;314;348
12;Castellón/Castelló;063;Fuente la Reina;38;20;18
12;Castellón/Castelló;064;Fuentes de Ayódar;89;48;41
12;Castellón/Castelló;065;Gaibiel;261;131;130
12;Castellón/Castelló;066;Gatova;553;264;289
12;Castellón/Castelló;067;Geldo;760;383;377
12;Castellón/Castelló;068;Herbés;138;73;65
12;Castellón/Castelló;069;Higueras;43;23;20
12;Castellón/Castelló;070;Jana (La);957;483;474
12;Castellón/Castelló;071;Jérica;1723;871;852
12;Castellón/Castelló;074;Llosa (La);949;476;473
12;Castellón/Castelló;072;Lucena del Cid;1737;844;893
12;Castellón/Castelló;073;Ludiente;274;136;138
12;Castellón/Castelló;075;Mata de Morella (La);207;102;105
12;Castellón/Castelló;076;Matet;158;82;76
12;Castellón/Castelló;077;Moncofa;3582;1768;1814
12;Castellón/Castelló;078;Montán;394;200;194
12;Castellón/Castelló;079;Montanejos;445;228;217
12;Castellón/Castelló;080;Morella;3031;1460;1571
12;Castellón/Castelló;081;Navajas;507;246;261
12;Castellón/Castelló;082;Nules;11463;5635;5828
12;Castellón/Castelló;083;Olocau del Rey;162;90;72
12;Castellón/Castelló;084;Onda;18233;9080;9153
12;Castellón/Castelló;085;Oropesa del Mar/Orpesa;2189;1127;1062
12;Castellón/Castelló;087;Palanques;24;15;9
12;Castellón/Castelló;088;Pavías;74;39;35
12;Castellón/Castelló;089;Peñíscola;3491;1744;1747
12;Castellón/Castelló;090;Pina de Montalgrao;216;122;94
12;Castellón/Castelló;093;Pobla de Benifassà (La);243;118;125
12;Castellón/Castelló;094;Pobla Tornesa (La);496;245;251
12;Castellón/Castelló;091;Portell de Morella;323;171;152
12;Castellón/Castelló;092;Puebla de Arenoso;222;109;113
12;Castellón/Castelló;095;Ribesalbes;1378;676;702
12;Castellón/Castelló;096;Rossell;1278;647;631
12;Castellón/Castelló;097;Sacañet;69;30;39
12;Castellón/Castelló;098;Salzadella (La);906;438;468
12;Castellón/Castelló;101;San Rafael del Río;510;254;256
12;Castellón/Castelló;902;Sant Joan de Moró;"";"";""
12;Castellón/Castelló;099;Sant Jordi/San Jorge;594;290;304
12;Castellón/Castelló;100;Sant Mateu;1886;909;977
12;Castellón/Castelló;102;Santa Magdalena de Pulpis;764;393;371
12;Castellón/Castelló;103;Sarratella;121;63;58
12;Castellón/Castelló;104;Segorbe;7778;3780;3998
12;Castellón/Castelló;105;Sierra Engarcerán;1168;610;558
12;Castellón/Castelló;106;Soneja;1502;760;742
12;Castellón/Castelló;107;Sot de Ferrer;422;211;211
12;Castellón/Castelló;108;Sueras/Suera;600;302;298
12;Castellón/Castelló;109;Tales;773;358;415
12;Castellón/Castelló;110;Teresa;472;242;230
12;Castellón/Castelló;111;Tírig;688;333;355
12;Castellón/Castelló;112;Todolella;161;82;79
12;Castellón/Castelló;113;Toga;113;47;66
12;Castellón/Castelló;114;Torás;317;164;153
12;Castellón/Castelló;115;Toro (El);323;169;154
12;Castellón/Castelló;116;Torralba del Pinar;70;36;34
12;Castellón/Castelló;119;Torre d'En Besora (La);271;143;128
12;Castellón/Castelló;120;Torre Endoménech;313;160;153
12;Castellón/Castelló;117;Torreblanca;4638;2338;2300
12;Castellón/Castelló;118;Torrechiva;56;33;23
12;Castellón/Castelló;121;Traiguera;1684;864;820
12;Castellón/Castelló;122;Useras/Useres (Les);1234;627;607
12;Castellón/Castelló;124;Vall d'Alba;2002;1000;1002
12;Castellón/Castelló;125;Vall de Almonacid;280;140;140
12;Castellón/Castelló;126;Vall d'Uixó (La);28103;14047;14056
12;Castellón/Castelló;123;Vallat;32;15;17
12;Castellón/Castelló;127;Vallibona;127;60;67
12;Castellón/Castelló;128;Vilafamés;3077;1590;1487
12;Castellón/Castelló;132;Vilanova d'Alcolea;827;412;415
12;Castellón/Castelló;134;Vilar de Canes;226;115;111
12;Castellón/Castelló;129;Villafranca del Cid;2845;1344;1501
12;Castellón/Castelló;130;Villahermosa del Río;545;283;262
12;Castellón/Castelló;131;Villamalur;174;95;79
12;Castellón/Castelló;133;Villanueva de Viver;134;70;64
12;Castellón/Castelló;135;Villarreal/Vila-real;38098;18862;19236
12;Castellón/Castelló;136;Villavieja;3473;1725;1748
12;Castellón/Castelló;137;Villores;96;51;45
12;Castellón/Castelló;138;Vinaròs;18834;9168;9666
12;Castellón/Castelló;139;Vistabella del Maestrazgo;616;302;314
12;Castellón/Castelló;140;Viver;1280;644;636
12;Castellón/Castelló;141;Zorita del Maestrazgo;152;71;81
12;Castellón/Castelló;142;Zucaina;261;144;117
13;Ciudad Real;001;Abenójar;2104;1068;1036
13;Ciudad Real;002;Agudo;2421;1211;1210
13;Ciudad Real;003;Alamillo;804;408;396
13;Ciudad Real;004;Albaladejo;2017;987;1030
13;Ciudad Real;005;Alcázar de San Juan;26554;12938;13616
13;Ciudad Real;006;Alcoba;918;463;455
13;Ciudad Real;007;Alcolea de Calatrava;1606;800;806
13;Ciudad Real;008;Alcubillas;864;417;447
13;Ciudad Real;009;Aldea del Rey;2507;1201;1306
13;Ciudad Real;010;Alhambra;1477;744;733
13;Ciudad Real;011;Almadén;9039;4363;4676
13;Ciudad Real;012;Almadenejos;795;418;377
13;Ciudad Real;013;Almagro;8449;4056;4393
13;Ciudad Real;014;Almedina;990;478;512
13;Ciudad Real;015;Almodóvar del Campo;8608;4318;4290
13;Ciudad Real;016;Almuradiel;849;413;436
13;Ciudad Real;017;Anchuras;536;282;254
13;Ciudad Real;903;Arenales de San Gregorio;"";"";""
13;Ciudad Real;018;Arenas de San Juan;1073;550;523
13;Ciudad Real;019;Argamasilla de Alba;7269;3598;3671
13;Ciudad Real;020;Argamasilla de Calatrava;5710;2842;2868
13;Ciudad Real;021;Arroba de los Montes;710;367;343
13;Ciudad Real;022;Ballesteros de Calatrava;696;342;354
13;Ciudad Real;023;Bolaños de Calatrava;10304;5104;5200
13;Ciudad Real;024;Brazatortas;1477;737;740
13;Ciudad Real;025;Cabezarados;431;219;212
13;Ciudad Real;026;Cabezarrubias del Puerto;811;421;390
13;Ciudad Real;027;Calzada de Calatrava;5223;2571;2652
13;Ciudad Real;028;Campo de Criptana;13982;6849;7133
13;Ciudad Real;029;Cañada de Calatrava;98;54;44
13;Ciudad Real;030;Caracuel de Calatrava;208;106;102
13;Ciudad Real;031;Carrión de Calatrava;2508;1203;1305
13;Ciudad Real;032;Carrizosa;1837;918;919
13;Ciudad Real;033;Castellar de Santiago;2545;1242;1303
13;Ciudad Real;038;Chillón;2775;1344;1431
13;Ciudad Real;034;Ciudad Real;57346;27319;30027
13;Ciudad Real;035;Corral de Calatrava;1381;676;705
13;Ciudad Real;036;Cortijos (Los);1269;631;638
13;Ciudad Real;037;Cózar;1577;757;820
13;Ciudad Real;039;Daimiel;17220;8377;8843
13;Ciudad Real;040;Fernán Caballero;1106;526;580
13;Ciudad Real;041;Fontanarejo;509;264;245
13;Ciudad Real;042;Fuencaliente;1463;784;679
13;Ciudad Real;043;Fuenllana;370;160;210
13;Ciudad Real;044;Fuente el Fresno;3707;1803;1904
13;Ciudad Real;045;Granátula de Calatrava;1205;578;627
13;Ciudad Real;046;Guadalmez;1171;602;569
13;Ciudad Real;047;Herencia;7165;3538;3627
13;Ciudad Real;048;Hinojosas de Calatrava;1041;502;539
13;Ciudad Real;049;Horcajo de los Montes;1227;622;605
13;Ciudad Real;050;Labores (Las);690;340;350
13;Ciudad Real;904;Llanos del Caudillo;"";"";""
13;Ciudad Real;051;Luciana;550;287;263
13;Ciudad Real;052;Malagón;8180;4030;4150
13;Ciudad Real;053;Manzanares;18196;8879;9317
13;Ciudad Real;054;Membrilla;6828;3409;3419
13;Ciudad Real;055;Mestanza;1266;621;645
13;Ciudad Real;056;Miguelturra;7313;3600;3713
13;Ciudad Real;057;Montiel;1764;871;893
13;Ciudad Real;058;Moral de Calatrava;5390;2605;2785
13;Ciudad Real;059;Navalpino;390;197;193
13;Ciudad Real;060;Navas de Estena;504;272;232
13;Ciudad Real;061;Pedro Muñoz;7300;3657;3643
13;Ciudad Real;062;Picón;627;335;292
13;Ciudad Real;063;Piedrabuena;5184;2598;2586
13;Ciudad Real;064;Poblete;670;343;327
13;Ciudad Real;065;Porzuna;4148;2085;2063
13;Ciudad Real;066;Pozuelo de Calatrava;2349;1147;1202
13;Ciudad Real;067;Pozuelos de Calatrava (Los);675;353;322
13;Ciudad Real;068;Puebla de Don Rodrigo;1384;735;649
13;Ciudad Real;069;Puebla del Príncipe;1134;578;556
13;Ciudad Real;070;Puerto Lápice;1033;512;521
13;Ciudad Real;071;Puertollano;52315;25658;26657
13;Ciudad Real;072;Retuerta del Bullaque;1118;586;532
13;Ciudad Real;901;Robledo (El);1306;681;625
13;Ciudad Real;902;Ruidera;"";"";""
13;Ciudad Real;073;Saceruela;849;440;409
13;Ciudad Real;074;San Carlos del Valle;1316;664;652
13;Ciudad Real;075;San Lorenzo de Calatrava;439;227;212
13;Ciudad Real;076;Santa Cruz de los Cáñamos;717;360;357
13;Ciudad Real;077;Santa Cruz de Mudela;5035;2422;2613
13;Ciudad Real;078;Socuéllamos;11971;5852;6119
13;Ciudad Real;080;Solana del Pino;778;384;394
13;Ciudad Real;079;Solana (La);14601;7274;7327
13;Ciudad Real;081;Terrinches;1202;588;614
13;Ciudad Real;082;Tomelloso;28527;13985;14542
13;Ciudad Real;083;Torralba de Calatrava;3137;1525;1612
13;Ciudad Real;084;Torre de Juan Abad;1952;951;1001
13;Ciudad Real;085;Torrenueva;3343;1643;1700
13;Ciudad Real;086;Valdemanco del Esteras;360;185;175
13;Ciudad Real;087;Valdepeñas;25725;12430;13295
13;Ciudad Real;088;Valenzuela de Calatrava;849;404;445
13;Ciudad Real;089;Villahermosa;3309;1559;1750
13;Ciudad Real;090;Villamanrique;2027;1000;1027
13;Ciudad Real;091;Villamayor de Calatrava;833;413;420
13;Ciudad Real;092;Villanueva de la Fuente;3171;1565;1606
13;Ciudad Real;093;Villanueva de los Infantes;6355;3049;3306
13;Ciudad Real;094;Villanueva de San Carlos;582;284;298
13;Ciudad Real;095;Villar del Pozo;106;53;53
13;Ciudad Real;096;Villarrubia de los Ojos;9628;4813;4815
13;Ciudad Real;097;Villarta de San Juan;3034;1502;1532
13;Ciudad Real;098;Viso del Marqués;3425;1688;1737
14;Córdoba;001;Adamuz;4649;2328;2321
14;Córdoba;002;Aguilar de la Frontera;13238;6533;6705
14;Córdoba;003;Alcaracejos;1506;761;745
14;Córdoba;004;Almedinilla;2808;1395;1413
14;Córdoba;005;Almodóvar del Río;7094;3548;3546
14;Córdoba;006;Añora;1821;866;955
14;Córdoba;007;Baena;19101;9464;9637
14;Córdoba;008;Belalcázar;4203;2043;2160
14;Córdoba;009;Belmez;4656;2246;2410
14;Córdoba;010;Benamejí;4740;2341;2399
14;Córdoba;011;Blázquez (Los);809;409;400
14;Córdoba;012;Bujalance;8926;4410;4516
14;Córdoba;013;Cabra;20450;9980;10470
14;Córdoba;015;Carcabuey;3043;1491;1552
14;Córdoba;016;Cardeña;2184;1108;1076
14;Córdoba;017;Carlota (La);9148;4609;4539
14;Córdoba;018;Carpio (El);4802;2357;2445
14;Córdoba;019;Castro del Río;7886;3854;4032
14;Córdoba;014;Cañete de las Torres;3481;1753;1728
14;Córdoba;020;Conquista;596;286;310
14;Córdoba;021;Córdoba;304780;147252;157528
14;Córdoba;023;Dos Torres;2516;1226;1290
14;Córdoba;022;Doña Mencía;5207;2558;2649
14;Córdoba;024;Encinas Reales;2294;1122;1172
14;Córdoba;025;Espejo;5162;2544;2618
14;Córdoba;026;Espiel;2868;1414;1454
14;Córdoba;027;Fernán-Núñez;9385;4677;4708
14;Córdoba;029;Fuente Obejuna;6951;3537;3414
14;Córdoba;030;Fuente Palmera;9408;4767;4641
14;Córdoba;028;Fuente la Lancha;508;248;260
14;Córdoba;031;Fuente-Tójar;940;456;484
14;Córdoba;032;Granjuela (La);560;290;270
14;Córdoba;033;Guadalcázar;1292;660;632
14;Córdoba;034;Guijo (El);518;261;257
14;Córdoba;035;Hinojosa del Duque;8258;3952;4306
14;Córdoba;036;Hornachuelos;5427;2787;2640
14;Córdoba;037;Iznájar;6164;3100;3064
14;Córdoba;038;Lucena;32502;16230;16272
14;Córdoba;039;Luque;3534;1749;1785
14;Córdoba;040;Montalbán de Córdoba;4491;2248;2243
14;Córdoba;041;Montemayor;3773;1918;1855
14;Córdoba;042;Montilla;22588;11204;11384
14;Córdoba;043;Montoro;9979;4895;5084
14;Córdoba;044;Monturque;2009;1023;986
14;Córdoba;045;Moriles;3692;1844;1848
14;Córdoba;046;Nueva Carteya;5840;2936;2904
14;Córdoba;047;Obejo;1485;731;754
14;Córdoba;048;Palenciana;1781;884;897
14;Córdoba;049;Palma del Río;18903;9405;9498
14;Córdoba;050;Pedro Abad;3051;1505;1546
14;Córdoba;051;Pedroche;1913;944;969
14;Córdoba;052;Peñarroya-Pueblonuevo;14174;6761;7413
14;Córdoba;053;Posadas;7128;3585;3543
14;Córdoba;054;Pozoblanco;14916;7135;7781
14;Córdoba;055;Priego de Córdoba;21442;10542;10900
14;Córdoba;056;Puente Genil;27571;13470;14101
14;Córdoba;057;Rambla (La);7124;3542;3582
14;Córdoba;058;Rute;10072;4905;5167
14;Córdoba;059;San Sebastián de los Ballesteros;829;427;402
14;Córdoba;061;Santa Eufemia;1368;687;681
14;Córdoba;060;Santaella;5865;2943;2922
14;Córdoba;062;Torrecampo;1670;807;863
14;Córdoba;063;Valenzuela;1679;798;881
14;Córdoba;064;Valsequillo;626;317;309
14;Córdoba;065;Victoria (La);1728;857;871
14;Córdoba;066;Villa del Río;7137;3598;3539
14;Córdoba;067;Villafranca de Córdoba;3642;1845;1797
14;Córdoba;068;Villaharta;664;320;344
14;Córdoba;069;Villanueva de Córdoba;10601;5145;5456
14;Córdoba;070;Villanueva del Duque;2132;984;1148
14;Córdoba;071;Villanueva del Rey;1402;721;681
14;Córdoba;072;Villaralto;1880;889;991
14;Córdoba;073;Villaviciosa de Córdoba;4262;2166;2096
14;Córdoba;074;Viso (El);3636;1791;1845
14;Córdoba;075;Zuheros;1049;510;539
15;Coruña (A);001;Abegondo;6136;3041;3095
15;Coruña (A);002;Ames;9954;4796;5158
15;Coruña (A);003;Aranga;2643;1303;1340
15;Coruña (A);004;Ares;4818;2307;2511
15;Coruña (A);005;Arteixo;17506;8796;8710
15;Coruña (A);006;Arzúa;7358;3663;3695
15;Coruña (A);007;Baña (A);7394;3614;3780
15;Coruña (A);008;Bergondo;5596;2705;2891
15;Coruña (A);009;Betanzos;11834;5530;6304
15;Coruña (A);010;Boimorto;3280;1660;1620
15;Coruña (A);011;Boiro;18033;8701;9332
15;Coruña (A);012;Boqueixón;4999;2488;2511
15;Coruña (A);013;Brión;7028;3395;3633
15;Coruña (A);014;Cabana de Bergantiños;7192;3635;3557
15;Coruña (A);015;Cabanas;3267;1570;1697
15;Coruña (A);016;Camariñas;7552;3780;3772
15;Coruña (A);017;Cambre;11501;5582;5919
15;Coruña (A);018;Capela (A);1845;918;927
15;Coruña (A);019;Carballo;27749;13781;13968
15;Coruña (A);901;Cariño;5868;2890;2978
15;Coruña (A);020;Carnota;7170;3476;3694
15;Coruña (A);021;Carral;5631;2798;2833
15;Coruña (A);022;Cedeira;7991;3921;4070
15;Coruña (A);023;Cee;7823;3821;4002
15;Coruña (A);024;Cerceda;7251;3551;3700
15;Coruña (A);025;Cerdido;2090;1021;1069
15;Coruña (A);026;Cesuras;3236;1600;1636
15;Coruña (A);027;Coirós;1644;821;823
15;Coruña (A);028;Corcubión;2116;1026;1090
15;Coruña (A);029;Coristanco;10165;5168;4997
15;Coruña (A);030;A Coruña;252419;118868;133551
15;Coruña (A);031;Culleredo;13772;6706;7066
15;Coruña (A);032;Curtis;5139;2558;2581
15;Coruña (A);033;Dodro;3675;1768;1907
15;Coruña (A);034;Dumbría;5043;2498;2545
15;Coruña (A);035;Fene;15788;7783;8005
15;Coruña (A);036;Ferrol;86271;40771;45500
15;Coruña (A);037;Fisterra;5559;2800;2759
15;Coruña (A);038;Frades;3620;1836;1784
15;Coruña (A);039;Irixoa;2005;965;1040
15;Coruña (A);041;Laracha (A);12002;5980;6022
15;Coruña (A);040;Laxe;3838;1918;1920
15;Coruña (A);042;Lousame;4994;2427;2567
15;Coruña (A);043;Malpica de Bergantiños;8475;4172;4303
15;Coruña (A);045;Mazaricos;7225;3498;3727
15;Coruña (A);044;Mañón;2480;1201;1279
15;Coruña (A);046;Melide;8370;4170;4200
15;Coruña (A);047;Mesía;4200;2084;2116
15;Coruña (A);048;Miño;5269;2506;2763
15;Coruña (A);049;Moeche;1895;912;983
15;Coruña (A);050;Monfero;3221;1651;1570
15;Coruña (A);051;Mugardos;6868;3337;3531
15;Coruña (A);053;Muros;12060;5823;6237
15;Coruña (A);052;Muxía;7143;3510;3633
15;Coruña (A);054;Narón;31036;15125;15911
15;Coruña (A);055;Neda;6707;3185;3522
15;Coruña (A);056;Negreira;7260;3455;3805
15;Coruña (A);057;Noia;14793;7204;7589
15;Coruña (A);058;Oleiros;17468;8561;8907
15;Coruña (A);059;Ordes;12070;5911;6159
15;Coruña (A);060;Oroso;4121;2029;2092
15;Coruña (A);061;Ortigueira;10421;4963;5458
15;Coruña (A);062;Outes;10092;4807;5285
15;Coruña (A);063;Oza dos Ríos;3481;1704;1777
15;Coruña (A);064;Paderne;3036;1453;1583
15;Coruña (A);065;Padrón;10275;4995;5280
15;Coruña (A);066;Pino (O);5662;2825;2837
15;Coruña (A);067;Pobra do Caramiñal (A);10425;4991;5434
15;Coruña (A);068;Ponteceso;8600;4336;4264
15;Coruña (A);069;Pontedeume;8731;4225;4506
15;Coruña (A);070;Pontes de García Rodríguez (As);13637;6969;6668
15;Coruña (A);071;Porto do Son;11137;5449;5688
15;Coruña (A);072;Rianxo;13205;6506;6699
15;Coruña (A);073;Ribeira;26007;12816;13191
15;Coruña (A);074;Rois;6054;2961;3093
15;Coruña (A);075;Sada;8533;4088;4445
15;Coruña (A);076;San Sadurniño;4035;1958;2077
15;Coruña (A);077;Santa Comba;12078;5924;6154
15;Coruña (A);078;Santiago de Compostela;89041;42336;46705
15;Coruña (A);079;Santiso;2800;1459;1341
15;Coruña (A);080;Sobrado;3101;1598;1503
15;Coruña (A);081;Somozas (As);1793;893;900
15;Coruña (A);082;Teo;11805;5773;6032
15;Coruña (A);083;Toques;2141;1098;1043
15;Coruña (A);084;Tordoia;6059;2921;3138
15;Coruña (A);085;Touro;5503;2724;2779
15;Coruña (A);086;Trazo;4987;2530;2457
15;Coruña (A);088;Val do Dubra;6167;3047;3120
15;Coruña (A);087;Valdoviño;7104;3488;3616
15;Coruña (A);089;Vedra;5731;2766;2965
15;Coruña (A);091;Vilarmaior;1544;749;795
15;Coruña (A);090;Vilasantar;2304;1173;1131
15;Coruña (A);092;Vimianzo;9698;4797;4901
15;Coruña (A);093;Zas;7033;3426;3607
16;Cuenca;001;Abia de la Obispalía;116;63;53
16;Cuenca;002;Acebrón (El);333;163;170
16;Cuenca;003;Alarcón;243;125;118
16;Cuenca;004;Albaladejo del Cuende;505;272;233
16;Cuenca;005;Albalate de las Nogueras;466;248;218
16;Cuenca;006;Albendea;235;122;113
16;Cuenca;007;Alberca de Záncara (La);1990;990;1000
16;Cuenca;008;Alcalá de la Vega;232;123;109
16;Cuenca;009;Alcantud;175;93;82
16;Cuenca;011;Alcohujate;77;39;38
16;Cuenca;012;Alconchel de la Estrella;253;123;130
16;Cuenca;010;Alcázar del Rey;299;154;145
16;Cuenca;013;Algarra;44;21;23
16;Cuenca;014;Aliaguilla;977;488;489
16;Cuenca;015;Almarcha (La);736;365;371
16;Cuenca;016;Almendros;475;239;236
16;Cuenca;017;Almodóvar del Pinar;599;311;288
16;Cuenca;018;Almonacid del Marquesado;606;312;294
16;Cuenca;019;Altarejos;497;254;243
16;Cuenca;020;Arandilla del Arroyo;69;36;33
16;Cuenca;905;Arcas del Villar;397;197;200
16;Cuenca;022;Arcos de la Sierra;149;83;66
16;Cuenca;024;Arguisuelas;247;129;118
16;Cuenca;025;Arrancacepas;51;25;26
16;Cuenca;026;Atalaya del Cañavate;159;78;81
16;Cuenca;027;Barajas de Melo;771;378;393
16;Cuenca;029;Barchín del Hoyo;188;101;87
16;Cuenca;030;Bascuñana de San Pedro;42;21;21
16;Cuenca;031;Beamud;101;56;45
16;Cuenca;032;Belinchón;354;175;179
16;Cuenca;033;Belmonte;2767;1286;1481
16;Cuenca;034;Belmontejo;334;174;160
16;Cuenca;035;Beteta;481;239;242
16;Cuenca;036;Boniches;259;122;137
16;Cuenca;038;Buciegas;118;62;56
16;Cuenca;039;Buenache de Alarcón;715;368;347
16;Cuenca;040;Buenache de la Sierra;112;69;43
16;Cuenca;041;Buendía;470;234;236
16;Cuenca;042;Campillo de Altobuey;1850;916;934
16;Cuenca;043;Campillos-Paravientos;181;95;86
16;Cuenca;044;Campillos-Sierra;107;56;51
16;Cuenca;901;Campos del Paraíso;1499;698;801
16;Cuenca;045;Canalejas del Arroyo;450;229;221
16;Cuenca;055;Carboneras de Guadazaón;1110;592;518
16;Cuenca;056;Cardenete;784;404;380
16;Cuenca;057;Carrascosa;162;87;75
16;Cuenca;058;Carrascosa de Haro;206;105;101
16;Cuenca;060;Casas de Benítez;1259;617;642
16;Cuenca;061;Casas de Fernando Alonso;1486;729;757
16;Cuenca;062;Casas de Garcimolina;40;17;23
16;Cuenca;063;Casas de Guijarro;219;111;108
16;Cuenca;064;Casas de Haro;964;474;490
16;Cuenca;065;Casas de los Pinos;614;307;307
16;Cuenca;066;Casasimarro;3102;1547;1555
16;Cuenca;067;Castejón;300;160;140
16;Cuenca;068;Castillejo de Iniesta;204;113;91
16;Cuenca;070;Castillejo-Sierra;61;29;32
16;Cuenca;072;Castillo de Garcimuñoz;324;169;155
16;Cuenca;071;Castillo-Albaráñez;39;19;20
16;Cuenca;047;Cañada Juncosa;428;220;208
16;Cuenca;046;Cañada del Hoyo;434;221;213
16;Cuenca;048;Cañamares;625;336;289
16;Cuenca;049;Cañavate (El);343;176;167
16;Cuenca;050;Cañaveras;500;253;247
16;Cuenca;051;Cañaveruelas;288;147;141
16;Cuenca;052;Cañete;953;474;479
16;Cuenca;053;Cañizares;701;383;318
16;Cuenca;073;Cervera del Llano;392;203;189
16;Cuenca;023;Chillarón de Cuenca;306;154;152
16;Cuenca;081;Chumillas;69;39;30
16;Cuenca;074;Cierva (La);64;36;28
16;Cuenca;078;Cuenca;42802;20716;22086
16;Cuenca;079;Cueva del Hierro;63;37;26
16;Cuenca;082;Enguídanos;746;383;363
16;Cuenca;083;Fresneda de Altarejos;108;63;45
16;Cuenca;084;Fresneda de la Sierra;104;48;56
16;Cuenca;085;Frontera (La);295;154;141
16;Cuenca;086;Fuente de Pedro Naharro;1313;656;657
16;Cuenca;087;Fuentelespino de Haro;441;242;199
16;Cuenca;088;Fuentelespino de Moya;184;88;96
16;Cuenca;904;Fuentenava de Jábaga;284;149;135
16;Cuenca;089;Fuentes;615;319;296
16;Cuenca;091;Fuertescusa;134;63;71
16;Cuenca;092;Gabaldón;213;122;91
16;Cuenca;093;Garaballa;237;122;115
16;Cuenca;094;Gascueña;211;101;110
16;Cuenca;095;Graja de Campalbo;162;94;68
16;Cuenca;096;Graja de Iniesta;394;207;187
16;Cuenca;097;Henarejos;408;199;209
16;Cuenca;098;Herrumblar (El);800;408;392
16;Cuenca;099;Hinojosa (La);428;206;222
16;Cuenca;100;Hinojosos (Los);1376;680;696
16;Cuenca;101;Hito (El);292;147;145
16;Cuenca;102;Honrubia;1747;876;871
16;Cuenca;103;Hontanaya;633;318;315
16;Cuenca;104;Hontecillas;120;57;63
16;Cuenca;106;Horcajo de Santiago;3675;1823;1852
16;Cuenca;108;Huelves;88;41;47
16;Cuenca;110;Huerta de la Obispalía;200;115;85
16;Cuenca;111;Huerta del Marquesado;197;98;99
16;Cuenca;112;Huete;2546;1276;1270
16;Cuenca;107;Huélamo;136;71;65
16;Cuenca;109;Huérguina;100;49;51
16;Cuenca;113;Iniesta;3662;1802;1860
16;Cuenca;115;Laguna del Marquesado;84;47;37
16;Cuenca;116;Lagunaseca;112;54;58
16;Cuenca;117;Landete;1684;842;842
16;Cuenca;118;Ledaña;2198;1108;1090
16;Cuenca;119;Leganiel;339;166;173
16;Cuenca;121;Majadas (Las);437;229;208
16;Cuenca;122;Mariana;326;158;168
16;Cuenca;123;Masegosa;155;78;77
16;Cuenca;124;Mesas (Las);2718;1383;1335
16;Cuenca;125;Minglanilla;2375;1195;1180
16;Cuenca;126;Mira;1294;651;643
16;Cuenca;128;Monreal del Llano;103;54;49
16;Cuenca;129;Montalbanejo;246;122;124
16;Cuenca;130;Montalbo;927;496;431
16;Cuenca;131;Monteagudo de las Salinas;137;74;63
16;Cuenca;132;Mota de Altarejos;85;45;40
16;Cuenca;133;Mota del Cuervo;5639;2778;2861
16;Cuenca;134;Motilla del Palancar;4782;2399;2383
16;Cuenca;135;Moya;398;210;188
16;Cuenca;137;Narboneta;120;59;61
16;Cuenca;139;Olivares de Júcar;766;376;390
16;Cuenca;140;Olmeda de la Cuesta;71;37;34
16;Cuenca;141;Olmeda del Rey;293;140;153
16;Cuenca;142;Olmedilla de Alarcón;288;148;140
16;Cuenca;143;Olmedilla de Eliz;39;22;17
16;Cuenca;145;Osa de la Vega;772;389;383
16;Cuenca;147;Pajaroncillo;119;63;56
16;Cuenca;146;Pajarón;169;91;78
16;Cuenca;148;Palomares del Campo;1058;529;529
16;Cuenca;149;Palomera;138;65;73
16;Cuenca;150;Paracuellos;239;122;117
16;Cuenca;151;Paredes;86;46;40
16;Cuenca;152;Parra de las Vegas (La);81;39;42
16;Cuenca;153;Pedernoso (El);1454;711;743
16;Cuenca;154;Pedroñeras (Las);6638;3356;3282
16;Cuenca;155;Peral (El);769;395;374
16;Cuenca;156;Peraleja (La);258;132;126
16;Cuenca;157;Pesquera (La);355;188;167
16;Cuenca;158;Picazo (El);776;371;405
16;Cuenca;159;Pinarejo;636;325;311
16;Cuenca;160;Pineda de Gigüela;230;117;113
16;Cuenca;161;Piqueras del Castillo;115;65;50
16;Cuenca;162;Portalrubio de Guadamejud;146;73;73
16;Cuenca;163;Portilla;123;60;63
16;Cuenca;165;Poyatos;136;74;62
16;Cuenca;166;Pozoamargo;411;201;210
16;Cuenca;908;Pozorrubielos de la Mancha;324;162;162
16;Cuenca;167;Pozorrubio;559;270;289
16;Cuenca;169;Pozuelo (El);119;59;60
16;Cuenca;170;Priego;1217;628;589
16;Cuenca;171;Provencio (El);2869;1418;1451
16;Cuenca;172;Puebla de Almenara;740;380;360
16;Cuenca;173;Puebla de Don Francisco;511;263;248
16;Cuenca;174;Puebla del Salvador;383;209;174
16;Cuenca;175;Quintanar del Rey;5664;2896;2768
16;Cuenca;176;Rada de Haro;76;37;39
16;Cuenca;177;Reíllo;159;73;86
16;Cuenca;181;Rozalén del Monte;188;88;100
16;Cuenca;185;Saceda-Trasierra;72;34;38
16;Cuenca;186;Saelices;876;443;433
16;Cuenca;187;Salinas del Manzano;166;91;75
16;Cuenca;188;Salmeroncillos;214;112;102
16;Cuenca;189;Salvacañete;385;208;177
16;Cuenca;190;San Clemente;6419;3174;3245
16;Cuenca;191;San Lorenzo de la Parrilla;1815;911;904
16;Cuenca;192;San Martín de Boniches;105;53;52
16;Cuenca;193;San Pedro Palmiches;134;79;55
16;Cuenca;194;Santa Cruz de Moya;498;254;244
16;Cuenca;196;Santa María de los Llanos;933;467;466
16;Cuenca;195;Santa María del Campo Rus;1109;556;553
16;Cuenca;197;Santa María del Val;153;78;75
16;Cuenca;198;Sisante;1997;1028;969
16;Cuenca;199;Solera de Gabaldón;56;34;22
16;Cuenca;909;Sotorribas;1082;552;530
16;Cuenca;202;Talayuelas;1307;678;629
16;Cuenca;203;Tarancón;10631;5280;5351
16;Cuenca;205;Tejadillos;211;103;108
16;Cuenca;206;Tinajas;477;253;224
16;Cuenca;209;Torralba;271;135;136
16;Cuenca;211;Torrejoncillo del Rey;958;468;490
16;Cuenca;212;Torrubia del Campo;406;197;209
16;Cuenca;213;Torrubia del Castillo;59;30;29
16;Cuenca;215;Tragacete;436;234;202
16;Cuenca;216;Tresjuncos;657;329;328
16;Cuenca;217;Tribaldos;195;100;95
16;Cuenca;204;Tébar;518;274;244
16;Cuenca;218;Uclés;356;171;185
16;Cuenca;219;Uña;153;74;79
16;Cuenca;906;Valdecolmenas (Los);186;91;95
16;Cuenca;224;Valdemeca;101;60;41
16;Cuenca;225;Valdemorillo de la Sierra;112;53;59
16;Cuenca;227;Valdemoro-Sierra;212;118;94
16;Cuenca;228;Valdeolivas;345;180;165
16;Cuenca;902;Valdetórtola;214;115;99
16;Cuenca;903;Valeras (Las);1553;778;775
16;Cuenca;231;Valhermoso de la Fuente;77;36;41
16;Cuenca;234;Valsalobre;83;40;43
16;Cuenca;236;Valverde de Júcar;1552;771;781
16;Cuenca;237;Valverdejo;173;88;85
16;Cuenca;238;Vara de Rey;966;484;482
16;Cuenca;239;Vega del Codorno;297;146;151
16;Cuenca;240;Vellisca;268;124;144
16;Cuenca;242;Villaconejos de Trabaque;583;297;286
16;Cuenca;243;Villaescusa de Haro;642;325;317
16;Cuenca;244;Villagarcía del Llano;1005;503;502
16;Cuenca;245;Villalba de la Sierra;547;286;261
16;Cuenca;246;Villalba del Rey;930;486;444
16;Cuenca;247;Villalgordo del Marquesado;202;99;103
16;Cuenca;248;Villalpardo;1160;597;563
16;Cuenca;249;Villamayor de Santiago;2964;1466;1498
16;Cuenca;250;Villanueva de Guadamejud;178;80;98
16;Cuenca;251;Villanueva de la Jara;2578;1283;1295
16;Cuenca;253;Villar de Cañas;550;275;275
16;Cuenca;254;Villar de Domingo García;296;150;146
16;Cuenca;263;Villar de Olalla;834;423;411
16;Cuenca;255;Villar de la Encina;270;133;137
16;Cuenca;258;Villar del Humo;510;261;249
16;Cuenca;259;Villar del Infantado;74;44;30
16;Cuenca;910;Villar y Velasco;185;102;83
16;Cuenca;264;Villarejo de Fuentes;964;475;489
16;Cuenca;265;Villarejo de la Peñuela;46;24;22
16;Cuenca;266;Villarejo-Periesteban;598;302;296
16;Cuenca;269;Villares del Saz;995;489;506
16;Cuenca;270;Villarrubio;303;142;161
16;Cuenca;271;Villarta;840;446;394
16;Cuenca;272;Villas de la Ventosa;555;289;266
16;Cuenca;273;Villaverde y Pasaconsol;491;239;252
16;Cuenca;275;Vindel;34;17;17
16;Cuenca;274;Víllora;322;153;169
16;Cuenca;276;Yémeda;56;29;27
16;Cuenca;277;Zafra de Záncara;310;162;148
16;Cuenca;278;Zafrilla;177;90;87
16;Cuenca;279;Zarza de Tajo;347;158;189
16;Cuenca;280;Zarzuela;370;182;188
17;Girona;001;Agullana;688;355;333
17;Girona;002;Aiguaviva;382;187;195
17;Girona;003;Albanyà;114;64;50
17;Girona;004;Albons;484;252;232
17;Girona;006;Alp;927;478;449
17;Girona;007;Amer;2401;1180;1221
17;Girona;008;Anglès;5166;2597;2569
17;Girona;009;Arbúcies;4416;2188;2228
17;Girona;010;Argelaguer;351;174;177
17;Girona;011;Armentera (L');846;391;455
17;Girona;012;Avinyonet de Puigventós;375;190;185
17;Girona;015;Banyoles;13379;6521;6858
17;Girona;016;Bàscara;774;405;369
17;Girona;013;Begur;2663;1343;1320
17;Girona;018;Bellcaire d'Empordà;484;238;246
17;Girona;019;Besalú;2121;1025;1096
17;Girona;020;Bescanó;2840;1412;1428
17;Girona;021;Beuda;104;56;48
17;Girona;022;Bisbal d'Empordà (La);7962;3926;4036
17;Girona;234;Biure;285;143;142
17;Girona;023;Blanes;24641;12350;12291
17;Girona;029;Boadella d'Empordà;231;122;109
17;Girona;024;Bolvir;224;104;120
17;Girona;025;Bordils;1264;620;644
17;Girona;026;Borrassà;510;254;256
17;Girona;027;Breda;3138;1608;1530
17;Girona;028;Brunyola;406;206;200
17;Girona;031;Cabanelles;256;132;124
17;Girona;030;Cabanes;865;449;416
17;Girona;032;Cadaqués;1801;897;904
17;Girona;033;Caldes de Malavella;3032;1483;1549
17;Girona;034;Calonge;4878;2434;2444
17;Girona;035;Camós;627;327;300
17;Girona;036;Campdevànol;3496;1723;1773
17;Girona;037;Campelles;177;89;88
17;Girona;038;Campllong;267;143;124
17;Girona;039;Camprodon;2296;1123;1173
17;Girona;040;Canet d'Adri;460;241;219
17;Girona;041;Cantallops;256;122;134
17;Girona;042;Capmany;441;235;206
17;Girona;044;Cassà de la Selva;7229;3534;3695
17;Girona;046;Castellfollit de la Roca;1057;503;554
17;Girona;047;Castelló d'Empúries;3874;1943;1931
17;Girona;048;Castell-Platja d'Aro;4973;2518;2455
17;Girona;189;Cellera de Ter (La);2041;988;1053
17;Girona;049;Celrà;2397;1184;1213
17;Girona;050;Cervià de Ter;641;312;329
17;Girona;051;Cistella;205;98;107
17;Girona;054;Colera;432;223;209
17;Girona;055;Colomers;205;103;102
17;Girona;057;Corçà;1123;567;556
17;Girona;056;Cornellà del Terri;1811;920;891
17;Girona;058;Crespià;215;110;105
17;Girona;901;Cruïlles, Monells i Sant Sadurní de l'Heura;1015;509;506
17;Girona;060;Darnius;487;261;226
17;Girona;061;Das;143;76;67
17;Girona;062;Escala (L');5201;2665;2536
17;Girona;063;Espinelves;230;121;109
17;Girona;064;Espolla;399;212;187
17;Girona;065;Esponellà;380;177;203
17;Girona;005;Far d'Empordà (El);414;209;205
17;Girona;066;Figueres;33840;16638;17202
17;Girona;067;Flaçà;955;467;488
17;Girona;068;Foixà;315;154;161
17;Girona;069;Fontanals de Cerdanya;338;179;159
17;Girona;070;Fontanilles;125;69;56
17;Girona;071;Fontcoberta;829;428;401
17;Girona;902;Forallac;1527;771;756
17;Girona;073;Fornells de la Selva;1049;506;543
17;Girona;074;Fortià;508;244;264
17;Girona;075;Garrigàs;313;163;150
17;Girona;076;Garrigoles;159;87;72
17;Girona;077;Garriguella;636;338;298
17;Girona;078;Ger;283;142;141
17;Girona;079;Girona;69739;33832;35907
17;Girona;080;Gombrèn;252;125;127
17;Girona;081;Gualta;294;149;145
17;Girona;082;Guils de Cerdanya;272;139;133
17;Girona;083;Hostalric;2824;1403;1421
17;Girona;084;Isòvol;217;106;111
17;Girona;085;Jafre;335;168;167
17;Girona;086;Jonquera (La);2685;1400;1285
17;Girona;087;Juià;271;132;139
17;Girona;088;Lladó;481;248;233
17;Girona;089;Llagostera;5240;2630;2610
17;Girona;090;Llambilles;446;217;229
17;Girona;091;Llanars;400;210;190
17;Girona;092;Llançà;3371;1719;1652
17;Girona;093;Llers;750;376;374
17;Girona;094;Llívia;893;460;433
17;Girona;095;Lloret de Mar;16380;8277;8103
17;Girona;096;Llosses (Les);380;196;184
17;Girona;102;Maçanet de Cabrenys;742;362;380
17;Girona;103;Maçanet de la Selva;2772;1414;1358
17;Girona;097;Madremanya;206;96;110
17;Girona;098;Maià de Montcal;352;176;176
17;Girona;100;Masarac;261;129;132
17;Girona;101;Massanes;459;244;215
17;Girona;099;Meranges;67;36;31
17;Girona;105;Mieres;385;189;196
17;Girona;106;Mollet de Peralada;172;94;78
17;Girona;107;Molló;376;195;181
17;Girona;109;Montagut i Oix;805;411;394
17;Girona;110;Mont-ras;1270;664;606
17;Girona;111;Navata;651;313;338
17;Girona;112;Ogassa;296;164;132
17;Girona;114;Olot;26660;12888;13772
17;Girona;115;Ordis;294;159;135
17;Girona;116;Osor;520;274;246
17;Girona;117;Palafrugell;16641;8299;8342
17;Girona;118;Palamós;13014;6404;6610
17;Girona;119;Palau de Santa Eulàlia;81;40;41
17;Girona;121;Palau-sator;313;162;151
17;Girona;120;Palau-saverdera;707;358;349
17;Girona;122;Palmerola;16;10;6
17;Girona;123;Palol de Revardit;391;203;188
17;Girona;124;Pals;1699;855;844
17;Girona;125;Pardines;131;71;60
17;Girona;126;Parlavà;340;182;158
17;Girona;128;Pau;316;147;169
17;Girona;129;Pedret i Marzà;140;63;77
17;Girona;130;Pera (La);371;184;187
17;Girona;132;Peralada;1219;631;588
17;Girona;133;Planes d'Hostoles (Les);1842;882;960
17;Girona;134;Planoles;293;156;137
17;Girona;135;Pont de Molins;365;192;173
17;Girona;136;Pontós;199;114;85
17;Girona;137;Porqueres;2974;1474;1500
17;Girona;140;Port de la Selva (El);814;397;417
17;Girona;138;Portbou;1994;990;1004
17;Girona;139;Preses (Les);1324;645;679
17;Girona;141;Puigcerdà;6283;3188;3095
17;Girona;142;Quart;1825;926;899
17;Girona;043;Queralbs;218;116;102
17;Girona;143;Rabós;148;71;77
17;Girona;144;Regencós;256;144;112
17;Girona;145;Ribes de Freser;2576;1244;1332
17;Girona;146;Riells i Viabrea;870;441;429
17;Girona;147;Ripoll;11558;5654;5904
17;Girona;148;Riudarenes;1103;557;546
17;Girona;149;Riudaura;387;186;201
17;Girona;150;Riudellots de la Selva;1239;633;606
17;Girona;151;Riumors;203;93;110
17;Girona;152;Roses;10546;5438;5108
17;Girona;153;Rupià;212;109;103
17;Girona;154;Sales de Llierca;57;36;21
17;Girona;155;Salt;21676;10797;10879
17;Girona;157;Sant Andreu Salou;140;75;65
17;Girona;183;Sant Aniol de Finestres;263;134;129
17;Girona;158;Sant Climent Sescebes;466;249;217
17;Girona;159;Sant Feliu de Buixalleu;617;328;289
17;Girona;160;Sant Feliu de Guíxols;16907;8231;8676
17;Girona;161;Sant Feliu de Pallerols;1059;509;550
17;Girona;162;Sant Ferriol;176;98;78
17;Girona;163;Sant Gregori;1828;940;888
17;Girona;164;Sant Hilari Sacalm;4634;2350;2284
17;Girona;165;Sant Jaume de Llierca;761;385;376
17;Girona;167;Sant Joan de les Abadesses;3996;1928;2068
17;Girona;168;Sant Joan de Mollet;311;154;157
17;Girona;185;Sant Joan les Fonts;2930;1465;1465
17;Girona;166;Sant Jordi Desvalls;586;291;295
17;Girona;169;Sant Julià de Ramis;1721;862;859
17;Girona;903;Sant Julià del Llor i Bonmatí;873;418;455
17;Girona;171;Sant Llorenç de la Muga;161;75;86
17;Girona;172;Sant Martí de Llémena;321;176;145
17;Girona;173;Sant Martí Vell;208;103;105
17;Girona;174;Sant Miquel de Campmajor;213;124;89
17;Girona;175;Sant Miquel de Fluvià;564;289;275
17;Girona;176;Sant Mori;145;69;76
17;Girona;177;Sant Pau de Segúries;612;304;308
17;Girona;178;Sant Pere Pescador;1208;631;577
17;Girona;180;Santa Coloma de Farners;7988;4052;3936
17;Girona;181;Santa Cristina d'Aro;1702;906;796
17;Girona;182;Santa Llogaia d'Àlguema;305;157;148
17;Girona;184;Santa Pau;1371;703;668
17;Girona;186;Sarrià de Ter;3453;1729;1724
17;Girona;187;Saus;701;354;347
17;Girona;188;Selva de Mar (La);154;82;72
17;Girona;190;Serinyà;709;349;360
17;Girona;191;Serra de Daró;188;99;89
17;Girona;192;Setcases;166;85;81
17;Girona;193;Sils;2242;1135;1107
17;Girona;052;Siurana;175;78;97
17;Girona;194;Susqueda;118;61;57
17;Girona;195;Tallada d'Empordà (La);360;185;175
17;Girona;196;Terrades;185;86;99
17;Girona;197;Torrent;199;103;96
17;Girona;198;Torroella de Fluvià;279;149;130
17;Girona;199;Torroella de Montgrí;6733;3375;3358
17;Girona;200;Tortellà;728;357;371
17;Girona;201;Toses;151;88;63
17;Girona;202;Tossa de Mar;3641;1828;1813
17;Girona;204;Ullà;739;372;367
17;Girona;205;Ullastret;275;133;142
17;Girona;203;Ultramort;214;109;105
17;Girona;206;Urús;112;52;60
17;Girona;014;Vajol (La);65;34;31
17;Girona;208;Vall de Bianya (La);1048;518;530
17;Girona;207;Vall d'en Bas (La);2590;1332;1258
17;Girona;170;Vallfogona de Ripollès;258;130;128
17;Girona;209;Vall-llobrega;263;135;128
17;Girona;210;Ventalló;543;288;255
17;Girona;211;Verges;1171;574;597
17;Girona;212;Vidrà;178;85;93
17;Girona;213;Vidreres;3733;1884;1849
17;Girona;214;Vilabertran;771;387;384
17;Girona;215;Vilablareix;989;493;496
17;Girona;217;Viladamat;356;187;169
17;Girona;216;Viladasens;181;94;87
17;Girona;218;Vilademuls;789;408;381
17;Girona;220;Viladrau;823;416;407
17;Girona;221;Vilafant;2490;1222;1268
17;Girona;223;Vilajuïga;684;334;350
17;Girona;224;Vilallonga de Ter;436;222;214
17;Girona;225;Vilamacolum;262;124;138
17;Girona;226;Vilamalla;585;291;294
17;Girona;227;Vilamaniscle;123;55;68
17;Girona;228;Vilanant;287;147;140
17;Girona;230;Vila-sacra;446;224;222
17;Girona;222;Vilaür;108;50;58
17;Girona;233;Vilobí d'Onyar;2000;1037;963
17;Girona;232;Vilopriu;184;90;94
18;Granada;001;Agrón;476;243;233
18;Granada;002;Alamedilla;1114;554;560
18;Granada;003;Albolote;9001;4478;4523
18;Granada;004;Albondón;1421;716;705
18;Granada;005;Albuñán;537;275;262
18;Granada;006;Albuñol;5773;2865;2908
18;Granada;007;Albuñuelas;1454;742;712
18;Granada;010;Aldeire;909;453;456
18;Granada;011;Alfacar;3451;1754;1697
18;Granada;012;Algarinejo;5057;2592;2465
18;Granada;013;Alhama de Granada;6113;3119;2994
18;Granada;014;Alhendín;3491;1737;1754
18;Granada;015;Alicún de Ortega;804;413;391
18;Granada;016;Almegíjar;543;275;268
18;Granada;017;Almuñécar;18436;9153;9283
18;Granada;904;Alpujarra de la Sierra;1442;737;705
18;Granada;018;Alquife;1303;645;658
18;Granada;020;Arenas del Rey;2173;1131;1042
18;Granada;021;Armilla;10824;5441;5383
18;Granada;022;Atarfe;10004;4918;5086
18;Granada;023;Baza;20998;10208;10790
18;Granada;024;Beas de Granada;880;445;435
18;Granada;025;Beas de Guadix;464;242;222
18;Granada;027;Benalúa;3573;1814;1759
18;Granada;028;Benalúa de las Villas;1419;691;728
18;Granada;029;Benamaurel;2724;1409;1315
18;Granada;030;Bérchules;1001;508;493
18;Granada;032;Bubión;323;166;157
18;Granada;033;Busquístar;425;219;206
18;Granada;034;Cacín;963;495;468
18;Granada;035;Cádiar;2086;1056;1030
18;Granada;036;Cájar;1811;828;983
18;Granada;114;Calahorra (La);1094;536;558
18;Granada;037;Calicasas;610;294;316
18;Granada;038;Campotéjar;1508;735;773
18;Granada;039;Caniles;6049;2959;3090
18;Granada;040;Cáñar;363;173;190
18;Granada;042;Capileira;607;300;307
18;Granada;043;Carataunas;175;90;85
18;Granada;044;Cástaras;381;195;186
18;Granada;045;Castilléjar;2404;1191;1213
18;Granada;046;Castril;3552;1837;1715
18;Granada;047;Cenes de la Vega;1769;906;863
18;Granada;059;Chauchina;4009;1978;2031
18;Granada;061;Chimeneas;1631;817;814
18;Granada;062;Churriana de la Vega;5010;2475;2535
18;Granada;048;Cijuela;1212;581;631
18;Granada;049;Cogollos de Guadix;816;441;375
18;Granada;050;Cogollos de la Vega;1916;970;946
18;Granada;051;Colomera;2009;1019;990
18;Granada;053;Cortes de Baza;3219;1655;1564
18;Granada;054;Cortes y Graena;1012;527;485
18;Granada;912;Cuevas del Campo;2594;1295;1299
18;Granada;056;Cúllar;5824;2853;2971
18;Granada;057;Cúllar Vega;1533;770;763
18;Granada;063;Darro;1664;808;856
18;Granada;064;Dehesas de Guadix;979;492;487
18;Granada;066;Deifontes;2525;1297;1228
18;Granada;067;Diezma;1140;597;543
18;Granada;068;Dílar;1342;663;679
18;Granada;069;Dólar;708;352;356
18;Granada;070;Dúdar;273;138;135
18;Granada;071;Dúrcal;5718;2840;2878
18;Granada;072;Escúzar;1154;582;572
18;Granada;074;Ferreira;444;206;238
18;Granada;076;Fonelas;1609;815;794
18;Granada;078;Freila;1387;701;686
18;Granada;079;Fuente Vaqueros;3806;1904;1902
18;Granada;905;Gabias (Las);5663;2830;2833
18;Granada;082;Galera;1870;918;952
18;Granada;083;Gobernador;442;213;229
18;Granada;084;Gójar;2152;1079;1073
18;Granada;085;Gor;1492;745;747
18;Granada;086;Gorafe;731;383;348
18;Granada;087;Granada;265265;125401;139864
18;Granada;088;Guadahortuna;2593;1318;1275
18;Granada;089;Guadix;20809;10203;10606
18;Granada;906;Guajares (Los);1612;826;786
18;Granada;093;Gualchos;3002;1494;1508
18;Granada;094;Güejar Sierra;2662;1348;1314
18;Granada;095;Güevéjar;1191;573;618
18;Granada;096;Huélago;737;387;350
18;Granada;097;Huéneja;1568;775;793
18;Granada;098;Huéscar;10338;5164;5174
18;Granada;099;Huétor de Santillán;1428;744;684
18;Granada;100;Huétor Tájar;7910;3983;3927
18;Granada;101;Huétor Vega;6273;3134;3139
18;Granada;102;Illora;10718;5399;5319
18;Granada;103;Itrabo;1179;597;582
18;Granada;105;Iznalloz;6966;3563;3403
18;Granada;107;Jayena;1539;810;729
18;Granada;108;Jerez del Marquesado;1346;679;667
18;Granada;109;Jete;746;371;375
18;Granada;111;Jun;859;423;436
18;Granada;112;Juviles;175;83;92
18;Granada;115;Láchar;2293;1161;1132
18;Granada;116;Lanjarón;4189;2079;2110
18;Granada;117;Lanteira;780;402;378
18;Granada;119;Lecrín;2612;1281;1331
18;Granada;120;Lentegí;370;179;191
18;Granada;121;Lobras;257;123;134
18;Granada;122;Loja;21066;10561;10505
18;Granada;123;Lugros;576;312;264
18;Granada;124;Lújar;697;362;335
18;Granada;126;Malahá (La);1687;862;825
18;Granada;127;Maracena;11925;5945;5980
18;Granada;128;Marchal;523;251;272
18;Granada;132;Moclín;5146;2596;2550
18;Granada;133;Molvízar;2516;1259;1257
18;Granada;134;Monachil;4000;2027;1973
18;Granada;135;Montefrío;8381;4264;4117
18;Granada;136;Montejícar;3014;1525;1489
18;Granada;137;Montillana;1435;725;710
18;Granada;138;Moraleda de Zafayona;2615;1319;1296
18;Granada;909;Morelábor;1126;545;581
18;Granada;140;Motril;46528;23117;23411
18;Granada;141;Murtas;1235;618;617
18;Granada;903;Nevada;1574;809;765
18;Granada;143;Nigüelas;1205;614;591
18;Granada;144;Nívar;481;246;235
18;Granada;145;Ogíjares;3823;1918;1905
18;Granada;146;Orce;1612;805;807
18;Granada;147;Órgiva;5264;2632;2632
18;Granada;148;Otívar;1217;611;606
18;Granada;149;Otura;2301;1145;1156
18;Granada;150;Padul;6370;3140;3230
18;Granada;151;Pampaneira;365;189;176
18;Granada;152;Pedro Martínez;1948;974;974
18;Granada;153;Peligros;5695;2847;2848
18;Granada;154;Peza (La);1686;883;803
18;Granada;910;Pinar (El);1434;709;725
18;Granada;157;Pinos Genil;984;504;480
18;Granada;158;Pinos Puente;14213;7052;7161
18;Granada;159;Píñar;1570;813;757
18;Granada;161;Polícar;276;146;130
18;Granada;162;Polopos;1342;713;629
18;Granada;163;Pórtugos;468;237;231
18;Granada;164;Puebla de Don Fadrique;2969;1471;1498
18;Granada;165;Pulianas;2372;1185;1187
18;Granada;167;Purullena;2819;1412;1407
18;Granada;168;Quéntar;1278;645;633
18;Granada;170;Rubite;524;271;253
18;Granada;171;Salar;2883;1422;1461
18;Granada;173;Salobreña;9409;4657;4752
18;Granada;174;Santa Cruz del Comercio;619;333;286
18;Granada;175;Santa Fe;11941;5825;6116
18;Granada;176;Soportújar;270;139;131
18;Granada;177;Sorvilán;964;490;474
18;Granada;901;Taha (La);933;468;465
18;Granada;178;Torre-Cardela;1468;736;732
18;Granada;179;Torvizcón;1265;619;646
18;Granada;180;Trevélez;873;455;418
18;Granada;181;Turón;490;274;216
18;Granada;182;Ugíjar;3147;1536;1611
18;Granada;907;Valle del Zalabí;2664;1331;1333
18;Granada;902;Valle (El);1615;806;809
18;Granada;183;Válor;1173;584;589
18;Granada;911;Vegas del Genil;2682;1347;1335
18;Granada;184;Vélez de Benaudalla;2581;1275;1306
18;Granada;185;Ventas de Huelma;759;379;380
18;Granada;908;Villamena;1169;552;617
18;Granada;187;Villanueva de las Torres;1110;591;519
18;Granada;188;Villanueva Mesía;1867;938;929
18;Granada;189;Víznar;677;337;340
18;Granada;192;Zafarraya;2287;1160;1127
18;Granada;913;Zagra;1449;732;717
18;Granada;193;Zubia (La);7695;3846;3849
18;Granada;194;Zújar;3350;1718;1632
19;Guadalajara;001;Abánades;129;74;55
19;Guadalajara;002;Ablanque;168;92;76
19;Guadalajara;003;Adobes;39;19;20
19;Guadalajara;004;Alaminos;120;56;64
19;Guadalajara;005;Alarilla;110;58;52
19;Guadalajara;006;Albalate de Zorita;1056;550;506
19;Guadalajara;007;Albares;530;270;260
19;Guadalajara;008;Albendiego;71;38;33
19;Guadalajara;009;Alcocer;368;179;189
19;Guadalajara;010;Alcolea de las Peñas;44;27;17
19;Guadalajara;011;Alcolea del Pinar;512;261;251
19;Guadalajara;013;Alcoroches;199;106;93
19;Guadalajara;015;Aldeanueva de Guadalajara;122;61;61
19;Guadalajara;016;Algar de Mesa;102;52;50
19;Guadalajara;017;Algora;121;73;48
19;Guadalajara;018;Alhóndiga;290;159;131
19;Guadalajara;019;Alique;13;6;7
19;Guadalajara;020;Almadrones;129;81;48
19;Guadalajara;021;Almoguera;772;390;382
19;Guadalajara;022;Almonacid de Zorita;975;511;464
19;Guadalajara;023;Alocén;129;65;64
19;Guadalajara;024;Alovera;1359;681;678
19;Guadalajara;027;Alustante;318;167;151
19;Guadalajara;031;Angón;37;22;15
19;Guadalajara;032;Anguita;424;216;208
19;Guadalajara;033;Anquela del Ducado;86;43;43
19;Guadalajara;034;Anquela del Pedregal;37;20;17
19;Guadalajara;036;Aranzueque;373;187;186
19;Guadalajara;037;Arbancón;226;128;98
19;Guadalajara;038;Arbeteta;52;30;22
19;Guadalajara;039;Argecilla;143;84;59
19;Guadalajara;040;Armallones;95;52;43
19;Guadalajara;041;Armuña de Tajuña;112;61;51
19;Guadalajara;042;Arroyo de las Fraguas;19;11;8
19;Guadalajara;043;Atanzón;127;71;56
19;Guadalajara;044;Atienza;545;290;255
19;Guadalajara;045;Auñón;277;148;129
19;Guadalajara;046;Azuqueca de Henares;11074;5599;5475
19;Guadalajara;047;Baides;85;43;42
19;Guadalajara;048;Baños de Tajo;39;25;14
19;Guadalajara;049;Bañuelos;45;22;23
19;Guadalajara;050;Barriopedro;25;11;14
19;Guadalajara;051;Berninches;135;80;55
19;Guadalajara;052;Bodera (La);56;31;25
19;Guadalajara;053;Brihuega;3241;1728;1513
19;Guadalajara;054;Budia;366;193;173
19;Guadalajara;055;Bujalaro;149;84;65
19;Guadalajara;057;Bustares;158;85;73
19;Guadalajara;058;Cabanillas del Campo;972;512;460
19;Guadalajara;059;Campillo de Dueñas;191;107;84
19;Guadalajara;060;Campillo de Ranas;98;43;55
19;Guadalajara;061;Campisábalos;81;38;43
19;Guadalajara;064;Canredondo;141;74;67
19;Guadalajara;065;Cantalojas;183;103;80
19;Guadalajara;066;Cañizar;123;64;59
19;Guadalajara;067;Cardoso de la Sierra (El);122;74;48
19;Guadalajara;070;Casa de Uceda;154;77;77
19;Guadalajara;071;Casar (El);1350;701;649
19;Guadalajara;073;Casas de San Galindo;40;23;17
19;Guadalajara;074;Caspueñas;53;26;27
19;Guadalajara;075;Castejón de Henares;137;73;64
19;Guadalajara;076;Castellar de la Muela;73;40;33
19;Guadalajara;078;Castilforte;56;32;24
19;Guadalajara;079;Castilnuevo;14;3;11
19;Guadalajara;080;Cendejas de Enmedio;173;85;88
19;Guadalajara;081;Cendejas de la Torre;163;94;69
19;Guadalajara;082;Centenera;96;51;45
19;Guadalajara;103;Checa;502;255;247
19;Guadalajara;104;Chequilla;30;14;16
19;Guadalajara;106;Chillarón del Rey;136;74;62
19;Guadalajara;105;Chiloeches;1081;563;518
19;Guadalajara;086;Cifuentes;2536;1326;1210
19;Guadalajara;087;Cincovillas;44;22;22
19;Guadalajara;088;Ciruelas;70;36;34
19;Guadalajara;089;Ciruelos del Pinar;99;49;50
19;Guadalajara;090;Cobeta;143;73;70
19;Guadalajara;091;Cogollor;73;40;33
19;Guadalajara;092;Cogolludo;703;382;321
19;Guadalajara;095;Condemios de Abajo;34;20;14
19;Guadalajara;096;Condemios de Arriba;227;119;108
19;Guadalajara;097;Congostrina;50;23;27
19;Guadalajara;098;Copernal;33;18;15
19;Guadalajara;099;Corduente;545;294;251
19;Guadalajara;102;Cubillo de Uceda (El);157;79;78
19;Guadalajara;107;Driebes;407;227;180
19;Guadalajara;108;Durón;90;51;39
19;Guadalajara;109;Embid;83;48;35
19;Guadalajara;110;Escamilla;166;86;80
19;Guadalajara;111;Escariche;246;119;127
19;Guadalajara;112;Escopete;65;28;37
19;Guadalajara;113;Espinosa de Henares;531;260;271
19;Guadalajara;114;Esplegares;98;56;42
19;Guadalajara;115;Establés;70;34;36
19;Guadalajara;116;Estriégana;36;18;18
19;Guadalajara;117;Fontanar;724;362;362
19;Guadalajara;118;Fuembellida;25;14;11
19;Guadalajara;119;Fuencemillán;140;73;67
19;Guadalajara;120;Fuentelahiguera de Albatages;263;126;137
19;Guadalajara;121;Fuentelencina;229;122;107
19;Guadalajara;122;Fuentelsaz;172;83;89
19;Guadalajara;123;Fuentelviejo;100;51;49
19;Guadalajara;124;Fuentenovilla;256;151;105
19;Guadalajara;125;Gajanejos;115;68;47
19;Guadalajara;126;Galápagos;200;113;87
19;Guadalajara;127;Galve de Sorbe;195;100;95
19;Guadalajara;129;Gascueña de Bornova;43;23;20
19;Guadalajara;130;Guadalajara;62366;31017;31349
19;Guadalajara;132;Henche;24;16;8
19;Guadalajara;133;Heras de Ayuso;139;74;65
19;Guadalajara;134;Herrería;45;21;24
19;Guadalajara;135;Hiendelaencina;176;99;77
19;Guadalajara;136;Hijes;30;18;12
19;Guadalajara;138;Hita;268;154;114
19;Guadalajara;139;Hombrados;71;37;34
19;Guadalajara;142;Hontoba;141;70;71
19;Guadalajara;143;Horche;1137;599;538
19;Guadalajara;145;Hortezuela de Océn;113;63;50
19;Guadalajara;146;Huerce (La);34;19;15
19;Guadalajara;147;Huérmeces del Cerro;69;42;27
19;Guadalajara;148;Huertahernando;91;51;40
19;Guadalajara;150;Hueva;152;82;70
19;Guadalajara;151;Humanes;1221;634;587
19;Guadalajara;152;Illana;737;374;363
19;Guadalajara;153;Iniéstola;28;16;12
19;Guadalajara;154;Inviernas (Las);120;69;51
19;Guadalajara;155;Irueste;86;43;43
19;Guadalajara;156;Jadraque;1249;613;636
19;Guadalajara;157;Jirueque;72;42;30
19;Guadalajara;159;Ledanca;212;108;104
19;Guadalajara;160;Loranca de Tajuña;293;158;135
19;Guadalajara;161;Lupiana;272;142;130
19;Guadalajara;162;Luzaga;147;67;80
19;Guadalajara;163;Luzón;110;57;53
19;Guadalajara;165;Majaelrayo;63;32;31
19;Guadalajara;166;Málaga del Fresno;253;139;114
19;Guadalajara;167;Malaguilla;211;115;96
19;Guadalajara;168;Mandayona;543;256;287
19;Guadalajara;169;Mantiel;37;16;21
19;Guadalajara;170;Maranchón;271;133;138
19;Guadalajara;171;Marchamalo;"";"";""
19;Guadalajara;172;Masegoso de Tajuña;127;64;63
19;Guadalajara;173;Matarrubia;49;30;19
19;Guadalajara;174;Matillas;302;154;148
19;Guadalajara;175;Mazarete;119;59;60
19;Guadalajara;176;Mazuecos;470;243;227
19;Guadalajara;177;Medranda;165;89;76
19;Guadalajara;178;Megina;91;42;49
19;Guadalajara;179;Membrillera;93;53;40
19;Guadalajara;181;Miedes de Atienza;168;82;86
19;Guadalajara;182;Mierla (La);36;21;15
19;Guadalajara;184;Millana;117;57;60
19;Guadalajara;183;Milmarcos;130;68;62
19;Guadalajara;185;Miñosa (La);73;39;34
19;Guadalajara;186;Mirabueno;132;75;57
19;Guadalajara;187;Miralrío;126;66;60
19;Guadalajara;188;Mochales;173;89;84
19;Guadalajara;189;Mohernando;135;81;54
19;Guadalajara;190;Molina de Aragón;3916;2010;1906
19;Guadalajara;191;Monasterio;17;8;9
19;Guadalajara;192;Mondéjar;2181;1071;1110
19;Guadalajara;193;Montarrón;89;49;40
19;Guadalajara;194;Moratilla de los Meleros;131;75;56
19;Guadalajara;195;Morenilla;69;45;24
19;Guadalajara;196;Muduex;138;74;64
19;Guadalajara;197;Navas de Jadraque (Las);29;17;12
19;Guadalajara;198;Negredo;26;11;15
19;Guadalajara;199;Ocentejo;55;24;31
19;Guadalajara;200;Olivar (El);53;30;23
19;Guadalajara;201;Olmeda de Cobeta;90;35;55
19;Guadalajara;202;Olmeda de Jadraque (La);11;7;4
19;Guadalajara;203;Ordial (El);50;18;32
19;Guadalajara;204;Orea;364;192;172
19;Guadalajara;208;Pálmaces de Jadraque;108;56;52
19;Guadalajara;209;Pardos;72;35;37
19;Guadalajara;210;Paredes de Sigüenza;86;44;42
19;Guadalajara;211;Pareja;501;249;252
19;Guadalajara;212;Pastrana;1219;609;610
19;Guadalajara;213;Pedregal (El);123;64;59
19;Guadalajara;214;Peñalén;197;96;101
19;Guadalajara;215;Peñalver;329;186;143
19;Guadalajara;216;Peralejos de las Truchas;200;108;92
19;Guadalajara;217;Peralveche;74;39;35
19;Guadalajara;218;Pinilla de Jadraque;102;53;49
19;Guadalajara;219;Pinilla de Molina;32;16;16
19;Guadalajara;220;Pioz;182;100;82
19;Guadalajara;221;Piqueras;51;29;22
19;Guadalajara;222;Pobo de Dueñas (El);209;114;95
19;Guadalajara;223;Poveda de la Sierra;208;103;105
19;Guadalajara;224;Pozo de Almoguera;239;124;115
19;Guadalajara;225;Pozo de Guadalajara;345;190;155
19;Guadalajara;226;Prádena de Atienza;54;32;22
19;Guadalajara;227;Prados Redondos;123;70;53
19;Guadalajara;228;Puebla de Beleña;38;22;16
19;Guadalajara;229;Puebla de Valles;87;45;42
19;Guadalajara;230;Quer;109;55;54
19;Guadalajara;231;Rebollosa de Jadraque;42;24;18
19;Guadalajara;232;Recuenco (El);146;74;72
19;Guadalajara;233;Renera;57;26;31
19;Guadalajara;234;Retiendas;32;15;17
19;Guadalajara;235;Riba de Saelices;188;105;83
19;Guadalajara;237;Rillo de Gallo;96;47;49
19;Guadalajara;238;Riofrío del Llano;106;56;50
19;Guadalajara;239;Robledillo de Mohernando;188;98;90
19;Guadalajara;240;Robledo de Corpes;94;42;52
19;Guadalajara;241;Romanillos de Atienza;87;51;36
19;Guadalajara;242;Romanones;188;106;82
19;Guadalajara;243;Rueda de la Sierra;94;47;47
19;Guadalajara;244;Sacecorbo;161;83;78
19;Guadalajara;245;Sacedón;1752;891;861
19;Guadalajara;246;Saelices de la Sal;85;45;40
19;Guadalajara;247;Salmerón;316;164;152
19;Guadalajara;248;San Andrés del Congosto;80;45;35
19;Guadalajara;249;San Andrés del Rey;49;22;27
19;Guadalajara;250;Santiuste;18;8;10
19;Guadalajara;251;Saúca;64;34;30
19;Guadalajara;252;Sayatón;220;109;111
19;Guadalajara;254;Selas;80;38;42
19;Guadalajara;901;Semillas;32;19;13
19;Guadalajara;255;Setiles;265;136;129
19;Guadalajara;256;Sienes;110;65;45
19;Guadalajara;257;Sigüenza;5128;2548;2580
19;Guadalajara;258;Solanillos del Extremo;116;60;56
19;Guadalajara;259;Somolinos;57;26;31
19;Guadalajara;260;Sotillo (El);59;39;20
19;Guadalajara;261;Sotodosos;88;44;44
19;Guadalajara;262;Tamajón;214;112;102
19;Guadalajara;263;Taragudo;30;15;15
19;Guadalajara;264;Taravilla;84;42;42
19;Guadalajara;265;Tartanedo;261;131;130
19;Guadalajara;266;Tendilla;424;225;199
19;Guadalajara;267;Terzaga;54;31;23
19;Guadalajara;268;Tierzo;53;27;26
19;Guadalajara;269;Toba (La);136;71;65
19;Guadalajara;271;Tordellego;111;56;55
19;Guadalajara;270;Tordelrábano;21;8;13
19;Guadalajara;272;Tordesilos;174;91;83
19;Guadalajara;274;Torija;356;182;174
19;Guadalajara;279;Torre del Burgo;54;29;25
19;Guadalajara;276;Torrecilla del Ducado;9;5;4
19;Guadalajara;277;Torrecuadrada de Molina;28;17;11
19;Guadalajara;278;Torrecuadradilla;93;53;40
19;Guadalajara;280;Torrejón del Rey;425;235;190
19;Guadalajara;281;Torremocha de Jadraque;19;13;6
19;Guadalajara;282;Torremocha del Campo;419;230;189
19;Guadalajara;283;Torremocha del Pinar;106;53;53
19;Guadalajara;284;Torremochuela;11;6;5
19;Guadalajara;285;Torrubia;53;26;27
19;Guadalajara;286;Tórtola de Henares;421;213;208
19;Guadalajara;287;Tortuera;304;153;151
19;Guadalajara;288;Tortuero;32;19;13
19;Guadalajara;289;Traíd;61;33;28
19;Guadalajara;290;Trijueque;305;159;146
19;Guadalajara;291;Trillo;1434;761;673
19;Guadalajara;293;Uceda;443;229;214
19;Guadalajara;294;Ujados;53;30;23
19;Guadalajara;296;Utande;82;47;35
19;Guadalajara;297;Valdarachas;30;14;16
19;Guadalajara;298;Valdearenas;74;38;36
19;Guadalajara;299;Valdeavellano;100;51;49
19;Guadalajara;300;Valdeaveruelo;143;77;66
19;Guadalajara;301;Valdeconcha;46;20;26
19;Guadalajara;302;Valdegrudas;75;39;36
19;Guadalajara;303;Valdelcubo;80;44;36
19;Guadalajara;304;Valdenuño Fernández;149;79;70
19;Guadalajara;305;Valdepeñas de la Sierra;308;167;141
19;Guadalajara;306;Valderrebollo;43;26;17
19;Guadalajara;307;Valdesotos;56;25;31
19;Guadalajara;308;Valfermoso de Tajuña;86;52;34
19;Guadalajara;309;Valhermoso;57;31;26
19;Guadalajara;310;Valtablado del Río;19;12;7
19;Guadalajara;311;Valverde de los Arroyos;83;42;41
19;Guadalajara;314;Viana de Jadraque;77;41;36
19;Guadalajara;317;Villanueva de Alcorón;370;198;172
19;Guadalajara;318;Villanueva de Argecilla;55;32;23
19;Guadalajara;319;Villanueva de la Torre;107;47;60
19;Guadalajara;321;Villares de Jadraque;50;25;25
19;Guadalajara;322;Villaseca de Henares;97;49;48
19;Guadalajara;323;Villaseca de Uceda;70;35;35
19;Guadalajara;324;Villel de Mesa;305;143;162
19;Guadalajara;325;Viñuelas;165;88;77
19;Guadalajara;326;Yebes;58;30;28
19;Guadalajara;327;Yebra;633;320;313
19;Guadalajara;329;Yélamos de Abajo;114;58;56
19;Guadalajara;330;Yélamos de Arriba;161;87;74
19;Guadalajara;331;Yunquera de Henares;1890;965;925
19;Guadalajara;332;Yunta (La);218;106;112
19;Guadalajara;333;Zaorejas;248;130;118
19;Guadalajara;334;Zarzuela de Jadraque;38;23;15
19;Guadalajara;335;Zorita de los Canes;111;57;54
20;Guipúzcoa;001;Abaltzisketa;288;157;131
20;Guipúzcoa;002;Aduna;338;179;159
20;Guipúzcoa;016;Aia;1755;1007;748
20;Guipúzcoa;003;Aizarnazabal;553;300;253
20;Guipúzcoa;004;Albiztur;312;166;146
20;Guipúzcoa;005;Alegia;1686;888;798
20;Guipúzcoa;006;Alkiza;263;148;115
20;Guipúzcoa;906;Altzaga;"";"";""
20;Guipúzcoa;007;Altzo;329;185;144
20;Guipúzcoa;008;Amezketa;1082;592;490
20;Guipúzcoa;009;Andoain;15794;7878;7916
20;Guipúzcoa;010;Anoeta;1871;935;936
20;Guipúzcoa;011;Antzuola;2109;1093;1016
20;Guipúzcoa;012;Arama;154;78;76
20;Guipúzcoa;013;Aretxabaleta;6049;3080;2969
20;Guipúzcoa;055;Arrasate/Mondragón;26026;13046;12980
20;Guipúzcoa;014;Asteasu;1241;670;571
20;Guipúzcoa;903;Astigarraga;3253;1623;1630
20;Guipúzcoa;015;Ataun;1801;927;874
20;Guipúzcoa;017;Azkoitia;10629;5305;5324
20;Guipúzcoa;018;Azpeitia;13342;6738;6604
20;Guipúzcoa;904;Baliarrain;98;52;46
20;Guipúzcoa;019;Beasain;12454;6325;6129
20;Guipúzcoa;020;Beizama;165;90;75
20;Guipúzcoa;021;Belauntza;312;166;146
20;Guipúzcoa;022;Berastegi;958;541;417
20;Guipúzcoa;074;Bergara;15784;7878;7906
20;Guipúzcoa;023;Berrobi;580;321;259
20;Guipúzcoa;024;Bidegoyan;480;270;210
20;Guipúzcoa;029;Deba;4886;2509;2377
20;Guipúzcoa;069;Donostia/San Sebastián;181794;85534;96260
20;Guipúzcoa;030;Eibar;33816;16867;16949
20;Guipúzcoa;031;Elduain;252;137;115
20;Guipúzcoa;033;Elgeta;1030;520;510
20;Guipúzcoa;032;Elgoibar;12193;6190;6003
20;Guipúzcoa;067;Errenteria;42736;21243;21493
20;Guipúzcoa;066;Errezil;716;399;317
20;Guipúzcoa;034;Eskoriatza;3973;2064;1909
20;Guipúzcoa;035;Ezkio-Itsaso;579;299;280
20;Guipúzcoa;038;Gabiria;440;246;194
20;Guipúzcoa;037;Gaintza;125;72;53
20;Guipúzcoa;907;Gaztelu;"";"";""
20;Guipúzcoa;039;Getaria;2332;1178;1154
20;Guipúzcoa;040;Hernani;19012;9479;9533
20;Guipúzcoa;041;Hernialde;287;155;132
20;Guipúzcoa;036;Hondarribia;13517;6754;6763
20;Guipúzcoa;042;Ibarra;4476;2305;2171
20;Guipúzcoa;043;Idiazabal;2084;1054;1030
20;Guipúzcoa;044;Ikaztegieta;404;199;205
20;Guipúzcoa;045;Irún;54959;27024;27935
20;Guipúzcoa;046;Irura;650;321;329
20;Guipúzcoa;047;Itsasondo;768;393;375
20;Guipúzcoa;048;Larraul;158;96;62
20;Guipúzcoa;902;Lasarte-Oria;18414;9226;9188
20;Guipúzcoa;049;Lazkao;5216;2680;2536
20;Guipúzcoa;050;Leaburu;602;333;269
20;Guipúzcoa;051;Legazpi;10215;5272;4943
20;Guipúzcoa;052;Legorreta;1544;783;761
20;Guipúzcoa;068;Leintz-Gatzaga;221;122;99
20;Guipúzcoa;053;Lezo;5628;2785;2843
20;Guipúzcoa;054;Lizartza;716;382;334
20;Guipúzcoa;901;Mendaro;1541;786;755
20;Guipúzcoa;057;Mutiloa;195;97;98
20;Guipúzcoa;056;Mutriku;4696;2358;2338
20;Guipúzcoa;063;Oiartzun;8334;4164;4170
20;Guipúzcoa;058;Olaberria;1221;628;593
20;Guipúzcoa;076;Ordizia;9418;4620;4798
20;Guipúzcoa;905;Orendain;184;109;75
20;Guipúzcoa;060;Orexa;82;43;39
20;Guipúzcoa;061;Orio;4316;2191;2125
20;Guipúzcoa;062;Ormaiztegi;1277;631;646
20;Guipúzcoa;059;Oñati;10859;5457;5402
20;Guipúzcoa;064;Pasaia;19253;9432;9821
20;Guipúzcoa;070;Segura;1345;691;654
20;Guipúzcoa;065;Soraluze/Placencia de las Armas;5037;2522;2515
20;Guipúzcoa;071;Tolosa;18340;8830;9510
20;Guipúzcoa;072;Urnieta;4437;2276;2161
20;Guipúzcoa;077;Urretxu;6340;3257;3083
20;Guipúzcoa;073;Usurbil;5521;2827;2694
20;Guipúzcoa;075;Villabona;5303;2691;2612
20;Guipúzcoa;078;Zaldibia;1614;847;767
20;Guipúzcoa;079;Zarautz;17027;8465;8562
20;Guipúzcoa;025;Zegama;1450;740;710
20;Guipúzcoa;026;Zerain;232;112;120
20;Guipúzcoa;027;Zestoa;3572;1874;1698
20;Guipúzcoa;028;Zizurkil;2781;1413;1368
20;Guipúzcoa;081;Zumaia;8157;4098;4059
20;Guipúzcoa;080;Zumarraga;11454;5789;5665
21;Huelva;001;Alájar;899;450;449
21;Huelva;002;Aljaraque;5781;2886;2895
21;Huelva;003;Almendro (El);901;469;432
21;Huelva;004;Almonaster la Real;2367;1166;1201
21;Huelva;005;Almonte;16032;8104;7928
21;Huelva;006;Alosno;4994;2412;2582
21;Huelva;007;Aracena;6516;3160;3356
21;Huelva;008;Aroche;3859;1887;1972
21;Huelva;009;Arroyomolinos de León;1327;661;666
21;Huelva;010;Ayamonte;17385;8639;8746
21;Huelva;011;Beas;4051;2019;2032
21;Huelva;012;Berrocal;428;220;208
21;Huelva;013;Bollullos Par del Condado;12526;6227;6299
21;Huelva;014;Bonares;4882;2462;2420
21;Huelva;015;Cabezas Rubias;968;498;470
21;Huelva;016;Cala;1546;774;772
21;Huelva;017;Calañas;5325;2609;2716
21;Huelva;018;Campillo (El);2850;1385;1465
21;Huelva;019;Campofrío;896;453;443
21;Huelva;020;Cañaveral de León;610;293;317
21;Huelva;021;Cartaya;10421;5234;5187
21;Huelva;022;Castaño del Robledo;206;104;102
21;Huelva;023;Cerro de Andévalo (El);3111;1533;1578
21;Huelva;030;Chucena;1932;990;942
21;Huelva;024;Corteconcepción;726;371;355
21;Huelva;025;Cortegana;5501;2684;2817
21;Huelva;026;Cortelazor;373;182;191
21;Huelva;027;Cumbres de Enmedio;60;28;32
21;Huelva;028;Cumbres de San Bartolomé;727;364;363
21;Huelva;029;Cumbres Mayores;2508;1194;1314
21;Huelva;031;Encinasola;2401;1163;1238
21;Huelva;032;Escacena del Campo;2217;1096;1121
21;Huelva;033;Fuenteheridos;651;323;328
21;Huelva;034;Galaroza;1665;803;862
21;Huelva;035;Gibraleón;9780;4912;4868
21;Huelva;036;Granada de Río-Tinto (La);235;127;108
21;Huelva;037;Granado (El);723;373;350
21;Huelva;038;Higuera de la Sierra;1400;693;707
21;Huelva;039;Hinojales;499;253;246
21;Huelva;040;Hinojos;3538;1797;1741
21;Huelva;041;Huelva;139125;67399;71726
21;Huelva;042;Isla Cristina;18002;8937;9065
21;Huelva;043;Jabugo;2637;1285;1352
21;Huelva;044;Lepe;16277;8296;7981
21;Huelva;045;Linares de la Sierra;281;135;146
21;Huelva;046;Lucena del Puerto;2053;1025;1028
21;Huelva;047;Manzanilla;2498;1236;1262
21;Huelva;048;Marines (Los);365;181;184
21;Huelva;049;Minas de Riotinto;6013;2849;3164
21;Huelva;050;Moguer;11665;5902;5763
21;Huelva;051;Nava (La);378;186;192
21;Huelva;052;Nerva;7208;3538;3670
21;Huelva;053;Niebla;4017;2041;1976
21;Huelva;054;Palma del Condado (La);9374;4673;4701
21;Huelva;055;Palos de la Frontera;6560;3317;3243
21;Huelva;056;Paterna del Campo;3844;2023;1821
21;Huelva;057;Paymogo;1502;715;787
21;Huelva;058;Puebla de Guzmán;3366;1704;1662
21;Huelva;059;Puerto Moral;238;112;126
21;Huelva;060;Punta Umbría;10065;5079;4986
21;Huelva;061;Rociana del Condado;6281;3195;3086
21;Huelva;062;Rosal de la Frontera;2085;1000;1085
21;Huelva;063;San Bartolomé de la Torre;2808;1423;1385
21;Huelva;064;San Juan del Puerto;5660;2841;2819
21;Huelva;066;San Silvestre de Guzmán;761;369;392
21;Huelva;065;Sanlúcar de Guadiana;428;205;223
21;Huelva;067;Santa Ana la Real;558;263;295
21;Huelva;068;Santa Bárbara de Casa;1556;778;778
21;Huelva;069;Santa Olalla del Cala;2462;1236;1226
21;Huelva;070;Trigueros;7078;3552;3526
21;Huelva;071;Valdelarco;329;155;174
21;Huelva;072;Valverde del Camino;12075;5794;6281
21;Huelva;073;Villablanca;2012;1045;967
21;Huelva;074;Villalba del Alcor;3799;1882;1917
21;Huelva;075;Villanueva de las Cruces;455;220;235
21;Huelva;076;Villanueva de los Castillejos;2696;1335;1361
21;Huelva;077;Villarrasa;2257;1163;1094
21;Huelva;078;Zalamea la Real;3948;1919;2029
21;Huelva;079;Zufre;1461;765;696
22;Huesca;001;Abiego;339;173;166
22;Huesca;002;Abizanda;112;63;49
22;Huesca;003;Adahuesca;178;90;88
22;Huesca;004;Agüero;182;97;85
22;Huesca;907;Aínsa-Sobrarbe;1389;738;651
22;Huesca;006;Aisa;315;166;149
22;Huesca;007;Albalate de Cinca;1220;625;595
22;Huesca;008;Albalatillo;288;142;146
22;Huesca;009;Albelda;1089;558;531
22;Huesca;011;Albero Alto;117;58;59
22;Huesca;012;Albero Bajo;138;71;67
22;Huesca;013;Alberuela de Tubo;470;244;226
22;Huesca;014;Alcalá de Gurrea;446;221;225
22;Huesca;015;Alcalá del Obispo;442;219;223
22;Huesca;016;Alcampell;1161;592;569
22;Huesca;017;Alcolea de Cinca;1183;602;581
22;Huesca;018;Alcubierre;537;275;262
22;Huesca;019;Alerre;136;67;69
22;Huesca;020;Alfántega;136;71;65
22;Huesca;021;Almudévar;2538;1333;1205
22;Huesca;022;Almunia de San Juan;804;396;408
22;Huesca;023;Almuniente;711;357;354
22;Huesca;024;Alquézar;285;141;144
22;Huesca;025;Altorricón;1559;832;727
22;Huesca;027;Angüés;540;291;249
22;Huesca;028;Ansó;528;275;253
22;Huesca;029;Antillón;184;91;93
22;Huesca;032;Aragüés del Puerto;127;82;45
22;Huesca;035;Arén;458;248;210
22;Huesca;036;Argavieso;121;68;53
22;Huesca;037;Arguis;60;31;29
22;Huesca;039;Ayerbe;1311;661;650
22;Huesca;040;Azanuy-Alins;270;128;142
22;Huesca;041;Azara;223;110;113
22;Huesca;042;Azlor;206;109;97
22;Huesca;043;Baélls;198;103;95
22;Huesca;044;Bailo;381;216;165
22;Huesca;045;Baldellou;204;105;99
22;Huesca;046;Ballobar;1198;599;599
22;Huesca;047;Banastás;107;50;57
22;Huesca;048;Barbastro;15118;7401;7717
22;Huesca;049;Barbués;126;60;66
22;Huesca;050;Barbuñales;123;64;59
22;Huesca;051;Bárcabo;111;64;47
22;Huesca;052;Belver de Cinca;1598;836;762
22;Huesca;053;Benabarre;1290;693;597
22;Huesca;054;Benasque;1044;551;493
22;Huesca;055;Berbegal;531;258;273
22;Huesca;057;Bielsa;463;239;224
22;Huesca;058;Bierge;212;117;95
22;Huesca;059;Biescas;1239;639;600
22;Huesca;060;Binaced;1704;868;836
22;Huesca;061;Binéfar;7977;4026;3951
22;Huesca;062;Bisaurri;276;166;110
22;Huesca;063;Biscarrués;270;142;128
22;Huesca;064;Blecua y Torres;220;110;110
22;Huesca;066;Boltaña;889;443;446
22;Huesca;067;Bonansa;70;40;30
22;Huesca;068;Borau;75;41;34
22;Huesca;069;Broto;477;246;231
22;Huesca;072;Caldearenas;327;167;160
22;Huesca;074;Campo;409;190;219
22;Huesca;075;Camporrélls;328;149;179
22;Huesca;076;Canal de Berdún;501;260;241
22;Huesca;077;Candasnos;675;345;330
22;Huesca;078;Canfranc;575;308;267
22;Huesca;079;Capdesaso;220;109;111
22;Huesca;080;Capella;470;244;226
22;Huesca;081;Casbas de Huesca;366;192;174
22;Huesca;083;Castejón de Monegros;842;422;420
22;Huesca;084;Castejón de Sos;430;220;210
22;Huesca;082;Castejón del Puente;448;220;228
22;Huesca;085;Castelflorite;177;91;86
22;Huesca;086;Castiello de Jaca;178;82;96
22;Huesca;087;Castigaleu;96;52;44
22;Huesca;088;Castillazuelo;276;143;133
22;Huesca;089;Castillonroy;443;220;223
22;Huesca;094;Chalamera;177;99;78
22;Huesca;095;Chía;133;78;55
22;Huesca;096;Chimillas;150;81;69
22;Huesca;090;Colungo;155;77;78
22;Huesca;099;Esplús;1462;727;735
22;Huesca;102;Estada;227;117;110
22;Huesca;103;Estadilla;1053;544;509
22;Huesca;105;Estopiñán del Castillo;205;104;101
22;Huesca;106;Fago;61;36;25
22;Huesca;107;Fanlo;44;30;14
22;Huesca;109;Fiscal;299;159;140
22;Huesca;110;Fonz;1343;678;665
22;Huesca;111;Foradada del Toscar;289;145;144
22;Huesca;112;Fraga;11520;5793;5727
22;Huesca;113;Fueva (La);701;394;307
22;Huesca;114;Gistaín;224;128;96
22;Huesca;115;Grado (El);596;309;287
22;Huesca;116;Grañén;2350;1187;1163
22;Huesca;117;Graus;3467;1781;1686
22;Huesca;119;Gurrea de Gállego;2074;1041;1033
22;Huesca;122;Hoz de Jaca;89;37;52
22;Huesca;908;Hoz y Costean;288;155;133
22;Huesca;124;Huerto;342;181;161
22;Huesca;125;Huesca;42214;20523;21691
22;Huesca;126;Ibieca;122;62;60
22;Huesca;127;Igriés;160;90;70
22;Huesca;128;Ilche;321;163;158
22;Huesca;129;Isábena;298;162;136
22;Huesca;130;Jaca;10818;5363;5455
22;Huesca;131;Jasa;111;60;51
22;Huesca;133;Labuerda;180;94;86
22;Huesca;135;Laluenga;327;171;156
22;Huesca;136;Lalueza;1429;775;654
22;Huesca;137;Lanaja;1916;993;923
22;Huesca;139;Laperdiguera;106;57;49
22;Huesca;141;Lascellas-Ponzano;200;94;106
22;Huesca;142;Lascuarre;182;90;92
22;Huesca;143;Laspaúles;329;197;132
22;Huesca;144;Laspuña;300;163;137
22;Huesca;149;Loarre;426;229;197
22;Huesca;150;Loporzano;522;255;267
22;Huesca;151;Loscorrales;140;76;64
22;Huesca;905;Lupiñén-Ortilla;399;212;187
22;Huesca;155;Monesma y Cajigar;108;51;57
22;Huesca;156;Monflorite-Lascasas;183;97;86
22;Huesca;157;Montanuy;355;205;150
22;Huesca;158;Monzón;14715;7394;7321
22;Huesca;160;Naval;292;144;148
22;Huesca;162;Novales;215;101;114
22;Huesca;163;Nueno;221;118;103
22;Huesca;164;Olvena;59;30;29
22;Huesca;165;Ontiñena;729;370;359
22;Huesca;167;Osso de Cinca;744;390;354
22;Huesca;168;Palo;41;24;17
22;Huesca;170;Panticosa;584;304;280
22;Huesca;172;Peñalba;832;408;424
22;Huesca;173;Peñas de Riglos (Las);319;171;148
22;Huesca;174;Peralta de Alcofea;812;394;418
22;Huesca;175;Peralta de Calasanz;418;220;198
22;Huesca;176;Peraltilla;180;96;84
22;Huesca;177;Perarrúa;164;83;81
22;Huesca;178;Pertusa;162;79;83
22;Huesca;181;Piracés;113;67;46
22;Huesca;182;Plan;302;165;137
22;Huesca;184;Poleñino;288;146;142
22;Huesca;186;Pozán de Vero;298;150;148
22;Huesca;187;Puebla de Castro (La);283;133;150
22;Huesca;188;Puente de Montañana;168;86;82
22;Huesca;902;Puente la Reina de Jaca;291;147;144
22;Huesca;189;Puértolas;203;112;91
22;Huesca;190;Pueyo de Araguás (El);167;102;65
22;Huesca;193;Pueyo de Santa Cruz;414;216;198
22;Huesca;195;Quicena;124;60;64
22;Huesca;197;Robres;786;393;393
22;Huesca;199;Sabiñánigo;9021;4641;4380
22;Huesca;200;Sahún;324;173;151
22;Huesca;201;Salas Altas;441;223;218
22;Huesca;202;Salas Bajas;231;111;120
22;Huesca;203;Salillas;143;73;70
22;Huesca;204;Sallent de Gállego;921;477;444
22;Huesca;205;San Esteban de Litera;797;391;406
22;Huesca;207;San Juan de Plan;180;105;75
22;Huesca;903;San Miguel del Cinca;985;511;474
22;Huesca;206;Sangarrén;319;158;161
22;Huesca;208;Santa Cilia;216;115;101
22;Huesca;209;Santa Cruz de la Serós;146;82;64
22;Huesca;906;Santa María de Dulcis;251;118;133
22;Huesca;212;Santaliestra y San Quílez;109;56;53
22;Huesca;213;Sariñena;4311;2177;2134
22;Huesca;214;Secastilla;202;87;115
22;Huesca;215;Seira;206;100;106
22;Huesca;217;Sena;719;368;351
22;Huesca;218;Senés de Alcubierre;70;31;39
22;Huesca;220;Sesa;323;163;160
22;Huesca;221;Sesué;74;41;33
22;Huesca;222;Siétamo;378;203;175
22;Huesca;223;Sopeira;155;84;71
22;Huesca;904;Sotonera (La);1405;714;691
22;Huesca;225;Tamarite de Litera;4152;2088;2064
22;Huesca;226;Tardienta;1268;650;618
22;Huesca;227;Tella-Sin;346;183;163
22;Huesca;228;Tierz;209;108;101
22;Huesca;229;Tolva;278;147;131
22;Huesca;230;Torla;354;195;159
22;Huesca;232;Torralba de Aragón;167;78;89
22;Huesca;233;Torre la Ribera;127;73;54
22;Huesca;234;Torrente de Cinca;1197;599;598
22;Huesca;235;Torres de Alcanadre;148;88;60
22;Huesca;236;Torres de Barbués;466;246;220
22;Huesca;239;Tramaced;143;82;61
22;Huesca;242;Valfarta;123;62;61
22;Huesca;243;Valle de Bardají;74;37;37
22;Huesca;901;Valle de Hecho;1080;577;503
22;Huesca;244;Valle de Lierp;66;36;30
22;Huesca;245;Velilla de Cinca;549;270;279
22;Huesca;909;Vencillón;155;77;78
22;Huesca;246;Veracruz;121;68;53
22;Huesca;247;Viacamp y Litera;49;31;18
22;Huesca;248;Vicién;132;76;56
22;Huesca;249;Villanova;102;52;50
22;Huesca;250;Villanúa;247;116;131
22;Huesca;251;Villanueva de Sigena;554;285;269
22;Huesca;252;Yebra de Basa;189;105;84
22;Huesca;253;Yésero;60;29;31
22;Huesca;254;Zaidín;1835;920;915
23;Jaén;001;Albanchez de Mágina;1794;879;915
23;Jaén;002;Alcalá la Real;20931;10466;10465
23;Jaén;003;Alcaudete;12011;5971;6040
23;Jaén;004;Aldeaquemada;674;341;333
23;Jaén;005;Andújar;37342;18502;18840
23;Jaén;006;Arjona;6094;3067;3027
23;Jaén;007;Arjonilla;3970;1980;1990
23;Jaén;008;Arquillos;1854;954;900
23;Jaén;009;Baeza;15086;7326;7760
23;Jaén;010;Bailén;16457;8279;8178
23;Jaén;011;Baños de la Encina;2829;1436;1393
23;Jaén;012;Beas de Segura;8628;4316;4312
23;Jaén;902;Bedmar y Garcíez;4011;2002;2009
23;Jaén;014;Begíjar;3160;1575;1585
23;Jaén;015;Bélmez de la Moraleda;2122;1057;1065
23;Jaén;016;Benatae;750;376;374
23;Jaén;017;Cabra del Santo Cristo;2527;1311;1216
23;Jaén;018;Cambil;3977;2055;1922
23;Jaén;019;Campillo de Arenas;2461;1248;1213
23;Jaén;020;Canena;2138;1035;1103
23;Jaén;021;Carboneros;756;367;389
23;Jaén;901;Cárcheles;1693;814;879
23;Jaén;024;Carolina (La);15319;7496;7823
23;Jaén;025;Castellar;3695;1847;1848
23;Jaén;026;Castillo de Locubín;6021;2990;3031
23;Jaén;027;Cazalilla;962;505;457
23;Jaén;028;Cazorla;9215;4556;4659
23;Jaén;029;Chiclana de Segura;2172;1083;1089
23;Jaén;030;Chilluévar;2067;1031;1036
23;Jaén;031;Escañuela;1072;552;520
23;Jaén;032;Espelúy;833;407;426
23;Jaén;033;Frailes;1989;1008;981
23;Jaén;034;Fuensanta de Martos;3674;1802;1872
23;Jaén;035;Fuerte del Rey;1197;592;605
23;Jaén;037;Génave;860;430;430
23;Jaén;038;Guardia de Jaén (La);1833;951;882
23;Jaén;039;Guarromán;3151;1550;1601
23;Jaén;041;Higuera de Calatrava;822;435;387
23;Jaén;042;Hinojares;758;383;375
23;Jaén;043;Hornos;880;457;423
23;Jaén;044;Huelma;6067;3018;3049
23;Jaén;045;Huesa;2919;1449;1470
23;Jaén;046;Ibros;3294;1621;1673
23;Jaén;047;Iruela (La);2294;1147;1147
23;Jaén;048;Iznatoraf;1396;674;722
23;Jaén;049;Jabalquinto;2685;1324;1361
23;Jaén;050;Jaén;107836;52037;55799
23;Jaén;051;Jamilena;3111;1585;1526
23;Jaén;052;Jimena;1857;917;940
23;Jaén;053;Jódar;12264;6142;6122
23;Jaén;040;Lahiguera;1962;964;998
23;Jaén;054;Larva;726;378;348
23;Jaén;055;Linares;58910;28817;30093
23;Jaén;056;Lopera;3997;1968;2029
23;Jaén;057;Lupión;1247;590;657
23;Jaén;058;Mancha Real;8306;4120;4186
23;Jaén;059;Marmolejo;7490;3772;3718
23;Jaén;060;Martos;22608;11056;11552
23;Jaén;061;Mengíbar;8266;4113;4153
23;Jaén;062;Montizón;2114;1059;1055
23;Jaén;063;Navas de San Juan;5505;2713;2792
23;Jaén;064;Noalejo;2426;1239;1187
23;Jaén;065;Orcera;2496;1280;1216
23;Jaén;066;Peal de Becerro;5527;2774;2753
23;Jaén;067;Pegalajar;3318;1627;1691
23;Jaén;069;Porcuna;7296;3642;3654
23;Jaén;070;Pozo Alcón;5953;2997;2956
23;Jaén;071;Puente de Génave;2147;1095;1052
23;Jaén;072;Puerta de Segura (La);3099;1557;1542
23;Jaén;073;Quesada;7199;3598;3601
23;Jaén;074;Rus;3737;1874;1863
23;Jaén;075;Sabiote;4519;2200;2319
23;Jaén;076;Santa Elena;1100;560;540
23;Jaén;077;Santiago de Calatrava;1095;557;538
23;Jaén;904;Santiago-Pontones;5481;2807;2674
23;Jaén;079;Santisteban del Puerto;5121;2593;2528
23;Jaén;080;Santo Tomé;2870;1440;1430
23;Jaén;081;Segura de la Sierra;2616;1363;1253
23;Jaén;082;Siles;2880;1439;1441
23;Jaén;084;Sorihuela del Guadalimar;1426;717;709
23;Jaén;086;Torre del Campo;11454;5646;5808
23;Jaén;085;Torreblascopedro;3295;1660;1635
23;Jaén;087;Torredonjimeno;13555;6656;6899
23;Jaén;088;Torreperogil;7801;3832;3969
23;Jaén;090;Torres;2150;1084;1066
23;Jaén;091;Torres de Albánchez;1213;608;605
23;Jaén;092;Úbeda;31344;15357;15987
23;Jaén;093;Valdepeñas de Jaén;5012;2543;2469
23;Jaén;094;Vilches;5402;2719;2683
23;Jaén;095;Villacarrillo;12382;6184;6198
23;Jaén;096;Villanueva de la Reina;3662;1831;1831
23;Jaén;097;Villanueva del Arzobispo;9119;4471;4648
23;Jaén;098;Villardompardo;1300;628;672
23;Jaén;099;Villares (Los);4432;2191;2241
23;Jaén;101;Villarrodrigo;881;449;432
23;Jaén;903;Villatorres;3992;2016;1976
24;León;001;Acebedo;409;211;198
24;León;002;Algadefe;453;232;221
24;León;003;Alija del Infantado;1265;640;625
24;León;004;Almanza;960;474;486
24;León;005;Antigua (La);865;442;423
24;León;006;Ardón;844;440;404
24;León;007;Arganza;1216;585;631
24;León;008;Astorga;12488;5985;6503
24;León;009;Balboa;795;389;406
24;León;010;Bañeza (La);9389;4543;4846
24;León;011;Barjas;744;402;342
24;León;012;Barrios de Luna (Los);445;224;221
24;León;014;Bembibre;11114;5617;5497
24;León;015;Benavides;3418;1786;1632
24;León;016;Benuza;1002;525;477
24;León;017;Bercianos del Páramo;1088;544;544
24;León;018;Bercianos del Real Camino;317;164;153
24;León;019;Berlanga del Bierzo;526;258;268
24;León;020;Boca de Huérgano;808;430;378
24;León;021;Boñar;3019;1487;1532
24;León;022;Borrenes;712;364;348
24;León;023;Brazuelo;387;197;190
24;León;024;Burgo Ranero (El);1264;641;623
24;León;025;Burón;633;334;299
24;León;026;Bustillo del Páramo;2374;1201;1173
24;León;027;Cabañas Raras;1269;669;600
24;León;028;Cabreros del Río;735;380;355
24;León;029;Cabrillanes;1470;730;740
24;León;030;Cacabelos;4721;2398;2323
24;León;031;Calzada del Coto;385;213;172
24;León;032;Campazas;230;111;119
24;León;033;Campo de Villavidel;483;247;236
24;León;034;Camponaraya;3086;1506;1580
24;León;036;Candín;619;334;285
24;León;037;Cármenes;605;279;326
24;León;038;Carracedelo;3629;1830;1799
24;León;039;Carrizo;2824;1455;1369
24;León;040;Carrocera;767;376;391
24;León;041;Carucedo;808;380;428
24;León;042;Castilfalé;143;74;69
24;León;043;Castrillo de Cabrera;447;230;217
24;León;044;Castrillo de la Valduerna;339;158;181
24;León;046;Castrocalbón;1568;789;779
24;León;047;Castrocontrigo;1531;771;760
24;León;049;Castropodame;2014;1006;1008
24;León;050;Castrotierra de Valmadrigal;191;100;91
24;León;051;Cea;960;501;459
24;León;052;Cebanico;366;199;167
24;León;053;Cebrones del Río;938;475;463
24;León;065;Chozas de Abajo;2392;1241;1151
24;León;054;Cimanes de la Vega;807;398;409
24;León;055;Cimanes del Tejar;1343;673;670
24;León;056;Cistierna;5496;2747;2749
24;León;057;Congosto;2138;1058;1080
24;León;058;Corbillos de los Oteros;442;216;226
24;León;059;Corullón;1752;869;883
24;León;060;Crémenes;1673;822;851
24;León;061;Cuadros;1864;880;984
24;León;062;Cubillas de los Oteros;279;133;146
24;León;063;Cubillas de Rueda;836;415;421
24;León;064;Cubillos del Sil;1580;800;780
24;León;066;Destriana;1184;564;620
24;León;067;Encinedo;1207;642;565
24;León;068;Ercina (La);1032;505;527
24;León;069;Escobar de Campos;108;61;47
24;León;070;Fabero;7038;3514;3524
24;León;071;Folgoso de la Ribera;1724;870;854
24;León;072;Fresnedo;"";"";""
24;León;073;Fresno de la Vega;837;406;431
24;León;074;Fuentes de Carbajal;181;101;80
24;León;076;Garrafe de Torío;1165;573;592
24;León;077;Gordaliza del Pino;482;237;245
24;León;078;Gordoncillo;761;370;391
24;León;079;Gradefes;1672;806;866
24;León;080;Grajal de Campos;434;190;244
24;León;081;Gusendos de los Oteros;319;157;162
24;León;082;Hospital de Órbigo;1218;611;607
24;León;083;Igüeña;2740;1478;1262
24;León;084;Izagre;462;218;244
24;León;086;Joarilla de las Matas;547;292;255
24;León;087;Laguna Dalga;1162;586;576
24;León;088;Laguna de Negrillos;1981;999;982
24;León;089;León;137261;65095;72166
24;León;092;Llamas de la Ribera;1573;805;768
24;León;090;Lucillo;639;334;305
24;León;091;Luyego;1137;543;594
24;León;093;Magaz de Cepeda;738;352;386
24;León;094;Mansilla de las Mulas;1823;904;919
24;León;095;Mansilla Mayor;520;254;266
24;León;096;Maraña;245;125;120
24;León;097;Matadeón de los Oteros;384;204;180
24;León;098;Matallana de Torío;2118;1044;1074
24;León;099;Matanza;447;223;224
24;León;100;Molinaseca;769;393;376
24;León;101;Murias de Paredes;978;466;512
24;León;102;Noceda del Bierzo;1177;578;599
24;León;103;Oencia;634;334;300
24;León;104;Omañas (Las);542;268;274
24;León;105;Onzonilla;1364;675;689
24;León;106;Oseja de Sajambre;442;229;213
24;León;107;Pajares de los Oteros;516;268;248
24;León;108;Palacios de la Valduerna;701;355;346
24;León;109;Palacios del Sil;2024;1046;978
24;León;110;Páramo del Sil;2562;1299;1263
24;León;111;Pedrosa del Rey;140;76;64
24;León;112;Peranzanes;491;253;238
24;León;113;Pobladura de Pelayo García;833;420;413
24;León;114;Pola de Gordón (La);6519;3174;3345
24;León;115;Ponferrada;60340;29754;30586
24;León;116;Posada de Valdeón;611;319;292
24;León;117;Pozuelo del Páramo;830;436;394
24;León;118;Prado de la Guzpeña;234;119;115
24;León;119;Priaranza del Bierzo;1141;586;555
24;León;120;Prioro;641;333;308
24;León;121;Puebla de Lillo;828;435;393
24;León;122;Puente de Domingo Flórez;2118;1125;993
24;León;123;Quintana del Castillo;1496;771;725
24;León;124;Quintana del Marco;756;393;363
24;León;125;Quintana y Congosto;1070;550;520
24;León;127;Regueras de Arriba;519;282;237
24;León;129;Reyero;241;128;113
24;León;130;Riaño;851;444;407
24;León;131;Riego de la Vega;1393;690;703
24;León;132;Riello;1403;687;716
24;León;133;Rioseco de Tapia;685;367;318
24;León;134;Robla (La);5669;2862;2807
24;León;136;Roperuelos del Páramo;1051;528;523
24;León;137;Sabero;2854;1446;1408
24;León;139;Sahagún;3498;1738;1760
24;León;141;San Adrián del Valle;251;118;133
24;León;142;San Andrés del Rabanedo;17362;8469;8893
24;León;144;San Cristóbal de la Polantera;1497;758;739
24;León;145;San Emiliano;1196;590;606
24;León;146;San Esteban de Nogales;556;259;297
24;León;148;San Justo de la Vega;2567;1294;1273
24;León;149;San Millán de los Caballeros;232;114;118
24;León;150;San Pedro Bercianos;469;238;231
24;León;143;Sancedo;690;350;340
24;León;151;Santa Colomba de Curueño;842;413;429
24;León;152;Santa Colomba de Somoza;629;315;314
24;León;153;Santa Cristina de Valmadrigal;497;268;229
24;León;154;Santa Elena de Jamuz;1624;826;798
24;León;155;Santa María de la Isla;882;468;414
24;León;158;Santa María de Ordás;601;299;302
24;León;156;Santa María del Monte de Cea;562;277;285
24;León;157;Santa María del Páramo;3113;1514;1599
24;León;159;Santa Marina del Rey;3036;1524;1512
24;León;160;Santas Martas;1346;682;664
24;León;161;Santiago Millas;418;205;213
24;León;162;Santovenia de la Valdoncina;1316;633;683
24;León;163;Sariegos;1631;812;819
24;León;164;Sena de Luna;687;339;348
24;León;165;Sobrado;705;350;355
24;León;166;Soto de la Vega;2256;1144;1112
24;León;167;Soto y Amío;1320;627;693
24;León;168;Toral de los Guzmanes;875;446;429
24;León;169;Toreno;5620;2923;2697
24;León;170;Torre del Bierzo;3993;2012;1981
24;León;171;Trabadelo;839;440;399
24;León;172;Truchas;1422;700;722
24;León;173;Turcia;1764;907;857
24;León;174;Urdiales del Páramo;1076;537;539
24;León;185;Val de San Lorenzo;888;433;455
24;León;175;Valdefresno;1621;818;803
24;León;176;Valdefuentes del Páramo;571;298;273
24;León;177;Valdelugueros;526;270;256
24;León;178;Valdemora;164;85;79
24;León;179;Valdepiélago;490;244;246
24;León;180;Valdepolo;1961;1039;922
24;León;181;Valderas;2560;1284;1276
24;León;182;Valderrey;860;416;444
24;León;183;Valderrueda;1764;873;891
24;León;184;Valdesamario;387;190;197
24;León;187;Valdevimbre;1506;764;742
24;León;188;Valencia de Don Juan;3871;1935;1936
24;León;191;Vallecillo;247;130;117
24;León;189;Valverde de la Virgen;3679;1879;1800
24;León;190;Valverde-Enrique;331;163;168
24;León;193;Vecilla (La);547;272;275
24;León;196;Vega de Espinareda;3687;1874;1813
24;León;197;Vega de Infanzones;987;501;486
24;León;198;Vega de Valcarce;1369;692;677
24;León;194;Vegacervera;394;205;189
24;León;199;Vegaquemada;724;347;377
24;León;201;Vegas del Condado;1798;900;898
24;León;202;Villablino;15945;8080;7865
24;León;203;Villabraz;232;121;111
24;León;205;Villadangos del Páramo;1082;526;556
24;León;206;Villadecanes;2633;1329;1304
24;León;207;Villademor de la Vega;597;312;285
24;León;209;Villafranca del Bierzo;5159;2581;2578
24;León;210;Villagatón;1301;675;626
24;León;211;Villamandos;600;287;313
24;León;901;Villamanín;1885;966;919
24;León;212;Villamañán;1657;813;844
24;León;213;Villamartín de Don Sancho;284;143;141
24;León;214;Villamejil;1239;636;603
24;León;215;Villamol;346;167;179
24;León;216;Villamontán de la Valduerna;1499;769;730
24;León;217;Villamoratiel de las Matas;282;153;129
24;León;218;Villanueva de las Manzanas;766;350;416
24;León;219;Villaobispo de Otero;869;447;422
24;León;902;Villaornate y Castro;674;339;335
24;León;221;Villaquejida;1279;648;631
24;León;222;Villaquilambre;4735;2325;2410
24;León;223;Villarejo de Órbigo;3820;1872;1948
24;León;224;Villares de Órbigo;1201;606;595
24;León;225;Villasabariego;1388;696;692
24;León;226;Villaselán;462;250;212
24;León;227;Villaturiel;1839;932;907
24;León;228;Villazala;1383;698;685
24;León;229;Villazanzo de Valderaduey;932;497;435
24;León;230;Zotes del Páramo;986;510;476
25;Lleida;001;Abella de la Conca;163;85;78
25;Lleida;002;Àger;624;328;296
25;Lleida;003;Agramunt;4747;2394;2353
25;Lleida;038;Aitona;2334;1167;1167
25;Lleida;004;Alamús (Els);675;338;337
25;Lleida;005;Alàs i Cerc;420;229;191
25;Lleida;006;Albagés (L');581;287;294
25;Lleida;007;Albatàrrec;1019;502;517
25;Lleida;008;Albesa;1438;724;714
25;Lleida;009;Albi (L');819;426;393
25;Lleida;010;Alcanó;290;142;148
25;Lleida;011;Alcarràs;4454;2243;2211
25;Lleida;012;Alcoletge;1453;730;723
25;Lleida;013;Alfarràs;3124;1541;1583
25;Lleida;014;Alfés;350;188;162
25;Lleida;015;Algerri;575;278;297
25;Lleida;016;Alguaire;2869;1427;1442
25;Lleida;017;Alins;300;155;145
25;Lleida;019;Almacelles;5546;2821;2725
25;Lleida;020;Almatret;580;299;281
25;Lleida;021;Almenar;3611;1846;1765
25;Lleida;022;Alòs de Balaguer;186;101;85
25;Lleida;023;Alpicat;3595;1862;1733
25;Lleida;024;Alt Àneu;356;192;164
25;Lleida;027;Anglesola;1322;664;658
25;Lleida;029;Arbeca;2412;1192;1220
25;Lleida;031;Arres;49;29;20
25;Lleida;032;Arsèguel;85;44;41
25;Lleida;033;Artesa de Lleida;1175;574;601
25;Lleida;034;Artesa de Segre;3215;1651;1564
25;Lleida;036;Aspa;267;135;132
25;Lleida;037;Avellanes i Santa Linya (Les);523;278;245
25;Lleida;039;Baix Pallars;405;224;181
25;Lleida;040;Balaguer;13305;6601;6704
25;Lleida;041;Barbens;802;413;389
25;Lleida;042;Baronia de Rialb (La);262;145;117
25;Lleida;044;Bassella;386;199;187
25;Lleida;045;Bausen;63;41;22
25;Lleida;046;Belianes;587;281;306
25;Lleida;170;Bellaguarda;384;197;187
25;Lleida;047;Bellcaire d'Urgell;1457;716;741
25;Lleida;048;Bell-lloc d'Urgell;2228;1114;1114
25;Lleida;049;Bellmunt d'Urgell;238;122;116
25;Lleida;050;Bellpuig;3809;1878;1931
25;Lleida;051;Bellver de Cerdanya;1586;816;770
25;Lleida;052;Bellvís;2328;1159;1169
25;Lleida;053;Benavent de Segrià;727;376;351
25;Lleida;055;Biosca;273;132;141
25;Lleida;057;Bòrdes (Es);193;97;96
25;Lleida;058;Borges Blanques (Les);5205;2552;2653
25;Lleida;059;Bossòst;802;395;407
25;Lleida;056;Bovera;476;242;234
25;Lleida;060;Cabanabona;116;54;62
25;Lleida;061;Cabó;157;88;69
25;Lleida;062;Camarasa;1006;506;500
25;Lleida;063;Canejan;118;64;54
25;Lleida;904;Castell de Mur;137;69;68
25;Lleida;064;Castellar de la Ribera;166;81;85
25;Lleida;067;Castelldans;980;494;486
25;Lleida;068;Castellnou de Seana;775;377;398
25;Lleida;069;Castelló de Farfanya;642;327;315
25;Lleida;070;Castellserà;1237;605;632
25;Lleida;071;Cava;52;32;20
25;Lleida;072;Cervera;6813;3341;3472
25;Lleida;073;Cervià de les Garrigues;929;465;464
25;Lleida;074;Ciutadilla;251;130;121
25;Lleida;075;Clariana de Cardener;157;81;76
25;Lleida;076;Cogul (El);245;122;123
25;Lleida;077;Coll de Nargó;649;336;313
25;Lleida;163;Coma i la Pedra (La);251;143;108
25;Lleida;161;Conca de Dalt;480;255;225
25;Lleida;078;Corbins;1037;533;504
25;Lleida;079;Cubells;403;212;191
25;Lleida;081;Espluga Calba (L');441;234;207
25;Lleida;082;Espot;234;121;113
25;Lleida;088;Estamariu;140;75;65
25;Lleida;085;Estaràs;193;97;96
25;Lleida;086;Esterri d'Àneu;543;274;269
25;Lleida;087;Esterri de Cardós;64;32;32
25;Lleida;089;Farrera;94;51;43
25;Lleida;908;Fígols i Alinyà;362;202;160
25;Lleida;092;Floresta (La);195;96;99
25;Lleida;093;Fondarella;564;280;284
25;Lleida;094;Foradada;154;85;69
25;Lleida;096;Fuliola (La);1339;685;654
25;Lleida;097;Fulleda;119;57;62
25;Lleida;098;Gavet de la Conca;376;186;190
25;Lleida;912;Gimenells i el Pla de la Font;"";"";""
25;Lleida;099;Golmés;1269;630;639
25;Lleida;100;Gósol;200;107;93
25;Lleida;101;Granadella (La);900;452;448
25;Lleida;102;Granja d'Escarp (La);1171;583;588
25;Lleida;103;Granyanella;124;63;61
25;Lleida;105;Granyena de les Garrigues;191;96;95
25;Lleida;104;Granyena de Segarra;205;109;96
25;Lleida;109;Guimerà;471;230;241
25;Lleida;903;Guingueta d'Àneu (La);268;139;129
25;Lleida;110;Guissona;2680;1343;1337
25;Lleida;111;Guixers;165;97;68
25;Lleida;115;Isona i Conca Dellà;1458;739;719
25;Lleida;112;Ivars de Noguera;367;184;183
25;Lleida;113;Ivars d'Urgell;1761;868;893
25;Lleida;114;Ivorra;189;93;96
25;Lleida;910;Josa i Tuixén;136;68;68
25;Lleida;118;Juncosa;611;316;295
25;Lleida;119;Juneda;2988;1510;1478
25;Lleida;121;Les;636;311;325
25;Lleida;122;Linyola;2410;1225;1185
25;Lleida;123;Lladorre;216;119;97
25;Lleida;124;Lladurs;250;133;117
25;Lleida;125;Llardecans;692;352;340
25;Lleida;126;Llavorsí;280;145;135
25;Lleida;120;Lleida;110962;54372;56590
25;Lleida;127;Lles de Cerdanya;309;169;140
25;Lleida;128;Llimiana;142;80;62
25;Lleida;129;Llobera;241;125;116
25;Lleida;133;Maials;1174;587;587
25;Lleida;130;Maldà;336;175;161
25;Lleida;131;Massalcoreig;696;343;353
25;Lleida;132;Massoteres;164;90;74
25;Lleida;134;Menàrguens;910;444;466
25;Lleida;135;Miralcamp;1212;593;619
25;Lleida;137;Mollerussa;8757;4361;4396
25;Lleida;136;Molsosa (La);139;69;70
25;Lleida;139;Montellà i Martinet;554;295;259
25;Lleida;140;Montferrer i Castellbò;641;341;300
25;Lleida;138;Montgai;875;443;432
25;Lleida;142;Montoliu de Lleida;458;223;235
25;Lleida;141;Montoliu de Segarra;230;121;109
25;Lleida;143;Montornès de Segarra;133;56;77
25;Lleida;145;Nalec;102;47;55
25;Lleida;025;Naut Aran;1208;659;549
25;Lleida;146;Navès;297;154;143
25;Lleida;148;Odèn;333;178;155
25;Lleida;149;Oliana;2024;1044;980
25;Lleida;150;Oliola;246;139;107
25;Lleida;151;Olius;478;245;233
25;Lleida;152;Oluges (Les);223;116;107
25;Lleida;153;Omellons (Els);280;141;139
25;Lleida;154;Omells de na Gaia (Els);164;87;77
25;Lleida;155;Organyà;1047;538;509
25;Lleida;156;Os de Balaguer;853;492;361
25;Lleida;157;Ossó de Sió;261;126;135
25;Lleida;158;Palau d'Anglesola (El);1618;826;792
25;Lleida;164;Penelles;595;297;298
25;Lleida;165;Peramola;397;209;188
25;Lleida;166;Pinell de Solsonès;264;140;124
25;Lleida;167;Pinós;377;205;172
25;Lleida;911;Plans de Sió (Els);725;367;358
25;Lleida;168;Poal (El);688;355;333
25;Lleida;169;Pobla de Cérvoles (La);201;105;96
25;Lleida;171;Pobla de Segur (La);3241;1581;1660
25;Lleida;030;Pont de Bar (El);167;92;75
25;Lleida;173;Pont de Suert (El);2324;1159;1165
25;Lleida;172;Ponts;2295;1133;1162
25;Lleida;174;Portella (La);648;343;305
25;Lleida;175;Prats i Sansor;111;61;50
25;Lleida;176;Preixana;486;245;241
25;Lleida;177;Preixens;606;263;343
25;Lleida;179;Prullans;186;94;92
25;Lleida;180;Puiggròs;282;135;147
25;Lleida;181;Puigverd d'Agramunt;248;129;119
25;Lleida;182;Puigverd de Lleida;954;445;509
25;Lleida;183;Rialp;459;248;211
25;Lleida;905;Ribera d'Ondara;498;255;243
25;Lleida;185;Ribera d'Urgellet;804;438;366
25;Lleida;186;Riner;288;159;129
25;Lleida;913;Riu de Cerdanya;"";"";""
25;Lleida;189;Rosselló;1585;783;802
25;Lleida;190;Salàs de Pallars;370;183;187
25;Lleida;191;Sanaüja;462;226;236
25;Lleida;196;Sant Esteve de la Sarga;136;79;57
25;Lleida;192;Sant Guim de Freixenet;1070;531;539
25;Lleida;197;Sant Guim de la Plana;204;103;101
25;Lleida;193;Sant Llorenç de Morunys;879;461;418
25;Lleida;902;Sant Martí de Riucorb;801;410;391
25;Lleida;194;Sant Ramon;595;295;300
25;Lleida;201;Sarroca de Bellera;132;74;58
25;Lleida;200;Sarroca de Lleida;513;262;251
25;Lleida;202;Senterada;121;72;49
25;Lleida;035;Sentiu de Sió (La);490;243;247
25;Lleida;204;Seròs;1946;1029;917
25;Lleida;203;Seu d'Urgell (La);10330;5172;5158
25;Lleida;205;Sidamon;453;230;223
25;Lleida;206;Soleràs (El);482;241;241
25;Lleida;207;Solsona;6608;3308;3300
25;Lleida;208;Soriguera;279;146;133
25;Lleida;209;Sort;1527;778;749
25;Lleida;210;Soses;1506;767;739
25;Lleida;211;Sudanell;812;427;385
25;Lleida;212;Sunyer;319;163;156
25;Lleida;215;Talarn;376;196;180
25;Lleida;216;Talavera;323;155;168
25;Lleida;217;Tàrrega;11350;5519;5831
25;Lleida;218;Tarrés;104;52;52
25;Lleida;219;Tarroja de Segarra;208;109;99
25;Lleida;220;Térmens;1416;703;713
25;Lleida;221;Tírvia;105;57;48
25;Lleida;222;Tiurana;211;114;97
25;Lleida;223;Torà;1202;622;580
25;Lleida;224;Torms (Els);214;117;97
25;Lleida;225;Tornabous;934;463;471
25;Lleida;227;Torre de Cabdella (La);708;349;359
25;Lleida;226;Torrebesses;359;182;177
25;Lleida;228;Torrefarrera;1457;756;701
25;Lleida;907;Torrefeta i Florejacs;734;359;375
25;Lleida;230;Torregrossa;2240;1115;1125
25;Lleida;231;Torrelameu;610;327;283
25;Lleida;232;Torres de Segre;1878;958;920
25;Lleida;233;Torre-serona;311;159;152
25;Lleida;234;Tremp;5512;2726;2786
25;Lleida;043;Vall de Boí (La);561;313;248
25;Lleida;901;Vall de Cardós;331;177;154
25;Lleida;238;Vallbona de les Monges;288;132;156
25;Lleida;240;Vallfogona de Balaguer;1396;707;689
25;Lleida;906;Valls d'Aguilar (Les);234;125;109
25;Lleida;239;Valls de Valira (Les);749;393;356
25;Lleida;909;Vansa i Fórnols (La);163;86;77
25;Lleida;242;Verdú;950;462;488
25;Lleida;243;Vielha e Mijaran;3168;1602;1566
25;Lleida;244;Vilagrassa;427;214;213
25;Lleida;245;Vilaller;619;329;290
25;Lleida;247;Vilamòs;87;48;39
25;Lleida;248;Vilanova de Bellpuig;1228;598;630
25;Lleida;254;Vilanova de la Barca;880;451;429
25;Lleida;249;Vilanova de l'Aguda;283;150;133
25;Lleida;250;Vilanova de Meià;522;263;259
25;Lleida;251;Vilanova de Segrià;682;335;347
25;Lleida;252;Vila-sana;547;272;275
25;Lleida;253;Vilosell (El);209;98;111
25;Lleida;255;Vinaixa;710;357;353
26;Rioja (La);001;Ábalos;307;173;134
26;Rioja (La);002;Agoncillo;876;462;414
26;Rioja (La);003;Aguilar del Río Alhama;908;465;443
26;Rioja (La);004;Ajamil;76;46;30
26;Rioja (La);005;Albelda de Iregua;2315;1189;1126
26;Rioja (La);006;Alberite;1969;992;977
26;Rioja (La);007;Alcanadre;967;483;484
26;Rioja (La);008;Aldeanueva de Ebro;2673;1383;1290
26;Rioja (La);009;Alesanco;580;300;280
26;Rioja (La);010;Alesón;171;89;82
26;Rioja (La);011;Alfaro;9229;4594;4635
26;Rioja (La);012;Almarza de Cameros;38;22;16
26;Rioja (La);013;Anguciana;367;184;183
26;Rioja (La);014;Anguiano;758;413;345
26;Rioja (La);015;Arenzana de Abajo;409;217;192
26;Rioja (La);016;Arenzana de Arriba;46;24;22
26;Rioja (La);017;Arnedillo;419;211;208
26;Rioja (La);018;Arnedo;12393;6166;6227
26;Rioja (La);019;Arrúbal;405;213;192
26;Rioja (La);020;Ausejo;742;389;353
26;Rioja (La);021;Autol;3461;1748;1713
26;Rioja (La);022;Azofra;450;239;211
26;Rioja (La);023;Badarán;885;470;415
26;Rioja (La);024;Bañares;550;278;272
26;Rioja (La);026;Baños de Río Tobía;1856;935;921
26;Rioja (La);025;Baños de Rioja;144;83;61
26;Rioja (La);027;Berceo;256;141;115
26;Rioja (La);028;Bergasa;228;122;106
26;Rioja (La);029;Bergasillas Bajera;29;16;13
26;Rioja (La);030;Bezares;26;15;11
26;Rioja (La);031;Bobadilla;198;96;102
26;Rioja (La);032;Brieva de Cameros;77;41;36
26;Rioja (La);033;Briñas;209;106;103
26;Rioja (La);034;Briones;963;524;439
26;Rioja (La);035;Cabezón de Cameros;44;24;20
26;Rioja (La);036;Calahorra;18737;9038;9699
26;Rioja (La);037;Camprovín;275;143;132
26;Rioja (La);038;Canales de la Sierra;89;46;43
26;Rioja (La);039;Canillas de Río Tuerto;93;46;47
26;Rioja (La);040;Cañas;127;61;66
26;Rioja (La);041;Cárdenas;286;138;148
26;Rioja (La);042;Casalarreina;957;479;478
26;Rioja (La);043;Castañares de Rioja;586;307;279
26;Rioja (La);044;Castroviejo;49;24;25
26;Rioja (La);045;Cellorigo;24;13;11
26;Rioja (La);046;Cenicero;2223;1130;1093
26;Rioja (La);047;Cervera del Río Alhama;3694;1826;1868
26;Rioja (La);048;Cidamón;102;58;44
26;Rioja (La);049;Cihuri;207;106;101
26;Rioja (La);050;Cirueña;141;81;60
26;Rioja (La);051;Clavijo;183;94;89
26;Rioja (La);052;Cordovín;272;130;142
26;Rioja (La);053;Corera;271;136;135
26;Rioja (La);054;Cornago;795;432;363
26;Rioja (La);055;Corporales;79;42;37
26;Rioja (La);056;Cuzcurrita de Río Tirón;569;307;262
26;Rioja (La);057;Daroca de Rioja;64;38;26
26;Rioja (La);058;Enciso;170;93;77
26;Rioja (La);059;Entrena;1108;590;518
26;Rioja (La);060;Estollo;143;76;67
26;Rioja (La);061;Ezcaray;1811;950;861
26;Rioja (La);062;Foncea;163;90;73
26;Rioja (La);063;Fonzaleche;246;124;122
26;Rioja (La);064;Fuenmayor;2105;1044;1061
26;Rioja (La);065;Galbárruli;57;33;24
26;Rioja (La);066;Galilea;272;150;122
26;Rioja (La);067;Gallinero de Cameros;21;13;8
26;Rioja (La);068;Gimileo;93;48;45
26;Rioja (La);069;Grañón;542;291;251
26;Rioja (La);070;Grávalos;358;182;176
26;Rioja (La);071;Haro;9160;4470;4690
26;Rioja (La);072;Herce;384;189;195
26;Rioja (La);073;Herramélluri;203;105;98
26;Rioja (La);074;Hervías;254;131;123
26;Rioja (La);075;Hormilla;531;273;258
26;Rioja (La);076;Hormilleja;212;108;104
26;Rioja (La);077;Hornillos de Cameros;25;13;12
26;Rioja (La);078;Hornos de Moncalvillo;94;48;46
26;Rioja (La);079;Huércanos;978;503;475
26;Rioja (La);080;Igea;1029;555;474
26;Rioja (La);081;Jalón de Cameros;43;24;19
26;Rioja (La);082;Laguna de Cameros;207;110;97
26;Rioja (La);083;Lagunilla del Jubera;401;199;202
26;Rioja (La);084;Lardero;2777;1375;1402
26;Rioja (La);086;Ledesma de la Cogolla;27;17;10
26;Rioja (La);087;Leiva;382;185;197
26;Rioja (La);088;Leza de Río Leza;26;20;6
26;Rioja (La);089;Logroño;120802;58543;62259
26;Rioja (La);091;Lumbreras;180;105;75
26;Rioja (La);092;Manjarrés;148;79;69
26;Rioja (La);093;Mansilla de la Sierra;57;36;21
26;Rioja (La);094;Manzanares de Rioja;166;89;77
26;Rioja (La);095;Matute;219;110;109
26;Rioja (La);096;Medrano;264;137;127
26;Rioja (La);098;Munilla;130;62;68
26;Rioja (La);099;Murillo de Río Leza;1704;839;865
26;Rioja (La);100;Muro de Aguas;67;37;30
26;Rioja (La);101;Muro en Cameros;46;31;15
26;Rioja (La);102;Nájera;6770;3383;3387
26;Rioja (La);103;Nalda;956;505;451
26;Rioja (La);104;Navajún;22;14;8
26;Rioja (La);105;Navarrete;2042;1056;986
26;Rioja (La);106;Nestares;58;30;28
26;Rioja (La);107;Nieva de Cameros;136;72;64
26;Rioja (La);109;Ochánduri;115;57;58
26;Rioja (La);108;Ocón;359;198;161
26;Rioja (La);110;Ojacastro;274;158;116
26;Rioja (La);111;Ollauri;338;184;154
26;Rioja (La);112;Ortigosa de Cameros;358;177;181
26;Rioja (La);113;Pazuengos;44;25;19
26;Rioja (La);114;Pedroso;116;61;55
26;Rioja (La);115;Pinillos;26;16;10
26;Rioja (La);117;Pradejón;2811;1420;1391
26;Rioja (La);118;Pradillo;109;54;55
26;Rioja (La);119;Préjano;255;125;130
26;Rioja (La);120;Quel;2045;1062;983
26;Rioja (La);121;Rabanera;51;24;27
26;Rioja (La);122;Rasillo de Cameros (El);118;60;58
26;Rioja (La);123;Redal (El);258;129;129
26;Rioja (La);124;Ribafrecha;1131;604;527
26;Rioja (La);125;Rincón de Soto;3424;1735;1689
26;Rioja (La);126;Robres del Castillo;29;17;12
26;Rioja (La);127;Rodezno;393;196;197
26;Rioja (La);128;Sajazarra;199;101;98
26;Rioja (La);129;San Asensio;1491;773;718
26;Rioja (La);130;San Millán de la Cogolla;312;184;128
26;Rioja (La);131;San Millán de Yécora;92;53;39
26;Rioja (La);132;San Román de Cameros;185;98;87
26;Rioja (La);139;San Torcuato;159;83;76
26;Rioja (La);142;San Vicente de la Sonsierra;1215;623;592
26;Rioja (La);134;Santa Coloma;183;106;77
26;Rioja (La);135;Santa Engracia del Jubera;213;128;85
26;Rioja (La);136;Santa Eulalia Bajera;117;64;53
26;Rioja (La);138;Santo Domingo de la Calzada;5774;2904;2870
26;Rioja (La);140;Santurde de Rioja;335;164;171
26;Rioja (La);141;Santurdejo;240;131;109
26;Rioja (La);143;Sojuela;101;58;43
26;Rioja (La);144;Sorzano;290;158;132
26;Rioja (La);145;Sotés;301;156;145
26;Rioja (La);146;Soto en Cameros;121;69;52
26;Rioja (La);147;Terroba;38;20;18
26;Rioja (La);148;Tirgo;305;156;149
26;Rioja (La);149;Tobía;74;42;32
26;Rioja (La);150;Tormantos;244;132;112
26;Rioja (La);153;Torre en Cameros;15;11;4
26;Rioja (La);151;Torrecilla en Cameros;543;282;261
26;Rioja (La);152;Torrecilla sobre Alesanco;112;55;57
26;Rioja (La);154;Torremontalbo;14;9;5
26;Rioja (La);155;Treviana;352;190;162
26;Rioja (La);157;Tricio;419;206;213
26;Rioja (La);158;Tudelilla;549;280;269
26;Rioja (La);160;Uruñuela;738;379;359
26;Rioja (La);161;Valdemadera;21;12;9
26;Rioja (La);162;Valgañón;187;97;90
26;Rioja (La);163;Ventosa;156;80;76
26;Rioja (La);164;Ventrosa;100;44;56
26;Rioja (La);165;Viguera;426;231;195
26;Rioja (La);166;Villalba de Rioja;194;107;87
26;Rioja (La);167;Villalobar de Rioja;145;84;61
26;Rioja (La);168;Villamediana de Iregua;1917;981;936
26;Rioja (La);169;Villanueva de Cameros;129;66;63
26;Rioja (La);170;Villar de Arnedo (El);796;385;411
26;Rioja (La);171;Villar de Torre;385;202;183
26;Rioja (La);172;Villarejo;48;27;21
26;Rioja (La);173;Villarroya;12;6;6
26;Rioja (La);174;Villarta-Quintana;253;129;124
26;Rioja (La);175;Villavelayo;82;48;34
26;Rioja (La);176;Villaverde de Rioja;105;61;44
26;Rioja (La);177;Villoslada de Cameros;417;225;192
26;Rioja (La);178;Viniegra de Abajo;149;73;76
26;Rioja (La);179;Viniegra de Arriba;48;27;21
26;Rioja (La);180;Zarratón;320;163;157
26;Rioja (La);181;Zarzosa;23;14;9
26;Rioja (La);183;Zorraquín;44;27;17
27;Lugo;001;Abadín;4751;2310;2441
27;Lugo;002;Alfoz;2787;1366;1421
27;Lugo;003;Antas de Ulla;4146;2059;2087
27;Lugo;004;Baleira;2466;1283;1183
27;Lugo;901;Baralla;4274;2208;2066
27;Lugo;005;Barreiros;4080;1998;2082
27;Lugo;006;Becerreá;4681;2402;2279
27;Lugo;007;Begonte;4749;2357;2392
27;Lugo;008;Bóveda;2557;1265;1292
27;Lugo;902;Burela;"";"";""
27;Lugo;009;Carballedo;5027;2514;2513
27;Lugo;010;Castro de Rei;6181;3113;3068
27;Lugo;011;Castroverde;4272;2183;2089
27;Lugo;012;Cervantes;3147;1714;1433
27;Lugo;013;Cervo;11974;5956;6018
27;Lugo;016;Chantada;11288;5486;5802
27;Lugo;014;Corgo (O);5185;2622;2563
27;Lugo;015;Cospeito;6968;3433;3535
27;Lugo;017;Folgoso do Courel;2599;1339;1260
27;Lugo;018;Fonsagrada (A);8246;4323;3923
27;Lugo;019;Foz;9819;4710;5109
27;Lugo;020;Friol;5500;2778;2722
27;Lugo;022;Guitiriz;7397;3671;3726
27;Lugo;023;Guntín;4421;2170;2251
27;Lugo;024;Incio (O);3556;1828;1728
27;Lugo;026;Láncara;4083;2099;1984
27;Lugo;027;Lourenzá;3248;1583;1665
27;Lugo;028;Lugo;80011;38049;41962
27;Lugo;029;Meira;2052;1006;1046
27;Lugo;030;Mondoñedo;6425;3036;3389
27;Lugo;031;Monforte de Lemos;20383;9803;10580
27;Lugo;032;Monterroso;5180;2724;2456
27;Lugo;033;Muras;1981;982;999
27;Lugo;034;Navia de Suarna;3275;1722;1553
27;Lugo;035;Negueira de Muñiz;390;208;182
27;Lugo;037;Nogais (As);2140;1142;998
27;Lugo;038;Ourol;2259;1047;1212
27;Lugo;039;Outeiro de Rei;4494;2219;2275
27;Lugo;040;Palas de Rei;6157;3057;3100
27;Lugo;041;Pantón;5695;2742;2953
27;Lugo;042;Paradela;3320;1647;1673
27;Lugo;043;Páramo (O);2232;1148;1084
27;Lugo;044;Pastoriza (A);4881;2457;2424
27;Lugo;045;Pedrafita do Cebreiro;2396;1280;1116
27;Lugo;047;Pobra do Brollón (A);3454;1686;1768
27;Lugo;046;Pol;2659;1327;1332
27;Lugo;048;Pontenova (A);4073;1989;2084
27;Lugo;049;Portomarín;2472;1253;1219
27;Lugo;050;Quiroga;5632;2810;2822
27;Lugo;056;Rábade;1917;972;945
27;Lugo;051;Ribadeo;9252;4376;4876
27;Lugo;052;Ribas de Sil;1971;983;988
27;Lugo;053;Ribeira de Piquín;1212;613;599
27;Lugo;054;Riotorto;2446;1217;1229
27;Lugo;055;Samos;3067;1643;1424
27;Lugo;057;Sarria;13223;6580;6643
27;Lugo;058;Saviñao (O);7167;3533;3634
27;Lugo;059;Sober;4917;2412;2505
27;Lugo;060;Taboada;6048;2996;3052
27;Lugo;061;Trabada;2188;1061;1127
27;Lugo;062;Triacastela;1151;600;551
27;Lugo;063;Valadouro (O);3049;1503;1546
27;Lugo;064;Vicedo (O);2988;1462;1526
27;Lugo;065;Vilalba;16485;8026;8459
27;Lugo;066;Viveiro;15123;7277;7846
27;Lugo;021;Xermade;3367;1630;1737
27;Lugo;025;Xove;3787;1918;1869
28;Madrid;001;Acebeda (La);63;35;28
28;Madrid;002;Ajalvir;1133;608;525
28;Madrid;003;Alameda del Valle;144;79;65
28;Madrid;004;Álamo (El);2224;1147;1077
28;Madrid;005;Alcalá de Henares;152473;76131;76342
28;Madrid;006;Alcobendas;75620;37545;38075
28;Madrid;007;Alcorcón;140621;69886;70735
28;Madrid;008;Aldea del Fresno;1044;530;514
28;Madrid;009;Algete;9073;4685;4388
28;Madrid;010;Alpedrete;3108;1552;1556
28;Madrid;011;Ambite;308;149;159
28;Madrid;012;Anchuelo;503;270;233
28;Madrid;013;Aranjuez;37852;18450;19402
28;Madrid;014;Arganda del Rey;25418;12676;12742
28;Madrid;015;Arroyomolinos;488;246;242
28;Madrid;016;Atazar (El);89;48;41
28;Madrid;017;Batres;300;151;149
28;Madrid;018;Becerril de la Sierra;1675;830;845
28;Madrid;019;Belmonte de Tajo;1074;542;532
28;Madrid;021;Berrueco (El);237;129;108
28;Madrid;020;Berzosa del Lozoya;71;41;30
28;Madrid;022;Boadilla del Monte;12016;6098;5918
28;Madrid;023;Boalo (El);1621;827;794
28;Madrid;024;Braojos;134;73;61
28;Madrid;025;Brea de Tajo;488;253;235
28;Madrid;026;Brunete;2024;1012;1012
28;Madrid;027;Buitrago del Lozoya;1198;637;561
28;Madrid;028;Bustarviejo;1189;607;582
28;Madrid;029;Cabanillas de la Sierra;361;183;178
28;Madrid;030;Cabrera (La);837;420;417
28;Madrid;031;Cadalso de los Vidrios;2093;1076;1017
28;Madrid;032;Camarma de Esteruelas;1370;695;675
28;Madrid;033;Campo Real;2074;1061;1013
28;Madrid;034;Canencia;460;241;219
28;Madrid;035;Carabaña;1048;529;519
28;Madrid;036;Casarrubuelos;502;278;224
28;Madrid;037;Cenicientos;2096;1047;1049
28;Madrid;038;Cercedilla;3880;1911;1969
28;Madrid;039;Cervera de Buitrago;94;48;46
28;Madrid;051;Chapinería;785;416;369
28;Madrid;052;Chinchón;4006;2018;1988
28;Madrid;040;Ciempozuelos;10398;5302;5096
28;Madrid;041;Cobeña;994;504;490
28;Madrid;046;Collado Mediano;1855;913;942
28;Madrid;047;Collado Villalba;24177;12051;12126
28;Madrid;043;Colmenar de Oreja;5292;2553;2739
28;Madrid;042;Colmenar del Arroyo;410;206;204
28;Madrid;045;Colmenar Viejo;35163;17485;17678
28;Madrid;044;Colmenarejo;1823;950;873
28;Madrid;048;Corpa;370;191;179
28;Madrid;049;Coslada;70572;35473;35099
28;Madrid;050;Cubas de la Sagra;850;405;445
28;Madrid;053;Daganzo de Arriba;1404;720;684
28;Madrid;054;Escorial (El);6936;3430;3506
28;Madrid;055;Estremera;1054;555;499
28;Madrid;056;Fresnedillas de la Oliva;418;208;210
28;Madrid;057;Fresno de Torote;180;88;92
28;Madrid;058;Fuenlabrada;136222;69121;67101
28;Madrid;059;Fuente el Saz de Jarama;2159;1117;1042
28;Madrid;060;Fuentidueña de Tajo;1257;628;629
28;Madrid;061;Galapagar;8964;4572;4392
28;Madrid;062;Garganta de los Montes;318;163;155
28;Madrid;063;Gargantilla del Lozoya y Pinilla de Buitrago;217;124;93
28;Madrid;064;Gascones;90;44;46
28;Madrid;065;Getafe;137389;68456;68933
28;Madrid;066;Griñón;1864;992;872
28;Madrid;067;Guadalix de la Sierra;1605;824;781
28;Madrid;068;Guadarrama;6468;3216;3252
28;Madrid;069;Hiruela (La);54;32;22
28;Madrid;070;Horcajo de la Sierra;129;65;64
28;Madrid;071;Horcajuelo de la Sierra;63;31;32
28;Madrid;072;Hoyo de Manzanares;2872;1472;1400
28;Madrid;073;Humanes de Madrid;7153;3629;3524
28;Madrid;074;Leganés;170973;85854;85119
28;Madrid;075;Loeches;2062;1042;1020
28;Madrid;076;Lozoya;445;230;215
28;Madrid;901;Lozoyuela-Navas-Sieteiglesias;636;349;287
28;Madrid;078;Madarcos;36;17;19
28;Madrid;079;Madrid;3108463;1465473;1642990
28;Madrid;080;Majadahonda;32934;16236;16698
28;Madrid;082;Manzanares el Real;1913;988;925
28;Madrid;083;Meco;2179;1117;1062
28;Madrid;084;Mejorada del Campo;12517;6339;6178
28;Madrid;085;Miraflores de la Sierra;2546;1267;1279
28;Madrid;086;Molar (El);2700;1413;1287
28;Madrid;087;Molinos (Los);2370;1106;1264
28;Madrid;088;Montejo de la Sierra;234;122;112
28;Madrid;089;Moraleja de Enmedio;1460;727;733
28;Madrid;090;Moralzarzal;1793;899;894
28;Madrid;091;Morata de Tajuña;4796;2374;2422
28;Madrid;092;Móstoles;185975;92865;93110
28;Madrid;093;Navacerrada;1553;855;698
28;Madrid;094;Navalafuente;280;155;125
28;Madrid;095;Navalagamella;564;280;284
28;Madrid;096;Navalcarnero;9474;4791;4683
28;Madrid;097;Navarredonda y San Mamés;113;59;54
28;Madrid;099;Navas del Rey;1008;514;494
28;Madrid;100;Nuevo Baztán;690;390;300
28;Madrid;101;Olmeda de las Fuentes;140;74;66
28;Madrid;102;Orusco de Tajuña;575;285;290
28;Madrid;104;Paracuellos de Jarama;4264;2198;2066
28;Madrid;106;Parla;67252;33923;33329
28;Madrid;107;Patones;352;174;178
28;Madrid;108;Pedrezuela;791;405;386
28;Madrid;109;Pelayos de la Presa;810;409;401
28;Madrid;110;Perales de Tajuña;1906;916;990
28;Madrid;111;Pezuela de las Torres;512;276;236
28;Madrid;112;Pinilla del Valle;137;74;63
28;Madrid;113;Pinto;21707;10876;10831
28;Madrid;114;Piñuécar-Gandullas;161;77;84
28;Madrid;115;Pozuelo de Alarcón;40515;19979;20536
28;Madrid;116;Pozuelo del Rey;211;108;103
28;Madrid;117;Prádena del Rincón;107;60;47
28;Madrid;118;Puebla de la Sierra;76;40;36
28;Madrid;902;Puentes Viejas;410;212;198
28;Madrid;119;Quijorna;582;309;273
28;Madrid;120;Rascafría;1276;658;618
28;Madrid;121;Redueña;122;60;62
28;Madrid;122;Ribatejada;244;125;119
28;Madrid;123;Rivas-Vaciamadrid;9592;4828;4764
28;Madrid;124;Robledillo de la Jara;62;27;35
28;Madrid;125;Robledo de Chavela;1702;853;849
28;Madrid;126;Robregordo;99;53;46
28;Madrid;127;Rozas de Madrid (Las);29779;14759;15020
28;Madrid;128;Rozas de Puerto Real;401;206;195
28;Madrid;129;San Agustín del Guadalix;2855;1460;1395
28;Madrid;130;San Fernando de Henares;24097;12100;11997
28;Madrid;131;San Lorenzo de El Escorial;9355;4551;4804
28;Madrid;132;San Martín de la Vega;6039;3096;2943
28;Madrid;133;San Martín de Valdeiglesias;5136;2601;2535
28;Madrid;134;San Sebastián de los Reyes;52512;26418;26094
28;Madrid;135;Santa María de la Alameda;747;402;345
28;Madrid;136;Santorcaz;519;267;252
28;Madrid;137;Santos de la Humosa (Los);889;456;433
28;Madrid;138;Serna del Monte (La);90;45;45
28;Madrid;140;Serranillos del Valle;481;256;225
28;Madrid;141;Sevilla la Nueva;797;413;384
28;Madrid;143;Somosierra;107;64;43
28;Madrid;144;Soto del Real;2045;1023;1022
28;Madrid;145;Talamanca de Jarama;1006;511;495
28;Madrid;146;Tielmes;1882;987;895
28;Madrid;147;Titulcia;859;423;436
28;Madrid;148;Torrejón de Ardoz;85135;42869;42266
28;Madrid;149;Torrejón de la Calzada;1111;584;527
28;Madrid;150;Torrejón de Velasco;1289;655;634
28;Madrid;151;Torrelaguna;2518;1235;1283
28;Madrid;152;Torrelodones;6342;3134;3208
28;Madrid;153;Torremocha de Jarama;206;107;99
28;Madrid;154;Torres de la Alameda;2674;1344;1330
28;Madrid;903;Tres Cantos;"";"";""
28;Madrid;155;Valdaracete;718;344;374
28;Madrid;156;Valdeavero;483;247;236
28;Madrid;157;Valdelaguna;557;287;270
28;Madrid;158;Valdemanco;464;247;217
28;Madrid;159;Valdemaqueda;462;234;228
28;Madrid;160;Valdemorillo;2575;1323;1252
28;Madrid;161;Valdemoro;18608;10116;8492
28;Madrid;162;Valdeolmos-Alalpardo;829;458;371
28;Madrid;163;Valdepiélagos;312;160;152
28;Madrid;164;Valdetorres de Jarama;1128;573;555
28;Madrid;165;Valdilecha;1538;765;773
28;Madrid;166;Valverde de Alcalá;211;114;97
28;Madrid;167;Velilla de San Antonio;1990;999;991
28;Madrid;168;Vellón (El);883;453;430
28;Madrid;169;Venturada;279;141;138
28;Madrid;171;Villa del Prado;3252;1625;1627
28;Madrid;170;Villaconejos;2920;1491;1429
28;Madrid;172;Villalbilla;1634;838;796
28;Madrid;173;Villamanrique de Tajo;561;278;283
28;Madrid;174;Villamanta;1070;539;531
28;Madrid;175;Villamantilla;301;156;145
28;Madrid;176;Villanueva de la Cañada;3554;1808;1746
28;Madrid;178;Villanueva de Perales;362;199;163
28;Madrid;177;Villanueva del Pardillo;1716;861;855
28;Madrid;179;Villar del Olmo;433;221;212
28;Madrid;180;Villarejo de Salvanés;4665;2343;2322
28;Madrid;181;Villaviciosa de Odón;11329;5508;5821
28;Madrid;182;Villavieja del Lozoya;153;68;85
28;Madrid;183;Zarzalejo;795;417;378
29;Málaga;001;Alameda;4842;2417;2425
29;Málaga;002;Alcaucín;1470;734;736
29;Málaga;003;Alfarnate;1592;823;769
29;Málaga;004;Alfarnatejo;427;231;196
29;Málaga;005;Algarrobo;4772;2419;2353
29;Málaga;006;Algatocín;1087;567;520
29;Málaga;007;Alhaurín de la Torre;12134;6039;6095
29;Málaga;008;Alhaurín el Grande;16500;8215;8285
29;Málaga;009;Almáchar;2076;1075;1001
29;Málaga;010;Almargen;2381;1182;1199
29;Málaga;011;Almogía;4143;2097;2046
29;Málaga;012;Álora;13938;6963;6975
29;Málaga;013;Alozaina;2957;1539;1418
29;Málaga;014;Alpandeire;380;198;182
29;Málaga;015;Antequera;41562;20429;21133
29;Málaga;016;Árchez;383;210;173
29;Málaga;017;Archidona;10394;5235;5159
29;Málaga;018;Ardales;3127;1592;1535
29;Málaga;019;Arenas;1317;709;608
29;Málaga;020;Arriate;3297;1651;1646
29;Málaga;021;Atajate;154;88;66
29;Málaga;022;Benadalid;272;145;127
29;Málaga;023;Benahavís;2113;1064;1049
29;Málaga;024;Benalauría;592;302;290
29;Málaga;025;Benalmádena;23206;11654;11552
29;Málaga;026;Benamargosa;1704;869;835
29;Málaga;027;Benamocarra;2769;1383;1386
29;Málaga;028;Benaoján;1795;897;898
29;Málaga;029;Benarrabá;762;387;375
29;Málaga;030;Borge (El);1126;578;548
29;Málaga;031;Burgo (El);2211;1159;1052
29;Málaga;032;Campillos;7598;3865;3733
29;Málaga;033;Canillas de Aceituno;2767;1417;1350
29;Málaga;034;Canillas de Albaida;647;336;311
29;Málaga;035;Cañete la Real;2392;1247;1145
29;Málaga;036;Carratraca;992;494;498
29;Málaga;037;Cartajima;411;212;199
29;Málaga;038;Cártama;11910;5966;5944
29;Málaga;039;Casabermeja;3113;1630;1483
29;Málaga;040;Casarabonela;2837;1480;1357
29;Málaga;041;Casares;3057;1561;1496
29;Málaga;042;Coín;20479;10458;10021
29;Málaga;043;Colmenar;3309;1633;1676
29;Málaga;044;Comares;1700;873;827
29;Málaga;045;Cómpeta;2317;1148;1169
29;Málaga;046;Cortes de la Frontera;4153;2077;2076
29;Málaga;047;Cuevas Bajas;1651;788;863
29;Málaga;049;Cuevas de San Marcos;4270;2131;2139
29;Málaga;048;Cuevas del Becerro;2120;1087;1033
29;Málaga;050;Cútar;653;319;334
29;Málaga;051;Estepona;30363;15265;15098
29;Málaga;052;Faraján;360;189;171
29;Málaga;053;Frigiliana;2115;1039;1076
29;Málaga;054;Fuengirola;40153;19882;20271
29;Málaga;055;Fuente de Piedra;2144;1088;1056
29;Málaga;056;Gaucín;1945;1013;932
29;Málaga;057;Genalguacil;761;391;370
29;Málaga;058;Guaro;2101;1059;1042
29;Málaga;059;Humilladero;2378;1208;1170
29;Málaga;060;Igualeja;1121;570;551
29;Málaga;061;Istán;1610;814;796
29;Málaga;062;Iznate;747;380;367
29;Málaga;063;Jimera de Líbar;532;272;260
29;Málaga;064;Jubrique;1031;528;503
29;Málaga;065;Júzcar;301;174;127
29;Málaga;066;Macharaviaya;360;186;174
29;Málaga;067;Málaga;555518;269143;286375
29;Málaga;068;Manilva;4675;2393;2282
29;Málaga;069;Marbella;79624;39566;40058
29;Málaga;070;Mijas;29078;14651;14427
29;Málaga;071;Moclinejo;1195;614;581
29;Málaga;072;Mollina;3234;1605;1629
29;Málaga;073;Monda;1713;870;843
29;Málaga;074;Montejaque;1363;677;686
29;Málaga;075;Nerja;13212;6600;6612
29;Málaga;076;Ojén;2091;1097;994
29;Málaga;077;Parauta;398;199;199
29;Málaga;079;Periana;3683;1935;1748
29;Málaga;080;Pizarra;6404;3261;3143
29;Málaga;081;Pujerra;338;193;145
29;Málaga;082;Rincón de la Victoria;11036;5492;5544
29;Málaga;083;Riogordo;2856;1448;1408
29;Málaga;084;Ronda;33692;16670;17022
29;Málaga;085;Salares;298;151;147
29;Málaga;086;Sayalonga;1130;585;545
29;Málaga;087;Sedella;569;302;267
29;Málaga;088;Sierra de Yeguas;3278;1616;1662
29;Málaga;089;Teba;4544;2343;2201
29;Málaga;090;Tolox;3123;1624;1499
29;Málaga;901;Torremolinos;25048;12420;12628
29;Málaga;091;Torrox;10413;5322;5091
29;Málaga;092;Totalán;623;325;298
29;Málaga;093;Valle de Abdalajís;3152;1597;1555
29;Málaga;094;Vélez-Málaga;53382;26764;26618
29;Málaga;095;Villanueva de Algaidas;4447;2209;2238
29;Málaga;098;Villanueva de Tapia;1563;793;770
29;Málaga;096;Villanueva del Rosario;3206;1576;1630
29;Málaga;097;Villanueva del Trabuco;4562;2320;2242
29;Málaga;099;Viñuela;1214;617;597
29;Málaga;100;Yunquera;3181;1647;1534
30;Murcia;001;Abanilla;7021;3442;3579
30;Murcia;002;Abarán;11873;5861;6012
30;Murcia;003;Águilas;24303;12161;12142
30;Murcia;004;Albudeite;1533;754;779
30;Murcia;005;Alcantarilla;29290;14293;14997
30;Murcia;902;Alcázares (Los);3675;1801;1874
30;Murcia;006;Aledo;1041;525;516
30;Murcia;007;Alguazas;6756;3337;3419
30;Murcia;008;Alhama de Murcia;14232;6992;7240
30;Murcia;009;Archena;13441;6652;6789
30;Murcia;010;Beniel;6879;3437;3442
30;Murcia;011;Blanca;6100;2944;3156
30;Murcia;012;Bullas;10262;5149;5113
30;Murcia;013;Calasparra;8919;4467;4452
30;Murcia;014;Campos del Río;2063;1022;1041
30;Murcia;015;Caravaca de la Cruz;23104;11451;11653
30;Murcia;016;Cartagena;173788;85751;88037
30;Murcia;017;Cehegín;15231;7603;7628
30;Murcia;018;Ceutí;6239;3141;3098
30;Murcia;019;Cieza;31085;15186;15899
30;Murcia;020;Fortuna;6221;3140;3081
30;Murcia;021;Fuente Álamo de Murcia;8950;4491;4459
30;Murcia;022;Jumilla;20948;10416;10532
30;Murcia;023;Librilla;3746;1842;1904
30;Murcia;024;Lorca;66784;32899;33885
30;Murcia;025;Lorquí;5416;2711;2705
30;Murcia;026;Mazarrón;14039;7057;6982
30;Murcia;027;Molina de Segura;37289;18474;18815
30;Murcia;028;Moratalla;10153;5136;5017
30;Murcia;029;Mula;13343;6633;6710
30;Murcia;030;Murcia;318688;155105;163583
30;Murcia;031;Ojós;640;312;328
30;Murcia;032;Pliego;3457;1732;1725
30;Murcia;033;Puerto Lumbreras;9592;4691;4901
30;Murcia;034;Ricote;1776;855;921
30;Murcia;035;San Javier;14861;7406;7455
30;Murcia;036;San Pedro del Pinatar;12252;6105;6147
30;Murcia;901;Santomera;8181;4084;4097
30;Murcia;037;Torre-Pacheco;16395;8334;8061
30;Murcia;038;Torres de Cotillas (Las);13507;6787;6720
30;Murcia;039;Totana;20121;10014;10107
30;Murcia;040;Ulea;1098;554;544
30;Murcia;041;Unión (La);15002;7440;7562
30;Murcia;042;Villanueva del Río Segura;1732;873;859
30;Murcia;043;Yecla;27003;13396;13607
31;Navarra;001;Abáigar;98;57;41
31;Navarra;002;Abárzuza;496;231;265
31;Navarra;003;Abaurregaina/Abaurrea Alta;216;124;92
31;Navarra;004;Abaurrepea/Abaurrea Baja;53;34;19
31;Navarra;005;Aberin;379;187;192
31;Navarra;006;Ablitas;2327;1185;1142
31;Navarra;007;Adiós;131;67;64
31;Navarra;008;Aguilar de Codés;155;80;75
31;Navarra;009;Aibar/Oibar;972;490;482
31;Navarra;011;Allín;829;436;393
31;Navarra;012;Allo;1208;592;616
31;Navarra;010;Altsasu/Alsasua;7066;3596;3470
31;Navarra;013;Améscoa Baja;927;471;456
31;Navarra;014;Ancín;294;153;141
31;Navarra;015;Andosilla;2509;1255;1254
31;Navarra;016;Ansoáin;10945;5542;5403
31;Navarra;017;Anue;461;260;201
31;Navarra;018;Añorbe;408;227;181
31;Navarra;019;Aoiz/Agoitz;1879;942;937
31;Navarra;020;Araitz;687;398;289
31;Navarra;025;Arakil;2868;1500;1368
31;Navarra;021;Aranarache;109;54;55
31;Navarra;023;Aranguren;1374;758;616
31;Navarra;024;Arano;186;101;85
31;Navarra;022;Arantza;743;409;334
31;Navarra;026;Aras;249;125;124
31;Navarra;027;Arbizu;899;482;417
31;Navarra;028;Arce/Artzi;280;155;125
31;Navarra;029;Arcos (Los);1405;693;712
31;Navarra;030;Arellano;225;122;103
31;Navarra;031;Areso;309;162;147
31;Navarra;032;Arguedas;2401;1189;1212
31;Navarra;033;Aria;72;45;27
31;Navarra;034;Aribe;81;39;42
31;Navarra;035;Armañanzas;123;58;65
31;Navarra;036;Arróniz;1301;679;622
31;Navarra;037;Arruazu;116;61;55
31;Navarra;038;Artajona;1758;926;832
31;Navarra;039;Artazu;112;60;52
31;Navarra;040;Atez;190;108;82
31;Navarra;058;Auritz/Burguete;345;157;188
31;Navarra;041;Ayegui;703;367;336
31;Navarra;042;Azagra;3280;1604;1676
31;Navarra;043;Azuelo;87;44;43
31;Navarra;044;Bakaiku;372;209;163
31;Navarra;901;Barañain;15552;7709;7843
31;Navarra;045;Barásoain;430;226;204
31;Navarra;046;Barbarin;127;56;71
31;Navarra;047;Bargota;421;220;201
31;Navarra;048;Barillas;212;104;108
31;Navarra;049;Basaburua;816;447;369
31;Navarra;050;Baztan;8166;4176;3990
31;Navarra;137;Beintza-Labaien;334;192;142
31;Navarra;051;Beire;364;174;190
31;Navarra;052;Belascoáin;77;43;34
31;Navarra;250;Bera/Vera de Bidasoa;3537;1821;1716
31;Navarra;053;Berbinzana;801;393;408
31;Navarra;905;Beriáin;"";"";""
31;Navarra;902;Berrioplano;"";"";""
31;Navarra;903;Berriozar;"";"";""
31;Navarra;054;Bertizarana;669;337;332
31;Navarra;055;Betelu;349;190;159
31;Navarra;253;Bidaurreta;114;65;49
31;Navarra;056;Biurrun-Olcoz;196;107;89
31;Navarra;057;Buñuel;2505;1233;1272
31;Navarra;059;Burgui/Burgi;274;148;126
31;Navarra;060;Burlada/Burlata;14343;7120;7223
31;Navarra;061;Busto (El);130;64;66
31;Navarra;062;Cabanillas;1463;748;715
31;Navarra;063;Cabredo;143;71;72
31;Navarra;064;Cadreita;1910;920;990
31;Navarra;065;Caparroso;2428;1171;1257
31;Navarra;066;Cárcar;1261;615;646
31;Navarra;067;Carcastillo;2677;1354;1323
31;Navarra;068;Cascante;3584;1747;1837
31;Navarra;069;Cáseda;1195;588;607
31;Navarra;070;Castejón;3287;1631;1656
31;Navarra;071;Castillonuevo;22;14;8
31;Navarra;072;Cintruénigo;5363;2670;2693
31;Navarra;074;Cirauqui;504;273;231
31;Navarra;075;Ciriza;52;26;26
31;Navarra;076;Cizur;5306;2654;2652
31;Navarra;077;Corella;6406;3190;3216
31;Navarra;078;Cortes;3328;1705;1623
31;Navarra;079;Desojo;174;93;81
31;Navarra;080;Dicastillo;794;411;383
31;Navarra;081;Donamaria;397;202;195
31;Navarra;221;Doneztebe/Santesteban;1179;600;579
31;Navarra;083;Echarri;50;26;24
31;Navarra;086;Egüés;1016;482;534
31;Navarra;087;Elgorriaga;188;93;95
31;Navarra;089;Enériz;185;96;89
31;Navarra;090;Eratsun;228;140;88
31;Navarra;091;Ergoiena;569;312;257
31;Navarra;092;Erro;845;447;398
31;Navarra;094;Eslava;240;120;120
31;Navarra;095;Esparza de Salazar;150;80;70
31;Navarra;096;Espronceda;214;122;92
31;Navarra;097;Estella/Lizarra;12796;6238;6558
31;Navarra;098;Esteribar;1464;773;691
31;Navarra;099;Etayo;114;59;55
31;Navarra;082;Etxalar;857;443;414
31;Navarra;084;Etxarri-Aranatz;2335;1216;1119
31;Navarra;085;Etxauri;389;202;187
31;Navarra;100;Eulate;431;220;211
31;Navarra;101;Ezcabarte;988;521;467
31;Navarra;093;Ezcároz/Ezkaroze;404;212;192
31;Navarra;102;Ezkurra;297;177;120
31;Navarra;103;Ezprogui;78;40;38
31;Navarra;104;Falces;2818;1390;1428
31;Navarra;105;Fitero;2220;1109;1111
31;Navarra;106;Fontellas;491;245;246
31;Navarra;107;Funes;2169;1081;1088
31;Navarra;108;Fustiñana;2358;1203;1155
31;Navarra;109;Galar;3284;1645;1639
31;Navarra;110;Gallipienzo;195;105;90
31;Navarra;111;Gallués/Galoze;143;86;57
31;Navarra;112;Garaioa;159;86;73
31;Navarra;113;Garde;225;117;108
31;Navarra;114;Garínoain;288;150;138
31;Navarra;115;Garralda;263;136;127
31;Navarra;116;Genevilla;159;87;72
31;Navarra;117;Goizueta;1068;577;491
31;Navarra;118;Goñi;217;121;96
31;Navarra;119;Güesa/Gorza;101;56;45
31;Navarra;120;Guesálaz;457;264;193
31;Navarra;121;Guirguillano;89;48;41
31;Navarra;256;Hiriberri/Villanueva de Aezkoa;185;99;86
31;Navarra;122;Huarte/Uharte;2767;1383;1384
31;Navarra;124;Ibargoiti;209;121;88
31;Navarra;259;Igantzi;588;312;276
31;Navarra;125;Igúzquiza;373;183;190
31;Navarra;126;Imotz;463;252;211
31;Navarra;127;Irañeta;171;98;73
31;Navarra;904;Irurtzun;"";"";""
31;Navarra;128;Isaba/Izaba;599;286;313
31;Navarra;129;Ituren;498;252;246
31;Navarra;130;Iturmendi;372;191;181
31;Navarra;131;Iza;602;328;274
31;Navarra;132;Izagaondoa;159;92;67
31;Navarra;133;Izalzu/Itzaltzu;53;25;28
31;Navarra;134;Jaurrieta;348;184;164
31;Navarra;135;Javier;168;78;90
31;Navarra;136;Juslapeña;393;219;174
31;Navarra;138;Lakuntza;1025;522;503
31;Navarra;139;Lana;238;135;103
31;Navarra;140;Lantz;143;88;55
31;Navarra;141;Lapoblación;215;119;96
31;Navarra;142;Larraga;1902;983;919
31;Navarra;143;Larraona;203;107;96
31;Navarra;144;Larraun;2073;1131;942
31;Navarra;145;Lazagurría;253;137;116
31;Navarra;146;Leache;69;39;30
31;Navarra;147;Legarda;74;36;38
31;Navarra;148;Legaria;178;87;91
31;Navarra;149;Leitza;3188;1644;1544
31;Navarra;908;Lekunberri;"";"";""
31;Navarra;150;Leoz;150;94;56
31;Navarra;151;Lerga;124;64;60
31;Navarra;152;Lerín;2151;1077;1074
31;Navarra;153;Lesaka;2877;1500;1377
31;Navarra;154;Lezáun;298;159;139
31;Navarra;155;Liédena;361;176;185
31;Navarra;156;Lizoáin;239;130;109
31;Navarra;157;Lodosa;4629;2342;2287
31;Navarra;158;Lónguida/Longida;350;185;165
31;Navarra;159;Lumbier;1460;752;708
31;Navarra;160;Luquin;158;86;72
31;Navarra;248;Luzaide/Valcarlos;570;290;280
31;Navarra;161;Mañeru;393;199;194
31;Navarra;162;Marañón;105;58;47
31;Navarra;163;Marcilla;2449;1253;1196
31;Navarra;164;Mélida;951;487;464
31;Navarra;165;Mendavia;3604;1805;1799
31;Navarra;166;Mendaza;492;229;263
31;Navarra;167;Mendigorría;998;518;480
31;Navarra;168;Metauten;361;187;174
31;Navarra;169;Milagro;2495;1257;1238
31;Navarra;170;Mirafuentes;60;27;33
31;Navarra;171;Miranda de Arga;1039;513;526
31;Navarra;172;Monreal;284;151;133
31;Navarra;173;Monteagudo;1180;579;601
31;Navarra;174;Morentin;130;60;70
31;Navarra;175;Mues;150;73;77
31;Navarra;176;Murchante;2931;1441;1490
31;Navarra;177;Murieta;274;154;120
31;Navarra;178;Murillo el Cuende;591;312;279
31;Navarra;179;Murillo el Fruto;886;446;440
31;Navarra;180;Muruzábal;200;103;97
31;Navarra;181;Navascués;294;181;113
31;Navarra;182;Nazar;50;28;22
31;Navarra;088;Noáin (Valle de Elorz)/Noain (Elortzibar);3543;1738;1805
31;Navarra;183;Obanos;702;339;363
31;Navarra;185;Ochagavía;707;371;336
31;Navarra;184;Oco;97;57;40
31;Navarra;186;Odieta;342;185;157
31;Navarra;187;Oitz;169;105;64
31;Navarra;188;Olaibar;196;105;91
31;Navarra;189;Olazti/Olazagutía;1814;944;870
31;Navarra;190;Olejua;69;32;37
31;Navarra;191;Olite;3043;1508;1535
31;Navarra;194;Ollo;371;208;163
31;Navarra;192;Olóriz;185;102;83
31;Navarra;193;Olza;2338;1197;1141
31;Navarra;195;Orbaitzeta;263;144;119
31;Navarra;196;Orbara;64;32;32
31;Navarra;906;Orcoyen;"";"";""
31;Navarra;197;Orísoain;105;57;48
31;Navarra;198;Oronz;70;40;30
31;Navarra;199;Oroz-Betelu;271;141;130
31;Navarra;211;Orreaga/Roncesvalles;31;17;14
31;Navarra;200;Oteiza;975;498;477
31;Navarra;201;Pamplona/Iruña;182365;88144;94221
31;Navarra;202;Peralta;4592;2263;2329
31;Navarra;203;Petilla de Aragón;61;31;30
31;Navarra;204;Piedramillera;107;55;52
31;Navarra;205;Pitillas;669;334;335
31;Navarra;206;Puente la Reina/Gares;2152;1079;1073
31;Navarra;207;Pueyo;333;170;163
31;Navarra;208;Ribaforada;3104;1580;1524
31;Navarra;209;Romanzado;161;94;67
31;Navarra;210;Roncal/Erronkari;415;215;200
31;Navarra;212;Sada;296;154;142
31;Navarra;213;Saldías;181;94;87
31;Navarra;214;Salinas de Oro;108;58;50
31;Navarra;215;San Adrián;4929;2418;2511
31;Navarra;217;San Martín de Unx;588;310;278
31;Navarra;216;Sangüesa/Zangoza;4635;2362;2273
31;Navarra;219;Sansol;165;82;83
31;Navarra;220;Santacara;1145;575;570
31;Navarra;222;Sarriés/Sartze;104;60;44
31;Navarra;223;Sartaguda;1428;716;712
31;Navarra;224;Sesma;1598;798;800
31;Navarra;225;Sorlada;80;41;39
31;Navarra;226;Sunbilla;764;403;361
31;Navarra;227;Tafalla;10266;5048;5218
31;Navarra;228;Tiebas-Muruarte de Reta;620;323;297
31;Navarra;229;Tirapu;68;37;31
31;Navarra;230;Torralba del Río;182;101;81
31;Navarra;231;Torres del Río;236;114;122
31;Navarra;232;Tudela;26864;13093;13771
31;Navarra;233;Tulebras;102;28;74
31;Navarra;234;Ucar;114;61;53
31;Navarra;123;Uharte-Arakil;864;454;410
31;Navarra;235;Ujué;324;171;153
31;Navarra;236;Ultzama;1628;849;779
31;Navarra;237;Unciti;221;121;100
31;Navarra;238;Unzué;130;65;65
31;Navarra;239;Urdazubi/Urdax;494;251;243
31;Navarra;240;Urdiain;722;381;341
31;Navarra;241;Urraul Alto;153;87;66
31;Navarra;242;Urraul Bajo;297;133;164
31;Navarra;244;Urrotz;237;137;100
31;Navarra;243;Urroz;373;189;184
31;Navarra;245;Urzainqui;123;65;58
31;Navarra;246;Uterga;146;71;75
31;Navarra;247;Uztárroz/Uztarroze;331;163;168
31;Navarra;249;Valtierra;2537;1260;1277
31;Navarra;251;Viana;3464;1764;1700
31;Navarra;252;Vidángoz/Bidankoze;117;58;59
31;Navarra;254;Villafranca;2632;1271;1361
31;Navarra;255;Villamayor de Monjardín;114;67;47
31;Navarra;257;Villatuerta;812;417;395
31;Navarra;258;Villava/Atarrabia;7420;3734;3686
31;Navarra;260;Yerri;1581;825;756
31;Navarra;261;Yesa;319;185;134
31;Navarra;262;Zabalza;142;64;78
31;Navarra;073;Ziordia;394;186;208
31;Navarra;907;Zizur Mayor/Zizur Nagusia;"";"";""
31;Navarra;263;Zubieta;341;201;140
31;Navarra;264;Zugarramurdi;282;149;133
31;Navarra;265;Zúñiga;139;77;62
32;Ourense;001;Allariz;6146;2964;3182
32;Ourense;002;Amoeiro;2657;1273;1384
32;Ourense;003;Arnoia (A);1275;613;662
32;Ourense;004;Avión;4549;2169;2380
32;Ourense;005;Baltar;3043;1516;1527
32;Ourense;006;Bande;4176;2014;2162
32;Ourense;007;Baños de Molgas;4367;2199;2168
32;Ourense;008;Barbadás;4335;2073;2262
32;Ourense;009;Barco de Valdeorras (O);10922;5405;5517
32;Ourense;010;Beade;1227;607;620
32;Ourense;011;Beariz;2059;918;1141
32;Ourense;012;Blancos (Os);2213;1131;1082
32;Ourense;013;Boborás;5180;2446;2734
32;Ourense;014;Bola (A);2294;1115;1179
32;Ourense;015;Bolo (O);2990;1490;1500
32;Ourense;016;Calvos de Randín;2156;1077;1079
32;Ourense;018;Carballeda de Avia;2452;1184;1268
32;Ourense;017;Carballeda de Valdeorras;3334;1710;1624
32;Ourense;019;Carballiño (O);12189;5829;6360
32;Ourense;020;Cartelle;5663;2796;2867
32;Ourense;022;Castrelo de Miño;5253;2636;2617
32;Ourense;021;Castrelo do Val;2032;1028;1004
32;Ourense;023;Castro Caldelas;3138;1562;1576
32;Ourense;024;Celanova;7406;3574;3832
32;Ourense;025;Cenlle;2281;1066;1215
32;Ourense;029;Chandrexa de Queixa;1267;670;597
32;Ourense;026;Coles;3503;1723;1780
32;Ourense;027;Cortegada;2158;1042;1116
32;Ourense;028;Cualedro;5771;2937;2834
32;Ourense;030;Entrimo;2597;1228;1369
32;Ourense;031;Esgos;2631;1286;1345
32;Ourense;033;Gomesende;2197;1051;1146
32;Ourense;034;Gudiña (A);2550;1295;1255
32;Ourense;035;Irixo (O);3831;1886;1945
32;Ourense;038;Larouco;881;416;465
32;Ourense;039;Laza;2794;1382;1412
32;Ourense;040;Leiro;2509;1189;1320
32;Ourense;041;Lobeira;3037;1462;1575
32;Ourense;042;Lobios;5004;2421;2583
32;Ourense;043;Maceda;4850;2344;2506
32;Ourense;044;Manzaneda;1872;938;934
32;Ourense;045;Maside;4993;2404;2589
32;Ourense;046;Melón;2196;989;1207
32;Ourense;047;Merca (A);3764;1849;1915
32;Ourense;048;Mezquita (A);2004;1014;990
32;Ourense;049;Montederramo;1778;908;870
32;Ourense;050;Monterrei;4871;2445;2426
32;Ourense;051;Muíños;3516;1728;1788
32;Ourense;052;Nogueira de Ramuín;3483;1658;1825
32;Ourense;053;Oímbra;2114;1072;1042
32;Ourense;054;Ourense;107054;50601;56453
32;Ourense;055;Paderne de Allariz;2222;1041;1181
32;Ourense;056;Padrenda;4897;2385;2512
32;Ourense;057;Parada de Sil;2058;993;1065
32;Ourense;058;Pereiro de Aguiar (O);6340;3088;3252
32;Ourense;059;Peroxa (A);3499;1670;1829
32;Ourense;060;Petín;1482;735;747
32;Ourense;061;Piñor;2165;1071;1094
32;Ourense;063;Pobra de Trives (A);4096;2033;2063
32;Ourense;064;Pontedeva;927;437;490
32;Ourense;062;Porqueira;1945;971;974
32;Ourense;065;Punxín;1232;579;653
32;Ourense;066;Quintela de Leirado;1418;689;729
32;Ourense;067;Rairiz de Veiga;4074;2005;2069
32;Ourense;068;Ramirás;3385;1649;1736
32;Ourense;069;Ribadavia;6900;3346;3554
32;Ourense;071;Riós;4562;2270;2292
32;Ourense;072;Rúa (A);5318;2634;2684
32;Ourense;073;Rubiá;2967;1492;1475
32;Ourense;074;San Amaro;2583;1277;1306
32;Ourense;075;San Cibrao das Viñas;3709;1788;1921
32;Ourense;076;San Cristovo de Cea;5086;2484;2602
32;Ourense;070;San Xoán de Río;1672;833;839
32;Ourense;077;Sandiás;2604;1262;1342
32;Ourense;078;Sarreaus;4009;2009;2000
32;Ourense;079;Taboadela;3157;1525;1632
32;Ourense;080;Teixeira (A);1952;981;971
32;Ourense;081;Toén;3439;1703;1736
32;Ourense;082;Trasmiras;4069;2081;1988
32;Ourense;083;Veiga (A);3135;1543;1592
32;Ourense;084;Verea;2848;1397;1451
32;Ourense;085;Verín;11483;5586;5897
32;Ourense;086;Viana do Bolo;6026;3056;2970
32;Ourense;087;Vilamarín;2409;1167;1242
32;Ourense;088;Vilamartín de Valdeorras;3021;1511;1510
32;Ourense;089;Vilar de Barrio;4285;2182;2103
32;Ourense;090;Vilar de Santos;1884;956;928
32;Ourense;091;Vilardevós;4220;2204;2016
32;Ourense;092;Vilariño de Conso;1223;669;554
32;Ourense;032;Xinzo de Limia;10741;5299;5442
32;Ourense;036;Xunqueira de Ambía;3373;1670;1703
32;Ourense;037;Xunqueira de Espadanedo;1457;712;745
33;Asturias;001;Allande;3223;1666;1557
33;Asturias;002;Aller;19869;9897;9972
33;Asturias;003;Amieva;1120;583;537
33;Asturias;004;Avilés;88029;43000;45029
33;Asturias;005;Belmonte de Miranda;3388;1754;1634
33;Asturias;006;Bimenes;2691;1256;1435
33;Asturias;007;Boal;3292;1649;1643
33;Asturias;008;Cabrales;2597;1314;1283
33;Asturias;009;Cabranes;1600;754;846
33;Asturias;010;Candamo;3158;1539;1619
33;Asturias;012;Cangas de Onís;6445;3254;3191
33;Asturias;011;Cangas del Narcea;20438;10559;9879
33;Asturias;013;Caravia;641;323;318
33;Asturias;014;Carreño;11472;5631;5841
33;Asturias;015;Caso;2287;1168;1119
33;Asturias;016;Castrillón;22499;11006;11493
33;Asturias;017;Castropol;5063;2432;2631
33;Asturias;018;Coaña;4204;2021;2183
33;Asturias;019;Colunga;5180;2522;2658
33;Asturias;020;Corvera de Asturias;18169;9110;9059
33;Asturias;021;Cudillero;7106;3542;3564
33;Asturias;022;Degaña;1842;987;855
33;Asturias;023;Franco (El);4320;2099;2221
33;Asturias;024;Gijón;263154;125869;137285
33;Asturias;025;Gozón;12185;5961;6224
33;Asturias;026;Grado;12625;6163;6462
33;Asturias;027;Grandas de Salime;1626;853;773
33;Asturias;028;Ibias;2806;1489;1317
33;Asturias;029;Illano;882;453;429
33;Asturias;030;Illas;1433;745;688
33;Asturias;031;Langreo;53569;25857;27712
33;Asturias;032;Laviana;15647;7750;7897
33;Asturias;033;Lena;14877;7328;7549
33;Asturias;035;Llanera;10387;5138;5249
33;Asturias;036;Llanes;13844;6612;7232
33;Asturias;037;Mieres;57829;28189;29640
33;Asturias;038;Morcín;3271;1620;1651
33;Asturias;039;Muros de Nalón;2782;1309;1473
33;Asturias;040;Nava;5800;2837;2963
33;Asturias;041;Navia;9161;4437;4724
33;Asturias;042;Noreña;4185;1982;2203
33;Asturias;043;Onís;1351;693;658
33;Asturias;044;Oviedo;192291;90918;101373
33;Asturias;045;Parres;5961;2930;3031
33;Asturias;046;Peñamellera Alta;1011;510;501
33;Asturias;047;Peñamellera Baja;1898;936;962
33;Asturias;048;Pesoz;364;182;182
33;Asturias;049;Piloña;10228;4953;5275
33;Asturias;050;Ponga;989;554;435
33;Asturias;051;Pravia;10178;4902;5276
33;Asturias;052;Proaza;1097;538;559
33;Asturias;053;Quirós;1873;951;922
33;Asturias;054;Regueras (Las);2566;1280;1286
33;Asturias;055;Ribadedeva;2319;1103;1216
33;Asturias;056;Ribadesella;6470;3102;3368
33;Asturias;057;Ribera de Arriba;2259;1119;1140
33;Asturias;058;Riosa;2968;1545;1423
33;Asturias;059;Salas;8641;4287;4354
33;Asturias;061;San Martín de Oscos;701;364;337
33;Asturias;060;San Martín del Rey Aurelio;25038;12210;12828
33;Asturias;063;San Tirso de Abres;789;400;389
33;Asturias;062;Santa Eulalia de Oscos;745;391;354
33;Asturias;064;Santo Adriano;404;193;211
33;Asturias;065;Sariego;1668;815;853
33;Asturias;066;Siero;43217;20744;22473
33;Asturias;067;Sobrescobio;849;426;423
33;Asturias;068;Somiedo;2006;1036;970
33;Asturias;069;Soto del Barco;5010;2399;2611
33;Asturias;070;Tapia de Casariego;4586;2212;2374
33;Asturias;071;Taramundi;1127;548;579
33;Asturias;072;Teverga;3006;1515;1491
33;Asturias;073;Tineo;17252;8731;8521
33;Asturias;034;Valdés;18155;8924;9231
33;Asturias;074;Vegadeo;5124;2460;2664
33;Asturias;075;Villanueva de Oscos;538;276;262
33;Asturias;076;Villaviciosa;15447;7591;7856
33;Asturias;077;Villayón;2369;1216;1153
33;Asturias;078;Yernes y Tameza;228;110;118
34;Palencia;001;Abarca de Campos;51;28;23
34;Palencia;003;Abia de las Torres;247;126;121
34;Palencia;004;Aguilar de Campoo;7512;3704;3808
34;Palencia;005;Alar del Rey;1668;804;864
34;Palencia;006;Alba de Cerrato;151;77;74
34;Palencia;009;Amayuelas de Arriba;76;42;34
34;Palencia;010;Ampudia;889;449;440
34;Palencia;011;Amusco;732;392;340
34;Palencia;012;Antigüedad;484;261;223
34;Palencia;015;Arconada;113;60;53
34;Palencia;017;Astudillo;1531;796;735
34;Palencia;018;Autilla del Pino;347;178;169
34;Palencia;019;Autillo de Campos;225;106;119
34;Palencia;020;Ayuela;127;72;55
34;Palencia;022;Baltanás;1709;886;823
34;Palencia;024;Baquerín de Campos;43;27;16
34;Palencia;025;Bárcena de Campos;78;33;45
34;Palencia;027;Barruelo de Santullán;2404;1144;1260
34;Palencia;028;Báscones de Ojeda;255;129;126
34;Palencia;029;Becerril de Campos;1314;643;671
34;Palencia;031;Belmonte de Campos;74;33;41
34;Palencia;032;Berzosilla;98;50;48
34;Palencia;033;Boada de Campos;31;16;15
34;Palencia;035;Boadilla de Rioseco;232;114;118
34;Palencia;034;Boadilla del Camino;252;129;123
34;Palencia;036;Brañosera;359;182;177
34;Palencia;037;Buenavista de Valdavia;540;262;278
34;Palencia;038;Bustillo de la Vega;441;239;202
34;Palencia;039;Bustillo del Páramo de Carrión;124;64;60
34;Palencia;041;Calahorra de Boedo;170;80;90
34;Palencia;042;Calzada de los Molinos;446;243;203
34;Palencia;045;Capillas;164;79;85
34;Palencia;046;Cardeñosa de Volpejera;76;37;39
34;Palencia;047;Carrión de los Condes;2589;1229;1360
34;Palencia;048;Castil de Vela;141;68;73
34;Palencia;049;Castrejón de la Peña;833;448;385
34;Palencia;050;Castrillo de Don Juan;477;255;222
34;Palencia;051;Castrillo de Onielo;226;113;113
34;Palencia;052;Castrillo de Villavega;384;191;193
34;Palencia;053;Castromocho;326;165;161
34;Palencia;055;Cervatos de la Cueza;460;226;234
34;Palencia;056;Cervera de Pisuerga;3083;1570;1513
34;Palencia;057;Cevico de la Torre;807;406;401
34;Palencia;058;Cevico Navero;379;199;180
34;Palencia;059;Cisneros;698;349;349
34;Palencia;060;Cobos de Cerrato;290;142;148
34;Palencia;061;Collazos de Boedo;190;106;84
34;Palencia;062;Congosto de Valdavia;353;184;169
34;Palencia;063;Cordovilla la Real;187;106;81
34;Palencia;066;Cubillas de Cerrato;154;78;76
34;Palencia;067;Dehesa de Montejo;401;225;176
34;Palencia;068;Dehesa de Romanos;83;45;38
34;Palencia;069;Dueñas;3117;1611;1506
34;Palencia;070;Espinosa de Cerrato;362;184;178
34;Palencia;071;Espinosa de Villagonzalo;350;171;179
34;Palencia;072;Frechilla;327;155;172
34;Palencia;073;Fresno del Río;237;120;117
34;Palencia;074;Frómista;1132;583;549
34;Palencia;076;Fuentes de Nava;1008;486;522
34;Palencia;077;Fuentes de Valdepero;258;139;119
34;Palencia;079;Grijota;812;407;405
34;Palencia;080;Guardo;9734;4980;4754
34;Palencia;081;Guaza de Campos;115;58;57
34;Palencia;082;Hérmedes de Cerrato;189;93;96
34;Palencia;083;Herrera de Pisuerga;2960;1501;1459
34;Palencia;084;Herrera de Valdecañas;233;118;115
34;Palencia;086;Hontoria de Cerrato;129;66;63
34;Palencia;087;Hornillos de Cerrato;201;95;106
34;Palencia;088;Husillos;216;116;100
34;Palencia;089;Itero de la Vega;298;164;134
34;Palencia;091;Lagartos;229;124;105
34;Palencia;092;Lantadilla;646;320;326
34;Palencia;094;Ledigos;140;72;68
34;Palencia;903;Loma de Ucieza;456;237;219
34;Palencia;096;Lomas;83;41;42
34;Palencia;098;Magaz de Pisuerga;601;315;286
34;Palencia;099;Manquillos;105;56;49
34;Palencia;100;Mantinos;247;131;116
34;Palencia;101;Marcilla de Campos;122;55;67
34;Palencia;102;Mazariegos;298;161;137
34;Palencia;103;Mazuecos de Valdeginate;169;80;89
34;Palencia;104;Melgar de Yuso;505;264;241
34;Palencia;106;Meneses de Campos;214;114;100
34;Palencia;107;Micieces de Ojeda;147;74;73
34;Palencia;108;Monzón de Campos;985;509;476
34;Palencia;109;Moratinos;120;61;59
34;Palencia;110;Mudá;210;103;107
34;Palencia;112;Nogal de las Huertas;111;58;53
34;Palencia;113;Olea de Boedo;53;24;29
34;Palencia;114;Olmos de Ojeda;509;275;234
34;Palencia;116;Osornillo;121;64;57
34;Palencia;901;Osorno la Mayor;2002;1022;980
34;Palencia;120;Palencia;77125;37170;39955
34;Palencia;121;Palenzuela;415;228;187
34;Palencia;122;Páramo de Boedo;136;70;66
34;Palencia;123;Paredes de Nava;2752;1373;1379
34;Palencia;124;Payo de Ojeda;116;64;52
34;Palencia;125;Pedraza de Campos;185;96;89
34;Palencia;126;Pedrosa de la Vega;433;229;204
34;Palencia;127;Perales;191;100;91
34;Palencia;904;Pernía (La);607;322;285
34;Palencia;129;Pino del Río;312;175;137
34;Palencia;130;Piña de Campos;415;223;192
34;Palencia;131;Población de Arroyo;115;61;54
34;Palencia;132;Población de Campos;259;135;124
34;Palencia;133;Población de Cerrato;158;83;75
34;Palencia;134;Polentinos;163;77;86
34;Palencia;135;Pomar de Valdivia;726;362;364
34;Palencia;136;Poza de la Vega;328;182;146
34;Palencia;137;Pozo de Urama;57;30;27
34;Palencia;139;Prádanos de Ojeda;276;141;135
34;Palencia;140;Puebla de Valdavia (La);237;113;124
34;Palencia;141;Quintana del Puente;382;181;201
34;Palencia;143;Quintanilla de Onsoña;329;181;148
34;Palencia;146;Reinoso de Cerrato;109;57;52
34;Palencia;147;Renedo de la Vega;335;174;161
34;Palencia;149;Requena de Campos;68;35;33
34;Palencia;151;Respenda de la Peña;387;208;179
34;Palencia;152;Revenga de Campos;222;103;119
34;Palencia;154;Revilla de Collazos;117;65;52
34;Palencia;155;Ribas de Campos;265;136;129
34;Palencia;156;Riberos de la Cueza;113;60;53
34;Palencia;157;Saldaña;3062;1594;1468
34;Palencia;158;Salinas de Pisuerga;312;169;143
34;Palencia;159;San Cebrián de Campos;592;339;253
34;Palencia;160;San Cebrián de Mudá;297;151;146
34;Palencia;161;San Cristóbal de Boedo;62;35;27
34;Palencia;163;San Mamés de Campos;160;76;84
34;Palencia;165;San Román de la Cuba;162;86;76
34;Palencia;167;Santa Cecilia del Alcor;193;107;86
34;Palencia;168;Santa Cruz de Boedo;97;48;49
34;Palencia;169;Santervás de la Vega;673;369;304
34;Palencia;170;Santibáñez de Ecla;133;50;83
34;Palencia;171;Santibáñez de la Peña;2134;1048;1086
34;Palencia;174;Santoyo;356;171;185
34;Palencia;175;Serna (La);144;80;64
34;Palencia;177;Soto de Cerrato;276;136;140
34;Palencia;176;Sotobañado y Priorato;239;125;114
34;Palencia;178;Tabanera de Cerrato;224;108;116
34;Palencia;179;Tabanera de Valdavia;75;42;33
34;Palencia;180;Támara de Campos;106;56;50
34;Palencia;181;Tariego de Cerrato;581;295;286
34;Palencia;182;Torquemada;1407;713;694
34;Palencia;184;Torremormojón;102;46;56
34;Palencia;185;Triollo;151;83;68
34;Palencia;186;Valbuena de Pisuerga;92;54;38
34;Palencia;189;Valdeolmillos;107;52;55
34;Palencia;190;Valderrábano;127;66;61
34;Palencia;192;Valde-Ucieza;184;111;73
34;Palencia;196;Valle de Cerrato;175;95;80
34;Palencia;902;Valle del Retortillo;332;163;169
34;Palencia;199;Velilla del Río Carrión;2246;1152;1094
34;Palencia;023;Venta de Baños;6981;3453;3528
34;Palencia;201;Vertavillo;344;182;162
34;Palencia;093;Vid de Ojeda (La);190;104;86
34;Palencia;202;Villabasta de Valdavia;51;23;28
34;Palencia;204;Villacidaler;122;59;63
34;Palencia;205;Villaconancio;117;60;57
34;Palencia;206;Villada;1515;742;773
34;Palencia;208;Villaeles de Valdavia;123;65;58
34;Palencia;210;Villahán;194;110;84
34;Palencia;211;Villaherreros;362;171;191
34;Palencia;213;Villalaco;95;43;52
34;Palencia;214;Villalba de Guardo;259;136;123
34;Palencia;215;Villalcázar de Sirga;277;126;151
34;Palencia;216;Villalcón;123;57;66
34;Palencia;217;Villalobón;256;136;120
34;Palencia;218;Villaluenga de la Vega;890;494;396
34;Palencia;220;Villamartín de Campos;184;89;95
34;Palencia;221;Villamediana;316;166;150
34;Palencia;222;Villameriel;210;103;107
34;Palencia;223;Villamoronta;359;182;177
34;Palencia;224;Villamuera de la Cueza;107;58;49
34;Palencia;225;Villamuriel de Cerrato;3787;1929;1858
34;Palencia;227;Villanueva del Rebollar;121;63;58
34;Palencia;228;Villanuño de Valdavia;160;92;68
34;Palencia;229;Villaprovedo;129;76;53
34;Palencia;230;Villarmentero de Campos;25;11;14
34;Palencia;231;Villarrabé;320;169;151
34;Palencia;232;Villarramiel;1279;643;636
34;Palencia;233;Villasarracino;411;204;207
34;Palencia;234;Villasila de Valdavia;140;79;61
34;Palencia;236;Villaturde;364;182;182
34;Palencia;237;Villaumbrales;999;518;481
34;Palencia;238;Villaviudas;548;278;270
34;Palencia;240;Villerías de Campos;152;84;68
34;Palencia;241;Villodre;57;32;25
34;Palencia;242;Villodrigo;154;82;72
34;Palencia;243;Villoldo;604;310;294
34;Palencia;245;Villota del Páramo;608;338;270
34;Palencia;246;Villovieco;168;88;80
35;Palmas (Las);001;Agaete;5412;2741;2671
35;Palmas (Las);002;Agüimes;15979;8112;7867
35;Palmas (Las);003;Antigua;2555;1392;1163
35;Palmas (Las);004;Arrecife;37653;19366;18287
35;Palmas (Las);005;Artenara;1105;587;518
35;Palmas (Las);006;Arucas;27907;14151;13756
35;Palmas (Las);007;Betancuria;605;316;289
35;Palmas (Las);008;Firgas;5773;2899;2874
35;Palmas (Las);009;Gáldar;21101;10685;10416
35;Palmas (Las);010;Haría;3121;1633;1488
35;Palmas (Las);011;Ingenio;22167;11251;10916
35;Palmas (Las);016;Las Palmas de Gran Canaria;371495;183889;187606
35;Palmas (Las);012;Mogán;9973;5301;4672
35;Palmas (Las);013;Moya;7934;4040;3894
35;Palmas (Las);014;Oliva (La);5665;3058;2607
35;Palmas (Las);015;Pájara;5209;2850;2359
35;Palmas (Las);017;Puerto del Rosario;16755;9265;7490
35;Palmas (Las);018;San Bartolomé;6571;3455;3116
35;Palmas (Las);019;San Bartolomé de Tirajana;31542;16595;14947
35;Palmas (Las);020;San Nicolás de Tolentino;7981;4001;3980
35;Palmas (Las);021;Santa Brígida;13897;6935;6962
35;Palmas (Las);022;Santa Lucía de Tirajana;32680;16678;16002
35;Palmas (Las);023;Santa María de Guía de Gran Canaria;12932;6553;6379
35;Palmas (Las);024;Teguise;8155;4303;3852
35;Palmas (Las);025;Tejeda;2197;1067;1130
35;Palmas (Las);026;Telde;77170;38849;38321
35;Palmas (Las);027;Teror;10996;5502;5494
35;Palmas (Las);028;Tías;8063;4346;3717
35;Palmas (Las);029;Tinajo;3441;1750;1691
35;Palmas (Las);030;Tuineje;7107;3773;3334
35;Palmas (Las);032;Valleseco;4178;2141;2037
35;Palmas (Las);031;Valsequillo de Gran Canaria;6229;3190;3039
35;Palmas (Las);033;Vega de San Mateo;7288;3717;3571
35;Palmas (Las);034;Yaiza;2556;1399;1157
36;Pontevedra;020;Agolada;5003;2440;2563
36;Pontevedra;001;Arbo;5135;2471;2664
36;Pontevedra;003;Baiona;10405;5095;5310
36;Pontevedra;002;Barro;3930;1867;2063
36;Pontevedra;004;Bueu;12502;6150;6352
36;Pontevedra;005;Caldas de Reis;9338;4499;4839
36;Pontevedra;006;Cambados;13368;6586;6782
36;Pontevedra;007;Campo Lameiro;2748;1296;1452
36;Pontevedra;008;Cangas;22939;11340;11599
36;Pontevedra;009;Cañiza (A);8490;4066;4424
36;Pontevedra;010;Catoira;3706;1829;1877
36;Pontevedra;011;Cerdedo;4472;2030;2442
36;Pontevedra;012;Cotobade;5924;2715;3209
36;Pontevedra;013;Covelo;5496;2540;2956
36;Pontevedra;014;Crecente;4169;1968;2201
36;Pontevedra;015;Cuntis;6667;3123;3544
36;Pontevedra;016;Dozón;2809;1417;1392
36;Pontevedra;017;Estrada (A);25621;12035;13586
36;Pontevedra;018;Forcarei;7993;3878;4115
36;Pontevedra;019;Fornelos de Montes;2603;1221;1382
36;Pontevedra;021;Gondomar;10496;5162;5334
36;Pontevedra;022;Grove (O);10860;5389;5471
36;Pontevedra;023;Guarda (A);10300;4980;5320
36;Pontevedra;901;Illa de Arousa (A);"";"";""
36;Pontevedra;024;Lalín;20664;10168;10496
36;Pontevedra;025;Lama (A);4382;1988;2394
36;Pontevedra;026;Marín;24203;11811;12392
36;Pontevedra;027;Meaño;5928;2895;3033
36;Pontevedra;028;Meis;5339;2545;2794
36;Pontevedra;029;Moaña;18364;8906;9458
36;Pontevedra;030;Mondariz;7135;3419;3716
36;Pontevedra;031;Mondariz-Balneario;634;298;336
36;Pontevedra;032;Moraña;5140;2442;2698
36;Pontevedra;033;Mos;13727;6706;7021
36;Pontevedra;034;Neves (As);6548;3110;3438
36;Pontevedra;035;Nigrán;14374;7053;7321
36;Pontevedra;036;Oia;3273;1622;1651
36;Pontevedra;037;Pazos de Borbén;3695;1711;1984
36;Pontevedra;041;Poio;13161;6447;6714
36;Pontevedra;043;Ponte Caldelas;8484;4013;4471
36;Pontevedra;042;Ponteareas;16944;8127;8817
36;Pontevedra;044;Pontecesures;2820;1372;1448
36;Pontevedra;038;Pontevedra;69218;32777;36441
36;Pontevedra;039;Porriño (O);15102;7324;7778
36;Pontevedra;040;Portas;3716;1776;1940
36;Pontevedra;045;Redondela;27762;13512;14250
36;Pontevedra;046;Ribadumia;4217;2034;2183
36;Pontevedra;047;Rodeiro;4855;2534;2321
36;Pontevedra;048;Rosal (O);6039;2976;3063
36;Pontevedra;049;Salceda de Caselas;5938;2900;3038
36;Pontevedra;050;Salvaterra de Miño;9490;4520;4970
36;Pontevedra;051;Sanxenxo;15561;7620;7941
36;Pontevedra;052;Silleda;10508;5006;5502
36;Pontevedra;053;Soutomaior;5297;2534;2763
36;Pontevedra;054;Tomiño;11089;5420;5669
36;Pontevedra;055;Tui;16280;7790;8490
36;Pontevedra;056;Valga;6551;3244;3307
36;Pontevedra;057;Vigo;275580;132107;143473
36;Pontevedra;059;Vila de Cruces;8444;4125;4319
36;Pontevedra;058;Vilaboa;6157;2994;3163
36;Pontevedra;060;Vilagarcía de Arousa;32889;16020;16869
36;Pontevedra;061;Vilanova de Arousa;15888;7785;8103
37;Salamanca;001;Abusejo;361;189;172
37;Salamanca;002;Agallas;325;174;151
37;Salamanca;003;Ahigal de los Aceiteros;250;124;126
37;Salamanca;004;Ahigal de Villarino;58;33;25
37;Salamanca;005;Alameda de Gardón (La);251;122;129
37;Salamanca;006;Alamedilla (La);305;145;160
37;Salamanca;007;Alaraz;781;409;372
37;Salamanca;008;Alba de Tormes;4251;2132;2119
37;Salamanca;009;Alba de Yeltes;388;197;191
37;Salamanca;010;Alberca (La);1118;579;539
37;Salamanca;011;Alberguería de Argañán (La);333;168;165
37;Salamanca;012;Alconada;281;146;135
37;Salamanca;015;Aldea del Obispo;509;257;252
37;Salamanca;013;Aldeacipreste;393;210;183
37;Salamanca;014;Aldeadávila de la Ribera;1863;972;891
37;Salamanca;016;Aldealengua;440;218;222
37;Salamanca;017;Aldeanueva de Figueroa;449;231;218
37;Salamanca;018;Aldeanueva de la Sierra;122;70;52
37;Salamanca;019;Aldearrodrigo;250;134;116
37;Salamanca;020;Aldearrubia;540;279;261
37;Salamanca;021;Aldeaseca de Alba;194;95;99
37;Salamanca;022;Aldeaseca de la Frontera;448;233;215
37;Salamanca;023;Aldeatejada;585;287;298
37;Salamanca;024;Aldeavieja de Tormes;163;87;76
37;Salamanca;025;Aldehuela de la Bóveda;447;224;223
37;Salamanca;026;Aldehuela de Yeltes;431;209;222
37;Salamanca;027;Almenara de Tormes;267;129;138
37;Salamanca;028;Almendra;263;134;129
37;Salamanca;029;Anaya de Alba;438;228;210
37;Salamanca;030;Añover de Tormes;132;64;68
37;Salamanca;031;Arabayona de Mógica;649;343;306
37;Salamanca;032;Arapiles;493;255;238
37;Salamanca;033;Arcediano;136;69;67
37;Salamanca;034;Arco (El);108;59;49
37;Salamanca;035;Armenteros;431;197;234
37;Salamanca;037;Atalaya (La);235;128;107
37;Salamanca;038;Babilafuente;1023;528;495
37;Salamanca;039;Bañobárez;608;317;291
37;Salamanca;040;Barbadillo;642;309;333
37;Salamanca;041;Barbalos;168;80;88
37;Salamanca;042;Barceo;114;59;55
37;Salamanca;044;Barruecopardo;749;379;370
37;Salamanca;045;Bastida (La);55;26;29
37;Salamanca;046;Béjar;17484;8375;9109
37;Salamanca;047;Beleña;125;57;68
37;Salamanca;049;Bermellar;261;132;129
37;Salamanca;050;Berrocal de Huebra;167;81;86
37;Salamanca;051;Berrocal de Salvatierra;186;93;93
37;Salamanca;052;Boada;490;245;245
37;Salamanca;054;Bodón (El);447;228;219
37;Salamanca;055;Bogajo;264;133;131
37;Salamanca;056;Bouza (La);71;38;33
37;Salamanca;057;Bóveda del Río Almar;365;182;183
37;Salamanca;058;Brincones;154;72;82
37;Salamanca;059;Buenamadre;232;114;118
37;Salamanca;060;Buenavista;127;66;61
37;Salamanca;061;Cabaco (El);338;172;166
37;Salamanca;063;Cabeza de Béjar (La);156;78;78
37;Salamanca;065;Cabeza del Caballo;623;324;299
37;Salamanca;062;Cabezabellosa de la Calzada;172;98;74
37;Salamanca;067;Cabrerizos;763;379;384
37;Salamanca;068;Cabrillas;677;318;359
37;Salamanca;069;Calvarrasa de Abajo;1092;544;548
37;Salamanca;070;Calvarrasa de Arriba;618;329;289
37;Salamanca;071;Calzada de Béjar (La);137;70;67
37;Salamanca;072;Calzada de Don Diego;340;171;169
37;Salamanca;073;Calzada de Valdunciel;726;352;374
37;Salamanca;074;Campillo de Azaba;408;197;211
37;Salamanca;077;Campo de Peñaranda (El);492;256;236
37;Salamanca;078;Candelario;1283;609;674
37;Salamanca;079;Canillas de Abajo;175;94;81
37;Salamanca;080;Cantagallo;321;157;164
37;Salamanca;081;Cantalapiedra;1672;841;831
37;Salamanca;082;Cantalpino;1388;730;658
37;Salamanca;083;Cantaracillo;323;161;162
37;Salamanca;085;Carbajosa de la Sagrada;596;290;306
37;Salamanca;086;Carpio de Azaba;125;67;58
37;Salamanca;087;Carrascal de Barregas;357;189;168
37;Salamanca;088;Carrascal del Obispo;306;145;161
37;Salamanca;089;Casafranca;101;46;55
37;Salamanca;090;Casas del Conde (Las);155;69;86
37;Salamanca;091;Casillas de Flores;343;167;176
37;Salamanca;092;Castellanos de Moriscos;345;155;190
37;Salamanca;185;Castellanos de Villiquera;494;250;244
37;Salamanca;096;Castillejo de Martín Viejo;422;218;204
37;Salamanca;097;Castraz;119;61;58
37;Salamanca;098;Cepeda;646;316;330
37;Salamanca;099;Cereceda de la Sierra;140;76;64
37;Salamanca;100;Cerezal de Peñahorcada;193;96;97
37;Salamanca;101;Cerralbo;343;188;155
37;Salamanca;102;Cerro (El);690;340;350
37;Salamanca;103;Cespedosa de Tormes;783;426;357
37;Salamanca;114;Chagarcía Medianero;205;111;94
37;Salamanca;104;Cilleros de la Bastida;70;31;39
37;Salamanca;106;Cipérez;623;316;307
37;Salamanca;107;Ciudad Rodrigo;15934;7670;8264
37;Salamanca;108;Coca de Alba;217;107;110
37;Salamanca;109;Colmenar de Montemayor;400;199;201
37;Salamanca;110;Cordovilla;160;85;75
37;Salamanca;112;Cristóbal;272;141;131
37;Salamanca;113;Cubo de Don Sancho (El);726;378;348
37;Salamanca;115;Dios le Guarde;204;106;98
37;Salamanca;116;Doñinos de Ledesma;126;60;66
37;Salamanca;117;Doñinos de Salamanca;663;339;324
37;Salamanca;118;Ejeme;288;154;134
37;Salamanca;120;Encina de San Silvestre;139;67;72
37;Salamanca;119;Encina (La);330;174;156
37;Salamanca;121;Encinas de Abajo;774;409;365
37;Salamanca;122;Encinas de Arriba;303;154;149
37;Salamanca;123;Encinasola de los Comendadores;398;205;193
37;Salamanca;124;Endrinal;371;195;176
37;Salamanca;125;Escurial de la Sierra;353;167;186
37;Salamanca;126;Espadaña;72;37;35
37;Salamanca;127;Espeja;402;204;198
37;Salamanca;128;Espino de la Orbada;455;231;224
37;Salamanca;129;Florida de Liébana;257;142;115
37;Salamanca;130;Forfoleda;277;130;147
37;Salamanca;131;Frades de la Sierra;353;182;171
37;Salamanca;132;Fregeneda (La);705;338;367
37;Salamanca;133;Fresnedoso;195;98;97
37;Salamanca;134;Fresno Alhándiga;430;228;202
37;Salamanca;135;Fuente de San Esteban (La);1886;945;941
37;Salamanca;136;Fuenteguinaldo;1195;597;598
37;Salamanca;137;Fuenteliante;165;83;82
37;Salamanca;138;Fuenterroble de Salvatierra;308;159;149
37;Salamanca;139;Fuentes de Béjar;311;133;178
37;Salamanca;140;Fuentes de Oñoro;1597;790;807
37;Salamanca;141;Gajates;309;159;150
37;Salamanca;142;Galindo y Perahuy;190;98;92
37;Salamanca;143;Galinduste;698;359;339
37;Salamanca;144;Galisancho;831;429;402
37;Salamanca;145;Gallegos de Argañán;663;338;325
37;Salamanca;146;Gallegos de Solmirón;372;179;193
37;Salamanca;147;Garcibuey;362;200;162
37;Salamanca;148;Garcihernández;707;375;332
37;Salamanca;149;Garcirrey;130;64;66
37;Salamanca;150;Gejuelo del Barro;60;32;28
37;Salamanca;151;Golpejas;261;136;125
37;Salamanca;152;Gomecello;698;340;358
37;Salamanca;154;Guadramiro;298;167;131
37;Salamanca;155;Guijo de Ávila;120;67;53
37;Salamanca;156;Guijuelo;4712;2356;2356
37;Salamanca;157;Herguijuela de Ciudad Rodrigo;215;108;107
37;Salamanca;158;Herguijuela de la Sierra;478;230;248
37;Salamanca;159;Herguijuela del Campo;178;93;85
37;Salamanca;160;Hinojosa de Duero;1017;490;527
37;Salamanca;161;Horcajo de Montemayor;232;119;113
37;Salamanca;162;Horcajo Medianero;546;284;262
37;Salamanca;163;Hoya (La);38;23;15
37;Salamanca;164;Huerta;308;166;142
37;Salamanca;165;Iruelos;88;41;47
37;Salamanca;166;Ituero de Azaba;435;221;214
37;Salamanca;167;Juzbado;263;135;128
37;Salamanca;168;Lagunilla;890;473;417
37;Salamanca;169;Larrodrigo;369;187;182
37;Salamanca;170;Ledesma;2138;1049;1089
37;Salamanca;171;Ledrada;662;325;337
37;Salamanca;172;Linares de Riofrío;1198;599;599
37;Salamanca;173;Lumbrales;2599;1271;1328
37;Salamanca;175;Machacón;603;313;290
37;Salamanca;174;Macotera;2036;1020;1016
37;Salamanca;176;Madroñal;171;90;81
37;Salamanca;177;Maíllo (El);508;252;256
37;Salamanca;178;Malpartida;244;128;116
37;Salamanca;179;Mancera de Abajo;471;243;228
37;Salamanca;180;Manzano (El);124;71;53
37;Salamanca;181;Martiago;558;280;278
37;Salamanca;183;Martín de Yeltes;780;404;376
37;Salamanca;182;Martinamor;119;62;57
37;Salamanca;184;Masueco;597;300;297
37;Salamanca;186;Mata de Ledesma (La);203;93;110
37;Salamanca;187;Matilla de los Caños del Río;790;404;386
37;Salamanca;188;Maya (La);330;176;154
37;Salamanca;189;Membribe de la Sierra;126;67;59
37;Salamanca;190;Mieza;469;242;227
37;Salamanca;191;Milano (El);221;117;104
37;Salamanca;192;Miranda de Azán;133;65;68
37;Salamanca;193;Miranda del Castañar;838;431;407
37;Salamanca;194;Mogarraz;469;225;244
37;Salamanca;195;Molinillo;94;49;45
37;Salamanca;196;Monforte de la Sierra;164;83;81
37;Salamanca;197;Monleón;176;99;77
37;Salamanca;198;Monleras;318;163;155
37;Salamanca;199;Monsagro;291;164;127
37;Salamanca;200;Montejo;258;133;125
37;Salamanca;201;Montemayor del Río;492;251;241
37;Salamanca;202;Monterrubio de Armuña;104;53;51
37;Salamanca;203;Monterrubio de la Sierra;201;106;95
37;Salamanca;204;Morasverdes;541;282;259
37;Salamanca;205;Morille;217;112;105
37;Salamanca;206;Moríñigo;190;99;91
37;Salamanca;207;Moriscos;146;79;67
37;Salamanca;208;Moronta;180;88;92
37;Salamanca;209;Mozárbez;390;197;193
37;Salamanca;211;Narros de Matalayegua;393;213;180
37;Salamanca;213;Nava de Béjar;148;72;76
37;Salamanca;214;Nava de Francia;184;101;83
37;Salamanca;215;Nava de Sotrobal;280;147;133
37;Salamanca;212;Navacarros;101;54;47
37;Salamanca;216;Navales;434;241;193
37;Salamanca;217;Navalmoral de Béjar;100;49;51
37;Salamanca;218;Navamorales;251;130;121
37;Salamanca;219;Navarredonda de la Rinconada;418;210;208
37;Salamanca;221;Navasfrías;949;468;481
37;Salamanca;222;Negrilla de Palencia;137;67;70
37;Salamanca;223;Olmedo de Camaces;213;105;108
37;Salamanca;224;Orbada (La);343;169;174
37;Salamanca;225;Pajares de la Laguna;165;82;83
37;Salamanca;226;Palacios del Arzobispo;296;154;142
37;Salamanca;228;Palaciosrubios;697;364;333
37;Salamanca;229;Palencia de Negrilla;248;123;125
37;Salamanca;230;Parada de Arriba;269;140;129
37;Salamanca;231;Parada de Rubiales;421;208;213
37;Salamanca;232;Paradinas de San Juan;707;388;319
37;Salamanca;233;Pastores;96;52;44
37;Salamanca;234;Payo (El);716;350;366
37;Salamanca;235;Pedraza de Alba;316;176;140
37;Salamanca;236;Pedrosillo de Alba;360;183;177
37;Salamanca;237;Pedrosillo de los Aires;585;316;269
37;Salamanca;238;Pedrosillo el Ralo;171;86;85
37;Salamanca;239;Pedroso de la Armuña (El);420;198;222
37;Salamanca;240;Pelabravo;589;303;286
37;Salamanca;241;Pelarrodríguez;241;133;108
37;Salamanca;242;Pelayos;103;52;51
37;Salamanca;243;Peña (La);242;122;120
37;Salamanca;244;Peñacaballera;267;132;135
37;Salamanca;245;Peñaparda;590;278;312
37;Salamanca;246;Peñaranda de Bracamonte;6407;3149;3258
37;Salamanca;247;Peñarandilla;336;169;167
37;Salamanca;248;Peralejos de Abajo;269;123;146
37;Salamanca;249;Peralejos de Arriba;96;52;44
37;Salamanca;250;Pereña de la Ribera;574;300;274
37;Salamanca;251;Peromingo;153;72;81
37;Salamanca;252;Pinedas;291;148;143
37;Salamanca;253;Pino de Tormes (El);190;103;87
37;Salamanca;254;Pitiegua;333;173;160
37;Salamanca;255;Pizarral;116;53;63
37;Salamanca;256;Poveda de las Cintas;439;240;199
37;Salamanca;257;Pozos de Hinojo;130;63;67
37;Salamanca;258;Puebla de Azaba;469;242;227
37;Salamanca;259;Puebla de San Medel;81;42;39
37;Salamanca;260;Puebla de Yeltes;304;167;137
37;Salamanca;261;Puente del Congosto;470;233;237
37;Salamanca;262;Puertas;154;82;72
37;Salamanca;263;Puerto de Béjar;598;290;308
37;Salamanca;264;Puerto Seguro;139;74;65
37;Salamanca;265;Rágama;402;217;185
37;Salamanca;266;Redonda (La);131;62;69
37;Salamanca;267;Retortillo;328;167;161
37;Salamanca;268;Rinconada de la Sierra (La);223;107;116
37;Salamanca;269;Robleda;728;372;356
37;Salamanca;270;Robliza de Cojos;270;120;150
37;Salamanca;271;Rollán;640;330;310
37;Salamanca;272;Saelices el Chico;229;126;103
37;Salamanca;273;Sagrada (La);238;117;121
37;Salamanca;303;Sahugo (El);389;199;190
37;Salamanca;274;Salamanca;160522;76480;84042
37;Salamanca;275;Saldeana;267;139;128
37;Salamanca;276;Salmoral;513;260;253
37;Salamanca;277;Salvatierra de Tormes;90;42;48
37;Salamanca;278;San Cristóbal de la Cuesta;255;129;126
37;Salamanca;284;San Esteban de la Sierra;541;279;262
37;Salamanca;285;San Felices de los Gallegos;791;406;385
37;Salamanca;286;San Martín del Castañar;438;222;216
37;Salamanca;287;San Miguel de Valero;544;259;285
37;Salamanca;036;San Miguel del Robledo;131;68;63
37;Salamanca;288;San Morales;187;97;90
37;Salamanca;289;San Muñoz;443;234;209
37;Salamanca;291;San Pedro de Rozados;511;256;255
37;Salamanca;290;San Pedro del Valle;315;159;156
37;Salamanca;292;San Pelayo de Guareña;150;77;73
37;Salamanca;280;Sanchón de la Ribera;189;95;94
37;Salamanca;281;Sanchón de la Sagrada;70;34;36
37;Salamanca;282;Sanchotello;422;223;199
37;Salamanca;279;Sancti-Spíritus;1530;764;766
37;Salamanca;283;Sando;277;156;121
37;Salamanca;293;Santa María de Sando;256;144;112
37;Salamanca;294;Santa Marta de Tormes;5349;2674;2675
37;Salamanca;296;Santiago de la Puebla;879;460;419
37;Salamanca;297;Santibáñez de Béjar;829;398;431
37;Salamanca;298;Santibáñez de la Sierra;322;173;149
37;Salamanca;299;Santiz;327;174;153
37;Salamanca;300;Santos (Los);883;470;413
37;Salamanca;301;Sardón de los Frailes;109;63;46
37;Salamanca;302;Saucelle;622;329;293
37;Salamanca;304;Sepulcro-Hilario;353;175;178
37;Salamanca;305;Sequeros;299;139;160
37;Salamanca;306;Serradilla del Arroyo;577;289;288
37;Salamanca;307;Serradilla del Llano;418;221;197
37;Salamanca;309;Sierpe (La);64;31;33
37;Salamanca;310;Sieteiglesias de Tormes;228;122;106
37;Salamanca;311;Sobradillo;466;221;245
37;Salamanca;312;Sorihuela;528;259;269
37;Salamanca;313;Sotoserrano;854;450;404
37;Salamanca;314;Tabera de Abajo;154;80;74
37;Salamanca;315;Tala (La);226;116;110
37;Salamanca;316;Tamames;1194;601;593
37;Salamanca;317;Tarazona de Guareña;505;276;229
37;Salamanca;318;Tardáguila;310;168;142
37;Salamanca;319;Tejado (El);228;107;121
37;Salamanca;320;Tejeda y Segoyuela;180;91;89
37;Salamanca;321;Tenebrón;280;137;143
37;Salamanca;322;Terradillos;1419;708;711
37;Salamanca;323;Topas;853;448;405
37;Salamanca;324;Tordillos;726;362;364
37;Salamanca;325;Tornadizo (El);188;94;94
37;Salamanca;327;Torresmenudas;295;144;151
37;Salamanca;328;Trabanca;303;164;139
37;Salamanca;329;Tremedal de Tormes;74;38;36
37;Salamanca;330;Valdecarros;537;272;265
37;Salamanca;331;Valdefuentes de Sangusín;377;191;186
37;Salamanca;332;Valdehijaderos;156;89;67
37;Salamanca;333;Valdelacasa;367;194;173
37;Salamanca;334;Valdelageve;166;95;71
37;Salamanca;335;Valdelosa;574;283;291
37;Salamanca;336;Valdemierque;75;39;36
37;Salamanca;337;Valderrodrigo;234;115;119
37;Salamanca;338;Valdunciel;140;65;75
37;Salamanca;339;Valero;582;291;291
37;Salamanca;343;Vallejera de Riofrío;65;23;42
37;Salamanca;340;Valsalabroso;301;148;153
37;Salamanca;341;Valverde de Valdelacasa;98;50;48
37;Salamanca;342;Valverdón;275;148;127
37;Salamanca;344;Vecinos;345;172;173
37;Salamanca;345;Vega de Tirados;266;138;128
37;Salamanca;346;Veguillas (Las);378;178;200
37;Salamanca;347;Vellés (La);506;255;251
37;Salamanca;348;Ventosa del Río Almar;192;95;97
37;Salamanca;349;Vídola (La);265;134;131
37;Salamanca;351;Villaflores;601;302;299
37;Salamanca;352;Villagonzalo de Tormes;284;152;132
37;Salamanca;353;Villalba de los Llanos;241;130;111
37;Salamanca;354;Villamayor;1038;529;509
37;Salamanca;355;Villanueva del Conde;367;185;182
37;Salamanca;356;Villar de Argañán;165;84;81
37;Salamanca;357;Villar de Ciervo;521;271;250
37;Salamanca;358;Villar de Gallimazo;348;181;167
37;Salamanca;359;Villar de la Yegua;471;241;230
37;Salamanca;360;Villar de Peralonso;476;230;246
37;Salamanca;361;Villar de Samaniego;187;99;88
37;Salamanca;362;Villares de la Reina;1002;498;504
37;Salamanca;363;Villares de Yeltes;203;104;99
37;Salamanca;364;Villarino de los Aires;1407;705;702
37;Salamanca;365;Villarmayor;266;134;132
37;Salamanca;366;Villarmuerto;102;52;50
37;Salamanca;367;Villasbuenas;411;202;209
37;Salamanca;368;Villasdardo;39;20;19
37;Salamanca;369;Villaseco de los Gamitos;253;124;129
37;Salamanca;370;Villaseco de los Reyes;511;257;254
37;Salamanca;371;Villasrubias;468;244;224
37;Salamanca;372;Villaverde de Guareña;245;125;120
37;Salamanca;373;Villavieja de Yeltes;1630;798;832
37;Salamanca;374;Villoria;1472;737;735
37;Salamanca;375;Villoruela;1122;550;572
37;Salamanca;350;Vilvestre;755;371;384
37;Salamanca;376;Vitigudino;3110;1529;1581
37;Salamanca;377;Yecla de Yeltes;490;248;242
37;Salamanca;378;Zamarra;227;114;113
37;Salamanca;379;Zamayón;213;121;92
37;Salamanca;380;Zarapicos;72;34;38
37;Salamanca;381;Zarza de Pumareda (La);269;148;121
37;Salamanca;382;Zorita de la Frontera;394;212;182
38;Santa Cruz de Tenerife;001;Adeje;9334;4801;4533
38;Santa Cruz de Tenerife;002;Agulo;1387;699;688
38;Santa Cruz de Tenerife;003;Alajeró;1130;596;534
38;Santa Cruz de Tenerife;004;Arafo;3952;1917;2035
38;Santa Cruz de Tenerife;005;Arico;4387;2284;2103
38;Santa Cruz de Tenerife;006;Arona;23589;12135;11454
38;Santa Cruz de Tenerife;007;Barlovento;2602;1305;1297
38;Santa Cruz de Tenerife;008;Breña Alta;5362;2685;2677
38;Santa Cruz de Tenerife;009;Breña Baja;3354;1682;1672
38;Santa Cruz de Tenerife;010;Buenavista del Norte;5428;2761;2667
38;Santa Cruz de Tenerife;011;Candelaria;9284;4632;4652
38;Santa Cruz de Tenerife;012;Fasnia;2265;1129;1136
38;Santa Cruz de Tenerife;013;Frontera;3864;1927;1937
38;Santa Cruz de Tenerife;014;Fuencaliente de la Palma;1823;915;908
38;Santa Cruz de Tenerife;015;Garachico;6221;3079;3142
38;Santa Cruz de Tenerife;016;Garafía;2041;1026;1015
38;Santa Cruz de Tenerife;017;Granadilla de Abona;16716;8513;8203
38;Santa Cruz de Tenerife;018;Guancha (La);5135;2563;2572
38;Santa Cruz de Tenerife;019;Guía de Isora;12079;5948;6131
38;Santa Cruz de Tenerife;020;Güímar;14797;7334;7463
38;Santa Cruz de Tenerife;021;Hermigua;2721;1353;1368
38;Santa Cruz de Tenerife;022;Icod de los Vinos;22210;11013;11197
38;Santa Cruz de Tenerife;024;Llanos de Aridane (Los);16681;8262;8419
38;Santa Cruz de Tenerife;025;Matanza de Acentejo (La);5933;3060;2873
38;Santa Cruz de Tenerife;026;Orotava (La);36275;17935;18340
38;Santa Cruz de Tenerife;027;Paso (El);7094;3509;3585
38;Santa Cruz de Tenerife;028;Puerto de la Cruz;27654;13577;14077
38;Santa Cruz de Tenerife;029;Puntagorda;1692;867;825
38;Santa Cruz de Tenerife;030;Puntallana;2280;1153;1127
38;Santa Cruz de Tenerife;031;Realejos (Los);29367;14463;14904
38;Santa Cruz de Tenerife;032;Rosario (El);7003;3510;3493
38;Santa Cruz de Tenerife;033;San Andrés y Sauces;5525;2756;2769
38;Santa Cruz de Tenerife;023;San Cristóbal de La Laguna;113733;56152;57581
38;Santa Cruz de Tenerife;034;San Juan de la Rambla;4757;2376;2381
38;Santa Cruz de Tenerife;035;San Miguel de Abona;5013;2544;2469
38;Santa Cruz de Tenerife;036;San Sebastián de la Gomera;5892;2979;2913
38;Santa Cruz de Tenerife;037;Santa Cruz de la Palma;18150;8755;9395
38;Santa Cruz de Tenerife;038;Santa Cruz de Tenerife;219907;107249;112658
38;Santa Cruz de Tenerife;039;Santa Úrsula;8700;4349;4351
38;Santa Cruz de Tenerife;040;Santiago del Teide;5081;2569;2512
38;Santa Cruz de Tenerife;041;Sauzal (El);6065;3037;3028
38;Santa Cruz de Tenerife;042;Silos (Los);5503;2692;2811
38;Santa Cruz de Tenerife;043;Tacoronte;17903;8969;8934
38;Santa Cruz de Tenerife;044;Tanque (El);2781;1390;1391
38;Santa Cruz de Tenerife;045;Tazacorte;7055;3550;3505
38;Santa Cruz de Tenerife;046;Tegueste;7464;3730;3734
38;Santa Cruz de Tenerife;047;Tijarafe;2734;1393;1341
38;Santa Cruz de Tenerife;049;Valle Gran Rey;2973;1535;1438
38;Santa Cruz de Tenerife;050;Vallehermoso;3390;1668;1722
38;Santa Cruz de Tenerife;048;Valverde;3632;1803;1829
38;Santa Cruz de Tenerife;051;Victoria de Acentejo (La);7554;3838;3716
38;Santa Cruz de Tenerife;052;Vilaflor;1557;795;762
38;Santa Cruz de Tenerife;053;Villa de Mazo;5112;2553;2559
39;Cantabria;001;Alfoz de Lloredo;2869;1480;1389
39;Cantabria;002;Ampuero;3373;1699;1674
39;Cantabria;003;Anievas;481;243;238
39;Cantabria;004;Arenas de Iguña;2403;1232;1171
39;Cantabria;005;Argoños;649;328;321
39;Cantabria;006;Arnuero;1832;917;915
39;Cantabria;007;Arredondo;804;421;383
39;Cantabria;008;Astillero (El);12546;6231;6315
39;Cantabria;009;Bárcena de Cicero;2347;1197;1150
39;Cantabria;010;Bárcena de Pie de Concha;963;457;506
39;Cantabria;011;Bareyo;1634;838;796
39;Cantabria;012;Cabezón de la Sal;6574;3259;3315
39;Cantabria;013;Cabezón de Liébana;924;479;445
39;Cantabria;014;Cabuérniga;1181;592;589
39;Cantabria;015;Camaleño;1338;692;646
39;Cantabria;016;Camargo;19848;9809;10039
39;Cantabria;027;Campoo de Enmedio;4151;2121;2030
39;Cantabria;017;Campoo de Yuso;918;463;455
39;Cantabria;018;Cartes;2180;1078;1102
39;Cantabria;019;Castañeda;1607;791;816
39;Cantabria;020;Castro-Urdiales;13378;6626;6752
39;Cantabria;021;Cieza;830;409;421
39;Cantabria;022;Cillorigo de Liébana;1271;680;591
39;Cantabria;023;Colindres;5450;2721;2729
39;Cantabria;024;Comillas;2528;1210;1318
39;Cantabria;025;Corrales de Buelna (Los);9729;4848;4881
39;Cantabria;026;Corvera de Toranzo;2274;1136;1138
39;Cantabria;028;Entrambasaguas;2650;1306;1344
39;Cantabria;029;Escalante;763;369;394
39;Cantabria;030;Guriezo;1841;932;909
39;Cantabria;031;Hazas de Cesto;1385;703;682
39;Cantabria;032;Hermandad de Campoo de Suso;1991;1049;942
39;Cantabria;033;Herrerías;894;471;423
39;Cantabria;034;Lamasón;488;260;228
39;Cantabria;035;Laredo;13269;6536;6733
39;Cantabria;036;Liendo;814;412;402
39;Cantabria;037;Liérganes;2397;1179;1218
39;Cantabria;038;Limpias;1196;605;591
39;Cantabria;039;Luena;1274;667;607
39;Cantabria;040;Marina de Cudeyo;4621;2297;2324
39;Cantabria;041;Mazcuerras;1850;949;901
39;Cantabria;042;Medio Cudeyo;5575;2736;2839
39;Cantabria;043;Meruelo;916;462;454
39;Cantabria;044;Miengo;3012;1502;1510
39;Cantabria;045;Miera;774;380;394
39;Cantabria;046;Molledo;2268;1116;1152
39;Cantabria;047;Noja;1561;781;780
39;Cantabria;048;Penagos;1846;921;925
39;Cantabria;049;Peñarrubia;387;194;193
39;Cantabria;050;Pesaguero;499;270;229
39;Cantabria;051;Pesquera;121;53;68
39;Cantabria;052;Piélagos;9172;4586;4586
39;Cantabria;053;Polaciones;390;224;166
39;Cantabria;054;Polanco;3738;1799;1939
39;Cantabria;055;Potes;1468;728;740
39;Cantabria;056;Puente Viesgo;2519;1269;1250
39;Cantabria;057;Ramales de la Victoria;2499;1253;1246
39;Cantabria;058;Rasines;1105;554;551
39;Cantabria;059;Reinosa;12917;6330;6587
39;Cantabria;060;Reocín;6472;3223;3249
39;Cantabria;061;Ribamontán al Mar;2780;1429;1351
39;Cantabria;062;Ribamontán al Monte;2151;1114;1037
39;Cantabria;063;Rionansa;1782;933;849
39;Cantabria;064;Riotuerto;1693;833;860
39;Cantabria;065;Rozas de Valdearroyo (Las);281;153;128
39;Cantabria;066;Ruente;1008;517;491
39;Cantabria;067;Ruesga;1436;718;718
39;Cantabria;068;Ruiloba;774;387;387
39;Cantabria;069;San Felices de Buelna;2371;1184;1187
39;Cantabria;070;San Miguel de Aguayo;193;105;88
39;Cantabria;071;San Pedro del Romeral;980;511;469
39;Cantabria;072;San Roque de Riomiera;652;341;311
39;Cantabria;080;San Vicente de la Barquera;4518;2335;2183
39;Cantabria;073;Santa Cruz de Bezana;4220;2107;2113
39;Cantabria;074;Santa María de Cayón;5954;3005;2949
39;Cantabria;075;Santander;192483;91441;101042
39;Cantabria;076;Santillana del Mar;3840;1886;1954
39;Cantabria;077;Santiurde de Reinosa;447;236;211
39;Cantabria;078;Santiurde de Toranzo;1872;943;929
39;Cantabria;079;Santoña;11166;5487;5679
39;Cantabria;081;Saro;601;315;286
39;Cantabria;082;Selaya;2074;1064;1010
39;Cantabria;083;Soba;1983;1054;929
39;Cantabria;084;Solórzano;1084;552;532
39;Cantabria;085;Suances;5824;2871;2953
39;Cantabria;086;Tojos (Los);428;223;205
39;Cantabria;087;Torrelavega;59683;29122;30561
39;Cantabria;088;Tresviso;93;52;41
39;Cantabria;089;Tudanca;373;207;166
39;Cantabria;090;Udías;879;436;443
39;Cantabria;095;Val de San Vicente;2635;1361;1274
39;Cantabria;091;Valdáliga;2849;1465;1384
39;Cantabria;092;Valdeolea;2090;1078;1012
39;Cantabria;093;Valdeprado del Río;439;229;210
39;Cantabria;094;Valderredible;1404;721;683
39;Cantabria;096;Vega de Liébana;1193;615;578
39;Cantabria;097;Vega de Pas;1296;659;637
39;Cantabria;098;Villacarriedo;2133;1072;1061
39;Cantabria;099;Villaescusa;2895;1430;1465
39;Cantabria;100;Villafufre;1206;598;608
39;Cantabria;101;Villaverde de Trucíos;470;251;219
39;Cantabria;102;Voto;2667;1388;1279
40;Segovia;001;Abades;941;479;462
40;Segovia;002;Adrada de Pirón;51;27;24
40;Segovia;003;Adrados;321;146;175
40;Segovia;004;Aguilafuente;819;400;419
40;Segovia;005;Alconada de Maderuelo;68;35;33
40;Segovia;012;Aldea Real;442;234;208
40;Segovia;006;Aldealcorvo;46;22;24
40;Segovia;007;Aldealengua de Pedraza;108;58;50
40;Segovia;008;Aldealengua de Santa María;113;67;46
40;Segovia;009;Aldeanueva de la Serrezuela;52;31;21
40;Segovia;010;Aldeanueva del Codonal;287;142;145
40;Segovia;013;Aldeasoña;172;80;92
40;Segovia;014;Aldehorno;102;58;44
40;Segovia;015;Aldehuela del Codonal;66;25;41
40;Segovia;016;Aldeonte;125;65;60
40;Segovia;017;Anaya;141;78;63
40;Segovia;018;Añe;142;75;67
40;Segovia;019;Arahuetes;53;29;24
40;Segovia;020;Arcones;315;165;150
40;Segovia;021;Arevalillo de Cega;37;19;18
40;Segovia;022;Armuña;356;175;181
40;Segovia;024;Ayllón;1318;661;657
40;Segovia;025;Barbolla;259;134;125
40;Segovia;026;Basardilla;106;55;51
40;Segovia;028;Bercial;181;91;90
40;Segovia;029;Bercimuel;97;41;56
40;Segovia;030;Bernardos;862;419;443
40;Segovia;031;Bernuy de Porreros;354;183;171
40;Segovia;032;Boceguillas;577;289;288
40;Segovia;033;Brieva;59;37;22
40;Segovia;034;Caballar;122;61;61
40;Segovia;035;Cabañas de Polendos;126;62;64
40;Segovia;036;Cabezuela;805;421;384
40;Segovia;037;Calabazas de Fuentidueña;125;61;64
40;Segovia;039;Campo de San Pedro;423;244;179
40;Segovia;040;Cantalejo;3565;1773;1792
40;Segovia;041;Cantimpalos;1385;694;691
40;Segovia;043;Carbonero el Mayor;2455;1231;1224
40;Segovia;044;Carrascal del Río;245;128;117
40;Segovia;045;Casla;139;66;73
40;Segovia;046;Castillejo de Mesleón;141;71;70
40;Segovia;047;Castro de Fuentidueña;130;76;54
40;Segovia;048;Castrojimeno;68;38;30
40;Segovia;049;Castroserna de Abajo;85;48;37
40;Segovia;051;Castroserracín;51;31;20
40;Segovia;052;Cedillo de la Torre;164;82;82
40;Segovia;053;Cerezo de Abajo;195;96;99
40;Segovia;054;Cerezo de Arriba;213;113;100
40;Segovia;065;Chañe;816;428;388
40;Segovia;055;Cilleruelo de San Mamés;70;38;32
40;Segovia;056;Cobos de Fuentidueña;104;46;58
40;Segovia;057;Coca;2152;1056;1096
40;Segovia;058;Codorniz;569;281;288
40;Segovia;059;Collado Hermoso;111;50;61
40;Segovia;060;Condado de Castilnovo;180;102;78
40;Segovia;061;Corral de Ayllón;143;83;60
40;Segovia;902;Cozuelos de Fuentidueña;275;141;134
40;Segovia;062;Cubillo;73;40;33
40;Segovia;063;Cuéllar;9305;4701;4604
40;Segovia;905;Cuevas de Provanco;"";"";""
40;Segovia;068;Domingo García;42;19;23
40;Segovia;069;Donhierro;120;74;46
40;Segovia;070;Duruelo;113;58;55
40;Segovia;071;Encinas;85;41;44
40;Segovia;072;Encinillas;81;40;41
40;Segovia;073;Escalona del Prado;671;334;337
40;Segovia;074;Escarabajosa de Cabezas;432;229;203
40;Segovia;075;Escobar de Polendos;262;126;136
40;Segovia;076;Espinar (El);5201;2627;2574
40;Segovia;077;Espirdo;213;123;90
40;Segovia;078;Fresneda de Cuéllar;293;157;136
40;Segovia;079;Fresno de Cantespino;256;128;128
40;Segovia;080;Fresno de la Fuente;108;59;49
40;Segovia;081;Frumales;290;141;149
40;Segovia;082;Fuente de Santa Cruz;233;121;112
40;Segovia;083;Fuente el Olmo de Fuentidueña;231;116;115
40;Segovia;084;Fuente el Olmo de Íscar;132;72;60
40;Segovia;086;Fuentepelayo;1069;545;524
40;Segovia;087;Fuentepiñel;203;100;103
40;Segovia;088;Fuenterrebollo;541;269;272
40;Segovia;089;Fuentesaúco de Fuentidueña;419;215;204
40;Segovia;091;Fuentesoto;214;106;108
40;Segovia;092;Fuentidueña;251;119;132
40;Segovia;093;Gallegos;114;60;54
40;Segovia;094;Garcillán;363;196;167
40;Segovia;095;Gomezserracín;671;344;327
40;Segovia;097;Grajera;79;40;39
40;Segovia;099;Honrubia de la Cuesta;111;58;53
40;Segovia;100;Hontalbilla;596;308;288
40;Segovia;101;Hontanares de Eresma;147;77;70
40;Segovia;103;Huertos (Los);161;83;78
40;Segovia;104;Ituero y Lama;51;29;22
40;Segovia;105;Juarros de Riomoros;102;50;52
40;Segovia;106;Juarros de Voltoya;338;186;152
40;Segovia;107;Labajos;184;100;84
40;Segovia;108;Laguna de Contreras;243;127;116
40;Segovia;109;Languilla;182;92;90
40;Segovia;110;Lastras de Cuéllar;696;358;338
40;Segovia;111;Lastras del Pozo;112;58;54
40;Segovia;112;Lastrilla (La);479;233;246
40;Segovia;113;Losa (La);274;137;137
40;Segovia;115;Maderuelo;188;92;96
40;Segovia;903;Marazoleja;191;106;85
40;Segovia;118;Marazuela;105;52;53
40;Segovia;119;Martín Miguel;223;108;115
40;Segovia;120;Martín Muñoz de la Dehesa;169;90;79
40;Segovia;121;Martín Muñoz de las Posadas;667;335;332
40;Segovia;122;Marugán;239;120;119
40;Segovia;124;Mata de Cuéllar;338;182;156
40;Segovia;123;Matabuena;239;117;122
40;Segovia;125;Matilla (La);133;71;62
40;Segovia;126;Melque de Cercos;187;92;95
40;Segovia;127;Membibre de la Hoz;110;57;53
40;Segovia;128;Migueláñez;214;106;108
40;Segovia;129;Montejo de Arévalo;353;197;156
40;Segovia;130;Montejo de la Vega de la Serrezuela;237;122;115
40;Segovia;131;Monterrubio;98;44;54
40;Segovia;132;Moral de Hornuez;164;84;80
40;Segovia;134;Mozoncillo;1111;565;546
40;Segovia;135;Muñopedro;498;258;240
40;Segovia;136;Muñoveros;256;133;123
40;Segovia;138;Nava de la Asunción;2626;1347;1279
40;Segovia;139;Navafría;450;238;212
40;Segovia;140;Navalilla;229;114;115
40;Segovia;141;Navalmanzano;1236;632;604
40;Segovia;142;Navares de Ayuso;93;49;44
40;Segovia;143;Navares de Enmedio;212;108;104
40;Segovia;144;Navares de las Cuevas;35;18;17
40;Segovia;145;Navas de Oro;1612;805;807
40;Segovia;904;Navas de Riofrío;226;104;122
40;Segovia;146;Navas de San Antonio;357;187;170
40;Segovia;148;Nieva;402;199;203
40;Segovia;149;Olombrada;969;511;458
40;Segovia;150;Orejana;135;68;67
40;Segovia;151;Ortigosa de Pestaño;111;58;53
40;Segovia;901;Ortigosa del Monte;284;143;141
40;Segovia;152;Otero de Herreros;848;432;416
40;Segovia;154;Pajarejos;52;24;28
40;Segovia;155;Palazuelos de Eresma;1365;704;661
40;Segovia;156;Pedraza;455;223;232
40;Segovia;157;Pelayos del Arroyo;62;33;29
40;Segovia;158;Perosillo;35;21;14
40;Segovia;159;Pinarejos;259;144;115
40;Segovia;160;Pinarnegrillo;222;111;111
40;Segovia;161;Pradales;70;38;32
40;Segovia;162;Prádena;596;301;295
40;Segovia;163;Puebla de Pedraza;108;54;54
40;Segovia;164;Rapariegos;317;166;151
40;Segovia;165;Rebollo;163;90;73
40;Segovia;166;Remondo;409;203;206
40;Segovia;168;Riaguas de San Bartolomé;87;46;41
40;Segovia;170;Riaza;1518;791;727
40;Segovia;171;Ribota;47;26;21
40;Segovia;172;Riofrío de Riaza;61;33;28
40;Segovia;173;Roda de Eresma;105;50;55
40;Segovia;174;Sacramenia;967;508;459
40;Segovia;176;Samboal;784;402;382
40;Segovia;177;San Cristóbal de Cuéllar;309;156;153
40;Segovia;178;San Cristóbal de la Vega;197;97;100
40;Segovia;906;San Cristóbal de Segovia;"";"";""
40;Segovia;181;San Ildefonso;4957;2423;2534
40;Segovia;182;San Martín y Mudrián;381;192;189
40;Segovia;183;San Miguel de Bernuy;247;124;123
40;Segovia;184;San Pedro de Gaíllos;330;173;157
40;Segovia;179;Sanchonuño;774;383;391
40;Segovia;180;Sangarcía;592;310;282
40;Segovia;185;Santa María la Real de Nieva;1733;867;866
40;Segovia;186;Santa Marta del Cerro;63;31;32
40;Segovia;188;Santiuste de Pedraza;146;78;68
40;Segovia;189;Santiuste de San Juan Bautista;931;472;459
40;Segovia;190;Santo Domingo de Pirón;56;27;29
40;Segovia;191;Santo Tomé del Puerto;414;209;205
40;Segovia;192;Sauquillo de Cabezas;283;151;132
40;Segovia;193;Sebúlcor;271;147;124
40;Segovia;194;Segovia;54754;26377;28377
40;Segovia;195;Sepúlveda;1494;757;737
40;Segovia;196;Sequera de Fresno;88;50;38
40;Segovia;198;Sotillo;75;34;41
40;Segovia;199;Sotosalbos;105;50;55
40;Segovia;200;Tabanera la Luenga;93;50;43
40;Segovia;201;Tolocirio;87;42;45
40;Segovia;206;Torre Val de San Pedro;182;94;88
40;Segovia;202;Torreadrada;191;93;98
40;Segovia;203;Torrecaballeros;258;128;130
40;Segovia;204;Torrecilla del Pinar;436;209;227
40;Segovia;205;Torreiglesias;442;235;207
40;Segovia;207;Trescasas;175;95;80
40;Segovia;208;Turégano;1247;613;634
40;Segovia;210;Urueñas;181;100;81
40;Segovia;211;Valdeprados;49;22;27
40;Segovia;212;Valdevacas de Montejo;50;28;22
40;Segovia;213;Valdevacas y Guijar;181;100;81
40;Segovia;218;Valle de Tabladillo;240;125;115
40;Segovia;219;Vallelado;902;452;450
40;Segovia;220;Valleruela de Pedraza;71;41;30
40;Segovia;221;Valleruela de Sepúlveda;96;48;48
40;Segovia;214;Valseca;347;176;171
40;Segovia;215;Valtiendas;273;148;125
40;Segovia;216;Valverde del Majano;522;270;252
40;Segovia;222;Veganzones;359;177;182
40;Segovia;223;Vegas de Matute;292;157;135
40;Segovia;224;Ventosilla y Tejadilla;31;17;14
40;Segovia;225;Villacastín;1643;851;792
40;Segovia;228;Villaverde de Íscar;800;408;392
40;Segovia;229;Villaverde de Montejo;102;53;49
40;Segovia;230;Villeguillo;153;85;68
40;Segovia;231;Yanguas de Eresma;240;106;134
40;Segovia;233;Zarzuela del Monte;557;278;279
40;Segovia;234;Zarzuela del Pinar;699;368;331
41;Sevilla;001;Aguadulce;1969;985;984
41;Sevilla;002;Alanís;2267;1137;1130
41;Sevilla;003;Albaida del Aljarafe;1702;867;835
41;Sevilla;004;Alcalá de Guadaira;51589;25703;25886
41;Sevilla;005;Alcalá del Río;9113;4652;4461
41;Sevilla;006;Alcolea del Río;3543;1729;1814
41;Sevilla;007;Algaba (La);12441;6269;6172
41;Sevilla;008;Algámitas;1534;786;748
41;Sevilla;009;Almadén de la Plata;1928;988;940
41;Sevilla;010;Almensilla;1705;843;862
41;Sevilla;011;Arahal;17643;8721;8922
41;Sevilla;012;Aznalcázar;3177;1592;1585
41;Sevilla;013;Aznalcóllar;5461;2782;2679
41;Sevilla;014;Badolatosa;3222;1638;1584
41;Sevilla;015;Benacazón;4692;2365;2327
41;Sevilla;016;Bollullos de la Mitación;4367;2170;2197
41;Sevilla;017;Bormujos;4936;2426;2510
41;Sevilla;018;Brenes;10081;5064;5017
41;Sevilla;019;Burguillos;3208;1618;1590
41;Sevilla;020;Cabezas de San Juan (Las);15585;8005;7580
41;Sevilla;021;Camas;25567;12581;12986
41;Sevilla;022;Campana (La);5520;2820;2700
41;Sevilla;023;Cantillana;8951;4474;4477
41;Sevilla;901;Cañada Rosal;2783;1404;1379
41;Sevilla;024;Carmona;24360;12216;12144
41;Sevilla;025;Carrión de los Céspedes;2462;1190;1272
41;Sevilla;026;Casariche;4975;2536;2439
41;Sevilla;027;Castilblanco de los Arroyos;3852;1948;1904
41;Sevilla;028;Castilleja de Guzmán;253;127;126
41;Sevilla;029;Castilleja de la Cuesta;14367;7090;7277
41;Sevilla;030;Castilleja del Campo;618;307;311
41;Sevilla;031;Castillo de las Guardas (El);1810;934;876
41;Sevilla;032;Cazalla de la Sierra;5442;2720;2722
41;Sevilla;033;Constantina;7935;3935;4000
41;Sevilla;034;Coria del Río;22138;11066;11072
41;Sevilla;035;Coripe;1821;936;885
41;Sevilla;036;Coronil (El);5212;2667;2545
41;Sevilla;037;Corrales (Los);3935;2036;1899
41;Sevilla;903;Cuervo de Sevilla (El);"";"";""
41;Sevilla;038;Dos Hermanas;70232;34671;35561
41;Sevilla;039;Écija;36252;17894;18358
41;Sevilla;040;Espartinas;2538;1322;1216
41;Sevilla;041;Estepa;10802;5303;5499
41;Sevilla;042;Fuentes de Andalucía;7706;3845;3861
41;Sevilla;043;Garrobo (El);745;370;375
41;Sevilla;044;Gelves;3806;1829;1977
41;Sevilla;045;Gerena;5139;2577;2562
41;Sevilla;046;Gilena;3790;1898;1892
41;Sevilla;047;Gines;5382;2662;2720
41;Sevilla;048;Guadalcanal;3336;1642;1694
41;Sevilla;049;Guillena;7763;3949;3814
41;Sevilla;050;Herrera;5663;2797;2866
41;Sevilla;051;Huévar del Aljarafe;2096;1093;1003
41;Sevilla;052;Lantejuela (La);3282;1699;1583
41;Sevilla;053;Lebrija;29491;14958;14533
41;Sevilla;054;Lora de Estepa;677;341;336
41;Sevilla;055;Lora del Río;19461;9622;9839
41;Sevilla;056;Luisiana (La);4131;2110;2021
41;Sevilla;057;Madroño (El);441;234;207
41;Sevilla;058;Mairena del Alcor;14144;7047;7097
41;Sevilla;059;Mairena del Aljarafe;20101;10183;9918
41;Sevilla;060;Marchena;17711;8697;9014
41;Sevilla;061;Marinaleda;2472;1219;1253
41;Sevilla;062;Martín de la Jara;2741;1437;1304
41;Sevilla;063;Molares (Los);2735;1394;1341
41;Sevilla;064;Montellano;7103;3601;3502
41;Sevilla;065;Morón de la Frontera;29116;14561;14555
41;Sevilla;066;Navas de la Concepción (Las);2155;1076;1079
41;Sevilla;067;Olivares;6392;3282;3110
41;Sevilla;068;Osuna;16939;8369;8570
41;Sevilla;069;Palacios y Villafranca (Los);29266;14868;14398
41;Sevilla;070;Palomares del Río;2108;1072;1036
41;Sevilla;071;Paradas;7187;3620;3567
41;Sevilla;072;Pedrera;4762;2410;2352
41;Sevilla;073;Pedroso (El);2474;1213;1261
41;Sevilla;074;Peñaflor;4097;2086;2011
41;Sevilla;075;Pilas;10411;5060;5351
41;Sevilla;076;Pruna;3903;2019;1884
41;Sevilla;077;Puebla de Cazalla (La);10831;5465;5366
41;Sevilla;078;Puebla de los Infantes (La);3870;1956;1914
41;Sevilla;079;Puebla del Río (La);15933;8080;7853
41;Sevilla;080;Real de la Jara (El);1850;937;913
41;Sevilla;081;Rinconada (La);20785;10531;10254
41;Sevilla;082;Roda de Andalucía (La);4095;2025;2070
41;Sevilla;083;Ronquillo (El);1424;718;706
41;Sevilla;084;Rubio (El);3846;1946;1900
41;Sevilla;085;Salteras;2398;1206;1192
41;Sevilla;086;San Juan de Aznalfarache;21565;10576;10989
41;Sevilla;088;San Nicolás del Puerto;765;400;365
41;Sevilla;087;Sanlúcar la Mayor;8985;4489;4496
41;Sevilla;089;Santiponce;6269;3135;3134
41;Sevilla;090;Saucejo (El);4067;2075;1992
41;Sevilla;091;Sevilla;669976;320561;349415
41;Sevilla;092;Tocina;8544;4249;4295
41;Sevilla;093;Tomares;11324;5594;5730
41;Sevilla;094;Umbrete;4216;2117;2099
41;Sevilla;095;Utrera;42365;21216;21149
41;Sevilla;096;Valencina de la Concepción;4187;2143;2044
41;Sevilla;902;Villafranco del Guadalquivir;"";"";""
41;Sevilla;097;Villamanrique de la Condesa;3534;1769;1765
41;Sevilla;100;Villanueva de San Juan;1785;897;888
41;Sevilla;098;Villanueva del Ariscal;3788;1799;1989
41;Sevilla;099;Villanueva del Río y Minas;5870;2827;3043
41;Sevilla;101;Villaverde del Río;6347;3251;3096
41;Sevilla;102;Viso del Alcor (El);14996;7646;7350
42;Soria;001;Abejar;374;194;180
42;Soria;003;Adradas;132;68;64
42;Soria;004;Ágreda;3665;1775;1890
42;Soria;006;Alconaba;156;87;69
42;Soria;007;Alcubilla de Avellaneda;295;155;140
42;Soria;008;Alcubilla de las Peñas;128;63;65
42;Soria;009;Aldealafuente;174;86;88
42;Soria;010;Aldealices;40;19;21
42;Soria;011;Aldealpozo;31;14;17
42;Soria;012;Aldealseñor;57;31;26
42;Soria;013;Aldehuela de Periáñez;53;27;26
42;Soria;014;Aldehuelas (Las);182;93;89
42;Soria;015;Alentisque;65;37;28
42;Soria;016;Aliud;62;29;33
42;Soria;017;Almajano;202;99;103
42;Soria;018;Almaluez;433;216;217
42;Soria;019;Almarza;663;353;310
42;Soria;020;Almazán;5817;2926;2891
42;Soria;021;Almazul;239;113;126
42;Soria;022;Almenar de Soria;486;249;237
42;Soria;023;Alpanseque;165;88;77
42;Soria;024;Arancón;117;64;53
42;Soria;025;Arcos de Jalón;2356;1181;1175
42;Soria;026;Arenillas;55;29;26
42;Soria;027;Arévalo de la Sierra;156;86;70
42;Soria;028;Ausejo de la Sierra;67;35;32
42;Soria;029;Baraona;336;173;163
42;Soria;030;Barca;203;108;95
42;Soria;031;Barcones;70;39;31
42;Soria;032;Bayubas de Abajo;342;182;160
42;Soria;033;Bayubas de Arriba;105;54;51
42;Soria;034;Beratón;48;32;16
42;Soria;035;Berlanga de Duero;1494;745;749
42;Soria;036;Blacos;90;51;39
42;Soria;037;Bliecos;71;36;35
42;Soria;038;Borjabad;80;42;38
42;Soria;039;Borobia;491;249;242
42;Soria;041;Buberos;62;29;33
42;Soria;042;Buitrago;51;28;23
42;Soria;043;Burgo de Osma-Ciudad de Osma;5026;2457;2569
42;Soria;044;Cabrejas del Campo;96;54;42
42;Soria;045;Cabrejas del Pinar;549;294;255
42;Soria;046;Calatañazor;91;47;44
42;Soria;048;Caltojar;196;100;96
42;Soria;049;Candilichera;265;139;126
42;Soria;050;Cañamaque;74;40;34
42;Soria;051;Carabantes;52;27;25
42;Soria;052;Caracena;9;5;4
42;Soria;053;Carrascosa de Abajo;54;28;26
42;Soria;054;Carrascosa de la Sierra;23;10;13
42;Soria;055;Casarejos;321;163;158
42;Soria;056;Castilfrío de la Sierra;40;20;20
42;Soria;058;Castillejo de Robledo;273;149;124
42;Soria;057;Castilruiz;446;226;220
42;Soria;059;Centenera de Andaluz;45;20;25
42;Soria;060;Cerbón;80;44;36
42;Soria;061;Cidones;355;181;174
42;Soria;062;Cigudosa;110;60;50
42;Soria;063;Cihuela;136;69;67
42;Soria;064;Ciria;113;56;57
42;Soria;065;Cirujales del Río;44;24;20
42;Soria;068;Coscurita;199;114;85
42;Soria;069;Covaleda;2215;1142;1073
42;Soria;070;Cubilla;112;61;51
42;Soria;071;Cubo de la Solana;402;206;196
42;Soria;073;Cueva de Ágreda;151;79;72
42;Soria;075;Dévanos;193;99;94
42;Soria;076;Deza;518;263;255
42;Soria;078;Duruelo de la Sierra;1563;800;763
42;Soria;079;Escobosa de Almazán;56;28;28
42;Soria;080;Espeja de San Marcelino;333;178;155
42;Soria;081;Espejón;266;140;126
42;Soria;082;Estepa de San Juan;20;10;10
42;Soria;083;Frechilla de Almazán;67;36;31
42;Soria;084;Fresno de Caracena;71;39;32
42;Soria;085;Fuentearmegil;479;247;232
42;Soria;086;Fuentecambrón;100;58;42
42;Soria;087;Fuentecantos;49;22;27
42;Soria;088;Fuentelmonge;182;92;90
42;Soria;089;Fuentelsaz de Soria;77;40;37
42;Soria;090;Fuentepinilla;213;108;105
42;Soria;092;Fuentes de Magaña;151;73;78
42;Soria;093;Fuentestrún;101;58;43
42;Soria;094;Garray;306;151;155
42;Soria;095;Golmayo;540;291;249
42;Soria;096;Gómara;659;320;339
42;Soria;097;Gormaz;41;18;23
42;Soria;098;Herrera de Soria;50;27;23
42;Soria;100;Hinojosa del Campo;70;41;29
42;Soria;103;Langa de Duero;1171;607;564
42;Soria;105;Liceras;82;41;41
42;Soria;106;Losilla (La);26;15;11
42;Soria;107;Magaña;131;68;63
42;Soria;108;Maján;34;17;17
42;Soria;110;Matalebreras;166;88;78
42;Soria;111;Matamala de Almazán;535;276;259
42;Soria;113;Medinaceli;867;442;425
42;Soria;115;Miño de Medinaceli;185;86;99
42;Soria;116;Miño de San Esteban;146;79;67
42;Soria;117;Molinos de Duero;209;104;105
42;Soria;118;Momblona;62;35;27
42;Soria;119;Monteagudo de las Vicarías;405;200;205
42;Soria;120;Montejo de Tiermes;314;168;146
42;Soria;121;Montenegro de Cameros;138;73;65
42;Soria;123;Morón de Almazán;397;191;206
42;Soria;124;Muriel de la Fuente;106;58;48
42;Soria;125;Muriel Viejo;113;58;55
42;Soria;127;Nafría de Ucero;118;56;62
42;Soria;128;Narros;66;34;32
42;Soria;129;Navaleno;944;471;473
42;Soria;130;Nepas;112;65;47
42;Soria;131;Nolay;117;64;53
42;Soria;132;Noviercas;297;141;156
42;Soria;134;Ólvega;3233;1666;1567
42;Soria;135;Oncala;149;85;64
42;Soria;139;Pinilla del Campo;33;17;16
42;Soria;140;Portillo de Soria;25;15;10
42;Soria;141;Póveda de Soria (La);177;89;88
42;Soria;142;Pozalmuro;147;70;77
42;Soria;144;Quintana Redonda;749;386;363
42;Soria;145;Quintanas de Gormaz;245;117;128
42;Soria;148;Quiñonería;27;11;16
42;Soria;149;Rábanos (Los);484;269;215
42;Soria;151;Rebollar;52;30;22
42;Soria;152;Recuerda;207;106;101
42;Soria;153;Rello;64;26;38
42;Soria;154;Renieblas;134;69;65
42;Soria;155;Retortillo de Soria;329;182;147
42;Soria;156;Reznos;58;31;27
42;Soria;157;Riba de Escalote (La);44;26;18
42;Soria;158;Rioseco de Soria;175;90;85
42;Soria;159;Rollamienta;49;26;23
42;Soria;160;Royo (El);401;192;209
42;Soria;161;Salduero;239;131;108
42;Soria;162;San Esteban de Gormaz;3709;1900;1809
42;Soria;163;San Felices;112;64;48
42;Soria;164;San Leonardo de Yagüe;2140;1077;1063
42;Soria;165;San Pedro Manrique;531;263;268
42;Soria;166;Santa Cruz de Yanguas;76;45;31
42;Soria;167;Santa María de Huerta;563;272;291
42;Soria;168;Santa María de las Hoyas;256;133;123
42;Soria;171;Serón de Nágima;348;180;168
42;Soria;172;Soliedra;45;27;18
42;Soria;173;Soria;32371;15473;16898
42;Soria;174;Sotillo del Rincón;194;96;98
42;Soria;175;Suellacabras;58;26;32
42;Soria;176;Tajahuerce;55;30;25
42;Soria;177;Tajueco;163;88;75
42;Soria;178;Talveila;266;139;127
42;Soria;181;Tardelcuende;749;360;389
42;Soria;182;Taroda;112;60;52
42;Soria;183;Tejado;276;139;137
42;Soria;184;Torlengua;161;78;83
42;Soria;185;Torreblacos;64;28;36
42;Soria;187;Torrubia de Soria;138;77;61
42;Soria;188;Trévago;95;46;49
42;Soria;189;Ucero;107;56;51
42;Soria;190;Vadillo;186;95;91
42;Soria;191;Valdeavellano de Tera;237;121;116
42;Soria;192;Valdegeña;62;34;28
42;Soria;193;Valdelagua del Cerro;53;26;27
42;Soria;194;Valdemaluque;381;192;189
42;Soria;195;Valdenebro;216;113;103
42;Soria;196;Valdeprado;31;14;17
42;Soria;197;Valderrodilla;158;75;83
42;Soria;198;Valtajeros;44;23;21
42;Soria;200;Velamazán;185;102;83
42;Soria;201;Velilla de la Sierra;11;4;7
42;Soria;202;Velilla de los Ajos;70;38;32
42;Soria;204;Viana de Duero;105;54;51
42;Soria;205;Villaciervos;109;58;51
42;Soria;206;Villanueva de Gormaz;24;13;11
42;Soria;207;Villar del Ala;45;19;26
42;Soria;208;Villar del Campo;55;28;27
42;Soria;209;Villar del Río;223;111;112
42;Soria;211;Villares de Soria (Los);116;56;60
42;Soria;212;Villasayas;134;77;57
42;Soria;213;Villaseca de Arciel;59;32;27
42;Soria;215;Vinuesa;1185;623;562
42;Soria;216;Vizmanos;49;31;18
42;Soria;217;Vozmediano;71;36;35
42;Soria;218;Yanguas;95;48;47
42;Soria;219;Yelo;107;53;54
43;Tarragona;001;Aiguamúrcia;590;312;278
43;Tarragona;002;Albinyana;676;351;325
43;Tarragona;003;Albiol (L');103;55;48
43;Tarragona;004;Alcanar;8030;3933;4097
43;Tarragona;005;Alcover;3516;1757;1759
43;Tarragona;904;Aldea (L');3552;1902;1650
43;Tarragona;006;Aldover;848;404;444
43;Tarragona;007;Aleixar (L');626;311;315
43;Tarragona;008;Alfara de Carles;424;219;205
43;Tarragona;009;Alforja;1086;535;551
43;Tarragona;010;Alió;346;176;170
43;Tarragona;011;Almoster;401;203;198
43;Tarragona;012;Altafulla;1724;867;857
43;Tarragona;013;Ametlla de Mar (L');4295;2161;2134
43;Tarragona;906;Ampolla (L');"";"";""
43;Tarragona;014;Amposta;15637;7789;7848
43;Tarragona;016;Arboç (L');3751;1889;1862
43;Tarragona;015;Arbolí;143;74;69
43;Tarragona;017;Argentera (L');154;74;80
43;Tarragona;018;Arnes;550;281;269
43;Tarragona;019;Ascó;1802;909;893
43;Tarragona;020;Banyeres del Penedès;1597;836;761
43;Tarragona;021;Barberà de la Conca;444;224;220
43;Tarragona;022;Batea;2031;1028;1003
43;Tarragona;023;Bellmunt del Priorat;327;160;167
43;Tarragona;024;Bellvei;912;477;435
43;Tarragona;025;Benifallet;1012;501;511
43;Tarragona;026;Benissanet;1069;507;562
43;Tarragona;027;Bisbal de Falset (La);308;158;150
43;Tarragona;028;Bisbal del Penedès (La);1316;669;647
43;Tarragona;029;Blancafort;433;207;226
43;Tarragona;030;Bonastre;275;139;136
43;Tarragona;031;Borges del Camp (Les);1381;685;696
43;Tarragona;032;Bot;953;479;474
43;Tarragona;033;Botarell;454;226;228
43;Tarragona;034;Bràfim;589;278;311
43;Tarragona;035;Cabacés;353;180;173
43;Tarragona;036;Cabra del Camp;417;219;198
43;Tarragona;037;Calafell;7075;3543;3532
43;Tarragona;903;Camarles;2911;1468;1443
43;Tarragona;038;Cambrils;14739;7401;7338
43;Tarragona;039;Capafonts;103;51;52
43;Tarragona;040;Capçanes;426;194;232
43;Tarragona;041;Caseres;338;168;170
43;Tarragona;042;Castellvell del Camp;766;381;385
43;Tarragona;043;Catllar (El);982;505;477
43;Tarragona;045;Colldejou;188;97;91
43;Tarragona;046;Conesa;131;59;72
43;Tarragona;047;Constantí;5615;2907;2708
43;Tarragona;048;Corbera d'Ebre;1140;590;550
43;Tarragona;049;Cornudella de Montsant;925;469;456
43;Tarragona;050;Creixell;812;400;412
43;Tarragona;051;Cunit;2248;1117;1131
43;Tarragona;901;Deltebre;10299;5194;5105
43;Tarragona;053;Duesaigües;209;113;96
43;Tarragona;054;Espluga de Francolí (L');3662;1789;1873
43;Tarragona;055;Falset;2603;1269;1334
43;Tarragona;056;Fatarella (La);1414;715;699
43;Tarragona;057;Febró (La);44;23;21
43;Tarragona;058;Figuera (La);137;65;72
43;Tarragona;059;Figuerola del Camp;232;114;118
43;Tarragona;060;Flix;4999;2514;2485
43;Tarragona;061;Forès;64;30;34
43;Tarragona;062;Freginals;389;189;200
43;Tarragona;063;Galera (La);782;377;405
43;Tarragona;064;Gandesa;2735;1375;1360
43;Tarragona;065;Garcia;587;286;301
43;Tarragona;066;Garidells (Els);188;93;95
43;Tarragona;067;Ginestar;922;469;453
43;Tarragona;068;Godall;786;380;406
43;Tarragona;069;Gratallops;258;124;134
43;Tarragona;070;Guiamets (Els);298;150;148
43;Tarragona;071;Horta de Sant Joan;1360;689;671
43;Tarragona;072;Lloar (El);162;82;80
43;Tarragona;073;Llorac;102;47;55
43;Tarragona;074;Llorenç del Penedès;1273;625;648
43;Tarragona;076;Marçà;616;290;326
43;Tarragona;075;Margalef;162;84;78
43;Tarragona;077;Mas de Barberans;763;374;389
43;Tarragona;078;Masdenverge;941;481;460
43;Tarragona;079;Masllorenç;385;190;195
43;Tarragona;080;Masó (La);276;130;146
43;Tarragona;081;Maspujols;379;194;185
43;Tarragona;082;Masroig (El);571;278;293
43;Tarragona;083;Milà (El);153;66;87
43;Tarragona;084;Miravet;832;433;399
43;Tarragona;085;Molar (El);345;172;173
43;Tarragona;086;Montblanc;5826;2885;2941
43;Tarragona;088;Montbrió del Camp;1428;716;712
43;Tarragona;089;Montferri;154;79;75
43;Tarragona;090;Montmell (El);239;119;120
43;Tarragona;091;Mont-ral;175;90;85
43;Tarragona;092;Mont-roig del Camp;5119;2601;2518
43;Tarragona;093;Móra d'Ebre;4286;2109;2177
43;Tarragona;094;Móra la Nova;2791;1406;1385
43;Tarragona;095;Morell (El);2262;1134;1128
43;Tarragona;096;Morera de Montsant (La);194;93;101
43;Tarragona;097;Nou de Gaià (La);367;197;170
43;Tarragona;098;Nulles;361;171;190
43;Tarragona;100;Pallaresos (Els);542;295;247
43;Tarragona;099;Palma d'Ebre (La);482;230;252
43;Tarragona;101;Passanant;206;113;93
43;Tarragona;102;Paüls;750;373;377
43;Tarragona;103;Perafort;498;262;236
43;Tarragona;104;Perelló (El);3723;1880;1843
43;Tarragona;105;Piles (Les);134;76;58
43;Tarragona;106;Pinell de Brai (El);1224;621;603
43;Tarragona;107;Pira;349;170;179
43;Tarragona;108;Pla de Santa Maria (El);1561;787;774
43;Tarragona;109;Pobla de Mafumet (La);856;416;440
43;Tarragona;110;Pobla de Massaluca (La);499;260;239
43;Tarragona;111;Pobla de Montornès (La);798;412;386
43;Tarragona;112;Poboleda;376;190;186
43;Tarragona;113;Pont d'Armentera (El);593;282;311
43;Tarragona;141;Pontils;127;62;65
43;Tarragona;114;Porrera;460;236;224
43;Tarragona;115;Pradell de la Teixeta;275;138;137
43;Tarragona;116;Prades;535;283;252
43;Tarragona;117;Prat de Comte;224;105;119
43;Tarragona;118;Pratdip;490;234;256
43;Tarragona;119;Puigpelat;438;220;218
43;Tarragona;120;Querol;219;112;107
43;Tarragona;121;Rasquera;909;472;437
43;Tarragona;122;Renau;50;28;22
43;Tarragona;123;Reus;85143;41724;43419
43;Tarragona;124;Riba (La);951;471;480
43;Tarragona;125;Riba-roja d'Ebre;1758;922;836
43;Tarragona;126;Riera de Gaià (La);947;444;503
43;Tarragona;127;Riudecanyes;578;291;287
43;Tarragona;128;Riudecols;945;491;454
43;Tarragona;129;Riudoms;4801;2390;2411
43;Tarragona;130;Rocafort de Queralt;273;144;129
43;Tarragona;131;Roda de Barà;1963;1002;961
43;Tarragona;132;Rodonyà;357;186;171
43;Tarragona;133;Roquetes;5830;2862;2968
43;Tarragona;134;Rourell (El);266;141;125
43;Tarragona;135;Salomó;453;228;225
43;Tarragona;905;Salou;"";"";""
43;Tarragona;136;Sant Carles de la Ràpita;10532;5291;5241
43;Tarragona;137;Sant Jaume dels Domenys;1180;605;575
43;Tarragona;902;Sant Jaume d'Enveja;3484;1765;1719
43;Tarragona;138;Santa Bàrbara;3342;1639;1703
43;Tarragona;139;Santa Coloma de Queralt;2581;1255;1326
43;Tarragona;140;Santa Oliva;1407;722;685
43;Tarragona;142;Sarral;1400;702;698
43;Tarragona;143;Savallà del Comtat;60;28;32
43;Tarragona;144;Secuita (La);1002;494;508
43;Tarragona;145;Selva del Camp (La);3386;1673;1713
43;Tarragona;146;Senan;28;20;8
43;Tarragona;044;Sénia (La);4781;2412;2369
43;Tarragona;147;Solivella;740;339;401
43;Tarragona;148;Tarragona;110947;54554;56393
43;Tarragona;149;Tivenys;1069;526;543
43;Tarragona;150;Tivissa;1844;903;941
43;Tarragona;151;Torre de Fontaubella (La);62;29;33
43;Tarragona;152;Torre de l'Espanyol (La);750;373;377
43;Tarragona;153;Torredembarra;6447;3197;3250
43;Tarragona;154;Torroja del Priorat;143;73;70
43;Tarragona;155;Tortosa;29600;14277;15323
43;Tarragona;156;Ulldecona;5269;2562;2707
43;Tarragona;157;Ulldemolins;563;300;263
43;Tarragona;158;Vallclara;106;54;52
43;Tarragona;159;Vallfogona de Riucorb;117;60;57
43;Tarragona;160;Vallmoll;1033;530;503
43;Tarragona;161;Valls;20177;9951;10226
43;Tarragona;162;Vandellòs i l'Hospitalet de l'Infant;4434;2256;2178
43;Tarragona;163;Vendrell (El);14734;7286;7448
43;Tarragona;164;Vespella de Gaià;82;41;41
43;Tarragona;165;Vilabella;829;394;435
43;Tarragona;175;Vilalba dels Arcs;822;434;388
43;Tarragona;166;Vilallonga del Camp;1177;577;600
43;Tarragona;168;Vilanova de Prades;160;79;81
43;Tarragona;167;Vilanova d'Escornalbou;445;220;225
43;Tarragona;169;Vilaplana;519;266;253
43;Tarragona;170;Vila-rodona;1030;537;493
43;Tarragona;171;Vila-seca;18987;9572;9415
43;Tarragona;172;Vilaverd;385;192;193
43;Tarragona;173;Vilella Alta (La);146;73;73
43;Tarragona;174;Vilella Baixa (La);180;93;87
43;Tarragona;176;Vimbodí;1145;582;563
43;Tarragona;177;Vinebre;450;214;236
43;Tarragona;178;Vinyols i els Arcs;818;435;383
43;Tarragona;052;Xerta;1257;604;653
44;Teruel;001;Ababuj;95;56;39
44;Teruel;002;Abejuela;82;42;40
44;Teruel;003;Aguatón;40;20;20
44;Teruel;004;Aguaviva;650;328;322
44;Teruel;005;Aguilar del Alfambra;109;53;56
44;Teruel;006;Alacón;526;270;256
44;Teruel;007;Alba;358;181;177
44;Teruel;008;Albalate del Arzobispo;2648;1280;1368
44;Teruel;009;Albarracín;1079;535;544
44;Teruel;010;Albentosa;315;157;158
44;Teruel;011;Alcaine;45;25;20
44;Teruel;012;Alcalá de la Selva;491;257;234
44;Teruel;013;Alcañiz;12455;6097;6358
44;Teruel;014;Alcorisa;3222;1616;1606
44;Teruel;016;Alfambra;832;419;413
44;Teruel;017;Aliaga;523;268;255
44;Teruel;021;Allepuz;190;102;88
44;Teruel;022;Alloza;968;472;496
44;Teruel;023;Allueva;10;6;4
44;Teruel;018;Almohaja;56;31;25
44;Teruel;019;Alobras;122;63;59
44;Teruel;020;Alpeñés;33;20;13
44;Teruel;024;Anadón;32;15;17
44;Teruel;025;Andorra;8836;4577;4259
44;Teruel;026;Arcos de las Salinas;190;101;89
44;Teruel;027;Arens de Lledó;278;127;151
44;Teruel;028;Argente;316;153;163
44;Teruel;029;Ariño;977;496;481
44;Teruel;031;Azaila;278;154;124
44;Teruel;032;Bádenas;33;16;17
44;Teruel;033;Báguena;669;322;347
44;Teruel;034;Bañón;249;129;120
44;Teruel;035;Barrachina;203;104;99
44;Teruel;036;Bea;28;18;10
44;Teruel;037;Beceite;711;373;338
44;Teruel;039;Bello;516;239;277
44;Teruel;038;Belmonte de San José;192;100;92
44;Teruel;040;Berge;286;145;141
44;Teruel;041;Bezas;72;37;35
44;Teruel;042;Blancas;266;131;135
44;Teruel;043;Blesa;183;96;87
44;Teruel;044;Bordón;157;84;73
44;Teruel;045;Bronchales;495;251;244
44;Teruel;046;Bueña;161;83;78
44;Teruel;047;Burbáguena;380;169;211
44;Teruel;048;Cabra de Mora;108;56;52
44;Teruel;049;Calaceite;1337;677;660
44;Teruel;050;Calamocha;4414;2198;2216
44;Teruel;051;Calanda;3574;1820;1754
44;Teruel;052;Calomarde;96;49;47
44;Teruel;053;Camañas;179;99;80
44;Teruel;054;Camarena de la Sierra;140;74;66
44;Teruel;055;Camarillas;147;81;66
44;Teruel;056;Caminreal;969;482;487
44;Teruel;059;Cantavieja;786;425;361
44;Teruel;060;Cañada de Benatanduz;81;48;33
44;Teruel;061;Cañada de Verich (La);121;65;56
44;Teruel;062;Cañada Vellida;71;42;29
44;Teruel;063;Cañizar del Olivar;160;82;78
44;Teruel;064;Cascante del Río;164;95;69
44;Teruel;065;Castejón de Tornos;135;66;69
44;Teruel;066;Castel de Cabra;278;139;139
44;Teruel;070;Castellar (El);114;62;52
44;Teruel;071;Castellote;968;486;482
44;Teruel;067;Castelnou;136;75;61
44;Teruel;068;Castelserás;967;507;460
44;Teruel;074;Cedrillas;582;303;279
44;Teruel;075;Celadas;503;259;244
44;Teruel;076;Cella;3120;1578;1542
44;Teruel;077;Cerollera (La);101;54;47
44;Teruel;080;Codoñera (La);386;198;188
44;Teruel;082;Corbalán;92;52;40
44;Teruel;084;Cortes de Aragón;153;74;79
44;Teruel;085;Cosa;145;79;66
44;Teruel;086;Cretas;782;384;398
44;Teruel;087;Crivillén;163;85;78
44;Teruel;088;Cuba (La);92;47;45
44;Teruel;089;Cubla;78;40;38
44;Teruel;090;Cucalón;113;59;54
44;Teruel;092;Cuervo (El);163;77;86
44;Teruel;093;Cuevas de Almudén;131;70;61
44;Teruel;094;Cuevas Labradas;231;116;115
44;Teruel;096;Ejulve;257;144;113
44;Teruel;097;Escorihuela;287;147;140
44;Teruel;099;Escucha;1290;708;582
44;Teruel;100;Estercuel;452;239;213
44;Teruel;101;Ferreruela de Huerva;112;57;55
44;Teruel;102;Fonfría;41;19;22
44;Teruel;103;Formiche Alto;231;121;110
44;Teruel;105;Fórnoles;135;62;73
44;Teruel;106;Fortanete;251;124;127
44;Teruel;107;Foz-Calanda;269;145;124
44;Teruel;108;Fresneda (La);519;266;253
44;Teruel;109;Frías de Albarracín;212;110;102
44;Teruel;110;Fuenferrada;57;28;29
44;Teruel;111;Fuentes Calientes;173;93;80
44;Teruel;112;Fuentes Claras;792;399;393
44;Teruel;113;Fuentes de Rubielos;91;49;42
44;Teruel;114;Fuentespalda;452;233;219
44;Teruel;115;Galve;163;86;77
44;Teruel;116;Gargallo;141;76;65
44;Teruel;117;Gea de Albarracín;509;255;254
44;Teruel;118;Ginebrosa (La);301;162;139
44;Teruel;119;Griegos;179;103;76
44;Teruel;120;Guadalaviar;319;163;156
44;Teruel;121;Gúdar;102;60;42
44;Teruel;122;Híjar;2115;1052;1063
44;Teruel;123;Hinojosa de Jarque;241;130;111
44;Teruel;124;Hoz de la Vieja (La);200;106;94
44;Teruel;125;Huesa del Común;196;99;97
44;Teruel;126;Iglesuela del Cid (La);539;280;259
44;Teruel;127;Jabaloyas;135;66;69
44;Teruel;128;Jarque de la Val;129;69;60
44;Teruel;129;Jatiel;69;31;38
44;Teruel;130;Jorcas;80;47;33
44;Teruel;131;Josa;57;30;27
44;Teruel;132;Lagueruela;89;48;41
44;Teruel;133;Lanzuela;50;28;22
44;Teruel;135;Libros;224;110;114
44;Teruel;136;Lidón;118;56;62
44;Teruel;137;Linares de Mora;366;203;163
44;Teruel;141;Lledó;257;128;129
44;Teruel;138;Loscos;263;139;124
44;Teruel;142;Maicas;21;8;13
44;Teruel;143;Manzanera;551;297;254
44;Teruel;144;Martín del Río;591;303;288
44;Teruel;145;Mas de las Matas;1547;776;771
44;Teruel;146;Mata de los Olmos (La);300;148;152
44;Teruel;147;Mazaleón;686;347;339
44;Teruel;148;Mezquita de Jarque;187;99;88
44;Teruel;149;Mirambel;163;83;80
44;Teruel;150;Miravete de la Sierra;62;34;28
44;Teruel;151;Molinos;406;200;206
44;Teruel;152;Monforte de Moyuela;124;67;57
44;Teruel;153;Monreal del Campo;2363;1181;1182
44;Teruel;154;Monroyo;404;201;203
44;Teruel;155;Montalbán;1976;1005;971
44;Teruel;156;Monteagudo del Castillo;99;57;42
44;Teruel;157;Monterde de Albarracín;88;38;50
44;Teruel;158;Mora de Rubielos;1354;694;660
44;Teruel;159;Moscardón;78;38;40
44;Teruel;160;Mosqueruela;767;398;369
44;Teruel;161;Muniesa;903;457;446
44;Teruel;163;Noguera de Albarracín;190;97;93
44;Teruel;164;Nogueras;33;22;11
44;Teruel;165;Nogueruelas;246;122;124
44;Teruel;167;Obón;81;38;43
44;Teruel;168;Odón;322;156;166
44;Teruel;169;Ojos Negros;845;430;415
44;Teruel;171;Olba;250;127;123
44;Teruel;172;Oliete;604;304;300
44;Teruel;173;Olmos (Los);195;107;88
44;Teruel;174;Orihuela del Tremedal;691;325;366
44;Teruel;175;Orrios;222;117;105
44;Teruel;176;Palomar de Arroyos;339;181;158
44;Teruel;177;Pancrudo;262;146;116
44;Teruel;178;Parras de Castellote (Las);123;64;59
44;Teruel;179;Peñarroya de Tastavins;606;300;306
44;Teruel;180;Peracense;104;48;56
44;Teruel;181;Peralejos;122;59;63
44;Teruel;182;Perales del Alfambra;329;183;146
44;Teruel;183;Pitarque;125;62;63
44;Teruel;184;Plou;64;30;34
44;Teruel;185;Pobo (El);194;108;86
44;Teruel;187;Portellada (La);385;204;181
44;Teruel;189;Pozondón;113;57;56
44;Teruel;190;Pozuel del Campo;156;82;74
44;Teruel;191;Puebla de Híjar (La);1312;629;683
44;Teruel;192;Puebla de Valverde (La);520;271;249
44;Teruel;193;Puertomingalvo;200;99;101
44;Teruel;194;Ráfales;282;142;140
44;Teruel;195;Rillo;202;110;92
44;Teruel;196;Riodeva;294;150;144
44;Teruel;197;Ródenas;111;58;53
44;Teruel;198;Royuela;243;138;105
44;Teruel;199;Rubiales;59;30;29
44;Teruel;200;Rubielos de la Cérida;79;40;39
44;Teruel;201;Rubielos de Mora;622;308;314
44;Teruel;203;Salcedillo;9;4;5
44;Teruel;204;Saldón;58;37;21
44;Teruel;205;Samper de Calanda;1225;593;632
44;Teruel;206;San Agustín;216;111;105
44;Teruel;207;San Martín del Río;401;195;206
44;Teruel;208;Santa Cruz de Nogueras;34;19;15
44;Teruel;209;Santa Eulalia;1547;745;802
44;Teruel;210;Sarrión;1135;590;545
44;Teruel;211;Segura de los Baños;85;46;39
44;Teruel;212;Seno;69;35;34
44;Teruel;213;Singra;133;68;65
44;Teruel;215;Terriente;211;113;98
44;Teruel;216;Teruel;28272;13730;14542
44;Teruel;217;Toril y Masegoso;52;29;23
44;Teruel;218;Tormón;61;32;29
44;Teruel;219;Tornos;320;164;156
44;Teruel;220;Torralba de los Sisones;263;132;131
44;Teruel;223;Torre de Arcas;141;67;74
44;Teruel;224;Torre de las Arcas;45;27;18
44;Teruel;225;Torre del Compte;231;106;125
44;Teruel;227;Torre los Negros;115;55;60
44;Teruel;221;Torrecilla de Alcañiz;495;254;241
44;Teruel;222;Torrecilla del Rebollar;219;115;104
44;Teruel;226;Torrelacárcel;375;189;186
44;Teruel;228;Torremocha de Jiloca;220;105;115
44;Teruel;229;Torres de Albarracín;206;106;100
44;Teruel;230;Torrevelilla;239;118;121
44;Teruel;231;Torrijas;84;44;40
44;Teruel;232;Torrijo del Campo;700;354;346
44;Teruel;234;Tramacastiel;156;73;83
44;Teruel;235;Tramacastilla;153;75;78
44;Teruel;236;Tronchón;131;66;65
44;Teruel;237;Urrea de Gaén;730;346;384
44;Teruel;238;Utrillas;4146;2135;2011
44;Teruel;239;Valacloche;36;20;16
44;Teruel;240;Valbona;218;115;103
44;Teruel;241;Valdealgorfa;871;432;439
44;Teruel;243;Valdecuenca;38;20;18
44;Teruel;244;Valdelinares;146;80;66
44;Teruel;245;Valdeltormo;484;250;234
44;Teruel;246;Valderrobres;1862;924;938
44;Teruel;247;Valjunquera;504;248;256
44;Teruel;249;Vallecillo (El);22;12;10
44;Teruel;250;Veguillas de la Sierra;33;17;16
44;Teruel;251;Villafranca del Campo;480;248;232
44;Teruel;252;Villahermosa del Campo;101;53;48
44;Teruel;256;Villanueva del Rebollar de la Sierra;60;30;30
44;Teruel;257;Villar del Cobo;257;131;126
44;Teruel;258;Villar del Salz;153;79;74
44;Teruel;260;Villarluengo;239;119;120
44;Teruel;261;Villarquemado;1109;554;555
44;Teruel;262;Villarroya de los Pinares;230;117;113
44;Teruel;263;Villastar;388;201;187
44;Teruel;264;Villel;406;200;206
44;Teruel;265;Vinaceite;395;213;182
44;Teruel;266;Visiedo;296;156;140
44;Teruel;267;Vivel del Río Martín;167;88;79
44;Teruel;268;Zoma (La);38;20;18
45;Toledo;001;Ajofrín;2129;1093;1036
45;Toledo;002;Alameda de la Sagra;2668;1393;1275
45;Toledo;003;Albarreal de Tajo;590;292;298
45;Toledo;004;Alcabón;520;252;268
45;Toledo;005;Alcañizo;422;220;202
45;Toledo;006;Alcaudete de la Jara;1571;762;809
45;Toledo;007;Alcolea de Tajo;859;418;441
45;Toledo;008;Aldea en Cabo;225;112;113
45;Toledo;009;Aldeanueva de Barbarroya;1011;504;507
45;Toledo;010;Aldeanueva de San Bartolomé;875;428;447
45;Toledo;011;Almendral de la Cañada;472;245;227
45;Toledo;012;Almonacid de Toledo;890;429;461
45;Toledo;013;Almorox;2209;1142;1067
45;Toledo;014;Añover de Tajo;4359;2214;2145
45;Toledo;015;Arcicóllar;455;232;223
45;Toledo;016;Argés;1679;855;824
45;Toledo;017;Azután;392;208;184
45;Toledo;018;Barcience;140;72;68
45;Toledo;019;Bargas;5760;2911;2849
45;Toledo;020;Belvís de la Jara;2095;1030;1065
45;Toledo;021;Borox;1948;958;990
45;Toledo;022;Buenaventura;523;264;259
45;Toledo;023;Burguillos de Toledo;673;348;325
45;Toledo;024;Burujón;1265;671;594
45;Toledo;025;Cabañas de la Sagra;900;462;438
45;Toledo;026;Cabañas de Yepes;269;140;129
45;Toledo;027;Cabezamesada;638;319;319
45;Toledo;028;Calera y Chozas;3723;1877;1846
45;Toledo;029;Caleruela;401;199;202
45;Toledo;030;Calzada de Oropesa;727;352;375
45;Toledo;031;Camarena;1908;971;937
45;Toledo;032;Camarenilla;561;280;281
45;Toledo;033;Campillo de la Jara (El);719;365;354
45;Toledo;034;Camuñas;1811;894;917
45;Toledo;035;Cardiel de los Montes;141;66;75
45;Toledo;036;Carmena;841;419;422
45;Toledo;037;Carpio de Tajo (El);2475;1178;1297
45;Toledo;038;Carranque;944;463;481
45;Toledo;039;Carriches;312;152;160
45;Toledo;040;Casar de Escalona (El);917;462;455
45;Toledo;041;Casarrubios del Monte;1710;865;845
45;Toledo;042;Casasbuenas;270;132;138
45;Toledo;043;Castillo de Bayuela;1101;565;536
45;Toledo;045;Cazalegas;1157;581;576
45;Toledo;046;Cebolla;2578;1287;1291
45;Toledo;047;Cedillo del Condado;1014;530;484
45;Toledo;048;Cerralbos (Los);525;263;262
45;Toledo;049;Cervera de los Montes;492;255;237
45;Toledo;056;Chozas de Canales;895;445;450
45;Toledo;057;Chueca;265;132;133
45;Toledo;050;Ciruelos;352;179;173
45;Toledo;051;Cobeja;1624;813;811
45;Toledo;052;Cobisa;227;109;118
45;Toledo;053;Consuegra;10081;4938;5143
45;Toledo;054;Corral de Almaguer;6222;3080;3142
45;Toledo;055;Cuerva;1262;619;643
45;Toledo;058;Domingo Pérez;598;299;299
45;Toledo;059;Dosbarrios;2072;1068;1004
45;Toledo;060;Erustes;222;113;109
45;Toledo;061;Escalona;1736;858;878
45;Toledo;062;Escalonilla;1511;745;766
45;Toledo;063;Espinoso del Rey;696;352;344
45;Toledo;064;Esquivias;3290;1658;1632
45;Toledo;065;Estrella (La);663;346;317
45;Toledo;066;Fuensalida;6554;3284;3270
45;Toledo;067;Gálvez;3252;1645;1607
45;Toledo;068;Garciotum;180;86;94
45;Toledo;069;Gerindote;1656;833;823
45;Toledo;070;Guadamur;1595;813;782
45;Toledo;071;Guardia (La);2587;1283;1304
45;Toledo;072;Herencias (Las);874;446;428
45;Toledo;073;Herreruela de Oropesa;509;257;252
45;Toledo;074;Hinojosa de San Vicente;571;310;261
45;Toledo;075;Hontanar;114;62;52
45;Toledo;076;Hormigos;401;209;192
45;Toledo;077;Huecas;364;191;173
45;Toledo;078;Huerta de Valdecarábanos;1741;847;894
45;Toledo;079;Iglesuela (La);533;272;261
45;Toledo;080;Illán de Vacas;11;7;4
45;Toledo;081;Illescas;7591;3845;3746
45;Toledo;082;Lagartera;2062;1000;1062
45;Toledo;083;Layos;265;132;133
45;Toledo;084;Lillo;3049;1491;1558
45;Toledo;085;Lominchar;1019;531;488
45;Toledo;086;Lucillos;532;252;280
45;Toledo;087;Madridejos;10291;4986;5305
45;Toledo;088;Magán;768;386;382
45;Toledo;089;Malpica de Tajo;1836;933;903
45;Toledo;090;Manzaneque;513;253;260
45;Toledo;091;Maqueda;477;246;231
45;Toledo;092;Marjaliza;368;181;187
45;Toledo;093;Marrupe;154;79;75
45;Toledo;094;Mascaraque;529;250;279
45;Toledo;095;Mata (La);1080;530;550
45;Toledo;096;Mazarambroz;1233;605;628
45;Toledo;097;Mejorada;1214;623;591
45;Toledo;098;Menasalbas;3030;1562;1468
45;Toledo;099;Méntrida;1524;783;741
45;Toledo;100;Mesegar de Tajo;275;142;133
45;Toledo;101;Miguel Esteban;4701;2315;2386
45;Toledo;102;Mocejón;3799;1925;1874
45;Toledo;103;Mohedas de la Jara;827;416;411
45;Toledo;104;Montearagón;510;259;251
45;Toledo;105;Montesclaros;521;246;275
45;Toledo;106;Mora;9401;4554;4847
45;Toledo;107;Nambroca;1790;885;905
45;Toledo;108;Nava de Ricomalillo (La);808;420;388
45;Toledo;109;Navahermosa;3767;1936;1831
45;Toledo;110;Navalcán;2630;1353;1277
45;Toledo;111;Navalmoralejo;142;66;76
45;Toledo;112;Navalmorales (Los);2917;1441;1476
45;Toledo;113;Navalucillos (Los);3269;1645;1624
45;Toledo;114;Navamorcuende;838;445;393
45;Toledo;115;Noblejas;2883;1456;1427
45;Toledo;116;Noez;952;480;472
45;Toledo;117;Nombela;903;467;436
45;Toledo;118;Novés;1466;736;730
45;Toledo;119;Numancia de la Sagra;991;507;484
45;Toledo;120;Nuño Gómez;190;92;98
45;Toledo;121;Ocaña;5556;2743;2813
45;Toledo;122;Olías del Rey;2896;1473;1423
45;Toledo;123;Ontígola;675;331;344
45;Toledo;124;Orgaz;2757;1388;1369
45;Toledo;125;Oropesa;3217;1602;1615
45;Toledo;126;Otero;208;92;116
45;Toledo;127;Palomeque;386;200;186
45;Toledo;128;Pantoja;1998;1028;970
45;Toledo;129;Paredes de Escalona;92;43;49
45;Toledo;130;Parrillas;585;295;290
45;Toledo;131;Pelahustán;462;237;225
45;Toledo;132;Pepino;621;323;298
45;Toledo;133;Polán;3003;1504;1499
45;Toledo;134;Portillo de Toledo;1863;951;912
45;Toledo;135;Puebla de Almoradiel (La);5490;2742;2748
45;Toledo;136;Puebla de Montalbán (La);6458;3233;3225
45;Toledo;137;Pueblanueva (La);2050;1042;1008
45;Toledo;138;Puente del Arzobispo (El);1665;802;863
45;Toledo;139;Puerto de San Vicente;384;188;196
45;Toledo;140;Pulgar;1202;590;612
45;Toledo;141;Quero;1545;769;776
45;Toledo;142;Quintanar de la Orden;9091;4519;4572
45;Toledo;143;Quismondo;1290;637;653
45;Toledo;144;Real de San Vicente (El);999;520;479
45;Toledo;145;Recas;2151;1114;1037
45;Toledo;146;Retamoso;205;111;94
45;Toledo;147;Rielves;428;218;210
45;Toledo;148;Robledo del Mazo;677;346;331
45;Toledo;149;Romeral (El);1104;531;573
45;Toledo;150;San Bartolomé de las Abiertas;562;282;280
45;Toledo;151;San Martín de Montalbán;826;412;414
45;Toledo;152;San Martín de Pusa;834;441;393
45;Toledo;153;San Pablo de los Montes;2023;1024;999
45;Toledo;154;San Román de los Montes;421;207;214
45;Toledo;155;Santa Ana de Pusa;457;237;220
45;Toledo;156;Santa Cruz de la Zarza;4323;2172;2151
45;Toledo;157;Santa Cruz del Retamar;1442;717;725
45;Toledo;158;Santa Olalla;2258;1123;1135
45;Toledo;901;Santo Domingo-Caudilla;841;405;436
45;Toledo;159;Sartajada;154;83;71
45;Toledo;160;Segurilla;1040;506;534
45;Toledo;161;Seseña;2647;1351;1296
45;Toledo;162;Sevilleja de la Jara;1347;690;657
45;Toledo;163;Sonseca;8410;4185;4225
45;Toledo;164;Sotillo de las Palomas;222;116;106
45;Toledo;165;Talavera de la Reina;68640;33734;34906
45;Toledo;166;Tembleque;2218;1096;1122
45;Toledo;167;Toboso (El);2306;1124;1182
45;Toledo;168;Toledo;60242;29310;30932
45;Toledo;169;Torralba de Oropesa;329;151;178
45;Toledo;171;Torre de Esteban Hambrán (La);1299;674;625
45;Toledo;170;Torrecilla de la Jara;339;181;158
45;Toledo;172;Torrico;1051;537;514
45;Toledo;173;Torrijos;9063;4458;4605
45;Toledo;174;Totanés;367;183;184
45;Toledo;175;Turleque;1193;591;602
45;Toledo;176;Ugena;383;200;183
45;Toledo;177;Urda;3263;1608;1655
45;Toledo;179;Valdeverdeja;1023;480;543
45;Toledo;180;Valmojado;2218;1137;1081
45;Toledo;181;Velada;2308;1186;1122
45;Toledo;182;Ventas con Peña Aguilera (Las);1474;744;730
45;Toledo;183;Ventas de Retamosa (Las);522;265;257
45;Toledo;184;Ventas de San Julián (Las);235;111;124
45;Toledo;186;Villa de Don Fadrique (La);4243;2049;2194
45;Toledo;185;Villacañas;8640;4294;4346
45;Toledo;187;Villafranca de los Caballeros;5508;2694;2814
45;Toledo;188;Villaluenga de la Sagra;2533;1264;1269
45;Toledo;189;Villamiel de Toledo;265;129;136
45;Toledo;190;Villaminaya;726;364;362
45;Toledo;191;Villamuelas;766;390;376
45;Toledo;192;Villanueva de Alcardete;3289;1646;1643
45;Toledo;193;Villanueva de Bogas;896;463;433
45;Toledo;194;Villarejo de Montalbán;118;56;62
45;Toledo;195;Villarrubia de Santiago;3054;1501;1553
45;Toledo;196;Villaseca de la Sagra;1604;802;802
45;Toledo;197;Villasequilla;2358;1204;1154
45;Toledo;198;Villatobas;2496;1250;1246
45;Toledo;199;Viso de San Juan (El);457;235;222
45;Toledo;200;Yébenes (Los);6488;3274;3214
45;Toledo;201;Yeles;976;486;490
45;Toledo;202;Yepes;4390;2196;2194
45;Toledo;203;Yuncler;1782;905;877
45;Toledo;204;Yunclillos;553;283;270
45;Toledo;205;Yuncos;2676;1377;1299
46;Valencia/València;001;Ademuz;1422;707;715
46;Valencia/València;002;Ador;1167;589;578
46;Valencia/València;004;Agullent;2077;1003;1074
46;Valencia/València;042;Aielo de Malferit;3854;1902;1952
46;Valencia/València;043;Aielo de Rugat;206;104;102
46;Valencia/València;005;Alaquàs;24530;12170;12360
46;Valencia/València;006;Albaida;5955;2942;3013
46;Valencia/València;007;Albal;8941;4501;4440
46;Valencia/València;008;Albalat de la Ribera;3607;1773;1834
46;Valencia/València;009;Albalat dels Sorells;3582;1767;1815
46;Valencia/València;010;Albalat dels Tarongers;573;281;292
46;Valencia/València;011;Alberic;9050;4464;4586
46;Valencia/València;012;Alborache;866;429;437
46;Valencia/València;013;Alboraya;11671;5709;5962
46;Valencia/València;014;Albuixech;2946;1460;1486
46;Valencia/València;016;Alcàntera de Xúquer;1539;763;776
46;Valencia/València;015;Alcàsser;7238;3639;3599
46;Valencia/València;018;Alcublas;920;473;447
46;Valencia/València;020;Alcúdia de Crespins (L');4277;2122;2155
46;Valencia/València;019;Alcúdia (L');10286;5049;5237
46;Valencia/València;021;Aldaia;22157;11070;11087
46;Valencia/València;022;Alfafar;20037;9912;10125
46;Valencia/València;024;Alfara de Algimia;551;268;283
46;Valencia/València;025;Alfara del Patriarca;2825;1415;1410
46;Valencia/València;026;Alfarp;1334;647;687
46;Valencia/València;027;Alfarrasí;1293;644;649
46;Valencia/València;023;Alfauir;305;149;156
46;Valencia/València;028;Algar de Palancia;397;185;212
46;Valencia/València;029;Algemesí;25173;12362;12811
46;Valencia/València;030;Algimia de Alfara;867;429;438
46;Valencia/València;031;Alginet;12056;6008;6048
46;Valencia/València;032;Almàssera;5615;2719;2896
46;Valencia/València;033;Almiserà;221;108;113
46;Valencia/València;034;Almoines;1913;958;955
46;Valencia/València;035;Almussafes;6166;3073;3093
46;Valencia/València;036;Alpuente;1242;657;585
46;Valencia/València;037;Alquería de la Condesa/Alqueria de la Comtessa (l');1622;779;843
46;Valencia/València;017;Alzira;40686;19805;20881
46;Valencia/València;038;Andilla;201;110;91
46;Valencia/València;039;Anna;2619;1307;1312
46;Valencia/València;040;Antella;1662;826;836
46;Valencia/València;041;Aras de los Olmos;489;263;226
46;Valencia/València;003;Atzeneta d'Albaida;1258;642;616
46;Valencia/València;044;Ayora;5733;2981;2752
46;Valencia/València;046;Barx;955;469;486
46;Valencia/València;045;Barxeta;1631;814;817
46;Valencia/València;047;Bèlgida;689;332;357
46;Valencia/València;048;Bellreguard;3875;1908;1967
46;Valencia/València;049;Bellús;414;207;207
46;Valencia/València;050;Benagéber;152;81;71
46;Valencia/València;051;Benaguasil;9112;4581;4531
46;Valencia/València;052;Benavites;668;323;345
46;Valencia/València;053;Beneixida;594;283;311
46;Valencia/València;054;Benetússer;14101;6966;7135
46;Valencia/València;055;Beniarjó;1259;621;638
46;Valencia/València;056;Beniatjar;260;129;131
46;Valencia/València;057;Benicolet;490;251;239
46;Valencia/València;060;Benifaió;12229;6050;6179
46;Valencia/València;059;Benifairó de la Valldigna;1645;812;833
46;Valencia/València;058;Benifairó de les Valls;1986;999;987
46;Valencia/València;061;Beniflá;175;79;96
46;Valencia/València;062;Benigánim;5362;2706;2656
46;Valencia/València;063;Benimodo;1698;865;833
46;Valencia/València;064;Benimuslem;556;268;288
46;Valencia/València;065;Beniparrell;1434;708;726
46;Valencia/València;066;Benirredrà;897;422;475
46;Valencia/València;067;Benisanó;1728;864;864
46;Valencia/València;068;Benissoda;302;167;135
46;Valencia/València;069;Benisuera;220;103;117
46;Valencia/València;070;Bétera;9263;4606;4657
46;Valencia/València;071;Bicorp;749;374;375
46;Valencia/València;072;Bocairent;4801;2344;2457
46;Valencia/València;073;Bolbaite;1411;719;692
46;Valencia/València;074;Bonrepòs i Mirambell;2296;1132;1164
46;Valencia/València;075;Bufali;224;117;107
46;Valencia/València;076;Bugarra;887;446;441
46;Valencia/València;077;Buñol;9576;4758;4818
46;Valencia/València;078;Burjassot;35123;17173;17950
46;Valencia/València;079;Calles;466;246;220
46;Valencia/València;080;Camporrobles;1584;782;802
46;Valencia/València;081;Canals;12255;6047;6208
46;Valencia/València;082;Canet d'En Berenguer;1488;730;758
46;Valencia/València;083;Carcaixent;20760;10093;10667
46;Valencia/València;084;Càrcer;2065;1006;1059
46;Valencia/València;085;Carlet;14287;7021;7266
46;Valencia/València;086;Carrícola;69;31;38
46;Valencia/València;087;Casas Altas;206;99;107
46;Valencia/València;088;Casas Bajas;390;193;197
46;Valencia/València;089;Casinos;2249;1149;1100
46;Valencia/València;090;Castelló de Rugat;2117;1086;1031
46;Valencia/València;091;Castellonet de la Conquesta;83;44;39
46;Valencia/València;092;Castielfabib;741;389;352
46;Valencia/València;093;Catadau;2205;1115;1090
46;Valencia/València;094;Catarroja;20912;10299;10613
46;Valencia/València;095;Caudete de las Fuentes;997;502;495
46;Valencia/València;096;Cerdà;264;131;133
46;Valencia/València;107;Chella;2617;1308;1309
46;Valencia/València;106;Chelva;2291;1176;1115
46;Valencia/València;108;Chera;630;323;307
46;Valencia/València;109;Cheste;6873;3443;3430
46;Valencia/València;111;Chiva;7454;3717;3737
46;Valencia/València;112;Chulilla;683;342;341
46;Valencia/València;097;Cofrentes;960;497;463
46;Valencia/València;098;Corbera;3244;1589;1655
46;Valencia/València;099;Cortes de Pallás;870;470;400
46;Valencia/València;100;Cotes;390;180;210
46;Valencia/València;105;Cullera;20784;10248;10536
46;Valencia/València;113;Daimús;1218;605;613
46;Valencia/València;114;Domeño;384;198;186
46;Valencia/València;115;Dos Aguas;474;262;212
46;Valencia/València;116;Eliana (L');7319;3648;3671
46;Valencia/València;117;Emperador;173;83;90
46;Valencia/València;118;Enguera;5169;2566;2603
46;Valencia/València;119;Ènova (L');1212;597;615
46;Valencia/València;120;Estivella;1121;523;598
46;Valencia/València;121;Estubeny;169;79;90
46;Valencia/València;122;Faura;2765;1389;1376
46;Valencia/València;123;Favara;1758;856;902
46;Valencia/València;126;Foios;5413;2619;2794
46;Valencia/València;128;Font de la Figuera (La);2241;1102;1139
46;Valencia/València;127;Font d'En Carròs (La);3315;1659;1656
46;Valencia/València;124;Fontanars dels Alforins;1005;538;467
46;Valencia/València;125;Fortaleny;1040;519;521
46;Valencia/València;129;Fuenterrobles;808;411;397
46;Valencia/València;131;Gandia;53757;26381;27376
46;Valencia/València;130;Gavarda;1279;642;637
46;Valencia/València;132;Genovés;2175;1085;1090
46;Valencia/València;133;Gestalgar;610;302;308
46;Valencia/València;134;Gilet;1161;571;590
46;Valencia/València;135;Godella;9052;4445;4607
46;Valencia/València;136;Godelleta;1960;966;994
46;Valencia/València;137;Granja de la Costera (La);390;187;203
46;Valencia/València;138;Guadasequies;376;191;185
46;Valencia/València;139;Guadassuar;5525;2791;2734
46;Valencia/València;140;Guardamar de la Safor;65;34;31
46;Valencia/València;141;Higueruelas;591;310;281
46;Valencia/València;142;Jalance;1320;673;647
46;Valencia/València;144;Jarafuel;1150;596;554
46;Valencia/València;154;Llanera de Ranes;960;483;477
46;Valencia/València;155;Llaurí;1512;742;770
46;Valencia/València;147;Llíria;13773;6757;7016
46;Valencia/València;153;Llocnou de Sant Jeroni;581;276;305
46;Valencia/València;151;Llocnou d'En Fenollet;662;318;344
46;Valencia/València;156;Llombai;2214;1101;1113
46;Valencia/València;157;Llosa de Ranes (La);3584;1831;1753
46;Valencia/València;150;Llutxent;2430;1252;1178
46;Valencia/València;148;Loriguilla;1168;599;569
46;Valencia/València;149;Losa del Obispo;505;240;265
46;Valencia/València;152;Lugar Nuevo de la Corona;115;60;55
46;Valencia/València;158;Macastre;878;430;448
46;Valencia/València;159;Manises;25690;12630;13060
46;Valencia/València;160;Manuel;2497;1209;1288
46;Valencia/València;161;Marines;1174;584;590
46;Valencia/València;162;Masalavés;1528;772;756
46;Valencia/València;163;Massalfassar;1480;726;754
46;Valencia/València;164;Massamagrell;12158;6070;6088
46;Valencia/València;165;Massanassa;8067;3988;4079
46;Valencia/València;166;Meliana;9089;4480;4609
46;Valencia/València;167;Millares;801;399;402
46;Valencia/València;168;Miramar;940;462;478
46;Valencia/València;169;Mislata;37413;18400;19013
46;Valencia/València;170;Mogente/Moixent;4170;2153;2017
46;Valencia/València;171;Moncada;18084;8969;9115
46;Valencia/València;172;Monserrat;2483;1260;1223
46;Valencia/València;173;Montaverner;1727;876;851
46;Valencia/València;174;Montesa;1245;630;615
46;Valencia/València;175;Montichelvo;673;340;333
46;Valencia/València;176;Montroy;1481;752;729
46;Valencia/València;177;Museros;4084;2024;2060
46;Valencia/València;178;Náquera;1693;845;848
46;Valencia/València;179;Navarrés;2808;1406;1402
46;Valencia/València;180;Novelé/Novetlè;593;293;300
46;Valencia/València;181;Oliva;20570;10214;10356
46;Valencia/València;183;Olleria (L');6851;3465;3386
46;Valencia/València;182;Olocau;605;310;295
46;Valencia/València;184;Ontinyent;29922;14761;15161
46;Valencia/València;185;Otos;560;277;283
46;Valencia/València;186;Paiporta;15467;7662;7805
46;Valencia/València;187;Palma de Gandía;1520;750;770
46;Valencia/València;188;Palmera;490;232;258
46;Valencia/València;189;Palomar (El);501;241;260
46;Valencia/València;190;Paterna;42856;21279;21577
46;Valencia/València;191;Pedralba;2103;1068;1035
46;Valencia/València;192;Petrés;650;305;345
46;Valencia/València;193;Picanya;7532;3779;3753
46;Valencia/València;194;Picassent;14663;7378;7285
46;Valencia/València;195;Piles;2036;974;1062
46;Valencia/València;196;Pinet;268;152;116
46;Valencia/València;199;Pobla de Farnals (La);4511;2215;2296
46;Valencia/València;202;Pobla de Vallbona (La);7844;4061;3783
46;Valencia/València;200;Pobla del Duc (La);2647;1310;1337
46;Valencia/València;203;Pobla Llarga (La);4504;2191;2313
46;Valencia/València;197;Polinyà de Xúquer;3055;1506;1549
46;Valencia/València;198;Potríes;943;458;485
46;Valencia/València;205;Puçol;12396;6110;6286
46;Valencia/València;201;Puebla de San Miguel;45;23;22
46;Valencia/València;204;Puig;6260;3114;3146
46;Valencia/València;101;Quart de les Valls;1104;520;584
46;Valencia/València;102;Quart de Poblet;27496;13623;13873
46;Valencia/València;103;Quartell;1350;669;681
46;Valencia/València;104;Quatretonda;2637;1344;1293
46;Valencia/València;206;Quesa;859;436;423
46;Valencia/València;207;Rafelbuñol/Rafelbunyol;4891;2434;2457
46;Valencia/València;208;Rafelcofer;1433;677;756
46;Valencia/València;209;Rafelguaraf;2416;1200;1216
46;Valencia/València;210;Ráfol de Salem;405;186;219
46;Valencia/València;211;Real de Gandía;1930;890;1040
46;Valencia/València;212;Real de Montroi;1845;950;895
46;Valencia/València;213;Requena;18465;9265;9200
46;Valencia/València;214;Riba-roja de Túria;9693;4813;4880
46;Valencia/València;215;Riola;1707;863;844
46;Valencia/València;216;Rocafort;3544;1741;1803
46;Valencia/València;217;Rotglá y Corberá;1040;515;525
46;Valencia/València;218;Rótova;1393;701;692
46;Valencia/València;219;Rugat;195;97;98
46;Valencia/València;220;Sagunto/Sagunt;57300;28150;29150
46;Valencia/València;221;Salem;504;252;252
46;Valencia/València;222;San Juan de Énova;388;185;203
46;Valencia/València;223;Sedaví;8487;4175;4312
46;Valencia/València;224;Segart;157;71;86
46;Valencia/València;225;Sellent;511;265;246
46;Valencia/València;226;Sempere;49;22;27
46;Valencia/València;227;Senyera;831;402;429
46;Valencia/València;228;Serra;1399;688;711
46;Valencia/València;229;Siete Aguas;1210;581;629
46;Valencia/València;230;Silla;16209;8224;7985
46;Valencia/València;231;Simat de la Valldigna;3252;1661;1591
46;Valencia/València;232;Sinarcas;1365;702;663
46;Valencia/València;233;Sollana;4456;2230;2226
46;Valencia/València;234;Sot de Chera;339;176;163
46;Valencia/València;235;Sueca;24805;12174;12631
46;Valencia/València;236;Sumacàrcer;1432;727;705
46;Valencia/València;237;Tavernes Blanques;8334;4087;4247
46;Valencia/València;238;Tavernes de la Valldigna;16357;8126;8231
46;Valencia/València;239;Teresa de Cofrentes;803;418;385
46;Valencia/València;240;Terrateig;230;117;113
46;Valencia/València;241;Titaguas;635;334;301
46;Valencia/València;242;Torrebaja;464;237;227
46;Valencia/València;243;Torrella;172;85;87
46;Valencia/València;244;Torrent;56359;28043;28316
46;Valencia/València;245;Torres Torres;396;189;207
46;Valencia/València;246;Tous;1231;612;619
46;Valencia/València;247;Tuéjar;1453;766;687
46;Valencia/València;248;Turís;4121;2125;1996
46;Valencia/València;249;Utiel;12251;6175;6076
46;Valencia/València;250;Valencia;749574;357672;391902
46;Valencia/València;251;Vallada;2916;1461;1455
46;Valencia/València;252;Vallanca;284;132;152
46;Valencia/València;253;Vallés;119;66;53
46;Valencia/València;254;Venta del Moro;1976;1006;970
46;Valencia/València;256;Vilamarxant;4927;2514;2413
46;Valencia/València;255;Villalonga;3655;1832;1823
46;Valencia/València;257;Villanueva de Castellón;7082;3449;3633
46;Valencia/València;258;Villar del Arzobispo;3372;1686;1686
46;Valencia/València;259;Villargordo del Cabriel;897;464;433
46;Valencia/València;260;Vinalesa;2335;1097;1238
46;Valencia/València;145;Xàtiva;25188;12258;12930
46;Valencia/València;143;Xeraco;4598;2285;2313
46;Valencia/València;146;Xeresa;2021;1013;1008
46;Valencia/València;110;Xirivella;25584;12772;12812
46;Valencia/València;261;Yátova;2115;1100;1015
46;Valencia/València;262;Yesa (La);322;163;159
46;Valencia/València;263;Zarra;536;270;266
47;Valladolid;001;Adalia;104;57;47
47;Valladolid;002;Aguasal;31;18;13
47;Valladolid;003;Aguilar de Campos;463;237;226
47;Valladolid;004;Alaejos;1988;1010;978
47;Valladolid;005;Alcazarén;806;430;376
47;Valladolid;006;Aldea de San Miguel;265;132;133
47;Valladolid;007;Aldeamayor de San Martín;1052;528;524
47;Valladolid;008;Almenara de Adaja;45;24;21
47;Valladolid;009;Amusquillo;220;119;101
47;Valladolid;010;Arroyo de la Encomienda;1319;667;652
47;Valladolid;011;Ataquines;1023;524;499
47;Valladolid;012;Bahabón;285;143;142
47;Valladolid;013;Barcial de la Loma;199;101;98
47;Valladolid;014;Barruelo del Valle;91;44;47
47;Valladolid;015;Becilla de Valderaduey;532;260;272
47;Valladolid;016;Benafarces;105;49;56
47;Valladolid;017;Bercero;305;157;148
47;Valladolid;018;Berceruelo;38;21;17
47;Valladolid;019;Berrueces;146;80;66
47;Valladolid;020;Bobadilla del Campo;482;249;233
47;Valladolid;021;Bocigas;119;64;55
47;Valladolid;022;Bocos de Duero;97;41;56
47;Valladolid;023;Boecillo;785;390;395
47;Valladolid;024;Bolaños de Campos;450;225;225
47;Valladolid;025;Brahojos de Medina;230;132;98
47;Valladolid;026;Bustillo de Chaves;137;64;73
47;Valladolid;027;Cabezón de Pisuerga;1525;769;756
47;Valladolid;028;Cabezón de Valderaduey;61;30;31
47;Valladolid;029;Cabreros del Monte;142;68;74
47;Valladolid;030;Campaspero;1814;934;880
47;Valladolid;031;Campillo (El);265;148;117
47;Valladolid;032;Camporredondo;247;131;116
47;Valladolid;033;Canalejas de Peñafiel;378;197;181
47;Valladolid;034;Canillas de Esgueva;174;92;82
47;Valladolid;035;Carpio;1346;708;638
47;Valladolid;036;Casasola de Arión;449;235;214
47;Valladolid;037;Castrejón de Trabancos;311;174;137
47;Valladolid;038;Castrillo de Duero;277;142;135
47;Valladolid;039;Castrillo-Tejeriego;341;176;165
47;Valladolid;040;Castrobol;126;52;74
47;Valladolid;041;Castrodeza;280;145;135
47;Valladolid;042;Castromembibre;113;56;57
47;Valladolid;043;Castromonte;547;283;264
47;Valladolid;044;Castronuevo de Esgueva;293;156;137
47;Valladolid;045;Castronuño;1308;679;629
47;Valladolid;046;Castroponce;246;125;121
47;Valladolid;047;Castroverde de Cerrato;354;189;165
47;Valladolid;048;Ceinos de Campos;308;165;143
47;Valladolid;049;Cervillego de la Cruz;218;104;114
47;Valladolid;050;Cigales;1679;804;875
47;Valladolid;051;Ciguñuela;351;176;175
47;Valladolid;052;Cistérniga;1331;679;652
47;Valladolid;053;Cogeces de Íscar;168;87;81
47;Valladolid;054;Cogeces del Monte;1080;566;514
47;Valladolid;055;Corcos;262;137;125
47;Valladolid;056;Corrales de Duero;181;100;81
47;Valladolid;057;Cubillas de Santa Marta;295;144;151
47;Valladolid;058;Cuenca de Campos;359;179;180
47;Valladolid;059;Curiel de Duero;195;108;87
47;Valladolid;060;Encinas de Esgueva;461;237;224
47;Valladolid;061;Esguevillas de Esgueva;503;263;240
47;Valladolid;062;Fombellida;347;187;160
47;Valladolid;063;Fompedraza;160;92;68
47;Valladolid;064;Fontihoyuelo;64;33;31
47;Valladolid;065;Fresno el Viejo;1493;752;741
47;Valladolid;066;Fuensaldaña;644;332;312
47;Valladolid;067;Fuente el Sol;389;200;189
47;Valladolid;068;Fuente-Olmedo;90;42;48
47;Valladolid;069;Gallegos de Hornija;159;80;79
47;Valladolid;070;Gatón de Campos;77;41;36
47;Valladolid;071;Geria;421;234;187
47;Valladolid;073;Herrín de Campos;251;124;127
47;Valladolid;074;Hornillos de Eresma;169;89;80
47;Valladolid;075;Íscar;5895;2969;2926
47;Valladolid;076;Laguna de Duero;10506;5271;5235
47;Valladolid;077;Langayo;559;287;272
47;Valladolid;079;Llano de Olmedo;113;55;58
47;Valladolid;078;Lomoviejo;312;161;151
47;Valladolid;080;Manzanillo;62;34;28
47;Valladolid;081;Marzales;83;41;42
47;Valladolid;082;Matapozuelos;961;496;465
47;Valladolid;083;Matilla de los Caños;92;49;43
47;Valladolid;084;Mayorga;1693;782;911
47;Valladolid;086;Medina de Rioseco;5046;2500;2546
47;Valladolid;085;Medina del Campo;19849;9799;10050
47;Valladolid;087;Megeces;510;252;258
47;Valladolid;088;Melgar de Abajo;259;117;142
47;Valladolid;089;Melgar de Arriba;360;177;183
47;Valladolid;090;Mojados;2081;1058;1023
47;Valladolid;091;Monasterio de Vega;129;59;70
47;Valladolid;092;Montealegre de Campos;187;100;87
47;Valladolid;093;Montemayor de Pililla;1185;623;562
47;Valladolid;094;Moral de la Reina;282;149;133
47;Valladolid;095;Moraleja de las Panaderas;29;18;11
47;Valladolid;096;Morales de Campos;238;121;117
47;Valladolid;097;Mota del Marqués;515;251;264
47;Valladolid;098;Mucientes;665;330;335
47;Valladolid;099;Mudarra (La);308;163;145
47;Valladolid;100;Muriel;315;152;163
47;Valladolid;101;Nava del Rey;2452;1197;1255
47;Valladolid;102;Nueva Villa de las Torres;460;242;218
47;Valladolid;103;Olivares de Duero;352;189;163
47;Valladolid;104;Olmedo;3767;1852;1915
47;Valladolid;105;Olmos de Esgueva;205;109;96
47;Valladolid;106;Olmos de Peñafiel;110;61;49
47;Valladolid;109;Palazuelo de Vedija;303;152;151
47;Valladolid;110;Parrilla (La);650;322;328
47;Valladolid;111;Pedraja de Portillo (La);1012;498;514
47;Valladolid;112;Pedrajas de San Esteban;3149;1609;1540
47;Valladolid;113;Pedrosa del Rey;305;146;159
47;Valladolid;114;Peñafiel;5251;2670;2581
47;Valladolid;115;Peñaflor de Hornija;537;284;253
47;Valladolid;116;Pesquera de Duero;638;335;303
47;Valladolid;117;Piña de Esgueva;461;244;217
47;Valladolid;118;Piñel de Abajo;306;167;139
47;Valladolid;119;Piñel de Arriba;205;102;103
47;Valladolid;121;Pollos;953;501;452
47;Valladolid;122;Portillo;2595;1310;1285
47;Valladolid;123;Pozal de Gallinas;516;262;254
47;Valladolid;124;Pozaldez;613;288;325
47;Valladolid;125;Pozuelo de la Orden;121;61;60
47;Valladolid;126;Puras;73;38;35
47;Valladolid;127;Quintanilla de Arriba;284;154;130
47;Valladolid;129;Quintanilla de Onésimo;1173;630;543
47;Valladolid;130;Quintanilla de Trigueros;109;57;52
47;Valladolid;128;Quintanilla del Molar;101;49;52
47;Valladolid;131;Rábano;306;163;143
47;Valladolid;132;Ramiro;120;62;58
47;Valladolid;133;Renedo de Esgueva;796;427;369
47;Valladolid;134;Roales de Campos;329;175;154
47;Valladolid;135;Robladillo;111;56;55
47;Valladolid;137;Roturas;45;26;19
47;Valladolid;138;Rubí de Bracamonte;393;206;187
47;Valladolid;139;Rueda;1666;848;818
47;Valladolid;140;Saelices de Mayorga;285;146;139
47;Valladolid;141;Salvador de Zapardiel;247;125;122
47;Valladolid;142;San Cebrián de Mazote;291;156;135
47;Valladolid;143;San Llorente;244;123;121
47;Valladolid;144;San Martín de Valvení;124;70;54
47;Valladolid;145;San Miguel del Arroyo;949;491;458
47;Valladolid;146;San Miguel del Pino;250;134;116
47;Valladolid;147;San Pablo de la Moraleja;204;109;95
47;Valladolid;148;San Pedro de Latarce;766;417;349
47;Valladolid;149;San Pelayo;48;21;27
47;Valladolid;150;San Román de Hornija;571;286;285
47;Valladolid;151;San Salvador;53;28;25
47;Valladolid;156;San Vicente del Palacio;330;171;159
47;Valladolid;152;Santa Eufemia del Arroyo;155;78;77
47;Valladolid;153;Santervás de Campos;218;117;101
47;Valladolid;154;Santibáñez de Valcorba;223;115;108
47;Valladolid;155;Santovenia de Pisuerga;1035;540;495
47;Valladolid;157;Sardón de Duero;635;321;314
47;Valladolid;158;Seca (La);1060;559;501
47;Valladolid;159;Serrada;1043;544;499
47;Valladolid;160;Siete Iglesias de Trabancos;743;375;368
47;Valladolid;161;Simancas;1834;941;893
47;Valladolid;162;Tamariz de Campos;107;51;56
47;Valladolid;163;Tiedra;461;223;238
47;Valladolid;164;Tordehumos;630;325;305
47;Valladolid;165;Tordesillas;7468;3774;3694
47;Valladolid;169;Torre de Esgueva;141;73;68
47;Valladolid;170;Torre de Peñafiel;76;39;37
47;Valladolid;166;Torrecilla de la Abadesa;414;220;194
47;Valladolid;167;Torrecilla de la Orden;463;229;234
47;Valladolid;168;Torrecilla de la Torre;48;28;20
47;Valladolid;171;Torrelobatón;686;335;351
47;Valladolid;172;Torrescárcela;208;106;102
47;Valladolid;173;Traspinedo;799;413;386
47;Valladolid;174;Trigueros del Valle;279;141;138
47;Valladolid;175;Tudela de Duero;4827;2449;2378
47;Valladolid;176;Unión de Campos (La);416;200;216
47;Valladolid;177;Urones de Castroponce;230;130;100
47;Valladolid;178;Urueña;265;137;128
47;Valladolid;179;Valbuena de Duero;576;303;273
47;Valladolid;180;Valdearcos de la Vega;172;88;84
47;Valladolid;181;Valdenebro de los Valles;259;138;121
47;Valladolid;182;Valdestillas;1418;731;687
47;Valladolid;183;Valdunquillo;317;155;162
47;Valladolid;186;Valladolid;333230;161632;171598
47;Valladolid;184;Valoria la Buena;665;350;315
47;Valladolid;185;Valverde de Campos;136;75;61
47;Valladolid;187;Vega de Ruiponce;222;104;118
47;Valladolid;188;Vega de Valdetronco;227;121;106
47;Valladolid;189;Velascálvaro;215;111;104
47;Valladolid;190;Velilla;161;86;75
47;Valladolid;191;Velliza;195;104;91
47;Valladolid;192;Ventosa de la Cuesta;197;105;92
47;Valladolid;193;Viana de Cega;994;509;485
47;Valladolid;195;Villabáñez;425;217;208
47;Valladolid;196;Villabaruz de Campos;58;24;34
47;Valladolid;197;Villabrágima;1343;692;651
47;Valladolid;198;Villacarralón;165;86;79
47;Valladolid;199;Villacid de Campos;144;77;67
47;Valladolid;200;Villaco;175;101;74
47;Valladolid;203;Villafrades de Campos;182;84;98
47;Valladolid;204;Villafranca de Duero;475;240;235
47;Valladolid;205;Villafrechós;600;305;295
47;Valladolid;206;Villafuerte;189;90;99
47;Valladolid;207;Villagarcía de Campos;495;256;239
47;Valladolid;208;Villagómez la Nueva;118;56;62
47;Valladolid;209;Villalán de Campos;64;32;32
47;Valladolid;210;Villalar de los Comuneros;512;260;252
47;Valladolid;211;Villalba de la Loma;57;30;27
47;Valladolid;212;Villalba de los Alcores;703;363;340
47;Valladolid;213;Villalbarba;191;94;97
47;Valladolid;214;Villalón de Campos;2209;1083;1126
47;Valladolid;215;Villamuriel de Campos;111;53;58
47;Valladolid;216;Villán de Tordesillas;179;90;89
47;Valladolid;217;Villanubla;983;511;472
47;Valladolid;218;Villanueva de Duero;849;442;407
47;Valladolid;219;Villanueva de la Condesa;55;31;24
47;Valladolid;220;Villanueva de los Caballeros;341;172;169
47;Valladolid;221;Villanueva de los Infantes;164;85;79
47;Valladolid;222;Villanueva de San Mancio;110;55;55
47;Valladolid;223;Villardefrades;351;180;171
47;Valladolid;224;Villarmentero de Esgueva;141;68;73
47;Valladolid;225;Villasexmir;150;80;70
47;Valladolid;226;Villavaquerín;248;136;112
47;Valladolid;227;Villavellid;105;52;53
47;Valladolid;228;Villaverde de Medina;681;360;321
47;Valladolid;229;Villavicencio de los Caballeros;424;197;227
47;Valladolid;194;Viloria;437;234;203
47;Valladolid;230;Wamba;405;214;191
47;Valladolid;231;Zaratán;1138;580;558
47;Valladolid;232;Zarza (La);202;103;99
48;Vizcaya;001;Abadiño;7194;3660;3534
48;Vizcaya;002;Abanto y Ciérvana-Abanto Zierbena;9626;4817;4809
48;Vizcaya;911;Ajangiz;"";789;760
48;Vizcaya;912;Alonsotegi;"";"";""
48;Vizcaya;003;Amorebieta-Etxano;15941;8057;7884
48;Vizcaya;004;Amoroto;406;215;191
48;Vizcaya;005;Arakaldo;96;57;39
48;Vizcaya;006;Arantzazu;322;158;164
48;Vizcaya;093;Areatza;1180;562;618
48;Vizcaya;009;Arrankudiaga;738;369;369
48;Vizcaya;914;Arratzu;"";"";""
48;Vizcaya;010;Arrieta;431;227;204
48;Vizcaya;011;Arrigorriaga;9622;4689;4933
48;Vizcaya;023;Artea;630;312;318
48;Vizcaya;008;Artzentales;681;376;305
48;Vizcaya;091;Atxondo;1549;789;760
48;Vizcaya;070;Aulesti;707;393;314
48;Vizcaya;012;Bakio;1262;632;630
48;Vizcaya;090;Balmaseda;7601;3724;3877
48;Vizcaya;013;Barakaldo;112551;55543;57008
48;Vizcaya;014;Barrika;759;370;389
48;Vizcaya;015;Basauri;51512;25788;25724
48;Vizcaya;092;Bedia;1122;551;571
48;Vizcaya;016;Berango;4058;2010;2048
48;Vizcaya;017;Bermeo;18300;9096;9204
48;Vizcaya;018;Berriatua;1082;578;504
48;Vizcaya;019;Berriz;4253;2150;2103
48;Vizcaya;020;Bilbao;384129;184436;199693
48;Vizcaya;021;Busturia;1792;895;897
48;Vizcaya;901;Derio;5076;2549;2527
48;Vizcaya;026;Dima;1018;531;487
48;Vizcaya;027;Durango;27444;13677;13767
48;Vizcaya;028;Ea;840;413;427
48;Vizcaya;031;Elantxobe;573;266;307
48;Vizcaya;032;Elorrio;7596;3830;3766
48;Vizcaya;902;Erandio;25309;12512;12797
48;Vizcaya;033;Ereño;295;146;149
48;Vizcaya;034;Ermua;18728;9613;9115
48;Vizcaya;079;Errigoiti;475;257;218
48;Vizcaya;029;Etxebarri, Anteiglesia de San Esteban-Etxebarri Doneztebeko Elizatea;6706;3392;3314
48;Vizcaya;030;Etxebarria;796;421;375
48;Vizcaya;906;Forua;1008;520;488
48;Vizcaya;035;Fruiz;350;185;165
48;Vizcaya;036;Galdakao;28025;14034;13991
48;Vizcaya;037;Galdames;809;426;383
48;Vizcaya;038;Gamiz-Fika;896;481;415
48;Vizcaya;039;Garay;255;133;122
48;Vizcaya;040;Gatika;865;432;433
48;Vizcaya;041;Gautegiz Arteaga;803;394;409
48;Vizcaya;046;Gernika-Lumo;16378;8035;8343
48;Vizcaya;044;Getxo;80915;39220;41695
48;Vizcaya;047;Gizaburuaga;136;71;65
48;Vizcaya;042;Gordexola;1570;792;778
48;Vizcaya;043;Gorliz;2825;1374;1451
48;Vizcaya;045;Güeñes;6172;3042;3130
48;Vizcaya;048;Ibarrangelu;555;250;305
48;Vizcaya;094;Igorre;3887;1957;1930
48;Vizcaya;049;Ispaster;617;332;285
48;Vizcaya;910;Iurreta;"";"";""
48;Vizcaya;050;Izurtza;279;139;140
48;Vizcaya;022;Karrantza Harana/Valle de Carranza;3421;1811;1610
48;Vizcaya;907;Kortezubi;403;211;192
48;Vizcaya;051;Lanestosa;322;168;154
48;Vizcaya;052;Larrabetzu;1519;752;767
48;Vizcaya;053;Laukiz;1027;521;506
48;Vizcaya;054;Leioa;24417;12120;12297
48;Vizcaya;057;Lekeitio;7688;3769;3919
48;Vizcaya;055;Lemoa;2982;1515;1467
48;Vizcaya;056;Lemoiz;804;402;402
48;Vizcaya;081;Lezama;1959;994;965
48;Vizcaya;903;Loiu;1668;857;811
48;Vizcaya;058;Mallabia;1142;596;546
48;Vizcaya;059;Mañaria;516;270;246
48;Vizcaya;060;Markina-Xemein;5053;2576;2477
48;Vizcaya;061;Maruri-Jatabe;513;255;258
48;Vizcaya;062;Mendata;379;213;166
48;Vizcaya;063;Mendexa;357;182;175
48;Vizcaya;064;Meñaka;407;217;190
48;Vizcaya;066;Morga;358;189;169
48;Vizcaya;068;Mundaka;1699;790;909
48;Vizcaya;069;Mungia;11404;5642;5762
48;Vizcaya;007;Munitibar-Arbatzegi Gerrikaitz;480;255;225
48;Vizcaya;908;Murueta;217;105;112
48;Vizcaya;071;Muskiz;6351;3196;3155
48;Vizcaya;067;Muxika;1530;803;727
48;Vizcaya;909;Nabarniz;248;121;127
48;Vizcaya;073;Ondarroa;11105;5597;5508
48;Vizcaya;075;Orozko;1983;976;1007
48;Vizcaya;083;Ortuella;9173;4530;4643
48;Vizcaya;072;Otxandio;1187;625;562
48;Vizcaya;077;Plentzia;2790;1344;1446
48;Vizcaya;078;Portugalete;57571;28523;29048
48;Vizcaya;082;Santurtzi;52049;25762;26287
48;Vizcaya;084;Sestao;37482;18388;19094
48;Vizcaya;904;Sondika;3538;1734;1804
48;Vizcaya;085;Sopelana;7669;3877;3792
48;Vizcaya;086;Sopuerta;2204;1154;1050
48;Vizcaya;076;Sukarrieta;288;140;148
48;Vizcaya;087;Trucios-Turtzioz;537;262;275
48;Vizcaya;088;Ubide;164;78;86
48;Vizcaya;065;Ugao-Miraballes;4215;2132;2083
48;Vizcaya;089;Urduliz;2487;1252;1235
48;Vizcaya;074;Urduña-Orduña;4169;2098;2071
48;Vizcaya;080;Valle de Trápaga-Trapagaran;13345;6592;6753
48;Vizcaya;095;Zaldibar;3248;1527;1721
48;Vizcaya;096;Zalla;7400;3706;3694
48;Vizcaya;905;Zamudio;3221;1628;1593
48;Vizcaya;097;Zaratamo;1630;822;808
48;Vizcaya;024;Zeanuri;1233;640;593
48;Vizcaya;025;Zeberio;973;504;469
48;Vizcaya;913;Zierbena;"";"";""
49;Zamora;002;Abezames;146;70;76
49;Zamora;003;Alcañices;1289;663;626
49;Zamora;004;Alcubilla de Nogales;273;132;141
49;Zamora;005;Alfaraz de Sayago;298;152;146
49;Zamora;006;Algodre;274;144;130
49;Zamora;007;Almaraz de Duero;540;267;273
49;Zamora;008;Almeida de Sayago;794;411;383
49;Zamora;009;Andavías;575;280;295
49;Zamora;010;Arcenillas;264;134;130
49;Zamora;011;Arcos de la Polvorosa;341;182;159
49;Zamora;012;Argañín;143;68;75
49;Zamora;013;Argujillo;469;245;224
49;Zamora;014;Arquillinos;228;115;113
49;Zamora;015;Arrabalde;496;240;256
49;Zamora;016;Aspariegos;489;226;263
49;Zamora;017;Asturianos;451;221;230
49;Zamora;018;Ayoó de Vidriales;646;321;325
49;Zamora;019;Barcial del Barco;376;203;173
49;Zamora;020;Belver de los Montes;614;319;295
49;Zamora;021;Benavente;14124;6825;7299
49;Zamora;022;Benegiles;521;276;245
49;Zamora;023;Bermillo de Sayago;1836;934;902
49;Zamora;024;Bóveda de Toro (La);1158;594;564
49;Zamora;025;Bretó;323;159;164
49;Zamora;026;Bretocino;387;207;180
49;Zamora;027;Brime de Sog;340;151;189
49;Zamora;028;Brime de Urz;204;102;102
49;Zamora;029;Burganes de Valverde;972;502;470
49;Zamora;030;Bustillo del Oro;222;98;124
49;Zamora;031;Cabañas de Sayago;269;139;130
49;Zamora;032;Calzadilla de Tera;664;320;344
49;Zamora;033;Camarzana de Tera;1293;647;646
49;Zamora;034;Cañizal;741;379;362
49;Zamora;035;Cañizo;420;202;218
49;Zamora;036;Carbajales de Alba;777;374;403
49;Zamora;037;Carbellino;307;161;146
49;Zamora;038;Casaseca de Campeán;225;118;107
49;Zamora;039;Casaseca de las Chanas;443;224;219
49;Zamora;040;Castrillo de la Guareña;192;95;97
49;Zamora;041;Castrogonzalo;623;305;318
49;Zamora;042;Castronuevo;466;242;224
49;Zamora;043;Castroverde de Campos;531;261;270
49;Zamora;044;Cazurra;130;70;60
49;Zamora;046;Cerecinos de Campos;564;292;272
49;Zamora;047;Cerecinos del Carrizal;217;113;104
49;Zamora;048;Cernadilla;233;108;125
49;Zamora;050;Cobreros;987;472;515
49;Zamora;052;Coomonte;411;202;209
49;Zamora;053;Coreses;1361;703;658
49;Zamora;054;Corrales;1528;758;770
49;Zamora;055;Cotanes del Monte;223;118;105
49;Zamora;056;Cubillos;494;263;231
49;Zamora;057;Cubo de Benavente;276;146;130
49;Zamora;058;Cubo de Tierra del Vino (El);487;261;226
49;Zamora;059;Cuelgamures;173;98;75
49;Zamora;061;Entrala;175;87;88
49;Zamora;062;Espadañedo;269;130;139
49;Zamora;063;Faramontanos de Tábara;640;326;314
49;Zamora;064;Fariza;881;434;447
49;Zamora;065;Fermoselle;2169;1056;1113
49;Zamora;066;Ferreras de Abajo;728;377;351
49;Zamora;067;Ferreras de Arriba;721;364;357
49;Zamora;068;Ferreruela;842;439;403
49;Zamora;069;Figueruela de Arriba;732;357;375
49;Zamora;071;Fonfría;1444;722;722
49;Zamora;075;Fresno de la Polvorosa;295;144;151
49;Zamora;076;Fresno de la Ribera;485;274;211
49;Zamora;077;Fresno de Sayago;423;213;210
49;Zamora;078;Friera de Valverde;371;184;187
49;Zamora;079;Fuente Encalada;225;119;106
49;Zamora;080;Fuentelapeña;1152;571;581
49;Zamora;082;Fuentes de Ropel;779;398;381
49;Zamora;081;Fuentesaúco;2076;1010;1066
49;Zamora;083;Fuentesecas;125;59;66
49;Zamora;084;Fuentespreadas;490;264;226
49;Zamora;085;Galende;1596;774;822
49;Zamora;086;Gallegos del Pan;228;114;114
49;Zamora;087;Gallegos del Río;1127;580;547
49;Zamora;088;Gamones;138;77;61
49;Zamora;090;Gema;368;181;187
49;Zamora;091;Granja de Moreruela;477;225;252
49;Zamora;092;Granucillo;371;191;180
49;Zamora;093;Guarrate;476;264;212
49;Zamora;094;Hermisende;616;300;316
49;Zamora;095;Hiniesta (La);444;221;223
49;Zamora;096;Jambrina;334;172;162
49;Zamora;097;Justel;264;134;130
49;Zamora;098;Losacino;443;235;208
49;Zamora;099;Losacio;195;104;91
49;Zamora;100;Lubián;534;255;279
49;Zamora;101;Luelmo;339;173;166
49;Zamora;102;Maderal (El);340;172;168
49;Zamora;103;Madridanos;642;348;294
49;Zamora;104;Mahide;703;353;350
49;Zamora;105;Maire de Castroponce;321;167;154
49;Zamora;107;Malva;321;155;166
49;Zamora;108;Manganeses de la Lampreana;1091;541;550
49;Zamora;109;Manganeses de la Polvorosa;1036;507;529
49;Zamora;110;Manzanal de Arriba;662;322;340
49;Zamora;112;Manzanal de los Infantes;263;127;136
49;Zamora;111;Manzanal del Barco;269;137;132
49;Zamora;113;Matilla de Arzón;384;198;186
49;Zamora;114;Matilla la Seca;104;52;52
49;Zamora;115;Mayalde;325;170;155
49;Zamora;116;Melgar de Tera;710;350;360
49;Zamora;117;Micereces de Tera;777;400;377
49;Zamora;118;Milles de la Polvorosa;327;165;162
49;Zamora;119;Molacillos;381;196;185
49;Zamora;120;Molezuelas de la Carballeda;203;103;100
49;Zamora;121;Mombuey;521;262;259
49;Zamora;122;Monfarracinos;595;318;277
49;Zamora;123;Montamarta;865;409;456
49;Zamora;124;Moral de Sayago;450;238;212
49;Zamora;126;Moraleja de Sayago;332;177;155
49;Zamora;125;Moraleja del Vino;1263;669;594
49;Zamora;128;Morales de Rey;864;437;427
49;Zamora;129;Morales de Toro;1230;604;626
49;Zamora;130;Morales de Valverde;420;204;216
49;Zamora;127;Morales del Vino;1121;589;532
49;Zamora;131;Moralina;411;213;198
49;Zamora;132;Moreruela de los Infanzones;558;296;262
49;Zamora;133;Moreruela de Tábara;660;336;324
49;Zamora;134;Muelas de los Caballeros;307;160;147
49;Zamora;135;Muelas del Pan;1011;507;504
49;Zamora;136;Muga de Sayago;559;272;287
49;Zamora;137;Navianos de Valverde;327;176;151
49;Zamora;138;Olmillos de Castro;653;341;312
49;Zamora;139;Otero de Bodas;354;180;174
49;Zamora;141;Pajares de la Lampreana;617;305;312
49;Zamora;143;Palacios de Sanabria;436;205;231
49;Zamora;142;Palacios del Pan;300;143;157
49;Zamora;145;Pedralba de la Pradería;537;272;265
49;Zamora;146;Pego (El);575;302;273
49;Zamora;147;Peleagonzalo;578;293;285
49;Zamora;148;Peleas de Abajo;229;120;109
49;Zamora;149;Peñausende;681;350;331
49;Zamora;150;Peque;311;144;167
49;Zamora;151;Perdigón (El);936;478;458
49;Zamora;152;Pereruela;951;467;484
49;Zamora;153;Perilla de Castro;407;203;204
49;Zamora;154;Pías;361;187;174
49;Zamora;155;Piedrahita de Castro;191;98;93
49;Zamora;156;Pinilla de Toro;502;241;261
49;Zamora;157;Pino del Oro;294;158;136
49;Zamora;158;Piñero (El);355;180;175
49;Zamora;160;Pobladura de Valderaduey;105;47;58
49;Zamora;159;Pobladura del Valle;424;197;227
49;Zamora;162;Porto;460;226;234
49;Zamora;163;Pozoantiguo;455;237;218
49;Zamora;164;Pozuelo de Tábara;309;156;153
49;Zamora;165;Prado;132;60;72
49;Zamora;166;Puebla de Sanabria;1774;858;916
49;Zamora;167;Pueblica de Valverde;436;221;215
49;Zamora;170;Quintanilla de Urz;171;93;78
49;Zamora;168;Quintanilla del Monte;193;99;94
49;Zamora;169;Quintanilla del Olmo;75;35;40
49;Zamora;171;Quiruelas de Vidriales;1155;572;583
49;Zamora;172;Rabanales;1108;565;543
49;Zamora;173;Rábano de Aliste;684;339;345
49;Zamora;174;Requejo;298;155;143
49;Zamora;175;Revellinos;420;223;197
49;Zamora;176;Riofrío de Aliste;1337;693;644
49;Zamora;177;Rionegro del Puente;534;249;285
49;Zamora;178;Roales;340;169;171
49;Zamora;179;Robleda-Cervantes;522;259;263
49;Zamora;180;Roelos de Sayago;213;107;106
49;Zamora;181;Rosinos de la Requejada;686;336;350
49;Zamora;183;Salce;178;95;83
49;Zamora;184;Samir de los Caños;305;155;150
49;Zamora;185;San Agustín del Pozo;250;133;117
49;Zamora;186;San Cebrián de Castro;500;241;259
49;Zamora;187;San Cristóbal de Entreviñas;1703;870;833
49;Zamora;188;San Esteban del Molar;261;135;126
49;Zamora;189;San Justo;477;230;247
49;Zamora;190;San Martín de Valderaduey;123;58;65
49;Zamora;191;San Miguel de la Ribera;509;258;251
49;Zamora;192;San Miguel del Valle;316;145;171
49;Zamora;193;San Pedro de Ceque;776;396;380
49;Zamora;194;San Pedro de la Nave-Almendra;614;305;309
49;Zamora;208;San Vicente de la Cabeza;816;415;401
49;Zamora;209;San Vitero;877;444;433
49;Zamora;197;Santa Clara de Avedillo;349;168;181
49;Zamora;199;Santa Colomba de las Monjas;379;187;192
49;Zamora;200;Santa Cristina de la Polvorosa;1347;683;664
49;Zamora;201;Santa Croya de Tera;600;299;301
49;Zamora;202;Santa Eufemia del Barco;404;207;197
49;Zamora;203;Santa María de la Vega;607;308;299
49;Zamora;204;Santa María de Valverde;144;82;62
49;Zamora;205;Santibáñez de Tera;743;385;358
49;Zamora;206;Santibáñez de Vidriales;1736;839;897
49;Zamora;207;Santovenia;586;294;292
49;Zamora;210;Sanzoles;838;417;421
49;Zamora;214;Tábara;1065;549;516
49;Zamora;216;Tapioles;284;154;130
49;Zamora;219;Toro;9621;4688;4933
49;Zamora;220;Torre del Valle (La);252;132;120
49;Zamora;221;Torregamones;433;211;222
49;Zamora;222;Torres del Carrizal;614;316;298
49;Zamora;223;Trabazos;1179;598;581
49;Zamora;224;Trefacio;249;120;129
49;Zamora;225;Uña de Quintana;320;163;157
49;Zamora;226;Vadillo de la Guareña;405;201;204
49;Zamora;227;Valcabado;331;171;160
49;Zamora;228;Valdefinjas;123;64;59
49;Zamora;229;Valdescorriel;223;105;118
49;Zamora;230;Vallesa de la Guareña;261;140;121
49;Zamora;231;Vega de Tera;689;330;359
49;Zamora;232;Vega de Villalobos;234;119;115
49;Zamora;233;Vegalatrave;203;106;97
49;Zamora;234;Venialbo;609;317;292
49;Zamora;235;Vezdemarbán;909;433;476
49;Zamora;236;Vidayanes;160;75;85
49;Zamora;237;Videmala;320;153;167
49;Zamora;238;Villabrázaro;540;273;267
49;Zamora;239;Villabuena del Puente;1220;626;594
49;Zamora;240;Villadepera;312;149;163
49;Zamora;241;Villaescusa;482;251;231
49;Zamora;242;Villafáfila;748;376;372
49;Zamora;243;Villaferrueña;221;113;108
49;Zamora;244;Villageriz;87;44;43
49;Zamora;245;Villalazán;440;224;216
49;Zamora;246;Villalba de la Lampreana;381;197;184
49;Zamora;247;Villalcampo;879;429;450
49;Zamora;248;Villalobos;417;194;223
49;Zamora;249;Villalonso;180;81;99
49;Zamora;250;Villalpando;1924;939;985
49;Zamora;251;Villalube;419;218;201
49;Zamora;252;Villamayor de Campos;796;384;412
49;Zamora;255;Villamor de los Escuderos;669;335;334
49;Zamora;256;Villanázar;471;226;245
49;Zamora;257;Villanueva de Azoague;459;235;224
49;Zamora;258;Villanueva de Campeán;225;111;114
49;Zamora;259;Villanueva de las Peras;259;126;133
49;Zamora;260;Villanueva del Campo;1309;648;661
49;Zamora;263;Villar de Fallaves;149;77;72
49;Zamora;264;Villar del Buey;1074;564;510
49;Zamora;261;Villaralbo;1487;745;742
49;Zamora;262;Villardeciervos;614;286;328
49;Zamora;265;Villardiegua de la Ribera;210;99;111
49;Zamora;266;Villárdiga;143;73;70
49;Zamora;267;Villardondiego;179;93;86
49;Zamora;268;Villarrín de Campos;761;370;391
49;Zamora;269;Villaseco del Pan;425;204;221
49;Zamora;270;Villavendimio;276;149;127
49;Zamora;272;Villaveza de Valverde;185;90;95
49;Zamora;271;Villaveza del Agua;328;176;152
49;Zamora;273;Viñas;360;182;178
49;Zamora;275;Zamora;62798;29947;32851
50;Zaragoza;001;Abanto;303;160;143
50;Zaragoza;002;Acered;361;188;173
50;Zaragoza;003;Agón;246;131;115
50;Zaragoza;004;Aguarón;785;387;398
50;Zaragoza;005;Aguilón;303;155;148
50;Zaragoza;006;Ainzón;1259;638;621
50;Zaragoza;007;Aladrén;54;25;29
50;Zaragoza;008;Alagón;5457;2723;2734
50;Zaragoza;009;Alarba;176;101;75
50;Zaragoza;010;Alberite de San Juan;115;59;56
50;Zaragoza;011;Albeta;151;71;80
50;Zaragoza;012;Alborge;131;60;71
50;Zaragoza;013;Alcalá de Ebro;368;185;183
50;Zaragoza;014;Alcalá de Moncayo;181;104;77
50;Zaragoza;015;Alconchel de Ariza;247;125;122
50;Zaragoza;016;Aldehuela de Liestos;86;45;41
50;Zaragoza;017;Alfajarín;1379;714;665
50;Zaragoza;018;Alfamén;1324;689;635
50;Zaragoza;019;Alforque;92;48;44
50;Zaragoza;020;Alhama de Aragón;1316;649;667
50;Zaragoza;021;Almochuel;60;33;27
50;Zaragoza;022;Almolda (La);768;375;393
50;Zaragoza;023;Almonacid de la Cuba;395;201;194
50;Zaragoza;024;Almonacid de la Sierra;885;460;425
50;Zaragoza;025;Almunia de Doña Godina (La);5082;2568;2514
50;Zaragoza;026;Alpartir;637;343;294
50;Zaragoza;027;Ambel;443;210;233
50;Zaragoza;028;Anento;33;20;13
50;Zaragoza;029;Aniñón;984;527;457
50;Zaragoza;030;Añón de Moncayo;359;207;152
50;Zaragoza;031;Aranda de Moncayo;280;154;126
50;Zaragoza;032;Arándiga;613;301;312
50;Zaragoza;033;Ardisa;89;42;47
50;Zaragoza;034;Ariza;1528;735;793
50;Zaragoza;035;Artieda;111;55;56
50;Zaragoza;036;Asín;122;63;59
50;Zaragoza;037;Atea;298;163;135
50;Zaragoza;038;Ateca;2206;1068;1138
50;Zaragoza;039;Azuara;868;456;412
50;Zaragoza;040;Badules;128;68;60
50;Zaragoza;041;Bagüés;14;6;8
50;Zaragoza;042;Balconchán;40;22;18
50;Zaragoza;043;Bárboles;383;201;182
50;Zaragoza;044;Bardallur;358;178;180
50;Zaragoza;045;Belchite;1744;884;860
50;Zaragoza;046;Belmonte de Gracián;380;210;170
50;Zaragoza;047;Berdejo;37;18;19
50;Zaragoza;048;Berrueco;38;23;15
50;Zaragoza;901;Biel;253;136;117
50;Zaragoza;050;Bijuesca;146;73;73
50;Zaragoza;051;Biota;1436;737;699
50;Zaragoza;052;Bisimbre;159;74;85
50;Zaragoza;053;Boquiñeni;1126;583;543
50;Zaragoza;054;Bordalba;117;62;55
50;Zaragoza;055;Borja;4091;2008;2083
50;Zaragoza;056;Botorrita;430;227;203
50;Zaragoza;057;Brea de Aragón;2094;1031;1063
50;Zaragoza;058;Bubierca;136;65;71
50;Zaragoza;059;Bujaraloz;1122;582;540
50;Zaragoza;060;Bulbuente;302;154;148
50;Zaragoza;061;Bureta;357;187;170
50;Zaragoza;062;Burgo de Ebro (El);1133;557;576
50;Zaragoza;063;Buste (El);158;79;79
50;Zaragoza;064;Cabañas de Ebro;577;291;286
50;Zaragoza;065;Cabolafuente;121;67;54
50;Zaragoza;066;Cadrete;893;458;435
50;Zaragoza;067;Calatayud;17721;8460;9261
50;Zaragoza;068;Calatorao;2836;1445;1391
50;Zaragoza;069;Calcena;100;50;50
50;Zaragoza;070;Calmarza;150;73;77
50;Zaragoza;071;Campillo de Aragón;248;136;112
50;Zaragoza;072;Carenas;276;141;135
50;Zaragoza;073;Cariñena;2932;1484;1448
50;Zaragoza;074;Caspe;8317;4122;4195
50;Zaragoza;075;Castejón de Alarba;154;88;66
50;Zaragoza;076;Castejón de las Armas;185;94;91
50;Zaragoza;077;Castejón de Valdejasa;433;234;199
50;Zaragoza;078;Castiliscar;479;240;239
50;Zaragoza;079;Cervera de la Cañada;401;201;200
50;Zaragoza;080;Cerveruela;4;2;2
50;Zaragoza;081;Cetina;865;440;425
50;Zaragoza;092;Chiprana;471;238;233
50;Zaragoza;093;Chodes;184;88;96
50;Zaragoza;082;Cimballa;149;75;74
50;Zaragoza;083;Cinco Olivas;160;81;79
50;Zaragoza;084;Clarés de Ribota;134;69;65
50;Zaragoza;085;Codo;383;194;189
50;Zaragoza;086;Codos;351;201;150
50;Zaragoza;087;Contamina;79;37;42
50;Zaragoza;088;Cosuenda;482;240;242
50;Zaragoza;089;Cuarte de Huerva;1316;681;635
50;Zaragoza;090;Cubel;295;148;147
50;Zaragoza;091;Cuerlas (Las);104;55;49
50;Zaragoza;094;Daroca;2473;1230;1243
50;Zaragoza;095;Ejea de los Caballeros;15693;7981;7712
50;Zaragoza;096;Embid de Ariza;100;53;47
50;Zaragoza;098;Encinacorba;335;178;157
50;Zaragoza;099;Épila;3762;1909;1853
50;Zaragoza;100;Erla;590;284;306
50;Zaragoza;101;Escatrón;1444;711;733
50;Zaragoza;102;Fabara;1415;744;671
50;Zaragoza;104;Farlete;488;248;240
50;Zaragoza;105;Fayón;453;227;226
50;Zaragoza;106;Fayos (Los);199;103;96
50;Zaragoza;107;Figueruelas;822;403;419
50;Zaragoza;108;Fombuena;10;7;3
50;Zaragoza;109;Frago (El);130;74;56
50;Zaragoza;110;Frasno (El);704;369;335
50;Zaragoza;111;Fréscano;304;148;156
50;Zaragoza;113;Fuendejalón;995;495;500
50;Zaragoza;114;Fuendetodos;174;96;78
50;Zaragoza;115;Fuentes de Ebro;3792;1960;1832
50;Zaragoza;116;Fuentes de Jiloca;445;232;213
50;Zaragoza;117;Gallocanta;214;113;101
50;Zaragoza;118;Gallur;3236;1630;1606
50;Zaragoza;119;Gelsa;1423;717;706
50;Zaragoza;120;Godojos;97;51;46
50;Zaragoza;121;Gotor;412;214;198
50;Zaragoza;122;Grisel;51;25;26
50;Zaragoza;123;Grisén;519;267;252
50;Zaragoza;124;Herrera de los Navarros;760;391;369
50;Zaragoza;125;Ibdes;648;340;308
50;Zaragoza;126;Illueca;3235;1587;1648
50;Zaragoza;128;Isuerre;62;35;27
50;Zaragoza;129;Jaraba;343;167;176
50;Zaragoza;130;Jarque;640;338;302
50;Zaragoza;131;Jaulín;307;153;154
50;Zaragoza;132;Joyosa (La);349;178;171
50;Zaragoza;133;Lagata;161;84;77
50;Zaragoza;134;Langa del Castillo;229;102;127
50;Zaragoza;135;Layana;199;99;100
50;Zaragoza;136;Lécera;1022;494;528
50;Zaragoza;138;Lechón;68;38;30
50;Zaragoza;137;Leciñena;1514;761;753
50;Zaragoza;139;Letux;505;260;245
50;Zaragoza;140;Litago;207;121;86
50;Zaragoza;141;Lituénigo;133;68;65
50;Zaragoza;142;Lobera de Onsella;74;47;27
50;Zaragoza;143;Longares;915;444;471
50;Zaragoza;144;Longás;29;21;8
50;Zaragoza;146;Lucena de Jalón;310;155;155
50;Zaragoza;147;Luceni;1131;561;570
50;Zaragoza;148;Luesia;488;257;231
50;Zaragoza;149;Luesma;29;15;14
50;Zaragoza;150;Lumpiaque;1079;556;523
50;Zaragoza;151;Luna;1050;548;502
50;Zaragoza;152;Maella;2265;1144;1121
50;Zaragoza;153;Magallón;1401;717;684
50;Zaragoza;154;Mainar;200;105;95
50;Zaragoza;155;Malanquilla;156;78;78
50;Zaragoza;156;Maleján;327;166;161
50;Zaragoza;160;Mallén;3021;1526;1495
50;Zaragoza;157;Malón;543;274;269
50;Zaragoza;159;Maluenda;1132;567;565
50;Zaragoza;161;Manchones;178;88;90
50;Zaragoza;162;Mara;278;143;135
50;Zaragoza;163;María de Huerva;713;354;359
50;Zaragoza;902;Marracos;"";"";""
50;Zaragoza;164;Mediana de Aragón;569;283;286
50;Zaragoza;165;Mequinenza;2804;1410;1394
50;Zaragoza;166;Mesones de Isuela;484;240;244
50;Zaragoza;167;Mezalocha;343;186;157
50;Zaragoza;168;Mianos;48;23;25
50;Zaragoza;169;Miedes de Aragón;618;315;303
50;Zaragoza;170;Monegrillo;588;320;268
50;Zaragoza;171;Moneva;94;42;52
50;Zaragoza;172;Monreal de Ariza;380;197;183
50;Zaragoza;173;Monterde;229;113;116
50;Zaragoza;174;Montón;183;90;93
50;Zaragoza;175;Morata de Jalón;1816;892;924
50;Zaragoza;176;Morata de Jiloca;424;219;205
50;Zaragoza;177;Morés;588;299;289
50;Zaragoza;178;Moros;687;350;337
50;Zaragoza;179;Moyuela;448;233;215
50;Zaragoza;180;Mozota;143;64;79
50;Zaragoza;181;Muel;1262;626;636
50;Zaragoza;182;Muela (La);961;501;460
50;Zaragoza;183;Munébrega;590;305;285
50;Zaragoza;184;Murero;174;96;78
50;Zaragoza;185;Murillo de Gállego;153;85;68
50;Zaragoza;186;Navardún;94;51;43
50;Zaragoza;187;Nigüella;144;71;73
50;Zaragoza;188;Nombrevilla;44;22;22
50;Zaragoza;189;Nonaspe;1166;588;578
50;Zaragoza;190;Novallas;847;413;434
50;Zaragoza;191;Novillas;765;393;372
50;Zaragoza;192;Nuévalos;324;178;146
50;Zaragoza;193;Nuez de Ebro;478;253;225
50;Zaragoza;194;Olvés;217;113;104
50;Zaragoza;195;Orcajo;55;25;30
50;Zaragoza;196;Orera;171;95;76
50;Zaragoza;197;Orés;143;81;62
50;Zaragoza;198;Oseja;18;9;9
50;Zaragoza;199;Osera de Ebro;347;157;190
50;Zaragoza;200;Paniza;796;387;409
50;Zaragoza;201;Paracuellos de Jiloca;555;258;297
50;Zaragoza;202;Paracuellos de la Ribera;397;192;205
50;Zaragoza;203;Pastriz;739;361;378
50;Zaragoza;204;Pedrola;2439;1241;1198
50;Zaragoza;205;Pedrosas (Las);108;54;54
50;Zaragoza;206;Perdiguera;513;265;248
50;Zaragoza;207;Piedratajada;261;128;133
50;Zaragoza;208;Pina de Ebro;2196;1095;1101
50;Zaragoza;209;Pinseque;1342;674;668
50;Zaragoza;210;Pintanos (Los);78;45;33
50;Zaragoza;211;Plasencia de Jalón;404;209;195
50;Zaragoza;212;Pleitas;87;43;44
50;Zaragoza;213;Plenas;179;86;93
50;Zaragoza;214;Pomer;27;12;15
50;Zaragoza;215;Pozuel de Ariza;36;21;15
50;Zaragoza;216;Pozuelo de Aragón;410;218;192
50;Zaragoza;217;Pradilla de Ebro;742;394;348
50;Zaragoza;218;Puebla de Albortón;181;91;90
50;Zaragoza;219;Puebla de Alfindén (La);1431;728;703
50;Zaragoza;220;Puendeluna;68;35;33
50;Zaragoza;221;Purujosa;19;16;3
50;Zaragoza;222;Quinto;2284;1146;1138
50;Zaragoza;223;Remolinos;1347;679;668
50;Zaragoza;224;Retascón;82;45;37
50;Zaragoza;225;Ricla;2244;1176;1068
50;Zaragoza;227;Romanos;173;94;79
50;Zaragoza;228;Rueda de Jalón;400;214;186
50;Zaragoza;229;Ruesca;95;50;45
50;Zaragoza;241;Sabiñán;1139;554;585
50;Zaragoza;230;Sádaba;1962;977;985
50;Zaragoza;231;Salillas de Jalón;436;219;217
50;Zaragoza;232;Salvatierra de Esca;363;195;168
50;Zaragoza;233;Samper del Salz;102;48;54
50;Zaragoza;234;San Martín de la Virgen de Moncayo;329;175;154
50;Zaragoza;235;San Mateo de Gállego;1834;948;886
50;Zaragoza;236;Santa Cruz de Grío;266;151;115
50;Zaragoza;237;Santa Cruz de Moncayo;103;55;48
50;Zaragoza;238;Santa Eulalia de Gállego;134;71;63
50;Zaragoza;239;Santed;93;44;49
50;Zaragoza;240;Sástago;1704;861;843
50;Zaragoza;242;Sediles;109;58;51
50;Zaragoza;243;Sestrica;577;296;281
50;Zaragoza;244;Sierra de Luna;321;162;159
50;Zaragoza;245;Sigüés;188;102;86
50;Zaragoza;246;Sisamón;128;72;56
50;Zaragoza;247;Sobradiel;568;267;301
50;Zaragoza;248;Sos del Rey Católico;969;491;478
50;Zaragoza;249;Tabuenca;548;283;265
50;Zaragoza;250;Talamantes;60;31;29
50;Zaragoza;251;Tarazona;10945;5262;5683
50;Zaragoza;252;Tauste;7243;3620;3623
50;Zaragoza;253;Terrer;805;379;426
50;Zaragoza;254;Tierga;320;170;150
50;Zaragoza;255;Tobed;320;158;162
50;Zaragoza;256;Torralba de los Frailes;135;68;67
50;Zaragoza;257;Torralba de Ribota;265;144;121
50;Zaragoza;258;Torralbilla;85;46;39
50;Zaragoza;259;Torrehermosa;144;73;71
50;Zaragoza;260;Torrelapaja;82;42;40
50;Zaragoza;261;Torrellas;375;184;191
50;Zaragoza;262;Torres de Berrellén;1460;746;714
50;Zaragoza;263;Torrijo de la Cañada;531;287;244
50;Zaragoza;264;Tosos;284;153;131
50;Zaragoza;265;Trasmoz;89;45;44
50;Zaragoza;266;Trasobares;326;171;155
50;Zaragoza;267;Uncastillo;925;460;465
50;Zaragoza;268;Undués de Lerda;49;25;24
50;Zaragoza;269;Urrea de Jalón;423;200;223
50;Zaragoza;270;Urriés;87;49;38
50;Zaragoza;271;Used;504;254;250
50;Zaragoza;272;Utebo;7433;3728;3705
50;Zaragoza;274;Val de San Martín;88;39;49
50;Zaragoza;273;Valdehorna;90;49;41
50;Zaragoza;275;Valmadrid;82;43;39
50;Zaragoza;276;Valpalmas;251;131;120
50;Zaragoza;277;Valtorres;146;70;76
50;Zaragoza;278;Velilla de Ebro;323;162;161
50;Zaragoza;279;Velilla de Jiloca;160;80;80
50;Zaragoza;280;Vera de Moncayo;557;279;278
50;Zaragoza;281;Vierlas;115;57;58
50;Zaragoza;283;Villadoz;112;58;54
50;Zaragoza;284;Villafeliche;278;140;138
50;Zaragoza;285;Villafranca de Ebro;694;340;354
50;Zaragoza;286;Villalba de Perejil;107;53;54
50;Zaragoza;287;Villalengua;525;279;246
50;Zaragoza;288;Villanueva de Gállego;2545;1279;1266
50;Zaragoza;290;Villanueva de Huerva;720;356;364
50;Zaragoza;289;Villanueva de Jiloca;145;78;67
50;Zaragoza;291;Villar de los Navarros;226;112;114
50;Zaragoza;292;Villarreal de Huerva;198;116;82
50;Zaragoza;293;Villarroya de la Sierra;865;434;431
50;Zaragoza;294;Villarroya del Campo;81;45;36
50;Zaragoza;282;Vilueña (La);139;66;73
50;Zaragoza;295;Vistabella;39;18;21
50;Zaragoza;296;Zaida (La);694;346;348
50;Zaragoza;297;Zaragoza;586574;283694;302880
50;Zaragoza;298;Zuera;5295;2695;2600
51;Ceuta;001;Ceuta;68014;33568;34446
52;Melilla;001;Melilla;55717;27788;27929
