01;Álava;001;Alegría-Dulantzi;994;502;492
01;Álava;002;Amurrio;9795;4879;4916
01;Álava;049;Añana;191;98;93
01;Álava;003;Aramaio;1307;678;629
01;Álava;006;Armiñón;127;67;60
01;Álava;037;Arraia-Maeztu;702;367;335
01;Álava;008;Arrazua-Ubarrundia;662;354;308
01;Álava;004;Artziniega;1232;601;631
01;Álava;009;Asparrena;1518;755;763
01;Álava;010;Ayala/Aiara;2055;1021;1034
01;Álava;011;Baños de Ebro/Mañueta;330;181;149
01;Álava;013;Barrundia;565;315;250
01;Álava;014;Berantevilla;420;217;203
01;Álava;016;Bernedo;539;304;235
01;Álava;017;Campezo/Kanpezu;1153;601;552
01;Álava;021;Elburgo/Burgelu;205;108;97
01;Álava;022;Elciego;905;446;459
01;Álava;023;Elvillar/Bilar;366;194;172
01;Álava;056;Harana/Valle de Arana;391;212;179
01;Álava;901;Iruña Oka/Iruña de Oca;1517;775;742
01;Álava;027;Iruraiz-Gauna;424;231;193
01;Álava;019;Kripan;200;102;98
01;Álava;020;Kuartango;348;197;151
01;Álava;028;Labastida;954;518;436
01;Álava;030;Lagrán;189;103;86
01;Álava;031;Laguardia;1489;764;725
01;Álava;032;Lanciego/Lantziego;640;349;291
01;Álava;902;Lantarón;805;420;385
01;Álava;033;Lapuebla de Labarca;827;416;411
01;Álava;058;Legutiano;1225;674;551
01;Álava;034;Leza;189;103;86
01;Álava;036;Llodio;20507;10329;10178
01;Álava;039;Moreda de Álava;275;150;125
01;Álava;041;Navaridas;217;113;104
01;Álava;042;Okondo;699;358;341
01;Álava;043;Oyón/Oion;2118;1058;1060
01;Álava;044;Peñacerrada-Urizaharra;220;119;101
01;Álava;046;Ribera Alta;503;300;203
01;Álava;047;Ribera Baja/Erribera Beitia;388;213;175
01;Álava;051;Salvatierra/Agurain;3741;1856;1885
01;Álava;052;Samaniego;268;135;133
01;Álava;053;San Millán/Donemiliaga;697;382;315
01;Álava;054;Urkabustaiz;842;445;397
01;Álava;055;Valdegovía;825;464;361
01;Álava;057;Villabuena de Álava/Eskuernaga;352;173;179
01;Álava;059;Vitoria-Gasteiz;210545;103937;106608
01;Álava;060;Yécora/Lekora;241;121;120
01;Álava;061;Zalduondo;120;67;53
01;Álava;062;Zambrana;327;175;152
01;Álava;018;Zigoitia;773;418;355
01;Álava;063;Zuia;1233;616;617
02;Albacete;001;Abengibre;1048;528;520
02;Albacete;002;Alatoz;787;409;378
02;Albacete;003;Albacete;132473;64783;67690
02;Albacete;004;Albatana;933;479;454
02;Albacete;005;Alborea;798;410;388
02;Albacete;006;Alcadozo;815;417;398
02;Albacete;007;Alcalá del Júcar;1668;843;825
02;Albacete;008;Alcaraz;1939;935;1004
02;Albacete;009;Almansa;22786;11178;11608
02;Albacete;010;Alpera;2309;1183;1126
02;Albacete;011;Ayna;1176;593;583
02;Albacete;012;Balazote;2221;1121;1100
02;Albacete;014;Ballestero (El);689;346;343
02;Albacete;013;Balsa de Ves;271;148;123
02;Albacete;015;Barrax;2008;1006;1002
02;Albacete;016;Bienservida;941;485;456
02;Albacete;017;Bogarra;1503;789;714
02;Albacete;018;Bonete;1297;661;636
02;Albacete;019;Bonillo (El);3334;1689;1645
02;Albacete;020;Carcelén;772;400;372
02;Albacete;021;Casas de Juan Núñez;1260;647;613
02;Albacete;022;Casas de Lázaro;512;261;251
02;Albacete;023;Casas de Ves;1025;528;497
02;Albacete;024;Casas-Ibáñez;3957;1988;1969
02;Albacete;025;Caudete;8323;4132;4191
02;Albacete;026;Cenizate;1077;551;526
02;Albacete;029;Chinchilla de Monte-Aragón;3232;1656;1576
02;Albacete;027;Corral-Rubio;482;247;235
02;Albacete;028;Cotillas;270;133;137
02;Albacete;030;Elche de la Sierra;3900;1919;1981
02;Albacete;032;Fuensanta;416;199;217
02;Albacete;033;Fuente-Álamo;2456;1237;1219
02;Albacete;034;Fuentealbilla;1862;935;927
02;Albacete;031;Férez;892;447;445
02;Albacete;035;Gineta (La);2108;1023;1085
02;Albacete;036;Golosalvo;134;68;66
02;Albacete;037;Hellín;25010;12322;12688
02;Albacete;038;Herrera (La);433;228;205
02;Albacete;039;Higueruela;1344;659;685
02;Albacete;040;Hoya-Gonzalo;746;378;368
02;Albacete;041;Jorquera;684;362;322
02;Albacete;042;Letur;1452;742;710
02;Albacete;043;Lezuza;2034;1041;993
02;Albacete;044;Liétor;1910;975;935
02;Albacete;045;Madrigueras;4498;2249;2249
02;Albacete;046;Mahora;1374;673;701
02;Albacete;047;Masegoso;160;93;67
02;Albacete;048;Minaya;1923;984;939
02;Albacete;049;Molinicos;1665;864;801
02;Albacete;050;Montalvos;159;77;82
02;Albacete;051;Montealegre del Castillo;2186;1100;1086
02;Albacete;052;Motilleja;584;297;287
02;Albacete;053;Munera;4105;2072;2033
02;Albacete;054;Navas de Jorquera;590;305;285
02;Albacete;055;Nerpio;2045;1071;974
02;Albacete;056;Ontur;2529;1256;1273
02;Albacete;057;Ossa de Montiel;2895;1445;1450
02;Albacete;058;Paterna del Madera;675;362;313
02;Albacete;060;Peñas de San Pedro;1363;711;652
02;Albacete;059;Peñascosa;480;259;221
02;Albacete;061;Pétrola;1054;534;520
02;Albacete;062;Povedilla;780;403;377
02;Albacete;064;Pozo-Lorente;541;262;279
02;Albacete;063;Pozohondo;2031;1044;987
02;Albacete;065;Pozuelo;702;344;358
02;Albacete;066;Recueja (La);402;200;202
02;Albacete;067;Riópar;1390;717;673
02;Albacete;068;Robledo;509;259;250
02;Albacete;069;Roda (La);13254;6645;6609
02;Albacete;070;Salobre;675;352;323
02;Albacete;071;San Pedro;1335;683;652
02;Albacete;072;Socovos;2131;1098;1033
02;Albacete;073;Tarazona de la Mancha;5846;2932;2914
02;Albacete;074;Tobarra;7339;3653;3686
02;Albacete;075;Valdeganga;2179;1105;1074
02;Albacete;076;Vianos;525;267;258
02;Albacete;077;Villa de Ves;54;28;26
02;Albacete;078;Villalgordo del Júcar;1300;638;662
02;Albacete;079;Villamalea;3430;1784;1646
02;Albacete;080;Villapalacios;1005;506;499
02;Albacete;081;Villarrobledo;21050;10339;10711
02;Albacete;082;Villatoya;200;107;93
02;Albacete;083;Villavaliente;320;167;153
02;Albacete;084;Villaverde de Guadalimar;656;350;306
02;Albacete;085;Viveros;649;338;311
02;Albacete;086;Yeste;4939;2537;2402
03;Alicante/Alacant;001;Adsubia;538;263;275
03;Alicante/Alacant;002;Agost;3978;2009;1969
03;Alicante/Alacant;003;Agres;676;352;324
03;Alicante/Alacant;004;Aigües;381;193;188
03;Alicante/Alacant;005;Albatera;9020;4533;4487
03;Alicante/Alacant;006;Alcalalí;824;410;414
03;Alicante/Alacant;007;Alcocer de Planes;125;57;68
03;Alicante/Alacant;008;Alcoleja;297;136;161
03;Alicante/Alacant;009;Alcoy/Alcoi;65431;31463;33968
03;Alicante/Alacant;010;Alfafara;387;185;202
03;Alicante/Alacant;011;Alfàs del Pi (L');9426;4609;4817
03;Alicante/Alacant;012;Algorfa;1084;552;532
03;Alicante/Alacant;013;Algueña;1477;723;754
03;Alicante/Alacant;014;Alicante/Alacant;266104;128081;138023
03;Alicante/Alacant;015;Almoradí;12705;6324;6381
03;Alicante/Alacant;016;Almudaina;139;68;71
03;Alicante/Alacant;017;Alquería d'Asnar (L');411;197;214
03;Alicante/Alacant;018;Altea;12671;6275;6396
03;Alicante/Alacant;019;Aspe;16039;7965;8074
03;Alicante/Alacant;020;Balones;154;63;91
03;Alicante/Alacant;021;Banyeres de Mariola;7027;3488;3539
03;Alicante/Alacant;022;Benasau;219;105;114
03;Alicante/Alacant;023;Beneixama;1834;901;933
03;Alicante/Alacant;024;Benejúzar;4716;2375;2341
03;Alicante/Alacant;025;Benferri;955;481;474
03;Alicante/Alacant;026;Beniarbeig;1201;593;608
03;Alicante/Alacant;027;Beniardá;231;110;121
03;Alicante/Alacant;028;Beniarrés;1495;753;742
03;Alicante/Alacant;030;Benidoleig;799;399;400
03;Alicante/Alacant;031;Benidorm;42856;21124;21732
03;Alicante/Alacant;032;Benifallim;169;90;79
03;Alicante/Alacant;033;Benifato;125;64;61
03;Alicante/Alacant;029;Benigembla;352;174;178
03;Alicante/Alacant;034;Benijófar;1507;718;789
03;Alicante/Alacant;035;Benilloba;959;484;475
03;Alicante/Alacant;036;Benillup;81;45;36
03;Alicante/Alacant;037;Benimantell;446;207;239
03;Alicante/Alacant;038;Benimarfull;412;187;225
03;Alicante/Alacant;039;Benimassot;118;59;59
03;Alicante/Alacant;040;Benimeli;329;165;164
03;Alicante/Alacant;041;Benissa;7985;3966;4019
03;Alicante/Alacant;042;Benitachell/Poble Nou de Benitatxell (el);1673;849;824
03;Alicante/Alacant;043;Biar;3463;1684;1779
03;Alicante/Alacant;044;Bigastro;4547;2327;2220
03;Alicante/Alacant;045;Bolulla;274;140;134
03;Alicante/Alacant;046;Busot;1005;497;508
03;Alicante/Alacant;048;Callosa d'En Sarrià;7591;3765;3826
03;Alicante/Alacant;049;Callosa de Segura;15589;7748;7841
03;Alicante/Alacant;047;Calpe/Calp;11525;5859;5666
03;Alicante/Alacant;050;Campello (El);11229;5572;5657
03;Alicante/Alacant;051;Campo de Mirra/Camp de Mirra (el);381;185;196
03;Alicante/Alacant;053;Castalla;7269;3571;3698
03;Alicante/Alacant;054;Castell de Castells;527;263;264
03;Alicante/Alacant;055;Catral;4532;2262;2270
03;Alicante/Alacant;052;Cañada;1078;527;551
03;Alicante/Alacant;056;Cocentaina;10618;5203;5415
03;Alicante/Alacant;057;Confrides;288;162;126
03;Alicante/Alacant;058;Cox;5543;2790;2753
03;Alicante/Alacant;059;Crevillent;22850;11540;11310
03;Alicante/Alacant;061;Daya Nueva;1187;597;590
03;Alicante/Alacant;062;Daya Vieja;202;101;101
03;Alicante/Alacant;064;Dolores;5959;2972;2987
03;Alicante/Alacant;063;Dénia;25639;12484;13155
03;Alicante/Alacant;065;Elche/Elx;188522;93435;95087
03;Alicante/Alacant;066;Elda;54809;26754;28055
03;Alicante/Alacant;067;Facheca;137;77;60
03;Alicante/Alacant;068;Famorca;69;33;36
03;Alicante/Alacant;069;Finestrat;1328;653;675
03;Alicante/Alacant;070;Formentera del Segura;2037;1013;1024
03;Alicante/Alacant;072;Gaianes;326;158;168
03;Alicante/Alacant;071;Gata de Gorgos;5024;2492;2532
03;Alicante/Alacant;073;Gorga;291;144;147
03;Alicante/Alacant;074;Granja de Rocamora;1964;1005;959
03;Alicante/Alacant;075;Guadalest;165;89;76
03;Alicante/Alacant;076;Guardamar del Segura;7016;3465;3551
03;Alicante/Alacant;077;Hondón de las Nieves;1426;712;714
03;Alicante/Alacant;078;Hondón de los Frailes;549;273;276
03;Alicante/Alacant;079;Ibi;20787;10308;10479
03;Alicante/Alacant;080;Jacarilla;1469;736;733
03;Alicante/Alacant;081;Jalón/Xaló;1957;965;992
03;Alicante/Alacant;083;Jijona/Xixona;7831;3674;4157
03;Alicante/Alacant;082;Jávea/Xàbia;16244;8112;8132
03;Alicante/Alacant;085;Llíber;475;230;245
03;Alicante/Alacant;084;Lorcha/Orxa (L');801;414;387
03;Alicante/Alacant;086;Millena;130;61;69
03;Alicante/Alacant;088;Monforte del Cid;5087;2620;2467
03;Alicante/Alacant;903;Montesinos (Los);2306;1169;1137
03;Alicante/Alacant;089;Monóvar/Monòver;12155;5916;6239
03;Alicante/Alacant;091;Murla;333;143;190
03;Alicante/Alacant;092;Muro de Alcoy;6607;3276;3331
03;Alicante/Alacant;090;Mutxamel;10593;5321;5272
03;Alicante/Alacant;093;Novelda;22261;10883;11378
03;Alicante/Alacant;094;Nucia (la);6222;3090;3132
03;Alicante/Alacant;095;Ondara;4913;2437;2476
03;Alicante/Alacant;096;Onil;6676;3338;3338
03;Alicante/Alacant;097;Orba;1525;727;798
03;Alicante/Alacant;099;Orihuela;49475;24266;25209
03;Alicante/Alacant;098;Orxeta;513;260;253
03;Alicante/Alacant;100;Parcent;728;356;372
03;Alicante/Alacant;101;Pedreguer;5702;2765;2937
03;Alicante/Alacant;102;Pego;9412;4663;4749
03;Alicante/Alacant;103;Penàguila;347;170;177
03;Alicante/Alacant;104;Petrer;24754;12320;12434
03;Alicante/Alacant;902;Pilar de la Horadada;8059;4062;3997
03;Alicante/Alacant;105;Pinoso;5700;2834;2866
03;Alicante/Alacant;106;Planes;792;387;405
03;Alicante/Alacant;901;Poblets (Els);1037;500;537
03;Alicante/Alacant;107;Polop;1869;926;943
03;Alicante/Alacant;060;Quatretondeta;196;97;99
03;Alicante/Alacant;109;Rafal;2682;1318;1364
03;Alicante/Alacant;111;Redován;5068;2577;2491
03;Alicante/Alacant;112;Relleu;815;411;404
03;Alicante/Alacant;113;Rojales;5375;2692;2683
03;Alicante/Alacant;114;Romana (La);1920;969;951
03;Alicante/Alacant;110;Ràfol d'Almúnia (El);371;180;191
03;Alicante/Alacant;115;Sagra;373;184;189
03;Alicante/Alacant;116;Salinas;1110;566;544
03;Alicante/Alacant;118;San Fulgencio;1789;911;878
03;Alicante/Alacant;904;San Isidro;"";"";""
03;Alicante/Alacant;120;San Miguel de Salinas;2997;1531;1466
03;Alicante/Alacant;122;San Vicente del Raspeig/Sant Vicent del Raspeig;29924;14836;15088
03;Alicante/Alacant;117;Sanet y Negrals;549;243;306
03;Alicante/Alacant;119;Sant Joan d'Alacant;14130;6966;7164
03;Alicante/Alacant;121;Santa Pola;15360;7650;7710
03;Alicante/Alacant;123;Sax;8397;4205;4192
03;Alicante/Alacant;124;Sella;583;304;279
03;Alicante/Alacant;125;Senija;479;245;234
03;Alicante/Alacant;128;Teulada;5424;2670;2754
03;Alicante/Alacant;129;Tibi;1051;533;518
03;Alicante/Alacant;130;Tollos;41;24;17
03;Alicante/Alacant;131;Tormos;277;138;139
03;Alicante/Alacant;132;Torremanzanas/Torre de les Maçanes (la);740;354;386
03;Alicante/Alacant;133;Torrevieja;25981;12743;13238
03;Alicante/Alacant;127;Tárbena;711;364;347
03;Alicante/Alacant;134;Vall d'Alcalà (La);170;78;92
03;Alicante/Alacant;135;Vall de Ebo;350;176;174
03;Alicante/Alacant;136;Vall de Gallinera;731;369;362
03;Alicante/Alacant;137;Vall de Laguar (La);976;478;498
03;Alicante/Alacant;138;Verger (El);3659;1758;1901
03;Alicante/Alacant;139;Villajoyosa/Vila Joiosa (La);22383;11063;11320
03;Alicante/Alacant;140;Villena;31237;15365;15872
04;Almería;001;Abla;1634;792;842
04;Almería;002;Abrucena;1430;690;740
04;Almería;003;Adra;20238;10135;10103
04;Almería;004;Albánchez;686;343;343
04;Almería;005;Alboloduy;894;411;483
04;Almería;006;Albox;10089;5018;5071
04;Almería;007;Alcolea;823;415;408
04;Almería;008;Alcóntar;625;325;300
04;Almería;009;Alcudia de Monteagud;209;95;114
04;Almería;010;Alhabia;765;385;380
04;Almería;011;Alhama de Almería;3066;1528;1538
04;Almería;012;Alicún;236;111;125
04;Almería;013;Almería;156108;75597;80511
04;Almería;014;Almócita;185;96;89
04;Almería;015;Alsodux;129;58;71
04;Almería;016;Antas;2526;1237;1289
04;Almería;017;Arboleas;1522;768;754
04;Almería;018;Armuña de Almanzora;374;177;197
04;Almería;019;Bacares;306;165;141
04;Almería;020;Bayárcal;388;213;175
04;Almería;021;Bayarque;234;112;122
04;Almería;022;Bédar;508;276;232
04;Almería;023;Beires;146;66;80
04;Almería;024;Benahadux;2299;1112;1187
04;Almería;026;Benitagla;114;59;55
04;Almería;027;Benizalón;343;181;162
04;Almería;028;Bentarique;364;186;178
04;Almería;029;Berja;12156;6016;6140
04;Almería;030;Canjáyar;1821;913;908
04;Almería;031;Cantoria;3321;1681;1640
04;Almería;032;Carboneras;5891;3037;2854
04;Almería;033;Castro de Filabres;167;79;88
04;Almería;036;Chercos;322;161;161
04;Almería;037;Chirivel;1963;969;994
04;Almería;034;Cóbdar;280;142;138
04;Almería;035;Cuevas del Almanzora;9229;4595;4634
04;Almería;038;Dalías;3560;1755;1805
04;Almería;039;Darrical;407;201;206
04;Almería;902;Ejido (El);42114;21380;20734
04;Almería;041;Enix;240;113;127
04;Almería;043;Felix;604;303;301
04;Almería;044;Fines;1652;841;811
04;Almería;045;Fiñana;2633;1297;1336
04;Almería;046;Fondón;922;471;451
04;Almería;047;Gádor;2560;1256;1304
04;Almería;048;Gallardos (Los);1677;845;832
04;Almería;049;Garrucha;4474;2292;2182
04;Almería;050;Gérgal;1090;525;565
04;Almería;051;Huécija;563;281;282
04;Almería;052;Huércal de Almería;3943;1952;1991
04;Almería;053;Huércal-Overa;13263;6552;6711
04;Almería;054;Illar;498;237;261
04;Almería;055;Instinción;617;294;323
04;Almería;056;Laroya;125;65;60
04;Almería;057;Láujar de Andarax;1848;912;936
04;Almería;058;Líjar;536;271;265
04;Almería;059;Lubrín;2004;965;1039
04;Almería;060;Lucainena de las Torres;573;275;298
04;Almería;061;Lúcar;784;385;399
04;Almería;062;Macael;6046;3067;2979
04;Almería;063;María;1773;905;868
04;Almería;064;Mojácar;3583;1750;1833
04;Almería;903;Mojonera (La);5583;2855;2728
04;Almería;065;Nacimiento;491;243;248
04;Almería;066;Níjar;12990;6594;6396
04;Almería;067;Ohanes;886;453;433
04;Almería;068;Olula de Castro;245;123;122
04;Almería;069;Olula del Río;5725;2877;2848
04;Almería;070;Oria;2413;1213;1200
04;Almería;071;Padules;524;272;252
04;Almería;072;Partaloa;406;198;208
04;Almería;073;Paterna del Río;341;169;172
04;Almería;074;Pechina;2247;1107;1140
04;Almería;075;Pulpí;4635;2339;2296
04;Almería;076;Purchena;1751;871;880
04;Almería;077;Rágol;430;204;226
04;Almería;078;Rioja;1124;554;570
04;Almería;079;Roquetas de Mar;27652;13786;13866
04;Almería;080;Santa Cruz de Marchena;194;95;99
04;Almería;081;Santa Fe de Mondújar;420;206;214
04;Almería;082;Senés;353;179;174
04;Almería;083;Serón;3009;1497;1512
04;Almería;084;Sierro;561;291;270
04;Almería;085;Somontín;482;238;244
04;Almería;086;Sorbas;2744;1373;1371
04;Almería;087;Suflí;265;133;132
04;Almería;088;Tabernas;3200;1603;1597
04;Almería;089;Taberno;1051;521;530
04;Almería;090;Tahal;513;253;260
04;Almería;091;Terque;454;225;229
04;Almería;092;Tíjola;3660;1849;1811
04;Almería;901;Tres Villas (Las);708;368;340
04;Almería;093;Turre;2109;1030;1079
04;Almería;094;Turrillas;287;154;133
04;Almería;095;Uleila del Campo;1000;507;493
04;Almería;096;Urrácal;327;165;162
04;Almería;097;Velefique;361;193;168
04;Almería;098;Vélez-Blanco;2360;1204;1156
04;Almería;099;Vélez-Rubio;6343;3070;3273
04;Almería;100;Vera;6108;3028;3080
04;Almería;101;Viator;2824;1377;1447
04;Almería;102;Vícar;11966;6110;5856
04;Almería;103;Zurgena;2130;1057;1073
05;Ávila;001;Adanero;363;190;173
05;Ávila;002;Adrada (La);1930;1004;926
05;Ávila;005;Albornos;294;153;141
05;Ávila;007;Aldeanueva de Santa Cruz;205;109;96
05;Ávila;008;Aldeaseca;408;197;211
05;Ávila;010;Aldehuela (La);312;157;155
05;Ávila;012;Amavida;220;108;112
05;Ávila;013;Arenal (El);1154;571;583
05;Ávila;014;Arenas de San Pedro;6518;3268;3250
05;Ávila;015;Arevalillo;177;90;87
05;Ávila;016;Arévalo;7352;3533;3819
05;Ávila;017;Aveinte;151;78;73
05;Ávila;018;Avellaneda;58;25;33
05;Ávila;019;Ávila;46759;22661;24098
05;Ávila;021;Barco de Ávila (El);2587;1294;1293
05;Ávila;022;Barraco (El);2047;1029;1018
05;Ávila;023;Barromán;297;164;133
05;Ávila;024;Becedas;556;292;264
05;Ávila;025;Becedillas;185;104;81
05;Ávila;026;Bercial de Zapardiel;374;181;193
05;Ávila;027;Berlanas (Las);409;203;206
05;Ávila;029;Bernuy-Zapardiel;297;158;139
05;Ávila;030;Berrocalejo de Aragona;45;22;23
05;Ávila;033;Blascomillán;377;181;196
05;Ávila;034;Blasconuño de Matacabras;31;18;13
05;Ávila;035;Blascosancho;173;88;85
05;Ávila;036;Bohodón (El);209;109;100
05;Ávila;037;Bohoyo;551;287;264
05;Ávila;038;Bonilla de la Sierra;226;122;104
05;Ávila;039;Brabos;82;45;37
05;Ávila;040;Bularros;148;80;68
05;Ávila;041;Burgohondo;1369;699;670
05;Ávila;042;Cabezas de Alambre;301;157;144
05;Ávila;043;Cabezas del Pozo;217;110;107
05;Ávila;044;Cabezas del Villar;565;308;257
05;Ávila;045;Cabizuela;166;80;86
05;Ávila;046;Canales;90;43;47
05;Ávila;047;Candeleda;5382;2718;2664
05;Ávila;048;Cantiveros;219;114;105
05;Ávila;049;Cardeñosa;604;317;287
05;Ávila;051;Carrera (La);355;177;178
05;Ávila;052;Casas del Puerto de Villatoro;129;69;60
05;Ávila;053;Casasola;194;100;94
05;Ávila;054;Casavieja;1648;864;784
05;Ávila;055;Casillas;998;513;485
05;Ávila;056;Castellanos de Zapardiel;160;89;71
05;Ávila;057;Cebreros;3608;1804;1804
05;Ávila;058;Cepeda la Mora;177;98;79
05;Ávila;067;Chamartín;128;68;60
05;Ávila;059;Cillán;170;85;85
05;Ávila;060;Cisla;238;113;125
05;Ávila;061;Colilla (La);208;104;104
05;Ávila;062;Collado de Contreras;294;156;138
05;Ávila;063;Collado del Mirón;120;63;57
05;Ávila;064;Constanzana;224;120;104
05;Ávila;065;Crespos;806;427;379
05;Ávila;066;Cuevas del Valle;661;360;301
05;Ávila;903;Diego del Carpio;402;213;189
05;Ávila;069;Donjimeno;160;81;79
05;Ávila;070;Donvidas;86;41;45
05;Ávila;072;Espinosa de los Caballeros;124;68;56
05;Ávila;073;Flores de Ávila;496;262;234
05;Ávila;074;Fontíveros;1141;580;561
05;Ávila;075;Fresnedilla;135;65;70
05;Ávila;076;Fresno (El);438;230;208
05;Ávila;077;Fuente el Saúz;368;179;189
05;Ávila;078;Fuentes de Año;257;134;123
05;Ávila;079;Gallegos de Altamiros;125;70;55
05;Ávila;080;Gallegos de Sobrinos;129;56;73
05;Ávila;081;Garganta del Villar;99;58;41
05;Ávila;082;Gavilanes;796;428;368
05;Ávila;083;Gemuño;274;133;141
05;Ávila;085;Gil García;95;45;50
05;Ávila;084;Gilbuena;185;103;82
05;Ávila;086;Gimialcón;156;82;74
05;Ávila;087;Gotarrendura;204;70;134
05;Ávila;088;Grandes y San Martín;67;32;35
05;Ávila;089;Guisando;750;382;368
05;Ávila;090;Gutierre-Muñoz;140;68;72
05;Ávila;092;Hernansancho;246;125;121
05;Ávila;093;Herradón de Pinares;508;265;243
05;Ávila;094;Herreros de Suso;267;132;135
05;Ávila;095;Higuera de las Dueñas;328;172;156
05;Ávila;096;Hija de Dios (La);153;85;68
05;Ávila;097;Horcajada (La);980;476;504
05;Ávila;099;Horcajo de las Torres;953;510;443
05;Ávila;100;Hornillo (El);555;272;283
05;Ávila;102;Hoyo de Pinares (El);2603;1319;1284
05;Ávila;101;Hoyocasero;478;254;224
05;Ávila;103;Hoyorredondo;156;79;77
05;Ávila;106;Hoyos de Miguel Muñoz;71;39;32
05;Ávila;104;Hoyos del Collado;55;37;18
05;Ávila;105;Hoyos del Espino;391;217;174
05;Ávila;107;Hurtumpascual;164;86;78
05;Ávila;108;Junciana;108;53;55
05;Ávila;109;Langa;626;327;299
05;Ávila;110;Lanzahíta;969;486;483
05;Ávila;113;Llanos de Tormes (Los);156;82;74
05;Ávila;112;Losar del Barco (El);187;102;85
05;Ávila;114;Madrigal de las Altas Torres;2112;1074;1038
05;Ávila;115;Maello;679;340;339
05;Ávila;116;Malpartida de Corneja;285;142;143
05;Ávila;117;Mamblas;327;173;154
05;Ávila;118;Mancera de Arriba;199;102;97
05;Ávila;119;Manjabálago;99;53;46
05;Ávila;120;Marlín;38;21;17
05;Ávila;121;Martiherrero;215;108;107
05;Ávila;122;Martínez;294;155;139
05;Ávila;123;Mediana de Voltoya;118;65;53
05;Ávila;124;Medinilla;283;149;134
05;Ávila;125;Mengamuñoz;79;34;45
05;Ávila;126;Mesegar de Corneja;142;69;73
05;Ávila;127;Mijares;1066;549;517
05;Ávila;128;Mingorría;573;291;282
05;Ávila;129;Mirón (El);342;187;155
05;Ávila;130;Mironcillo;138;79;59
05;Ávila;131;Mirueña de los Infanzones;267;132;135
05;Ávila;132;Mombeltrán;1215;655;560
05;Ávila;133;Monsalupe;120;60;60
05;Ávila;134;Moraleja de Matacabras;75;35;40
05;Ávila;135;Muñana;617;321;296
05;Ávila;136;Muñico;181;96;85
05;Ávila;138;Muñogalindo;476;268;208
05;Ávila;139;Muñogrande;122;64;58
05;Ávila;140;Muñomer del Peco;138;76;62
05;Ávila;141;Muñopepe;120;63;57
05;Ávila;142;Muñosancho;197;90;107
05;Ávila;143;Muñotello;152;82;70
05;Ávila;144;Narrillos del Álamo;194;97;97
05;Ávila;145;Narrillos del Rebollar;96;49;47
05;Ávila;149;Narros de Saldueña;260;135;125
05;Ávila;147;Narros del Castillo;313;169;144
05;Ávila;148;Narros del Puerto;57;32;25
05;Ávila;152;Nava de Arévalo;1137;591;546
05;Ávila;153;Nava del Barco;239;109;130
05;Ávila;151;Navacepedilla de Corneja;157;82;75
05;Ávila;154;Navadijos;86;49;37
05;Ávila;155;Navaescurial;124;71;53
05;Ávila;156;Navahondilla;149;63;86
05;Ávila;157;Navalacruz;338;163;175
05;Ávila;158;Navalmoral;665;341;324
05;Ávila;159;Navalonguilla;574;282;292
05;Ávila;160;Navalosa;601;316;285
05;Ávila;161;Navalperal de Pinares;934;450;484
05;Ávila;162;Navalperal de Tormes;157;81;76
05;Ávila;163;Navaluenga;2041;1033;1008
05;Ávila;164;Navaquesera;118;60;58
05;Ávila;165;Navarredonda de Gredos;504;258;246
05;Ávila;166;Navarredondilla;320;158;162
05;Ávila;167;Navarrevisca;430;225;205
05;Ávila;168;Navas del Marqués (Las);4165;2097;2068
05;Ávila;169;Navatalgordo;545;280;265
05;Ávila;170;Navatejares;126;57;69
05;Ávila;171;Neila de San Miguel;141;72;69
05;Ávila;172;Niharra;212;102;110
05;Ávila;173;Ojos-Albos;39;18;21
05;Ávila;174;Orbita;110;58;52
05;Ávila;175;Oso (El);263;141;122
05;Ávila;176;Padiernos;273;146;127
05;Ávila;177;Pajares de Adaja;204;108;96
05;Ávila;178;Palacios de Goda;596;283;313
05;Ávila;179;Papatrigo;381;193;188
05;Ávila;180;Parral (El);124;66;58
05;Ávila;181;Pascualcobo;56;31;25
05;Ávila;182;Pedro Bernardo;1569;800;769
05;Ávila;183;Pedro-Rodríguez;258;124;134
05;Ávila;184;Peguerinos;398;207;191
05;Ávila;185;Peñalba de Ávila;147;84;63
05;Ávila;186;Piedrahíta;2288;1131;1157
05;Ávila;187;Piedralaves;2164;1079;1085
05;Ávila;188;Poveda;101;57;44
05;Ávila;189;Poyales del Hoyo;847;424;423
05;Ávila;190;Pozanco;67;37;30
05;Ávila;191;Pradosegar;201;108;93
05;Ávila;192;Puerto Castilla;163;77;86
05;Ávila;193;Rasueros;426;228;198
05;Ávila;194;Riocabado;231;130;101
05;Ávila;195;Riofrío;362;202;160
05;Ávila;196;Rivilla de Barajas;101;56;45
05;Ávila;197;Salobral;128;64;64
05;Ávila;198;Salvadiós;151;80;71
05;Ávila;199;San Bartolomé de Béjar;106;51;55
05;Ávila;200;San Bartolomé de Corneja;136;74;62
05;Ávila;201;San Bartolomé de Pinares;806;439;367
05;Ávila;206;San Esteban de los Patos;46;24;22
05;Ávila;208;San Esteban de Zapardiel;98;44;54
05;Ávila;207;San Esteban del Valle;1011;514;497
05;Ávila;209;San García de Ingelmos;210;109;101
05;Ávila;901;San Juan de Gredos;492;246;246
05;Ávila;210;San Juan de la Encinilla;165;75;90
05;Ávila;211;San Juan de la Nava;750;388;362
05;Ávila;212;San Juan del Molinillo;400;223;177
05;Ávila;213;San Juan del Olmo;219;118;101
05;Ávila;214;San Lorenzo de Tormes;94;45;49
05;Ávila;215;San Martín de la Vega del Alberche;349;199;150
05;Ávila;216;San Martín del Pimpollar;344;183;161
05;Ávila;217;San Miguel de Corneja;132;66;66
05;Ávila;218;San Miguel de Serrezuela;255;134;121
05;Ávila;219;San Pascual;67;35;32
05;Ávila;220;San Pedro del Arroyo;520;271;249
05;Ávila;231;San Vicente de Arévalo;258;128;130
05;Ávila;204;Sanchidrián;771;375;396
05;Ávila;205;Sanchorreja;140;74;66
05;Ávila;222;Santa Cruz de Pinares;250;139;111
05;Ávila;221;Santa Cruz del Valle;678;337;341
05;Ávila;226;Santa María de los Caballeros;204;106;98
05;Ávila;224;Santa María del Arroyo;162;82;80
05;Ávila;225;Santa María del Berrocal;700;337;363
05;Ávila;902;Santa María del Cubillo;443;242;201
05;Ávila;227;Santa María del Tiétar;370;190;180
05;Ávila;228;Santiago del Collado;334;203;131
05;Ávila;904;Santiago del Tormes;388;197;191
05;Ávila;229;Santo Domingo de las Posadas;102;51;51
05;Ávila;230;Santo Tomé de Zabarcos;140;79;61
05;Ávila;232;Serrada (La);156;80;76
05;Ávila;233;Serranillos;529;277;252
05;Ávila;234;Sigeres;94;41;53
05;Ávila;235;Sinlabajos;286;149;137
05;Ávila;236;Solana de Ávila;290;148;142
05;Ávila;237;Solana de Rioalmar;363;188;175
05;Ávila;238;Solosancho;1197;640;557
05;Ávila;239;Sotalbo;279;146;133
05;Ávila;240;Sotillo de la Adrada;3396;1690;1706
05;Ávila;241;Tiemblo (El);3757;1879;1878
05;Ávila;242;Tiñosillos;749;399;350
05;Ávila;243;Tolbaños;164;81;83
05;Ávila;244;Tormellas;150;74;76
05;Ávila;245;Tornadizos de Ávila;348;171;177
05;Ávila;247;Torre (La);513;276;237
05;Ávila;246;Tórtoles;129;67;62
05;Ávila;249;Umbrías;188;92;96
05;Ávila;251;Vadillo de la Sierra;201;113;88
05;Ávila;252;Valdecasa;135;71;64
05;Ávila;253;Vega de Santa María;148;80;68
05;Ávila;254;Velayos;312;157;155
05;Ávila;256;Villaflor;195;101;94
05;Ávila;257;Villafranca de la Sierra;272;141;131
05;Ávila;905;Villanueva de Ávila;666;344;322
05;Ávila;258;Villanueva de Gómez;176;81;95
05;Ávila;259;Villanueva del Aceral;254;119;135
05;Ávila;260;Villanueva del Campillo;255;129;126
05;Ávila;261;Villar de Corneja;111;53;58
05;Ávila;262;Villarejo del Valle;478;252;226
05;Ávila;263;Villatoro;267;145;122
05;Ávila;264;Viñegra de Moraña;90;50;40
05;Ávila;265;Vita;122;74;48
05;Ávila;266;Zapardiel de la Cañada;234;117;117
05;Ávila;267;Zapardiel de la Ribera;162;81;81
06;Badajoz;001;Acedera;1050;566;484
06;Badajoz;002;Aceuchal;5084;2512;2572
06;Badajoz;003;Ahillones;1316;651;665
06;Badajoz;004;Alange;2020;1043;977
06;Badajoz;005;Albuera (La);1811;928;883
06;Badajoz;006;Alburquerque;5845;2958;2887
06;Badajoz;007;Alconchel;2342;1162;1180
06;Badajoz;008;Alconera;808;408;400
06;Badajoz;009;Aljucén;221;123;98
06;Badajoz;010;Almendral;1535;758;777
06;Badajoz;011;Almendralejo;25030;12198;12832
06;Badajoz;012;Arroyo de San Serván;3984;2020;1964
06;Badajoz;013;Atalaya;380;186;194
06;Badajoz;014;Azuaga;9900;4859;5041
06;Badajoz;015;Badajoz;123422;59621;63801
06;Badajoz;016;Barcarrota;4179;2078;2101
06;Badajoz;017;Baterno;432;215;217
06;Badajoz;018;Benquerencia de la Serena;1170;594;576
06;Badajoz;019;Berlanga;2747;1360;1387
06;Badajoz;020;Bienvenida;2450;1239;1211
06;Badajoz;021;Bodonal de la Sierra;1409;715;694
06;Badajoz;022;Burguillos del Cerro;3402;1665;1737
06;Badajoz;023;Cabeza del Buey;6423;3137;3286
06;Badajoz;024;Cabeza la Vaca;1756;883;873
06;Badajoz;025;Calamonte;5596;2749;2847
06;Badajoz;026;Calera de León;1212;615;597
06;Badajoz;027;Calzadilla de los Barros;834;419;415
06;Badajoz;028;Campanario;6054;2916;3138
06;Badajoz;029;Campillo de Llerena;1831;904;927
06;Badajoz;030;Capilla;252;117;135
06;Badajoz;031;Carmonita;736;401;335
06;Badajoz;032;Carrascalejo (El);29;15;14
06;Badajoz;033;Casas de Don Pedro;1932;938;994
06;Badajoz;034;Casas de Reina;326;141;185
06;Badajoz;035;Castilblanco;1489;730;759
06;Badajoz;036;Castuera;7491;3767;3724
06;Badajoz;042;Cheles;1359;686;673
06;Badajoz;037;Codosera (La);2592;1328;1264
06;Badajoz;038;Cordobilla de Lácara;1028;523;505
06;Badajoz;039;Coronada (La);2558;1285;1273
06;Badajoz;040;Corte de Peleas;1298;657;641
06;Badajoz;041;Cristina;549;292;257
06;Badajoz;043;Don Álvaro;608;309;299
06;Badajoz;044;Don Benito;29201;14479;14722
06;Badajoz;045;Entrín Bajo;677;335;342
06;Badajoz;046;Esparragalejo;1425;715;710
06;Badajoz;047;Esparragosa de la Serena;1159;581;578
06;Badajoz;048;Esparragosa de Lares;1296;634;662
06;Badajoz;049;Feria;1580;778;802
06;Badajoz;050;Fregenal de la Sierra;5562;2708;2854
06;Badajoz;051;Fuenlabrada de los Montes;2146;1057;1089
06;Badajoz;052;Fuente de Cantos;5092;2574;2518
06;Badajoz;053;Fuente del Arco;898;453;445
06;Badajoz;054;Fuente del Maestre;6791;3356;3435
06;Badajoz;055;Fuentes de León;2942;1416;1526
06;Badajoz;056;Garbayuela;621;331;290
06;Badajoz;057;Garlitos;900;453;447
06;Badajoz;058;Garrovilla (La);2695;1399;1296
06;Badajoz;059;Granja de Torrehermosa;2784;1386;1398
06;Badajoz;060;Guareña;7372;3737;3635
06;Badajoz;061;Haba (La);1593;802;791
06;Badajoz;062;Helechosa de los Montes;822;431;391
06;Badajoz;063;Herrera del Duque;4109;2070;2039
06;Badajoz;064;Higuera de la Serena;1343;677;666
06;Badajoz;065;Higuera de Llerena;553;264;289
06;Badajoz;066;Higuera de Vargas;3021;1518;1503
06;Badajoz;067;Higuera la Real;2802;1407;1395
06;Badajoz;068;Hinojosa del Valle;670;352;318
06;Badajoz;069;Hornachos;3818;1920;1898
06;Badajoz;070;Jerez de los Caballeros;10269;5139;5130
06;Badajoz;071;Lapa (La);365;180;185
06;Badajoz;073;Llera;1045;541;504
06;Badajoz;074;Llerena;5626;2716;2910
06;Badajoz;072;Lobón;2735;1411;1324
06;Badajoz;075;Magacela;903;464;439
06;Badajoz;076;Maguilla;1188;599;589
06;Badajoz;077;Malcocinado;639;340;299
06;Badajoz;078;Malpartida de la Serena;1064;537;527
06;Badajoz;079;Manchita;773;398;375
06;Badajoz;080;Medellín;2473;1254;1219
06;Badajoz;081;Medina de las Torres;1699;826;873
06;Badajoz;082;Mengabril;496;245;251
06;Badajoz;083;Mérida;49284;24141;25143
06;Badajoz;084;Mirandilla;1291;652;639
06;Badajoz;085;Monesterio;5178;2575;2603
06;Badajoz;086;Montemolín;1892;921;971
06;Badajoz;087;Monterrubio de la Serena;3257;1588;1669
06;Badajoz;088;Montijo;15035;7294;7741
06;Badajoz;089;Morera (La);806;411;395
06;Badajoz;090;Nava de Santiago (La);1163;591;572
06;Badajoz;091;Navalvillar de Pela;5058;2554;2504
06;Badajoz;092;Nogales;805;414;391
06;Badajoz;093;Oliva de la Frontera;6597;3294;3303
06;Badajoz;094;Oliva de Mérida;2164;1081;1083
06;Badajoz;095;Olivenza;10314;5054;5260
06;Badajoz;096;Orellana de la Sierra;486;252;234
06;Badajoz;097;Orellana la Vieja;4029;2028;2001
06;Badajoz;098;Palomas;705;372;333
06;Badajoz;099;Parra (La);1429;737;692
06;Badajoz;100;Peñalsordo;1816;863;953
06;Badajoz;101;Peraleda del Zaucejo;810;418;392
06;Badajoz;102;Puebla de Alcocer;1659;838;821
06;Badajoz;103;Puebla de la Calzada;5515;2752;2763
06;Badajoz;104;Puebla de la Reina;929;486;443
06;Badajoz;107;Puebla de Obando;2135;1059;1076
06;Badajoz;108;Puebla de Sancho Pérez;3040;1515;1525
06;Badajoz;105;Puebla del Maestre;1050;523;527
06;Badajoz;106;Puebla del Prior;631;333;298
06;Badajoz;109;Quintana de la Serena;5080;2539;2541
06;Badajoz;110;Reina;245;126;119
06;Badajoz;111;Rena;681;348;333
06;Badajoz;112;Retamal de Llerena;648;334;314
06;Badajoz;113;Ribera del Fresno;3470;1654;1816
06;Badajoz;114;Risco;235;119;116
06;Badajoz;115;Roca de la Sierra (La);1615;811;804
06;Badajoz;116;Salvaleón;2507;1279;1228
06;Badajoz;117;Salvatierra de los Barros;2002;978;1024
06;Badajoz;119;San Pedro de Mérida;804;426;378
06;Badajoz;123;San Vicente de Alcántara;6117;3006;3111
06;Badajoz;118;Sancti-Spíritus;375;176;199
06;Badajoz;120;Santa Amalia;4287;2160;2127
06;Badajoz;121;Santa Marta;4038;1996;2042
06;Badajoz;122;Santos de Maimona (Los);7721;3858;3863
06;Badajoz;124;Segura de León;2321;1145;1176
06;Badajoz;125;Siruela;2575;1270;1305
06;Badajoz;126;Solana de los Barros;2832;1453;1379
06;Badajoz;127;Talarrubias;3830;1885;1945
06;Badajoz;128;Talavera la Real;5265;2666;2599
06;Badajoz;129;Táliga;735;375;360
06;Badajoz;130;Tamurejo;302;144;158
06;Badajoz;131;Torre de Miguel Sesmero;1306;641;665
06;Badajoz;132;Torremayor;1154;562;592
06;Badajoz;133;Torremejía;1932;975;957
06;Badajoz;134;Trasierra;712;379;333
06;Badajoz;135;Trujillanos;944;490;454
06;Badajoz;136;Usagre;2203;1128;1075
06;Badajoz;137;Valdecaballeros;1660;829;831
06;Badajoz;901;Valdelacalzada;"";"";""
06;Badajoz;138;Valdetorres;1413;711;702
06;Badajoz;139;Valencia de las Torres;947;467;480
06;Badajoz;140;Valencia del Mombuey;945;467;478
06;Badajoz;141;Valencia del Ventoso;2513;1249;1264
06;Badajoz;146;Valle de la Serena;1803;876;927
06;Badajoz;147;Valle de Matamoros;577;280;297
06;Badajoz;148;Valle de Santa Ana;1334;678;656
06;Badajoz;142;Valverde de Burguillos;411;201;210
06;Badajoz;143;Valverde de Leganés;3656;1843;1813
06;Badajoz;144;Valverde de Llerena;929;456;473
06;Badajoz;145;Valverde de Mérida;1165;595;570
06;Badajoz;149;Villafranca de los Barros;12503;6153;6350
06;Badajoz;150;Villagarcía de la Torre;1094;567;527
06;Badajoz;151;Villagonzalo;1571;761;810
06;Badajoz;152;Villalba de los Barros;1755;887;868
06;Badajoz;153;Villanueva de la Serena;23215;11425;11790
06;Badajoz;154;Villanueva del Fresno;3624;1814;1810
06;Badajoz;156;Villar de Rena;1788;939;849
06;Badajoz;155;Villar del Rey;2367;1224;1143
06;Badajoz;157;Villarta de los Montes;871;421;450
06;Badajoz;158;Zafra;14420;6964;7456
06;Badajoz;159;Zahínos;3237;1619;1618
06;Badajoz;160;Zalamea de la Serena;5135;2546;2589
06;Badajoz;162;Zarza (La);3669;1844;1825
06;Badajoz;161;Zarza-Capilla;658;326;332
07;Balears (Illes);002;Alaior;6583;3317;3266
07;Balears (Illes);001;Alaró;3710;1772;1938
07;Balears (Illes);003;Alcúdia;8533;4261;4272
07;Balears (Illes);004;Algaida;3210;1620;1590
07;Balears (Illes);005;Andratx;7005;3456;3549
07;Balears (Illes);901;Ariany;839;405;434
07;Balears (Illes);006;Artà;5729;2808;2921
07;Balears (Illes);007;Banyalbufar;448;217;231
07;Balears (Illes);008;Binissalem;4763;2308;2455
07;Balears (Illes);009;Búger;910;448;462
07;Balears (Illes);010;Bunyola;4333;2170;2163
07;Balears (Illes);011;Calvià;23200;11741;11459
07;Balears (Illes);012;Campanet;2201;1079;1122
07;Balears (Illes);013;Campos;6468;3246;3222
07;Balears (Illes);014;Capdepera;6613;3327;3286
07;Balears (Illes);064;Castell (Es);5614;2795;2819
07;Balears (Illes);015;Ciutadella de Menorca;20785;10378;10407
07;Balears (Illes);016;Consell;1998;971;1027
07;Balears (Illes);017;Costitx;808;388;420
07;Balears (Illes);018;Deyá;554;268;286
07;Balears (Illes);026;Eivissa;31961;15973;15988
07;Balears (Illes);019;Escorca;222;123;99
07;Balears (Illes);020;Esporles;3141;1523;1618
07;Balears (Illes);021;Estellencs;347;179;168
07;Balears (Illes);022;Felanitx;14180;7026;7154
07;Balears (Illes);023;Ferreries;3710;1963;1747
07;Balears (Illes);024;Formentera;4744;2418;2326
07;Balears (Illes);025;Fornalutx;574;289;285
07;Balears (Illes);027;Inca;20682;10142;10540
07;Balears (Illes);028;Lloret de Vistalegre;816;395;421
07;Balears (Illes);029;Lloseta;4503;2231;2272
07;Balears (Illes);030;Llubí;1955;964;991
07;Balears (Illes);031;Llucmajor;17388;8607;8781
07;Balears (Illes);032;Mahón;22150;10772;11378
07;Balears (Illes);033;Manacor;26038;12814;13224
07;Balears (Illes);034;Mancor de la Vall;888;428;460
07;Balears (Illes);035;Maria de la Salut;1782;859;923
07;Balears (Illes);036;Marratxí;11769;5889;5880
07;Balears (Illes);037;Mercadal (Es);2398;1196;1202
07;Balears (Illes);902;Migjorn Gran (Es);1065;554;511
07;Balears (Illes);038;Montuïri;2053;984;1069
07;Balears (Illes);039;Muro;5872;2879;2993
07;Balears (Illes);040;Palma de Mallorca;303485;147549;155936
07;Balears (Illes);041;Petra;2642;1275;1367
07;Balears (Illes);044;Pobla (Sa);10138;5148;4990
07;Balears (Illes);042;Pollença;12247;6149;6098
07;Balears (Illes);043;Porreres;4364;2157;2207
07;Balears (Illes);045;Puigpunyent;1148;575;573
07;Balears (Illes);059;Salines (Ses);3064;1530;1534
07;Balears (Illes);046;Sant Antoni de Portmany;13588;6880;6708
07;Balears (Illes);049;Sant Joan;1657;809;848
07;Balears (Illes);050;Sant Joan de Labritja;3640;1809;1831
07;Balears (Illes);048;Sant Josep de sa Talaia;10093;5150;4943
07;Balears (Illes);051;Sant Llorenç des Cardassar;4618;2275;2343
07;Balears (Illes);052;Sant Lluís;3247;1620;1627
07;Balears (Illes);053;Santa Eugènia;944;476;468
07;Balears (Illes);054;Santa Eulalia del Río;16913;8541;8372
07;Balears (Illes);055;Santa Margalida;5858;2903;2955
07;Balears (Illes);056;Santa María del Camí;4089;1996;2093
07;Balears (Illes);057;Santanyí;7088;3555;3533
07;Balears (Illes);058;Selva;2886;1432;1454
07;Balears (Illes);047;Sencelles;1690;830;860
07;Balears (Illes);060;Sineu;2577;1282;1295
07;Balears (Illes);061;Sóller;10301;5058;5243
07;Balears (Illes);062;Son Servera;6295;3108;3187
07;Balears (Illes);063;Valldemossa;1349;640;709
07;Balears (Illes);065;Vilafranca de Bonany;2146;1050;1096
08;Barcelona;001;Abrera;5726;2947;2779
08;Barcelona;002;Aguilar de Segarra;194;100;94
08;Barcelona;014;Aiguafreda;2062;999;1063
08;Barcelona;003;Alella;6943;3424;3519
08;Barcelona;004;Alpens;245;133;112
08;Barcelona;005;Ametlla del Vallès (L');3645;1802;1843
08;Barcelona;006;Arenys de Mar;11178;5388;5790
08;Barcelona;007;Arenys de Munt;4791;2313;2478
08;Barcelona;008;Argençola;192;100;92
08;Barcelona;009;Argentona;7933;3917;4016
08;Barcelona;010;Artés;4147;2022;2125
08;Barcelona;011;Avià;1783;919;864
08;Barcelona;012;Avinyó;2048;1004;1044
08;Barcelona;013;Avinyonet del Penedès;1197;612;585
08;Barcelona;015;Badalona;218319;107962;110357
08;Barcelona;904;Badia del Vallès;"";"";""
08;Barcelona;016;Bagà;2131;1054;1077
08;Barcelona;017;Balenyà;3269;1650;1619
08;Barcelona;018;Balsareny;3396;1676;1720
08;Barcelona;252;Barberà del Vallès;31263;15866;15397
08;Barcelona;019;Barcelona;1630635;769648;860987
08;Barcelona;020;Begues;2163;1065;1098
08;Barcelona;021;Bellprat;95;51;44
08;Barcelona;022;Berga;14118;6818;7300
08;Barcelona;023;Bigues i Riells;2974;1548;1426
08;Barcelona;024;Borredà;443;207;236
08;Barcelona;025;Bruc (El);785;405;380
08;Barcelona;026;Brull (El);182;93;89
08;Barcelona;027;Cabanyes (Les);422;231;191
08;Barcelona;029;Cabrera de Mar;2915;1465;1450
08;Barcelona;028;Cabrera d'Igualada;269;150;119
08;Barcelona;030;Cabrils;3073;1489;1584
08;Barcelona;031;Calaf;3204;1576;1628
08;Barcelona;034;Calders;590;313;277
08;Barcelona;033;Caldes de Montbui;11501;5664;5837
08;Barcelona;032;Caldes d'Estrac;1475;703;772
08;Barcelona;035;Calella;11463;5346;6117
08;Barcelona;037;Calldetenes;1498;766;732
08;Barcelona;038;Callús;1388;672;716
08;Barcelona;036;Calonge de Segarra;199;106;93
08;Barcelona;039;Campins;199;91;108
08;Barcelona;040;Canet de Mar;8935;4342;4593
08;Barcelona;041;Canovelles;13324;6722;6602
08;Barcelona;042;Cànoves i Samalús;1033;515;518
08;Barcelona;043;Canyelles;762;403;359
08;Barcelona;044;Capellades;5054;2473;2581
08;Barcelona;045;Capolat;59;34;25
08;Barcelona;046;Cardedeu;9214;4591;4623
08;Barcelona;047;Cardona;6387;3108;3279
08;Barcelona;048;Carme;683;354;329
08;Barcelona;049;Casserres;1659;794;865
08;Barcelona;057;Castell de l'Areny;41;24;17
08;Barcelona;052;Castellar de n'Hug;159;84;75
08;Barcelona;050;Castellar del Riu;63;36;27
08;Barcelona;051;Castellar del Vallès;13822;6893;6929
08;Barcelona;053;Castellbell i el Vilar;2796;1386;1410
08;Barcelona;054;Castellbisbal;5143;2641;2502
08;Barcelona;055;Castellcir;242;128;114
08;Barcelona;056;Castelldefels;33648;16743;16905
08;Barcelona;058;Castellet i la Gornal;1108;554;554
08;Barcelona;060;Castellfollit de Riubregós;249;122;127
08;Barcelona;059;Castellfollit del Boix;321;154;167
08;Barcelona;061;Castellgalí;705;353;352
08;Barcelona;062;Castellnou de Bages;212;109;103
08;Barcelona;063;Castellolí;431;211;220
08;Barcelona;064;Castellterçol;1922;905;1017
08;Barcelona;065;Castellví de la Marca;1436;716;720
08;Barcelona;066;Castellví de Rosanes;671;341;330
08;Barcelona;067;Centelles;5713;2790;2923
08;Barcelona;268;Cercs;1651;805;846
08;Barcelona;266;Cerdanyola del Vallès;56932;28528;28404
08;Barcelona;068;Cervelló;5971;3019;2952
08;Barcelona;069;Collbató;1138;578;560
08;Barcelona;070;Collsuspina;217;111;106
08;Barcelona;071;Copons;259;132;127
08;Barcelona;072;Corbera de Llobregat;5572;2806;2766
08;Barcelona;073;Cornellà de Llobregat;84692;41925;42767
08;Barcelona;074;Cubelles;3400;1724;1676
08;Barcelona;075;Dosrius;1486;750;736
08;Barcelona;076;Esparreguera;12925;6472;6453
08;Barcelona;077;Esplugues de Llobregat;48422;24041;24381
08;Barcelona;078;Espunyola (L');270;135;135
08;Barcelona;079;Estany (L');373;177;196
08;Barcelona;134;Figaró-Montmany;640;333;307
08;Barcelona;080;Fígols;33;17;16
08;Barcelona;082;Fogars de la Selva;425;210;215
08;Barcelona;081;Fogars de Montclús;247;126;121
08;Barcelona;083;Folgueroles;1167;574;593
08;Barcelona;084;Fonollosa;706;351;355
08;Barcelona;085;Font-rubí;1142;596;546
08;Barcelona;086;Franqueses del Vallès (Les);10353;5225;5128
08;Barcelona;090;Gaià;143;78;65
08;Barcelona;087;Gallifa;89;45;44
08;Barcelona;088;Garriga (La);9592;4673;4919
08;Barcelona;089;Gavà;35890;17919;17971
08;Barcelona;091;Gelida;3965;1983;1982
08;Barcelona;092;Gironella;5102;2458;2644
08;Barcelona;093;Gisclareny;28;14;14
08;Barcelona;094;Granada (La);1215;599;616
08;Barcelona;095;Granera;51;29;22
08;Barcelona;096;Granollers;52303;25741;26562
08;Barcelona;097;Gualba;649;341;308
08;Barcelona;099;Guardiola de Berguedà;1280;624;656
08;Barcelona;100;Gurb;1686;857;829
08;Barcelona;101;Hospitalet de Llobregat (L');270541;133234;137307
08;Barcelona;162;Hostalets de Pierola (Els);971;491;480
08;Barcelona;102;Igualada;31934;15483;16451
08;Barcelona;103;Jorba;529;259;270
08;Barcelona;104;Llacuna (La);817;410;407
08;Barcelona;105;Llagosta (La);11332;5639;5693
08;Barcelona;107;Lliçà d'Amunt;5797;2975;2822
08;Barcelona;108;Lliçà de Vall;3616;1852;1764
08;Barcelona;106;Llinars del Vallès;5665;2863;2802
08;Barcelona;109;Lluçà;279;155;124
08;Barcelona;110;Malgrat de Mar;11674;5754;5920
08;Barcelona;111;Malla;254;119;135
08;Barcelona;112;Manlleu;16280;8018;8262
08;Barcelona;113;Manresa;66133;31830;34303
08;Barcelona;242;Marganell;226;94;132
08;Barcelona;114;Martorell;16704;8343;8361
08;Barcelona;115;Martorelles;4951;2446;2505
08;Barcelona;116;Masies de Roda (Les);627;314;313
08;Barcelona;117;Masies de Voltregà (Les);2505;1234;1271
08;Barcelona;118;Masnou (El);18640;9001;9639
08;Barcelona;119;Masquefa;2739;1347;1392
08;Barcelona;120;Matadepera;4884;2454;2430
08;Barcelona;121;Mataró;101527;49886;51641
08;Barcelona;122;Mediona;1055;526;529
08;Barcelona;138;Moià;3359;1628;1731
08;Barcelona;123;Molins de Rei;18319;9015;9304
08;Barcelona;124;Mollet del Vallès;42213;21174;21039
08;Barcelona;128;Monistrol de Calders;615;302;313
08;Barcelona;127;Monistrol de Montserrat;2494;1243;1251
08;Barcelona;125;Montcada i Reixac;26860;13331;13529
08;Barcelona;130;Montclar;256;110;146
08;Barcelona;131;Montesquiu;845;412;433
08;Barcelona;126;Montgat;7422;3641;3781
08;Barcelona;132;Montmajor;485;253;232
08;Barcelona;133;Montmaneu;237;131;106
08;Barcelona;135;Montmeló;7591;3782;3809
08;Barcelona;136;Montornès del Vallès;10929;5441;5488
08;Barcelona;137;Montseny;291;155;136
08;Barcelona;129;Muntanyola;178;98;80
08;Barcelona;139;Mura;278;146;132
08;Barcelona;140;Navarcles;5157;2564;2593
08;Barcelona;141;Navàs;5598;2765;2833
08;Barcelona;142;Nou de Berguedà (La);143;77;66
08;Barcelona;143;Òdena;2543;1291;1252
08;Barcelona;145;Olèrdola;1660;856;804
08;Barcelona;146;Olesa de Bonesvalls;469;251;218
08;Barcelona;147;Olesa de Montserrat;15169;7563;7606
08;Barcelona;148;Olivella;422;208;214
08;Barcelona;149;Olost;969;475;494
08;Barcelona;144;Olvan;979;457;522
08;Barcelona;150;Orís;229;117;112
08;Barcelona;151;Oristà;940;477;463
08;Barcelona;152;Orpí;152;79;73
08;Barcelona;153;Òrrius;381;197;184
08;Barcelona;154;Pacs del Penedès;448;232;216
08;Barcelona;155;Palafolls;3349;1641;1708
08;Barcelona;156;Palau-solità i Plegamans;7947;4089;3858
08;Barcelona;157;Pallejà;6710;3366;3344
08;Barcelona;905;Palma de Cervelló (La);"";"";""
08;Barcelona;158;Papiol (El);3334;1650;1684
08;Barcelona;159;Parets del Vallès;11268;5658;5610
08;Barcelona;160;Perafita;330;158;172
08;Barcelona;161;Piera;6144;3083;3061
08;Barcelona;163;Pineda de Mar;16587;8247;8340
08;Barcelona;164;Pla del Penedès (El);955;472;483
08;Barcelona;165;Pobla de Claramunt (La);1656;828;828
08;Barcelona;166;Pobla de Lillet (La);1744;850;894
08;Barcelona;167;Polinyà;3556;1833;1723
08;Barcelona;182;Pont de Vilomara i Rocafort (El);2226;1104;1122
08;Barcelona;168;Pontons;287;153;134
08;Barcelona;169;Prat de Llobregat (El);64610;32386;32224
08;Barcelona;171;Prats de Lluçanès;2638;1313;1325
08;Barcelona;170;Prats de Rei (Els);571;280;291
08;Barcelona;230;Premià de Dalt;6659;3333;3326
08;Barcelona;172;Premià de Mar;23107;11533;11574
08;Barcelona;174;Puigdàlber;303;145;158
08;Barcelona;175;Puig-reig;4740;2329;2411
08;Barcelona;176;Pujalt;174;89;85
08;Barcelona;177;Quar (La);44;19;25
08;Barcelona;178;Rajadell;295;155;140
08;Barcelona;179;Rellinars;256;124;132
08;Barcelona;180;Ripollet;27094;13510;13584
08;Barcelona;181;Roca del Vallès (La);5868;2930;2938
08;Barcelona;183;Roda de Ter;5061;2441;2620
08;Barcelona;184;Rubí;50703;25334;25369
08;Barcelona;185;Rubió;122;67;55
08;Barcelona;901;Rupit i Pruit;345;175;170
08;Barcelona;187;Sabadell;189113;92264;96849
08;Barcelona;188;Sagàs;190;101;89
08;Barcelona;190;Saldes;335;184;151
08;Barcelona;191;Sallent;7646;3701;3945
08;Barcelona;194;Sant Adrià de Besòs;34298;17012;17286
08;Barcelona;195;Sant Agustí de Lluçanès;120;61;59
08;Barcelona;196;Sant Andreu de la Barca;15348;7860;7488
08;Barcelona;197;Sant Andreu de Llavaneres;4447;2198;2249
08;Barcelona;198;Sant Antoni de Vilamajor;2260;1099;1161
08;Barcelona;199;Sant Bartomeu del Grau;1109;582;527
08;Barcelona;200;Sant Boi de Llobregat;78016;38951;39065
08;Barcelona;201;Sant Boi de Lluçanès;534;268;266
08;Barcelona;203;Sant Cebrià de Vallalta;928;505;423
08;Barcelona;202;Sant Celoni;11990;5984;6006
08;Barcelona;204;Sant Climent de Llobregat;2297;1132;1165
08;Barcelona;205;Sant Cugat del Vallès;40110;19870;20240
08;Barcelona;206;Sant Cugat Sesgarrigues;715;371;344
08;Barcelona;207;Sant Esteve de Palautordera;1194;610;584
08;Barcelona;208;Sant Esteve Sesrovires;2799;1431;1368
08;Barcelona;210;Sant Feliu de Codines;3737;1792;1945
08;Barcelona;211;Sant Feliu de Llobregat;36403;18019;18384
08;Barcelona;212;Sant Feliu Sasserra;652;330;322
08;Barcelona;209;Sant Fost de Campsentelles;5103;2606;2497
08;Barcelona;213;Sant Fruitós de Bages;4788;2403;2385
08;Barcelona;215;Sant Hipòlit de Voltregà;2989;1462;1527
08;Barcelona;193;Sant Iscle de Vallalta;524;265;259
08;Barcelona;216;Sant Jaume de Frontanyà;28;14;14
08;Barcelona;218;Sant Joan de Vilatorrada;8033;4005;4028
08;Barcelona;217;Sant Joan Despí;25023;12487;12536
08;Barcelona;903;Sant Julià de Cerdanyola;"";"";""
08;Barcelona;220;Sant Julià de Vilatorta;1949;948;1001
08;Barcelona;221;Sant Just Desvern;12726;6103;6623
08;Barcelona;222;Sant Llorenç d'Hortons;1092;550;542
08;Barcelona;223;Sant Llorenç Savall;1973;936;1037
08;Barcelona;225;Sant Martí d'Albars;125;69;56
08;Barcelona;224;Sant Martí de Centelles;653;330;323
08;Barcelona;226;Sant Martí de Tous;956;472;484
08;Barcelona;227;Sant Martí Sarroca;2422;1206;1216
08;Barcelona;228;Sant Martí Sesgueioles;358;180;178
08;Barcelona;229;Sant Mateu de Bages;538;271;267
08;Barcelona;231;Sant Pere de Ribes;14157;7086;7071
08;Barcelona;232;Sant Pere de Riudebitlles;2113;1051;1062
08;Barcelona;233;Sant Pere de Torelló;2018;970;1048
08;Barcelona;234;Sant Pere de Vilamajor;1196;606;590
08;Barcelona;189;Sant Pere Sallavinera;177;89;88
08;Barcelona;235;Sant Pol de Mar;2469;1214;1255
08;Barcelona;236;Sant Quintí de Mediona;1497;743;754
08;Barcelona;237;Sant Quirze de Besora;2010;968;1042
08;Barcelona;238;Sant Quirze del Vallès;9238;4547;4691
08;Barcelona;239;Sant Quirze Safaja;248;119;129
08;Barcelona;240;Sant Sadurní d'Anoia;9353;4668;4685
08;Barcelona;241;Sant Sadurní d'Osormort;73;36;37
08;Barcelona;098;Sant Salvador de Guardiola;1275;651;624
08;Barcelona;262;Sant Vicenç de Castellet;7431;3573;3858
08;Barcelona;264;Sant Vicenç de Montalt;1685;832;853
08;Barcelona;265;Sant Vicenç de Torelló;1707;815;892
08;Barcelona;263;Sant Vicenç dels Horts;21198;10666;10532
08;Barcelona;243;Santa Cecilia de Voltregà;186;104;82
08;Barcelona;244;Santa Coloma de Cervelló;3026;1489;1537
08;Barcelona;245;Santa Coloma de Gramenet;133006;66431;66575
08;Barcelona;246;Santa Eugènia de Berga;1590;818;772
08;Barcelona;247;Santa Eulàlia de Riuprimer;854;437;417
08;Barcelona;248;Santa Eulàlia de Ronçana;3106;1562;1544
08;Barcelona;249;Santa Fe del Penedès;209;96;113
08;Barcelona;250;Santa Margarida de Montbui;9369;4691;4678
08;Barcelona;251;Santa Margarida i els Monjos;4014;2076;1938
08;Barcelona;253;Santa Maria de Besora;202;102;100
08;Barcelona;254;Santa Maria de Corcó;2006;995;1011
08;Barcelona;256;Santa Maria de Martorelles;501;246;255
08;Barcelona;255;Santa Maria de Merlès;195;99;96
08;Barcelona;257;Santa Maria de Miralles;108;55;53
08;Barcelona;259;Santa Maria de Palautordera;5058;2580;2478
08;Barcelona;258;Santa Maria d'Oló;1009;513;496
08;Barcelona;260;Santa Perpètua de Mogoda;16936;8583;8353
08;Barcelona;261;Santa Susanna;1074;525;549
08;Barcelona;192;Santpedor;4644;2262;2382
08;Barcelona;267;Sentmenat;4677;2324;2353
08;Barcelona;269;Seva;1784;897;887
08;Barcelona;270;Sitges;13889;6718;7171
08;Barcelona;271;Sobremunt;95;44;51
08;Barcelona;272;Sora;214;112;102
08;Barcelona;273;Subirats;2103;1056;1047
08;Barcelona;274;Súria;6519;3194;3325
08;Barcelona;276;Tagamanent;145;77;68
08;Barcelona;277;Talamanca;81;41;40
08;Barcelona;278;Taradell;4593;2272;2321
08;Barcelona;275;Tavèrnoles;209;100;109
08;Barcelona;280;Tavertet;133;71;62
08;Barcelona;281;Teià;3870;1941;1929
08;Barcelona;279;Terrassa;158507;77233;81274
08;Barcelona;282;Tiana;4779;2401;2378
08;Barcelona;283;Tona;5541;2745;2796
08;Barcelona;284;Tordera;8476;4224;4252
08;Barcelona;285;Torelló;11453;5591;5862
08;Barcelona;286;Torre de Claramunt (La);1576;806;770
08;Barcelona;287;Torrelavit;1205;612;593
08;Barcelona;288;Torrelles de Foix;1392;736;656
08;Barcelona;289;Torrelles de Llobregat;2486;1258;1228
08;Barcelona;290;Ullastrell;947;474;473
08;Barcelona;291;Vacarisses;977;508;469
08;Barcelona;292;Vallbona d'Anoia;1051;528;523
08;Barcelona;293;Vallcebre;298;159;139
08;Barcelona;294;Vallgorguina;761;380;381
08;Barcelona;295;Vallirana;6620;3306;3314
08;Barcelona;296;Vallromanes;698;350;348
08;Barcelona;297;Veciana;169;87;82
08;Barcelona;298;Vic;28971;13844;15127
08;Barcelona;299;Vilada;541;277;264
08;Barcelona;301;Viladecans;48989;24721;24268
08;Barcelona;300;Viladecavalls;3532;1757;1775
08;Barcelona;305;Vilafranca del Penedès;27806;13589;14217
08;Barcelona;306;Vilalba Sasserra;297;155;142
08;Barcelona;303;Vilanova de Sau;306;148;158
08;Barcelona;302;Vilanova del Camí;9412;4736;4676
08;Barcelona;902;Vilanova del Vallès;1530;764;766
08;Barcelona;307;Vilanova i la Geltrú;46179;22653;23526
08;Barcelona;214;Vilassar de Dalt;6796;3339;3457
08;Barcelona;219;Vilassar de Mar;12431;6088;6343
08;Barcelona;304;Vilobí del Penedès;816;417;399
08;Barcelona;308;Viver i Serrateix;212;118;94
09;Burgos;001;Abajas;50;23;27
09;Burgos;003;Adrada de Haza;319;168;151
09;Burgos;006;Aguas Cándidas;110;62;48
09;Burgos;007;Aguilar de Bureba;110;57;53
09;Burgos;009;Albillos;149;78;71
09;Burgos;010;Alcocero de Mola;65;38;27
09;Burgos;011;Alfoz de Bricia;136;68;68
09;Burgos;907;Alfoz de Quintanadueñas;483;254;229
09;Burgos;012;Alfoz de Santa Gadea;167;89;78
09;Burgos;013;Altable;76;47;29
09;Burgos;014;Altos (Los);290;168;122
09;Burgos;016;Ameyugo;63;32;31
09;Burgos;017;Anguix;186;95;91
09;Burgos;018;Aranda de Duero;29922;14970;14952
09;Burgos;019;Arandilla;217;131;86
09;Burgos;020;Arauzo de Miel;443;242;201
09;Burgos;021;Arauzo de Salce;81;50;31
09;Burgos;022;Arauzo de Torre;116;63;53
09;Burgos;023;Arcos;239;142;97
09;Burgos;024;Arenillas de Riopisuerga;241;129;112
09;Burgos;025;Arija;292;137;155
09;Burgos;026;Arlanzón;403;214;189
09;Burgos;027;Arraya de Oca;55;28;27
09;Burgos;029;Atapuerca;149;77;72
09;Burgos;030;Ausines (Los);121;67;54
09;Burgos;032;Avellanosa de Muñó;206;107;99
09;Burgos;033;Bahabón de Esgueva;171;100;71
09;Burgos;034;Balbases (Los);397;210;187
09;Burgos;035;Baños de Valdearados;553;304;249
09;Burgos;036;Bañuelos de Bureba;62;40;22
09;Burgos;037;Barbadillo de Herreros;159;81;78
09;Burgos;038;Barbadillo del Mercado;200;99;101
09;Burgos;039;Barbadillo del Pez;116;62;54
09;Burgos;041;Barrio de Muñó;35;20;15
09;Burgos;043;Barrios de Bureba (Los);335;179;156
09;Burgos;044;Barrios de Colina;82;45;37
09;Burgos;045;Basconcillos del Tozo;435;228;207
09;Burgos;046;Bascuñana;88;47;41
09;Burgos;047;Belbimbre;84;40;44
09;Burgos;048;Belorado;2193;1109;1084
09;Burgos;050;Berberana;99;51;48
09;Burgos;051;Berlangas de Roa;311;163;148
09;Burgos;052;Berzosa de Bureba;54;31;23
09;Burgos;054;Bozoó;106;55;51
09;Burgos;055;Brazacorta;99;54;45
09;Burgos;056;Briviesca;5735;2834;2901
09;Burgos;057;Bugedo;118;86;32
09;Burgos;058;Buniel;136;77;59
09;Burgos;059;Burgos;161475;78460;83015
09;Burgos;060;Busto de Bureba;327;171;156
09;Burgos;061;Cabañes de Esgueva;317;164;153
09;Burgos;062;Cabezón de la Sierra;93;42;51
09;Burgos;063;Cabia;215;115;100
09;Burgos;064;Caleruega;439;217;222
09;Burgos;065;Campillo de Aranda;184;103;81
09;Burgos;066;Campolara;113;61;52
09;Burgos;067;Canicosa de la Sierra;684;341;343
09;Burgos;068;Cantabrana;70;40;30
09;Burgos;070;Carazo;52;30;22
09;Burgos;071;Carcedo de Bureba;42;23;19
09;Burgos;072;Carcedo de Burgos;120;71;49
09;Burgos;073;Cardeñadijo;338;185;153
09;Burgos;074;Cardeñajimeno;326;178;148
09;Burgos;075;Cardeñuela Riopico;71;34;37
09;Burgos;076;Carrias;56;37;19
09;Burgos;077;Cascajares de Bureba;66;37;29
09;Burgos;078;Cascajares de la Sierra;17;10;7
09;Burgos;079;Castellanos de Castro;74;42;32
09;Burgos;083;Castil de Peones;53;27;26
09;Burgos;082;Castildelgado;94;46;48
09;Burgos;084;Castrillo de la Reina;344;203;141
09;Burgos;085;Castrillo de la Vega;638;337;301
09;Burgos;088;Castrillo de Riopisuerga;105;60;45
09;Burgos;086;Castrillo del Val;210;124;86
09;Burgos;090;Castrillo Matajudíos;82;45;37
09;Burgos;091;Castrojeriz;1124;566;558
09;Burgos;093;Cayuela;117;69;48
09;Burgos;094;Cebrecos;79;46;33
09;Burgos;095;Celada del Camino;103;44;59
09;Burgos;098;Cerezo de Río Tirón;864;454;410
09;Burgos;100;Cerratón de Juarros;69;36;33
09;Burgos;101;Ciadoncha;142;82;60
09;Burgos;102;Cillaperlata;85;46;39
09;Burgos;103;Cilleruelo de Abajo;392;213;179
09;Burgos;104;Cilleruelo de Arriba;97;53;44
09;Burgos;105;Ciruelos de Cervera;188;99;89
09;Burgos;108;Cogollos;208;117;91
09;Burgos;109;Condado de Treviño;940;513;427
09;Burgos;110;Contreras;89;54;35
09;Burgos;112;Coruña del Conde;182;98;84
09;Burgos;113;Covarrubias;667;344;323
09;Burgos;114;Cubillo del Campo;74;39;35
09;Burgos;115;Cubo de Bureba;151;75;76
09;Burgos;117;Cueva de Roa (La);149;84;65
09;Burgos;119;Cuevas de San Clemente;70;34;36
09;Burgos;120;Encío;68;37;31
09;Burgos;122;Espinosa de Cervera;125;75;50
09;Burgos;124;Espinosa de los Monteros;2443;1260;1183
09;Burgos;123;Espinosa del Camino;55;28;27
09;Burgos;125;Estépar;890;473;417
09;Burgos;127;Fontioso;102;52;50
09;Burgos;128;Frandovínez;98;52;46
09;Burgos;129;Fresneda de la Sierra Tirón;118;58;60
09;Burgos;130;Fresneña;140;77;63
09;Burgos;131;Fresnillo de las Dueñas;317;160;157
09;Burgos;132;Fresno de Río Tirón;287;164;123
09;Burgos;133;Fresno de Rodilla;33;18;15
09;Burgos;134;Frías;331;173;158
09;Burgos;135;Fuentebureba;101;48;53
09;Burgos;136;Fuentecén;330;177;153
09;Burgos;137;Fuentelcésped;236;118;118
09;Burgos;138;Fuentelisendo;140;71;69
09;Burgos;139;Fuentemolinos;143;75;68
09;Burgos;140;Fuentenebro;222;122;100
09;Burgos;141;Fuentespina;562;292;270
09;Burgos;143;Galbarros;30;21;9
09;Burgos;144;Gallega (La);93;56;37
09;Burgos;148;Grijalba;166;78;88
09;Burgos;149;Grisaleña;65;37;28
09;Burgos;151;Gumiel de Izán;706;381;325
09;Burgos;152;Gumiel de Mercado;452;245;207
09;Burgos;154;Hacinas;227;124;103
09;Burgos;155;Haza;51;25;26
09;Burgos;159;Hontanas;95;55;40
09;Burgos;160;Hontangas;165;90;75
09;Burgos;162;Hontoria de la Cantera;105;49;56
09;Burgos;164;Hontoria de Valdearados;267;157;110
09;Burgos;163;Hontoria del Pinar;986;528;458
09;Burgos;166;Hormazas (Las);169;85;84
09;Burgos;167;Hornillos del Camino;89;47;42
09;Burgos;168;Horra (La);507;260;247
09;Burgos;169;Hortigüela;117;61;56
09;Burgos;170;Hoyales de Roa;350;167;183
09;Burgos;172;Huérmeces;160;90;70
09;Burgos;173;Huerta de Arriba;222;113;109
09;Burgos;174;Huerta de Rey;1242;646;596
09;Burgos;175;Humada;295;171;124
09;Burgos;176;Hurones;62;40;22
09;Burgos;177;Ibeas de Juarros;844;447;397
09;Burgos;178;Ibrillos;114;64;50
09;Burgos;179;Iglesiarrubia;76;42;34
09;Burgos;180;Iglesias;215;110;105
09;Burgos;181;Isar;430;205;225
09;Burgos;182;Itero del Castillo;142;68;74
09;Burgos;183;Jaramillo de la Fuente;34;19;15
09;Burgos;184;Jaramillo Quemado;16;10;6
09;Burgos;189;Junta de Traslaloma;249;125;124
09;Burgos;190;Junta de Villalba de Losa;106;57;49
09;Burgos;191;Jurisdicción de Lara;80;46;34
09;Burgos;192;Jurisdicción de San Zadornil;77;40;37
09;Burgos;194;Lerma;2580;1304;1276
09;Burgos;195;Llano de Bureba;68;42;26
09;Burgos;196;Madrigal del Monte;184;89;95
09;Burgos;197;Madrigalejo del Monte;179;98;81
09;Burgos;198;Mahamud;173;86;87
09;Burgos;199;Mambrilla de Castrejón;178;94;84
09;Burgos;200;Mambrillas de Lara;79;41;38
09;Burgos;201;Mamolar;99;54;45
09;Burgos;202;Manciles;50;27;23
09;Burgos;206;Mazuela;92;47;45
09;Burgos;208;Mecerreyes;312;151;161
09;Burgos;209;Medina de Pomar;5431;2720;2711
09;Burgos;211;Melgar de Fernamental;2224;1138;1086
09;Burgos;213;Merindad de Cuesta-Urria;600;346;254
09;Burgos;214;Merindad de Montija;1056;555;501
09;Burgos;431;Villafranca Montes de Oca;219;114;105
09;Burgos;432;Villafruela;342;183;159
09;Burgos;433;Villagalijo;56;28;28
09;Burgos;434;Villagonzalo Pedernales;454;222;232
09;Burgos;437;Villahoz;446;217;229
09;Burgos;438;Villalba de Duero;539;299;240
09;Burgos;439;Villalbilla de Burgos;561;305;256
09;Burgos;440;Villalbilla de Gumiel;153;84;69
09;Burgos;441;Villaldemiro;93;43;50
09;Burgos;442;Villalmanzo;453;241;212
09;Burgos;443;Villamayor de los Montes;299;145;154
09;Burgos;444;Villamayor de Treviño;125;71;54
09;Burgos;445;Villambistia;84;47;37
09;Burgos;446;Villamedianilla;29;15;14
09;Burgos;447;Villamiel de la Sierra;35;22;13
09;Burgos;448;Villangómez;388;200;188
09;Burgos;449;Villanueva de Argaño;117;62;55
09;Burgos;450;Villanueva de Carazo;30;18;12
09;Burgos;451;Villanueva de Gumiel;334;176;158
09;Burgos;454;Villanueva de Teba;67;38;29
09;Burgos;455;Villaquirán de la Puebla;79;45;34
09;Burgos;456;Villaquirán de los Infantes;224;118;106
09;Burgos;903;Villarcayo de Merindad de Castilla la Vieja;4136;2075;2061
09;Burgos;458;Villariezo;149;79;70
09;Burgos;460;Villasandino;310;156;154
09;Burgos;463;Villasur de Herreros;348;180;168
09;Burgos;464;Villatuelda;84;45;39
09;Burgos;466;Villaverde del Monte;205;112;93
09;Burgos;467;Villaverde-Mogina;152;87;65
09;Burgos;471;Villayerno Morquillas;138;62;76
09;Burgos;472;Villazopeque;101;57;44
09;Burgos;473;Villegas;140;72;68
09;Burgos;476;Villoruebo;46;32;14
09;Burgos;424;Viloria de Rioja;83;45;38
09;Burgos;425;Vilviestre del Pinar;827;426;401
09;Burgos;478;Vizcaínos;49;26;23
09;Burgos;480;Zael;168;83;85
09;Burgos;482;Zarzosa de Río Pisuerga;84;44;40
09;Burgos;483;Zazuar;295;151;144
09;Burgos;485;Zuñeda;97;49;48
09;Burgos;906;Merindad de Río Ubierna;1123;593;530
09;Burgos;215;Merindad de Sotoscueva;704;369;335
09;Burgos;216;Merindad de Valdeporres;571;289;282
09;Burgos;217;Merindad de Valdivielso;637;330;307
09;Burgos;218;Milagros;471;247;224
09;Burgos;219;Miranda de Ebro;36618;18207;18411
09;Burgos;220;Miraveche;121;67;54
09;Burgos;221;Modúbar de la Emparedada;171;92;79
09;Burgos;223;Monasterio de la Sierra;36;20;16
09;Burgos;224;Monasterio de Rodilla;218;115;103
09;Burgos;225;Moncalvillo;156;89;67
09;Burgos;226;Monterrubio de la Demanda;93;52;41
09;Burgos;227;Montorio;170;81;89
09;Burgos;228;Moradillo de Roa;230;123;107
09;Burgos;229;Nava de Roa;338;172;166
09;Burgos;230;Navas de Bureba;50;25;25
09;Burgos;231;Nebreda;118;74;44
09;Burgos;232;Neila;242;117;125
09;Burgos;235;Olmedillo de Roa;270;135;135
09;Burgos;236;Olmillos de Muñó;53;30;23
09;Burgos;238;Oña;1932;967;965
09;Burgos;239;Oquillas;79;38;41
09;Burgos;241;Orbaneja Riopico;157;86;71
09;Burgos;242;Padilla de Abajo;122;65;57
09;Burgos;243;Padilla de Arriba;142;72;70
09;Burgos;244;Padrones de Bureba;94;51;43
09;Burgos;246;Palacios de la Sierra;1008;513;495
09;Burgos;247;Palacios de Riopisuerga;49;26;23
09;Burgos;248;Palazuelos de la Sierra;68;33;35
09;Burgos;249;Palazuelos de Muñó;73;39;34
09;Burgos;250;Pampliega;437;226;211
09;Burgos;251;Pancorbo;570;283;287
09;Burgos;253;Pardilla;112;54;58
09;Burgos;255;Partido de la Sierra en Tobalina;77;44;33
09;Burgos;256;Pedrosa de Duero;643;343;300
09;Burgos;259;Pedrosa de Río Úrbel;316;177;139
09;Burgos;257;Pedrosa del Páramo;122;68;54
09;Burgos;258;Pedrosa del Príncipe;338;171;167
09;Burgos;261;Peñaranda de Duero;660;344;316
09;Burgos;262;Peral de Arlanza;264;142;122
09;Burgos;265;Piérnigas;42;25;17
09;Burgos;266;Pineda de la Sierra;118;65;53
09;Burgos;267;Pineda Trasmonte;218;110;108
09;Burgos;268;Pinilla de los Barruecos;143;75;68
09;Burgos;269;Pinilla de los Moros;54;35;19
09;Burgos;270;Pinilla Trasmonte;284;150;134
09;Burgos;272;Poza de la Sal;490;243;247
09;Burgos;273;Prádanos de Bureba;87;51;36
09;Burgos;274;Pradoluengo;1721;827;894
09;Burgos;275;Presencio;332;175;157
09;Burgos;276;Puebla de Arganzón (La);233;129;104
09;Burgos;277;Puentedura;141;75;66
09;Burgos;279;Quemada;257;143;114
09;Burgos;281;Quintana del Pidio;216;117;99
09;Burgos;280;Quintanabureba;50;30;20
09;Burgos;283;Quintanaélez;127;67;60
09;Burgos;287;Quintanaortuño;114;56;58
09;Burgos;288;Quintanapalla;135;71;64
09;Burgos;289;Quintanar de la Sierra;2483;1278;1205
09;Burgos;292;Quintanavides;82;36;46
09;Burgos;294;Quintanilla de la Mata;175;101;74
09;Burgos;901;Quintanilla del Agua y Tordueles;656;341;315
09;Burgos;295;Quintanilla del Coco;130;68;62
09;Burgos;298;Quintanilla San García;142;75;67
09;Burgos;301;Quintanilla Vivar;310;150;160
09;Burgos;297;Quintanillas (Las);342;181;161
09;Burgos;302;Rabanera del Pinar;171;87;84
09;Burgos;303;Rábanos;60;32;28
09;Burgos;304;Rabé de las Calzadas;151;83;68
09;Burgos;306;Rebolledo de la Torre;193;96;97
09;Burgos;307;Redecilla del Camino;143;86;57
09;Burgos;308;Redecilla del Campo;102;50;52
09;Burgos;309;Regumiel de la Sierra;564;286;278
09;Burgos;310;Reinoso;31;20;11
09;Burgos;311;Retuerta;78;44;34
09;Burgos;314;Revilla del Campo;137;71;66
09;Burgos;316;Revilla Vallejera;186;102;84
09;Burgos;312;Revilla y Ahedo (La);133;68;65
09;Burgos;315;Revillarruz;144;76;68
09;Burgos;317;Rezmondo;28;15;13
09;Burgos;318;Riocavado de la Sierra;80;46;34
09;Burgos;321;Roa;2377;1207;1170
09;Burgos;323;Rojas;104;57;47
09;Burgos;325;Royuela de Río Franco;392;213;179
09;Burgos;326;Rubena;158;78;80
09;Burgos;327;Rublacedo de Abajo;41;20;21
09;Burgos;328;Rucandio;142;69;73
09;Burgos;329;Salas de Bureba;186;102;84
09;Burgos;330;Salas de los Infantes;2114;1061;1053
09;Burgos;332;Saldaña de Burgos;100;52;48
09;Burgos;334;Salinillas de Bureba;69;41;28
09;Burgos;335;San Adrián de Juarros;41;19;22
09;Burgos;337;San Juan del Monte;186;97;89
09;Burgos;338;San Mamés de Burgos;144;81;63
09;Burgos;339;San Martín de Rubiales;339;180;159
09;Burgos;340;San Millán de Lara;98;57;41
09;Burgos;360;San Vicente del Valle;33;20;13
09;Burgos;343;Santa Cecilia;144;78;66
09;Burgos;345;Santa Cruz de la Salceda;182;94;88
09;Burgos;346;Santa Cruz del Valle Urbión;139;80;59
09;Burgos;347;Santa Gadea del Cid;218;111;107
09;Burgos;348;Santa Inés;210;111;99
09;Burgos;350;Santa María del Campo;756;391;365
09;Burgos;351;Santa María del Invierno;62;36;26
09;Burgos;352;Santa María del Mercadillo;221;123;98
09;Burgos;353;Santa María Rivarredonda;136;72;64
09;Burgos;354;Santa Olalla de Bureba;50;20;30
09;Burgos;355;Santibáñez de Esgueva;193;95;98
09;Burgos;356;Santibáñez del Val;69;38;31
09;Burgos;358;Santo Domingo de Silos;341;217;124
09;Burgos;361;Sargentes de la Lora;198;101;97
09;Burgos;362;Sarracín;152;87;65
09;Burgos;363;Sasamón;1511;804;707
09;Burgos;365;Sequera de Haza (La);76;44;32
09;Burgos;366;Solarana;128;69;59
09;Burgos;368;Sordillos;43;25;18
09;Burgos;369;Sotillo de la Ribera;578;322;256
09;Burgos;372;Sotragero;124;72;52
09;Burgos;373;Sotresgudo;840;446;394
09;Burgos;374;Susinos del Páramo;61;34;27
09;Burgos;375;Tamarón;51;27;24
09;Burgos;377;Tardajos;746;422;324
09;Burgos;378;Tejada;55;32;23
09;Burgos;380;Terradillos de Esgueva;147;74;73
09;Burgos;381;Tinieblas de la Sierra;34;18;16
09;Burgos;382;Tobar;56;28;28
09;Burgos;384;Tordómar;406;230;176
09;Burgos;386;Torrecilla del Monte;84;44;40
09;Burgos;387;Torregalindo;170;90;80
09;Burgos;388;Torrelara;22;10;12
09;Burgos;389;Torrepadre;203;110;93
09;Burgos;390;Torresandino;826;438;388
09;Burgos;391;Tórtoles de Esgueva;609;331;278
09;Burgos;392;Tosantos;84;40;44
09;Burgos;394;Trespaderne;1221;647;574
09;Burgos;395;Tubilla del Agua;176;101;75
09;Burgos;396;Tubilla del Lago;226;116;110
09;Burgos;398;Úrbel del Castillo;116;61;55
09;Burgos;400;Vadocondes;489;247;242
09;Burgos;403;Valdeande;202;110;92
09;Burgos;405;Valdezate;241;127;114
09;Burgos;406;Valdorros;100;55;45
09;Burgos;408;Vallarta de Bureba;92;50;42
09;Burgos;904;Valle de las Navas;664;357;307
09;Burgos;908;Valle de Losa;730;411;319
09;Burgos;409;Valle de Manzanedo;103;57;46
09;Burgos;410;Valle de Mena;4671;2384;2287
09;Burgos;411;Valle de Oca;219;111;108
09;Burgos;902;Valle de Santibáñez;730;381;349
09;Burgos;905;Valle de Sedano;515;279;236
09;Burgos;412;Valle de Tobalina;1087;583;504
09;Burgos;413;Valle de Valdebezana;871;476;395
09;Burgos;414;Valle de Valdelaguna;283;143;140
09;Burgos;415;Valle de Valdelucio;428;229;199
09;Burgos;416;Valle de Zamanzas;46;24;22
09;Burgos;417;Vallejera;60;32;28
09;Burgos;418;Valles de Palenzuela;110;57;53
09;Burgos;419;Valluércanes;134;78;56
09;Burgos;407;Valmala;37;20;17
09;Burgos;422;Vid de Bureba (La);49;24;25
09;Burgos;421;Vid y Barrios (La);390;221;169
09;Burgos;423;Vileña;49;29;20
09;Burgos;427;Villadiego;2347;1256;1091
09;Burgos;428;Villaescusa de Roa;194;104;90
09;Burgos;429;Villaescusa la Sombría;71;43;28
09;Burgos;430;Villaespasa;44;27;17
10;Cáceres;001;Abadía;307;176;131
10;Cáceres;002;Abertura;530;279;251
10;Cáceres;003;Acebo;890;450;440
10;Cáceres;004;Acehúche;1010;509;501
10;Cáceres;005;Aceituna;759;378;381
10;Cáceres;006;Ahigal;1815;943;872
10;Cáceres;007;Albalá del Caudillo;965;472;493
10;Cáceres;008;Alcántara;2067;1041;1026
10;Cáceres;009;Alcollarín;380;180;200
10;Cáceres;010;Alcuéscar;3360;1760;1600
10;Cáceres;012;Aldea del Cano;796;391;405
10;Cáceres;013;Aldea del Obispo (La);431;222;209
10;Cáceres;011;Aldeacentenera;1074;526;548
10;Cáceres;014;Aldeanueva de la Vera;2620;1297;1323
10;Cáceres;015;Aldeanueva del Camino;960;455;505
10;Cáceres;016;Aldehuela de Jerte;400;230;170
10;Cáceres;017;Alía;1668;829;839
10;Cáceres;018;Aliseda;2476;1244;1232
10;Cáceres;019;Almaraz;1339;678;661
10;Cáceres;020;Almoharín;2121;1043;1078
10;Cáceres;021;Arroyo de la Luz;6644;3315;3329
10;Cáceres;023;Arroyomolinos;1168;596;572
10;Cáceres;022;Arroyomolinos de la Vera;661;327;334
10;Cáceres;024;Baños de Montemayor;736;344;392
10;Cáceres;025;Barrado;578;289;289
10;Cáceres;026;Belvís de Monroy;550;280;270
10;Cáceres;027;Benquerencia;114;64;50
10;Cáceres;028;Berrocalejo;156;71;85
10;Cáceres;029;Berzocana;737;375;362
10;Cáceres;030;Bohonal de Ibor;673;333;340
10;Cáceres;031;Botija;200;91;109
10;Cáceres;032;Brozas;2481;1228;1253
10;Cáceres;033;Cabañas del Castillo;679;347;332
10;Cáceres;034;Cabezabellosa;647;322;325
10;Cáceres;035;Cabezuela del Valle;2435;1228;1207
10;Cáceres;036;Cabrero;477;247;230
10;Cáceres;037;Cáceres;75512;36164;39348
10;Cáceres;038;Cachorrilla;111;53;58
10;Cáceres;039;Cadalso;582;295;287
10;Cáceres;040;Calzadilla;614;294;320
10;Cáceres;041;Caminomorisco;1326;703;623
10;Cáceres;042;Campillo de Deleitosa;170;83;87
10;Cáceres;043;Campo Lugar;1288;645;643
10;Cáceres;044;Cañamero;2051;1048;1003
10;Cáceres;045;Cañaveral;1720;827;893
10;Cáceres;046;Carbajo;313;167;146
10;Cáceres;047;Carcaboso;1320;688;632
10;Cáceres;048;Carrascalejo;489;236;253
10;Cáceres;049;Casar de Cáceres;4104;2079;2025
10;Cáceres;050;Casar de Palomero;1476;757;719
10;Cáceres;051;Casares de las Hurdes;990;510;480
10;Cáceres;052;Casas de Don Antonio;260;127;133
10;Cáceres;053;Casas de Don Gómez;411;209;202
10;Cáceres;056;Casas de Millán;870;447;423
10;Cáceres;057;Casas de Miravete;163;85;78
10;Cáceres;054;Casas del Castañar;751;362;389
10;Cáceres;055;Casas del Monte;955;494;461
10;Cáceres;058;Casatejada;1407;706;701
10;Cáceres;059;Casillas de Coria;652;313;339
10;Cáceres;060;Castañar de Ibor;1365;697;668
10;Cáceres;061;Ceclavín;2413;1211;1202
10;Cáceres;062;Cedillo;601;300;301
10;Cáceres;063;Cerezo;261;125;136
10;Cáceres;064;Cilleros;2382;1187;1195
10;Cáceres;065;Collado;365;187;178
10;Cáceres;066;Conquista de la Sierra;201;103;98
10;Cáceres;067;Coria;11350;5669;5681
10;Cáceres;068;Cuacos de Yuste;982;512;470
10;Cáceres;069;Cumbre (La);1252;617;635
10;Cáceres;070;Deleitosa;1066;523;543
10;Cáceres;071;Descargamaría;260;133;127
10;Cáceres;072;Eljas;1375;703;672
10;Cáceres;073;Escurial;1019;510;509
10;Cáceres;075;Fresnedoso de Ibor;507;265;242
10;Cáceres;076;Galisteo;2060;1029;1031
10;Cáceres;077;Garciaz;1085;544;541
10;Cáceres;078;Garganta (La);669;349;320
10;Cáceres;079;Garganta la Olla;1264;650;614
10;Cáceres;080;Gargantilla;576;294;282
10;Cáceres;081;Gargüera;273;131;142
10;Cáceres;082;Garrovillas de Alconétar;2635;1260;1375
10;Cáceres;083;Garvín;122;70;52
10;Cáceres;084;Gata;2114;1049;1065
10;Cáceres;085;Gordo (El);347;175;172
10;Cáceres;086;Granja (La);470;251;219
10;Cáceres;087;Guadalupe;2499;1229;1270
10;Cáceres;088;Guijo de Coria;350;185;165
10;Cáceres;089;Guijo de Galisteo;1758;903;855
10;Cáceres;090;Guijo de Granadilla;823;402;421
10;Cáceres;091;Guijo de Santa Bárbara;568;285;283
10;Cáceres;092;Herguijuela;460;224;236
10;Cáceres;093;Hernán-Pérez;514;271;243
10;Cáceres;094;Herrera de Alcántara;389;192;197
10;Cáceres;095;Herreruela;533;264;269
10;Cáceres;096;Hervás;3867;1862;2005
10;Cáceres;097;Higuera;127;69;58
10;Cáceres;098;Hinojal;464;227;237
10;Cáceres;099;Holguera;865;428;437
10;Cáceres;100;Hoyos;1003;495;508
10;Cáceres;101;Huélaga;182;90;92
10;Cáceres;102;Ibahernando;857;429;428
10;Cáceres;103;Jaraicejo;769;383;386
10;Cáceres;104;Jaraíz de la Vera;7368;3654;3714
10;Cáceres;105;Jarandilla de la Vera;3110;1536;1574
10;Cáceres;106;Jarilla;202;103;99
10;Cáceres;107;Jerte;1368;715;653
10;Cáceres;108;Ladrillar;446;234;212
10;Cáceres;109;Logrosán;2766;1346;1420
10;Cáceres;110;Losar de la Vera;3107;1549;1558
10;Cáceres;111;Madrigal de la Vera;1832;933;899
10;Cáceres;112;Madrigalejo;2442;1213;1229
10;Cáceres;113;Madroñera;3287;1636;1651
10;Cáceres;114;Majadas;1131;579;552
10;Cáceres;115;Malpartida de Cáceres;4004;1998;2006
10;Cáceres;116;Malpartida de Plasencia;4178;2041;2137
10;Cáceres;117;Marchagaz;427;203;224
10;Cáceres;118;Mata de Alcántara;398;201;197
10;Cáceres;119;Membrío;1013;480;533
10;Cáceres;120;Mesas de Ibor;227;120;107
10;Cáceres;121;Miajadas;9927;4972;4955
10;Cáceres;122;Millanes;264;143;121
10;Cáceres;123;Mirabel;934;465;469
10;Cáceres;124;Mohedas de Granadilla;1145;592;553
10;Cáceres;125;Monroy;1333;652;681
10;Cáceres;126;Montánchez;2503;1251;1252
10;Cáceres;127;Montehermoso;5335;2686;2649
10;Cáceres;128;Moraleja;8086;4021;4065
10;Cáceres;129;Morcillo;592;277;315
10;Cáceres;130;Navaconcejo;2169;1105;1064
10;Cáceres;131;Navalmoral de la Mata;15264;7558;7706
10;Cáceres;132;Navalvillar de Ibor;632;317;315
10;Cáceres;133;Navas del Madroño;1694;845;849
10;Cáceres;134;Navezuelas;802;425;377
10;Cáceres;135;Nuñomoral;2201;1152;1049
10;Cáceres;136;Oliva de Plasencia;366;175;191
10;Cáceres;137;Palomero;606;315;291
10;Cáceres;138;Pasarón de la Vera;713;359;354
10;Cáceres;139;Pedroso de Acim;192;93;99
10;Cáceres;140;Peraleda de la Mata;1518;760;758
10;Cáceres;141;Peraleda de San Román;431;209;222
10;Cáceres;142;Perales del Puerto;1018;503;515
10;Cáceres;143;Pescueza;273;136;137
10;Cáceres;144;Pesga (La);1402;727;675
10;Cáceres;145;Piedras Albas;263;122;141
10;Cáceres;146;Pinofranqueado;1833;974;859
10;Cáceres;147;Piornal;1619;800;819
10;Cáceres;148;Plasencia;36361;17832;18529
10;Cáceres;149;Plasenzuela;503;256;247
10;Cáceres;150;Portaje;483;242;241
10;Cáceres;151;Portezuelo;350;162;188
10;Cáceres;152;Pozuelo de Zarzón;683;331;352
10;Cáceres;153;Puerto de Santa Cruz;460;224;236
10;Cáceres;154;Rebollar;284;151;133
10;Cáceres;155;Riolobos;1795;941;854
10;Cáceres;156;Robledillo de Gata;215;108;107
10;Cáceres;157;Robledillo de la Vera;467;227;240
10;Cáceres;158;Robledillo de Trujillo;536;276;260
10;Cáceres;159;Robledollano;442;234;208
10;Cáceres;160;Romangordo;222;111;111
10;Cáceres;901;Rosalejo;"";"";""
10;Cáceres;161;Ruanes;111;56;55
10;Cáceres;162;Salorino;965;470;495
10;Cáceres;163;Salvatierra de Santiago;473;243;230
10;Cáceres;164;San Martín de Trevejo;974;484;490
10;Cáceres;165;Santa Ana;410;208;202
10;Cáceres;166;Santa Cruz de la Sierra;399;207;192
10;Cáceres;167;Santa Cruz de Paniagua;509;265;244
10;Cáceres;168;Santa Marta de Magasca;404;203;201
10;Cáceres;169;Santiago de Alcántara;900;445;455
10;Cáceres;170;Santiago del Campo;374;189;185
10;Cáceres;171;Santibáñez el Alto;531;270;261
10;Cáceres;172;Santibáñez el Bajo;1086;585;501
10;Cáceres;173;Saucedilla;599;290;309
10;Cáceres;174;Segura de Toro;202;109;93
10;Cáceres;175;Serradilla;2256;1130;1126
10;Cáceres;176;Serrejón;500;253;247
10;Cáceres;177;Sierra de Fuentes;1544;758;786
10;Cáceres;178;Talaván;1092;532;560
10;Cáceres;179;Talaveruela de la Vera;535;255;280
10;Cáceres;180;Talayuela;7833;3990;3843
10;Cáceres;181;Tejeda de Tiétar;1061;563;498
10;Cáceres;182;Toril;185;100;85
10;Cáceres;183;Tornavacas;1443;747;696
10;Cáceres;184;Torno (El);1115;583;532
10;Cáceres;187;Torre de Don Miguel;724;367;357
10;Cáceres;188;Torre de Santa María;817;397;420
10;Cáceres;185;Torrecilla de los Ángeles;718;369;349
10;Cáceres;186;Torrecillas de la Tiesa;1303;653;650
10;Cáceres;190;Torrejón el Rubio;804;408;396
10;Cáceres;189;Torrejoncillo;3720;1793;1927
10;Cáceres;191;Torremenga;585;296;289
10;Cáceres;192;Torremocha;1357;656;701
10;Cáceres;193;Torreorgaz;1459;742;717
10;Cáceres;194;Torrequemada;628;286;342
10;Cáceres;195;Trujillo;9073;4314;4759
10;Cáceres;196;Valdastillas;431;210;221
10;Cáceres;197;Valdecañas de Tajo;133;72;61
10;Cáceres;198;Valdefuentes;1683;834;849
10;Cáceres;199;Valdehúncar;178;81;97
10;Cáceres;200;Valdelacasa de Tajo;729;344;385
10;Cáceres;201;Valdemorales;272;133;139
10;Cáceres;202;Valdeobispo;888;444;444
10;Cáceres;203;Valencia de Alcántara;6558;3204;3354
10;Cáceres;204;Valverde de la Vera;723;359;364
10;Cáceres;205;Valverde del Fresno;2810;1401;1409
10;Cáceres;206;Viandar de la Vera;375;174;201
10;Cáceres;207;Villa del Campo;703;351;352
10;Cáceres;208;Villa del Rey;186;91;95
10;Cáceres;209;Villamesías;470;223;247
10;Cáceres;210;Villamiel;811;402;409
10;Cáceres;211;Villanueva de la Sierra;723;353;370
10;Cáceres;212;Villanueva de la Vera;2152;1081;1071
10;Cáceres;214;Villar de Plasencia;350;173;177
10;Cáceres;213;Villar del Pedroso;929;473;456
10;Cáceres;215;Villasbuenas de Gata;531;268;263
10;Cáceres;216;Zarza de Granadilla;1861;957;904
10;Cáceres;217;Zarza de Montánchez;705;346;359
10;Cáceres;218;Zarza la Mayor;1710;856;854
10;Cáceres;219;Zorita;2276;1113;1163
11;Cádiz;001;Alcalá de los Gazules;5602;2909;2693
11;Cádiz;002;Alcalá del Valle;5329;2699;2630
11;Cádiz;003;Algar;1888;1011;877
11;Cádiz;004;Algeciras;101751;50050;51701
11;Cádiz;005;Algodonales;5766;2987;2779
11;Cádiz;006;Arcos de la Frontera;27200;13669;13531
11;Cádiz;007;Barbate;21855;10938;10917
11;Cádiz;008;Barrios (Los);13919;7082;6837
11;Cádiz;901;Benalup-Casas Viejas;5851;3015;2836
11;Cádiz;009;Benaocaz;537;274;263
11;Cádiz;010;Bornos;7899;3957;3942
11;Cádiz;011;Bosque (El);1789;912;877
11;Cádiz;013;Castellar de la Frontera;2314;1176;1138
11;Cádiz;015;Chiclana de la Frontera;47484;24269;23215
11;Cádiz;016;Chipiona;14555;7345;7210
11;Cádiz;014;Conil de la Frontera;15804;8041;7763
11;Cádiz;012;Cádiz;154644;75139;79505
11;Cádiz;017;Espera;4152;2143;2009
11;Cádiz;018;Gastor (El);2151;1143;1008
11;Cádiz;019;Grazalema;2242;1154;1088
11;Cádiz;020;Jerez de la Frontera;184813;90781;94032
11;Cádiz;021;Jimena de la Frontera;8924;4567;4357
11;Cádiz;022;Línea de la Concepción (La);58716;28576;30140
11;Cádiz;023;Medina-Sidonia;10777;5562;5215
11;Cádiz;024;Olvera;9085;4577;4508
11;Cádiz;025;Paterna de Rivera;4916;2530;2386
11;Cádiz;026;Prado del Rey;5560;2790;2770
11;Cádiz;028;Puerto Real;29855;15050;14805
11;Cádiz;029;Puerto Serrano;6545;3336;3209
11;Cádiz;027;Puerto de Santa María (El);66433;33161;33272
11;Cádiz;030;Rota;22904;11571;11333
11;Cádiz;031;San Fernando;85913;42380;43533
11;Cádiz;902;San José del Valle;"";"";""
11;Cádiz;033;San Roque;21464;10814;10650
11;Cádiz;032;Sanlúcar de Barrameda;56624;28338;28286
11;Cádiz;034;Setenil de las Bodegas;3227;1619;1608
11;Cádiz;035;Tarifa;14565;7347;7218
11;Cádiz;036;Torre Alháquime;1016;521;495
11;Cádiz;037;Trebujena;6985;3551;3434
11;Cádiz;038;Ubrique;18235;9074;9161
11;Cádiz;039;Vejer de la Frontera;12841;6559;6282
11;Cádiz;040;Villaluenga del Rosario;507;263;244
11;Cádiz;041;Villamartín;12425;6234;6191
11;Cádiz;042;Zahara;1617;828;789
12;Castellón/Castelló;002;Aín;134;66;68
12;Castellón/Castelló;003;Albocàsser;1490;718;772
12;Castellón/Castelló;004;Alcalà de Xivert;4765;2404;2361
12;Castellón/Castelló;005;Alcora (L');8405;4251;4154
12;Castellón/Castelló;006;Alcudia de Veo;188;87;101
12;Castellón/Castelló;007;Alfondeguilla;915;449;466
12;Castellón/Castelló;008;Algimia de Almonacid;334;183;151
12;Castellón/Castelló;009;Almazora/Almassora;15610;7660;7950
12;Castellón/Castelló;010;Almedíjar;291;141;150
12;Castellón/Castelló;011;Almenara;5042;2499;2543
12;Castellón/Castelló;901;Alquerías del Niño Perdido;3612;1756;1856
12;Castellón/Castelló;012;Altura;3030;1505;1525
12;Castellón/Castelló;013;Arañuel;106;44;62
12;Castellón/Castelló;014;Ares del Maestre;335;165;170
12;Castellón/Castelló;015;Argelita;103;50;53
12;Castellón/Castelló;016;Artana;1899;946;953
12;Castellón/Castelló;001;Atzeneta del Maestrat;1568;785;783
12;Castellón/Castelló;017;Ayódar;218;121;97
12;Castellón/Castelló;018;Azuébar;407;202;205
12;Castellón/Castelló;020;Barracas;173;95;78
12;Castellón/Castelló;022;Bejís;423;219;204
12;Castellón/Castelló;024;Benafer;127;65;62
12;Castellón/Castelló;025;Benafigos;253;139;114
12;Castellón/Castelló;026;Benasal;1444;697;747
12;Castellón/Castelló;027;Benicarló;18550;9101;9449
12;Castellón/Castelló;028;Benicasim/Benicàssim;6640;3326;3314
12;Castellón/Castelló;029;Benlloch;940;490;450
12;Castellón/Castelló;021;Betxí;5316;2702;2614
12;Castellón/Castelló;031;Borriol;2733;1383;1350
12;Castellón/Castelló;032;Burriana;25856;12664;13192
12;Castellón/Castelló;033;Cabanes;2458;1205;1253
12;Castellón/Castelló;034;Càlig;1785;875;910
12;Castellón/Castelló;036;Canet lo Roig;1024;503;521
12;Castellón/Castelló;037;Castell de Cabres;24;12;12
12;Castellón/Castelló;038;Castellfort;271;142;129
12;Castellón/Castelló;039;Castellnovo;1076;536;540
12;Castellón/Castelló;040;Castellón de la Plana/Castelló de la Plana;135069;65828;69241
12;Castellón/Castelló;041;Castillo de Villamalefa;139;71;68
12;Castellón/Castelló;042;Catí;931;472;459
12;Castellón/Castelló;043;Caudiel;704;349;355
12;Castellón/Castelló;044;Cervera del Maestre;779;380;399
12;Castellón/Castelló;052;Chert/Xert;1030;502;528
12;Castellón/Castelló;053;Chilches/Xilxes;2144;1083;1061
12;Castellón/Castelló;055;Chodos/Xodos;162;89;73
12;Castellón/Castelló;056;Chóvar;419;216;203
12;Castellón/Castelló;045;Cinctorres;605;276;329
12;Castellón/Castelló;046;Cirat;306;152;154
12;Castellón/Castelló;048;Cortes de Arenoso;425;230;195
12;Castellón/Castelló;049;Costur;482;240;242
12;Castellón/Castelló;050;Coves de Vinromà (les);1903;940;963
12;Castellón/Castelló;051;Culla;946;464;482
12;Castellón/Castelló;057;Eslida;842;412;430
12;Castellón/Castelló;058;Espadilla;80;34;46
12;Castellón/Castelló;059;Fanzara;296;142;154
12;Castellón/Castelló;060;Figueroles;588;291;297
12;Castellón/Castelló;061;Forcall;605;288;317
12;Castellón/Castelló;063;Fuente la Reina;34;18;16
12;Castellón/Castelló;064;Fuentes de Ayódar;80;42;38
12;Castellón/Castelló;065;Gaibiel;224;118;106
12;Castellón/Castelló;066;Gatova;495;245;250
12;Castellón/Castelló;067;Geldo;711;353;358
12;Castellón/Castelló;068;Herbés;134;66;68
12;Castellón/Castelló;069;Higueras;33;18;15
12;Castellón/Castelló;070;Jana (La);921;457;464
12;Castellón/Castelló;071;Jérica;1629;840;789
12;Castellón/Castelló;074;Llosa (La);951;472;479
12;Castellón/Castelló;072;Lucena del Cid;1656;808;848
12;Castellón/Castelló;073;Ludiente;261;131;130
12;Castellón/Castelló;075;Mata de Morella (La);221;104;117
12;Castellón/Castelló;076;Matet;138;70;68
12;Castellón/Castelló;077;Moncofa;3613;1825;1788
12;Castellón/Castelló;078;Montán;361;180;181
12;Castellón/Castelló;079;Montanejos;417;209;208
12;Castellón/Castelló;080;Morella;2850;1382;1468
12;Castellón/Castelló;081;Navajas;456;221;235
12;Castellón/Castelló;082;Nules;11536;5729;5807
12;Castellón/Castelló;083;Olocau del Rey;163;92;71
12;Castellón/Castelló;084;Onda;18047;9030;9017
12;Castellón/Castelló;085;Oropesa del Mar/Orpesa;2443;1244;1199
12;Castellón/Castelló;087;Palanques;23;14;9
12;Castellón/Castelló;088;Pavías;63;37;26
12;Castellón/Castelló;089;Peñíscola;3609;1800;1809
12;Castellón/Castelló;090;Pina de Montalgrao;201;109;92
12;Castellón/Castelló;093;Pobla de Benifassà (La);225;109;116
12;Castellón/Castelló;094;Pobla Tornesa (La);512;246;266
12;Castellón/Castelló;091;Portell de Morella;295;148;147
12;Castellón/Castelló;092;Puebla de Arenoso;205;104;101
12;Castellón/Castelló;095;Ribesalbes;1317;648;669
12;Castellón/Castelló;096;Rossell;1231;618;613
12;Castellón/Castelló;097;Sacañet;122;58;64
12;Castellón/Castelló;098;Salzadella (La);871;423;448
12;Castellón/Castelló;101;San Rafael del Río;494;248;246
12;Castellón/Castelló;902;Sant Joan de Moró;1605;820;785
12;Castellón/Castelló;099;Sant Jordi/San Jorge;561;269;292
12;Castellón/Castelló;100;Sant Mateu;1814;877;937
12;Castellón/Castelló;102;Santa Magdalena de Pulpis;742;379;363
12;Castellón/Castelló;103;Sarratella;108;62;46
12;Castellón/Castelló;104;Segorbe;7519;3682;3837
12;Castellón/Castelló;105;Sierra Engarcerán;1144;600;544
12;Castellón/Castelló;106;Soneja;1432;717;715
12;Castellón/Castelló;107;Sot de Ferrer;413;208;205
12;Castellón/Castelló;108;Sueras/Suera;592;298;294
12;Castellón/Castelló;109;Tales;789;387;402
12;Castellón/Castelló;110;Teresa;389;200;189
12;Castellón/Castelló;111;Tírig;624;303;321
12;Castellón/Castelló;112;Todolella;150;87;63
12;Castellón/Castelló;113;Toga;110;48;62
12;Castellón/Castelló;114;Torás;305;158;147
12;Castellón/Castelló;115;Toro (El);304;158;146
12;Castellón/Castelló;116;Torralba del Pinar;66;33;33
12;Castellón/Castelló;119;Torre d'En Besora (La);237;126;111
12;Castellón/Castelló;120;Torre Endoménech;282;139;143
12;Castellón/Castelló;117;Torreblanca;4626;2316;2310
12;Castellón/Castelló;118;Torrechiva;63;37;26
12;Castellón/Castelló;121;Traiguera;1637;838;799
12;Castellón/Castelló;122;Useras/Useres (Les);1140;580;560
12;Castellón/Castelló;124;Vall d'Alba;1887;946;941
12;Castellón/Castelló;125;Vall de Almonacid;273;134;139
12;Castellón/Castelló;126;Vall d'Uixó (La);28314;14080;14234
12;Castellón/Castelló;123;Vallat;34;16;18
12;Castellón/Castelló;127;Vallibona;110;55;55
12;Castellón/Castelló;128;Vilafamés;1408;731;677
12;Castellón/Castelló;132;Vilanova d'Alcolea;717;361;356
12;Castellón/Castelló;134;Vilar de Canes;196;95;101
12;Castellón/Castelló;129;Villafranca del Cid;2769;1316;1453
12;Castellón/Castelló;130;Villahermosa del Río;511;277;234
12;Castellón/Castelló;131;Villamalur;151;79;72
12;Castellón/Castelló;133;Villanueva de Viver;115;58;57
12;Castellón/Castelló;135;Villarreal/Vila-real;38207;18934;19273
12;Castellón/Castelló;136;Villavieja;3443;1696;1747
12;Castellón/Castelló;137;Villores;92;46;46
12;Castellón/Castelló;138;Vinaròs;20149;9830;10319
12;Castellón/Castelló;139;Vistabella del Maestrazgo;530;256;274
12;Castellón/Castelló;140;Viver;1208;612;596
12;Castellón/Castelló;141;Zorita del Maestrazgo;157;79;78
12;Castellón/Castelló;142;Zucaina;237;131;106
13;Ciudad Real;001;Abenójar;2012;1001;1011
13;Ciudad Real;002;Agudo;2259;1143;1116
13;Ciudad Real;003;Alamillo;736;369;367
13;Ciudad Real;004;Albaladejo;1904;933;971
13;Ciudad Real;005;Alcázar de San Juan;26092;12743;13349
13;Ciudad Real;006;Alcoba;836;427;409
13;Ciudad Real;007;Alcolea de Calatrava;1608;806;802
13;Ciudad Real;008;Alcubillas;780;378;402
13;Ciudad Real;009;Aldea del Rey;2390;1156;1234
13;Ciudad Real;010;Alhambra;1414;715;699
13;Ciudad Real;011;Almadén;8151;3965;4186
13;Ciudad Real;012;Almadenejos;669;354;315
13;Ciudad Real;013;Almagro;8472;4091;4381
13;Ciudad Real;014;Almedina;877;429;448
13;Ciudad Real;015;Almodóvar del Campo;7708;3836;3872
13;Ciudad Real;016;Almuradiel;852;410;442
13;Ciudad Real;017;Anchuras;487;258;229
13;Ciudad Real;903;Arenales de San Gregorio;"";"";""
13;Ciudad Real;018;Arenas de San Juan;1066;538;528
13;Ciudad Real;019;Argamasilla de Alba;6564;3232;3332
13;Ciudad Real;020;Argamasilla de Calatrava;5518;2765;2753
13;Ciudad Real;021;Arroba de los Montes;714;377;337
13;Ciudad Real;022;Ballesteros de Calatrava;646;322;324
13;Ciudad Real;023;Bolaños de Calatrava;10311;5141;5170
13;Ciudad Real;024;Brazatortas;1353;673;680
13;Ciudad Real;025;Cabezarados;415;214;201
13;Ciudad Real;026;Cabezarrubias del Puerto;766;394;372
13;Ciudad Real;027;Calzada de Calatrava;5065;2455;2610
13;Ciudad Real;028;Campo de Criptana;13863;6770;7093
13;Ciudad Real;029;Cañada de Calatrava;99;58;41
13;Ciudad Real;030;Caracuel de Calatrava;189;99;90
13;Ciudad Real;031;Carrión de Calatrava;2480;1207;1273
13;Ciudad Real;032;Carrizosa;1779;897;882
13;Ciudad Real;033;Castellar de Santiago;2338;1124;1214
13;Ciudad Real;038;Chillón;2589;1252;1337
13;Ciudad Real;034;Ciudad Real;57807;27473;30334
13;Ciudad Real;035;Corral de Calatrava;1376;689;687
13;Ciudad Real;036;Cortijos (Los);1077;529;548
13;Ciudad Real;037;Cózar;1489;721;768
13;Ciudad Real;039;Daimiel;16790;8161;8629
13;Ciudad Real;040;Fernán Caballero;1034;491;543
13;Ciudad Real;041;Fontanarejo;441;231;210
13;Ciudad Real;042;Fuencaliente;1375;744;631
13;Ciudad Real;043;Fuenllana;352;154;198
13;Ciudad Real;044;Fuente el Fresno;3534;1715;1819
13;Ciudad Real;045;Granátula de Calatrava;1060;509;551
13;Ciudad Real;046;Guadalmez;1105;564;541
13;Ciudad Real;047;Herencia;6910;3459;3451
13;Ciudad Real;048;Hinojosas de Calatrava;916;441;475
13;Ciudad Real;049;Horcajo de los Montes;1100;567;533
13;Ciudad Real;050;Labores (Las);691;337;354
13;Ciudad Real;904;Llanos del Caudillo;"";"";""
13;Ciudad Real;051;Luciana;489;252;237
13;Ciudad Real;052;Malagón;7909;3889;4020
13;Ciudad Real;053;Manzanares;18036;8799;9237
13;Ciudad Real;054;Membrilla;6745;3341;3404
13;Ciudad Real;055;Mestanza;1081;536;545
13;Ciudad Real;056;Miguelturra;7320;3612;3708
13;Ciudad Real;057;Montiel;1766;871;895
13;Ciudad Real;058;Moral de Calatrava;5223;2520;2703
13;Ciudad Real;059;Navalpino;373;184;189
13;Ciudad Real;060;Navas de Estena;440;237;203
13;Ciudad Real;061;Pedro Muñoz;7127;3537;3590
13;Ciudad Real;062;Picón;610;322;288
13;Ciudad Real;063;Piedrabuena;5255;2644;2611
13;Ciudad Real;064;Poblete;652;333;319
13;Ciudad Real;065;Porzuna;3913;1927;1986
13;Ciudad Real;066;Pozuelo de Calatrava;2386;1168;1218
13;Ciudad Real;067;Pozuelos de Calatrava (Los);636;319;317
13;Ciudad Real;068;Puebla de Don Rodrigo;1384;707;677
13;Ciudad Real;069;Puebla del Príncipe;1094;551;543
13;Ciudad Real;070;Puerto Lápice;1017;497;520
13;Ciudad Real;071;Puertollano;51501;25092;26409
13;Ciudad Real;072;Retuerta del Bullaque;1107;565;542
13;Ciudad Real;901;Robledo (El);1126;590;536
13;Ciudad Real;902;Ruidera;621;331;290
13;Ciudad Real;073;Saceruela;820;420;400
13;Ciudad Real;074;San Carlos del Valle;1295;651;644
13;Ciudad Real;075;San Lorenzo de Calatrava;379;195;184
13;Ciudad Real;076;Santa Cruz de los Cáñamos;672;335;337
13;Ciudad Real;077;Santa Cruz de Mudela;4923;2377;2546
13;Ciudad Real;078;Socuéllamos;11456;5592;5864
13;Ciudad Real;080;Solana del Pino;695;346;349
13;Ciudad Real;079;Solana (La);14268;7105;7163
13;Ciudad Real;081;Terrinches;1085;522;563
13;Ciudad Real;082;Tomelloso;28770;14109;14661
13;Ciudad Real;083;Torralba de Calatrava;3051;1480;1571
13;Ciudad Real;084;Torre de Juan Abad;1809;908;901
13;Ciudad Real;085;Torrenueva;3215;1604;1611
13;Ciudad Real;086;Valdemanco del Esteras;344;174;170
13;Ciudad Real;087;Valdepeñas;25610;12398;13212
13;Ciudad Real;088;Valenzuela de Calatrava;827;401;426
13;Ciudad Real;089;Villahermosa;2948;1380;1568
13;Ciudad Real;090;Villamanrique;1883;936;947
13;Ciudad Real;091;Villamayor de Calatrava;797;387;410
13;Ciudad Real;092;Villanueva de la Fuente;2968;1484;1484
13;Ciudad Real;093;Villanueva de los Infantes;6126;2936;3190
13;Ciudad Real;094;Villanueva de San Carlos;575;287;288
13;Ciudad Real;095;Villar del Pozo;103;55;48
13;Ciudad Real;096;Villarrubia de los Ojos;9582;4795;4787
13;Ciudad Real;097;Villarta de San Juan;2986;1496;1490
13;Ciudad Real;098;Viso del Marqués;3288;1612;1676
14;Córdoba;001;Adamuz;4537;2259;2278
14;Córdoba;002;Aguilar de la Frontera;13198;6540;6658
14;Córdoba;003;Alcaracejos;1505;758;747
14;Córdoba;004;Almedinilla;2585;1283;1302
14;Córdoba;005;Almodóvar del Río;7133;3558;3575
14;Córdoba;006;Añora;1641;813;828
14;Córdoba;007;Baena;20402;10038;10364
14;Córdoba;008;Belalcázar;4150;2005;2145
14;Córdoba;009;Belmez;4344;2068;2276
14;Córdoba;010;Benamejí;4584;2271;2313
14;Córdoba;011;Blázquez (Los);752;379;373
14;Córdoba;012;Bujalance;8627;4226;4401
14;Córdoba;013;Cabra;20417;9958;10459
14;Córdoba;015;Carcabuey;2940;1449;1491
14;Córdoba;016;Cardeña;2129;1060;1069
14;Córdoba;017;Carlota (La);9303;4641;4662
14;Córdoba;018;Carpio (El);4668;2299;2369
14;Córdoba;019;Castro del Río;7967;3888;4079
14;Córdoba;014;Cañete de las Torres;3453;1720;1733
14;Córdoba;020;Conquista;541;271;270
14;Córdoba;021;Córdoba;305086;147128;157958
14;Córdoba;023;Dos Torres;2523;1231;1292
14;Córdoba;022;Doña Mencía;5105;2520;2585
14;Córdoba;024;Encinas Reales;2313;1130;1183
14;Córdoba;025;Espejo;5074;2521;2553
14;Córdoba;026;Espiel;2601;1310;1291
14;Córdoba;027;Fernán-Núñez;9425;4684;4741
14;Córdoba;029;Fuente Obejuna;6366;3208;3158
14;Córdoba;030;Fuente Palmera;9473;4805;4668
14;Córdoba;028;Fuente la Lancha;483;238;245
14;Córdoba;031;Fuente-Tójar;901;438;463
14;Córdoba;032;Granjuela (La);536;280;256
14;Córdoba;033;Guadalcázar;1145;589;556
14;Córdoba;034;Guijo (El);436;223;213
14;Córdoba;035;Hinojosa del Duque;8212;3923;4289
14;Córdoba;036;Hornachuelos;5103;2626;2477
14;Córdoba;037;Iznájar;5689;2847;2842
14;Córdoba;038;Lucena;32557;16175;16382
14;Córdoba;039;Luque;3402;1669;1733
14;Córdoba;040;Montalbán de Córdoba;4539;2275;2264
14;Córdoba;041;Montemayor;3698;1853;1845
14;Córdoba;042;Montilla;22581;11164;11417
14;Córdoba;043;Montoro;9739;4786;4953
14;Córdoba;044;Monturque;1975;1002;973
14;Córdoba;045;Moriles;3693;1834;1859
14;Córdoba;046;Nueva Carteya;5757;2865;2892
14;Córdoba;047;Obejo;1484;731;753
14;Córdoba;048;Palenciana;1696;855;841
14;Córdoba;049;Palma del Río;18804;9384;9420
14;Córdoba;050;Pedro Abad;3014;1497;1517
14;Córdoba;051;Pedroche;1898;921;977
14;Córdoba;052;Peñarroya-Pueblonuevo;14035;6729;7306
14;Córdoba;053;Posadas;7129;3554;3575
14;Córdoba;054;Pozoblanco;15436;7401;8035
14;Córdoba;055;Priego de Córdoba;21456;10543;10913
14;Córdoba;056;Puente Genil;26703;13074;13629
14;Córdoba;057;Rambla (La);6945;3434;3511
14;Córdoba;058;Rute;10067;4895;5172
14;Córdoba;059;San Sebastián de los Ballesteros;824;425;399
14;Córdoba;061;Santa Eufemia;1261;642;619
14;Córdoba;060;Santaella;5796;2908;2888
14;Córdoba;062;Torrecampo;1559;753;806
14;Córdoba;063;Valenzuela;1573;744;829
14;Córdoba;064;Valsequillo;559;273;286
14;Córdoba;065;Victoria (La);1727;853;874
14;Córdoba;066;Villa del Río;7055;3559;3496
14;Córdoba;067;Villafranca de Córdoba;3617;1866;1751
14;Córdoba;068;Villaharta;646;313;333
14;Córdoba;069;Villanueva de Córdoba;10393;5056;5337
14;Córdoba;070;Villanueva del Duque;2033;940;1093
14;Córdoba;071;Villanueva del Rey;1312;685;627
14;Córdoba;072;Villaralto;1732;821;911
14;Córdoba;073;Villaviciosa de Córdoba;3978;2025;1953
14;Córdoba;074;Viso (El);3435;1664;1771
14;Córdoba;075;Zuheros;964;467;497
15;Coruña (A);001;Abegondo;5475;2720;2755
15;Coruña (A);002;Ames;10203;4941;5262
15;Coruña (A);003;Aranga;2510;1240;1270
15;Coruña (A);004;Ares;4525;2205;2320
15;Coruña (A);005;Arteixo;17931;9003;8928
15;Coruña (A);006;Arzúa;6982;3461;3521
15;Coruña (A);007;Baña (A);5851;2825;3026
15;Coruña (A);008;Bergondo;5418;2631;2787
15;Coruña (A);009;Betanzos;11964;5653;6311
15;Coruña (A);010;Boimorto;3000;1535;1465
15;Coruña (A);011;Boiro;17762;8705;9057
15;Coruña (A);012;Boqueixón;4221;2068;2153
15;Coruña (A);013;Brión;6370;3039;3331
15;Coruña (A);014;Cabana de Bergantiños;6354;3151;3203
15;Coruña (A);015;Cabanas;3119;1507;1612
15;Coruña (A);016;Camariñas;7436;3697;3739
15;Coruña (A);017;Cambre;12473;6053;6420
15;Coruña (A);018;Capela (A);1743;868;875
15;Coruña (A);019;Carballo;26418;13024;13394
15;Coruña (A);901;Cariño;5563;2742;2821
15;Coruña (A);020;Carnota;6783;3278;3505
15;Coruña (A);021;Carral;5216;2555;2661
15;Coruña (A);022;Cedeira;7696;3764;3932
15;Coruña (A);023;Cee;7246;3508;3738
15;Coruña (A);024;Cerceda;7045;3449;3596
15;Coruña (A);025;Cerdido;1900;916;984
15;Coruña (A);026;Cesuras;2956;1455;1501
15;Coruña (A);027;Coirós;1598;786;812
15;Coruña (A);028;Corcubión;2106;1020;1086
15;Coruña (A);029;Coristanco;9324;4669;4655
15;Coruña (A);030;A Coruña;248001;116380;131621
15;Coruña (A);031;Culleredo;14970;7291;7679
15;Coruña (A);032;Curtis;4637;2274;2363
15;Coruña (A);033;Dodro;3501;1698;1803
15;Coruña (A);034;Dumbría;4997;2441;2556
15;Coruña (A);035;Fene;15001;7352;7649
15;Coruña (A);036;Ferrol;82950;38967;43983
15;Coruña (A);037;Fisterra;5484;2758;2726
15;Coruña (A);038;Frades;3322;1681;1641
15;Coruña (A);039;Irixoa;1911;934;977
15;Coruña (A);041;Laracha (A);10563;5233;5330
15;Coruña (A);040;Laxe;3492;1736;1756
15;Coruña (A);042;Lousame;4680;2269;2411
15;Coruña (A);043;Malpica de Bergantiños;7933;3911;4022
15;Coruña (A);045;Mazaricos;7004;3384;3620
15;Coruña (A);044;Mañón;2222;1069;1153
15;Coruña (A);046;Melide;8330;4129;4201
15;Coruña (A);047;Mesía;3692;1851;1841
15;Coruña (A);048;Miño;5068;2422;2646
15;Coruña (A);049;Moeche;1746;841;905
15;Coruña (A);050;Monfero;2986;1531;1455
15;Coruña (A);051;Mugardos;6660;3213;3447
15;Coruña (A);053;Muros;11256;5399;5857
15;Coruña (A);052;Muxía;6729;3281;3448
15;Coruña (A);054;Narón;31692;15512;16180
15;Coruña (A);055;Neda;6457;3123;3334
15;Coruña (A);056;Negreira;6652;3133;3519
15;Coruña (A);057;Noia;14903;7199;7704
15;Coruña (A);058;Oleiros;18741;9054;9687
15;Coruña (A);059;Ordes;11746;5709;6037
15;Coruña (A);060;Oroso;3824;1872;1952
15;Coruña (A);061;Ortigueira;9939;4799;5140
15;Coruña (A);062;Outes;9257;4386;4871
15;Coruña (A);063;Oza dos Ríos;3333;1604;1729
15;Coruña (A);064;Paderne;2870;1364;1506
15;Coruña (A);065;Padrón;10092;4855;5237
15;Coruña (A);066;Pino (O);5281;2640;2641
15;Coruña (A);067;Pobra do Caramiñal (A);10372;4977;5395
15;Coruña (A);068;Ponteceso;8001;4021;3980
15;Coruña (A);069;Pontedeume;8817;4238;4579
15;Coruña (A);070;Pontes de García Rodríguez (As);13385;6745;6640
15;Coruña (A);071;Porto do Son;10735;5236;5499
15;Coruña (A);072;Rianxo;12767;6325;6442
15;Coruña (A);073;Ribeira;25537;12536;13001
15;Coruña (A);074;Rois;5644;2744;2900
15;Coruña (A);075;Sada;9148;4410;4738
15;Coruña (A);076;San Sadurniño;3785;1872;1913
15;Coruña (A);077;Santa Comba;11423;5549;5874
15;Coruña (A);078;Santiago de Compostela;88265;41543;46722
15;Coruña (A);079;Santiso;2486;1293;1193
15;Coruña (A);080;Sobrado;2894;1500;1394
15;Coruña (A);081;Somozas (As);1657;840;817
15;Coruña (A);082;Teo;12689;6171;6518
15;Coruña (A);083;Toques;1955;1016;939
15;Coruña (A);084;Tordoia;5854;2810;3044
15;Coruña (A);085;Touro;5016;2464;2552
15;Coruña (A);086;Trazo;4274;2124;2150
15;Coruña (A);088;Val do Dubra;5370;2630;2740
15;Coruña (A);087;Valdoviño;6978;3476;3502
15;Coruña (A);089;Vedra;5061;2434;2627
15;Coruña (A);091;Vilarmaior;1441;711;730
15;Coruña (A);090;Vilasantar;1871;963;908
15;Coruña (A);092;Vimianzo;9644;4783;4861
15;Coruña (A);093;Zas;6641;3256;3385
16;Cuenca;001;Abia de la Obispalía;114;62;52
16;Cuenca;002;Acebrón (El);317;158;159
16;Cuenca;003;Alarcón;227;115;112
16;Cuenca;004;Albaladejo del Cuende;461;250;211
16;Cuenca;005;Albalate de las Nogueras;413;221;192
16;Cuenca;006;Albendea;209;106;103
16;Cuenca;007;Alberca de Záncara (La);1882;935;947
16;Cuenca;008;Alcalá de la Vega;178;93;85
16;Cuenca;009;Alcantud;158;84;74
16;Cuenca;011;Alcohujate;72;37;35
16;Cuenca;012;Alconchel de la Estrella;252;128;124
16;Cuenca;010;Alcázar del Rey;281;143;138
16;Cuenca;013;Algarra;36;19;17
16;Cuenca;014;Aliaguilla;938;490;448
16;Cuenca;015;Almarcha (La);695;348;347
16;Cuenca;016;Almendros;417;203;214
16;Cuenca;017;Almodóvar del Pinar;591;304;287
16;Cuenca;018;Almonacid del Marquesado;592;305;287
16;Cuenca;019;Altarejos;398;201;197
16;Cuenca;020;Arandilla del Arroyo;55;26;29
16;Cuenca;905;Arcas del Villar;406;201;205
16;Cuenca;022;Arcos de la Sierra;134;73;61
16;Cuenca;024;Arguisuelas;214;110;104
16;Cuenca;025;Arrancacepas;40;21;19
16;Cuenca;026;Atalaya del Cañavate;143;67;76
16;Cuenca;027;Barajas de Melo;720;356;364
16;Cuenca;029;Barchín del Hoyo;152;83;69
16;Cuenca;030;Bascuñana de San Pedro;42;23;19
16;Cuenca;031;Beamud;103;56;47
16;Cuenca;032;Belinchón;324;160;164
16;Cuenca;033;Belmonte;2668;1235;1433
16;Cuenca;034;Belmontejo;290;147;143
16;Cuenca;035;Beteta;443;222;221
16;Cuenca;036;Boniches;203;102;101
16;Cuenca;038;Buciegas;102;51;51
16;Cuenca;039;Buenache de Alarcón;652;345;307
16;Cuenca;040;Buenache de la Sierra;112;66;46
16;Cuenca;041;Buendía;492;250;242
16;Cuenca;042;Campillo de Altobuey;1760;872;888
16;Cuenca;043;Campillos-Paravientos;166;86;80
16;Cuenca;044;Campillos-Sierra;95;51;44
16;Cuenca;901;Campos del Paraíso;1335;628;707
16;Cuenca;045;Canalejas del Arroyo;393;208;185
16;Cuenca;055;Carboneras de Guadazaón;1032;552;480
16;Cuenca;056;Cardenete;666;346;320
16;Cuenca;057;Carrascosa;139;74;65
16;Cuenca;058;Carrascosa de Haro;165;82;83
16;Cuenca;060;Casas de Benítez;1140;566;574
16;Cuenca;061;Casas de Fernando Alonso;1414;685;729
16;Cuenca;062;Casas de Garcimolina;48;21;27
16;Cuenca;063;Casas de Guijarro;185;93;92
16;Cuenca;064;Casas de Haro;897;449;448
16;Cuenca;065;Casas de los Pinos;578;281;297
16;Cuenca;066;Casasimarro;3059;1558;1501
16;Cuenca;067;Castejón;262;136;126
16;Cuenca;068;Castillejo de Iniesta;190;107;83
16;Cuenca;070;Castillejo-Sierra;66;30;36
16;Cuenca;072;Castillo de Garcimuñoz;314;161;153
16;Cuenca;071;Castillo-Albaráñez;35;18;17
16;Cuenca;047;Cañada Juncosa;423;221;202
16;Cuenca;046;Cañada del Hoyo;426;220;206
16;Cuenca;048;Cañamares;626;333;293
16;Cuenca;049;Cañavate (El);306;153;153
16;Cuenca;050;Cañaveras;438;223;215
16;Cuenca;051;Cañaveruelas;268;136;132
16;Cuenca;052;Cañete;810;403;407
16;Cuenca;053;Cañizares;660;340;320
16;Cuenca;073;Cervera del Llano;351;180;171
16;Cuenca;023;Chillarón de Cuenca;314;162;152
16;Cuenca;081;Chumillas;48;30;18
16;Cuenca;074;Cierva (La);58;32;26
16;Cuenca;078;Cuenca;43356;20876;22480
16;Cuenca;079;Cueva del Hierro;53;32;21
16;Cuenca;082;Enguídanos;648;337;311
16;Cuenca;083;Fresneda de Altarejos;90;52;38
16;Cuenca;084;Fresneda de la Sierra;87;42;45
16;Cuenca;085;Frontera (La);279;136;143
16;Cuenca;086;Fuente de Pedro Naharro;1249;625;624
16;Cuenca;087;Fuentelespino de Haro;411;218;193
16;Cuenca;088;Fuentelespino de Moya;156;76;80
16;Cuenca;904;Fuentenava de Jábaga;232;125;107
16;Cuenca;089;Fuentes;560;293;267
16;Cuenca;091;Fuertescusa;125;62;63
16;Cuenca;092;Gabaldón;202;110;92
16;Cuenca;093;Garaballa;172;89;83
16;Cuenca;094;Gascueña;194;91;103
16;Cuenca;095;Graja de Campalbo;145;81;64
16;Cuenca;096;Graja de Iniesta;348;185;163
16;Cuenca;097;Henarejos;363;175;188
16;Cuenca;098;Herrumblar (El);801;414;387
16;Cuenca;099;Hinojosa (La);400;201;199
16;Cuenca;100;Hinojosos (Los);1233;619;614
16;Cuenca;101;Hito (El);275;138;137
16;Cuenca;102;Honrubia;1710;851;859
16;Cuenca;103;Hontanaya;564;275;289
16;Cuenca;104;Hontecillas;107;48;59
16;Cuenca;106;Horcajo de Santiago;3632;1813;1819
16;Cuenca;108;Huelves;78;36;42
16;Cuenca;110;Huerta de la Obispalía;183;105;78
16;Cuenca;111;Huerta del Marquesado;198;105;93
16;Cuenca;112;Huete;2442;1242;1200
16;Cuenca;107;Huélamo;138;73;65
16;Cuenca;109;Huérguina;95;52;43
16;Cuenca;113;Iniesta;3654;1816;1838
16;Cuenca;115;Laguna del Marquesado;70;38;32
16;Cuenca;116;Lagunaseca;103;51;52
16;Cuenca;117;Landete;1658;822;836
16;Cuenca;118;Ledaña;2052;1029;1023
16;Cuenca;119;Leganiel;291;140;151
16;Cuenca;121;Majadas (Las);409;214;195
16;Cuenca;122;Mariana;310;151;159
16;Cuenca;123;Masegosa;141;73;68
16;Cuenca;124;Mesas (Las);2626;1344;1282
16;Cuenca;125;Minglanilla;2343;1183;1160
16;Cuenca;126;Mira;1180;596;584
16;Cuenca;128;Monreal del Llano;100;52;48
16;Cuenca;129;Montalbanejo;238;114;124
16;Cuenca;130;Montalbo;871;463;408
16;Cuenca;131;Monteagudo de las Salinas;131;71;60
16;Cuenca;132;Mota de Altarejos;75;44;31
16;Cuenca;133;Mota del Cuervo;5581;2762;2819
16;Cuenca;134;Motilla del Palancar;4876;2441;2435
16;Cuenca;135;Moya;316;168;148
16;Cuenca;137;Narboneta;99;52;47
16;Cuenca;139;Olivares de Júcar;668;338;330
16;Cuenca;140;Olmeda de la Cuesta;52;28;24
16;Cuenca;141;Olmeda del Rey;270;125;145
16;Cuenca;142;Olmedilla de Alarcón;255;133;122
16;Cuenca;143;Olmedilla de Eliz;38;21;17
16;Cuenca;145;Osa de la Vega;732;375;357
16;Cuenca;147;Pajaroncillo;93;49;44
16;Cuenca;146;Pajarón;164;85;79
16;Cuenca;148;Palomares del Campo;1073;526;547
16;Cuenca;149;Palomera;167;81;86
16;Cuenca;150;Paracuellos;185;90;95
16;Cuenca;151;Paredes;78;44;34
16;Cuenca;152;Parra de las Vegas (La);68;31;37
16;Cuenca;153;Pedernoso (El);1408;695;713
16;Cuenca;154;Pedroñeras (Las);6571;3330;3241
16;Cuenca;155;Peral (El);767;394;373
16;Cuenca;156;Peraleja (La);195;103;92
16;Cuenca;157;Pesquera (La);294;153;141
16;Cuenca;158;Picazo (El);721;350;371
16;Cuenca;159;Pinarejo;619;320;299
16;Cuenca;160;Pineda de Gigüela;200;107;93
16;Cuenca;161;Piqueras del Castillo;91;50;41
16;Cuenca;162;Portalrubio de Guadamejud;117;56;61
16;Cuenca;163;Portilla;110;55;55
16;Cuenca;165;Poyatos;135;73;62
16;Cuenca;166;Pozoamargo;353;167;186
16;Cuenca;908;Pozorrubielos de la Mancha;309;158;151
16;Cuenca;167;Pozorrubio;556;266;290
16;Cuenca;169;Pozuelo (El);111;55;56
16;Cuenca;170;Priego;1123;575;548
16;Cuenca;171;Provencio (El);2725;1355;1370
16;Cuenca;172;Puebla de Almenara;665;339;326
16;Cuenca;173;Puebla de Don Francisco;425;223;202
16;Cuenca;174;Puebla del Salvador;326;181;145
16;Cuenca;175;Quintanar del Rey;5892;2987;2905
16;Cuenca;176;Rada de Haro;67;33;34
16;Cuenca;177;Reíllo;167;79;88
16;Cuenca;181;Rozalén del Monte;154;72;82
16;Cuenca;185;Saceda-Trasierra;46;20;26
16;Cuenca;186;Saelices;813;410;403
16;Cuenca;187;Salinas del Manzano;150;82;68
16;Cuenca;188;Salmeroncillos;168;92;76
16;Cuenca;189;Salvacañete;369;203;166
16;Cuenca;190;San Clemente;6192;3038;3154
16;Cuenca;191;San Lorenzo de la Parrilla;1684;856;828
16;Cuenca;192;San Martín de Boniches;98;49;49
16;Cuenca;193;San Pedro Palmiches;122;65;57
16;Cuenca;194;Santa Cruz de Moya;434;224;210
16;Cuenca;196;Santa María de los Llanos;908;451;457
16;Cuenca;195;Santa María del Campo Rus;948;467;481
16;Cuenca;197;Santa María del Val;135;72;63
16;Cuenca;198;Sisante;1872;952;920
16;Cuenca;199;Solera de Gabaldón;42;25;17
16;Cuenca;909;Sotorribas;1008;511;497
16;Cuenca;202;Talayuelas;1255;648;607
16;Cuenca;203;Tarancón;11122;5488;5634
16;Cuenca;205;Tejadillos;215;104;111
16;Cuenca;206;Tinajas;423;230;193
16;Cuenca;209;Torralba;240;115;125
16;Cuenca;211;Torrejoncillo del Rey;827;399;428
16;Cuenca;212;Torrubia del Campo;374;168;206
16;Cuenca;213;Torrubia del Castillo;53;28;25
16;Cuenca;215;Tragacete;426;230;196
16;Cuenca;216;Tresjuncos;596;302;294
16;Cuenca;217;Tribaldos;156;77;79
16;Cuenca;204;Tébar;457;246;211
16;Cuenca;218;Uclés;301;147;154
16;Cuenca;219;Uña;164;85;79
16;Cuenca;906;Valdecolmenas (Los);163;81;82
16;Cuenca;224;Valdemeca;106;60;46
16;Cuenca;225;Valdemorillo de la Sierra;105;53;52
16;Cuenca;227;Valdemoro-Sierra;201;117;84
16;Cuenca;228;Valdeolivas;322;171;151
16;Cuenca;902;Valdetórtola;170;94;76
16;Cuenca;903;Valeras (Las);1427;712;715
16;Cuenca;231;Valhermoso de la Fuente;70;34;36
16;Cuenca;234;Valsalobre;69;34;35
16;Cuenca;236;Valverde de Júcar;1502;747;755
16;Cuenca;237;Valverdejo;162;82;80
16;Cuenca;238;Vara de Rey;805;397;408
16;Cuenca;239;Vega del Codorno;279;139;140
16;Cuenca;240;Vellisca;214;100;114
16;Cuenca;242;Villaconejos de Trabaque;574;292;282
16;Cuenca;243;Villaescusa de Haro;624;317;307
16;Cuenca;244;Villagarcía del Llano;1014;516;498
16;Cuenca;245;Villalba de la Sierra;541;272;269
16;Cuenca;246;Villalba del Rey;803;408;395
16;Cuenca;247;Villalgordo del Marquesado;185;90;95
16;Cuenca;248;Villalpardo;1132;573;559
16;Cuenca;249;Villamayor de Santiago;2945;1455;1490
16;Cuenca;250;Villanueva de Guadamejud;145;75;70
16;Cuenca;251;Villanueva de la Jara;2469;1232;1237
16;Cuenca;253;Villar de Cañas;515;260;255
16;Cuenca;254;Villar de Domingo García;302;156;146
16;Cuenca;263;Villar de Olalla;781;402;379
16;Cuenca;255;Villar de la Encina;263;132;131
16;Cuenca;258;Villar del Humo;509;259;250
16;Cuenca;259;Villar del Infantado;58;33;25
16;Cuenca;910;Villar y Velasco;168;91;77
16;Cuenca;264;Villarejo de Fuentes;903;440;463
16;Cuenca;265;Villarejo de la Peñuela;44;23;21
16;Cuenca;266;Villarejo-Periesteban;587;304;283
16;Cuenca;269;Villares del Saz;868;444;424
16;Cuenca;270;Villarrubio;267;129;138
16;Cuenca;271;Villarta;808;403;405
16;Cuenca;272;Villas de la Ventosa;468;251;217
16;Cuenca;273;Villaverde y Pasaconsol;432;220;212
16;Cuenca;275;Vindel;29;16;13
16;Cuenca;274;Víllora;272;129;143
16;Cuenca;276;Yémeda;40;18;22
16;Cuenca;277;Zafra de Záncara;275;141;134
16;Cuenca;278;Zafrilla;152;79;73
16;Cuenca;279;Zarza de Tajo;315;140;175
16;Cuenca;280;Zarzuela;341;163;178
17;Girona;001;Agullana;670;355;315
17;Girona;002;Aiguaviva;354;178;176
17;Girona;003;Albanyà;113;58;55
17;Girona;004;Albons;471;249;222
17;Girona;006;Alp;918;463;455
17;Girona;007;Amer;2299;1140;1159
17;Girona;008;Anglès;5154;2614;2540
17;Girona;009;Arbúcies;4624;2312;2312
17;Girona;010;Argelaguer;366;181;185
17;Girona;011;Armentera (L');745;362;383
17;Girona;012;Avinyonet de Puigventós;466;229;237
17;Girona;015;Banyoles;13808;6808;7000
17;Girona;016;Bàscara;762;392;370
17;Girona;013;Begur;2818;1414;1404
17;Girona;018;Bellcaire d'Empordà;479;242;237
17;Girona;019;Besalú;2085;1014;1071
17;Girona;020;Bescanó;2871;1450;1421
17;Girona;021;Beuda;131;66;65
17;Girona;022;Bisbal d'Empordà (La);7829;3865;3964
17;Girona;234;Biure;205;103;102
17;Girona;023;Blanes;25928;13073;12855
17;Girona;029;Boadella d'Empordà;209;105;104
17;Girona;024;Bolvir;229;111;118
17;Girona;025;Bordils;1370;685;685
17;Girona;026;Borrassà;476;237;239
17;Girona;027;Breda;3279;1708;1571
17;Girona;028;Brunyola;375;188;187
17;Girona;031;Cabanelles;235;125;110
17;Girona;030;Cabanes;782;408;374
17;Girona;032;Cadaqués;1828;905;923
17;Girona;033;Caldes de Malavella;3186;1560;1626
17;Girona;034;Calonge;5150;2564;2586
17;Girona;035;Camós;609;309;300
17;Girona;036;Campdevànol;3386;1656;1730
17;Girona;037;Campelles;134;69;65
17;Girona;038;Campllong;273;141;132
17;Girona;039;Camprodon;2232;1099;1133
17;Girona;040;Canet d'Adri;468;244;224
17;Girona;041;Cantallops;268;127;141
17;Girona;042;Capmany;400;205;195
17;Girona;044;Cassà de la Selva;7178;3556;3622
17;Girona;046;Castellfollit de la Roca;1025;494;531
17;Girona;047;Castelló d'Empúries;3712;1877;1835
17;Girona;048;Castell-Platja d'Aro;5122;2610;2512
17;Girona;189;Cellera de Ter (La);2075;1007;1068
17;Girona;049;Celrà;2467;1224;1243
17;Girona;050;Cervià de Ter;639;314;325
17;Girona;051;Cistella;213;105;108
17;Girona;054;Colera;446;229;217
17;Girona;055;Colomers;201;97;104
17;Girona;057;Corçà;1083;540;543
17;Girona;056;Cornellà del Terri;1812;918;894
17;Girona;058;Crespià;231;117;114
17;Girona;901;Cruïlles, Monells i Sant Sadurní de l'Heura;1073;541;532
17;Girona;060;Darnius;512;272;240
17;Girona;061;Das;136;74;62
17;Girona;062;Escala (L');5246;2645;2601
17;Girona;063;Espinelves;175;87;88
17;Girona;064;Espolla;398;201;197
17;Girona;065;Esponellà;383;191;192
17;Girona;005;Far d'Empordà (El);398;200;198
17;Girona;066;Figueres;34907;17064;17843
17;Girona;067;Flaçà;924;460;464
17;Girona;068;Foixà;302;150;152
17;Girona;069;Fontanals de Cerdanya;298;150;148
17;Girona;070;Fontanilles;125;70;55
17;Girona;071;Fontcoberta;942;488;454
17;Girona;902;Forallac;1527;759;768
17;Girona;073;Fornells de la Selva;1167;569;598
17;Girona;074;Fortià;505;253;252
17;Girona;075;Garrigàs;305;161;144
17;Girona;076;Garrigoles;151;84;67
17;Girona;077;Garriguella;653;328;325
17;Girona;078;Ger;272;141;131
17;Girona;079;Girona;69570;33450;36120
17;Girona;080;Gombrèn;237;116;121
17;Girona;081;Gualta;266;126;140
17;Girona;082;Guils de Cerdanya;275;141;134
17;Girona;083;Hostalric;2905;1453;1452
17;Girona;084;Isòvol;171;84;87
17;Girona;085;Jafre;360;178;182
17;Girona;086;Jonquera (La);2522;1282;1240
17;Girona;087;Juià;280;138;142
17;Girona;088;Lladó;484;242;242
17;Girona;089;Llagostera;5363;2703;2660
17;Girona;090;Llambilles;430;211;219
17;Girona;091;Llanars;393;199;194
17;Girona;092;Llançà;3557;1789;1768
17;Girona;093;Llers;796;421;375
17;Girona;094;Llívia;851;437;414
17;Girona;095;Lloret de Mar;14991;7532;7459
17;Girona;096;Llosses (Les);418;237;181
17;Girona;102;Maçanet de Cabrenys;685;347;338
17;Girona;103;Maçanet de la Selva;3004;1517;1487
17;Girona;097;Madremanya;179;81;98
17;Girona;098;Maià de Montcal;323;157;166
17;Girona;100;Masarac;262;128;134
17;Girona;101;Massanes;490;258;232
17;Girona;099;Meranges;67;36;31
17;Girona;105;Mieres;339;170;169
17;Girona;106;Mollet de Peralada;180;98;82
17;Girona;107;Molló;367;189;178
17;Girona;109;Montagut i Oix;776;402;374
17;Girona;110;Mont-ras;1390;722;668
17;Girona;111;Navata;666;322;344
17;Girona;112;Ogassa;263;152;111
17;Girona;114;Olot;26788;12839;13949
17;Girona;115;Ordis;301;164;137
17;Girona;116;Osor;494;251;243
17;Girona;117;Palafrugell;17335;8842;8493
17;Girona;118;Palamós;13405;6623;6782
17;Girona;119;Palau de Santa Eulàlia;80;40;40
17;Girona;121;Palau-sator;300;151;149
17;Girona;120;Palau-saverdera;695;348;347
17;Girona;122;Palmerola;"";"";""
17;Girona;123;Palol de Revardit;370;178;192
17;Girona;124;Pals;1689;872;817
17;Girona;125;Pardines;125;67;58
17;Girona;126;Parlavà;334;179;155
17;Girona;128;Pau;354;160;194
17;Girona;129;Pedret i Marzà;130;61;69
17;Girona;130;Pera (La);377;196;181
17;Girona;132;Peralada;1142;584;558
17;Girona;133;Planes d'Hostoles (Les);1795;885;910
17;Girona;134;Planoles;253;135;118
17;Girona;135;Pont de Molins;351;172;179
17;Girona;136;Pontós;189;111;78
17;Girona;137;Porqueres;3086;1538;1548
17;Girona;140;Port de la Selva (El);790;377;413
17;Girona;138;Portbou;1904;942;962
17;Girona;139;Preses (Les);1294;634;660
17;Girona;141;Puigcerdà;6365;3208;3157
17;Girona;142;Quart;2094;1074;1020
17;Girona;043;Queralbs;200;109;91
17;Girona;143;Rabós;133;59;74
17;Girona;144;Regencós;263;147;116
17;Girona;145;Ribes de Freser;2310;1103;1207
17;Girona;146;Riells i Viabrea;1038;526;512
17;Girona;147;Ripoll;11374;5550;5824
17;Girona;148;Riudarenes;1113;560;553
17;Girona;149;Riudaura;372;181;191
17;Girona;150;Riudellots de la Selva;1332;674;658
17;Girona;151;Riumors;201;95;106
17;Girona;152;Roses;10303;5305;4998
17;Girona;153;Rupià;201;102;99
17;Girona;154;Sales de Llierca;54;30;24
17;Girona;155;Salt;21979;11012;10967
17;Girona;157;Sant Andreu Salou;135;74;61
17;Girona;183;Sant Aniol de Finestres;248;126;122
17;Girona;158;Sant Climent Sescebes;430;234;196
17;Girona;159;Sant Feliu de Buixalleu;601;326;275
17;Girona;160;Sant Feliu de Guíxols;16248;7907;8341
17;Girona;161;Sant Feliu de Pallerols;1076;521;555
17;Girona;162;Sant Ferriol;201;108;93
17;Girona;163;Sant Gregori;1895;989;906
17;Girona;164;Sant Hilari Sacalm;4722;2404;2318
17;Girona;165;Sant Jaume de Llierca;772;400;372
17;Girona;167;Sant Joan de les Abadesses;3881;1891;1990
17;Girona;168;Sant Joan de Mollet;312;151;161
17;Girona;185;Sant Joan les Fonts;2821;1396;1425
17;Girona;166;Sant Jordi Desvalls;595;299;296
17;Girona;169;Sant Julià de Ramis;1745;870;875
17;Girona;903;Sant Julià del Llor i Bonmatí;895;436;459
17;Girona;171;Sant Llorenç de la Muga;156;75;81
17;Girona;172;Sant Martí de Llémena;324;172;152
17;Girona;173;Sant Martí Vell;204;111;93
17;Girona;174;Sant Miquel de Campmajor;219;124;95
17;Girona;175;Sant Miquel de Fluvià;549;285;264
17;Girona;176;Sant Mori;146;68;78
17;Girona;177;Sant Pau de Segúries;656;327;329
17;Girona;178;Sant Pere Pescador;1218;621;597
17;Girona;180;Santa Coloma de Farners;8321;4255;4066
17;Girona;181;Santa Cristina d'Aro;1901;1006;895
17;Girona;182;Santa Llogaia d'Àlguema;316;167;149
17;Girona;184;Santa Pau;1385;713;672
17;Girona;186;Sarrià de Ter;3247;1605;1642
17;Girona;187;Saus;693;350;343
17;Girona;188;Selva de Mar (La);167;88;79
17;Girona;190;Serinyà;770;394;376
17;Girona;191;Serra de Daró;186;98;88
17;Girona;192;Setcases;152;82;70
17;Girona;193;Sils;2425;1224;1201
17;Girona;052;Siurana;145;64;81
17;Girona;194;Susqueda;99;52;47
17;Girona;195;Tallada d'Empordà (La);322;161;161
17;Girona;196;Terrades;182;84;98
17;Girona;197;Torrent;181;89;92
17;Girona;198;Torroella de Fluvià;296;165;131
17;Girona;199;Torroella de Montgrí;7139;3620;3519
17;Girona;200;Tortellà;681;344;337
17;Girona;201;Toses;146;87;59
17;Girona;202;Tossa de Mar;3595;1803;1792
17;Girona;204;Ullà;710;354;356
17;Girona;205;Ullastret;262;135;127
17;Girona;203;Ultramort;201;101;100
17;Girona;206;Urús;123;62;61
17;Girona;014;Vajol (La);78;43;35
17;Girona;208;Vall de Bianya (La);1039;515;524
17;Girona;207;Vall d'en Bas (La);2528;1281;1247
17;Girona;170;Vallfogona de Ripollès;257;134;123
17;Girona;209;Vall-llobrega;258;134;124
17;Girona;210;Ventalló;522;267;255
17;Girona;211;Verges;1126;526;600
17;Girona;212;Vidrà;172;91;81
17;Girona;213;Vidreres;3922;1979;1943
17;Girona;214;Vilabertran;798;402;396
17;Girona;215;Vilablareix;1044;518;526
17;Girona;217;Viladamat;386;203;183
17;Girona;216;Viladasens;189;98;91
17;Girona;218;Vilademuls;761;379;382
17;Girona;220;Viladrau;875;437;438
17;Girona;221;Vilafant;2937;1470;1467
17;Girona;223;Vilajuïga;586;283;303
17;Girona;224;Vilallonga de Ter;426;222;204
17;Girona;225;Vilamacolum;215;111;104
17;Girona;226;Vilamalla;641;334;307
17;Girona;227;Vilamaniscle;120;61;59
17;Girona;228;Vilanant;249;129;120
17;Girona;230;Vila-sacra;402;190;212
17;Girona;222;Vilaür;101;47;54
17;Girona;233;Vilobí d'Onyar;2094;1097;997
17;Girona;232;Vilopriu;178;90;88
18;Granada;001;Agrón;446;225;221
18;Granada;002;Alamedilla;1041;517;524
18;Granada;003;Albolote;10475;5260;5215
18;Granada;004;Albondón;1355;679;676
18;Granada;005;Albuñán;485;243;242
18;Granada;006;Albuñol;5359;2642;2717
18;Granada;007;Albuñuelas;1367;693;674
18;Granada;010;Aldeire;796;395;401
18;Granada;011;Alfacar;3682;1862;1820
18;Granada;012;Algarinejo;5263;2686;2577
18;Granada;013;Alhama de Granada;6054;3039;3015
18;Granada;014;Alhendín;3720;1875;1845
18;Granada;015;Alicún de Ortega;800;403;397
18;Granada;016;Almegíjar;462;235;227
18;Granada;017;Almuñécar;20372;10122;10250
18;Granada;904;Alpujarra de la Sierra;1312;667;645
18;Granada;018;Alquife;1128;541;587
18;Granada;020;Arenas del Rey;2072;1078;994
18;Granada;021;Armilla;10950;5410;5540
18;Granada;022;Atarfe;10045;4958;5087
18;Granada;023;Baza;20616;10066;10550
18;Granada;024;Beas de Granada;916;473;443
18;Granada;025;Beas de Guadix;405;218;187
18;Granada;027;Benalúa;3433;1720;1713
18;Granada;028;Benalúa de las Villas;1404;702;702
18;Granada;029;Benamaurel;2501;1285;1216
18;Granada;030;Bérchules;866;446;420
18;Granada;032;Bubión;359;173;186
18;Granada;033;Busquístar;453;235;218
18;Granada;034;Cacín;882;455;427
18;Granada;035;Cádiar;2023;1026;997
18;Granada;036;Cájar;2292;1075;1217
18;Granada;114;Calahorra (La);1001;474;527
18;Granada;037;Calicasas;603;298;305
18;Granada;038;Campotéjar;1450;713;737
18;Granada;039;Caniles;5213;2539;2674
18;Granada;040;Cáñar;340;165;175
18;Granada;042;Capileira;574;281;293
18;Granada;043;Carataunas;216;112;104
18;Granada;044;Cástaras;337;174;163
18;Granada;045;Castilléjar;2222;1128;1094
18;Granada;046;Castril;3239;1679;1560
18;Granada;047;Cenes de la Vega;2540;1301;1239
18;Granada;059;Chauchina;3800;1882;1918
18;Granada;061;Chimeneas;1563;786;777
18;Granada;062;Churriana de la Vega;5653;2817;2836
18;Granada;048;Cijuela;1344;647;697
18;Granada;049;Cogollos de Guadix;786;419;367
18;Granada;050;Cogollos de la Vega;1978;990;988
18;Granada;051;Colomera;1861;951;910
18;Granada;053;Cortes de Baza;2984;1518;1466
18;Granada;054;Cortes y Graena;1000;522;478
18;Granada;912;Cuevas del Campo;2338;1149;1189
18;Granada;056;Cúllar;5436;2688;2748
18;Granada;057;Cúllar Vega;1769;881;888
18;Granada;063;Darro;1607;773;834
18;Granada;064;Dehesas de Guadix;682;349;333
18;Granada;066;Deifontes;2416;1219;1197
18;Granada;067;Diezma;1049;540;509
18;Granada;068;Dílar;1455;725;730
18;Granada;069;Dólar;736;367;369
18;Granada;070;Dúdar;256;128;128
18;Granada;071;Dúrcal;5876;2938;2938
18;Granada;072;Escúzar;967;500;467
18;Granada;074;Ferreira;422;204;218
18;Granada;076;Fonelas;1389;694;695
18;Granada;078;Freila;1258;637;621
18;Granada;079;Fuente Vaqueros;3873;1927;1946
18;Granada;905;Gabias (Las);6208;3080;3128
18;Granada;082;Galera;1648;815;833
18;Granada;083;Gobernador;408;199;209
18;Granada;084;Gójar;2406;1216;1190
18;Granada;085;Gor;1311;657;654
18;Granada;086;Gorafe;601;308;293
18;Granada;087;Granada;259702;122407;137295
18;Granada;088;Guadahortuna;2437;1243;1194
18;Granada;089;Guadix;20067;9920;10147
18;Granada;906;Guajares (Los);1511;776;735
18;Granada;093;Gualchos;3000;1522;1478
18;Granada;094;Güejar Sierra;2660;1358;1302
18;Granada;095;Güevéjar;1272;624;648
18;Granada;096;Huélago;685;353;332
18;Granada;097;Huéneja;1393;688;705
18;Granada;098;Huéscar;10029;5017;5012
18;Granada;099;Huétor de Santillán;1561;806;755
18;Granada;100;Huétor Tájar;7604;3788;3816
18;Granada;101;Huétor Vega;6611;3303;3308
18;Granada;102;Illora;10553;5301;5252
18;Granada;103;Itrabo;1113;560;553
18;Granada;105;Iznalloz;6640;3374;3266
18;Granada;107;Jayena;1495;774;721
18;Granada;108;Jerez del Marquesado;1213;608;605
18;Granada;109;Jete;737;360;377
18;Granada;111;Jun;1070;529;541
18;Granada;112;Juviles;217;105;112
18;Granada;115;Láchar;2307;1162;1145
18;Granada;116;Lanjarón;4003;2005;1998
18;Granada;117;Lanteira;709;359;350
18;Granada;119;Lecrín;2431;1187;1244
18;Granada;120;Lentegí;385;185;200
18;Granada;121;Lobras;218;111;107
18;Granada;122;Loja;21030;10453;10577
18;Granada;123;Lugros;478;262;216
18;Granada;124;Lújar;627;334;293
18;Granada;126;Malahá (La);1631;827;804
18;Granada;127;Maracena;13086;6503;6583
18;Granada;128;Marchal;473;229;244
18;Granada;132;Moclín;4744;2358;2386
18;Granada;133;Molvízar;2539;1260;1279
18;Granada;134;Monachil;4358;2212;2146
18;Granada;135;Montefrío;8189;4135;4054
18;Granada;136;Montejícar;3003;1543;1460
18;Granada;137;Montillana;1367;691;676
18;Granada;138;Moraleda de Zafayona;2605;1344;1261
18;Granada;909;Morelábor;1032;507;525
18;Granada;140;Motril;47143;23260;23883
18;Granada;141;Murtas;1153;590;563
18;Granada;903;Nevada;1508;758;750
18;Granada;143;Nigüelas;1187;604;583
18;Granada;144;Nívar;572;296;276
18;Granada;145;Ogíjares;5277;2663;2614
18;Granada;146;Orce;1515;773;742
18;Granada;147;Órgiva;5140;2578;2562
18;Granada;148;Otívar;1160;584;576
18;Granada;149;Otura;2772;1400;1372
18;Granada;150;Padul;6198;3090;3108
18;Granada;151;Pampaneira;337;177;160
18;Granada;152;Pedro Martínez;1557;787;770
18;Granada;153;Peligros;6446;3217;3229
18;Granada;154;Peza (La);1578;818;760
18;Granada;910;Pinar (El);1314;651;663
18;Granada;157;Pinos Genil;1084;563;521
18;Granada;158;Pinos Puente;13217;6597;6620
18;Granada;159;Píñar;1508;766;742
18;Granada;161;Polícar;265;139;126
18;Granada;162;Polopos;1179;630;549
18;Granada;163;Pórtugos;454;232;222
18;Granada;164;Puebla de Don Fadrique;2647;1319;1328
18;Granada;165;Pulianas;2612;1310;1302
18;Granada;167;Purullena;2520;1238;1282
18;Granada;168;Quéntar;1082;540;542
18;Granada;170;Rubite;436;230;206
18;Granada;171;Salar;2810;1388;1422
18;Granada;173;Salobreña;9569;4768;4801
18;Granada;174;Santa Cruz del Comercio;594;316;278
18;Granada;175;Santa Fe;12091;5914;6177
18;Granada;176;Soportújar;265;143;122
18;Granada;177;Sorvilán;953;474;479
18;Granada;901;Taha (La);979;494;485
18;Granada;178;Torre-Cardela;1213;603;610
18;Granada;179;Torvizcón;1154;580;574
18;Granada;180;Trevélez;822;447;375
18;Granada;181;Turón;460;264;196
18;Granada;182;Ugíjar;3012;1466;1546
18;Granada;907;Valle del Zalabí;2469;1224;1245
18;Granada;902;Valle (El);1531;757;774
18;Granada;183;Válor;1123;569;554
18;Granada;911;Vegas del Genil;2649;1332;1317
18;Granada;184;Vélez de Benaudalla;2490;1226;1264
18;Granada;185;Ventas de Huelma;683;340;343
18;Granada;908;Villamena;985;473;512
18;Granada;187;Villanueva de las Torres;1081;562;519
18;Granada;188;Villanueva Mesía;1924;971;953
18;Granada;189;Víznar;781;406;375
18;Granada;192;Zafarraya;2214;1115;1099
18;Granada;913;Zagra;1227;606;621
18;Granada;193;Zubia (La);9169;4533;4636
18;Granada;194;Zújar;3002;1511;1491
19;Guadalajara;001;Abánades;124;71;53
19;Guadalajara;002;Ablanque;156;83;73
19;Guadalajara;003;Adobes;42;19;23
19;Guadalajara;004;Alaminos;102;48;54
19;Guadalajara;005;Alarilla;126;65;61
19;Guadalajara;006;Albalate de Zorita;1002;524;478
19;Guadalajara;007;Albares;521;267;254
19;Guadalajara;008;Albendiego;61;31;30
19;Guadalajara;009;Alcocer;316;153;163
19;Guadalajara;010;Alcolea de las Peñas;43;25;18
19;Guadalajara;011;Alcolea del Pinar;453;224;229
19;Guadalajara;013;Alcoroches;200;102;98
19;Guadalajara;015;Aldeanueva de Guadalajara;112;54;58
19;Guadalajara;016;Algar de Mesa;89;48;41
19;Guadalajara;017;Algora;115;64;51
19;Guadalajara;018;Alhóndiga;269;153;116
19;Guadalajara;019;Alique;39;9;30
19;Guadalajara;020;Almadrones;110;69;41
19;Guadalajara;021;Almoguera;784;400;384
19;Guadalajara;022;Almonacid de Zorita;986;499;487
19;Guadalajara;023;Alocén;138;71;67
19;Guadalajara;024;Alovera;1332;669;663
19;Guadalajara;027;Alustante;306;169;137
19;Guadalajara;031;Angón;37;21;16
19;Guadalajara;032;Anguita;336;165;171
19;Guadalajara;033;Anquela del Ducado;81;40;41
19;Guadalajara;034;Anquela del Pedregal;21;13;8
19;Guadalajara;036;Aranzueque;356;182;174
19;Guadalajara;037;Arbancón;218;120;98
19;Guadalajara;038;Arbeteta;51;28;23
19;Guadalajara;039;Argecilla;136;77;59
19;Guadalajara;040;Armallones;60;36;24
19;Guadalajara;041;Armuña de Tajuña;101;54;47
19;Guadalajara;042;Arroyo de las Fraguas;22;12;10
19;Guadalajara;043;Atanzón;109;61;48
19;Guadalajara;044;Atienza;498;254;244
19;Guadalajara;045;Auñón;289;146;143
19;Guadalajara;046;Azuqueca de Henares;11981;6047;5934
19;Guadalajara;047;Baides;82;43;39
19;Guadalajara;048;Baños de Tajo;36;23;13
19;Guadalajara;049;Bañuelos;38;20;18
19;Guadalajara;050;Barriopedro;28;12;16
19;Guadalajara;051;Berninches;143;79;64
19;Guadalajara;052;Bodera (La);59;34;25
19;Guadalajara;053;Brihuega;3003;1569;1434
19;Guadalajara;054;Budia;328;183;145
19;Guadalajara;055;Bujalaro;108;61;47
19;Guadalajara;057;Bustares;126;68;58
19;Guadalajara;058;Cabanillas del Campo;1100;588;512
19;Guadalajara;059;Campillo de Dueñas;163;86;77
19;Guadalajara;060;Campillo de Ranas;128;54;74
19;Guadalajara;061;Campisábalos;68;32;36
19;Guadalajara;064;Canredondo;144;74;70
19;Guadalajara;065;Cantalojas;166;92;74
19;Guadalajara;066;Cañizar;124;62;62
19;Guadalajara;067;Cardoso de la Sierra (El);124;76;48
19;Guadalajara;070;Casa de Uceda;127;63;64
19;Guadalajara;071;Casar (El);1460;762;698
19;Guadalajara;073;Casas de San Galindo;36;22;14
19;Guadalajara;074;Caspueñas;46;24;22
19;Guadalajara;075;Castejón de Henares;124;67;57
19;Guadalajara;076;Castellar de la Muela;63;33;30
19;Guadalajara;078;Castilforte;59;32;27
19;Guadalajara;079;Castilnuevo;12;4;8
19;Guadalajara;080;Cendejas de Enmedio;137;67;70
19;Guadalajara;081;Cendejas de la Torre;127;71;56
19;Guadalajara;082;Centenera;75;38;37
19;Guadalajara;103;Checa;453;235;218
19;Guadalajara;104;Chequilla;25;12;13
19;Guadalajara;106;Chillarón del Rey;142;75;67
19;Guadalajara;105;Chiloeches;1091;574;517
19;Guadalajara;086;Cifuentes;2349;1196;1153
19;Guadalajara;087;Cincovillas;39;18;21
19;Guadalajara;088;Ciruelas;67;37;30
19;Guadalajara;089;Ciruelos del Pinar;72;37;35
19;Guadalajara;090;Cobeta;147;75;72
19;Guadalajara;091;Cogollor;62;35;27
19;Guadalajara;092;Cogolludo;604;332;272
19;Guadalajara;095;Condemios de Abajo;33;19;14
19;Guadalajara;096;Condemios de Arriba;187;97;90
19;Guadalajara;097;Congostrina;56;27;29
19;Guadalajara;098;Copernal;33;18;15
19;Guadalajara;099;Corduente;502;272;230
19;Guadalajara;102;Cubillo de Uceda (El);150;74;76
19;Guadalajara;107;Driebes;359;205;154
19;Guadalajara;108;Durón;116;56;60
19;Guadalajara;109;Embid;77;43;34
19;Guadalajara;110;Escamilla;119;61;58
19;Guadalajara;111;Escariche;232;122;110
19;Guadalajara;112;Escopete;59;17;42
19;Guadalajara;113;Espinosa de Henares;517;249;268
19;Guadalajara;114;Esplegares;94;55;39
19;Guadalajara;115;Establés;53;24;29
19;Guadalajara;116;Estriégana;33;18;15
19;Guadalajara;117;Fontanar;790;407;383
19;Guadalajara;118;Fuembellida;19;10;9
19;Guadalajara;119;Fuencemillán;125;67;58
19;Guadalajara;120;Fuentelahiguera de Albatages;208;109;99
19;Guadalajara;121;Fuentelencina;188;102;86
19;Guadalajara;122;Fuentelsaz;154;74;80
19;Guadalajara;123;Fuentelviejo;82;41;41
19;Guadalajara;124;Fuentenovilla;219;125;94
19;Guadalajara;125;Gajanejos;115;65;50
19;Guadalajara;126;Galápagos;199;103;96
19;Guadalajara;127;Galve de Sorbe;186;90;96
19;Guadalajara;129;Gascueña de Bornova;38;19;19
19;Guadalajara;130;Guadalajara;64284;31818;32466
19;Guadalajara;132;Henche;37;25;12
19;Guadalajara;133;Heras de Ayuso;114;59;55
19;Guadalajara;134;Herrería;42;19;23
19;Guadalajara;135;Hiendelaencina;153;85;68
19;Guadalajara;136;Hijes;28;15;13
19;Guadalajara;138;Hita;274;148;126
19;Guadalajara;139;Hombrados;59;31;28
19;Guadalajara;142;Hontoba;144;70;74
19;Guadalajara;143;Horche;1121;581;540
19;Guadalajara;145;Hortezuela de Océn;101;53;48
19;Guadalajara;146;Huerce (La);25;14;11
19;Guadalajara;147;Huérmeces del Cerro;60;35;25
19;Guadalajara;148;Huertahernando;87;48;39
19;Guadalajara;150;Hueva;147;75;72
19;Guadalajara;151;Humanes;1195;626;569
19;Guadalajara;152;Illana;658;340;318
19;Guadalajara;153;Iniéstola;25;14;11
19;Guadalajara;154;Inviernas (Las);108;62;46
19;Guadalajara;155;Irueste;70;33;37
19;Guadalajara;156;Jadraque;1206;615;591
19;Guadalajara;157;Jirueque;62;35;27
19;Guadalajara;159;Ledanca;188;89;99
19;Guadalajara;160;Loranca de Tajuña;276;142;134
19;Guadalajara;161;Lupiana;262;143;119
19;Guadalajara;162;Luzaga;121;56;65
19;Guadalajara;163;Luzón;96;50;46
19;Guadalajara;165;Majaelrayo;60;30;30
19;Guadalajara;166;Málaga del Fresno;234;124;110
19;Guadalajara;167;Malaguilla;187;105;82
19;Guadalajara;168;Mandayona;500;235;265
19;Guadalajara;169;Mantiel;70;32;38
19;Guadalajara;170;Maranchón;224;125;99
19;Guadalajara;171;Marchamalo;"";"";""
19;Guadalajara;172;Masegoso de Tajuña;110;52;58
19;Guadalajara;173;Matarrubia;58;35;23
19;Guadalajara;174;Matillas;265;135;130
19;Guadalajara;175;Mazarete;93;47;46
19;Guadalajara;176;Mazuecos;431;222;209
19;Guadalajara;177;Medranda;151;77;74
19;Guadalajara;178;Megina;91;40;51
19;Guadalajara;179;Membrillera;101;52;49
19;Guadalajara;181;Miedes de Atienza;140;71;69
19;Guadalajara;182;Mierla (La);36;22;14
19;Guadalajara;184;Millana;109;51;58
19;Guadalajara;183;Milmarcos;110;63;47
19;Guadalajara;185;Miñosa (La);50;28;22
19;Guadalajara;186;Mirabueno;119;67;52
19;Guadalajara;187;Miralrío;110;60;50
19;Guadalajara;188;Mochales;150;75;75
19;Guadalajara;189;Mohernando;138;78;60
19;Guadalajara;190;Molina de Aragón;3596;1829;1767
19;Guadalajara;191;Monasterio;19;9;10
19;Guadalajara;192;Mondéjar;2104;1037;1067
19;Guadalajara;193;Montarrón;73;41;32
19;Guadalajara;194;Moratilla de los Meleros;127;71;56
19;Guadalajara;195;Morenilla;60;37;23
19;Guadalajara;196;Muduex;135;69;66
19;Guadalajara;197;Navas de Jadraque (Las);26;17;9
19;Guadalajara;198;Negredo;24;10;14
19;Guadalajara;199;Ocentejo;47;21;26
19;Guadalajara;200;Olivar (El);86;46;40
19;Guadalajara;201;Olmeda de Cobeta;90;36;54
19;Guadalajara;202;Olmeda de Jadraque (La);7;4;3
19;Guadalajara;203;Ordial (El);43;19;24
19;Guadalajara;204;Orea;316;168;148
19;Guadalajara;208;Pálmaces de Jadraque;77;41;36
19;Guadalajara;209;Pardos;64;32;32
19;Guadalajara;210;Paredes de Sigüenza;86;44;42
19;Guadalajara;211;Pareja;463;224;239
19;Guadalajara;212;Pastrana;1127;571;556
19;Guadalajara;213;Pedregal (El);115;59;56
19;Guadalajara;214;Peñalén;172;86;86
19;Guadalajara;215;Peñalver;295;167;128
19;Guadalajara;216;Peralejos de las Truchas;175;95;80
19;Guadalajara;217;Peralveche;71;39;32
19;Guadalajara;218;Pinilla de Jadraque;96;49;47
19;Guadalajara;219;Pinilla de Molina;25;15;10
19;Guadalajara;220;Pioz;191;103;88
19;Guadalajara;221;Piqueras;54;30;24
19;Guadalajara;222;Pobo de Dueñas (El);185;102;83
19;Guadalajara;223;Poveda de la Sierra;189;97;92
19;Guadalajara;224;Pozo de Almoguera;228;114;114
19;Guadalajara;225;Pozo de Guadalajara;334;182;152
19;Guadalajara;226;Prádena de Atienza;51;31;20
19;Guadalajara;227;Prados Redondos;98;55;43
19;Guadalajara;228;Puebla de Beleña;36;25;11
19;Guadalajara;229;Puebla de Valles;77;42;35
19;Guadalajara;230;Quer;109;53;56
19;Guadalajara;231;Rebollosa de Jadraque;40;23;17
19;Guadalajara;232;Recuenco (El);138;72;66
19;Guadalajara;233;Renera;70;33;37
19;Guadalajara;234;Retiendas;43;19;24
19;Guadalajara;235;Riba de Saelices;165;92;73
19;Guadalajara;237;Rillo de Gallo;74;41;33
19;Guadalajara;238;Riofrío del Llano;101;52;49
19;Guadalajara;239;Robledillo de Mohernando;163;87;76
19;Guadalajara;240;Robledo de Corpes;82;39;43
19;Guadalajara;241;Romanillos de Atienza;75;46;29
19;Guadalajara;242;Romanones;162;91;71
19;Guadalajara;243;Rueda de la Sierra;85;44;41
19;Guadalajara;244;Sacecorbo;159;84;75
19;Guadalajara;245;Sacedón;1616;822;794
19;Guadalajara;246;Saelices de la Sal;76;41;35
19;Guadalajara;247;Salmerón;271;143;128
19;Guadalajara;248;San Andrés del Congosto;82;44;38
19;Guadalajara;249;San Andrés del Rey;47;19;28
19;Guadalajara;250;Santiuste;27;12;15
19;Guadalajara;251;Saúca;67;32;35
19;Guadalajara;252;Sayatón;232;113;119
19;Guadalajara;254;Selas;78;38;40
19;Guadalajara;901;Semillas;32;17;15
19;Guadalajara;255;Setiles;229;124;105
19;Guadalajara;256;Sienes;107;63;44
19;Guadalajara;257;Sigüenza;4781;2371;2410
19;Guadalajara;258;Solanillos del Extremo;120;62;58
19;Guadalajara;259;Somolinos;56;26;30
19;Guadalajara;260;Sotillo (El);63;39;24
19;Guadalajara;261;Sotodosos;75;37;38
19;Guadalajara;262;Tamajón;189;95;94
19;Guadalajara;263;Taragudo;35;18;17
19;Guadalajara;264;Taravilla;79;43;36
19;Guadalajara;265;Tartanedo;243;120;123
19;Guadalajara;266;Tendilla;419;230;189
19;Guadalajara;267;Terzaga;47;27;20
19;Guadalajara;268;Tierzo;46;24;22
19;Guadalajara;269;Toba (La);134;70;64
19;Guadalajara;271;Tordellego;103;55;48
19;Guadalajara;270;Tordelrábano;17;8;9
19;Guadalajara;272;Tordesilos;168;87;81
19;Guadalajara;274;Torija;360;176;184
19;Guadalajara;279;Torre del Burgo;59;31;28
19;Guadalajara;276;Torrecilla del Ducado;"";"";""
19;Guadalajara;277;Torrecuadrada de Molina;25;15;10
19;Guadalajara;278;Torrecuadradilla;81;47;34
19;Guadalajara;280;Torrejón del Rey;480;262;218
19;Guadalajara;281;Torremocha de Jadraque;18;12;6
19;Guadalajara;282;Torremocha del Campo;393;217;176
19;Guadalajara;283;Torremocha del Pinar;82;39;43
19;Guadalajara;284;Torremochuela;10;5;5
19;Guadalajara;285;Torrubia;47;24;23
19;Guadalajara;286;Tórtola de Henares;422;211;211
19;Guadalajara;287;Tortuera;274;144;130
19;Guadalajara;288;Tortuero;37;22;15
19;Guadalajara;289;Traíd;66;35;31
19;Guadalajara;290;Trijueque;328;176;152
19;Guadalajara;291;Trillo;1431;732;699
19;Guadalajara;293;Uceda;517;260;257
19;Guadalajara;294;Ujados;48;27;21
19;Guadalajara;296;Utande;75;45;30
19;Guadalajara;297;Valdarachas;26;11;15
19;Guadalajara;298;Valdearenas;63;33;30
19;Guadalajara;299;Valdeavellano;96;50;46
19;Guadalajara;300;Valdeaveruelo;155;86;69
19;Guadalajara;301;Valdeconcha;39;20;19
19;Guadalajara;302;Valdegrudas;67;34;33
19;Guadalajara;303;Valdelcubo;65;38;27
19;Guadalajara;304;Valdenuño Fernández;137;72;65
19;Guadalajara;305;Valdepeñas de la Sierra;260;143;117
19;Guadalajara;306;Valderrebollo;57;26;31
19;Guadalajara;307;Valdesotos;45;17;28
19;Guadalajara;308;Valfermoso de Tajuña;70;40;30
19;Guadalajara;309;Valhermoso;49;27;22
19;Guadalajara;310;Valtablado del Río;22;13;9
19;Guadalajara;311;Valverde de los Arroyos;89;44;45
19;Guadalajara;314;Viana de Jadraque;49;27;22
19;Guadalajara;317;Villanueva de Alcorón;337;177;160
19;Guadalajara;318;Villanueva de Argecilla;52;29;23
19;Guadalajara;319;Villanueva de la Torre;110;56;54
19;Guadalajara;321;Villares de Jadraque;51;27;24
19;Guadalajara;322;Villaseca de Henares;62;34;28
19;Guadalajara;323;Villaseca de Uceda;65;33;32
19;Guadalajara;324;Villel de Mesa;270;129;141
19;Guadalajara;325;Viñuelas;124;66;58
19;Guadalajara;326;Yebes;70;41;29
19;Guadalajara;327;Yebra;596;299;297
19;Guadalajara;329;Yélamos de Abajo;97;46;51
19;Guadalajara;330;Yélamos de Arriba;132;70;62
19;Guadalajara;331;Yunquera de Henares;1957;996;961
19;Guadalajara;332;Yunta (La);188;91;97
19;Guadalajara;333;Zaorejas;227;123;104
19;Guadalajara;334;Zarzuela de Jadraque;31;20;11
19;Guadalajara;335;Zorita de los Canes;103;57;46
20;Guipúzcoa;001;Abaltzisketa;283;154;129
20;Guipúzcoa;002;Aduna;293;154;139
20;Guipúzcoa;016;Aia;1686;966;720
20;Guipúzcoa;003;Aizarnazabal;535;293;242
20;Guipúzcoa;004;Albiztur;304;161;143
20;Guipúzcoa;005;Alegia;1691;886;805
20;Guipúzcoa;006;Alkiza;265;150;115
20;Guipúzcoa;906;Altzaga;98;51;47
20;Guipúzcoa;007;Altzo;329;186;143
20;Guipúzcoa;008;Amezketa;1038;566;472
20;Guipúzcoa;009;Andoain;15159;7574;7585
20;Guipúzcoa;010;Anoeta;1791;900;891
20;Guipúzcoa;011;Antzuola;2053;1059;994
20;Guipúzcoa;012;Arama;145;71;74
20;Guipúzcoa;013;Aretxabaleta;6176;3152;3024
20;Guipúzcoa;055;Arrasate/Mondragón;25491;12774;12717
20;Guipúzcoa;014;Asteasu;1212;653;559
20;Guipúzcoa;903;Astigarraga;3236;1587;1649
20;Guipúzcoa;015;Ataun;1708;879;829
20;Guipúzcoa;017;Azkoitia;10553;5280;5273
20;Guipúzcoa;018;Azpeitia;13720;6931;6789
20;Guipúzcoa;904;Baliarrain;101;52;49
20;Guipúzcoa;019;Beasain;12375;6238;6137
20;Guipúzcoa;020;Beizama;176;99;77
20;Guipúzcoa;021;Belauntza;295;160;135
20;Guipúzcoa;022;Berastegi;952;536;416
20;Guipúzcoa;074;Bergara;15542;7735;7807
20;Guipúzcoa;023;Berrobi;603;333;270
20;Guipúzcoa;024;Bidegoyan;442;252;190
20;Guipúzcoa;029;Deba;4980;2537;2443
20;Guipúzcoa;069;Donostia/San Sebastián;172251;80708;91543
20;Guipúzcoa;030;Eibar;32330;15904;16426
20;Guipúzcoa;031;Elduain;232;123;109
20;Guipúzcoa;033;Elgeta;1006;504;502
20;Guipúzcoa;032;Elgoibar;11639;5858;5781
20;Guipúzcoa;067;Errenteria;41666;20614;21052
20;Guipúzcoa;066;Errezil;679;378;301
20;Guipúzcoa;034;Eskoriatza;3854;1990;1864
20;Guipúzcoa;035;Ezkio-Itsaso;527;274;253
20;Guipúzcoa;038;Gabiria;434;240;194
20;Guipúzcoa;037;Gaintza;123;72;51
20;Guipúzcoa;907;Gaztelu;"";"";""
20;Guipúzcoa;039;Getaria;2373;1198;1175
20;Guipúzcoa;040;Hernani;18465;9167;9298
20;Guipúzcoa;041;Hernialde;279;148;131
20;Guipúzcoa;036;Hondarribia;13521;6724;6797
20;Guipúzcoa;042;Ibarra;4438;2295;2143
20;Guipúzcoa;043;Idiazabal;2042;1034;1008
20;Guipúzcoa;044;Ikaztegieta;370;193;177
20;Guipúzcoa;045;Irún;53787;26421;27366
20;Guipúzcoa;046;Irura;645;321;324
20;Guipúzcoa;047;Itsasondo;638;320;318
20;Guipúzcoa;048;Larraul;139;82;57
20;Guipúzcoa;902;Lasarte-Oria;18218;9114;9104
20;Guipúzcoa;049;Lazkao;5026;2567;2459
20;Guipúzcoa;050;Leaburu;563;315;248
20;Guipúzcoa;051;Legazpi;9831;5079;4752
20;Guipúzcoa;052;Legorreta;1505;762;743
20;Guipúzcoa;068;Leintz-Gatzaga;247;136;111
20;Guipúzcoa;053;Lezo;5293;2602;2691
20;Guipúzcoa;054;Lizartza;696;370;326
20;Guipúzcoa;901;Mendaro;1424;732;692
20;Guipúzcoa;057;Mutiloa;184;91;93
20;Guipúzcoa;056;Mutriku;4589;2286;2303
20;Guipúzcoa;063;Oiartzun;8473;4220;4253
20;Guipúzcoa;058;Olaberria;1111;575;536
20;Guipúzcoa;076;Ordizia;9389;4612;4777
20;Guipúzcoa;905;Orendain;166;99;67
20;Guipúzcoa;060;Orexa;78;41;37
20;Guipúzcoa;061;Orio;4266;2162;2104
20;Guipúzcoa;062;Ormaiztegi;1240;620;620
20;Guipúzcoa;059;Oñati;10658;5338;5320
20;Guipúzcoa;064;Pasaia;18255;8910;9345
20;Guipúzcoa;070;Segura;1290;651;639
20;Guipúzcoa;065;Soraluze/Placencia de las Armas;4820;2397;2423
20;Guipúzcoa;071;Tolosa;18118;8674;9444
20;Guipúzcoa;072;Urnieta;4446;2278;2168
20;Guipúzcoa;077;Urretxu;6071;3087;2984
20;Guipúzcoa;073;Usurbil;5332;2732;2600
20;Guipúzcoa;075;Villabona;5377;2722;2655
20;Guipúzcoa;078;Zaldibia;1574;827;747
20;Guipúzcoa;079;Zarautz;18141;8987;9154
20;Guipúzcoa;025;Zegama;1399;713;686
20;Guipúzcoa;026;Zerain;233;111;122
20;Guipúzcoa;027;Zestoa;3366;1772;1594
20;Guipúzcoa;028;Zizurkil;2714;1386;1328
20;Guipúzcoa;081;Zumaia;8219;4120;4099
20;Guipúzcoa;080;Zumarraga;11020;5551;5469
21;Huelva;001;Alájar;854;438;416
21;Huelva;002;Aljaraque;6903;3455;3448
21;Huelva;003;Almendro (El);851;440;411
21;Huelva;004;Almonaster la Real;2103;1035;1068
21;Huelva;005;Almonte;16413;8268;8145
21;Huelva;006;Alosno;5003;2414;2589
21;Huelva;007;Aracena;6520;3185;3335
21;Huelva;008;Aroche;3611;1765;1846
21;Huelva;009;Arroyomolinos de León;1232;620;612
21;Huelva;010;Ayamonte;15188;7424;7764
21;Huelva;011;Beas;4078;2021;2057
21;Huelva;012;Berrocal;423;214;209
21;Huelva;013;Bollullos Par del Condado;12635;6263;6372
21;Huelva;014;Bonares;4956;2490;2466
21;Huelva;015;Cabezas Rubias;975;497;478
21;Huelva;016;Cala;1494;766;728
21;Huelva;017;Calañas;5078;2488;2590
21;Huelva;018;Campillo (El);2665;1291;1374
21;Huelva;019;Campofrío;900;453;447
21;Huelva;020;Cañaveral de León;586;280;306
21;Huelva;021;Cartaya;10488;5177;5311
21;Huelva;022;Castaño del Robledo;199;98;101
21;Huelva;023;Cerro de Andévalo (El);2878;1412;1466
21;Huelva;030;Chucena;1920;988;932
21;Huelva;024;Corteconcepción;701;354;347
21;Huelva;025;Cortegana;5240;2570;2670
21;Huelva;026;Cortelazor;312;154;158
21;Huelva;027;Cumbres de Enmedio;58;30;28
21;Huelva;028;Cumbres de San Bartolomé;655;330;325
21;Huelva;029;Cumbres Mayores;2314;1119;1195
21;Huelva;031;Encinasola;2033;1008;1025
21;Huelva;032;Escacena del Campo;2225;1096;1129
21;Huelva;033;Fuenteheridos;656;336;320
21;Huelva;034;Galaroza;1634;787;847
21;Huelva;035;Gibraleón;10051;5061;4990
21;Huelva;036;Granada de Río-Tinto (La);229;119;110
21;Huelva;037;Granado (El);698;368;330
21;Huelva;038;Higuera de la Sierra;1319;650;669
21;Huelva;039;Hinojales;469;236;233
21;Huelva;040;Hinojos;3429;1733;1696
21;Huelva;041;Huelva;142809;69263;73546
21;Huelva;042;Isla Cristina;16742;8287;8455
21;Huelva;043;Jabugo;2550;1257;1293
21;Huelva;044;Lepe;16734;8464;8270
21;Huelva;045;Linares de la Sierra;286;136;150
21;Huelva;046;Lucena del Puerto;2071;1051;1020
21;Huelva;047;Manzanilla;2558;1262;1296
21;Huelva;048;Marines (Los);354;180;174
21;Huelva;049;Minas de Riotinto;5427;2579;2848
21;Huelva;050;Moguer;11993;6059;5934
21;Huelva;051;Nava (La);356;178;178
21;Huelva;052;Nerva;7033;3421;3612
21;Huelva;053;Niebla;3842;1941;1901
21;Huelva;054;Palma del Condado (La);9497;4688;4809
21;Huelva;055;Palos de la Frontera;6709;3375;3334
21;Huelva;056;Paterna del Campo;3829;1963;1866
21;Huelva;057;Paymogo;1375;658;717
21;Huelva;058;Puebla de Guzmán;3205;1607;1598
21;Huelva;059;Puerto Moral;234;109;125
21;Huelva;060;Punta Umbría;10142;5121;5021
21;Huelva;061;Rociana del Condado;6165;3136;3029
21;Huelva;062;Rosal de la Frontera;1946;923;1023
21;Huelva;063;San Bartolomé de la Torre;2867;1442;1425
21;Huelva;064;San Juan del Puerto;5768;2907;2861
21;Huelva;066;San Silvestre de Guzmán;695;341;354
21;Huelva;065;Sanlúcar de Guadiana;400;196;204
21;Huelva;067;Santa Ana la Real;505;235;270
21;Huelva;068;Santa Bárbara de Casa;1441;718;723
21;Huelva;069;Santa Olalla del Cala;2336;1196;1140
21;Huelva;070;Trigueros;7037;3523;3514
21;Huelva;071;Valdelarco;290;140;150
21;Huelva;072;Valverde del Camino;12374;5954;6420
21;Huelva;073;Villablanca;2029;1047;982
21;Huelva;074;Villalba del Alcor;3686;1826;1860
21;Huelva;075;Villanueva de las Cruces;422;207;215
21;Huelva;076;Villanueva de los Castillejos;2615;1274;1341
21;Huelva;077;Villarrasa;2180;1112;1068
21;Huelva;078;Zalamea la Real;3780;1854;1926
21;Huelva;079;Zufre;1326;683;643
22;Huesca;001;Abiego;314;158;156
22;Huesca;002;Abizanda;127;69;58
22;Huesca;003;Adahuesca;179;93;86
22;Huesca;004;Agüero;167;86;81
22;Huesca;907;Aínsa-Sobrarbe;1429;769;660
22;Huesca;006;Aisa;329;180;149
22;Huesca;007;Albalate de Cinca;1151;598;553
22;Huesca;008;Albalatillo;276;139;137
22;Huesca;009;Albelda;1022;527;495
22;Huesca;011;Albero Alto;105;57;48
22;Huesca;012;Albero Bajo;124;67;57
22;Huesca;013;Alberuela de Tubo;431;226;205
22;Huesca;014;Alcalá de Gurrea;396;199;197
22;Huesca;015;Alcalá del Obispo;359;173;186
22;Huesca;016;Alcampell;1063;529;534
22;Huesca;017;Alcolea de Cinca;1245;632;613
22;Huesca;018;Alcubierre;508;261;247
22;Huesca;019;Alerre;155;79;76
22;Huesca;020;Alfántega;138;70;68
22;Huesca;021;Almudévar;2443;1280;1163
22;Huesca;022;Almunia de San Juan;767;384;383
22;Huesca;023;Almuniente;669;341;328
22;Huesca;024;Alquézar;267;136;131
22;Huesca;025;Altorricón;1519;795;724
22;Huesca;027;Angüés;504;276;228
22;Huesca;028;Ansó;498;248;250
22;Huesca;029;Antillón;177;89;88
22;Huesca;032;Aragüés del Puerto;122;74;48
22;Huesca;035;Arén;439;241;198
22;Huesca;036;Argavieso;116;66;50
22;Huesca;037;Arguis;58;33;25
22;Huesca;039;Ayerbe;1198;612;586
22;Huesca;040;Azanuy-Alins;233;110;123
22;Huesca;041;Azara;225;116;109
22;Huesca;042;Azlor;187;97;90
22;Huesca;043;Baélls;167;84;83
22;Huesca;044;Bailo;353;203;150
22;Huesca;045;Baldellou;169;85;84
22;Huesca;046;Ballobar;1155;581;574
22;Huesca;047;Banastás;127;62;65
22;Huesca;048;Barbastro;14844;7291;7553
22;Huesca;049;Barbués;128;63;65
22;Huesca;050;Barbuñales;124;61;63
22;Huesca;051;Bárcabo;121;67;54
22;Huesca;052;Belver de Cinca;1512;788;724
22;Huesca;053;Benabarre;1226;642;584
22;Huesca;054;Benasque;1158;588;570
22;Huesca;055;Berbegal;530;264;266
22;Huesca;057;Bielsa;432;226;206
22;Huesca;058;Bierge;195;110;85
22;Huesca;059;Biescas;1222;637;585
22;Huesca;060;Binaced;1630;836;794
22;Huesca;061;Binéfar;8014;4022;3992
22;Huesca;062;Bisaurri;231;136;95
22;Huesca;063;Biscarrués;265;140;125
22;Huesca;064;Blecua y Torres;202;103;99
22;Huesca;066;Boltaña;854;432;422
22;Huesca;067;Bonansa;71;37;34
22;Huesca;068;Borau;72;37;35
22;Huesca;069;Broto;517;264;253
22;Huesca;072;Caldearenas;270;142;128
22;Huesca;074;Campo;376;183;193
22;Huesca;075;Camporrélls;268;122;146
22;Huesca;076;Canal de Berdún;459;240;219
22;Huesca;077;Candasnos;623;314;309
22;Huesca;078;Canfranc;485;257;228
22;Huesca;079;Capdesaso;196;94;102
22;Huesca;080;Capella;444;231;213
22;Huesca;081;Casbas de Huesca;359;176;183
22;Huesca;083;Castejón de Monegros;785;388;397
22;Huesca;084;Castejón de Sos;464;243;221
22;Huesca;082;Castejón del Puente;422;208;214
22;Huesca;085;Castelflorite;169;87;82
22;Huesca;086;Castiello de Jaca;148;68;80
22;Huesca;087;Castigaleu;97;54;43
22;Huesca;088;Castillazuelo;241;121;120
22;Huesca;089;Castillonroy;436;213;223
22;Huesca;094;Chalamera;165;89;76
22;Huesca;095;Chía;125;74;51
22;Huesca;096;Chimillas;152;84;68
22;Huesca;090;Colungo;141;78;63
22;Huesca;099;Esplús;901;434;467
22;Huesca;102;Estada;194;98;96
22;Huesca;103;Estadilla;1004;508;496
22;Huesca;105;Estopiñán del Castillo;185;93;92
22;Huesca;106;Fago;45;28;17
22;Huesca;107;Fanlo;54;38;16
22;Huesca;109;Fiscal;250;133;117
22;Huesca;110;Fonz;1227;621;606
22;Huesca;111;Foradada del Toscar;276;135;141
22;Huesca;112;Fraga;11630;5868;5762
22;Huesca;113;Fueva (La);654;356;298
22;Huesca;114;Gistaín;206;117;89
22;Huesca;115;Grado (El);596;312;284
22;Huesca;116;Grañén;2151;1085;1066
22;Huesca;117;Graus;3327;1679;1648
22;Huesca;119;Gurrea de Gállego;1981;989;992
22;Huesca;122;Hoz de Jaca;83;34;49
22;Huesca;908;Hoz y Costean;264;139;125
22;Huesca;124;Huerto;314;165;149
22;Huesca;125;Huesca;44478;21623;22855
22;Huesca;126;Ibieca;112;60;52
22;Huesca;127;Igriés;149;85;64
22;Huesca;128;Ilche;317;162;155
22;Huesca;129;Isábena;276;146;130
22;Huesca;130;Jaca;10908;5362;5546
22;Huesca;131;Jasa;115;63;52
22;Huesca;133;Labuerda;167;86;81
22;Huesca;135;Laluenga;286;152;134
22;Huesca;136;Lalueza;1379;744;635
22;Huesca;137;Lanaja;1762;917;845
22;Huesca;139;Laperdiguera;111;58;53
22;Huesca;141;Lascellas-Ponzano;182;86;96
22;Huesca;142;Lascuarre;171;87;84
22;Huesca;143;Laspaúles;322;182;140
22;Huesca;144;Laspuña;294;158;136
22;Huesca;149;Loarre;417;222;195
22;Huesca;150;Loporzano;549;275;274
22;Huesca;151;Loscorrales;130;71;59
22;Huesca;905;Lupiñén-Ortilla;390;208;182
22;Huesca;155;Monesma y Cajigar;107;52;55
22;Huesca;156;Monflorite-Lascasas;185;103;82
22;Huesca;157;Montanuy;320;183;137
22;Huesca;158;Monzón;14780;7446;7334
22;Huesca;160;Naval;296;148;148
22;Huesca;162;Novales;193;96;97
22;Huesca;163;Nueno;212;110;102
22;Huesca;164;Olvena;53;25;28
22;Huesca;165;Ontiñena;751;385;366
22;Huesca;167;Osso de Cinca;740;378;362
22;Huesca;168;Palo;33;19;14
22;Huesca;170;Panticosa;604;310;294
22;Huesca;172;Peñalba;804;399;405
22;Huesca;173;Peñas de Riglos (Las);280;150;130
22;Huesca;174;Peralta de Alcofea;766;381;385
22;Huesca;175;Peralta de Calasanz;343;184;159
22;Huesca;176;Peraltilla;174;93;81
22;Huesca;177;Perarrúa;157;76;81
22;Huesca;178;Pertusa;158;77;81
22;Huesca;181;Piracés;107;63;44
22;Huesca;182;Plan;295;163;132
22;Huesca;184;Poleñino;258;127;131
22;Huesca;186;Pozán de Vero;270;132;138
22;Huesca;187;Puebla de Castro (La);293;156;137
22;Huesca;188;Puente de Montañana;140;72;68
22;Huesca;902;Puente la Reina de Jaca;291;147;144
22;Huesca;189;Puértolas;198;114;84
22;Huesca;190;Pueyo de Araguás (El);180;107;73
22;Huesca;193;Pueyo de Santa Cruz;396;209;187
22;Huesca;195;Quicena;153;72;81
22;Huesca;197;Robres;718;367;351
22;Huesca;199;Sabiñánigo;9014;4630;4384
22;Huesca;200;Sahún;306;167;139
22;Huesca;201;Salas Altas;412;211;201
22;Huesca;202;Salas Bajas;199;96;103
22;Huesca;203;Salillas;126;67;59
22;Huesca;204;Sallent de Gállego;899;457;442
22;Huesca;205;San Esteban de Litera;695;343;352
22;Huesca;207;San Juan de Plan;169;97;72
22;Huesca;903;San Miguel del Cinca;988;514;474
22;Huesca;206;Sangarrén;296;141;155
22;Huesca;208;Santa Cilia;206;110;96
22;Huesca;209;Santa Cruz de la Serós;156;88;68
22;Huesca;906;Santa María de Dulcis;223;106;117
22;Huesca;212;Santaliestra y San Quílez;105;54;51
22;Huesca;213;Sariñena;4208;2121;2087
22;Huesca;214;Secastilla;188;87;101
22;Huesca;215;Seira;214;105;109
22;Huesca;217;Sena;661;341;320
22;Huesca;218;Senés de Alcubierre;61;29;32
22;Huesca;220;Sesa;295;150;145
22;Huesca;221;Sesué;74;43;31
22;Huesca;222;Siétamo;341;186;155
22;Huesca;223;Sopeira;145;78;67
22;Huesca;904;Sotonera (La);1239;643;596
22;Huesca;225;Tamarite de Litera;4065;2008;2057
22;Huesca;226;Tardienta;1194;611;583
22;Huesca;227;Tella-Sin;315;167;148
22;Huesca;228;Tierz;191;100;91
22;Huesca;229;Tolva;249;135;114
22;Huesca;230;Torla;368;198;170
22;Huesca;232;Torralba de Aragón;148;70;78
22;Huesca;233;Torre la Ribera;118;67;51
22;Huesca;234;Torrente de Cinca;1166;592;574
22;Huesca;235;Torres de Alcanadre;142;86;56
22;Huesca;236;Torres de Barbués;436;228;208
22;Huesca;239;Tramaced;130;75;55
22;Huesca;242;Valfarta;111;56;55
22;Huesca;243;Valle de Bardají;56;28;28
22;Huesca;901;Valle de Hecho;1037;550;487
22;Huesca;244;Valle de Lierp;63;31;32
22;Huesca;245;Velilla de Cinca;519;255;264
22;Huesca;909;Vencillón;516;275;241
22;Huesca;246;Veracruz;119;68;51
22;Huesca;247;Viacamp y Litera;39;25;14
22;Huesca;248;Vicién;121;65;56
22;Huesca;249;Villanova;92;45;47
22;Huesca;250;Villanúa;286;145;141
22;Huesca;251;Villanueva de Sigena;504;264;240
22;Huesca;252;Yebra de Basa;172;100;72
22;Huesca;253;Yésero;55;23;32
22;Huesca;254;Zaidín;1762;901;861
23;Jaén;001;Albanchez de Mágina;1641;815;826
23;Jaén;002;Alcalá la Real;21137;10502;10635
23;Jaén;003;Alcaudete;11513;5721;5792
23;Jaén;004;Aldeaquemada;562;289;273
23;Jaén;005;Andújar;37060;18354;18706
23;Jaén;006;Arjona;5520;2790;2730
23;Jaén;007;Arjonilla;3979;1985;1994
23;Jaén;008;Arquillos;1726;879;847
23;Jaén;009;Baeza;15159;7434;7725
23;Jaén;010;Bailén;17058;8611;8447
23;Jaén;011;Baños de la Encina;2759;1398;1361
23;Jaén;012;Beas de Segura;8336;4177;4159
23;Jaén;902;Bedmar y Garcíez;3434;1724;1710
23;Jaén;014;Begíjar;3113;1556;1557
23;Jaén;015;Bélmez de la Moraleda;2039;1012;1027
23;Jaén;016;Benatae;607;309;298
23;Jaén;017;Cabra del Santo Cristo;2334;1190;1144
23;Jaén;018;Cambil;3539;1850;1689
23;Jaén;019;Campillo de Arenas;2283;1157;1126
23;Jaén;020;Canena;2074;1001;1073
23;Jaén;021;Carboneros;721;351;370
23;Jaén;901;Cárcheles;1607;786;821
23;Jaén;024;Carolina (La);15202;7474;7728
23;Jaén;025;Castellar;3717;1876;1841
23;Jaén;026;Castillo de Locubín;5740;2834;2906
23;Jaén;027;Cazalilla;884;458;426
23;Jaén;028;Cazorla;9025;4411;4614
23;Jaén;029;Chiclana de Segura;1666;851;815
23;Jaén;030;Chilluévar;1931;963;968
23;Jaén;031;Escañuela;1032;518;514
23;Jaén;032;Espelúy;805;388;417
23;Jaén;033;Frailes;1915;959;956
23;Jaén;034;Fuensanta de Martos;3443;1674;1769
23;Jaén;035;Fuerte del Rey;1178;589;589
23;Jaén;037;Génave;805;405;400
23;Jaén;038;Guardia de Jaén (La);1858;954;904
23;Jaén;039;Guarromán;2878;1385;1493
23;Jaén;041;Higuera de Calatrava;733;383;350
23;Jaén;042;Hinojares;611;310;301
23;Jaén;043;Hornos;802;406;396
23;Jaén;044;Huelma;5983;2985;2998
23;Jaén;045;Huesa;2751;1384;1367
23;Jaén;046;Ibros;3159;1574;1585
23;Jaén;047;Iruela (La);2111;1063;1048
23;Jaén;048;Iznatoraf;1271;609;662
23;Jaén;049;Jabalquinto;2607;1281;1326
23;Jaén;050;Jaén;105534;51019;54515
23;Jaén;051;Jamilena;3112;1581;1531
23;Jaén;052;Jimena;1666;816;850
23;Jaén;053;Jódar;11888;5893;5995
23;Jaén;040;Lahiguera;1929;948;981
23;Jaén;054;Larva;578;293;285
23;Jaén;055;Linares;59666;29182;30484
23;Jaén;056;Lopera;3956;1958;1998
23;Jaén;057;Lupión;1162;542;620
23;Jaén;058;Mancha Real;8530;4259;4271
23;Jaén;059;Marmolejo;7353;3675;3678
23;Jaén;060;Martos;21221;10434;10787
23;Jaén;061;Mengíbar;8237;4122;4115
23;Jaén;062;Montizón;2012;1007;1005
23;Jaén;063;Navas de San Juan;5443;2717;2726
23;Jaén;064;Noalejo;2369;1202;1167
23;Jaén;065;Orcera;2393;1212;1181
23;Jaén;066;Peal de Becerro;5356;2661;2695
23;Jaén;067;Pegalajar;3073;1513;1560
23;Jaén;069;Porcuna;7022;3506;3516
23;Jaén;070;Pozo Alcón;6060;3065;2995
23;Jaén;071;Puente de Génave;2072;1041;1031
23;Jaén;072;Puerta de Segura (La);2871;1433;1438
23;Jaén;073;Quesada;6542;3204;3338
23;Jaén;074;Rus;3730;1878;1852
23;Jaén;075;Sabiote;4302;2105;2197
23;Jaén;076;Santa Elena;1101;576;525
23;Jaén;077;Santiago de Calatrava;1005;511;494
23;Jaén;904;Santiago-Pontones;5071;2574;2497
23;Jaén;079;Santisteban del Puerto;5039;2572;2467
23;Jaén;080;Santo Tomé;2591;1298;1293
23;Jaén;081;Segura de la Sierra;2281;1156;1125
23;Jaén;082;Siles;2917;1489;1428
23;Jaén;084;Sorihuela del Guadalimar;1398;695;703
23;Jaén;086;Torre del Campo;11444;5638;5806
23;Jaén;085;Torreblascopedro;3031;1505;1526
23;Jaén;087;Torredonjimeno;13501;6620;6881
23;Jaén;088;Torreperogil;7669;3745;3924
23;Jaén;090;Torres;1957;991;966
23;Jaén;091;Torres de Albánchez;1139;566;573
23;Jaén;092;Úbeda;31056;15236;15820
23;Jaén;093;Valdepeñas de Jaén;4578;2303;2275
23;Jaén;094;Vilches;5062;2536;2526
23;Jaén;095;Villacarrillo;11796;5843;5953
23;Jaén;096;Villanueva de la Reina;3376;1680;1696
23;Jaén;097;Villanueva del Arzobispo;8763;4254;4509
23;Jaén;098;Villardompardo;1299;635;664
23;Jaén;099;Villares (Los);4543;2244;2299
23;Jaén;101;Villarrodrigo;725;361;364
23;Jaén;903;Villatorres;3922;1958;1964
24;León;001;Acebedo;421;218;203
24;León;002;Algadefe;405;205;200
24;León;003;Alija del Infantado;1056;533;523
24;León;004;Almanza;882;455;427
24;León;005;Antigua (La);754;397;357
24;León;006;Ardón;811;416;395
24;León;007;Arganza;1155;556;599
24;León;008;Astorga;12553;5973;6580
24;León;009;Balboa;607;315;292
24;León;010;Bañeza (La);10141;4948;5193
24;León;011;Barjas;705;373;332
24;León;012;Barrios de Luna (Los);404;197;207
24;León;014;Bembibre;10908;5446;5462
24;León;015;Benavides;3243;1673;1570
24;León;016;Benuza;838;430;408
24;León;017;Bercianos del Páramo;970;488;482
24;León;018;Bercianos del Real Camino;282;143;139
24;León;019;Berlanga del Bierzo;499;249;250
24;León;020;Boca de Huérgano;729;395;334
24;León;021;Boñar;2853;1404;1449
24;León;022;Borrenes;615;316;299
24;León;023;Brazuelo;376;186;190
24;León;024;Burgo Ranero (El);1125;589;536
24;León;025;Burón;550;285;265
24;León;026;Bustillo del Páramo;2178;1089;1089
24;León;027;Cabañas Raras;1390;723;667
24;León;028;Cabreros del Río;693;360;333
24;León;029;Cabrillanes;1314;638;676
24;León;030;Cacabelos;5053;2579;2474
24;León;031;Calzada del Coto;340;193;147
24;León;032;Campazas;218;104;114
24;León;033;Campo de Villavidel;414;212;202
24;León;034;Camponaraya;3152;1536;1616
24;León;036;Candín;606;327;279
24;León;037;Cármenes;539;252;287
24;León;038;Carracedelo;3473;1736;1737
24;León;039;Carrizo;2851;1429;1422
24;León;040;Carrocera;667;322;345
24;León;041;Carucedo;708;333;375
24;León;042;Castilfalé;130;69;61
24;León;043;Castrillo de Cabrera;323;162;161
24;León;044;Castrillo de la Valduerna;308;142;166
24;León;046;Castrocalbón;1487;759;728
24;León;047;Castrocontrigo;1452;723;729
24;León;049;Castropodame;1959;975;984
24;León;050;Castrotierra de Valmadrigal;179;93;86
24;León;051;Cea;855;444;411
24;León;052;Cebanico;297;165;132
24;León;053;Cebrones del Río;828;418;410
24;León;065;Chozas de Abajo;2260;1181;1079
24;León;054;Cimanes de la Vega;764;379;385
24;León;055;Cimanes del Tejar;1196;604;592
24;León;056;Cistierna;4953;2492;2461
24;León;057;Congosto;1988;974;1014
24;León;058;Corbillos de los Oteros;387;194;193
24;León;059;Corullón;1529;765;764
24;León;060;Crémenes;1620;789;831
24;León;061;Cuadros;1695;808;887
24;León;062;Cubillas de los Oteros;265;130;135
24;León;063;Cubillas de Rueda;751;373;378
24;León;064;Cubillos del Sil;1520;780;740
24;León;066;Destriana;1131;552;579
24;León;067;Encinedo;1102;567;535
24;León;068;Ercina (La);906;441;465
24;León;069;Escobar de Campos;101;58;43
24;León;070;Fabero;6507;3262;3245
24;León;071;Folgoso de la Ribera;1596;799;797
24;León;072;Fresnedo;"";"";""
24;León;073;Fresno de la Vega;795;396;399
24;León;074;Fuentes de Carbajal;166;90;76
24;León;076;Garrafe de Torío;1104;549;555
24;León;077;Gordaliza del Pino;445;219;226
24;León;078;Gordoncillo;701;345;356
24;León;079;Gradefes;1597;780;817
24;León;080;Grajal de Campos;347;143;204
24;León;081;Gusendos de los Oteros;276;137;139
24;León;082;Hospital de Órbigo;1206;599;607
24;León;083;Igüeña;2444;1293;1151
24;León;084;Izagre;335;159;176
24;León;086;Joarilla de las Matas;516;271;245
24;León;087;Laguna Dalga;1087;548;539
24;León;088;Laguna de Negrillos;1771;902;869
24;León;089;León;144539;68330;76209
24;León;092;Llamas de la Ribera;1386;711;675
24;León;090;Lucillo;608;308;300
24;León;091;Luyego;1053;499;554
24;León;093;Magaz de Cepeda;651;315;336
24;León;094;Mansilla de las Mulas;1757;864;893
24;León;095;Mansilla Mayor;478;240;238
24;León;096;Maraña;200;100;100
24;León;097;Matadeón de los Oteros;395;190;205
24;León;098;Matallana de Torío;2048;1014;1034
24;León;099;Matanza;415;199;216
24;León;100;Molinaseca;750;377;373
24;León;101;Murias de Paredes;879;419;460
24;León;102;Noceda del Bierzo;1033;505;528
24;León;103;Oencia;547;295;252
24;León;104;Omañas (Las);532;267;265
24;León;105;Onzonilla;1433;702;731
24;León;106;Oseja de Sajambre;379;212;167
24;León;107;Pajares de los Oteros;465;238;227
24;León;108;Palacios de la Valduerna;643;316;327
24;León;109;Palacios del Sil;1651;837;814
24;León;110;Páramo del Sil;2268;1149;1119
24;León;111;Pedrosa del Rey;"";"";""
24;León;112;Peranzanes;387;204;183
24;León;113;Pobladura de Pelayo García;724;372;352
24;León;114;Pola de Gordón (La);5922;2902;3020
24;León;115;Ponferrada;60193;29438;30755
24;León;116;Posada de Valdeón;548;284;264
24;León;117;Pozuelo del Páramo;743;391;352
24;León;118;Prado de la Guzpeña;204;108;96
24;León;119;Priaranza del Bierzo;1043;541;502
24;León;120;Prioro;571;301;270
24;León;121;Puebla de Lillo;772;400;372
24;León;122;Puente de Domingo Flórez;2069;1084;985
24;León;123;Quintana del Castillo;1370;718;652
24;León;124;Quintana del Marco;673;346;327
24;León;125;Quintana y Congosto;1004;520;484
24;León;127;Regueras de Arriba;477;251;226
24;León;129;Reyero;192;105;87
24;León;130;Riaño;559;302;257
24;León;131;Riego de la Vega;1277;625;652
24;León;132;Riello;1335;665;670
24;León;133;Rioseco de Tapia;650;345;305
24;León;134;Robla (La);5454;2749;2705
24;León;136;Roperuelos del Páramo;959;487;472
24;León;137;Sabero;2509;1245;1264
24;León;139;Sahagún;3396;1694;1702
24;León;141;San Adrián del Valle;230;106;124
24;León;142;San Andrés del Rabanedo;20562;10028;10534
24;León;144;San Cristóbal de la Polantera;1288;650;638
24;León;145;San Emiliano;1083;536;547
24;León;146;San Esteban de Nogales;544;256;288
24;León;148;San Justo de la Vega;2431;1219;1212
24;León;149;San Millán de los Caballeros;210;100;110
24;León;150;San Pedro Bercianos;418;209;209
24;León;143;Sancedo;693;350;343
24;León;151;Santa Colomba de Curueño;807;382;425
24;León;152;Santa Colomba de Somoza;536;268;268
24;León;153;Santa Cristina de Valmadrigal;450;226;224
24;León;154;Santa Elena de Jamuz;1577;799;778
24;León;155;Santa María de la Isla;814;430;384
24;León;158;Santa María de Ordás;562;280;282
24;León;156;Santa María del Monte de Cea;490;245;245
24;León;157;Santa María del Páramo;3135;1500;1635
24;León;159;Santa Marina del Rey;2796;1411;1385
24;León;160;Santas Martas;1190;610;580
24;León;161;Santiago Millas;398;200;198
24;León;162;Santovenia de la Valdoncina;1313;631;682
24;León;163;Sariegos;1717;854;863
24;León;164;Sena de Luna;633;308;325
24;León;165;Sobrado;622;312;310
24;León;166;Soto de la Vega;2237;1132;1105
24;León;167;Soto y Amío;1320;639;681
24;León;168;Toral de los Guzmanes;802;408;394
24;León;169;Toreno;5127;2682;2445
24;León;170;Torre del Bierzo;3581;1788;1793
24;León;171;Trabadelo;769;406;363
24;León;172;Truchas;1156;585;571
24;León;173;Turcia;1606;811;795
24;León;174;Urdiales del Páramo;912;461;451
24;León;185;Val de San Lorenzo;840;404;436
24;León;175;Valdefresno;1576;791;785
24;León;176;Valdefuentes del Páramo;540;277;263
24;León;177;Valdelugueros;453;233;220
24;León;178;Valdemora;140;72;68
24;León;179;Valdepiélago;474;229;245
24;León;180;Valdepolo;1781;933;848
24;León;181;Valderas;2407;1217;1190
24;León;182;Valderrey;780;388;392
24;León;183;Valderrueda;1619;807;812
24;León;184;Valdesamario;368;185;183
24;León;187;Valdevimbre;1358;700;658
24;León;188;Valencia de Don Juan;3876;1946;1930
24;León;191;Vallecillo;220;114;106
24;León;189;Valverde de la Virgen;3569;1769;1800
24;León;190;Valverde-Enrique;290;143;147
24;León;193;Vecilla (La);493;241;252
24;León;196;Vega de Espinareda;3257;1654;1603
24;León;197;Vega de Infanzones;884;444;440
24;León;198;Vega de Valcarce;1177;595;582
24;León;194;Vegacervera;414;214;200
24;León;199;Vegaquemada;664;318;346
24;León;201;Vegas del Condado;1613;809;804
24;León;202;Villablino;16177;8170;8007
24;León;203;Villabraz;209;109;100
24;León;205;Villadangos del Páramo;1031;503;528
24;León;206;Villadecanes;2489;1264;1225
24;León;207;Villademor de la Vega;546;278;268
24;León;209;Villafranca del Bierzo;4137;2070;2067
24;León;210;Villagatón;1047;529;518
24;León;211;Villamandos;531;255;276
24;León;901;Villamanín;1522;760;762
24;León;212;Villamañán;1593;800;793
24;León;213;Villamartín de Don Sancho;261;133;128
24;León;214;Villamejil;1128;574;554
24;León;215;Villamol;299;155;144
24;León;216;Villamontán de la Valduerna;1314;660;654
24;León;217;Villamoratiel de las Matas;246;137;109
24;León;218;Villanueva de las Manzanas;676;316;360
24;León;219;Villaobispo de Otero;819;422;397
24;León;902;Villaornate y Castro;616;322;294
24;León;221;Villaquejida;1187;609;578
24;León;222;Villaquilambre;5500;2726;2774
24;León;223;Villarejo de Órbigo;3654;1781;1873
24;León;224;Villares de Órbigo;1047;539;508
24;León;225;Villasabariego;1257;629;628
24;León;226;Villaselán;405;221;184
24;León;227;Villaturiel;1775;901;874
24;León;228;Villazala;1224;633;591
24;León;229;Villazanzo de Valderaduey;769;415;354
24;León;230;Zotes del Páramo;839;432;407
25;Lleida;001;Abella de la Conca;165;85;80
25;Lleida;002;Àger;595;319;276
25;Lleida;003;Agramunt;4814;2415;2399
25;Lleida;038;Aitona;2265;1118;1147
25;Lleida;004;Alamús (Els);661;341;320
25;Lleida;005;Alàs i Cerc;399;216;183
25;Lleida;006;Albagés (L');553;271;282
25;Lleida;007;Albatàrrec;1009;477;532
25;Lleida;008;Albesa;1470;733;737
25;Lleida;009;Albi (L');776;400;376
25;Lleida;010;Alcanó;282;137;145
25;Lleida;011;Alcarràs;4551;2260;2291
25;Lleida;012;Alcoletge;1521;771;750
25;Lleida;013;Alfarràs;3017;1483;1534
25;Lleida;014;Alfés;339;179;160
25;Lleida;015;Algerri;562;280;282
25;Lleida;016;Alguaire;2856;1437;1419
25;Lleida;017;Alins;301;158;143
25;Lleida;019;Almacelles;5505;2831;2674
25;Lleida;020;Almatret;545;287;258
25;Lleida;021;Almenar;3591;1828;1763
25;Lleida;022;Alòs de Balaguer;164;94;70
25;Lleida;023;Alpicat;2606;1322;1284
25;Lleida;024;Alt Àneu;349;189;160
25;Lleida;027;Anglesola;1229;603;626
25;Lleida;029;Arbeca;2336;1167;1169
25;Lleida;031;Arres;101;54;47
25;Lleida;032;Arsèguel;103;52;51
25;Lleida;033;Artesa de Lleida;1211;600;611
25;Lleida;034;Artesa de Segre;3140;1610;1530
25;Lleida;036;Aspa;248;123;125
25;Lleida;037;Avellanes i Santa Linya (Les);475;255;220
25;Lleida;039;Baix Pallars;350;196;154
25;Lleida;040;Balaguer;13069;6403;6666
25;Lleida;041;Barbens;790;406;384
25;Lleida;042;Baronia de Rialb (La);257;138;119
25;Lleida;044;Bassella;367;184;183
25;Lleida;045;Bausen;68;40;28
25;Lleida;046;Belianes;564;264;300
25;Lleida;170;Bellaguarda;383;193;190
25;Lleida;047;Bellcaire d'Urgell;1427;688;739
25;Lleida;048;Bell-lloc d'Urgell;2176;1081;1095
25;Lleida;049;Bellmunt d'Urgell;238;120;118
25;Lleida;050;Bellpuig;3888;1936;1952
25;Lleida;051;Bellver de Cerdanya;1540;799;741
25;Lleida;052;Bellvís;2234;1122;1112
25;Lleida;053;Benavent de Segrià;747;383;364
25;Lleida;055;Biosca;262;129;133
25;Lleida;057;Bòrdes (Es);194;95;99
25;Lleida;058;Borges Blanques (Les);5131;2550;2581
25;Lleida;059;Bossòst;812;395;417
25;Lleida;056;Bovera;455;230;225
25;Lleida;060;Cabanabona;107;51;56
25;Lleida;061;Cabó;143;78;65
25;Lleida;062;Camarasa;939;471;468
25;Lleida;063;Canejan;108;58;50
25;Lleida;904;Castell de Mur;145;71;74
25;Lleida;064;Castellar de la Ribera;155;75;80
25;Lleida;067;Castelldans;972;497;475
25;Lleida;068;Castellnou de Seana;748;358;390
25;Lleida;069;Castelló de Farfanya;612;307;305
25;Lleida;070;Castellserà;1157;575;582
25;Lleida;071;Cava;53;31;22
25;Lleida;072;Cervera;6993;3444;3549
25;Lleida;073;Cervià de les Garrigues;845;426;419
25;Lleida;074;Ciutadilla;228;116;112
25;Lleida;075;Clariana de Cardener;142;73;69
25;Lleida;076;Cogul (El);235;118;117
25;Lleida;077;Coll de Nargó;618;320;298
25;Lleida;163;Coma i la Pedra (La);256;154;102
25;Lleida;161;Conca de Dalt;469;246;223
25;Lleida;078;Corbins;1024;525;499
25;Lleida;079;Cubells;381;193;188
25;Lleida;081;Espluga Calba (L');450;237;213
25;Lleida;082;Espot;241;118;123
25;Lleida;088;Estamariu;133;68;65
25;Lleida;085;Estaràs;164;85;79
25;Lleida;086;Esterri d'Àneu;497;252;245
25;Lleida;087;Esterri de Cardós;66;35;31
25;Lleida;089;Farrera;87;46;41
25;Lleida;908;Fígols i Alinyà;344;192;152
25;Lleida;092;Floresta (La);195;99;96
25;Lleida;093;Fondarella;632;310;322
25;Lleida;094;Foradada;156;85;71
25;Lleida;096;Fuliola (La);1322;673;649
25;Lleida;097;Fulleda;130;67;63
25;Lleida;098;Gavet de la Conca;369;188;181
25;Lleida;912;Gimenells i el Pla de la Font;1186;617;569
25;Lleida;099;Golmés;1275;628;647
25;Lleida;100;Gósol;199;106;93
25;Lleida;101;Granadella (La);850;421;429
25;Lleida;102;Granja d'Escarp (La);1140;571;569
25;Lleida;103;Granyanella;135;70;65
25;Lleida;105;Granyena de les Garrigues;174;85;89
25;Lleida;104;Granyena de Segarra;178;94;84
25;Lleida;109;Guimerà;421;206;215
25;Lleida;903;Guingueta d'Àneu (La);276;142;134
25;Lleida;110;Guissona;2720;1393;1327
25;Lleida;111;Guixers;152;85;67
25;Lleida;115;Isona i Conca Dellà;1351;705;646
25;Lleida;112;Ivars de Noguera;343;170;173
25;Lleida;113;Ivars d'Urgell;1746;852;894
25;Lleida;114;Ivorra;144;78;66
25;Lleida;910;Josa i Tuixén;152;80;72
25;Lleida;118;Juncosa;583;304;279
25;Lleida;119;Juneda;2967;1493;1474
25;Lleida;121;Les;684;339;345
25;Lleida;122;Linyola;2359;1181;1178
25;Lleida;123;Lladorre;218;118;100
25;Lleida;124;Lladurs;260;141;119
25;Lleida;125;Llardecans;669;338;331
25;Lleida;126;Llavorsí;274;145;129
25;Lleida;120;Lleida;112282;54850;57432
25;Lleida;127;Lles de Cerdanya;301;160;141
25;Lleida;128;Llimiana;125;64;61
25;Lleida;129;Llobera;253;130;123
25;Lleida;133;Maials;1074;541;533
25;Lleida;130;Maldà;329;169;160
25;Lleida;131;Massalcoreig;671;328;343
25;Lleida;132;Massoteres;161;79;82
25;Lleida;134;Menàrguens;888;442;446
25;Lleida;135;Miralcamp;1193;582;611
25;Lleida;137;Mollerussa;9012;4459;4553
25;Lleida;136;Molsosa (La);133;66;67
25;Lleida;139;Montellà i Martinet;541;282;259
25;Lleida;140;Montferrer i Castellbò;673;369;304
25;Lleida;138;Montgai;858;436;422
25;Lleida;142;Montoliu de Lleida;462;229;233
25;Lleida;141;Montoliu de Segarra;210;111;99
25;Lleida;143;Montornès de Segarra;123;56;67
25;Lleida;145;Nalec;103;45;58
25;Lleida;025;Naut Aran;1159;623;536
25;Lleida;146;Navès;283;144;139
25;Lleida;148;Odèn;310;170;140
25;Lleida;149;Oliana;2007;1029;978
25;Lleida;150;Oliola;201;103;98
25;Lleida;151;Olius;494;239;255
25;Lleida;152;Oluges (Les);213;108;105
25;Lleida;153;Omellons (Els);271;138;133
25;Lleida;154;Omells de na Gaia (Els);152;81;71
25;Lleida;155;Organyà;1039;525;514
25;Lleida;156;Os de Balaguer;766;404;362
25;Lleida;157;Ossó de Sió;245;125;120
25;Lleida;158;Palau d'Anglesola (El);1622;820;802
25;Lleida;164;Penelles;564;306;258
25;Lleida;165;Peramola;395;204;191
25;Lleida;166;Pinell de Solsonès;262;139;123
25;Lleida;167;Pinós;339;185;154
25;Lleida;911;Plans de Sió (Els);669;338;331
25;Lleida;168;Poal (El);644;337;307
25;Lleida;169;Pobla de Cérvoles (La);210;115;95
25;Lleida;171;Pobla de Segur (La);3094;1508;1586
25;Lleida;030;Pont de Bar (El);166;93;73
25;Lleida;173;Pont de Suert (El);2300;1165;1135
25;Lleida;172;Ponts;2208;1098;1110
25;Lleida;174;Portella (La);601;307;294
25;Lleida;175;Prats i Sansor;133;71;62
25;Lleida;176;Preixana;468;238;230
25;Lleida;177;Preixens;548;268;280
25;Lleida;179;Prullans;203;105;98
25;Lleida;180;Puiggròs;260;127;133
25;Lleida;181;Puigverd d'Agramunt;250;128;122
25;Lleida;182;Puigverd de Lleida;956;449;507
25;Lleida;183;Rialp;452;245;207
25;Lleida;905;Ribera d'Ondara;500;251;249
25;Lleida;185;Ribera d'Urgellet;828;430;398
25;Lleida;186;Riner;255;136;119
25;Lleida;913;Riu de Cerdanya;"";"";""
25;Lleida;189;Rosselló;1624;796;828
25;Lleida;190;Salàs de Pallars;342;173;169
25;Lleida;191;Sanaüja;465;230;235
25;Lleida;196;Sant Esteve de la Sarga;90;57;33
25;Lleida;192;Sant Guim de Freixenet;1067;542;525
25;Lleida;197;Sant Guim de la Plana;197;102;95
25;Lleida;193;Sant Llorenç de Morunys;860;444;416
25;Lleida;902;Sant Martí de Riucorb;781;401;380
25;Lleida;194;Sant Ramon;557;277;280
25;Lleida;201;Sarroca de Bellera;140;81;59
25;Lleida;200;Sarroca de Lleida;497;259;238
25;Lleida;202;Senterada;108;63;45
25;Lleida;035;Sentiu de Sió (La);468;229;239
25;Lleida;204;Seròs;1886;1007;879
25;Lleida;203;Seu d'Urgell (La);10348;5125;5223
25;Lleida;205;Sidamon;442;220;222
25;Lleida;206;Soleràs (El);445;221;224
25;Lleida;207;Solsona;6720;3362;3358
25;Lleida;208;Soriguera;304;158;146
25;Lleida;209;Sort;1645;826;819
25;Lleida;210;Soses;1514;773;741
25;Lleida;211;Sudanell;733;387;346
25;Lleida;212;Sunyer;312;155;157
25;Lleida;215;Talarn;376;186;190
25;Lleida;216;Talavera;315;158;157
25;Lleida;217;Tàrrega;11282;5493;5789
25;Lleida;218;Tarrés;100;52;48
25;Lleida;219;Tarroja de Segarra;196;95;101
25;Lleida;220;Térmens;1406;706;700
25;Lleida;221;Tírvia;106;58;48
25;Lleida;222;Tiurana;230;125;105
25;Lleida;223;Torà;1131;573;558
25;Lleida;224;Torms (Els);211;116;95
25;Lleida;225;Tornabous;865;429;436
25;Lleida;227;Torre de Cabdella (La);749;365;384
25;Lleida;226;Torrebesses;365;182;183
25;Lleida;228;Torrefarrera;1526;777;749
25;Lleida;907;Torrefeta i Florejacs;725;358;367
25;Lleida;230;Torregrossa;2211;1089;1122
25;Lleida;231;Torrelameu;609;322;287
25;Lleida;232;Torres de Segre;1814;926;888
25;Lleida;233;Torre-serona;303;152;151
25;Lleida;234;Tremp;5279;2589;2690
25;Lleida;043;Vall de Boí (La);647;353;294
25;Lleida;901;Vall de Cardós;329;168;161
25;Lleida;238;Vallbona de les Monges;286;137;149
25;Lleida;240;Vallfogona de Balaguer;1397;701;696
25;Lleida;906;Valls d'Aguilar (Les);228;123;105
25;Lleida;239;Valls de Valira (Les);821;431;390
25;Lleida;909;Vansa i Fórnols (La);174;89;85
25;Lleida;242;Verdú;948;462;486
25;Lleida;243;Vielha e Mijaran;3309;1672;1637
25;Lleida;244;Vilagrassa;417;208;209
25;Lleida;245;Vilaller;594;312;282
25;Lleida;247;Vilamòs;118;58;60
25;Lleida;248;Vilanova de Bellpuig;1178;566;612
25;Lleida;254;Vilanova de la Barca;883;447;436
25;Lleida;249;Vilanova de l'Aguda;278;143;135
25;Lleida;250;Vilanova de Meià;496;246;250
25;Lleida;251;Vilanova de Segrià;674;335;339
25;Lleida;252;Vila-sana;520;257;263
25;Lleida;253;Vilosell (El);206;89;117
25;Lleida;255;Vinaixa;728;359;369
26;Rioja (La);001;Ábalos;295;165;130
26;Rioja (La);002;Agoncillo;867;459;408
26;Rioja (La);003;Aguilar del Río Alhama;832;431;401
26;Rioja (La);004;Ajamil;72;45;27
26;Rioja (La);005;Albelda de Iregua;2170;1100;1070
26;Rioja (La);006;Alberite;1947;979;968
26;Rioja (La);007;Alcanadre;910;460;450
26;Rioja (La);008;Aldeanueva de Ebro;2537;1305;1232
26;Rioja (La);009;Alesanco;579;294;285
26;Rioja (La);010;Alesón;160;79;81
26;Rioja (La);011;Alfaro;9335;4656;4679
26;Rioja (La);012;Almarza de Cameros;38;21;17
26;Rioja (La);013;Anguciana;299;155;144
26;Rioja (La);014;Anguiano;651;355;296
26;Rioja (La);015;Arenzana de Abajo;377;201;176
26;Rioja (La);016;Arenzana de Arriba;46;25;21
26;Rioja (La);017;Arnedillo;403;196;207
26;Rioja (La);018;Arnedo;12453;6187;6266
26;Rioja (La);019;Arrúbal;402;212;190
26;Rioja (La);020;Ausejo;738;389;349
26;Rioja (La);021;Autol;3413;1728;1685
26;Rioja (La);022;Azofra;406;209;197
26;Rioja (La);023;Badarán;816;435;381
26;Rioja (La);024;Bañares;476;242;234
26;Rioja (La);026;Baños de Río Tobía;1873;956;917
26;Rioja (La);025;Baños de Rioja;133;79;54
26;Rioja (La);027;Berceo;258;147;111
26;Rioja (La);028;Bergasa;206;110;96
26;Rioja (La);029;Bergasillas Bajera;30;15;15
26;Rioja (La);030;Bezares;29;19;10
26;Rioja (La);031;Bobadilla;192;98;94
26;Rioja (La);032;Brieva de Cameros;78;44;34
26;Rioja (La);033;Briñas;192;97;95
26;Rioja (La);034;Briones;924;492;432
26;Rioja (La);035;Cabezón de Cameros;38;22;16
26;Rioja (La);036;Calahorra;19015;9202;9813
26;Rioja (La);037;Camprovín;260;136;124
26;Rioja (La);038;Canales de la Sierra;97;49;48
26;Rioja (La);039;Canillas de Río Tuerto;82;39;43
26;Rioja (La);040;Cañas;122;56;66
26;Rioja (La);041;Cárdenas;263;132;131
26;Rioja (La);042;Casalarreina;902;447;455
26;Rioja (La);043;Castañares de Rioja;537;282;255
26;Rioja (La);044;Castroviejo;49;24;25
26;Rioja (La);045;Cellorigo;18;11;7
26;Rioja (La);046;Cenicero;2195;1103;1092
26;Rioja (La);047;Cervera del Río Alhama;3431;1717;1714
26;Rioja (La);048;Cidamón;90;50;40
26;Rioja (La);049;Cihuri;185;101;84
26;Rioja (La);050;Cirueña;138;79;59
26;Rioja (La);051;Clavijo;201;102;99
26;Rioja (La);052;Cordovín;243;124;119
26;Rioja (La);053;Corera;261;126;135
26;Rioja (La);054;Cornago;708;388;320
26;Rioja (La);055;Corporales;72;37;35
26;Rioja (La);056;Cuzcurrita de Río Tirón;508;275;233
26;Rioja (La);057;Daroca de Rioja;56;34;22
26;Rioja (La);058;Enciso;193;113;80
26;Rioja (La);059;Entrena;1109;587;522
26;Rioja (La);060;Estollo;155;82;73
26;Rioja (La);061;Ezcaray;1767;935;832
26;Rioja (La);062;Foncea;156;84;72
26;Rioja (La);063;Fonzaleche;201;112;89
26;Rioja (La);064;Fuenmayor;2121;1047;1074
26;Rioja (La);065;Galbárruli;61;34;27
26;Rioja (La);066;Galilea;289;154;135
26;Rioja (La);067;Gallinero de Cameros;25;16;9
26;Rioja (La);068;Gimileo;94;47;47
26;Rioja (La);069;Grañón;482;255;227
26;Rioja (La);070;Grávalos;311;161;150
26;Rioja (La);071;Haro;8819;4312;4507
26;Rioja (La);072;Herce;379;191;188
26;Rioja (La);073;Herramélluri;194;103;91
26;Rioja (La);074;Hervías;226;119;107
26;Rioja (La);075;Hormilla;493;256;237
26;Rioja (La);076;Hormilleja;193;95;98
26;Rioja (La);077;Hornillos de Cameros;30;15;15
26;Rioja (La);078;Hornos de Moncalvillo;101;53;48
26;Rioja (La);079;Huércanos;937;480;457
26;Rioja (La);080;Igea;968;520;448
26;Rioja (La);081;Jalón de Cameros;41;24;17
26;Rioja (La);082;Laguna de Cameros;180;97;83
26;Rioja (La);083;Lagunilla del Jubera;371;195;176
26;Rioja (La);084;Lardero;3055;1516;1539
26;Rioja (La);086;Ledesma de la Cogolla;21;13;8
26;Rioja (La);087;Leiva;363;176;187
26;Rioja (La);088;Leza de Río Leza;29;20;9
26;Rioja (La);089;Logroño;122573;59183;63390
26;Rioja (La);091;Lumbreras;187;108;79
26;Rioja (La);092;Manjarrés;148;81;67
26;Rioja (La);093;Mansilla de la Sierra;52;33;19
26;Rioja (La);094;Manzanares de Rioja;146;79;67
26;Rioja (La);095;Matute;190;93;97
26;Rioja (La);096;Medrano;240;129;111
26;Rioja (La);098;Munilla;147;68;79
26;Rioja (La);099;Murillo de Río Leza;1599;799;800
26;Rioja (La);100;Muro de Aguas;70;39;31
26;Rioja (La);101;Muro en Cameros;44;31;13
26;Rioja (La);102;Nájera;6979;3475;3504
26;Rioja (La);103;Nalda;904;461;443
26;Rioja (La);104;Navajún;20;14;6
26;Rioja (La);105;Navarrete;2042;1036;1006
26;Rioja (La);106;Nestares;62;35;27
26;Rioja (La);107;Nieva de Cameros;120;63;57
26;Rioja (La);109;Ochánduri;117;59;58
26;Rioja (La);108;Ocón;339;180;159
26;Rioja (La);110;Ojacastro;245;143;102
26;Rioja (La);111;Ollauri;306;167;139
26;Rioja (La);112;Ortigosa de Cameros;355;174;181
26;Rioja (La);113;Pazuengos;47;29;18
26;Rioja (La);114;Pedroso;117;62;55
26;Rioja (La);115;Pinillos;26;15;11
26;Rioja (La);117;Pradejón;2850;1439;1411
26;Rioja (La);118;Pradillo;113;60;53
26;Rioja (La);119;Préjano;215;98;117
26;Rioja (La);120;Quel;2017;1052;965
26;Rioja (La);121;Rabanera;45;23;22
26;Rioja (La);122;Rasillo de Cameros (El);125;67;58
26;Rioja (La);123;Redal (El);241;122;119
26;Rioja (La);124;Ribafrecha;1091;587;504
26;Rioja (La);125;Rincón de Soto;3316;1665;1651
26;Rioja (La);126;Robres del Castillo;27;16;11
26;Rioja (La);127;Rodezno;368;187;181
26;Rioja (La);128;Sajazarra;171;86;85
26;Rioja (La);129;San Asensio;1388;720;668
26;Rioja (La);130;San Millán de la Cogolla;305;182;123
26;Rioja (La);131;San Millán de Yécora;81;49;32
26;Rioja (La);132;San Román de Cameros;191;102;89
26;Rioja (La);139;San Torcuato;134;73;61
26;Rioja (La);142;San Vicente de la Sonsierra;1157;596;561
26;Rioja (La);134;Santa Coloma;168;101;67
26;Rioja (La);135;Santa Engracia del Jubera;193;115;78
26;Rioja (La);136;Santa Eulalia Bajera;114;63;51
26;Rioja (La);138;Santo Domingo de la Calzada;5535;2787;2748
26;Rioja (La);140;Santurde de Rioja;324;158;166
26;Rioja (La);141;Santurdejo;251;137;114
26;Rioja (La);143;Sojuela;98;57;41
26;Rioja (La);144;Sorzano;274;148;126
26;Rioja (La);145;Sotés;297;154;143
26;Rioja (La);146;Soto en Cameros;126;69;57
26;Rioja (La);147;Terroba;35;20;15
26;Rioja (La);148;Tirgo;289;145;144
26;Rioja (La);149;Tobía;67;39;28
26;Rioja (La);150;Tormantos;224;115;109
26;Rioja (La);153;Torre en Cameros;14;11;3
26;Rioja (La);151;Torrecilla en Cameros;510;265;245
26;Rioja (La);152;Torrecilla sobre Alesanco;109;56;53
26;Rioja (La);154;Torremontalbo;12;7;5
26;Rioja (La);155;Treviana;314;168;146
26;Rioja (La);157;Tricio;401;200;201
26;Rioja (La);158;Tudelilla;513;257;256
26;Rioja (La);160;Uruñuela;725;377;348
26;Rioja (La);161;Valdemadera;16;10;6
26;Rioja (La);162;Valgañón;182;98;84
26;Rioja (La);163;Ventosa;146;75;71
26;Rioja (La);164;Ventrosa;100;42;58
26;Rioja (La);165;Viguera;418;224;194
26;Rioja (La);166;Villalba de Rioja;176;99;77
26;Rioja (La);167;Villalobar de Rioja;141;81;60
26;Rioja (La);168;Villamediana de Iregua;1882;969;913
26;Rioja (La);169;Villanueva de Cameros;123;61;62
26;Rioja (La);170;Villar de Arnedo (El);761;375;386
26;Rioja (La);171;Villar de Torre;367;187;180
26;Rioja (La);172;Villarejo;48;29;19
26;Rioja (La);173;Villarroya;11;5;6
26;Rioja (La);174;Villarta-Quintana;238;121;117
26;Rioja (La);175;Villavelayo;76;44;32
26;Rioja (La);176;Villaverde de Rioja;99;56;43
26;Rioja (La);177;Villoslada de Cameros;390;221;169
26;Rioja (La);178;Viniegra de Abajo;141;72;69
26;Rioja (La);179;Viniegra de Arriba;46;26;20
26;Rioja (La);180;Zarratón;308;159;149
26;Rioja (La);181;Zarzosa;17;12;5
26;Rioja (La);183;Zorraquín;42;26;16
27;Lugo;001;Abadín;4083;1962;2121
27;Lugo;002;Alfoz;2697;1322;1375
27;Lugo;003;Antas de Ulla;3319;1609;1710
27;Lugo;004;Baleira;2181;1137;1044
27;Lugo;901;Baralla;3842;1958;1884
27;Lugo;005;Barreiros;3786;1811;1975
27;Lugo;006;Becerreá;4128;2098;2030
27;Lugo;007;Begonte;4588;2275;2313
27;Lugo;008;Bóveda;2334;1139;1195
27;Lugo;902;Burela;"";"";""
27;Lugo;009;Carballedo;4197;2088;2109
27;Lugo;010;Castro de Rei;5865;2947;2918
27;Lugo;011;Castroverde;3917;2003;1914
27;Lugo;012;Cervantes;2564;1393;1171
27;Lugo;013;Cervo;12780;6353;6427
27;Lugo;016;Chantada;10187;4969;5218
27;Lugo;014;Corgo (O);4796;2427;2369
27;Lugo;015;Cospeito;6453;3174;3279
27;Lugo;017;Folgoso do Courel;1888;968;920
27;Lugo;018;Fonsagrada (A);6933;3654;3279
27;Lugo;019;Foz;9777;4724;5053
27;Lugo;020;Friol;5119;2563;2556
27;Lugo;022;Guitiriz;6962;3463;3499
27;Lugo;023;Guntín;3973;1951;2022
27;Lugo;024;Incio (O);2889;1449;1440
27;Lugo;026;Láncara;3590;1860;1730
27;Lugo;027;Lourenzá;3136;1521;1615
27;Lugo;028;Lugo;83802;39751;44051
27;Lugo;029;Meira;1883;933;950
27;Lugo;030;Mondoñedo;5817;2715;3102
27;Lugo;031;Monforte de Lemos;20360;9784;10576
27;Lugo;032;Monterroso;4553;2293;2260
27;Lugo;033;Muras;1408;712;696
27;Lugo;034;Navia de Suarna;2298;1232;1066
27;Lugo;035;Negueira de Muñiz;335;174;161
27;Lugo;037;Nogais (As);1943;1019;924
27;Lugo;038;Ourol;1939;933;1006
27;Lugo;039;Outeiro de Rei;4215;2095;2120
27;Lugo;040;Palas de Rei;5004;2490;2514
27;Lugo;041;Pantón;4072;1964;2108
27;Lugo;042;Paradela;3209;1585;1624
27;Lugo;043;Páramo (O);2091;1079;1012
27;Lugo;044;Pastoriza (A);4459;2234;2225
27;Lugo;045;Pedrafita do Cebreiro;2096;1118;978
27;Lugo;047;Pobra do Brollón (A);3243;1596;1647
27;Lugo;046;Pol;2453;1207;1246
27;Lugo;048;Pontenova (A);3747;1817;1930
27;Lugo;049;Portomarín;2229;1113;1116
27;Lugo;050;Quiroga;5125;2517;2608
27;Lugo;056;Rábade;1771;902;869
27;Lugo;051;Ribadeo;8970;4224;4746
27;Lugo;052;Ribas de Sil;1664;806;858
27;Lugo;053;Ribeira de Piquín;1078;538;540
27;Lugo;054;Riotorto;2234;1105;1129
27;Lugo;055;Samos;2419;1285;1134
27;Lugo;057;Sarria;12611;6243;6368
27;Lugo;058;Saviñao (O);5872;2883;2989
27;Lugo;059;Sober;3744;1803;1941
27;Lugo;060;Taboada;5068;2514;2554
27;Lugo;061;Trabada;2029;985;1044
27;Lugo;062;Triacastela;1060;549;511
27;Lugo;063;Valadouro (O);2800;1388;1412
27;Lugo;064;Vicedo (O);2693;1307;1386
27;Lugo;065;Vilalba;16128;7860;8268
27;Lugo;066;Viveiro;15082;7174;7908
27;Lugo;021;Xermade;3098;1544;1554
27;Lugo;025;Xove;3568;1778;1790
28;Madrid;001;Acebeda (La);56;28;28
28;Madrid;002;Ajalvir;1327;709;618
28;Madrid;003;Alameda del Valle;166;90;76
28;Madrid;004;Álamo (El);2999;1497;1502
28;Madrid;005;Alcalá de Henares;161381;80739;80642
28;Madrid;006;Alcobendas;80040;39715;40325
28;Madrid;007;Alcorcón;139686;69498;70188
28;Madrid;008;Aldea del Fresno;1167;594;573
28;Madrid;009;Algete;10536;5396;5140
28;Madrid;010;Alpedrete;3586;1821;1765
28;Madrid;011;Ambite;283;140;143
28;Madrid;012;Anchuelo;530;286;244
28;Madrid;013;Aranjuez;36635;17812;18823
28;Madrid;014;Arganda del Rey;26523;13229;13294
28;Madrid;015;Arroyomolinos;1325;658;667
28;Madrid;016;Atazar (El);86;49;37
28;Madrid;017;Batres;378;197;181
28;Madrid;018;Becerril de la Sierra;1996;996;1000
28;Madrid;019;Belmonte de Tajo;1144;586;558
28;Madrid;021;Berrueco (El);278;150;128
28;Madrid;020;Berzosa del Lozoya;92;47;45
28;Madrid;022;Boadilla del Monte;16293;8198;8095
28;Madrid;023;Boalo (El);1795;909;886
28;Madrid;024;Braojos;127;71;56
28;Madrid;025;Brea de Tajo;468;247;221
28;Madrid;026;Brunete;2581;1297;1284
28;Madrid;027;Buitrago del Lozoya;1280;625;655
28;Madrid;028;Bustarviejo;1249;638;611
28;Madrid;029;Cabanillas de la Sierra;374;195;179
28;Madrid;030;Cabrera (La);1053;539;514
28;Madrid;031;Cadalso de los Vidrios;2108;1076;1032
28;Madrid;032;Camarma de Esteruelas;1450;731;719
28;Madrid;033;Campo Real;2182;1105;1077
28;Madrid;034;Canencia;440;229;211
28;Madrid;035;Carabaña;1073;540;533
28;Madrid;036;Casarrubuelos;553;294;259
28;Madrid;037;Cenicientos;1793;879;914
28;Madrid;038;Cercedilla;4020;1980;2040
28;Madrid;039;Cervera de Buitrago;91;50;41
28;Madrid;051;Chapinería;938;493;445
28;Madrid;052;Chinchón;3965;1979;1986
28;Madrid;040;Ciempozuelos;10902;5543;5359
28;Madrid;041;Cobeña;1225;628;597
28;Madrid;046;Collado Mediano;2487;1263;1224
28;Madrid;047;Collado Villalba;27853;13826;14027
28;Madrid;043;Colmenar de Oreja;5266;2563;2703
28;Madrid;042;Colmenar del Arroyo;531;270;261
28;Madrid;045;Colmenar Viejo;24702;12279;12423
28;Madrid;044;Colmenarejo;2509;1308;1201
28;Madrid;048;Corpa;351;184;167
28;Madrid;049;Coslada;75270;37727;37543
28;Madrid;050;Cubas de la Sagra;916;447;469
28;Madrid;053;Daganzo de Arriba;1684;858;826
28;Madrid;054;Escorial (El);7353;3663;3690
28;Madrid;055;Estremera;1067;561;506
28;Madrid;056;Fresnedillas de la Oliva;459;226;233
28;Madrid;057;Fresno de Torote;248;121;127
28;Madrid;058;Fuenlabrada;147780;74749;73031
28;Madrid;059;Fuente el Saz de Jarama;2717;1394;1323
28;Madrid;060;Fuentidueña de Tajo;1306;630;676
28;Madrid;061;Galapagar;9938;5032;4906
28;Madrid;062;Garganta de los Montes;304;149;155
28;Madrid;063;Gargantilla del Lozoya y Pinilla de Buitrago;221;127;94
28;Madrid;064;Gascones;106;52;54
28;Madrid;065;Getafe;140341;70012;70329
28;Madrid;066;Griñón;2353;1208;1145
28;Madrid;067;Guadalix de la Sierra;1786;903;883
28;Madrid;068;Guadarrama;7071;3516;3555
28;Madrid;069;Hiruela (La);39;23;16
28;Madrid;070;Horcajo de la Sierra;117;61;56
28;Madrid;071;Horcajuelo de la Sierra;73;35;38
28;Madrid;072;Hoyo de Manzanares;3553;1782;1771
28;Madrid;073;Humanes de Madrid;8234;4182;4052
28;Madrid;074;Leganés;172951;86622;86329
28;Madrid;075;Loeches;2283;1165;1118
28;Madrid;076;Lozoya;399;207;192
28;Madrid;901;Lozoyuela-Navas-Sieteiglesias;615;330;285
28;Madrid;078;Madarcos;33;17;16
28;Madrid;079;Madrid;3017439;1418994;1598445
28;Madrid;080;Majadahonda;34256;16751;17505
28;Madrid;082;Manzanares el Real;2439;1255;1184
28;Madrid;083;Meco;3255;1670;1585
28;Madrid;084;Mejorada del Campo;13802;7020;6782
28;Madrid;085;Miraflores de la Sierra;2718;1335;1383
28;Madrid;086;Molar (El);2760;1449;1311
28;Madrid;087;Molinos (Los);2528;1190;1338
28;Madrid;088;Montejo de la Sierra;253;121;132
28;Madrid;089;Moraleja de Enmedio;1532;751;781
28;Madrid;090;Moralzarzal;2246;1151;1095
28;Madrid;091;Morata de Tajuña;5066;2483;2583
28;Madrid;092;Móstoles;192899;95929;96970
28;Madrid;093;Navacerrada;1621;870;751
28;Madrid;094;Navalafuente;328;175;153
28;Madrid;095;Navalagamella;626;311;315
28;Madrid;096;Navalcarnero;10398;5299;5099
28;Madrid;097;Navarredonda y San Mamés;96;48;48
28;Madrid;099;Navas del Rey;1061;532;529
28;Madrid;100;Nuevo Baztán;680;362;318
28;Madrid;101;Olmeda de las Fuentes;119;63;56
28;Madrid;102;Orusco de Tajuña;597;298;299
28;Madrid;104;Paracuellos de Jarama;4607;2390;2217
28;Madrid;106;Parla;70423;35339;35084
28;Madrid;107;Patones;339;173;166
28;Madrid;108;Pedrezuela;811;419;392
28;Madrid;109;Pelayos de la Presa;951;478;473
28;Madrid;110;Perales de Tajuña;1982;959;1023
28;Madrid;111;Pezuela de las Torres;466;246;220
28;Madrid;112;Pinilla del Valle;154;82;72
28;Madrid;113;Pinto;22535;11245;11290
28;Madrid;114;Piñuécar-Gandullas;145;69;76
28;Madrid;115;Pozuelo de Alarcón;50800;25024;25776
28;Madrid;116;Pozuelo del Rey;218;110;108
28;Madrid;117;Prádena del Rincón;102;53;49
28;Madrid;118;Puebla de la Sierra;52;29;23
28;Madrid;902;Puentes Viejas;385;200;185
28;Madrid;119;Quijorna;623;327;296
28;Madrid;120;Rascafría;1308;677;631
28;Madrid;121;Redueña;149;72;77
28;Madrid;122;Ribatejada;287;146;141
28;Madrid;123;Rivas-Vaciamadrid;15851;7971;7880
28;Madrid;124;Robledillo de la Jara;58;30;28
28;Madrid;125;Robledo de Chavela;1852;911;941
28;Madrid;126;Robregordo;82;40;42
28;Madrid;127;Rozas de Madrid (Las);37785;18604;19181
28;Madrid;128;Rozas de Puerto Real;345;176;169
28;Madrid;129;San Agustín del Guadalix;3364;1738;1626
28;Madrid;130;San Fernando de Henares;26012;13022;12990
28;Madrid;131;San Lorenzo de El Escorial;8839;4258;4581
28;Madrid;132;San Martín de la Vega;6650;3394;3256
28;Madrid;133;San Martín de Valdeiglesias;5461;2731;2730
28;Madrid;134;San Sebastián de los Reyes;54053;27140;26913
28;Madrid;135;Santa María de la Alameda;711;387;324
28;Madrid;136;Santorcaz;535;278;257
28;Madrid;137;Santos de la Humosa (Los);941;492;449
28;Madrid;138;Serna del Monte (La);92;47;45
28;Madrid;140;Serranillos del Valle;507;260;247
28;Madrid;141;Sevilla la Nueva;1433;713;720
28;Madrid;143;Somosierra;106;66;40
28;Madrid;144;Soto del Real;2760;1392;1368
28;Madrid;145;Talamanca de Jarama;1115;557;558
28;Madrid;146;Tielmes;1954;996;958
28;Madrid;147;Titulcia;864;426;438
28;Madrid;148;Torrejón de Ardoz;82993;41685;41308
28;Madrid;149;Torrejón de la Calzada;1599;817;782
28;Madrid;150;Torrejón de Velasco;1488;769;719
28;Madrid;151;Torrelaguna;2557;1233;1324
28;Madrid;152;Torrelodones;7739;3837;3902
28;Madrid;153;Torremocha de Jarama;246;122;124
28;Madrid;154;Torres de la Alameda;3134;1554;1580
28;Madrid;903;Tres Cantos;16331;8104;8227
28;Madrid;155;Valdaracete;682;334;348
28;Madrid;156;Valdeavero;497;256;241
28;Madrid;157;Valdelaguna;537;282;255
28;Madrid;158;Valdemanco;482;254;228
28;Madrid;159;Valdemaqueda;470;227;243
28;Madrid;160;Valdemorillo;2892;1474;1418
28;Madrid;161;Valdemoro;18025;8997;9028
28;Madrid;162;Valdeolmos-Alalpardo;1131;593;538
28;Madrid;163;Valdepiélagos;331;166;165
28;Madrid;164;Valdetorres de Jarama;1278;654;624
28;Madrid;165;Valdilecha;1630;818;812
28;Madrid;166;Valverde de Alcalá;231;123;108
28;Madrid;167;Velilla de San Antonio;2446;1244;1202
28;Madrid;168;Vellón (El);908;464;444
28;Madrid;169;Venturada;338;176;162
28;Madrid;171;Villa del Prado;3291;1658;1633
28;Madrid;170;Villaconejos;2879;1485;1394
28;Madrid;172;Villalbilla;1995;1028;967
28;Madrid;173;Villamanrique de Tajo;563;284;279
28;Madrid;174;Villamanta;1227;619;608
28;Madrid;175;Villamantilla;300;151;149
28;Madrid;176;Villanueva de la Cañada;4605;2336;2269
28;Madrid;178;Villanueva de Perales;348;197;151
28;Madrid;177;Villanueva del Pardillo;2171;1091;1080
28;Madrid;179;Villar del Olmo;529;273;256
28;Madrid;180;Villarejo de Salvanés;5008;2498;2510
28;Madrid;181;Villaviciosa de Odón;13708;6707;7001
28;Madrid;182;Villavieja del Lozoya;158;76;82
28;Madrid;183;Zarzalejo;870;444;426
29;Málaga;001;Alameda;4875;2440;2435
29;Málaga;002;Alcaucín;1390;691;699
29;Málaga;003;Alfarnate;1530;795;735
29;Málaga;004;Alfarnatejo;428;235;193
29;Málaga;005;Algarrobo;4553;2306;2247
29;Málaga;006;Algatocín;996;511;485
29;Málaga;007;Alhaurín de la Torre;12874;6471;6403
29;Málaga;008;Alhaurín el Grande;17394;8584;8810
29;Málaga;009;Almáchar;2027;1034;993
29;Málaga;010;Almargen;2261;1131;1130
29;Málaga;011;Almogía;3857;1958;1899
29;Málaga;012;Álora;13176;6628;6548
29;Málaga;013;Alozaina;2578;1350;1228
29;Málaga;014;Alpandeire;334;177;157
29;Málaga;015;Antequera;38954;19028;19926
29;Málaga;016;Árchez;329;179;150
29;Málaga;017;Archidona;10271;5143;5128
29;Málaga;018;Ardales;3222;1633;1589
29;Málaga;019;Arenas;1263;676;587
29;Málaga;020;Arriate;3300;1641;1659
29;Málaga;021;Atajate;163;90;73
29;Málaga;022;Benadalid;260;140;120
29;Málaga;023;Benahavís;1355;657;698
29;Málaga;024;Benalauría;531;278;253
29;Málaga;025;Benalmádena;22323;11039;11284
29;Málaga;026;Benamargosa;1658;835;823
29;Málaga;027;Benamocarra;2795;1413;1382
29;Málaga;028;Benaoján;1640;819;821
29;Málaga;029;Benarrabá;701;348;353
29;Málaga;030;Borge (El);1070;557;513
29;Málaga;031;Burgo (El);2128;1101;1027
29;Málaga;032;Campillos;7646;3859;3787
29;Málaga;033;Canillas de Aceituno;2789;1417;1372
29;Málaga;034;Canillas de Albaida;639;334;305
29;Málaga;035;Cañete la Real;2332;1204;1128
29;Málaga;036;Carratraca;817;408;409
29;Málaga;037;Cartajima;354;185;169
29;Málaga;038;Cártama;11159;5606;5553
29;Málaga;039;Casabermeja;3102;1642;1460
29;Málaga;040;Casarabonela;2566;1331;1235
29;Málaga;041;Casares;3310;1729;1581
29;Málaga;042;Coín;14855;7408;7447
29;Málaga;043;Colmenar;3166;1541;1625
29;Málaga;044;Comares;1468;763;705
29;Málaga;045;Cómpeta;2473;1230;1243
29;Málaga;046;Cortes de la Frontera;3744;1869;1875
29;Málaga;047;Cuevas Bajas;1546;726;820
29;Málaga;049;Cuevas de San Marcos;4124;2061;2063
29;Málaga;048;Cuevas del Becerro;2024;1045;979
29;Málaga;050;Cútar;616;317;299
29;Málaga;051;Estepona;35240;17639;17601
29;Málaga;052;Faraján;318;164;154
29;Málaga;053;Frigiliana;2186;1069;1117
29;Málaga;054;Fuengirola;39290;19287;20003
29;Málaga;055;Fuente de Piedra;2003;974;1029
29;Málaga;056;Gaucín;1803;933;870
29;Málaga;057;Genalguacil;665;341;324
29;Málaga;058;Guaro;1996;1018;978
29;Málaga;059;Humilladero;2346;1173;1173
29;Málaga;060;Igualeja;1047;534;513
29;Málaga;061;Istán;1320;666;654
29;Málaga;062;Iznate;748;377;371
29;Málaga;063;Jimera de Líbar;463;232;231
29;Málaga;064;Jubrique;904;464;440
29;Málaga;065;Júzcar;252;142;110
29;Málaga;066;Macharaviaya;359;188;171
29;Málaga;067;Málaga;524542;252859;271683
29;Málaga;068;Manilva;4926;2522;2404
29;Málaga;069;Marbella;81129;40202;40927
29;Málaga;070;Mijas;31993;15967;16026
29;Málaga;071;Moclinejo;1070;542;528
29;Málaga;072;Mollina;3164;1551;1613
29;Málaga;073;Monda;1658;851;807
29;Málaga;074;Montejaque;1039;505;534
29;Málaga;075;Nerja;13863;6869;6994
29;Málaga;076;Ojén;1987;1043;944
29;Málaga;077;Parauta;301;150;151
29;Málaga;079;Periana;3408;1782;1626
29;Málaga;080;Pizarra;6464;3278;3186
29;Málaga;081;Pujerra;350;199;151
29;Málaga;082;Rincón de la Victoria;13070;6472;6598
29;Málaga;083;Riogordo;2569;1313;1256
29;Málaga;084;Ronda;33921;16720;17201
29;Málaga;085;Salares;235;121;114
29;Málaga;086;Sayalonga;1053;539;514
29;Málaga;087;Sedella;471;253;218
29;Málaga;088;Sierra de Yeguas;3192;1609;1583
29;Málaga;089;Teba;4398;2232;2166
29;Málaga;090;Tolox;3100;1596;1504
29;Málaga;901;Torremolinos;28455;13932;14523
29;Málaga;091;Torrox;10645;5393;5252
29;Málaga;092;Totalán;604;314;290
29;Málaga;093;Valle de Abdalajís;2999;1522;1477
29;Málaga;094;Vélez-Málaga;51634;25743;25891
29;Málaga;095;Villanueva de Algaidas;4256;2104;2152
29;Málaga;098;Villanueva de Tapia;1608;811;797
29;Málaga;096;Villanueva del Rosario;3190;1574;1616
29;Málaga;097;Villanueva del Trabuco;4557;2329;2228
29;Málaga;099;Viñuela;1164;589;575
29;Málaga;100;Yunquera;3165;1648;1517
30;Murcia;001;Abanilla;6107;3018;3089
30;Murcia;002;Abarán;11884;5883;6001
30;Murcia;003;Águilas;25110;12578;12532
30;Murcia;004;Albudeite;1401;705;696
30;Murcia;005;Alcantarilla;30621;14933;15688
30;Murcia;902;Alcázares (Los);3827;1869;1958
30;Murcia;006;Aledo;984;510;474
30;Murcia;007;Alguazas;6961;3448;3513
30;Murcia;008;Alhama de Murcia;14318;7059;7259
30;Murcia;009;Archena;13550;6742;6808
30;Murcia;010;Beniel;7339;3646;3693
30;Murcia;011;Blanca;5802;2832;2970
30;Murcia;012;Bullas;10073;5064;5009
30;Murcia;013;Calasparra;8805;4402;4403
30;Murcia;014;Campos del Río;1981;983;998
30;Murcia;015;Caravaca de la Cruz;21346;10558;10788
30;Murcia;016;Cartagena;169536;84000;85536
30;Murcia;017;Cehegín;13670;6806;6864
30;Murcia;018;Ceutí;6536;3291;3245
30;Murcia;019;Cieza;31485;15330;16155
30;Murcia;020;Fortuna;6072;3062;3010
30;Murcia;021;Fuente Álamo de Murcia;8311;4145;4166
30;Murcia;022;Jumilla;20236;10045;10191
30;Murcia;023;Librilla;3758;1829;1929
30;Murcia;024;Lorca;66555;32842;33713
30;Murcia;025;Lorquí;5412;2673;2739
30;Murcia;026;Mazarrón;14729;7389;7340
30;Murcia;027;Molina de Segura;38714;19014;19700
30;Murcia;028;Moratalla;8906;4507;4399
30;Murcia;029;Mula;13171;6553;6618
30;Murcia;030;Murcia;328408;159822;168586
30;Murcia;031;Ojós;669;329;340
30;Murcia;032;Pliego;3334;1697;1637
30;Murcia;033;Puerto Lumbreras;10070;4891;5179
30;Murcia;034;Ricote;1705;824;881
30;Murcia;035;San Javier;14947;7432;7515
30;Murcia;036;San Pedro del Pinatar;12220;6041;6179
30;Murcia;901;Santomera;8681;4326;4355
30;Murcia;037;Torre-Pacheco;16820;8475;8345
30;Murcia;038;Torres de Cotillas (Las);14342;7195;7147
30;Murcia;039;Totana;20816;10321;10495
30;Murcia;040;Ulea;1065;536;529
30;Murcia;041;Unión (La);14072;6982;7090
30;Murcia;042;Villanueva del Río Segura;1646;827;819
30;Murcia;043;Yecla;27391;13639;13752
31;Navarra;001;Abáigar;93;49;44
31;Navarra;002;Abárzuza;503;243;260
31;Navarra;003;Abaurregaina/Abaurrea Alta;220;128;92
31;Navarra;004;Abaurrepea/Abaurrea Baja;53;36;17
31;Navarra;005;Aberin;370;190;180
31;Navarra;006;Ablitas;2303;1184;1119
31;Navarra;007;Adiós;114;58;56
31;Navarra;008;Aguilar de Codés;123;67;56
31;Navarra;009;Aibar/Oibar;969;493;476
31;Navarra;011;Allín;804;417;387
31;Navarra;012;Allo;1115;547;568
31;Navarra;010;Altsasu/Alsasua;7004;3568;3436
31;Navarra;013;Améscoa Baja;848;438;410
31;Navarra;014;Ancín;289;150;139
31;Navarra;015;Andosilla;2484;1230;1254
31;Navarra;016;Ansoáin;5137;2588;2549
31;Navarra;017;Anue;435;254;181
31;Navarra;018;Añorbe;411;228;183
31;Navarra;019;Aoiz/Agoitz;1894;928;966
31;Navarra;020;Araitz;630;365;265
31;Navarra;025;Arakil;2838;1492;1346
31;Navarra;021;Aranarache;106;51;55
31;Navarra;023;Aranguren;1728;916;812
31;Navarra;024;Arano;173;95;78
31;Navarra;022;Arantza;726;406;320
31;Navarra;026;Aras;233;117;116
31;Navarra;027;Arbizu;908;482;426
31;Navarra;028;Arce/Artzi;281;155;126
31;Navarra;029;Arcos (Los);1386;695;691
31;Navarra;030;Arellano;218;120;98
31;Navarra;031;Areso;279;152;127
31;Navarra;032;Arguedas;2286;1128;1158
31;Navarra;033;Aria;77;49;28
31;Navarra;034;Aribe;78;42;36
31;Navarra;035;Armañanzas;113;57;56
31;Navarra;036;Arróniz;1237;670;567
31;Navarra;037;Arruazu;128;69;59
31;Navarra;038;Artajona;1690;895;795
31;Navarra;039;Artazu;94;50;44
31;Navarra;040;Atez;251;147;104
31;Navarra;058;Auritz/Burguete;299;137;162
31;Navarra;041;Ayegui;767;390;377
31;Navarra;042;Azagra;3334;1657;1677
31;Navarra;043;Azuelo;76;40;36
31;Navarra;044;Bakaiku;356;200;156
31;Navarra;901;Barañain;16871;8344;8527
31;Navarra;045;Barásoain;420;215;205
31;Navarra;046;Barbarin;118;54;64
31;Navarra;047;Bargota;416;211;205
31;Navarra;048;Barillas;209;101;108
31;Navarra;049;Basaburua;735;414;321
31;Navarra;050;Baztan;7989;4031;3958
31;Navarra;137;Beintza-Labaien;318;183;135
31;Navarra;051;Beire;341;162;179
31;Navarra;052;Belascoáin;89;47;42
31;Navarra;250;Bera/Vera de Bidasoa;3528;1799;1729
31;Navarra;053;Berbinzana;734;367;367
31;Navarra;905;Beriáin;"";"";""
31;Navarra;902;Berrioplano;891;445;446
31;Navarra;903;Berriozar;5278;2686;2592
31;Navarra;054;Bertizarana;659;325;334
31;Navarra;055;Betelu;341;189;152
31;Navarra;253;Bidaurreta;107;63;44
31;Navarra;056;Biurrun-Olcoz;173;94;79
31;Navarra;057;Buñuel;2393;1167;1226
31;Navarra;059;Burgui/Burgi;257;145;112
31;Navarra;060;Burlada/Burlata;15269;7628;7641
31;Navarra;061;Busto (El);118;56;62
31;Navarra;062;Cabanillas;1423;714;709
31;Navarra;063;Cabredo;151;78;73
31;Navarra;064;Cadreita;1882;911;971
31;Navarra;065;Caparroso;2372;1157;1215
31;Navarra;066;Cárcar;1249;619;630
31;Navarra;067;Carcastillo;2573;1302;1271
31;Navarra;068;Cascante;3505;1701;1804
31;Navarra;069;Cáseda;1124;552;572
31;Navarra;070;Castejón;3200;1620;1580
31;Navarra;071;Castillonuevo;24;14;10
31;Navarra;072;Cintruénigo;5403;2704;2699
31;Navarra;074;Cirauqui;463;257;206
31;Navarra;075;Ciriza;57;25;32
31;Navarra;076;Cizur;6855;3448;3407
31;Navarra;077;Corella;6270;3128;3142
31;Navarra;078;Cortes;3264;1644;1620
31;Navarra;079;Desojo;169;87;82
31;Navarra;080;Dicastillo;737;388;349
31;Navarra;081;Donamaria;355;179;176
31;Navarra;221;Doneztebe/Santesteban;1225;619;606
31;Navarra;083;Echarri;70;39;31
31;Navarra;086;Egüés;1147;562;585
31;Navarra;087;Elgorriaga;182;91;91
31;Navarra;089;Enériz;192;98;94
31;Navarra;090;Eratsun;195;120;75
31;Navarra;091;Ergoiena;514;289;225
31;Navarra;092;Erro;777;415;362
31;Navarra;094;Eslava;214;110;104
31;Navarra;095;Esparza de Salazar;130;67;63
31;Navarra;096;Espronceda;198;116;82
31;Navarra;097;Estella/Lizarra;12772;6181;6591
31;Navarra;098;Esteribar;1422;766;656
31;Navarra;099;Etayo;100;52;48
31;Navarra;082;Etxalar;867;444;423
31;Navarra;084;Etxarri-Aranatz;2402;1247;1155
31;Navarra;085;Etxauri;414;207;207
31;Navarra;100;Eulate;406;207;199
31;Navarra;101;Ezcabarte;958;508;450
31;Navarra;093;Ezcároz/Ezkaroze;354;190;164
31;Navarra;102;Ezkurra;267;160;107
31;Navarra;103;Ezprogui;75;38;37
31;Navarra;104;Falces;2715;1336;1379
31;Navarra;105;Fitero;2151;1067;1084
31;Navarra;106;Fontellas;558;287;271
31;Navarra;107;Funes;2165;1094;1071
31;Navarra;108;Fustiñana;2313;1170;1143
31;Navarra;109;Galar;3157;1606;1551
31;Navarra;110;Gallipienzo;196;108;88
31;Navarra;111;Gallués/Galoze;136;84;52
31;Navarra;112;Garaioa;146;78;68
31;Navarra;113;Garde;221;116;105
31;Navarra;114;Garínoain;290;152;138
31;Navarra;115;Garralda;243;129;114
31;Navarra;116;Genevilla;133;67;66
31;Navarra;117;Goizueta;1038;564;474
31;Navarra;118;Goñi;211;114;97
31;Navarra;119;Güesa/Gorza;89;50;39
31;Navarra;120;Guesálaz;532;291;241
31;Navarra;121;Guirguillano;82;45;37
31;Navarra;256;Hiriberri/Villanueva de Aezkoa;173;90;83
31;Navarra;122;Huarte/Uharte;2788;1398;1390
31;Navarra;124;Ibargoiti;214;127;87
31;Navarra;259;Igantzi;591;305;286
31;Navarra;125;Igúzquiza;361;179;182
31;Navarra;126;Imotz;422;229;193
31;Navarra;127;Irañeta;160;89;71
31;Navarra;904;Irurtzun;"";"";""
31;Navarra;128;Isaba/Izaba;588;292;296
31;Navarra;129;Ituren;485;243;242
31;Navarra;130;Iturmendi;360;185;175
31;Navarra;131;Iza;640;333;307
31;Navarra;132;Izagaondoa;190;108;82
31;Navarra;133;Izalzu/Itzaltzu;49;25;24
31;Navarra;134;Jaurrieta;317;164;153
31;Navarra;135;Javier;156;69;87
31;Navarra;136;Juslapeña;442;240;202
31;Navarra;138;Lakuntza;973;513;460
31;Navarra;139;Lana;221;123;98
31;Navarra;140;Lantz;115;64;51
31;Navarra;141;Lapoblación;181;99;82
31;Navarra;142;Larraga;1907;997;910
31;Navarra;143;Larraona;187;96;91
31;Navarra;144;Larraun;1906;1025;881
31;Navarra;145;Lazagurría;246;128;118
31;Navarra;146;Leache;66;37;29
31;Navarra;147;Legarda;72;38;34
31;Navarra;148;Legaria;173;90;83
31;Navarra;149;Leitza;3181;1646;1535
31;Navarra;908;Lekunberri;"";"";""
31;Navarra;150;Leoz;210;117;93
31;Navarra;151;Lerga;114;61;53
31;Navarra;152;Lerín;2060;1024;1036
31;Navarra;153;Lesaka;2754;1443;1311
31;Navarra;154;Lezáun;279;156;123
31;Navarra;155;Liédena;334;159;175
31;Navarra;156;Lizoáin;237;129;108
31;Navarra;157;Lodosa;4571;2297;2274
31;Navarra;158;Lónguida/Longida;316;171;145
31;Navarra;159;Lumbier;1532;819;713
31;Navarra;160;Luquin;139;77;62
31;Navarra;248;Luzaide/Valcarlos;538;266;272
31;Navarra;161;Mañeru;361;183;178
31;Navarra;162;Marañón;89;45;44
31;Navarra;163;Marcilla;2339;1164;1175
31;Navarra;164;Mélida;898;454;444
31;Navarra;165;Mendavia;3588;1810;1778
31;Navarra;166;Mendaza;433;205;228
31;Navarra;167;Mendigorría;990;517;473
31;Navarra;168;Metauten;324;168;156
31;Navarra;169;Milagro;2597;1285;1312
31;Navarra;170;Mirafuentes;51;22;29
31;Navarra;171;Miranda de Arga;981;487;494
31;Navarra;172;Monreal;307;153;154
31;Navarra;173;Monteagudo;1177;584;593
31;Navarra;174;Morentin;137;68;69
31;Navarra;175;Mues;132;66;66
31;Navarra;176;Murchante;2878;1423;1455
31;Navarra;177;Murieta;283;157;126
31;Navarra;178;Murillo el Cuende;665;355;310
31;Navarra;179;Murillo el Fruto;830;421;409
31;Navarra;180;Muruzábal;200;104;96
31;Navarra;181;Navascués;289;176;113
31;Navarra;182;Nazar;52;29;23
31;Navarra;088;Noáin (Valle de Elorz)/Noain (Elortzibar);3732;1864;1868
31;Navarra;183;Obanos;719;349;370
31;Navarra;185;Ochagavía;682;360;322
31;Navarra;184;Oco;95;57;38
31;Navarra;186;Odieta;359;189;170
31;Navarra;187;Oitz;160;99;61
31;Navarra;188;Olaibar;166;91;75
31;Navarra;189;Olazti/Olazagutía;1728;897;831
31;Navarra;190;Olejua;66;35;31
31;Navarra;191;Olite;3059;1521;1538
31;Navarra;194;Ollo;364;206;158
31;Navarra;192;Olóriz;175;99;76
31;Navarra;193;Olza;2291;1182;1109
31;Navarra;195;Orbaitzeta;261;148;113
31;Navarra;196;Orbara;62;32;30
31;Navarra;906;Orcoyen;"";"";""
31;Navarra;197;Orísoain;103;55;48
31;Navarra;198;Oronz;56;31;25
31;Navarra;199;Oroz-Betelu;235;123;112
31;Navarra;211;Orreaga/Roncesvalles;35;20;15
31;Navarra;200;Oteiza;931;478;453
31;Navarra;201;Pamplona/Iruña;180319;86599;93720
31;Navarra;202;Peralta;4610;2262;2348
31;Navarra;203;Petilla de Aragón;51;26;25
31;Navarra;204;Piedramillera;88;48;40
31;Navarra;205;Pitillas;654;328;326
31;Navarra;206;Puente la Reina/Gares;2139;1057;1082
31;Navarra;207;Pueyo;326;167;159
31;Navarra;208;Ribaforada;3095;1580;1515
31;Navarra;209;Romanzado;161;91;70
31;Navarra;210;Roncal/Erronkari;363;181;182
31;Navarra;212;Sada;285;152;133
31;Navarra;213;Saldías;171;93;78
31;Navarra;214;Salinas de Oro;103;57;46
31;Navarra;215;San Adrián;5138;2509;2629
31;Navarra;217;San Martín de Unx;536;284;252
31;Navarra;216;Sangüesa/Zangoza;4578;2333;2245
31;Navarra;219;Sansol;151;77;74
31;Navarra;220;Santacara;1095;558;537
31;Navarra;222;Sarriés/Sartze;110;61;49
31;Navarra;223;Sartaguda;1430;718;712
31;Navarra;224;Sesma;1472;731;741
31;Navarra;225;Sorlada;64;33;31
31;Navarra;226;Sunbilla;703;365;338
31;Navarra;227;Tafalla;10174;5017;5157
31;Navarra;228;Tiebas-Muruarte de Reta;591;316;275
31;Navarra;229;Tirapu;71;38;33
31;Navarra;230;Torralba del Río;176;96;80
31;Navarra;231;Torres del Río;220;107;113
31;Navarra;232;Tudela;26528;12964;13564
31;Navarra;233;Tulebras;111;44;67
31;Navarra;234;Ucar;114;60;54
31;Navarra;123;Uharte-Arakil;855;450;405
31;Navarra;235;Ujué;294;158;136
31;Navarra;236;Ultzama;1664;851;813
31;Navarra;237;Unciti;251;121;130
31;Navarra;238;Unzué;143;74;69
31;Navarra;239;Urdazubi/Urdax;458;228;230
31;Navarra;240;Urdiain;691;362;329
31;Navarra;241;Urraul Alto;159;94;65
31;Navarra;242;Urraul Bajo;281;129;152
31;Navarra;244;Urrotz;207;119;88
31;Navarra;243;Urroz;371;188;183
31;Navarra;245;Urzainqui;119;63;56
31;Navarra;246;Uterga;137;66;71
31;Navarra;247;Uztárroz/Uztarroze;320;157;163
31;Navarra;249;Valtierra;2506;1243;1263
31;Navarra;251;Viana;3434;1738;1696
31;Navarra;252;Vidángoz/Bidankoze;109;55;54
31;Navarra;254;Villafranca;2573;1237;1336
31;Navarra;255;Villamayor de Monjardín;116;65;51
31;Navarra;257;Villatuerta;803;400;403
31;Navarra;258;Villava/Atarrabia;7753;3923;3830
31;Navarra;260;Yerri;1558;831;727
31;Navarra;261;Yesa;291;163;128
31;Navarra;262;Zabalza;139;63;76
31;Navarra;073;Ziordia;393;185;208
31;Navarra;907;Zizur Mayor/Zizur Nagusia;"";"";""
31;Navarra;263;Zubieta;326;193;133
31;Navarra;264;Zugarramurdi;261;140;121
31;Navarra;265;Zúñiga;126;68;58
32;Ourense;001;Allariz;5328;2545;2783
32;Ourense;002;Amoeiro;2329;1130;1199
32;Ourense;003;Arnoia (A);1097;517;580
32;Ourense;004;Avión;3523;1606;1917
32;Ourense;005;Baltar;1854;907;947
32;Ourense;006;Bande;2843;1351;1492
32;Ourense;007;Baños de Molgas;3159;1566;1593
32;Ourense;008;Barbadás;3924;1892;2032
32;Ourense;009;Barco de Valdeorras (O);10811;5350;5461
32;Ourense;010;Beade;894;446;448
32;Ourense;011;Beariz;1861;838;1023
32;Ourense;012;Blancos (Os);1290;640;650
32;Ourense;013;Boborás;3893;1780;2113
32;Ourense;014;Bola (A);1753;827;926
32;Ourense;015;Bolo (O);1892;954;938
32;Ourense;016;Calvos de Randín;2020;1026;994
32;Ourense;018;Carballeda de Avia;1887;899;988
32;Ourense;017;Carballeda de Valdeorras;2703;1383;1320
32;Ourense;019;Carballiño (O);11243;5287;5956
32;Ourense;020;Cartelle;4125;2004;2121
32;Ourense;022;Castrelo de Miño;3594;1763;1831
32;Ourense;021;Castrelo do Val;1444;716;728
32;Ourense;023;Castro Caldelas;2133;1082;1051
32;Ourense;024;Celanova;5983;2835;3148
32;Ourense;025;Cenlle;1919;893;1026
32;Ourense;029;Chandrexa de Queixa;1067;561;506
32;Ourense;026;Coles;3223;1569;1654
32;Ourense;027;Cortegada;1604;773;831
32;Ourense;028;Cualedro;2634;1338;1296
32;Ourense;030;Entrimo;1698;765;933
32;Ourense;031;Esgos;1464;698;766
32;Ourense;033;Gomesende;1406;651;755
32;Ourense;034;Gudiña (A);2024;1013;1011
32;Ourense;035;Irixo (O);2533;1165;1368
32;Ourense;038;Larouco;692;324;368
32;Ourense;039;Laza;2334;1151;1183
32;Ourense;040;Leiro;2215;1064;1151
32;Ourense;041;Lobeira;1471;709;762
32;Ourense;042;Lobios;3262;1558;1704
32;Ourense;043;Maceda;3445;1657;1788
32;Ourense;044;Manzaneda;1608;822;786
32;Ourense;045;Maside;3619;1676;1943
32;Ourense;046;Melón;1765;770;995
32;Ourense;047;Merca (A);2750;1307;1443
32;Ourense;048;Mezquita (A);1847;924;923
32;Ourense;049;Montederramo;1496;764;732
32;Ourense;050;Monterrei;3684;1837;1847
32;Ourense;051;Muíños;2303;1117;1186
32;Ourense;052;Nogueira de Ramuín;2811;1328;1483
32;Ourense;053;Oímbra;2110;1050;1060
32;Ourense;054;Ourense;103595;49012;54583
32;Ourense;055;Paderne de Allariz;1834;865;969
32;Ourense;056;Padrenda;2894;1368;1526
32;Ourense;057;Parada de Sil;1087;530;557
32;Ourense;058;Pereiro de Aguiar (O);4712;2261;2451
32;Ourense;059;Peroxa (A);2830;1352;1478
32;Ourense;060;Petín;1324;633;691
32;Ourense;061;Piñor;1839;920;919
32;Ourense;063;Pobra de Trives (A);3140;1543;1597
32;Ourense;064;Pontedeva;865;415;450
32;Ourense;062;Porqueira;1317;647;670
32;Ourense;065;Punxín;1053;486;567
32;Ourense;066;Quintela de Leirado;1046;470;576
32;Ourense;067;Rairiz de Veiga;2358;1177;1181
32;Ourense;068;Ramirás;2152;990;1162
32;Ourense;069;Ribadavia;6091;2907;3184
32;Ourense;071;Riós;2562;1296;1266
32;Ourense;072;Rúa (A);5090;2523;2567
32;Ourense;073;Rubiá;2192;1099;1093
32;Ourense;074;San Amaro;1645;803;842
32;Ourense;075;San Cibrao das Viñas;3359;1602;1757
32;Ourense;076;San Cristovo de Cea;3804;1864;1940
32;Ourense;070;San Xoán de Río;1330;643;687
32;Ourense;077;Sandiás;1940;912;1028
32;Ourense;078;Sarreaus;2674;1323;1351
32;Ourense;079;Taboadela;1877;920;957
32;Ourense;080;Teixeira (A);731;357;374
32;Ourense;081;Toén;2764;1368;1396
32;Ourense;082;Trasmiras;2291;1131;1160
32;Ourense;083;Veiga (A);1723;857;866
32;Ourense;084;Verea;1822;866;956
32;Ourense;085;Verín;11335;5495;5840
32;Ourense;086;Viana do Bolo;4633;2367;2266
32;Ourense;087;Vilamarín;2265;1097;1168
32;Ourense;088;Vilamartín de Valdeorras;2558;1273;1285
32;Ourense;089;Vilar de Barrio;2601;1302;1299
32;Ourense;090;Vilar de Santos;1487;752;735
32;Ourense;091;Vilardevós;3244;1647;1597
32;Ourense;092;Vilariño de Conso;927;510;417
32;Ourense;032;Xinzo de Limia;9198;4477;4721
32;Ourense;036;Xunqueira de Ambía;2332;1141;1191
32;Ourense;037;Xunqueira de Espadanedo;1215;577;638
33;Asturias;001;Allande;2803;1455;1348
33;Asturias;002;Aller;17483;8662;8821
33;Asturias;003;Amieva;1003;527;476
33;Asturias;004;Avilés;85803;41624;44179
33;Asturias;005;Belmonte de Miranda;2806;1432;1374
33;Asturias;006;Bimenes;2534;1197;1337
33;Asturias;007;Boal;2982;1485;1497
33;Asturias;008;Cabrales;2546;1281;1265
33;Asturias;009;Cabranes;1474;707;767
33;Asturias;010;Candamo;2902;1420;1482
33;Asturias;012;Cangas de Onís;"";3162;3252
33;Asturias;011;Cangas del Narcea;19102;9787;9315
33;Asturias;013;Caravia;596;301;295
33;Asturias;014;Carreño;11107;5384;5723
33;Asturias;015;Caso;2090;1070;1020
33;Asturias;016;Castrillón;21644;10540;11104
33;Asturias;017;Castropol;5049;2443;2606
33;Asturias;018;Coaña;4026;1935;2091
33;Asturias;019;Colunga;5072;2475;2597
33;Asturias;020;Corvera de Asturias;17221;8576;8645
33;Asturias;021;Cudillero;6610;3283;3327
33;Asturias;022;Degaña;1686;888;798
33;Asturias;023;Franco (El);4255;2072;2183
33;Asturias;024;Gijón;262658;125540;137118
33;Asturias;025;Gozón;11671;5656;6015
33;Asturias;026;Grado;12093;5876;6217
33;Asturias;027;Grandas de Salime;1477;762;715
33;Asturias;028;Ibias;2491;1344;1147
33;Asturias;029;Illano;774;396;378
33;Asturias;030;Illas;1290;676;614
33;Asturias;031;Langreo;51709;24752;26957
33;Asturias;032;Laviana;15303;7497;7806
33;Asturias;033;Lena;14156;6963;7193
33;Asturias;035;Llanera;10501;5129;5372
33;Asturias;036;Llanes;13785;6570;7215
33;Asturias;037;Mieres;53241;25810;27431
33;Asturias;038;Morcín;3084;1541;1543
33;Asturias;039;Muros de Nalón;2647;1244;1403
33;Asturias;040;Nava;5661;2767;2894
33;Asturias;041;Navia;9100;4384;4716
33;Asturias;042;Noreña;4186;1971;2215
33;Asturias;043;Onís;1070;535;535
33;Asturias;044;Oviedo;196946;92333;104613
33;Asturias;045;Parres;5781;2847;2934
33;Asturias;046;Peñamellera Alta;888;435;453
33;Asturias;047;Peñamellera Baja;1795;878;917
33;Asturias;048;Pesoz;334;169;165
33;Asturias;049;Piloña;9665;4689;4976
33;Asturias;050;Ponga;892;491;401
33;Asturias;051;Pravia;10023;4820;5203
33;Asturias;052;Proaza;1016;495;521
33;Asturias;053;Quirós;1789;911;878
33;Asturias;054;Regueras (Las);2397;1187;1210
33;Asturias;055;Ribadedeva;2042;983;1059
33;Asturias;056;Ribadesella;6351;3024;3327
33;Asturias;057;Ribera de Arriba;2199;1088;1111
33;Asturias;058;Riosa;2828;1464;1364
33;Asturias;059;Salas;7976;3963;4013
33;Asturias;061;San Martín de Oscos;618;328;290
33;Asturias;060;San Martín del Rey Aurelio;23659;11457;12202
33;Asturias;063;San Tirso de Abres;740;375;365
33;Asturias;062;Santa Eulalia de Oscos;665;345;320
33;Asturias;064;Santo Adriano;393;191;202
33;Asturias;065;Sariego;1479;742;737
33;Asturias;066;Siero;44485;21552;22933
33;Asturias;067;Sobrescobio;817;419;398
33;Asturias;068;Somiedo;1801;934;867
33;Asturias;069;Soto del Barco;4617;2210;2407
33;Asturias;070;Tapia de Casariego;4483;2147;2336
33;Asturias;071;Taramundi;1034;505;529
33;Asturias;072;Teverga;2591;1321;1270
33;Asturias;073;Tineo;14879;7537;7342
33;Asturias;034;Valdés;16963;8315;8648
33;Asturias;074;Vegadeo;5110;2444;2666
33;Asturias;075;Villanueva de Oscos;481;250;231
33;Asturias;076;Villaviciosa;15007;7359;7648
33;Asturias;077;Villayón;2253;1154;1099
33;Asturias;078;Yernes y Tameza;194;92;102
34;Palencia;001;Abarca de Campos;48;23;25
34;Palencia;003;Abia de las Torres;239;127;112
34;Palencia;004;Aguilar de Campoo;7569;3710;3859
34;Palencia;005;Alar del Rey;1563;734;829
34;Palencia;006;Alba de Cerrato;141;67;74
34;Palencia;009;Amayuelas de Arriba;63;37;26
34;Palencia;010;Ampudia;843;434;409
34;Palencia;011;Amusco;618;335;283
34;Palencia;012;Antigüedad;426;229;197
34;Palencia;015;Arconada;105;53;52
34;Palencia;017;Astudillo;1436;745;691
34;Palencia;018;Autilla del Pino;302;159;143
34;Palencia;019;Autillo de Campos;219;99;120
34;Palencia;020;Ayuela;105;59;46
34;Palencia;022;Baltanás;1654;846;808
34;Palencia;024;Baquerín de Campos;45;27;18
34;Palencia;025;Bárcena de Campos;70;31;39
34;Palencia;027;Barruelo de Santullán;2177;1018;1159
34;Palencia;028;Báscones de Ojeda;221;112;109
34;Palencia;029;Becerril de Campos;1238;602;636
34;Palencia;031;Belmonte de Campos;57;27;30
34;Palencia;032;Berzosilla;88;44;44
34;Palencia;033;Boada de Campos;31;15;16
34;Palencia;035;Boadilla de Rioseco;217;112;105
34;Palencia;034;Boadilla del Camino;220;114;106
34;Palencia;036;Brañosera;317;162;155
34;Palencia;037;Buenavista de Valdavia;478;239;239
34;Palencia;038;Bustillo de la Vega;414;220;194
34;Palencia;039;Bustillo del Páramo de Carrión;118;63;55
34;Palencia;041;Calahorra de Boedo;167;81;86
34;Palencia;042;Calzada de los Molinos;413;222;191
34;Palencia;045;Capillas;160;74;86
34;Palencia;046;Cardeñosa de Volpejera;60;29;31
34;Palencia;047;Carrión de los Condes;2541;1203;1338
34;Palencia;048;Castil de Vela;128;62;66
34;Palencia;049;Castrejón de la Peña;759;408;351
34;Palencia;050;Castrillo de Don Juan;403;220;183
34;Palencia;051;Castrillo de Onielo;215;107;108
34;Palencia;052;Castrillo de Villavega;332;164;168
34;Palencia;053;Castromocho;304;158;146
34;Palencia;055;Cervatos de la Cueza;422;215;207
34;Palencia;056;Cervera de Pisuerga;2931;1470;1461
34;Palencia;057;Cevico de la Torre;745;356;389
34;Palencia;058;Cevico Navero;317;165;152
34;Palencia;059;Cisneros;685;334;351
34;Palencia;060;Cobos de Cerrato;263;131;132
34;Palencia;061;Collazos de Boedo;184;100;84
34;Palencia;062;Congosto de Valdavia;298;162;136
34;Palencia;063;Cordovilla la Real;155;88;67
34;Palencia;066;Cubillas de Cerrato;127;63;64
34;Palencia;067;Dehesa de Montejo;346;195;151
34;Palencia;068;Dehesa de Romanos;68;36;32
34;Palencia;069;Dueñas;3087;1593;1494
34;Palencia;070;Espinosa de Cerrato;307;155;152
34;Palencia;071;Espinosa de Villagonzalo;331;161;170
34;Palencia;072;Frechilla;294;138;156
34;Palencia;073;Fresno del Río;219;114;105
34;Palencia;074;Frómista;1077;551;526
34;Palencia;076;Fuentes de Nava;923;451;472
34;Palencia;077;Fuentes de Valdepero;243;127;116
34;Palencia;079;Grijota;813;406;407
34;Palencia;080;Guardo;9420;4804;4616
34;Palencia;081;Guaza de Campos;111;57;54
34;Palencia;082;Hérmedes de Cerrato;163;75;88
34;Palencia;083;Herrera de Pisuerga;2860;1428;1432
34;Palencia;084;Herrera de Valdecañas;207;99;108
34;Palencia;086;Hontoria de Cerrato;135;70;65
34;Palencia;087;Hornillos de Cerrato;174;83;91
34;Palencia;088;Husillos;229;123;106
34;Palencia;089;Itero de la Vega;281;148;133
34;Palencia;091;Lagartos;197;108;89
34;Palencia;092;Lantadilla;634;310;324
34;Palencia;094;Ledigos;129;64;65
34;Palencia;903;Loma de Ucieza;377;192;185
34;Palencia;096;Lomas;71;35;36
34;Palencia;098;Magaz de Pisuerga;748;385;363
34;Palencia;099;Manquillos;96;53;43
34;Palencia;100;Mantinos;219;118;101
34;Palencia;101;Marcilla de Campos;90;39;51
34;Palencia;102;Mazariegos;280;150;130
34;Palencia;103;Mazuecos de Valdeginate;158;76;82
34;Palencia;104;Melgar de Yuso;482;261;221
34;Palencia;106;Meneses de Campos;186;100;86
34;Palencia;107;Micieces de Ojeda;133;67;66
34;Palencia;108;Monzón de Campos;914;471;443
34;Palencia;109;Moratinos;101;51;50
34;Palencia;110;Mudá;171;86;85
34;Palencia;112;Nogal de las Huertas;104;60;44
34;Palencia;113;Olea de Boedo;52;24;28
34;Palencia;114;Olmos de Ojeda;463;248;215
34;Palencia;116;Osornillo;120;61;59
34;Palencia;901;Osorno la Mayor;1875;972;903
34;Palencia;120;Palencia;78085;37640;40445
34;Palencia;121;Palenzuela;394;218;176
34;Palencia;122;Páramo de Boedo;136;66;70
34;Palencia;123;Paredes de Nava;2629;1300;1329
34;Palencia;124;Payo de Ojeda;106;55;51
34;Palencia;125;Pedraza de Campos;162;87;75
34;Palencia;126;Pedrosa de la Vega;436;237;199
34;Palencia;127;Perales;161;81;80
34;Palencia;904;Pernía (La);532;283;249
34;Palencia;129;Pino del Río;289;162;127
34;Palencia;130;Piña de Campos;350;185;165
34;Palencia;131;Población de Arroyo;109;61;48
34;Palencia;132;Población de Campos;252;137;115
34;Palencia;133;Población de Cerrato;144;76;68
34;Palencia;134;Polentinos;130;67;63
34;Palencia;135;Pomar de Valdivia;640;319;321
34;Palencia;136;Poza de la Vega;313;175;138
34;Palencia;137;Pozo de Urama;44;23;21
34;Palencia;139;Prádanos de Ojeda;266;132;134
34;Palencia;140;Puebla de Valdavia (La);204;102;102
34;Palencia;141;Quintana del Puente;338;167;171
34;Palencia;143;Quintanilla de Onsoña;307;168;139
34;Palencia;146;Reinoso de Cerrato;94;52;42
34;Palencia;147;Renedo de la Vega;309;171;138
34;Palencia;149;Requena de Campos;59;30;29
34;Palencia;151;Respenda de la Peña;341;179;162
34;Palencia;152;Revenga de Campos;216;103;113
34;Palencia;154;Revilla de Collazos;118;68;50
34;Palencia;155;Ribas de Campos;242;127;115
34;Palencia;156;Riberos de la Cueza;92;49;43
34;Palencia;157;Saldaña;3171;1649;1522
34;Palencia;158;Salinas de Pisuerga;290;158;132
34;Palencia;159;San Cebrián de Campos;536;302;234
34;Palencia;160;San Cebrián de Mudá;264;132;132
34;Palencia;161;San Cristóbal de Boedo;55;31;24
34;Palencia;163;San Mamés de Campos;140;63;77
34;Palencia;165;San Román de la Cuba;130;66;64
34;Palencia;167;Santa Cecilia del Alcor;181;95;86
34;Palencia;168;Santa Cruz de Boedo;91;45;46
34;Palencia;169;Santervás de la Vega;615;337;278
34;Palencia;170;Santibáñez de Ecla;117;48;69
34;Palencia;171;Santibáñez de la Peña;1880;940;940
34;Palencia;174;Santoyo;328;158;170
34;Palencia;175;Serna (La);147;79;68
34;Palencia;177;Soto de Cerrato;245;124;121
34;Palencia;176;Sotobañado y Priorato;217;114;103
34;Palencia;178;Tabanera de Cerrato;207;105;102
34;Palencia;179;Tabanera de Valdavia;62;27;35
34;Palencia;180;Támara de Campos;103;51;52
34;Palencia;181;Tariego de Cerrato;562;287;275
34;Palencia;182;Torquemada;1367;684;683
34;Palencia;184;Torremormojón;89;43;46
34;Palencia;185;Triollo;127;71;56
34;Palencia;186;Valbuena de Pisuerga;89;50;39
34;Palencia;189;Valdeolmillos;104;48;56
34;Palencia;190;Valderrábano;124;67;57
34;Palencia;192;Valde-Ucieza;161;90;71
34;Palencia;196;Valle de Cerrato;166;88;78
34;Palencia;902;Valle del Retortillo;283;137;146
34;Palencia;199;Velilla del Río Carrión;2092;1061;1031
34;Palencia;023;Venta de Baños;7056;3496;3560
34;Palencia;201;Vertavillo;294;164;130
34;Palencia;093;Vid de Ojeda (La);165;96;69
34;Palencia;202;Villabasta de Valdavia;50;22;28
34;Palencia;204;Villacidaler;94;48;46
34;Palencia;205;Villaconancio;99;53;46
34;Palencia;206;Villada;1453;711;742
34;Palencia;208;Villaeles de Valdavia;107;60;47
34;Palencia;210;Villahán;171;97;74
34;Palencia;211;Villaherreros;339;159;180
34;Palencia;213;Villalaco;97;43;54
34;Palencia;214;Villalba de Guardo;230;124;106
34;Palencia;215;Villalcázar de Sirga;247;114;133
34;Palencia;216;Villalcón;108;54;54
34;Palencia;217;Villalobón;261;136;125
34;Palencia;218;Villaluenga de la Vega;750;422;328
34;Palencia;220;Villamartín de Campos;173;90;83
34;Palencia;221;Villamediana;284;148;136
34;Palencia;222;Villameriel;188;97;91
34;Palencia;223;Villamoronta;360;190;170
34;Palencia;224;Villamuera de la Cueza;102;57;45
34;Palencia;225;Villamuriel de Cerrato;4021;2053;1968
34;Palencia;227;Villanueva del Rebollar;122;60;62
34;Palencia;228;Villanuño de Valdavia;143;79;64
34;Palencia;229;Villaprovedo;121;71;50
34;Palencia;230;Villarmentero de Campos;23;11;12
34;Palencia;231;Villarrabé;309;159;150
34;Palencia;232;Villarramiel;1194;600;594
34;Palencia;233;Villasarracino;373;186;187
34;Palencia;234;Villasila de Valdavia;126;65;61
34;Palencia;236;Villaturde;313;159;154
34;Palencia;237;Villaumbrales;956;502;454
34;Palencia;238;Villaviudas;503;247;256
34;Palencia;240;Villerías de Campos;144;80;64
34;Palencia;241;Villodre;52;28;24
34;Palencia;242;Villodrigo;155;77;78
34;Palencia;243;Villoldo;566;293;273
34;Palencia;245;Villota del Páramo;538;308;230
34;Palencia;246;Villovieco;147;82;65
35;Palmas (Las);001;Agaete;5301;2656;2645
35;Palmas (Las);002;Agüimes;16433;8301;8132
35;Palmas (Las);003;Antigua;2350;1226;1124
35;Palmas (Las);004;Arrecife;36159;18291;17868
35;Palmas (Las);005;Artenara;1120;562;558
35;Palmas (Las);006;Arucas;27392;13744;13648
35;Palmas (Las);007;Betancuria;571;296;275
35;Palmas (Las);008;Firgas;5820;2931;2889
35;Palmas (Las);009;Gáldar;20987;10551;10436
35;Palmas (Las);010;Haría;2899;1489;1410
35;Palmas (Las);011;Ingenio;22100;11260;10840
35;Palmas (Las);016;Las Palmas de Gran Canaria;355153;174652;180501
35;Palmas (Las);012;Mogán;9175;4797;4378
35;Palmas (Las);013;Moya;8058;4065;3993
35;Palmas (Las);014;Oliva (La);5379;2785;2594
35;Palmas (Las);015;Pájara;5345;2804;2541
35;Palmas (Las);017;Puerto del Rosario;17014;9092;7922
35;Palmas (Las);018;San Bartolomé;6818;3498;3320
35;Palmas (Las);019;San Bartolomé de Tirajana;26775;13814;12961
35;Palmas (Las);020;San Nicolás de Tolentino;7751;3886;3865
35;Palmas (Las);021;Santa Brígida;12552;6236;6316
35;Palmas (Las);022;Santa Lucía de Tirajana;34296;17476;16820
35;Palmas (Las);023;Santa María de Guía de Gran Canaria;12499;6305;6194
35;Palmas (Las);024;Teguise;8231;4274;3957
35;Palmas (Las);025;Tejeda;2359;1163;1196
35;Palmas (Las);026;Telde;80062;40107;39955
35;Palmas (Las);027;Teror;10454;5224;5230
35;Palmas (Las);028;Tías;8117;4211;3906
35;Palmas (Las);029;Tinajo;3499;1779;1720
35;Palmas (Las);030;Tuineje;7086;3715;3371
35;Palmas (Las);032;Valleseco;4412;2254;2158
35;Palmas (Las);031;Valsequillo de Gran Canaria;6770;3438;3332
35;Palmas (Las);033;Vega de San Mateo;6153;3139;3014
35;Palmas (Las);034;Yaiza;2858;1505;1353
36;Pontevedra;020;Agolada;5056;2485;2571
36;Pontevedra;001;Arbo;5017;2439;2578
36;Pontevedra;003;Baiona;10186;4983;5203
36;Pontevedra;002;Barro;3649;1738;1911
36;Pontevedra;004;Bueu;12685;6252;6433
36;Pontevedra;005;Caldas de Reis;9204;4444;4760
36;Pontevedra;006;Cambados;12842;6304;6538
36;Pontevedra;007;Campo Lameiro;2663;1276;1387
36;Pontevedra;008;Cangas;23162;11458;11704
36;Pontevedra;009;Cañiza (A);8017;3822;4195
36;Pontevedra;010;Catoira;3677;1825;1852
36;Pontevedra;011;Cerdedo;3777;1708;2069
36;Pontevedra;012;Cotobade;5494;2496;2998
36;Pontevedra;013;Covelo;4476;2035;2441
36;Pontevedra;014;Crecente;4042;1912;2130
36;Pontevedra;015;Cuntis;6026;2776;3250
36;Pontevedra;016;Dozón;2783;1383;1400
36;Pontevedra;017;Estrada (A);22382;10405;11977
36;Pontevedra;018;Forcarei;5837;2761;3076
36;Pontevedra;019;Fornelos de Montes;2476;1144;1332
36;Pontevedra;021;Gondomar;10635;5193;5442
36;Pontevedra;022;Grove (O);10766;5356;5410
36;Pontevedra;023;Guarda (A);10177;4903;5274
36;Pontevedra;901;Illa de Arousa (A);"";"";""
36;Pontevedra;024;Lalín;20644;10054;10590
36;Pontevedra;025;Lama (A);3291;1458;1833
36;Pontevedra;026;Marín;24167;11770;12397
36;Pontevedra;027;Meaño;5338;2575;2763
36;Pontevedra;028;Meis;5065;2391;2674
36;Pontevedra;029;Moaña;17555;8498;9057
36;Pontevedra;030;Mondariz;6687;3180;3507
36;Pontevedra;031;Mondariz-Balneario;638;300;338
36;Pontevedra;032;Moraña;4853;2332;2521
36;Pontevedra;033;Mos;13483;6529;6954
36;Pontevedra;034;Neves (As);5377;2521;2856
36;Pontevedra;035;Nigrán;14327;7041;7286
36;Pontevedra;036;Oia;3159;1565;1594
36;Pontevedra;037;Pazos de Borbén;3483;1619;1864
36;Pontevedra;041;Poio;13047;6345;6702
36;Pontevedra;043;Ponte Caldelas;7882;3729;4153
36;Pontevedra;042;Ponteareas;15761;7466;8295
36;Pontevedra;044;Pontecesures;2801;1371;1430
36;Pontevedra;038;Pontevedra;71691;33952;37739
36;Pontevedra;039;Porriño (O);15253;7389;7864
36;Pontevedra;040;Portas;3327;1543;1784
36;Pontevedra;045;Redondela;28176;13714;14462
36;Pontevedra;046;Ribadumia;4080;1976;2104
36;Pontevedra;047;Rodeiro;4942;2553;2389
36;Pontevedra;048;Rosal (O);5780;2823;2957
36;Pontevedra;049;Salceda de Caselas;5724;2818;2906
36;Pontevedra;050;Salvaterra de Miño;8937;4259;4678
36;Pontevedra;051;Sanxenxo;15111;7466;7645
36;Pontevedra;052;Silleda;10029;4811;5218
36;Pontevedra;053;Soutomaior;4984;2392;2592
36;Pontevedra;054;Tomiño;10184;4962;5222
36;Pontevedra;055;Tui;15259;7239;8020
36;Pontevedra;056;Valga;6310;3091;3219
36;Pontevedra;057;Vigo;278370;132864;145506
36;Pontevedra;059;Vila de Cruces;7504;3649;3855
36;Pontevedra;058;Vilaboa;5780;2809;2971
36;Pontevedra;060;Vilagarcía de Arousa;32333;15633;16700
36;Pontevedra;061;Vilanova de Arousa;15199;7451;7748
37;Salamanca;001;Abusejo;339;174;165
37;Salamanca;002;Agallas;248;126;122
37;Salamanca;003;Ahigal de los Aceiteros;244;122;122
37;Salamanca;004;Ahigal de Villarino;61;31;30
37;Salamanca;005;Alameda de Gardón (La);172;79;93
37;Salamanca;006;Alamedilla (La);249;120;129
37;Salamanca;007;Alaraz;745;394;351
37;Salamanca;008;Alba de Tormes;4391;2176;2215
37;Salamanca;009;Alba de Yeltes;329;165;164
37;Salamanca;010;Alberca (La);1071;547;524
37;Salamanca;011;Alberguería de Argañán (La);211;105;106
37;Salamanca;012;Alconada;258;132;126
37;Salamanca;015;Aldea del Obispo;439;219;220
37;Salamanca;013;Aldeacipreste;334;183;151
37;Salamanca;014;Aldeadávila de la Ribera;1721;880;841
37;Salamanca;016;Aldealengua;485;238;247
37;Salamanca;017;Aldeanueva de Figueroa;398;203;195
37;Salamanca;018;Aldeanueva de la Sierra;109;58;51
37;Salamanca;019;Aldearrodrigo;228;119;109
37;Salamanca;020;Aldearrubia;502;261;241
37;Salamanca;021;Aldeaseca de Alba;151;74;77
37;Salamanca;022;Aldeaseca de la Frontera;426;218;208
37;Salamanca;023;Aldeatejada;536;262;274
37;Salamanca;024;Aldeavieja de Tormes;150;73;77
37;Salamanca;025;Aldehuela de la Bóveda;431;216;215
37;Salamanca;026;Aldehuela de Yeltes;393;198;195
37;Salamanca;027;Almenara de Tormes;253;125;128
37;Salamanca;028;Almendra;237;117;120
37;Salamanca;029;Anaya de Alba;360;190;170
37;Salamanca;030;Añover de Tormes;129;66;63
37;Salamanca;031;Arabayona de Mógica;614;325;289
37;Salamanca;032;Arapiles;542;266;276
37;Salamanca;033;Arcediano;114;58;56
37;Salamanca;034;Arco (El);100;52;48
37;Salamanca;035;Armenteros;378;181;197
37;Salamanca;037;Atalaya (La);180;99;81
37;Salamanca;038;Babilafuente;1008;530;478
37;Salamanca;039;Bañobárez;547;284;263
37;Salamanca;040;Barbadillo;573;276;297
37;Salamanca;041;Barbalos;142;70;72
37;Salamanca;042;Barceo;88;47;41
37;Salamanca;044;Barruecopardo;677;344;333
37;Salamanca;045;Bastida (La);51;24;27
37;Salamanca;046;Béjar;17087;8180;8907
37;Salamanca;047;Beleña;130;58;72
37;Salamanca;049;Bermellar;270;132;138
37;Salamanca;050;Berrocal de Huebra;146;72;74
37;Salamanca;051;Berrocal de Salvatierra;170;86;84
37;Salamanca;052;Boada;524;257;267
37;Salamanca;054;Bodón (El);424;218;206
37;Salamanca;055;Bogajo;253;131;122
37;Salamanca;056;Bouza (La);78;41;37
37;Salamanca;057;Bóveda del Río Almar;356;185;171
37;Salamanca;058;Brincones;142;65;77
37;Salamanca;059;Buenamadre;211;107;104
37;Salamanca;060;Buenavista;112;60;52
37;Salamanca;061;Cabaco (El);298;151;147
37;Salamanca;063;Cabeza de Béjar (La);148;75;73
37;Salamanca;065;Cabeza del Caballo;573;295;278
37;Salamanca;062;Cabezabellosa de la Calzada;141;78;63
37;Salamanca;067;Cabrerizos;958;468;490
37;Salamanca;068;Cabrillas;633;299;334
37;Salamanca;069;Calvarrasa de Abajo;1096;548;548
37;Salamanca;070;Calvarrasa de Arriba;622;323;299
37;Salamanca;071;Calzada de Béjar (La);118;62;56
37;Salamanca;072;Calzada de Don Diego;313;156;157
37;Salamanca;073;Calzada de Valdunciel;678;331;347
37;Salamanca;074;Campillo de Azaba;327;155;172
37;Salamanca;077;Campo de Peñaranda (El);457;235;222
37;Salamanca;078;Candelario;1201;593;608
37;Salamanca;079;Canillas de Abajo;148;81;67
37;Salamanca;080;Cantagallo;289;139;150
37;Salamanca;081;Cantalapiedra;1622;814;808
37;Salamanca;082;Cantalpino;1313;697;616
37;Salamanca;083;Cantaracillo;319;157;162
37;Salamanca;085;Carbajosa de la Sagrada;701;346;355
37;Salamanca;086;Carpio de Azaba;126;63;63
37;Salamanca;087;Carrascal de Barregas;274;137;137
37;Salamanca;088;Carrascal del Obispo;263;131;132
37;Salamanca;089;Casafranca;87;40;47
37;Salamanca;090;Casas del Conde (Las);115;55;60
37;Salamanca;091;Casillas de Flores;316;146;170
37;Salamanca;092;Castellanos de Moriscos;381;178;203
37;Salamanca;185;Castellanos de Villiquera;462;231;231
37;Salamanca;096;Castillejo de Martín Viejo;350;177;173
37;Salamanca;097;Castraz;79;44;35
37;Salamanca;098;Cepeda;593;281;312
37;Salamanca;099;Cereceda de la Sierra;127;66;61
37;Salamanca;100;Cerezal de Peñahorcada;159;82;77
37;Salamanca;101;Cerralbo;298;158;140
37;Salamanca;102;Cerro (El);630;310;320
37;Salamanca;103;Cespedosa de Tormes;752;399;353
37;Salamanca;114;Chagarcía Medianero;176;90;86
37;Salamanca;104;Cilleros de la Bastida;66;29;37
37;Salamanca;106;Cipérez;551;274;277
37;Salamanca;107;Ciudad Rodrigo;15125;7314;7811
37;Salamanca;108;Coca de Alba;201;97;104
37;Salamanca;109;Colmenar de Montemayor;309;165;144
37;Salamanca;110;Cordovilla;149;79;70
37;Salamanca;112;Cristóbal;250;137;113
37;Salamanca;113;Cubo de Don Sancho (El);663;352;311
37;Salamanca;115;Dios le Guarde;186;102;84
37;Salamanca;116;Doñinos de Ledesma;120;59;61
37;Salamanca;117;Doñinos de Salamanca;643;329;314
37;Salamanca;118;Ejeme;288;152;136
37;Salamanca;120;Encina de San Silvestre;122;60;62
37;Salamanca;119;Encina (La);270;145;125
37;Salamanca;121;Encinas de Abajo;761;392;369
37;Salamanca;122;Encinas de Arriba;293;147;146
37;Salamanca;123;Encinasola de los Comendadores;360;188;172
37;Salamanca;124;Endrinal;310;162;148
37;Salamanca;125;Escurial de la Sierra;354;169;185
37;Salamanca;126;Espadaña;68;37;31
37;Salamanca;127;Espeja;336;169;167
37;Salamanca;128;Espino de la Orbada;384;192;192
37;Salamanca;129;Florida de Liébana;232;130;102
37;Salamanca;130;Forfoleda;245;122;123
37;Salamanca;131;Frades de la Sierra;318;170;148
37;Salamanca;132;Fregeneda (La);673;321;352
37;Salamanca;133;Fresnedoso;159;72;87
37;Salamanca;134;Fresno Alhándiga;377;207;170
37;Salamanca;135;Fuente de San Esteban (La);1799;908;891
37;Salamanca;136;Fuenteguinaldo;1085;544;541
37;Salamanca;137;Fuenteliante;164;77;87
37;Salamanca;138;Fuenterroble de Salvatierra;286;149;137
37;Salamanca;139;Fuentes de Béjar;325;136;189
37;Salamanca;140;Fuentes de Oñoro;1487;728;759
37;Salamanca;141;Gajates;285;148;137
37;Salamanca;142;Galindo y Perahuy;164;81;83
37;Salamanca;143;Galinduste;628;317;311
37;Salamanca;144;Galisancho;776;413;363
37;Salamanca;145;Gallegos de Argañán;519;257;262
37;Salamanca;146;Gallegos de Solmirón;256;120;136
37;Salamanca;147;Garcibuey;339;189;150
37;Salamanca;148;Garcihernández;663;361;302
37;Salamanca;149;Garcirrey;115;58;57
37;Salamanca;150;Gejuelo del Barro;55;31;24
37;Salamanca;151;Golpejas;235;126;109
37;Salamanca;152;Gomecello;633;313;320
37;Salamanca;154;Guadramiro;264;154;110
37;Salamanca;155;Guijo de Ávila;125;69;56
37;Salamanca;156;Guijuelo;4850;2419;2431
37;Salamanca;157;Herguijuela de Ciudad Rodrigo;189;96;93
37;Salamanca;158;Herguijuela de la Sierra;403;191;212
37;Salamanca;159;Herguijuela del Campo;166;80;86
37;Salamanca;160;Hinojosa de Duero;969;467;502
37;Salamanca;161;Horcajo de Montemayor;208;106;102
37;Salamanca;162;Horcajo Medianero;461;238;223
37;Salamanca;163;Hoya (La);24;15;9
37;Salamanca;164;Huerta;282;151;131
37;Salamanca;165;Iruelos;83;38;45
37;Salamanca;166;Ituero de Azaba;345;174;171
37;Salamanca;167;Juzbado;207;107;100
37;Salamanca;168;Lagunilla;766;400;366
37;Salamanca;169;Larrodrigo;361;191;170
37;Salamanca;170;Ledesma;2008;989;1019
37;Salamanca;171;Ledrada;644;311;333
37;Salamanca;172;Linares de Riofrío;1222;628;594
37;Salamanca;173;Lumbrales;2442;1215;1227
37;Salamanca;175;Machacón;575;290;285
37;Salamanca;174;Macotera;1893;950;943
37;Salamanca;176;Madroñal;177;89;88
37;Salamanca;177;Maíllo (El);471;239;232
37;Salamanca;178;Malpartida;195;105;90
37;Salamanca;179;Mancera de Abajo;418;211;207
37;Salamanca;180;Manzano (El);117;64;53
37;Salamanca;181;Martiago;509;250;259
37;Salamanca;183;Martín de Yeltes;615;314;301
37;Salamanca;182;Martinamor;98;52;46
37;Salamanca;184;Masueco;517;256;261
37;Salamanca;186;Mata de Ledesma (La);172;82;90
37;Salamanca;187;Matilla de los Caños del Río;743;381;362
37;Salamanca;188;Maya (La);285;152;133
37;Salamanca;189;Membribe de la Sierra;118;59;59
37;Salamanca;190;Mieza;420;215;205
37;Salamanca;191;Milano (El);191;102;89
37;Salamanca;192;Miranda de Azán;131;69;62
37;Salamanca;193;Miranda del Castañar;634;339;295
37;Salamanca;194;Mogarraz;417;199;218
37;Salamanca;195;Molinillo;96;50;46
37;Salamanca;196;Monforte de la Sierra;140;74;66
37;Salamanca;197;Monleón;144;87;57
37;Salamanca;198;Monleras;310;160;150
37;Salamanca;199;Monsagro;284;160;124
37;Salamanca;200;Montejo;251;131;120
37;Salamanca;201;Montemayor del Río;385;193;192
37;Salamanca;202;Monterrubio de Armuña;160;79;81
37;Salamanca;203;Monterrubio de la Sierra;178;92;86
37;Salamanca;204;Morasverdes;527;271;256
37;Salamanca;205;Morille;226;117;109
37;Salamanca;206;Moríñigo;154;86;68
37;Salamanca;207;Moriscos;138;77;61
37;Salamanca;208;Moronta;161;80;81
37;Salamanca;209;Mozárbez;350;172;178
37;Salamanca;211;Narros de Matalayegua;371;196;175
37;Salamanca;213;Nava de Béjar;129;62;67
37;Salamanca;214;Nava de Francia;155;82;73
37;Salamanca;215;Nava de Sotrobal;238;126;112
37;Salamanca;212;Navacarros;100;51;49
37;Salamanca;216;Navales;419;239;180
37;Salamanca;217;Navalmoral de Béjar;88;42;46
37;Salamanca;218;Navamorales;210;113;97
37;Salamanca;219;Navarredonda de la Rinconada;311;154;157
37;Salamanca;221;Navasfrías;804;396;408
37;Salamanca;222;Negrilla de Palencia;120;61;59
37;Salamanca;223;Olmedo de Camaces;212;103;109
37;Salamanca;224;Orbada (La);328;161;167
37;Salamanca;225;Pajares de la Laguna;166;80;86
37;Salamanca;226;Palacios del Arzobispo;276;142;134
37;Salamanca;228;Palaciosrubios;632;324;308
37;Salamanca;229;Palencia de Negrilla;219;108;111
37;Salamanca;230;Parada de Arriba;244;121;123
37;Salamanca;231;Parada de Rubiales;396;197;199
37;Salamanca;232;Paradinas de San Juan;677;359;318
37;Salamanca;233;Pastores;82;44;38
37;Salamanca;234;Payo (El);605;288;317
37;Salamanca;235;Pedraza de Alba;308;166;142
37;Salamanca;236;Pedrosillo de Alba;325;164;161
37;Salamanca;237;Pedrosillo de los Aires;517;278;239
37;Salamanca;238;Pedrosillo el Ralo;161;84;77
37;Salamanca;239;Pedroso de la Armuña (El);364;179;185
37;Salamanca;240;Pelabravo;652;340;312
37;Salamanca;241;Pelarrodríguez;222;119;103
37;Salamanca;242;Pelayos;103;56;47
37;Salamanca;243;Peña (La);180;89;91
37;Salamanca;244;Peñacaballera;262;127;135
37;Salamanca;245;Peñaparda;555;264;291
37;Salamanca;246;Peñaranda de Bracamonte;6400;3121;3279
37;Salamanca;247;Peñarandilla;312;156;156
37;Salamanca;248;Peralejos de Abajo;253;119;134
37;Salamanca;249;Peralejos de Arriba;83;46;37
37;Salamanca;250;Pereña de la Ribera;555;290;265
37;Salamanca;251;Peromingo;169;77;92
37;Salamanca;252;Pinedas;244;120;124
37;Salamanca;253;Pino de Tormes (El);169;89;80
37;Salamanca;254;Pitiegua;293;145;148
37;Salamanca;255;Pizarral;98;45;53
37;Salamanca;256;Poveda de las Cintas;412;223;189
37;Salamanca;257;Pozos de Hinojo;111;59;52
37;Salamanca;258;Puebla de Azaba;330;166;164
37;Salamanca;259;Puebla de San Medel;76;40;36
37;Salamanca;260;Puebla de Yeltes;273;145;128
37;Salamanca;261;Puente del Congosto;408;201;207
37;Salamanca;262;Puertas;130;71;59
37;Salamanca;263;Puerto de Béjar;524;245;279
37;Salamanca;264;Puerto Seguro;136;70;66
37;Salamanca;265;Rágama;362;192;170
37;Salamanca;266;Redonda (La);127;59;68
37;Salamanca;267;Retortillo;297;142;155
37;Salamanca;268;Rinconada de la Sierra (La);191;90;101
37;Salamanca;269;Robleda;643;336;307
37;Salamanca;270;Robliza de Cojos;237;112;125
37;Salamanca;271;Rollán;636;322;314
37;Salamanca;272;Saelices el Chico;217;117;100
37;Salamanca;273;Sagrada (La);229;109;120
37;Salamanca;303;Sahugo (El);351;179;172
37;Salamanca;274;Salamanca;163963;77703;86260
37;Salamanca;275;Saldeana;228;118;110
37;Salamanca;276;Salmoral;410;211;199
37;Salamanca;277;Salvatierra de Tormes;75;40;35
37;Salamanca;278;San Cristóbal de la Cuesta;251;129;122
37;Salamanca;284;San Esteban de la Sierra;491;260;231
37;Salamanca;285;San Felices de los Gallegos;719;362;357
37;Salamanca;286;San Martín del Castañar;329;173;156
37;Salamanca;287;San Miguel de Valero;457;230;227
37;Salamanca;036;San Miguel del Robledo;106;54;52
37;Salamanca;288;San Morales;188;100;88
37;Salamanca;289;San Muñoz;422;213;209
37;Salamanca;291;San Pedro de Rozados;434;223;211
37;Salamanca;290;San Pedro del Valle;142;72;70
37;Salamanca;292;San Pelayo de Guareña;127;65;62
37;Salamanca;280;Sanchón de la Ribera;167;84;83
37;Salamanca;281;Sanchón de la Sagrada;67;35;32
37;Salamanca;282;Sanchotello;380;198;182
37;Salamanca;279;Sancti-Spíritus;1343;674;669
37;Salamanca;283;Sando;234;135;99
37;Salamanca;293;Santa María de Sando;220;121;99
37;Salamanca;294;Santa Marta de Tormes;7097;3528;3569
37;Salamanca;296;Santiago de la Puebla;681;350;331
37;Salamanca;297;Santibáñez de Béjar;763;377;386
37;Salamanca;298;Santibáñez de la Sierra;268;145;123
37;Salamanca;299;Santiz;330;176;154
37;Salamanca;300;Santos (Los);807;433;374
37;Salamanca;301;Sardón de los Frailes;122;67;55
37;Salamanca;302;Saucelle;560;279;281
37;Salamanca;304;Sepulcro-Hilario;337;171;166
37;Salamanca;305;Sequeros;278;125;153
37;Salamanca;306;Serradilla del Arroyo;522;265;257
37;Salamanca;307;Serradilla del Llano;371;183;188
37;Salamanca;309;Sierpe (La);61;32;29
37;Salamanca;310;Sieteiglesias de Tormes;177;93;84
37;Salamanca;311;Sobradillo;452;216;236
37;Salamanca;312;Sorihuela;476;234;242
37;Salamanca;313;Sotoserrano;806;414;392
37;Salamanca;314;Tabera de Abajo;116;59;57
37;Salamanca;315;Tala (La);175;91;84
37;Salamanca;316;Tamames;1146;573;573
37;Salamanca;317;Tarazona de Guareña;473;257;216
37;Salamanca;318;Tardáguila;283;150;133
37;Salamanca;319;Tejado (El);219;108;111
37;Salamanca;320;Tejeda y Segoyuela;157;79;78
37;Salamanca;321;Tenebrón;256;123;133
37;Salamanca;322;Terradillos;1870;931;939
37;Salamanca;323;Topas;770;396;374
37;Salamanca;324;Tordillos;684;343;341
37;Salamanca;325;Tornadizo (El);156;82;74
37;Salamanca;327;Torresmenudas;275;136;139
37;Salamanca;328;Trabanca;269;141;128
37;Salamanca;329;Tremedal de Tormes;67;34;33
37;Salamanca;330;Valdecarros;496;252;244
37;Salamanca;331;Valdefuentes de Sangusín;374;186;188
37;Salamanca;332;Valdehijaderos;133;75;58
37;Salamanca;333;Valdelacasa;376;196;180
37;Salamanca;334;Valdelageve;147;79;68
37;Salamanca;335;Valdelosa;482;226;256
37;Salamanca;336;Valdemierque;77;40;37
37;Salamanca;337;Valderrodrigo;218;109;109
37;Salamanca;338;Valdunciel;139;66;73
37;Salamanca;339;Valero;501;253;248
37;Salamanca;343;Vallejera de Riofrío;54;21;33
37;Salamanca;340;Valsalabroso;277;141;136
37;Salamanca;341;Valverde de Valdelacasa;85;42;43
37;Salamanca;342;Valverdón;262;140;122
37;Salamanca;344;Vecinos;339;169;170
37;Salamanca;345;Vega de Tirados;244;130;114
37;Salamanca;346;Veguillas (Las);331;158;173
37;Salamanca;347;Vellés (La);440;218;222
37;Salamanca;348;Ventosa del Río Almar;175;85;90
37;Salamanca;349;Vídola (La);235;119;116
37;Salamanca;351;Villaflores;547;275;272
37;Salamanca;352;Villagonzalo de Tormes;274;146;128
37;Salamanca;353;Villalba de los Llanos;223;124;99
37;Salamanca;354;Villamayor;1247;646;601
37;Salamanca;355;Villanueva del Conde;310;160;150
37;Salamanca;356;Villar de Argañán;130;65;65
37;Salamanca;357;Villar de Ciervo;485;256;229
37;Salamanca;358;Villar de Gallimazo;266;138;128
37;Salamanca;359;Villar de la Yegua;367;181;186
37;Salamanca;360;Villar de Peralonso;400;195;205
37;Salamanca;361;Villar de Samaniego;167;90;77
37;Salamanca;362;Villares de la Reina;1205;593;612
37;Salamanca;363;Villares de Yeltes;191;95;96
37;Salamanca;364;Villarino de los Aires;1298;637;661
37;Salamanca;365;Villarmayor;242;121;121
37;Salamanca;366;Villarmuerto;76;43;33
37;Salamanca;367;Villasbuenas;380;186;194
37;Salamanca;368;Villasdardo;30;15;15
37;Salamanca;369;Villaseco de los Gamitos;238;116;122
37;Salamanca;370;Villaseco de los Reyes;467;239;228
37;Salamanca;371;Villasrubias;455;247;208
37;Salamanca;372;Villaverde de Guareña;227;117;110
37;Salamanca;373;Villavieja de Yeltes;1210;607;603
37;Salamanca;374;Villoria;1405;695;710
37;Salamanca;375;Villoruela;1089;541;548
37;Salamanca;350;Vilvestre;695;342;353
37;Salamanca;376;Vitigudino;3150;1539;1611
37;Salamanca;377;Yecla de Yeltes;445;220;225
37;Salamanca;378;Zamarra;181;100;81
37;Salamanca;379;Zamayón;174;98;76
37;Salamanca;380;Zarapicos;77;40;37
37;Salamanca;381;Zarza de Pumareda (La);234;128;106
37;Salamanca;382;Zorita de la Frontera;339;179;160
38;Santa Cruz de Tenerife;001;Adeje;11047;5547;5500
38;Santa Cruz de Tenerife;002;Agulo;1164;587;577
38;Santa Cruz de Tenerife;003;Alajeró;1183;621;562
38;Santa Cruz de Tenerife;004;Arafo;4232;2050;2182
38;Santa Cruz de Tenerife;005;Arico;4697;2408;2289
38;Santa Cruz de Tenerife;006;Arona;23434;11749;11685
38;Santa Cruz de Tenerife;007;Barlovento;2658;1337;1321
38;Santa Cruz de Tenerife;008;Breña Alta;5474;2738;2736
38;Santa Cruz de Tenerife;009;Breña Baja;3376;1675;1701
38;Santa Cruz de Tenerife;010;Buenavista del Norte;5582;2820;2762
38;Santa Cruz de Tenerife;011;Candelaria;10915;5430;5485
38;Santa Cruz de Tenerife;012;Fasnia;2224;1106;1118
38;Santa Cruz de Tenerife;013;Frontera;3613;1812;1801
38;Santa Cruz de Tenerife;014;Fuencaliente de la Palma;1730;881;849
38;Santa Cruz de Tenerife;015;Garachico;5983;2926;3057
38;Santa Cruz de Tenerife;016;Garafía;2029;1028;1001
38;Santa Cruz de Tenerife;017;Granadilla de Abona;17019;8635;8384
38;Santa Cruz de Tenerife;018;Guancha (La);5230;2620;2610
38;Santa Cruz de Tenerife;019;Guía de Isora;12020;5914;6106
38;Santa Cruz de Tenerife;020;Güímar;14587;7213;7374
38;Santa Cruz de Tenerife;021;Hermigua;2111;1086;1025
38;Santa Cruz de Tenerife;022;Icod de los Vinos;21553;10647;10906
38;Santa Cruz de Tenerife;024;Llanos de Aridane (Los);16588;8125;8463
38;Santa Cruz de Tenerife;025;Matanza de Acentejo (La);5997;3089;2908
38;Santa Cruz de Tenerife;026;Orotava (La);35303;17408;17895
38;Santa Cruz de Tenerife;027;Paso (El);7022;3471;3551
38;Santa Cruz de Tenerife;028;Puerto de la Cruz;25769;12580;13189
38;Santa Cruz de Tenerife;029;Puntagorda;1810;894;916
38;Santa Cruz de Tenerife;030;Puntallana;2274;1138;1136
38;Santa Cruz de Tenerife;031;Realejos (Los);30022;14793;15229
38;Santa Cruz de Tenerife;032;Rosario (El);8428;4246;4182
38;Santa Cruz de Tenerife;033;San Andrés y Sauces;5386;2691;2695
38;Santa Cruz de Tenerife;023;San Cristóbal de La Laguna;112917;55520;57397
38;Santa Cruz de Tenerife;034;San Juan de la Rambla;4525;2245;2280
38;Santa Cruz de Tenerife;035;San Miguel de Abona;5325;2689;2636
38;Santa Cruz de Tenerife;036;San Sebastián de la Gomera;5656;2862;2794
38;Santa Cruz de Tenerife;037;Santa Cruz de la Palma;17296;8335;8961
38;Santa Cruz de Tenerife;038;Santa Cruz de Tenerife;200172;96841;103331
38;Santa Cruz de Tenerife;039;Santa Úrsula;8766;4375;4391
38;Santa Cruz de Tenerife;040;Santiago del Teide;6057;3038;3019
38;Santa Cruz de Tenerife;041;Sauzal (El);6349;3169;3180
38;Santa Cruz de Tenerife;042;Silos (Los);5377;2655;2722
38;Santa Cruz de Tenerife;043;Tacoronte;17299;8638;8661
38;Santa Cruz de Tenerife;044;Tanque (El);3074;1546;1528
38;Santa Cruz de Tenerife;045;Tazacorte;6553;3292;3261
38;Santa Cruz de Tenerife;046;Tegueste;8135;4086;4049
38;Santa Cruz de Tenerife;047;Tijarafe;2195;1108;1087
38;Santa Cruz de Tenerife;049;Valle Gran Rey;3102;1568;1534
38;Santa Cruz de Tenerife;050;Vallehermoso;2940;1488;1452
38;Santa Cruz de Tenerife;048;Valverde;3590;1780;1810
38;Santa Cruz de Tenerife;051;Victoria de Acentejo (La);7443;3764;3679
38;Santa Cruz de Tenerife;052;Vilaflor;1554;795;759
38;Santa Cruz de Tenerife;053;Villa de Mazo;5122;2562;2560
39;Cantabria;001;Alfoz de Lloredo;2755;1419;1336
39;Cantabria;002;Ampuero;3388;1682;1706
39;Cantabria;003;Anievas;442;223;219
39;Cantabria;004;Arenas de Iguña;2280;1164;1116
39;Cantabria;005;Argoños;658;332;326
39;Cantabria;006;Arnuero;1884;937;947
39;Cantabria;007;Arredondo;739;395;344
39;Cantabria;008;Astillero (El);12591;6235;6356
39;Cantabria;009;Bárcena de Cicero;2302;1172;1130
39;Cantabria;010;Bárcena de Pie de Concha;955;447;508
39;Cantabria;011;Bareyo;1661;841;820
39;Cantabria;012;Cabezón de la Sal;7016;3441;3575
39;Cantabria;013;Cabezón de Liébana;836;438;398
39;Cantabria;014;Cabuérniga;1134;571;563
39;Cantabria;015;Camaleño;1223;624;599
39;Cantabria;016;Camargo;20651;10224;10427
39;Cantabria;027;Campoo de Enmedio;3898;1977;1921
39;Cantabria;017;Campoo de Yuso;829;413;416
39;Cantabria;018;Cartes;2201;1105;1096
39;Cantabria;019;Castañeda;1554;769;785
39;Cantabria;020;Castro-Urdiales;13597;6760;6837
39;Cantabria;021;Cieza;793;389;404
39;Cantabria;022;Cillorigo de Liébana;1126;600;526
39;Cantabria;023;Colindres;5638;2807;2831
39;Cantabria;024;Comillas;2489;1183;1306
39;Cantabria;025;Corrales de Buelna (Los);9963;4969;4994
39;Cantabria;026;Corvera de Toranzo;2204;1104;1100
39;Cantabria;028;Entrambasaguas;2571;1280;1291
39;Cantabria;029;Escalante;728;364;364
39;Cantabria;030;Guriezo;1779;913;866
39;Cantabria;031;Hazas de Cesto;1289;656;633
39;Cantabria;032;Hermandad de Campoo de Suso;1913;1018;895
39;Cantabria;033;Herrerías;822;443;379
39;Cantabria;034;Lamasón;468;252;216
39;Cantabria;035;Laredo;13140;6345;6795
39;Cantabria;036;Liendo;800;401;399
39;Cantabria;037;Liérganes;2309;1155;1154
39;Cantabria;038;Limpias;1172;584;588
39;Cantabria;039;Luena;1167;596;571
39;Cantabria;040;Marina de Cudeyo;4442;2207;2235
39;Cantabria;041;Mazcuerras;1809;945;864
39;Cantabria;042;Medio Cudeyo;5750;2822;2928
39;Cantabria;043;Meruelo;968;492;476
39;Cantabria;044;Miengo;3014;1493;1521
39;Cantabria;045;Miera;651;314;337
39;Cantabria;046;Molledo;2134;1058;1076
39;Cantabria;047;Noja;1569;780;789
39;Cantabria;048;Penagos;1828;895;933
39;Cantabria;049;Peñarrubia;344;175;169
39;Cantabria;050;Pesaguero;468;258;210
39;Cantabria;051;Pesquera;111;54;57
39;Cantabria;052;Piélagos;9381;4636;4745
39;Cantabria;053;Polaciones;355;207;148
39;Cantabria;054;Polanco;3807;1869;1938
39;Cantabria;055;Potes;1480;723;757
39;Cantabria;056;Puente Viesgo;2467;1238;1229
39;Cantabria;057;Ramales de la Victoria;2487;1269;1218
39;Cantabria;058;Rasines;1062;540;522
39;Cantabria;059;Reinosa;12613;6157;6456
39;Cantabria;060;Reocín;6570;3252;3318
39;Cantabria;061;Ribamontán al Mar;2942;1506;1436
39;Cantabria;062;Ribamontán al Monte;2028;1057;971
39;Cantabria;063;Rionansa;1718;915;803
39;Cantabria;064;Riotuerto;1576;761;815
39;Cantabria;065;Rozas de Valdearroyo (Las);285;149;136
39;Cantabria;066;Ruente;958;489;469
39;Cantabria;067;Ruesga;1345;670;675
39;Cantabria;068;Ruiloba;744;370;374
39;Cantabria;069;San Felices de Buelna;2344;1150;1194
39;Cantabria;070;San Miguel de Aguayo;170;88;82
39;Cantabria;071;San Pedro del Romeral;819;425;394
39;Cantabria;072;San Roque de Riomiera;611;332;279
39;Cantabria;080;San Vicente de la Barquera;4540;2312;2228
39;Cantabria;073;Santa Cruz de Bezana;5312;2642;2670
39;Cantabria;074;Santa María de Cayón;6089;3058;3031
39;Cantabria;075;Santander;191583;90546;101037
39;Cantabria;076;Santillana del Mar;3912;1912;2000
39;Cantabria;077;Santiurde de Reinosa;397;213;184
39;Cantabria;078;Santiurde de Toranzo;1795;897;898
39;Cantabria;079;Santoña;11027;5715;5312
39;Cantabria;081;Saro;582;298;284
39;Cantabria;082;Selaya;2053;1038;1015
39;Cantabria;083;Soba;1869;982;887
39;Cantabria;084;Solórzano;992;513;479
39;Cantabria;085;Suances;5912;2907;3005
39;Cantabria;086;Tojos (Los);420;222;198
39;Cantabria;087;Torrelavega;60155;29326;30829
39;Cantabria;088;Tresviso;78;46;32
39;Cantabria;089;Tudanca;291;174;117
39;Cantabria;090;Udías;843;425;418
39;Cantabria;095;Val de San Vicente;2523;1295;1228
39;Cantabria;091;Valdáliga;2760;1410;1350
39;Cantabria;092;Valdeolea;1774;910;864
39;Cantabria;093;Valdeprado del Río;387;194;193
39;Cantabria;094;Valderredible;1289;660;629
39;Cantabria;096;Vega de Liébana;1110;587;523
39;Cantabria;097;Vega de Pas;1129;575;554
39;Cantabria;098;Villacarriedo;2121;1057;1064
39;Cantabria;099;Villaescusa;2989;1462;1527
39;Cantabria;100;Villafufre;1147;583;564
39;Cantabria;101;Villaverde de Trucíos;390;208;182
39;Cantabria;102;Voto;2535;1316;1219
40;Segovia;001;Abades;921;459;462
40;Segovia;002;Adrada de Pirón;54;31;23
40;Segovia;003;Adrados;273;131;142
40;Segovia;004;Aguilafuente;811;390;421
40;Segovia;005;Alconada de Maderuelo;60;31;29
40;Segovia;012;Aldea Real;420;219;201
40;Segovia;006;Aldealcorvo;37;19;18
40;Segovia;007;Aldealengua de Pedraza;111;63;48
40;Segovia;008;Aldealengua de Santa María;80;45;35
40;Segovia;009;Aldeanueva de la Serrezuela;53;31;22
40;Segovia;010;Aldeanueva del Codonal;251;125;126
40;Segovia;013;Aldeasoña;172;79;93
40;Segovia;014;Aldehorno;97;53;44
40;Segovia;015;Aldehuela del Codonal;68;29;39
40;Segovia;016;Aldeonte;110;55;55
40;Segovia;017;Anaya;135;70;65
40;Segovia;018;Añe;130;72;58
40;Segovia;019;Arahuetes;55;28;27
40;Segovia;020;Arcones;287;155;132
40;Segovia;021;Arevalillo de Cega;41;22;19
40;Segovia;022;Armuña;322;164;158
40;Segovia;024;Ayllón;1265;642;623
40;Segovia;025;Barbolla;243;125;118
40;Segovia;026;Basardilla;122;62;60
40;Segovia;028;Bercial;143;67;76
40;Segovia;029;Bercimuel;80;34;46
40;Segovia;030;Bernardos;809;396;413
40;Segovia;031;Bernuy de Porreros;304;157;147
40;Segovia;032;Boceguillas;555;268;287
40;Segovia;033;Brieva;59;38;21
40;Segovia;034;Caballar;108;51;57
40;Segovia;035;Cabañas de Polendos;116;59;57
40;Segovia;036;Cabezuela;785;413;372
40;Segovia;037;Calabazas de Fuentidueña;101;49;52
40;Segovia;039;Campo de San Pedro;374;217;157
40;Segovia;040;Cantalejo;3456;1736;1720
40;Segovia;041;Cantimpalos;1326;670;656
40;Segovia;043;Carbonero el Mayor;2381;1206;1175
40;Segovia;044;Carrascal del Río;231;122;109
40;Segovia;045;Casla;151;82;69
40;Segovia;046;Castillejo de Mesleón;144;71;73
40;Segovia;047;Castro de Fuentidueña;106;61;45
40;Segovia;048;Castrojimeno;48;29;19
40;Segovia;049;Castroserna de Abajo;70;42;28
40;Segovia;051;Castroserracín;44;27;17
40;Segovia;052;Cedillo de la Torre;161;83;78
40;Segovia;053;Cerezo de Abajo;179;96;83
40;Segovia;054;Cerezo de Arriba;203;109;94
40;Segovia;065;Chañe;764;400;364
40;Segovia;055;Cilleruelo de San Mamés;72;35;37
40;Segovia;056;Cobos de Fuentidueña;90;41;49
40;Segovia;057;Coca;2026;1017;1009
40;Segovia;058;Codorniz;515;258;257
40;Segovia;059;Collado Hermoso;128;61;67
40;Segovia;060;Condado de Castilnovo;154;82;72
40;Segovia;061;Corral de Ayllón;128;69;59
40;Segovia;902;Cozuelos de Fuentidueña;246;123;123
40;Segovia;062;Cubillo;74;41;33
40;Segovia;063;Cuéllar;9126;4624;4502
40;Segovia;905;Cuevas de Provanco;255;138;117
40;Segovia;068;Domingo García;56;25;31
40;Segovia;069;Donhierro;118;68;50
40;Segovia;070;Duruelo;119;60;59
40;Segovia;071;Encinas;75;35;40
40;Segovia;072;Encinillas;78;39;39
40;Segovia;073;Escalona del Prado;626;319;307
40;Segovia;074;Escarabajosa de Cabezas;409;221;188
40;Segovia;075;Escobar de Polendos;232;115;117
40;Segovia;076;Espinar (El);5160;2627;2533
40;Segovia;077;Espirdo;206;120;86
40;Segovia;078;Fresneda de Cuéllar;273;146;127
40;Segovia;079;Fresno de Cantespino;242;127;115
40;Segovia;080;Fresno de la Fuente;92;50;42
40;Segovia;081;Frumales;262;133;129
40;Segovia;082;Fuente de Santa Cruz;231;121;110
40;Segovia;083;Fuente el Olmo de Fuentidueña;211;108;103
40;Segovia;084;Fuente el Olmo de Íscar;117;67;50
40;Segovia;086;Fuentepelayo;1031;523;508
40;Segovia;087;Fuentepiñel;203;100;103
40;Segovia;088;Fuenterrebollo;482;239;243
40;Segovia;089;Fuentesaúco de Fuentidueña;395;207;188
40;Segovia;091;Fuentesoto;176;90;86
40;Segovia;092;Fuentidueña;238;113;125
40;Segovia;093;Gallegos;104;55;49
40;Segovia;094;Garcillán;362;186;176
40;Segovia;095;Gomezserracín;670;336;334
40;Segovia;097;Grajera;80;39;41
40;Segovia;099;Honrubia de la Cuesta;104;51;53
40;Segovia;100;Hontalbilla;512;266;246
40;Segovia;101;Hontanares de Eresma;133;73;60
40;Segovia;103;Huertos (Los);157;83;74
40;Segovia;104;Ituero y Lama;56;33;23
40;Segovia;105;Juarros de Riomoros;86;47;39
40;Segovia;106;Juarros de Voltoya;293;158;135
40;Segovia;107;Labajos;170;94;76
40;Segovia;108;Laguna de Contreras;214;117;97
40;Segovia;109;Languilla;156;84;72
40;Segovia;110;Lastras de Cuéllar;610;320;290
40;Segovia;111;Lastras del Pozo;98;53;45
40;Segovia;112;Lastrilla (La);650;337;313
40;Segovia;113;Losa (La);286;147;139
40;Segovia;115;Maderuelo;166;84;82
40;Segovia;903;Marazoleja;179;98;81
40;Segovia;118;Marazuela;103;51;52
40;Segovia;119;Martín Miguel;217;108;109
40;Segovia;120;Martín Muñoz de la Dehesa;183;98;85
40;Segovia;121;Martín Muñoz de las Posadas;603;304;299
40;Segovia;122;Marugán;265;133;132
40;Segovia;124;Mata de Cuéllar;324;173;151
40;Segovia;123;Matabuena;225;112;113
40;Segovia;125;Matilla (La);137;74;63
40;Segovia;126;Melque de Cercos;146;67;79
40;Segovia;127;Membibre de la Hoz;98;50;48
40;Segovia;128;Migueláñez;197;100;97
40;Segovia;129;Montejo de Arévalo;329;177;152
40;Segovia;130;Montejo de la Vega de la Serrezuela;212;117;95
40;Segovia;131;Monterrubio;62;30;32
40;Segovia;132;Moral de Hornuez;131;69;62
40;Segovia;134;Mozoncillo;1074;553;521
40;Segovia;135;Muñopedro;435;221;214
40;Segovia;136;Muñoveros;240;126;114
40;Segovia;138;Nava de la Asunción;2675;1369;1306
40;Segovia;139;Navafría;415;220;195
40;Segovia;140;Navalilla;196;102;94
40;Segovia;141;Navalmanzano;1188;607;581
40;Segovia;142;Navares de Ayuso;82;46;36
40;Segovia;143;Navares de Enmedio;208;109;99
40;Segovia;144;Navares de las Cuevas;28;16;12
40;Segovia;145;Navas de Oro;1496;758;738
40;Segovia;904;Navas de Riofrío;236;109;127
40;Segovia;146;Navas de San Antonio;324;167;157
40;Segovia;148;Nieva;390;193;197
40;Segovia;149;Olombrada;883;463;420
40;Segovia;150;Orejana;125;63;62
40;Segovia;151;Ortigosa de Pestaño;97;50;47
40;Segovia;901;Ortigosa del Monte;306;145;161
40;Segovia;152;Otero de Herreros;841;419;422
40;Segovia;154;Pajarejos;49;22;27
40;Segovia;155;Palazuelos de Eresma;1559;772;787
40;Segovia;156;Pedraza;471;231;240
40;Segovia;157;Pelayos del Arroyo;46;25;21
40;Segovia;158;Perosillo;35;20;15
40;Segovia;159;Pinarejos;242;131;111
40;Segovia;160;Pinarnegrillo;215;114;101
40;Segovia;161;Pradales;70;42;28
40;Segovia;162;Prádena;554;287;267
40;Segovia;163;Puebla de Pedraza;98;47;51
40;Segovia;164;Rapariegos;324;178;146
40;Segovia;165;Rebollo;153;86;67
40;Segovia;166;Remondo;395;187;208
40;Segovia;168;Riaguas de San Bartolomé;77;41;36
40;Segovia;170;Riaza;1646;857;789
40;Segovia;171;Ribota;47;27;20
40;Segovia;172;Riofrío de Riaza;60;34;26
40;Segovia;173;Roda de Eresma;100;49;51
40;Segovia;174;Sacramenia;603;320;283
40;Segovia;176;Samboal;686;347;339
40;Segovia;177;San Cristóbal de Cuéllar;271;138;133
40;Segovia;178;San Cristóbal de la Vega;194;98;96
40;Segovia;906;San Cristóbal de Segovia;"";"";""
40;Segovia;181;San Ildefonso;4924;2381;2543
40;Segovia;182;San Martín y Mudrián;331;172;159
40;Segovia;183;San Miguel de Bernuy;223;118;105
40;Segovia;184;San Pedro de Gaíllos;336;177;159
40;Segovia;179;Sanchonuño;756;379;377
40;Segovia;180;Sangarcía;533;273;260
40;Segovia;185;Santa María la Real de Nieva;1642;833;809
40;Segovia;186;Santa Marta del Cerro;57;27;30
40;Segovia;188;Santiuste de Pedraza;125;70;55
40;Segovia;189;Santiuste de San Juan Bautista;869;434;435
40;Segovia;190;Santo Domingo de Pirón;50;24;26
40;Segovia;191;Santo Tomé del Puerto;368;186;182
40;Segovia;192;Sauquillo de Cabezas;276;145;131
40;Segovia;193;Sebúlcor;281;151;130
40;Segovia;194;Segovia;54548;26280;28268
40;Segovia;195;Sepúlveda;1376;706;670
40;Segovia;196;Sequera de Fresno;75;42;33
40;Segovia;198;Sotillo;66;31;35
40;Segovia;199;Sotosalbos;97;50;47
40;Segovia;200;Tabanera la Luenga;84;45;39
40;Segovia;201;Tolocirio;75;35;40
40;Segovia;206;Torre Val de San Pedro;197;101;96
40;Segovia;202;Torreadrada;152;77;75
40;Segovia;203;Torrecaballeros;302;148;154
40;Segovia;204;Torrecilla del Pinar;375;179;196
40;Segovia;205;Torreiglesias;404;216;188
40;Segovia;207;Trescasas;177;94;83
40;Segovia;208;Turégano;1139;563;576
40;Segovia;210;Urueñas;141;80;61
40;Segovia;211;Valdeprados;44;24;20
40;Segovia;212;Valdevacas de Montejo;40;23;17
40;Segovia;213;Valdevacas y Guijar;166;92;74
40;Segovia;218;Valle de Tabladillo;207;110;97
40;Segovia;219;Vallelado;891;448;443
40;Segovia;220;Valleruela de Pedraza;75;42;33
40;Segovia;221;Valleruela de Sepúlveda;82;44;38
40;Segovia;214;Valseca;327;166;161
40;Segovia;215;Valtiendas;219;118;101
40;Segovia;216;Valverde del Majano;513;264;249
40;Segovia;222;Veganzones;330;164;166
40;Segovia;223;Vegas de Matute;272;148;124
40;Segovia;224;Ventosilla y Tejadilla;25;15;10
40;Segovia;225;Villacastín;1627;836;791
40;Segovia;228;Villaverde de Íscar;779;399;380
40;Segovia;229;Villaverde de Montejo;90;44;46
40;Segovia;230;Villeguillo;140;78;62
40;Segovia;231;Yanguas de Eresma;223;106;117
40;Segovia;233;Zarzuela del Monte;554;278;276
40;Segovia;234;Zarzuela del Pinar;639;341;298
41;Sevilla;001;Aguadulce;1940;983;957
41;Sevilla;002;Alanís;2097;1067;1030
41;Sevilla;003;Albaida del Aljarafe;1684;853;831
41;Sevilla;004;Alcalá de Guadaira;52444;25984;26460
41;Sevilla;005;Alcalá del Río;9134;4647;4487
41;Sevilla;006;Alcolea del Río;3438;1698;1740
41;Sevilla;007;Algaba (La);12498;6293;6205
41;Sevilla;008;Algámitas;1454;747;707
41;Sevilla;009;Almadén de la Plata;1791;913;878
41;Sevilla;010;Almensilla;1867;929;938
41;Sevilla;011;Arahal;17838;8856;8982
41;Sevilla;012;Aznalcázar;3211;1593;1618
41;Sevilla;013;Aznalcóllar;5638;2859;2779
41;Sevilla;014;Badolatosa;3136;1600;1536
41;Sevilla;015;Benacazón;4796;2429;2367
41;Sevilla;016;Bollullos de la Mitación;6109;3058;3051
41;Sevilla;017;Bormujos;5309;2604;2705
41;Sevilla;018;Brenes;10359;5198;5161
41;Sevilla;019;Burguillos;3259;1632;1627
41;Sevilla;020;Cabezas de San Juan (Las);15211;7792;7419
41;Sevilla;021;Camas;25625;12460;13165
41;Sevilla;022;Campana (La);5313;2682;2631
41;Sevilla;023;Cantillana;8869;4448;4421
41;Sevilla;901;Cañada Rosal;2859;1437;1422
41;Sevilla;024;Carmona;23757;11955;11802
41;Sevilla;025;Carrión de los Céspedes;2364;1144;1220
41;Sevilla;026;Casariche;5079;2576;2503
41;Sevilla;027;Castilblanco de los Arroyos;4054;2044;2010
41;Sevilla;028;Castilleja de Guzmán;386;199;187
41;Sevilla;029;Castilleja de la Cuesta;15296;7511;7785
41;Sevilla;030;Castilleja del Campo;639;316;323
41;Sevilla;031;Castillo de las Guardas (El);1734;888;846
41;Sevilla;032;Cazalla de la Sierra;5167;2596;2571
41;Sevilla;033;Constantina;7419;3647;3772
41;Sevilla;034;Coria del Río;22312;11090;11222
41;Sevilla;035;Coripe;1697;870;827
41;Sevilla;036;Coronil (El);5118;2596;2522
41;Sevilla;037;Corrales (Los);4027;2058;1969
41;Sevilla;903;Cuervo de Sevilla (El);"";"";""
41;Sevilla;038;Dos Hermanas;79003;39019;39984
41;Sevilla;039;Écija;36364;17971;18393
41;Sevilla;040;Espartinas;2939;1494;1445
41;Sevilla;041;Estepa;11023;5451;5572
41;Sevilla;042;Fuentes de Andalucía;7241;3593;3648
41;Sevilla;043;Garrobo (El);737;366;371
41;Sevilla;044;Gelves;4158;2034;2124
41;Sevilla;045;Gerena;5276;2649;2627
41;Sevilla;046;Gilena;3783;1897;1886
41;Sevilla;047;Gines;6735;3292;3443
41;Sevilla;048;Guadalcanal;3159;1560;1599
41;Sevilla;049;Guillena;7787;3923;3864
41;Sevilla;050;Herrera;5818;2882;2936
41;Sevilla;051;Huévar del Aljarafe;2153;1110;1043
41;Sevilla;052;Lantejuela (La);3374;1716;1658
41;Sevilla;053;Lebrija;30636;15582;15054
41;Sevilla;054;Lora de Estepa;720;362;358
41;Sevilla;055;Lora del Río;18965;9363;9602
41;Sevilla;056;Luisiana (La);4238;2164;2074
41;Sevilla;057;Madroño (El);408;212;196
41;Sevilla;058;Mairena del Alcor;15054;7519;7535
41;Sevilla;059;Mairena del Aljarafe;25187;12593;12594
41;Sevilla;060;Marchena;17445;8637;8808
41;Sevilla;061;Marinaleda;2560;1265;1295
41;Sevilla;062;Martín de la Jara;2724;1419;1305
41;Sevilla;063;Molares (Los);2648;1331;1317
41;Sevilla;064;Montellano;7023;3574;3449
41;Sevilla;065;Morón de la Frontera;28172;14124;14048
41;Sevilla;066;Navas de la Concepción (Las);2008;1001;1007
41;Sevilla;067;Olivares;6742;3430;3312
41;Sevilla;068;Osuna;16887;8332;8555
41;Sevilla;069;Palacios y Villafranca (Los);30084;15276;14808
41;Sevilla;070;Palomares del Río;2510;1292;1218
41;Sevilla;071;Paradas;7163;3442;3721
41;Sevilla;072;Pedrera;4725;2379;2346
41;Sevilla;073;Pedroso (El);2398;1188;1210
41;Sevilla;074;Peñaflor;4068;2051;2017
41;Sevilla;075;Pilas;10673;5234;5439
41;Sevilla;076;Pruna;3589;1847;1742
41;Sevilla;077;Puebla de Cazalla (La);10663;5348;5315
41;Sevilla;078;Puebla de los Infantes (La);3660;1850;1810
41;Sevilla;079;Puebla del Río (La);16542;8330;8212
41;Sevilla;080;Real de la Jara (El);1756;879;877
41;Sevilla;081;Rinconada (La);21714;10919;10795
41;Sevilla;082;Roda de Andalucía (La);4106;2030;2076
41;Sevilla;083;Ronquillo (El);1374;683;691
41;Sevilla;084;Rubio (El);3644;1823;1821
41;Sevilla;085;Salteras;2610;1312;1298
41;Sevilla;086;San Juan de Aznalfarache;22371;10869;11502
41;Sevilla;088;San Nicolás del Puerto;737;394;343
41;Sevilla;087;Sanlúcar la Mayor;9602;4790;4812
41;Sevilla;089;Santiponce;6424;3213;3211
41;Sevilla;090;Saucejo (El);4063;2058;2005
41;Sevilla;091;Sevilla;683028;327628;355400
41;Sevilla;092;Tocina;8786;4354;4432
41;Sevilla;093;Tomares;13548;6713;6835
41;Sevilla;094;Umbrete;3014;1509;1505
41;Sevilla;095;Utrera;43773;21881;21892
41;Sevilla;096;Valencina de la Concepción;4572;2305;2267
41;Sevilla;902;Villafranco del Guadalquivir;"";"";""
41;Sevilla;097;Villamanrique de la Condesa;3549;1744;1805
41;Sevilla;100;Villanueva de San Juan;1699;846;853
41;Sevilla;098;Villanueva del Ariscal;4107;1955;2152
41;Sevilla;099;Villanueva del Río y Minas;6032;2900;3132
41;Sevilla;101;Villaverde del Río;6567;3339;3228
41;Sevilla;102;Viso del Alcor (El);15198;7698;7500
42;Soria;001;Abejar;374;193;181
42;Soria;003;Adradas;128;64;64
42;Soria;004;Ágreda;3641;1773;1868
42;Soria;006;Alconaba;180;100;80
42;Soria;007;Alcubilla de Avellaneda;271;142;129
42;Soria;008;Alcubilla de las Peñas;110;54;56
42;Soria;009;Aldealafuente;170;84;86
42;Soria;010;Aldealices;38;18;20
42;Soria;011;Aldealpozo;31;14;17
42;Soria;012;Aldealseñor;56;30;26
42;Soria;013;Aldehuela de Periáñez;46;23;23
42;Soria;014;Aldehuelas (Las);157;82;75
42;Soria;015;Alentisque;57;29;28
42;Soria;016;Aliud;57;27;30
42;Soria;017;Almajano;200;98;102
42;Soria;018;Almaluez;379;185;194
42;Soria;019;Almarza;664;352;312
42;Soria;020;Almazán;6005;2982;3023
42;Soria;021;Almazul;217;109;108
42;Soria;022;Almenar de Soria;465;237;228
42;Soria;023;Alpanseque;133;69;64
42;Soria;024;Arancón;120;65;55
42;Soria;025;Arcos de Jalón;2189;1084;1105
42;Soria;026;Arenillas;49;25;24
42;Soria;027;Arévalo de la Sierra;134;72;62
42;Soria;028;Ausejo de la Sierra;64;31;33
42;Soria;029;Baraona;293;144;149
42;Soria;030;Barca;175;97;78
42;Soria;031;Barcones;61;34;27
42;Soria;032;Bayubas de Abajo;322;168;154
42;Soria;033;Bayubas de Arriba;98;49;49
42;Soria;034;Beratón;42;31;11
42;Soria;035;Berlanga de Duero;1342;683;659
42;Soria;036;Blacos;74;41;33
42;Soria;037;Bliecos;71;37;34
42;Soria;038;Borjabad;74;40;34
42;Soria;039;Borobia;435;219;216
42;Soria;041;Buberos;57;24;33
42;Soria;042;Buitrago;58;29;29
42;Soria;043;Burgo de Osma-Ciudad de Osma;5000;2447;2553
42;Soria;044;Cabrejas del Campo;97;54;43
42;Soria;045;Cabrejas del Pinar;509;274;235
42;Soria;046;Calatañazor;72;39;33
42;Soria;048;Caltojar;172;88;84
42;Soria;049;Candilichera;256;133;123
42;Soria;050;Cañamaque;69;39;30
42;Soria;051;Carabantes;42;22;20
42;Soria;052;Caracena;12;7;5
42;Soria;053;Carrascosa de Abajo;49;26;23
42;Soria;054;Carrascosa de la Sierra;18;7;11
42;Soria;055;Casarejos;296;149;147
42;Soria;056;Castilfrío de la Sierra;41;22;19
42;Soria;058;Castillejo de Robledo;245;129;116
42;Soria;057;Castilruiz;386;197;189
42;Soria;059;Centenera de Andaluz;38;17;21
42;Soria;060;Cerbón;66;36;30
42;Soria;061;Cidones;365;192;173
42;Soria;062;Cigudosa;100;57;43
42;Soria;063;Cihuela;114;56;58
42;Soria;064;Ciria;106;51;55
42;Soria;065;Cirujales del Río;44;26;18
42;Soria;068;Coscurita;174;97;77
42;Soria;069;Covaleda;2112;1083;1029
42;Soria;070;Cubilla;101;52;49
42;Soria;071;Cubo de la Solana;344;171;173
42;Soria;073;Cueva de Ágreda;141;71;70
42;Soria;075;Dévanos;177;92;85
42;Soria;076;Deza;459;234;225
42;Soria;078;Duruelo de la Sierra;1501;768;733
42;Soria;079;Escobosa de Almazán;52;29;23
42;Soria;080;Espeja de San Marcelino;288;161;127
42;Soria;081;Espejón;242;126;116
42;Soria;082;Estepa de San Juan;21;11;10
42;Soria;083;Frechilla de Almazán;55;28;27
42;Soria;084;Fresno de Caracena;61;31;30
42;Soria;085;Fuentearmegil;430;232;198
42;Soria;086;Fuentecambrón;82;47;35
42;Soria;087;Fuentecantos;53;25;28
42;Soria;088;Fuentelmonge;179;90;89
42;Soria;089;Fuentelsaz de Soria;68;35;33
42;Soria;090;Fuentepinilla;182;94;88
42;Soria;092;Fuentes de Magaña;133;66;67
42;Soria;093;Fuentestrún;82;49;33
42;Soria;094;Garray;337;170;167
42;Soria;095;Golmayo;536;282;254
42;Soria;096;Gómara;643;310;333
42;Soria;097;Gormaz;29;12;17
42;Soria;098;Herrera de Soria;41;23;18
42;Soria;100;Hinojosa del Campo;67;41;26
42;Soria;103;Langa de Duero;1040;545;495
42;Soria;105;Liceras;74;37;37
42;Soria;106;Losilla (La);23;14;9
42;Soria;107;Magaña;113;59;54
42;Soria;108;Maján;23;14;9
42;Soria;110;Matalebreras;154;78;76
42;Soria;111;Matamala de Almazán;484;245;239
42;Soria;113;Medinaceli;747;386;361
42;Soria;115;Miño de Medinaceli;162;77;85
42;Soria;116;Miño de San Esteban;125;65;60
42;Soria;117;Molinos de Duero;201;102;99
42;Soria;118;Momblona;56;31;25
42;Soria;119;Monteagudo de las Vicarías;355;175;180
42;Soria;120;Montejo de Tiermes;307;165;142
42;Soria;121;Montenegro de Cameros;126;67;59
42;Soria;123;Morón de Almazán;334;164;170
42;Soria;124;Muriel de la Fuente;93;50;43
42;Soria;125;Muriel Viejo;99;48;51
42;Soria;127;Nafría de Ucero;109;54;55
42;Soria;128;Narros;63;30;33
42;Soria;129;Navaleno;946;479;467
42;Soria;130;Nepas;103;60;43
42;Soria;131;Nolay;107;58;49
42;Soria;132;Noviercas;277;132;145
42;Soria;134;Ólvega;3165;1640;1525
42;Soria;135;Oncala;131;79;52
42;Soria;139;Pinilla del Campo;33;17;16
42;Soria;140;Portillo de Soria;26;15;11
42;Soria;141;Póveda de Soria (La);142;72;70
42;Soria;142;Pozalmuro;122;54;68
42;Soria;144;Quintana Redonda;667;343;324
42;Soria;145;Quintanas de Gormaz;223;111;112
42;Soria;148;Quiñonería;22;8;14
42;Soria;149;Rábanos (Los);425;245;180
42;Soria;151;Rebollar;50;29;21
42;Soria;152;Recuerda;173;90;83
42;Soria;153;Rello;52;22;30
42;Soria;154;Renieblas;138;73;65
42;Soria;155;Retortillo de Soria;307;160;147
42;Soria;156;Reznos;71;40;31
42;Soria;157;Riba de Escalote (La);46;26;20
42;Soria;158;Rioseco de Soria;168;87;81
42;Soria;159;Rollamienta;55;28;27
42;Soria;160;Royo (El);388;183;205
42;Soria;161;Salduero;217;116;101
42;Soria;162;San Esteban de Gormaz;3575;1837;1738
42;Soria;163;San Felices;91;52;39
42;Soria;164;San Leonardo de Yagüe;2129;1084;1045
42;Soria;165;San Pedro Manrique;518;263;255
42;Soria;166;Santa Cruz de Yanguas;66;43;23
42;Soria;167;Santa María de Huerta;530;268;262
42;Soria;168;Santa María de las Hoyas;222;118;104
42;Soria;171;Serón de Nágima;354;184;170
42;Soria;172;Soliedra;48;28;20
42;Soria;173;Soria;32401;15458;16943
42;Soria;174;Sotillo del Rincón;185;84;101
42;Soria;175;Suellacabras;52;26;26
42;Soria;176;Tajahuerce;54;27;27
42;Soria;177;Tajueco;157;82;75
42;Soria;178;Talveila;234;125;109
42;Soria;181;Tardelcuende;713;343;370
42;Soria;182;Taroda;96;50;46
42;Soria;183;Tejado;265;131;134
42;Soria;184;Torlengua;145;69;76
42;Soria;185;Torreblacos;58;28;30
42;Soria;187;Torrubia de Soria;118;61;57
42;Soria;188;Trévago;85;39;46
42;Soria;189;Ucero;103;51;52
42;Soria;190;Vadillo;172;89;83
42;Soria;191;Valdeavellano de Tera;241;129;112
42;Soria;192;Valdegeña;62;33;29
42;Soria;193;Valdelagua del Cerro;44;22;22
42;Soria;194;Valdemaluque;361;183;178
42;Soria;195;Valdenebro;187;99;88
42;Soria;196;Valdeprado;24;10;14
42;Soria;197;Valderrodilla;148;70;78
42;Soria;198;Valtajeros;34;18;16
42;Soria;200;Velamazán;166;93;73
42;Soria;201;Velilla de la Sierra;21;8;13
42;Soria;202;Velilla de los Ajos;58;34;24
42;Soria;204;Viana de Duero;88;46;42
42;Soria;205;Villaciervos;91;48;43
42;Soria;206;Villanueva de Gormaz;21;11;10
42;Soria;207;Villar del Ala;42;19;23
42;Soria;208;Villar del Campo;47;24;23
42;Soria;209;Villar del Río;207;112;95
42;Soria;211;Villares de Soria (Los);135;62;73
42;Soria;212;Villasayas;124;76;48
42;Soria;213;Villaseca de Arciel;55;29;26
42;Soria;215;Vinuesa;1155;612;543
42;Soria;216;Vizmanos;46;28;18
42;Soria;217;Vozmediano;65;35;30
42;Soria;218;Yanguas;77;43;34
42;Soria;219;Yelo;91;48;43
43;Tarragona;001;Aiguamúrcia;568;292;276
43;Tarragona;002;Albinyana;817;417;400
43;Tarragona;003;Albiol (L');114;59;55
43;Tarragona;004;Alcanar;7924;3941;3983
43;Tarragona;005;Alcover;3386;1727;1659
43;Tarragona;904;Aldea (L');3557;1776;1781
43;Tarragona;006;Aldover;813;395;418
43;Tarragona;007;Aleixar (L');604;308;296
43;Tarragona;008;Alfara de Carles;389;205;184
43;Tarragona;009;Alforja;1097;526;571
43;Tarragona;010;Alió;342;176;166
43;Tarragona;011;Almoster;481;245;236
43;Tarragona;012;Altafulla;1867;944;923
43;Tarragona;013;Ametlla de Mar (L');4209;2104;2105
43;Tarragona;906;Ampolla (L');1593;770;823
43;Tarragona;014;Amposta;15338;7618;7720
43;Tarragona;016;Arboç (L');3537;1801;1736
43;Tarragona;015;Arbolí;135;70;65
43;Tarragona;017;Argentera (L');128;66;62
43;Tarragona;018;Arnes;525;272;253
43;Tarragona;019;Ascó;1723;875;848
43;Tarragona;020;Banyeres del Penedès;1475;766;709
43;Tarragona;021;Barberà de la Conca;422;216;206
43;Tarragona;022;Batea;2024;1034;990
43;Tarragona;023;Bellmunt del Priorat;304;148;156
43;Tarragona;024;Bellvei;1006;527;479
43;Tarragona;025;Benifallet;932;470;462
43;Tarragona;026;Benissanet;1023;497;526
43;Tarragona;027;Bisbal de Falset (La);266;132;134
43;Tarragona;028;Bisbal del Penedès (La);1425;730;695
43;Tarragona;029;Blancafort;396;194;202
43;Tarragona;030;Bonastre;269;137;132
43;Tarragona;031;Borges del Camp (Les);1391;690;701
43;Tarragona;032;Bot;901;454;447
43;Tarragona;033;Botarell;462;227;235
43;Tarragona;034;Bràfim;577;279;298
43;Tarragona;035;Cabacés;351;182;169
43;Tarragona;036;Cabra del Camp;440;234;206
43;Tarragona;037;Calafell;7499;3759;3740
43;Tarragona;903;Camarles;2865;1438;1427
43;Tarragona;038;Cambrils;15075;7494;7581
43;Tarragona;039;Capafonts;108;52;56
43;Tarragona;040;Capçanes;408;185;223
43;Tarragona;041;Caseres;336;167;169
43;Tarragona;042;Castellvell del Camp;923;461;462
43;Tarragona;043;Catllar (El);1346;692;654
43;Tarragona;045;Colldejou;191;102;89
43;Tarragona;046;Conesa;123;56;67
43;Tarragona;047;Constantí;5313;2746;2567
43;Tarragona;048;Corbera d'Ebre;1122;579;543
43;Tarragona;049;Cornudella de Montsant;856;435;421
43;Tarragona;050;Creixell;1106;567;539
43;Tarragona;051;Cunit;2763;1420;1343
43;Tarragona;901;Deltebre;10171;5115;5056
43;Tarragona;053;Duesaigües;216;127;89
43;Tarragona;054;Espluga de Francolí (L');3602;1748;1854
43;Tarragona;055;Falset;2589;1270;1319
43;Tarragona;056;Fatarella (La);1372;690;682
43;Tarragona;057;Febró (La);57;31;26
43;Tarragona;058;Figuera (La);131;64;67
43;Tarragona;059;Figuerola del Camp;213;105;108
43;Tarragona;060;Flix;4965;2499;2466
43;Tarragona;061;Forès;61;29;32
43;Tarragona;062;Freginals;371;179;192
43;Tarragona;063;Galera (La);750;358;392
43;Tarragona;064;Gandesa;2658;1319;1339
43;Tarragona;065;Garcia;567;279;288
43;Tarragona;066;Garidells (Els);184;94;90
43;Tarragona;067;Ginestar;875;452;423
43;Tarragona;068;Godall;750;370;380
43;Tarragona;069;Gratallops;239;115;124
43;Tarragona;070;Guiamets (Els);299;149;150
43;Tarragona;071;Horta de Sant Joan;1317;681;636
43;Tarragona;072;Lloar (El);136;71;65
43;Tarragona;073;Llorac;104;50;54
43;Tarragona;074;Llorenç del Penedès;1333;648;685
43;Tarragona;076;Marçà;569;273;296
43;Tarragona;075;Margalef;150;78;72
43;Tarragona;077;Mas de Barberans;758;375;383
43;Tarragona;078;Masdenverge;929;473;456
43;Tarragona;079;Masllorenç;373;192;181
43;Tarragona;080;Masó (La);263;129;134
43;Tarragona;081;Maspujols;374;189;185
43;Tarragona;082;Masroig (El);534;256;278
43;Tarragona;083;Milà (El);162;74;88
43;Tarragona;084;Miravet;820;419;401
43;Tarragona;085;Molar (El);318;161;157
43;Tarragona;086;Montblanc;5750;2847;2903
43;Tarragona;088;Montbrió del Camp;1400;684;716
43;Tarragona;089;Montferri;159;79;80
43;Tarragona;090;Montmell (El);280;141;139
43;Tarragona;091;Mont-ral;113;54;59
43;Tarragona;092;Mont-roig del Camp;5152;2625;2527
43;Tarragona;093;Móra d'Ebre;4454;2191;2263
43;Tarragona;094;Móra la Nova;2699;1327;1372
43;Tarragona;095;Morell (El);2255;1161;1094
43;Tarragona;096;Morera de Montsant (La);189;95;94
43;Tarragona;097;Nou de Gaià (La);368;178;190
43;Tarragona;098;Nulles;328;154;174
43;Tarragona;100;Pallaresos (Els);677;365;312
43;Tarragona;099;Palma d'Ebre (La);453;214;239
43;Tarragona;101;Passanant;195;106;89
43;Tarragona;102;Paüls;715;367;348
43;Tarragona;103;Perafort;511;262;249
43;Tarragona;104;Perelló (El);2144;1097;1047
43;Tarragona;105;Piles (Les);135;76;59
43;Tarragona;106;Pinell de Brai (El);1166;600;566
43;Tarragona;107;Pira;313;146;167
43;Tarragona;108;Pla de Santa Maria (El);1584;805;779
43;Tarragona;109;Pobla de Mafumet (La);928;465;463
43;Tarragona;110;Pobla de Massaluca (La);462;236;226
43;Tarragona;111;Pobla de Montornès (La);943;508;435
43;Tarragona;112;Poboleda;370;188;182
43;Tarragona;113;Pont d'Armentera (El);580;280;300
43;Tarragona;141;Pontils;112;55;57
43;Tarragona;114;Porrera;435;226;209
43;Tarragona;115;Pradell de la Teixeta;261;132;129
43;Tarragona;116;Prades;534;282;252
43;Tarragona;117;Prat de Comte;219;103;116
43;Tarragona;118;Pratdip;439;214;225
43;Tarragona;119;Puigpelat;444;223;221
43;Tarragona;120;Querol;165;90;75
43;Tarragona;121;Rasquera;891;450;441
43;Tarragona;122;Renau;55;32;23
43;Tarragona;123;Reus;88215;43383;44832
43;Tarragona;124;Riba (La);893;449;444
43;Tarragona;125;Riba-roja d'Ebre;1597;822;775
43;Tarragona;126;Riera de Gaià (La);913;441;472
43;Tarragona;127;Riudecanyes;573;290;283
43;Tarragona;128;Riudecols;944;487;457
43;Tarragona;129;Riudoms;4828;2444;2384
43;Tarragona;130;Rocafort de Queralt;259;136;123
43;Tarragona;131;Roda de Barà;2203;1156;1047
43;Tarragona;132;Rodonyà;367;180;187
43;Tarragona;133;Roquetes;5535;2718;2817
43;Tarragona;134;Rourell (El);264;141;123
43;Tarragona;135;Salomó;434;220;214
43;Tarragona;905;Salou;8277;4142;4135
43;Tarragona;136;Sant Carles de la Ràpita;10781;5405;5376
43;Tarragona;137;Sant Jaume dels Domenys;1220;618;602
43;Tarragona;902;Sant Jaume d'Enveja;3466;1743;1723
43;Tarragona;138;Santa Bàrbara;3361;1664;1697
43;Tarragona;139;Santa Coloma de Queralt;2527;1237;1290
43;Tarragona;140;Santa Oliva;1526;788;738
43;Tarragona;142;Sarral;1363;687;676
43;Tarragona;143;Savallà del Comtat;55;26;29
43;Tarragona;144;Secuita (La);996;488;508
43;Tarragona;145;Selva del Camp (La);3546;1751;1795
43;Tarragona;146;Senan;25;16;9
43;Tarragona;044;Sénia (La);4930;2500;2430
43;Tarragona;147;Solivella;709;338;371
43;Tarragona;148;Tarragona;112283;55098;57185
43;Tarragona;149;Tivenys;1035;506;529
43;Tarragona;150;Tivissa;1774;886;888
43;Tarragona;151;Torre de Fontaubella (La);76;35;41
43;Tarragona;152;Torre de l'Espanyol (La);707;356;351
43;Tarragona;153;Torredembarra;6908;3390;3518
43;Tarragona;154;Torroja del Priorat;136;79;57
43;Tarragona;155;Tortosa;29616;14355;15261
43;Tarragona;156;Ulldecona;5197;2565;2632
43;Tarragona;157;Ulldemolins;521;263;258
43;Tarragona;158;Vallclara;100;49;51
43;Tarragona;159;Vallfogona de Riucorb;108;61;47
43;Tarragona;160;Vallmoll;1040;528;512
43;Tarragona;161;Valls;20074;9880;10194
43;Tarragona;162;Vandellòs i l'Hospitalet de l'Infant;4286;2150;2136
43;Tarragona;163;Vendrell (El);15715;7759;7956
43;Tarragona;164;Vespella de Gaià;86;49;37
43;Tarragona;165;Vilabella;857;417;440
43;Tarragona;175;Vilalba dels Arcs;785;408;377
43;Tarragona;166;Vilallonga del Camp;1187;590;597
43;Tarragona;168;Vilanova de Prades;164;83;81
43;Tarragona;167;Vilanova d'Escornalbou;443;218;225
43;Tarragona;169;Vilaplana;511;263;248
43;Tarragona;170;Vila-rodona;1009;525;484
43;Tarragona;171;Vila-seca;11743;5904;5839
43;Tarragona;172;Vilaverd;369;186;183
43;Tarragona;173;Vilella Alta (La);136;69;67
43;Tarragona;174;Vilella Baixa (La);159;84;75
43;Tarragona;176;Vimbodí;1090;562;528
43;Tarragona;177;Vinebre;446;209;237
43;Tarragona;178;Vinyols i els Arcs;864;473;391
43;Tarragona;052;Xerta;1252;609;643
44;Teruel;001;Ababuj;82;48;34
44;Teruel;002;Abejuela;74;45;29
44;Teruel;003;Aguatón;32;16;16
44;Teruel;004;Aguaviva;615;303;312
44;Teruel;005;Aguilar del Alfambra;99;47;52
44;Teruel;006;Alacón;516;269;247
44;Teruel;007;Alba;320;166;154
44;Teruel;008;Albalate del Arzobispo;2446;1195;1251
44;Teruel;009;Albarracín;1058;520;538
44;Teruel;010;Albentosa;286;141;145
44;Teruel;011;Alcaine;49;28;21
44;Teruel;012;Alcalá de la Selva;450;237;213
44;Teruel;013;Alcañiz;12598;6171;6427
44;Teruel;014;Alcorisa;3260;1651;1609
44;Teruel;016;Alfambra;771;385;386
44;Teruel;017;Aliaga;452;233;219
44;Teruel;021;Allepuz;146;79;67
44;Teruel;022;Alloza;905;436;469
44;Teruel;023;Allueva;14;8;6
44;Teruel;018;Almohaja;38;21;17
44;Teruel;019;Alobras;111;57;54
44;Teruel;020;Alpeñés;35;20;15
44;Teruel;024;Anadón;30;15;15
44;Teruel;025;Andorra;8608;4473;4135
44;Teruel;026;Arcos de las Salinas;189;101;88
44;Teruel;027;Arens de Lledó;268;124;144
44;Teruel;028;Argente;295;145;150
44;Teruel;029;Ariño;968;489;479
44;Teruel;031;Azaila;237;126;111
44;Teruel;032;Bádenas;28;12;16
44;Teruel;033;Báguena;612;304;308
44;Teruel;034;Bañón;222;119;103
44;Teruel;035;Barrachina;202;102;100
44;Teruel;036;Bea;25;15;10
44;Teruel;037;Beceite;699;365;334
44;Teruel;039;Bello;468;214;254
44;Teruel;038;Belmonte de San José;166;84;82
44;Teruel;040;Berge;263;138;125
44;Teruel;041;Bezas;78;41;37
44;Teruel;042;Blancas;241;118;123
44;Teruel;043;Blesa;169;99;70
44;Teruel;044;Bordón;142;78;64
44;Teruel;045;Bronchales;482;248;234
44;Teruel;046;Bueña;123;65;58
44;Teruel;047;Burbáguena;371;163;208
44;Teruel;048;Cabra de Mora;100;52;48
44;Teruel;049;Calaceite;1268;638;630
44;Teruel;050;Calamocha;4254;2122;2132
44;Teruel;051;Calanda;3555;1802;1753
44;Teruel;052;Calomarde;105;54;51
44;Teruel;053;Camañas;166;92;74
44;Teruel;054;Camarena de la Sierra;148;80;68
44;Teruel;055;Camarillas;135;73;62
44;Teruel;056;Caminreal;896;443;453
44;Teruel;059;Cantavieja;764;404;360
44;Teruel;060;Cañada de Benatanduz;82;52;30
44;Teruel;061;Cañada de Verich (La);113;62;51
44;Teruel;062;Cañada Vellida;74;46;28
44;Teruel;063;Cañizar del Olivar;155;77;78
44;Teruel;064;Cascante del Río;142;84;58
44;Teruel;065;Castejón de Tornos;118;55;63
44;Teruel;066;Castel de Cabra;229;118;111
44;Teruel;070;Castellar (El);102;54;48
44;Teruel;071;Castellote;907;438;469
44;Teruel;067;Castelnou;121;63;58
44;Teruel;068;Castelserás;931;486;445
44;Teruel;074;Cedrillas;555;288;267
44;Teruel;075;Celadas;496;259;237
44;Teruel;076;Cella;3141;1597;1544
44;Teruel;077;Cerollera (La);95;51;44
44;Teruel;080;Codoñera (La);364;187;177
44;Teruel;082;Corbalán;78;48;30
44;Teruel;084;Cortes de Aragón;140;68;72
44;Teruel;085;Cosa;131;69;62
44;Teruel;086;Cretas;702;355;347
44;Teruel;087;Crivillén;155;78;77
44;Teruel;088;Cuba (La);84;41;43
44;Teruel;089;Cubla;69;37;32
44;Teruel;090;Cucalón;105;54;51
44;Teruel;092;Cuervo (El);148;73;75
44;Teruel;093;Cuevas de Almudén;116;61;55
44;Teruel;094;Cuevas Labradas;216;112;104
44;Teruel;096;Ejulve;240;121;119
44;Teruel;097;Escorihuela;268;133;135
44;Teruel;099;Escucha;1200;647;553
44;Teruel;100;Estercuel;425;218;207
44;Teruel;101;Ferreruela de Huerva;99;50;49
44;Teruel;102;Fonfría;34;19;15
44;Teruel;103;Formiche Alto;219;116;103
44;Teruel;105;Fórnoles;127;58;69
44;Teruel;106;Fortanete;210;101;109
44;Teruel;107;Foz-Calanda;267;142;125
44;Teruel;108;Fresneda (La);475;247;228
44;Teruel;109;Frías de Albarracín;206;111;95
44;Teruel;110;Fuenferrada;54;28;26
44;Teruel;111;Fuentes Calientes;166;89;77
44;Teruel;112;Fuentes Claras;745;372;373
44;Teruel;113;Fuentes de Rubielos;82;41;41
44;Teruel;114;Fuentespalda;422;210;212
44;Teruel;115;Galve;144;77;67
44;Teruel;116;Gargallo;138;74;64
44;Teruel;117;Gea de Albarracín;506;259;247
44;Teruel;118;Ginebrosa (La);286;156;130
44;Teruel;119;Griegos;149;90;59
44;Teruel;120;Guadalaviar;298;150;148
44;Teruel;121;Gúdar;87;54;33
44;Teruel;122;Híjar;2087;1030;1057
44;Teruel;123;Hinojosa de Jarque;212;116;96
44;Teruel;124;Hoz de la Vieja (La);166;87;79
44;Teruel;125;Huesa del Común;149;76;73
44;Teruel;126;Iglesuela del Cid (La);517;271;246
44;Teruel;127;Jabaloyas;119;65;54
44;Teruel;128;Jarque de la Val;120;63;57
44;Teruel;129;Jatiel;76;35;41
44;Teruel;130;Jorcas;67;40;27
44;Teruel;131;Josa;42;22;20
44;Teruel;132;Lagueruela;88;48;40
44;Teruel;133;Lanzuela;40;25;15
44;Teruel;135;Libros;215;107;108
44;Teruel;136;Lidón;107;53;54
44;Teruel;137;Linares de Mora;351;197;154
44;Teruel;141;Lledó;229;117;112
44;Teruel;138;Loscos;215;115;100
44;Teruel;142;Maicas;20;8;12
44;Teruel;143;Manzanera;486;254;232
44;Teruel;144;Martín del Río;562;294;268
44;Teruel;145;Mas de las Matas;1497;755;742
44;Teruel;146;Mata de los Olmos (La);284;139;145
44;Teruel;147;Mazaleón;627;327;300
44;Teruel;148;Mezquita de Jarque;177;95;82
44;Teruel;149;Mirambel;153;83;70
44;Teruel;150;Miravete de la Sierra;48;27;21
44;Teruel;151;Molinos;394;199;195
44;Teruel;152;Monforte de Moyuela;112;59;53
44;Teruel;153;Monreal del Campo;2301;1151;1150
44;Teruel;154;Monroyo;405;205;200
44;Teruel;155;Montalbán;1787;895;892
44;Teruel;156;Monteagudo del Castillo;86;48;38
44;Teruel;157;Monterde de Albarracín;84;40;44
44;Teruel;158;Mora de Rubielos;1337;690;647
44;Teruel;159;Moscardón;70;38;32
44;Teruel;160;Mosqueruela;712;373;339
44;Teruel;161;Muniesa;809;407;402
44;Teruel;163;Noguera de Albarracín;171;85;86
44;Teruel;164;Nogueras;31;21;10
44;Teruel;165;Nogueruelas;249;127;122
44;Teruel;167;Obón;70;31;39
44;Teruel;168;Odón;304;148;156
44;Teruel;169;Ojos Negros;755;388;367
44;Teruel;171;Olba;241;122;119
44;Teruel;172;Oliete;561;281;280
44;Teruel;173;Olmos (Los);178;100;78
44;Teruel;174;Orihuela del Tremedal;636;316;320
44;Teruel;175;Orrios;220;112;108
44;Teruel;176;Palomar de Arroyos;318;171;147
44;Teruel;177;Pancrudo;229;124;105
44;Teruel;178;Parras de Castellote (Las);102;57;45
44;Teruel;179;Peñarroya de Tastavins;586;300;286
44;Teruel;180;Peracense;103;50;53
44;Teruel;181;Peralejos;110;56;54
44;Teruel;182;Perales del Alfambra;309;167;142
44;Teruel;183;Pitarque;132;63;69
44;Teruel;184;Plou;61;30;31
44;Teruel;185;Pobo (El);166;94;72
44;Teruel;187;Portellada (La);347;184;163
44;Teruel;189;Pozondón;97;50;47
44;Teruel;190;Pozuel del Campo;152;82;70
44;Teruel;191;Puebla de Híjar (La);1247;608;639
44;Teruel;192;Puebla de Valverde (La);497;268;229
44;Teruel;193;Puertomingalvo;159;84;75
44;Teruel;194;Ráfales;255;129;126
44;Teruel;195;Rillo;163;90;73
44;Teruel;196;Riodeva;274;133;141
44;Teruel;197;Ródenas;102;51;51
44;Teruel;198;Royuela;247;132;115
44;Teruel;199;Rubiales;57;29;28
44;Teruel;200;Rubielos de la Cérida;70;35;35
44;Teruel;201;Rubielos de Mora;629;320;309
44;Teruel;203;Salcedillo;11;5;6
44;Teruel;204;Saldón;53;34;19
44;Teruel;205;Samper de Calanda;1171;560;611
44;Teruel;206;San Agustín;172;90;82
44;Teruel;207;San Martín del Río;351;170;181
44;Teruel;208;Santa Cruz de Nogueras;32;20;12
44;Teruel;209;Santa Eulalia;1426;683;743
44;Teruel;210;Sarrión;1066;553;513
44;Teruel;211;Segura de los Baños;64;34;30
44;Teruel;212;Seno;58;29;29
44;Teruel;213;Singra;114;57;57
44;Teruel;215;Terriente;196;101;95
44;Teruel;216;Teruel;28828;13980;14848
44;Teruel;217;Toril y Masegoso;49;26;23
44;Teruel;218;Tormón;48;24;24
44;Teruel;219;Tornos;301;154;147
44;Teruel;220;Torralba de los Sisones;248;128;120
44;Teruel;223;Torre de Arcas;130;60;70
44;Teruel;224;Torre de las Arcas;48;26;22
44;Teruel;225;Torre del Compte;200;96;104
44;Teruel;227;Torre los Negros;100;51;49
44;Teruel;221;Torrecilla de Alcañiz;478;247;231
44;Teruel;222;Torrecilla del Rebollar;196;107;89
44;Teruel;226;Torrelacárcel;354;180;174
44;Teruel;228;Torremocha de Jiloca;204;96;108
44;Teruel;229;Torres de Albarracín;187;100;87
44;Teruel;230;Torrevelilla;212;104;108
44;Teruel;231;Torrijas;83;43;40
44;Teruel;232;Torrijo del Campo;677;336;341
44;Teruel;234;Tramacastiel;140;65;75
44;Teruel;235;Tramacastilla;140;68;72
44;Teruel;236;Tronchón;116;62;54
44;Teruel;237;Urrea de Gaén;696;335;361
44;Teruel;238;Utrillas;3719;1911;1808
44;Teruel;239;Valacloche;29;15;14
44;Teruel;240;Valbona;210;111;99
44;Teruel;241;Valdealgorfa;818;410;408
44;Teruel;243;Valdecuenca;48;30;18
44;Teruel;244;Valdelinares;125;69;56
44;Teruel;245;Valdeltormo;435;224;211
44;Teruel;246;Valderrobres;1907;956;951
44;Teruel;247;Valjunquera;475;241;234
44;Teruel;249;Vallecillo (El);30;14;16
44;Teruel;250;Veguillas de la Sierra;33;17;16
44;Teruel;251;Villafranca del Campo;421;218;203
44;Teruel;252;Villahermosa del Campo;87;48;39
44;Teruel;256;Villanueva del Rebollar de la Sierra;52;27;25
44;Teruel;257;Villar del Cobo;240;124;116
44;Teruel;258;Villar del Salz;143;74;69
44;Teruel;260;Villarluengo;241;122;119
44;Teruel;261;Villarquemado;1054;521;533
44;Teruel;262;Villarroya de los Pinares;211;106;105
44;Teruel;263;Villastar;371;193;178
44;Teruel;264;Villel;370;187;183
44;Teruel;265;Vinaceite;350;181;169
44;Teruel;266;Visiedo;267;133;134
44;Teruel;267;Vivel del Río Martín;135;72;63
44;Teruel;268;Zoma (La);51;27;24
45;Toledo;001;Ajofrín;2196;1129;1067
45;Toledo;002;Alameda de la Sagra;2783;1458;1325
45;Toledo;003;Albarreal de Tajo;580;293;287
45;Toledo;004;Alcabón;503;248;255
45;Toledo;005;Alcañizo;367;193;174
45;Toledo;006;Alcaudete de la Jara;1476;698;778
45;Toledo;007;Alcolea de Tajo;804;403;401
45;Toledo;008;Aldea en Cabo;194;98;96
45;Toledo;009;Aldeanueva de Barbarroya;925;462;463
45;Toledo;010;Aldeanueva de San Bartolomé;704;345;359
45;Toledo;011;Almendral de la Cañada;437;233;204
45;Toledo;012;Almonacid de Toledo;826;411;415
45;Toledo;013;Almorox;2197;1134;1063
45;Toledo;014;Añover de Tajo;4472;2281;2191
45;Toledo;015;Arcicóllar;492;242;250
45;Toledo;016;Argés;1873;935;938
45;Toledo;017;Azután;377;192;185
45;Toledo;018;Barcience;116;58;58
45;Toledo;019;Bargas;6194;3127;3067
45;Toledo;020;Belvís de la Jara;1881;928;953
45;Toledo;021;Borox;1997;975;1022
45;Toledo;022;Buenaventura;577;291;286
45;Toledo;023;Burguillos de Toledo;687;338;349
45;Toledo;024;Burujón;1241;646;595
45;Toledo;025;Cabañas de la Sagra;972;491;481
45;Toledo;026;Cabañas de Yepes;252;131;121
45;Toledo;027;Cabezamesada;570;292;278
45;Toledo;028;Calera y Chozas;3627;1851;1776
45;Toledo;029;Caleruela;355;180;175
45;Toledo;030;Calzada de Oropesa;724;357;367
45;Toledo;031;Camarena;2025;1022;1003
45;Toledo;032;Camarenilla;542;266;276
45;Toledo;033;Campillo de la Jara (El);649;340;309
45;Toledo;034;Camuñas;1795;899;896
45;Toledo;035;Cardiel de los Montes;149;77;72
45;Toledo;036;Carmena;821;414;407
45;Toledo;037;Carpio de Tajo (El);2385;1141;1244
45;Toledo;038;Carranque;1076;549;527
45;Toledo;039;Carriches;302;145;157
45;Toledo;040;Casar de Escalona (El);872;436;436
45;Toledo;041;Casarrubios del Monte;1970;983;987
45;Toledo;042;Casasbuenas;262;131;131
45;Toledo;043;Castillo de Bayuela;1060;541;519
45;Toledo;045;Cazalegas;1139;563;576
45;Toledo;046;Cebolla;2627;1301;1326
45;Toledo;047;Cedillo del Condado;995;515;480
45;Toledo;048;Cerralbos (Los);507;255;252
45;Toledo;049;Cervera de los Montes;439;231;208
45;Toledo;056;Chozas de Canales;924;464;460
45;Toledo;057;Chueca;250;129;121
45;Toledo;050;Ciruelos;334;177;157
45;Toledo;051;Cobeja;1642;837;805
45;Toledo;052;Cobisa;336;164;172
45;Toledo;053;Consuegra;9950;4892;5058
45;Toledo;054;Corral de Almaguer;5988;2968;3020
45;Toledo;055;Cuerva;1243;619;624
45;Toledo;058;Domingo Pérez;544;265;279
45;Toledo;059;Dosbarrios;2050;1039;1011
45;Toledo;060;Erustes;204;104;100
45;Toledo;061;Escalona;1828;906;922
45;Toledo;062;Escalonilla;1475;723;752
45;Toledo;063;Espinoso del Rey;652;339;313
45;Toledo;064;Esquivias;3483;1745;1738
45;Toledo;065;Estrella (La);499;273;226
45;Toledo;066;Fuensalida;6942;3495;3447
45;Toledo;067;Gálvez;3185;1616;1569
45;Toledo;068;Garciotum;154;76;78
45;Toledo;069;Gerindote;1714;866;848
45;Toledo;070;Guadamur;1565;805;760
45;Toledo;071;Guardia (La);2472;1229;1243
45;Toledo;072;Herencias (Las);733;375;358
45;Toledo;073;Herreruela de Oropesa;440;228;212
45;Toledo;074;Hinojosa de San Vicente;512;284;228
45;Toledo;075;Hontanar;115;63;52
45;Toledo;076;Hormigos;399;212;187
45;Toledo;077;Huecas;377;193;184
45;Toledo;078;Huerta de Valdecarábanos;1713;835;878
45;Toledo;079;Iglesuela (La);483;242;241
45;Toledo;080;Illán de Vacas;10;6;4
45;Toledo;081;Illescas;7991;4007;3984
45;Toledo;082;Lagartera;1961;957;1004
45;Toledo;083;Layos;267;137;130
45;Toledo;084;Lillo;2887;1438;1449
45;Toledo;085;Lominchar;992;521;471
45;Toledo;086;Lucillos;497;243;254
45;Toledo;087;Madridejos;10432;5127;5305
45;Toledo;088;Magán;811;403;408
45;Toledo;089;Malpica de Tajo;1793;913;880
45;Toledo;090;Manzaneque;476;239;237
45;Toledo;091;Maqueda;555;267;288
45;Toledo;092;Marjaliza;334;171;163
45;Toledo;093;Marrupe;155;74;81
45;Toledo;094;Mascaraque;543;256;287
45;Toledo;095;Mata (La);1004;497;507
45;Toledo;096;Mazarambroz;1216;592;624
45;Toledo;097;Mejorada;1120;578;542
45;Toledo;098;Menasalbas;2972;1539;1433
45;Toledo;099;Méntrida;1492;767;725
45;Toledo;100;Mesegar de Tajo;238;118;120
45;Toledo;101;Miguel Esteban;4697;2330;2367
45;Toledo;102;Mocejón;4015;2024;1991
45;Toledo;103;Mohedas de la Jara;733;366;367
45;Toledo;104;Montearagón;480;247;233
45;Toledo;105;Montesclaros;487;233;254
45;Toledo;106;Mora;9243;4502;4741
45;Toledo;107;Nambroca;1858;908;950
45;Toledo;108;Nava de Ricomalillo (La);792;411;381
45;Toledo;109;Navahermosa;3787;1945;1842
45;Toledo;110;Navalcán;2566;1340;1226
45;Toledo;111;Navalmoralejo;95;46;49
45;Toledo;112;Navalmorales (Los);2731;1355;1376
45;Toledo;113;Navalucillos (Los);3029;1530;1499
45;Toledo;114;Navamorcuende;767;394;373
45;Toledo;115;Noblejas;2919;1461;1458
45;Toledo;116;Noez;988;506;482
45;Toledo;117;Nombela;895;453;442
45;Toledo;118;Novés;1554;787;767
45;Toledo;119;Numancia de la Sagra;1091;561;530
45;Toledo;120;Nuño Gómez;182;89;93
45;Toledo;121;Ocaña;5855;2886;2969
45;Toledo;122;Olías del Rey;3421;1725;1696
45;Toledo;123;Ontígola;812;422;390
45;Toledo;124;Orgaz;2632;1315;1317
45;Toledo;125;Oropesa;2942;1475;1467
45;Toledo;126;Otero;236;112;124
45;Toledo;127;Palomeque;416;211;205
45;Toledo;128;Pantoja;2033;1049;984
45;Toledo;129;Paredes de Escalona;104;49;55
45;Toledo;130;Parrillas;508;250;258
45;Toledo;131;Pelahustán;404;210;194
45;Toledo;132;Pepino;635;330;305
45;Toledo;133;Polán;3116;1574;1542
45;Toledo;134;Portillo de Toledo;1962;988;974
45;Toledo;135;Puebla de Almoradiel (La);5429;2691;2738
45;Toledo;136;Puebla de Montalbán (La);6237;3110;3127
45;Toledo;137;Pueblanueva (La);1990;998;992
45;Toledo;138;Puente del Arzobispo (El);1583;761;822
45;Toledo;139;Puerto de San Vicente;295;139;156
45;Toledo;140;Pulgar;1168;601;567
45;Toledo;141;Quero;1449;726;723
45;Toledo;142;Quintanar de la Orden;9123;4569;4554
45;Toledo;143;Quismondo;1236;608;628
45;Toledo;144;Real de San Vicente (El);1010;511;499
45;Toledo;145;Recas;2273;1168;1105
45;Toledo;146;Retamoso;194;106;88
45;Toledo;147;Rielves;432;219;213
45;Toledo;148;Robledo del Mazo;570;294;276
45;Toledo;149;Romeral (El);1001;487;514
45;Toledo;150;San Bartolomé de las Abiertas;476;245;231
45;Toledo;151;San Martín de Montalbán;774;388;386
45;Toledo;152;San Martín de Pusa;827;437;390
45;Toledo;153;San Pablo de los Montes;2026;1026;1000
45;Toledo;154;San Román de los Montes;457;236;221
45;Toledo;155;Santa Ana de Pusa;411;210;201
45;Toledo;156;Santa Cruz de la Zarza;4334;2171;2163
45;Toledo;157;Santa Cruz del Retamar;1461;733;728
45;Toledo;158;Santa Olalla;2291;1177;1114
45;Toledo;901;Santo Domingo-Caudilla;800;387;413
45;Toledo;159;Sartajada;125;76;49
45;Toledo;160;Segurilla;939;470;469
45;Toledo;161;Seseña;2820;1441;1379
45;Toledo;162;Sevilleja de la Jara;1180;614;566
45;Toledo;163;Sonseca;8697;4351;4346
45;Toledo;164;Sotillo de las Palomas;193;105;88
45;Toledo;165;Talavera de la Reina;69933;34552;35381
45;Toledo;166;Tembleque;2187;1093;1094
45;Toledo;167;Toboso (El);2187;1067;1120
45;Toledo;168;Toledo;60798;29442;31356
45;Toledo;169;Torralba de Oropesa;333;160;173
45;Toledo;171;Torre de Esteban Hambrán (La);1291;661;630
45;Toledo;170;Torrecilla de la Jara;345;184;161
45;Toledo;172;Torrico;1001;500;501
45;Toledo;173;Torrijos;9485;4671;4814
45;Toledo;174;Totanés;373;185;188
45;Toledo;175;Turleque;1094;549;545
45;Toledo;176;Ugena;487;257;230
45;Toledo;177;Urda;3116;1553;1563
45;Toledo;179;Valdeverdeja;937;431;506
45;Toledo;180;Valmojado;2210;1129;1081
45;Toledo;181;Velada;2300;1177;1123
45;Toledo;182;Ventas con Peña Aguilera (Las);1454;741;713
45;Toledo;183;Ventas de Retamosa (Las);516;269;247
45;Toledo;184;Ventas de San Julián (Las);230;106;124
45;Toledo;186;Villa de Don Fadrique (La);4214;2055;2159
45;Toledo;185;Villacañas;8814;4395;4419
45;Toledo;187;Villafranca de los Caballeros;5406;2668;2738
45;Toledo;188;Villaluenga de la Sagra;2486;1248;1238
45;Toledo;189;Villamiel de Toledo;271;131;140
45;Toledo;190;Villaminaya;684;341;343
45;Toledo;191;Villamuelas;777;393;384
45;Toledo;192;Villanueva de Alcardete;3222;1611;1611
45;Toledo;193;Villanueva de Bogas;845;418;427
45;Toledo;194;Villarejo de Montalbán;106;50;56
45;Toledo;195;Villarrubia de Santiago;2947;1470;1477
45;Toledo;196;Villaseca de la Sagra;1593;797;796
45;Toledo;197;Villasequilla;2378;1233;1145
45;Toledo;198;Villatobas;2447;1218;1229
45;Toledo;199;Viso de San Juan (El);584;300;284
45;Toledo;200;Yébenes (Los);6632;3330;3302
45;Toledo;201;Yeles;1052;536;516
45;Toledo;202;Yepes;4390;2219;2171
45;Toledo;203;Yuncler;1825;949;876
45;Toledo;204;Yunclillos;572;287;285
45;Toledo;205;Yuncos;2828;1458;1370
46;Valencia/València;001;Ademuz;1298;650;648
46;Valencia/València;002;Ador;1088;543;545
46;Valencia/València;004;Agullent;2137;1026;1111
46;Valencia/València;042;Aielo de Malferit;3833;1900;1933
46;Valencia/València;043;Aielo de Rugat;200;103;97
46;Valencia/València;005;Alaquàs;24246;12047;12199
46;Valencia/València;006;Albaida;5900;2891;3009
46;Valencia/València;007;Albal;9327;4659;4668
46;Valencia/València;008;Albalat de la Ribera;3491;1691;1800
46;Valencia/València;009;Albalat dels Sorells;3560;1728;1832
46;Valencia/València;010;Albalat dels Tarongers;570;284;286
46;Valencia/València;011;Alberic;9140;4471;4669
46;Valencia/València;012;Alborache;886;451;435
46;Valencia/València;013;Alboraya;11871;5830;6041
46;Valencia/València;014;Albuixech;2989;1467;1522
46;Valencia/València;016;Alcàntera de Xúquer;1459;729;730
46;Valencia/València;015;Alcàsser;7347;3691;3656
46;Valencia/València;018;Alcublas;859;434;425
46;Valencia/València;020;Alcúdia de Crespins (L');4098;2014;2084
46;Valencia/València;019;Alcúdia (L');10584;5201;5383
46;Valencia/València;021;Aldaia;22591;11238;11353
46;Valencia/València;022;Alfafar;20418;10140;10278
46;Valencia/València;024;Alfara de Algimia;534;260;274
46;Valencia/València;025;Alfara del Patriarca;2835;1400;1435
46;Valencia/València;026;Alfarp;1346;654;692
46;Valencia/València;027;Alfarrasí;1251;609;642
46;Valencia/València;023;Alfauir;287;146;141
46;Valencia/València;028;Algar de Palancia;396;187;209
46;Valencia/València;029;Algemesí;25525;12538;12987
46;Valencia/València;030;Algimia de Alfara;870;429;441
46;Valencia/València;031;Alginet;11685;5797;5888
46;Valencia/València;032;Almàssera;5458;2621;2837
46;Valencia/València;033;Almiserà;199;104;95
46;Valencia/València;034;Almoines;1863;936;927
46;Valencia/València;035;Almussafes;6471;3221;3250
46;Valencia/València;036;Alpuente;1174;608;566
46;Valencia/València;037;Alquería de la Condesa/Alqueria de la Comtessa (l');1541;734;807
46;Valencia/València;017;Alzira;40414;19656;20758
46;Valencia/València;038;Andilla;192;102;90
46;Valencia/València;039;Anna;2679;1329;1350
46;Valencia/València;040;Antella;1621;809;812
46;Valencia/València;041;Aras de los Olmos;428;236;192
46;Valencia/València;003;Atzeneta d'Albaida;1258;642;616
46;Valencia/València;044;Ayora;5572;2887;2685
46;Valencia/València;046;Barx;994;493;501
46;Valencia/València;045;Barxeta;1605;814;791
46;Valencia/València;047;Bèlgida;678;328;350
46;Valencia/València;048;Bellreguard;3719;1824;1895
46;Valencia/València;049;Bellús;413;202;211
46;Valencia/València;050;Benagéber;124;65;59
46;Valencia/València;051;Benaguasil;8854;4432;4422
46;Valencia/València;052;Benavites;665;322;343
46;Valencia/València;053;Beneixida;499;243;256
46;Valencia/València;054;Benetússer;13986;6908;7078
46;Valencia/València;055;Beniarjó;1120;522;598
46;Valencia/València;056;Beniatjar;258;128;130
46;Valencia/València;057;Benicolet;494;256;238
46;Valencia/València;060;Benifaió;11986;5917;6069
46;Valencia/València;059;Benifairó de la Valldigna;1652;812;840
46;Valencia/València;058;Benifairó de les Valls;1978;978;1000
46;Valencia/València;061;Beniflá;155;72;83
46;Valencia/València;062;Benigánim;5346;2753;2593
46;Valencia/València;063;Benimodo;1711;889;822
46;Valencia/València;064;Benimuslem;569;274;295
46;Valencia/València;065;Beniparrell;1365;684;681
46;Valencia/València;066;Benirredrà;887;419;468
46;Valencia/València;067;Benisanó;1683;856;827
46;Valencia/València;068;Benissoda;310;171;139
46;Valencia/València;069;Benisuera;206;94;112
46;Valencia/València;070;Bétera;9923;4909;5014
46;Valencia/València;071;Bicorp;702;353;349
46;Valencia/València;072;Bocairent;4672;2284;2388
46;Valencia/València;073;Bolbaite;1402;714;688
46;Valencia/València;074;Bonrepòs i Mirambell;2378;1165;1213
46;Valencia/València;075;Bufali;216;111;105
46;Valencia/València;076;Bugarra;870;442;428
46;Valencia/València;077;Buñol;9110;4523;4587
46;Valencia/València;078;Burjassot;34041;16764;17277
46;Valencia/València;079;Calles;404;221;183
46;Valencia/València;080;Camporrobles;1458;721;737
46;Valencia/València;081;Canals;12304;6052;6252
46;Valencia/València;082;Canet d'En Berenguer;1578;776;802
46;Valencia/València;083;Carcaixent;20307;9882;10425
46;Valencia/València;084;Càrcer;2005;961;1044
46;Valencia/València;085;Carlet;14239;6985;7254
46;Valencia/València;086;Carrícola;73;32;41
46;Valencia/València;087;Casas Altas;164;83;81
46;Valencia/València;088;Casas Bajas;329;168;161
46;Valencia/València;089;Casinos;2280;1171;1109
46;Valencia/València;090;Castelló de Rugat;2080;1073;1007
46;Valencia/València;091;Castellonet de la Conquesta;101;51;50
46;Valencia/València;092;Castielfabib;645;340;305
46;Valencia/València;093;Catadau;2201;1081;1120
46;Valencia/València;094;Catarroja;20639;10107;10532
46;Valencia/València;095;Caudete de las Fuentes;902;460;442
46;Valencia/València;096;Cerdà;256;129;127
46;Valencia/València;107;Chella;2531;1253;1278
46;Valencia/València;106;Chelva;2072;1049;1023
46;Valencia/València;108;Chera;618;319;299
46;Valencia/València;109;Cheste;6688;3368;3320
46;Valencia/València;111;Chiva;7592;3761;3831
46;Valencia/València;112;Chulilla;685;336;349
46;Valencia/València;097;Cofrentes;893;458;435
46;Valencia/València;098;Corbera;3141;1519;1622
46;Valencia/València;099;Cortes de Pallás;713;381;332
46;Valencia/València;100;Cotes;389;178;211
46;Valencia/València;105;Cullera;20336;10054;10282
46;Valencia/València;113;Daimús;1277;643;634
46;Valencia/València;114;Domeño;494;262;232
46;Valencia/València;115;Dos Aguas;406;225;181
46;Valencia/València;116;Eliana (L');8626;4303;4323
46;Valencia/València;117;Emperador;159;76;83
46;Valencia/València;118;Enguera;5030;2464;2566
46;Valencia/València;119;Ènova (L');1176;585;591
46;Valencia/València;120;Estivella;1092;505;587
46;Valencia/València;121;Estubeny;137;64;73
46;Valencia/València;122;Faura;2821;1393;1428
46;Valencia/València;123;Favara;1723;833;890
46;Valencia/València;126;Foios;5373;2600;2773
46;Valencia/València;128;Font de la Figuera (La);2207;1095;1112
46;Valencia/València;127;Font d'En Carròs (La);3267;1624;1643
46;Valencia/València;124;Fontanars dels Alforins;952;495;457
46;Valencia/València;125;Fortaleny;1006;513;493
46;Valencia/València;129;Fuenterrobles;739;380;359
46;Valencia/València;131;Gandia;55412;27064;28348
46;Valencia/València;130;Gavarda;1276;618;658
46;Valencia/València;132;Genovés;2198;1094;1104
46;Valencia/València;133;Gestalgar;612;286;326
46;Valencia/València;134;Gilet;1215;604;611
46;Valencia/València;135;Godella;9833;4822;5011
46;Valencia/València;136;Godelleta;1972;970;1002
46;Valencia/València;137;Granja de la Costera (La);363;175;188
46;Valencia/València;138;Guadasequies;405;199;206
46;Valencia/València;139;Guadassuar;5375;2684;2691
46;Valencia/València;140;Guardamar de la Safor;54;33;21
46;Valencia/València;141;Higueruelas;593;319;274
46;Valencia/València;142;Jalance;1196;620;576
46;Valencia/València;144;Jarafuel;1030;531;499
46;Valencia/València;154;Llanera de Ranes;963;480;483
46;Valencia/València;155;Llaurí;1360;661;699
46;Valencia/València;147;Llíria;13720;6750;6970
46;Valencia/València;153;Llocnou de Sant Jeroni;569;278;291
46;Valencia/València;151;Llocnou d'En Fenollet;671;324;347
46;Valencia/València;156;Llombai;2190;1079;1111
46;Valencia/València;157;Llosa de Ranes (La);3589;1836;1753
46;Valencia/València;150;Llutxent;2358;1197;1161
46;Valencia/València;148;Loriguilla;1042;528;514
46;Valencia/València;149;Losa del Obispo;490;239;251
46;Valencia/València;152;Lugar Nuevo de la Corona;123;58;65
46;Valencia/València;158;Macastre;857;411;446
46;Valencia/València;159;Manises;25080;12252;12828
46;Valencia/València;160;Manuel;2436;1174;1262
46;Valencia/València;161;Marines;1199;611;588
46;Valencia/València;162;Masalavés;1490;774;716
46;Valencia/València;163;Massalfassar;1415;708;707
46;Valencia/València;164;Massamagrell;12260;6058;6202
46;Valencia/València;165;Massanassa;7714;3786;3928
46;Valencia/València;166;Meliana;9196;4485;4711
46;Valencia/València;167;Millares;747;381;366
46;Valencia/València;168;Miramar;977;475;502
46;Valencia/València;169;Mislata;38962;19068;19894
46;Valencia/València;170;Mogente/Moixent;4179;2146;2033
46;Valencia/València;171;Moncada;17955;8924;9031
46;Valencia/València;172;Monserrat;2578;1333;1245
46;Valencia/València;173;Montaverner;1670;845;825
46;Valencia/València;174;Montesa;1270;635;635
46;Valencia/València;175;Montichelvo;622;307;315
46;Valencia/València;176;Montroy;1491;766;725
46;Valencia/València;177;Museros;4124;2050;2074
46;Valencia/València;178;Náquera;1511;737;774
46;Valencia/València;179;Navarrés;2827;1409;1418
46;Valencia/València;180;Novelé/Novetlè;563;281;282
46;Valencia/València;181;Oliva;20460;10047;10413
46;Valencia/València;183;Olleria (L');6845;3487;3358
46;Valencia/València;182;Olocau;662;350;312
46;Valencia/València;184;Ontinyent;30083;14788;15295
46;Valencia/València;185;Otos;556;274;282
46;Valencia/València;186;Paiporta;16348;8098;8250
46;Valencia/València;187;Palma de Gandía;1506;748;758
46;Valencia/València;188;Palmera;468;228;240
46;Valencia/València;189;Palomar (El);504;241;263
46;Valencia/València;190;Paterna;41881;20668;21213
46;Valencia/València;191;Pedralba;2005;1012;993
46;Valencia/València;192;Petrés;712;339;373
46;Valencia/València;193;Picanya;7885;3935;3950
46;Valencia/València;194;Picassent;14739;7418;7321
46;Valencia/València;195;Piles;2131;1031;1100
46;Valencia/València;196;Pinet;249;137;112
46;Valencia/València;199;Pobla de Farnals (La);4663;2315;2348
46;Valencia/València;202;Pobla de Vallbona (La);8122;4164;3958
46;Valencia/València;200;Pobla del Duc (La);2627;1291;1336
46;Valencia/València;203;Pobla Llarga (La);4376;2121;2255
46;Valencia/València;197;Polinyà de Xúquer;3089;1527;1562
46;Valencia/València;198;Potríes;977;476;501
46;Valencia/València;205;Puçol;12641;6237;6404
46;Valencia/València;201;Puebla de San Miguel;39;22;17
46;Valencia/València;204;Puig;6520;3225;3295
46;Valencia/València;101;Quart de les Valls;1083;508;575
46;Valencia/València;102;Quart de Poblet;26784;13228;13556
46;Valencia/València;103;Quartell;1356;663;693
46;Valencia/València;104;Quatretonda;2585;1320;1265
46;Valencia/València;206;Quesa;818;413;405
46;Valencia/València;207;Rafelbuñol/Rafelbunyol;4967;2470;2497
46;Valencia/València;208;Rafelcofer;1468;683;785
46;Valencia/València;209;Rafelguaraf;2440;1195;1245
46;Valencia/València;210;Ráfol de Salem;374;168;206
46;Valencia/València;211;Real de Gandía;1902;892;1010
46;Valencia/València;212;Real de Montroi;1830;928;902
46;Valencia/València;213;Requena;17696;8855;8841
46;Valencia/València;214;Riba-roja de Túria;9930;4954;4976
46;Valencia/València;215;Riola;1631;826;805
46;Valencia/València;216;Rocafort;4242;2082;2160
46;Valencia/València;217;Rotglá y Corberá;1007;507;500
46;Valencia/València;218;Rótova;1276;645;631
46;Valencia/València;219;Rugat;195;94;101
46;Valencia/València;220;Sagunto/Sagunt;55720;27256;28464
46;Valencia/València;221;Salem;467;236;231
46;Valencia/València;222;San Juan de Énova;360;157;203
46;Valencia/València;223;Sedaví;8141;3991;4150
46;Valencia/València;224;Segart;155;71;84
46;Valencia/València;225;Sellent;483;248;235
46;Valencia/València;226;Sempere;45;21;24
46;Valencia/València;227;Senyera;834;396;438
46;Valencia/València;228;Serra;1467;720;747
46;Valencia/València;229;Siete Aguas;1067;522;545
46;Valencia/València;230;Silla;16533;8343;8190
46;Valencia/València;231;Simat de la Valldigna;3141;1589;1552
46;Valencia/València;232;Sinarcas;1332;694;638
46;Valencia/València;233;Sollana;4184;2047;2137
46;Valencia/València;234;Sot de Chera;292;146;146
46;Valencia/València;235;Sueca;23044;11264;11780
46;Valencia/València;236;Sumacàrcer;1365;695;670
46;Valencia/València;237;Tavernes Blanques;8143;4007;4136
46;Valencia/València;238;Tavernes de la Valldigna;16293;8123;8170
46;Valencia/València;239;Teresa de Cofrentes;757;386;371
46;Valencia/València;240;Terrateig;191;97;94
46;Valencia/València;241;Titaguas;613;321;292
46;Valencia/València;242;Torrebaja;483;247;236
46;Valencia/València;243;Torrella;191;95;96
46;Valencia/València;244;Torrent;57292;28351;28941
46;Valencia/València;245;Torres Torres;376;179;197
46;Valencia/València;246;Tous;1259;625;634
46;Valencia/València;247;Tuéjar;1400;738;662
46;Valencia/València;248;Turís;4204;2145;2059
46;Valencia/València;249;Utiel;11813;5861;5952
46;Valencia/València;250;Valencia;755604;360302;395302
46;Valencia/València;251;Vallada;2958;1500;1458
46;Valencia/València;252;Vallanca;248;120;128
46;Valencia/València;253;Vallés;100;53;47
46;Valencia/València;254;Venta del Moro;1728;891;837
46;Valencia/València;256;Vilamarxant;4774;2412;2362
46;Valencia/València;255;Villalonga;3564;1784;1780
46;Valencia/València;257;Villanueva de Castellón;6978;3433;3545
46;Valencia/València;258;Villar del Arzobispo;3425;1708;1717
46;Valencia/València;259;Villargordo del Cabriel;803;412;391
46;Valencia/València;260;Vinalesa;2260;1069;1191
46;Valencia/València;145;Xàtiva;24629;11968;12661
46;Valencia/València;143;Xeraco;4605;2310;2295
46;Valencia/València;146;Xeresa;1985;1001;984
46;Valencia/València;110;Xirivella;26323;13061;13262
46;Valencia/València;261;Yátova;1983;1028;955
46;Valencia/València;262;Yesa (La);294;147;147
46;Valencia/València;263;Zarra;462;240;222
47;Valladolid;001;Adalia;88;48;40
47;Valladolid;002;Aguasal;30;16;14
47;Valladolid;003;Aguilar de Campos;426;225;201
47;Valladolid;004;Alaejos;1807;929;878
47;Valladolid;005;Alcazarén;782;415;367
47;Valladolid;006;Aldea de San Miguel;239;121;118
47;Valladolid;007;Aldeamayor de San Martín;1097;548;549
47;Valladolid;008;Almenara de Adaja;36;20;16
47;Valladolid;009;Amusquillo;199;107;92
47;Valladolid;010;Arroyo de la Encomienda;1454;745;709
47;Valladolid;011;Ataquines;956;498;458
47;Valladolid;012;Bahabón;258;128;130
47;Valladolid;013;Barcial de la Loma;181;91;90
47;Valladolid;014;Barruelo del Valle;84;42;42
47;Valladolid;015;Becilla de Valderaduey;498;251;247
47;Valladolid;016;Benafarces;105;51;54
47;Valladolid;017;Bercero;292;152;140
47;Valladolid;018;Berceruelo;37;20;17
47;Valladolid;019;Berrueces;126;71;55
47;Valladolid;020;Bobadilla del Campo;448;232;216
47;Valladolid;021;Bocigas;174;85;89
47;Valladolid;022;Bocos de Duero;100;44;56
47;Valladolid;023;Boecillo;948;483;465
47;Valladolid;024;Bolaños de Campos;405;206;199
47;Valladolid;025;Brahojos de Medina;203;116;87
47;Valladolid;026;Bustillo de Chaves;117;54;63
47;Valladolid;027;Cabezón de Pisuerga;1532;769;763
47;Valladolid;028;Cabezón de Valderaduey;55;28;27
47;Valladolid;029;Cabreros del Monte;115;59;56
47;Valladolid;030;Campaspero;1706;882;824
47;Valladolid;031;Campillo (El);243;132;111
47;Valladolid;032;Camporredondo;249;136;113
47;Valladolid;033;Canalejas de Peñafiel;352;183;169
47;Valladolid;034;Canillas de Esgueva;154;81;73
47;Valladolid;035;Carpio;1309;693;616
47;Valladolid;036;Casasola de Arión;416;223;193
47;Valladolid;037;Castrejón de Trabancos;284;157;127
47;Valladolid;038;Castrillo de Duero;258;134;124
47;Valladolid;039;Castrillo-Tejeriego;322;167;155
47;Valladolid;040;Castrobol;99;45;54
47;Valladolid;041;Castrodeza;282;147;135
47;Valladolid;042;Castromembibre;98;49;49
47;Valladolid;043;Castromonte;538;287;251
47;Valladolid;044;Castronuevo de Esgueva;302;159;143
47;Valladolid;045;Castronuño;1214;643;571
47;Valladolid;046;Castroponce;209;102;107
47;Valladolid;047;Castroverde de Cerrato;311;166;145
47;Valladolid;048;Ceinos de Campos;278;151;127
47;Valladolid;049;Cervillego de la Cruz;181;93;88
47;Valladolid;050;Cigales;1708;814;894
47;Valladolid;051;Ciguñuela;382;200;182
47;Valladolid;052;Cistérniga;1774;905;869
47;Valladolid;053;Cogeces de Íscar;157;83;74
47;Valladolid;054;Cogeces del Monte;1039;552;487
47;Valladolid;055;Corcos;262;135;127
47;Valladolid;056;Corrales de Duero;172;94;78
47;Valladolid;057;Cubillas de Santa Marta;266;143;123
47;Valladolid;058;Cuenca de Campos;324;161;163
47;Valladolid;059;Curiel de Duero;170;90;80
47;Valladolid;060;Encinas de Esgueva;443;235;208
47;Valladolid;061;Esguevillas de Esgueva;457;239;218
47;Valladolid;062;Fombellida;326;172;154
47;Valladolid;063;Fompedraza;156;88;68
47;Valladolid;064;Fontihoyuelo;52;30;22
47;Valladolid;065;Fresno el Viejo;1361;686;675
47;Valladolid;066;Fuensaldaña;728;373;355
47;Valladolid;067;Fuente el Sol;343;176;167
47;Valladolid;068;Fuente-Olmedo;69;32;37
47;Valladolid;069;Gallegos de Hornija;159;82;77
47;Valladolid;070;Gatón de Campos;68;36;32
47;Valladolid;071;Geria;425;234;191
47;Valladolid;073;Herrín de Campos;241;115;126
47;Valladolid;074;Hornillos de Eresma;150;75;75
47;Valladolid;075;Íscar;5948;3002;2946
47;Valladolid;076;Laguna de Duero;12004;6070;5934
47;Valladolid;077;Langayo;530;280;250
47;Valladolid;079;Llano de Olmedo;114;54;60
47;Valladolid;078;Lomoviejo;295;148;147
47;Valladolid;080;Manzanillo;57;30;27
47;Valladolid;081;Marzales;90;44;46
47;Valladolid;082;Matapozuelos;955;482;473
47;Valladolid;083;Matilla de los Caños;96;52;44
47;Valladolid;084;Mayorga;1668;797;871
47;Valladolid;086;Medina de Rioseco;5021;2467;2554
47;Valladolid;085;Medina del Campo;19826;9745;10081
47;Valladolid;087;Megeces;486;244;242
47;Valladolid;088;Melgar de Abajo;214;105;109
47;Valladolid;089;Melgar de Arriba;333;164;169
47;Valladolid;090;Mojados;2232;1116;1116
47;Valladolid;091;Monasterio de Vega;110;52;58
47;Valladolid;092;Montealegre de Campos;177;98;79
47;Valladolid;093;Montemayor de Pililla;1106;582;524
47;Valladolid;094;Moral de la Reina;258;134;124
47;Valladolid;095;Moraleja de las Panaderas;28;15;13
47;Valladolid;096;Morales de Campos;222;119;103
47;Valladolid;097;Mota del Marqués;502;240;262
47;Valladolid;098;Mucientes;660;339;321
47;Valladolid;099;Mudarra (La);297;161;136
47;Valladolid;100;Muriel;277;136;141
47;Valladolid;101;Nava del Rey;2347;1142;1205
47;Valladolid;102;Nueva Villa de las Torres;436;232;204
47;Valladolid;103;Olivares de Duero;330;176;154
47;Valladolid;104;Olmedo;3595;1756;1839
47;Valladolid;105;Olmos de Esgueva;186;100;86
47;Valladolid;106;Olmos de Peñafiel;100;54;46
47;Valladolid;109;Palazuelo de Vedija;250;131;119
47;Valladolid;110;Parrilla (La);657;318;339
47;Valladolid;111;Pedraja de Portillo (La);1052;518;534
47;Valladolid;112;Pedrajas de San Esteban;3138;1600;1538
47;Valladolid;113;Pedrosa del Rey;273;142;131
47;Valladolid;114;Peñafiel;5063;2574;2489
47;Valladolid;115;Peñaflor de Hornija;489;259;230
47;Valladolid;116;Pesquera de Duero;574;299;275
47;Valladolid;117;Piña de Esgueva;425;224;201
47;Valladolid;118;Piñel de Abajo;269;146;123
47;Valladolid;119;Piñel de Arriba;178;92;86
47;Valladolid;121;Pollos;896;459;437
47;Valladolid;122;Portillo;2563;1308;1255
47;Valladolid;123;Pozal de Gallinas;500;259;241
47;Valladolid;124;Pozaldez;600;289;311
47;Valladolid;125;Pozuelo de la Orden;102;54;48
47;Valladolid;126;Puras;72;37;35
47;Valladolid;127;Quintanilla de Arriba;253;136;117
47;Valladolid;129;Quintanilla de Onésimo;1122;603;519
47;Valladolid;130;Quintanilla de Trigueros;97;48;49
47;Valladolid;128;Quintanilla del Molar;89;37;52
47;Valladolid;131;Rábano;262;136;126
47;Valladolid;132;Ramiro;99;48;51
47;Valladolid;133;Renedo de Esgueva;828;438;390
47;Valladolid;134;Roales de Campos;307;165;142
47;Valladolid;135;Robladillo;105;54;51
47;Valladolid;137;Roturas;22;12;10
47;Valladolid;138;Rubí de Bracamonte;369;196;173
47;Valladolid;139;Rueda;1618;837;781
47;Valladolid;140;Saelices de Mayorga;222;119;103
47;Valladolid;141;Salvador de Zapardiel;222;115;107
47;Valladolid;142;San Cebrián de Mazote;256;136;120
47;Valladolid;143;San Llorente;238;122;116
47;Valladolid;144;San Martín de Valvení;121;67;54
47;Valladolid;145;San Miguel del Arroyo;869;447;422
47;Valladolid;146;San Miguel del Pino;222;121;101
47;Valladolid;147;San Pablo de la Moraleja;196;103;93
47;Valladolid;148;San Pedro de Latarce;725;396;329
47;Valladolid;149;San Pelayo;50;23;27
47;Valladolid;150;San Román de Hornija;530;263;267
47;Valladolid;151;San Salvador;52;27;25
47;Valladolid;156;San Vicente del Palacio;297;153;144
47;Valladolid;152;Santa Eufemia del Arroyo;147;75;72
47;Valladolid;153;Santervás de Campos;203;108;95
47;Valladolid;154;Santibáñez de Valcorba;229;117;112
47;Valladolid;155;Santovenia de Pisuerga;1108;569;539
47;Valladolid;157;Sardón de Duero;673;342;331
47;Valladolid;158;Seca (La);1083;574;509
47;Valladolid;159;Serrada;1035;532;503
47;Valladolid;160;Siete Iglesias de Trabancos;722;365;357
47;Valladolid;161;Simancas;2093;1067;1026
47;Valladolid;162;Tamariz de Campos;118;62;56
47;Valladolid;163;Tiedra;453;225;228
47;Valladolid;164;Tordehumos;600;308;292
47;Valladolid;165;Tordesillas;7616;3826;3790
47;Valladolid;169;Torre de Esgueva;129;61;68
47;Valladolid;170;Torre de Peñafiel;54;28;26
47;Valladolid;166;Torrecilla de la Abadesa;406;217;189
47;Valladolid;167;Torrecilla de la Orden;418;203;215
47;Valladolid;168;Torrecilla de la Torre;47;27;20
47;Valladolid;171;Torrelobatón;658;330;328
47;Valladolid;172;Torrescárcela;195;96;99
47;Valladolid;173;Traspinedo;782;399;383
47;Valladolid;174;Trigueros del Valle;273;140;133
47;Valladolid;175;Tudela de Duero;4979;2544;2435
47;Valladolid;176;Unión de Campos (La);374;177;197
47;Valladolid;177;Urones de Castroponce;203;115;88
47;Valladolid;178;Urueña;228;113;115
47;Valladolid;179;Valbuena de Duero;543;280;263
47;Valladolid;180;Valdearcos de la Vega;170;85;85
47;Valladolid;181;Valdenebro de los Valles;271;142;129
47;Valladolid;182;Valdestillas;1430;733;697
47;Valladolid;183;Valdunquillo;295;144;151
47;Valladolid;186;Valladolid;330428;160027;170401
47;Valladolid;184;Valoria la Buena;691;362;329
47;Valladolid;185;Valverde de Campos;122;64;58
47;Valladolid;187;Vega de Ruiponce;195;91;104
47;Valladolid;188;Vega de Valdetronco;210;114;96
47;Valladolid;189;Velascálvaro;203;107;96
47;Valladolid;190;Velilla;149;81;68
47;Valladolid;191;Velliza;163;91;72
47;Valladolid;192;Ventosa de la Cuesta;169;85;84
47;Valladolid;193;Viana de Cega;1075;548;527
47;Valladolid;195;Villabáñez;462;242;220
47;Valladolid;196;Villabaruz de Campos;57;25;32
47;Valladolid;197;Villabrágima;1310;680;630
47;Valladolid;198;Villacarralón;140;72;68
47;Valladolid;199;Villacid de Campos;141;79;62
47;Valladolid;200;Villaco;169;97;72
47;Valladolid;203;Villafrades de Campos;162;76;86
47;Valladolid;204;Villafranca de Duero;431;218;213
47;Valladolid;205;Villafrechós;567;286;281
47;Valladolid;206;Villafuerte;178;80;98
47;Valladolid;207;Villagarcía de Campos;472;254;218
47;Valladolid;208;Villagómez la Nueva;116;52;64
47;Valladolid;209;Villalán de Campos;58;30;28
47;Valladolid;210;Villalar de los Comuneros;515;260;255
47;Valladolid;211;Villalba de la Loma;59;32;27
47;Valladolid;212;Villalba de los Alcores;612;317;295
47;Valladolid;213;Villalbarba;184;96;88
47;Valladolid;214;Villalón de Campos;2187;1069;1118
47;Valladolid;215;Villamuriel de Campos;92;45;47
47;Valladolid;216;Villán de Tordesillas;176;89;87
47;Valladolid;217;Villanubla;940;486;454
47;Valladolid;218;Villanueva de Duero;842;434;408
47;Valladolid;219;Villanueva de la Condesa;52;31;21
47;Valladolid;220;Villanueva de los Caballeros;323;155;168
47;Valladolid;221;Villanueva de los Infantes;164;86;78
47;Valladolid;222;Villanueva de San Mancio;100;50;50
47;Valladolid;223;Villardefrades;271;144;127
47;Valladolid;224;Villarmentero de Esgueva;135;70;65
47;Valladolid;225;Villasexmir;148;80;68
47;Valladolid;226;Villavaquerín;225;118;107
47;Valladolid;227;Villavellid;73;42;31
47;Valladolid;228;Villaverde de Medina;656;351;305
47;Valladolid;229;Villavicencio de los Caballeros;385;180;205
47;Valladolid;194;Viloria;414;224;190
47;Valladolid;230;Wamba;375;194;181
47;Valladolid;231;Zaratán;1159;587;572
47;Valladolid;232;Zarza (La);192;99;93
48;Vizcaya;001;Abadiño;7073;3573;3500
48;Vizcaya;002;Abanto y Ciérvana-Abanto Zierbena;9468;4711;4757
48;Vizcaya;911;Ajangiz;361;188;173
48;Vizcaya;912;Alonsotegi;3053;1485;1568
48;Vizcaya;003;Amorebieta-Etxano;15891;7979;7912
48;Vizcaya;004;Amoroto;388;209;179
48;Vizcaya;005;Arakaldo;105;59;46
48;Vizcaya;006;Arantzazu;280;134;146
48;Vizcaya;093;Areatza;1133;520;613
48;Vizcaya;009;Arrankudiaga;721;353;368
48;Vizcaya;914;Arratzu;"";"";""
48;Vizcaya;010;Arrieta;425;218;207
48;Vizcaya;011;Arrigorriaga;10019;4937;5082
48;Vizcaya;023;Artea;610;296;314
48;Vizcaya;008;Artzentales;671;366;305
48;Vizcaya;091;Atxondo;1516;758;758
48;Vizcaya;070;Aulesti;692;371;321
48;Vizcaya;012;Bakio;1247;630;617
48;Vizcaya;090;Balmaseda;7333;3552;3781
48;Vizcaya;013;Barakaldo;104599;51587;53012
48;Vizcaya;014;Barrika;874;415;459
48;Vizcaya;015;Basauri;50063;25025;25038
48;Vizcaya;092;Bedia;1033;504;529
48;Vizcaya;016;Berango;4134;2052;2082
48;Vizcaya;017;Bermeo;17855;8875;8980
48;Vizcaya;018;Berriatua;1016;536;480
48;Vizcaya;019;Berriz;4246;2140;2106
48;Vizcaya;020;Bilbao;370263;177041;193222
48;Vizcaya;021;Busturia;1722;871;851
48;Vizcaya;901;Derio;4835;2421;2414
48;Vizcaya;026;Dima;1038;547;491
48;Vizcaya;027;Durango;22722;11217;11505
48;Vizcaya;028;Ea;798;389;409
48;Vizcaya;031;Elantxobe;543;249;294
48;Vizcaya;032;Elorrio;7433;3742;3691
48;Vizcaya;902;Erandio;24831;12230;12601
48;Vizcaya;033;Ereño;271;131;140
48;Vizcaya;034;Ermua;17885;9176;8709
48;Vizcaya;079;Errigoiti;432;237;195
48;Vizcaya;029;Etxebarri, Anteiglesia de San Esteban-Etxebarri Doneztebeko Elizatea;6463;3258;3205
48;Vizcaya;030;Etxebarria;787;410;377
48;Vizcaya;906;Forua;940;482;458
48;Vizcaya;035;Fruiz;310;159;151
48;Vizcaya;036;Galdakao;28829;14389;14440
48;Vizcaya;037;Galdames;809;429;380
48;Vizcaya;038;Gamiz-Fika;903;481;422
48;Vizcaya;039;Garay;255;138;117
48;Vizcaya;040;Gatika;936;469;467
48;Vizcaya;041;Gautegiz Arteaga;770;376;394
48;Vizcaya;046;Gernika-Lumo;16072;7884;8188
48;Vizcaya;044;Getxo;80732;38891;41841
48;Vizcaya;047;Gizaburuaga;128;66;62
48;Vizcaya;042;Gordexola;1525;766;759
48;Vizcaya;043;Gorliz;2993;1451;1542
48;Vizcaya;045;Güeñes;5874;2894;2980
48;Vizcaya;048;Ibarrangelu;529;240;289
48;Vizcaya;094;Igorre;3881;1938;1943
48;Vizcaya;049;Ispaster;619;325;294
48;Vizcaya;910;Iurreta;4885;2399;2486
48;Vizcaya;050;Izurtza;269;135;134
48;Vizcaya;022;Karrantza Harana/Valle de Carranza;3151;1654;1497
48;Vizcaya;907;Kortezubi;390;205;185
48;Vizcaya;051;Lanestosa;306;159;147
48;Vizcaya;052;Larrabetzu;1479;730;749
48;Vizcaya;053;Laukiz;974;498;476
48;Vizcaya;054;Leioa;25013;12382;12631
48;Vizcaya;057;Lekeitio;7413;3621;3792
48;Vizcaya;055;Lemoa;2703;1366;1337
48;Vizcaya;056;Lemoiz;775;399;376
48;Vizcaya;081;Lezama;2025;1028;997
48;Vizcaya;903;Loiu;1727;889;838
48;Vizcaya;058;Mallabia;1119;598;521
48;Vizcaya;059;Mañaria;498;263;235
48;Vizcaya;060;Markina-Xemein;4889;2422;2467
48;Vizcaya;061;Maruri-Jatabe;527;257;270
48;Vizcaya;062;Mendata;341;183;158
48;Vizcaya;063;Mendexa;348;178;170
48;Vizcaya;064;Meñaka;440;232;208
48;Vizcaya;066;Morga;351;182;169
48;Vizcaya;068;Mundaka;1704;781;923
48;Vizcaya;069;Mungia;12023;5921;6102
48;Vizcaya;007;Munitibar-Arbatzegi Gerrikaitz;447;242;205
48;Vizcaya;908;Murueta;197;98;99
48;Vizcaya;071;Muskiz;6425;3165;3260
48;Vizcaya;067;Muxika;1437;746;691
48;Vizcaya;909;Nabarniz;252;126;126
48;Vizcaya;073;Ondarroa;10653;5325;5328
48;Vizcaya;075;Orozko;1908;962;946
48;Vizcaya;083;Ortuella;8975;4418;4557
48;Vizcaya;072;Otxandio;1117;591;526
48;Vizcaya;077;Plentzia;2564;1245;1319
48;Vizcaya;078;Portugalete;55869;27545;28324
48;Vizcaya;082;Santurtzi;50469;24948;25521
48;Vizcaya;084;Sestao;35905;17525;18380
48;Vizcaya;904;Sondika;3316;1599;1717
48;Vizcaya;085;Sopelana;8175;4083;4092
48;Vizcaya;086;Sopuerta;2149;1108;1041
48;Vizcaya;076;Sukarrieta;288;139;149
48;Vizcaya;087;Trucios-Turtzioz;525;253;272
48;Vizcaya;088;Ubide;165;85;80
48;Vizcaya;065;Ugao-Miraballes;4138;2062;2076
48;Vizcaya;089;Urduliz;2585;1295;1290
48;Vizcaya;074;Urduña-Orduña;4032;2065;1967
48;Vizcaya;080;Valle de Trápaga-Trapagaran;13229;6524;6705
48;Vizcaya;095;Zaldibar;3135;1490;1645
48;Vizcaya;096;Zalla;7322;3631;3691
48;Vizcaya;905;Zamudio;3171;1589;1582
48;Vizcaya;097;Zaratamo;1651;824;827
48;Vizcaya;024;Zeanuri;1165;611;554
48;Vizcaya;025;Zeberio;960;490;470
48;Vizcaya;913;Zierbena;"";"";""
49;Zamora;002;Abezames;122;60;62
49;Zamora;003;Alcañices;1241;644;597
49;Zamora;004;Alcubilla de Nogales;265;129;136
49;Zamora;005;Alfaraz de Sayago;257;141;116
49;Zamora;006;Algodre;240;129;111
49;Zamora;007;Almaraz de Duero;500;248;252
49;Zamora;008;Almeida de Sayago;748;391;357
49;Zamora;009;Andavías;543;262;281
49;Zamora;010;Arcenillas;251;126;125
49;Zamora;011;Arcos de la Polvorosa;324;174;150
49;Zamora;012;Argañín;133;62;71
49;Zamora;013;Argujillo;436;232;204
49;Zamora;014;Arquillinos;189;96;93
49;Zamora;015;Arrabalde;473;231;242
49;Zamora;016;Aspariegos;436;200;236
49;Zamora;017;Asturianos;420;201;219
49;Zamora;018;Ayoó de Vidriales;566;280;286
49;Zamora;019;Barcial del Barco;340;185;155
49;Zamora;020;Belver de los Montes;585;303;282
49;Zamora;021;Benavente;14687;7105;7582
49;Zamora;022;Benegiles;453;243;210
49;Zamora;023;Bermillo de Sayago;1719;885;834
49;Zamora;024;Bóveda de Toro (La);1086;566;520
49;Zamora;025;Bretó;299;153;146
49;Zamora;026;Bretocino;349;191;158
49;Zamora;027;Brime de Sog;288;129;159
49;Zamora;028;Brime de Urz;191;106;85
49;Zamora;029;Burganes de Valverde;908;459;449
49;Zamora;030;Bustillo del Oro;193;95;98
49;Zamora;031;Cabañas de Sayago;258;131;127
49;Zamora;032;Calzadilla de Tera;631;300;331
49;Zamora;033;Camarzana de Tera;1160;575;585
49;Zamora;034;Cañizal;696;363;333
49;Zamora;035;Cañizo;397;195;202
49;Zamora;036;Carbajales de Alba;751;369;382
49;Zamora;037;Carbellino;285;152;133
49;Zamora;038;Casaseca de Campeán;188;100;88
49;Zamora;039;Casaseca de las Chanas;403;198;205
49;Zamora;040;Castrillo de la Guareña;175;89;86
49;Zamora;041;Castrogonzalo;591;300;291
49;Zamora;042;Castronuevo;396;204;192
49;Zamora;043;Castroverde de Campos;477;228;249
49;Zamora;044;Cazurra;116;62;54
49;Zamora;046;Cerecinos de Campos;477;246;231
49;Zamora;047;Cerecinos del Carrizal;180;97;83
49;Zamora;048;Cernadilla;186;85;101
49;Zamora;050;Cobreros;846;414;432
49;Zamora;052;Coomonte;391;196;195
49;Zamora;053;Coreses;1352;697;655
49;Zamora;054;Corrales;1360;664;696
49;Zamora;055;Cotanes del Monte;203;106;97
49;Zamora;056;Cubillos;456;237;219
49;Zamora;057;Cubo de Benavente;253;135;118
49;Zamora;058;Cubo de Tierra del Vino (El);496;255;241
49;Zamora;059;Cuelgamures;161;91;70
49;Zamora;061;Entrala;156;77;79
49;Zamora;062;Espadañedo;258;124;134
49;Zamora;063;Faramontanos de Tábara;589;294;295
49;Zamora;064;Fariza;809;409;400
49;Zamora;065;Fermoselle;1975;950;1025
49;Zamora;066;Ferreras de Abajo;674;343;331
49;Zamora;067;Ferreras de Arriba;573;293;280
49;Zamora;068;Ferreruela;745;393;352
49;Zamora;069;Figueruela de Arriba;636;315;321
49;Zamora;071;Fonfría;1289;655;634
49;Zamora;075;Fresno de la Polvorosa;267;134;133
49;Zamora;076;Fresno de la Ribera;441;239;202
49;Zamora;077;Fresno de Sayago;352;185;167
49;Zamora;078;Friera de Valverde;338;173;165
49;Zamora;079;Fuente Encalada;195;102;93
49;Zamora;080;Fuentelapeña;1114;553;561
49;Zamora;082;Fuentes de Ropel;725;373;352
49;Zamora;081;Fuentesaúco;1997;980;1017
49;Zamora;083;Fuentesecas;106;54;52
49;Zamora;084;Fuentespreadas;464;244;220
49;Zamora;085;Galende;1333;660;673
49;Zamora;086;Gallegos del Pan;204;99;105
49;Zamora;087;Gallegos del Río;1029;535;494
49;Zamora;088;Gamones;114;64;50
49;Zamora;090;Gema;335;164;171
49;Zamora;091;Granja de Moreruela;396;190;206
49;Zamora;092;Granucillo;320;156;164
49;Zamora;093;Guarrate;437;235;202
49;Zamora;094;Hermisende;528;266;262
49;Zamora;095;Hiniesta (La);441;215;226
49;Zamora;096;Jambrina;312;156;156
49;Zamora;097;Justel;252;133;119
49;Zamora;098;Losacino;392;204;188
49;Zamora;099;Losacio;188;104;84
49;Zamora;100;Lubián;438;213;225
49;Zamora;101;Luelmo;295;155;140
49;Zamora;102;Maderal (El);319;163;156
49;Zamora;103;Madridanos;591;309;282
49;Zamora;104;Mahide;642;334;308
49;Zamora;105;Maire de Castroponce;305;152;153
49;Zamora;107;Malva;289;136;153
49;Zamora;108;Manganeses de la Lampreana;939;472;467
49;Zamora;109;Manganeses de la Polvorosa;997;475;522
49;Zamora;110;Manzanal de Arriba;559;281;278
49;Zamora;112;Manzanal de los Infantes;236;112;124
49;Zamora;111;Manzanal del Barco;239;126;113
49;Zamora;113;Matilla de Arzón;328;175;153
49;Zamora;114;Matilla la Seca;93;49;44
49;Zamora;115;Mayalde;292;151;141
49;Zamora;116;Melgar de Tera;663;330;333
49;Zamora;117;Micereces de Tera;694;356;338
49;Zamora;118;Milles de la Polvorosa;304;148;156
49;Zamora;119;Molacillos;332;173;159
49;Zamora;120;Molezuelas de la Carballeda;176;88;88
49;Zamora;121;Mombuey;523;263;260
49;Zamora;122;Monfarracinos;551;293;258
49;Zamora;123;Montamarta;759;356;403
49;Zamora;124;Moral de Sayago;417;221;196
49;Zamora;126;Moraleja de Sayago;321;172;149
49;Zamora;125;Moraleja del Vino;1203;629;574
49;Zamora;128;Morales de Rey;817;406;411
49;Zamora;129;Morales de Toro;1143;567;576
49;Zamora;130;Morales de Valverde;366;181;185
49;Zamora;127;Morales del Vino;1192;621;571
49;Zamora;131;Moralina;407;217;190
49;Zamora;132;Moreruela de los Infanzones;535;284;251
49;Zamora;133;Moreruela de Tábara;644;336;308
49;Zamora;134;Muelas de los Caballeros;285;145;140
49;Zamora;135;Muelas del Pan;956;466;490
49;Zamora;136;Muga de Sayago;558;269;289
49;Zamora;137;Navianos de Valverde;293;161;132
49;Zamora;138;Olmillos de Castro;507;251;256
49;Zamora;139;Otero de Bodas;307;158;149
49;Zamora;141;Pajares de la Lampreana;559;278;281
49;Zamora;143;Palacios de Sanabria;337;162;175
49;Zamora;142;Palacios del Pan;288;137;151
49;Zamora;145;Pedralba de la Pradería;448;232;216
49;Zamora;146;Pego (El);506;263;243
49;Zamora;147;Peleagonzalo;515;258;257
49;Zamora;148;Peleas de Abajo;224;114;110
49;Zamora;149;Peñausende;635;323;312
49;Zamora;150;Peque;228;111;117
49;Zamora;151;Perdigón (El);920;464;456
49;Zamora;152;Pereruela;883;436;447
49;Zamora;153;Perilla de Castro;286;139;147
49;Zamora;154;Pías;298;155;143
49;Zamora;155;Piedrahita de Castro;173;106;67
49;Zamora;156;Pinilla de Toro;494;251;243
49;Zamora;157;Pino del Oro;274;151;123
49;Zamora;158;Piñero (El);337;191;146
49;Zamora;160;Pobladura de Valderaduey;95;45;50
49;Zamora;159;Pobladura del Valle;389;188;201
49;Zamora;162;Porto;436;212;224
49;Zamora;163;Pozoantiguo;424;215;209
49;Zamora;164;Pozuelo de Tábara;279;137;142
49;Zamora;165;Prado;130;62;68
49;Zamora;166;Puebla de Sanabria;1670;797;873
49;Zamora;167;Pueblica de Valverde;387;194;193
49;Zamora;170;Quintanilla de Urz;155;89;66
49;Zamora;168;Quintanilla del Monte;176;85;91
49;Zamora;169;Quintanilla del Olmo;74;34;40
49;Zamora;171;Quiruelas de Vidriales;1084;526;558
49;Zamora;172;Rabanales;988;504;484
49;Zamora;173;Rábano de Aliste;564;276;288
49;Zamora;174;Requejo;255;129;126
49;Zamora;175;Revellinos;394;196;198
49;Zamora;176;Riofrío de Aliste;1150;612;538
49;Zamora;177;Rionegro del Puente;441;218;223
49;Zamora;178;Roales;335;168;167
49;Zamora;179;Robleda-Cervantes;492;235;257
49;Zamora;180;Roelos de Sayago;181;92;89
49;Zamora;181;Rosinos de la Requejada;638;307;331
49;Zamora;183;Salce;170;91;79
49;Zamora;184;Samir de los Caños;282;149;133
49;Zamora;185;San Agustín del Pozo;225;124;101
49;Zamora;186;San Cebrián de Castro;478;226;252
49;Zamora;187;San Cristóbal de Entreviñas;1673;856;817
49;Zamora;188;San Esteban del Molar;238;131;107
49;Zamora;189;San Justo;362;183;179
49;Zamora;190;San Martín de Valderaduey;104;47;57
49;Zamora;191;San Miguel de la Ribera;470;235;235
49;Zamora;192;San Miguel del Valle;296;140;156
49;Zamora;193;San Pedro de Ceque;744;368;376
49;Zamora;194;San Pedro de la Nave-Almendra;548;271;277
49;Zamora;208;San Vicente de la Cabeza;751;387;364
49;Zamora;209;San Vitero;799;417;382
49;Zamora;197;Santa Clara de Avedillo;305;150;155
49;Zamora;199;Santa Colomba de las Monjas;356;182;174
49;Zamora;200;Santa Cristina de la Polvorosa;1340;681;659
49;Zamora;201;Santa Croya de Tera;571;283;288
49;Zamora;202;Santa Eufemia del Barco;342;185;157
49;Zamora;203;Santa María de la Vega;563;295;268
49;Zamora;204;Santa María de Valverde;132;72;60
49;Zamora;205;Santibáñez de Tera;675;347;328
49;Zamora;206;Santibáñez de Vidriales;1580;767;813
49;Zamora;207;Santovenia;516;260;256
49;Zamora;210;Sanzoles;790;406;384
49;Zamora;214;Tábara;994;504;490
49;Zamora;216;Tapioles;272;148;124
49;Zamora;219;Toro;9279;4516;4763
49;Zamora;220;Torre del Valle (La);221;117;104
49;Zamora;221;Torregamones;392;190;202
49;Zamora;222;Torres del Carrizal;570;294;276
49;Zamora;223;Trabazos;1096;558;538
49;Zamora;224;Trefacio;254;121;133
49;Zamora;225;Uña de Quintana;278;136;142
49;Zamora;226;Vadillo de la Guareña;387;193;194
49;Zamora;227;Valcabado;339;171;168
49;Zamora;228;Valdefinjas;116;62;54
49;Zamora;229;Valdescorriel;215;103;112
49;Zamora;230;Vallesa de la Guareña;210;116;94
49;Zamora;231;Vega de Tera;629;300;329
49;Zamora;232;Vega de Villalobos;200;97;103
49;Zamora;233;Vegalatrave;201;95;106
49;Zamora;234;Venialbo;557;291;266
49;Zamora;235;Vezdemarbán;784;373;411
49;Zamora;236;Vidayanes;138;69;69
49;Zamora;237;Videmala;254;125;129
49;Zamora;238;Villabrázaro;462;233;229
49;Zamora;239;Villabuena del Puente;1122;584;538
49;Zamora;240;Villadepera;300;147;153
49;Zamora;241;Villaescusa;467;240;227
49;Zamora;242;Villafáfila;700;338;362
49;Zamora;243;Villaferrueña;186;96;90
49;Zamora;244;Villageriz;75;38;37
49;Zamora;245;Villalazán;430;219;211
49;Zamora;246;Villalba de la Lampreana;370;190;180
49;Zamora;247;Villalcampo;796;383;413
49;Zamora;248;Villalobos;376;181;195
49;Zamora;249;Villalonso;169;79;90
49;Zamora;250;Villalpando;1868;899;969
49;Zamora;251;Villalube;380;189;191
49;Zamora;252;Villamayor de Campos;661;333;328
49;Zamora;255;Villamor de los Escuderos;638;321;317
49;Zamora;256;Villanázar;411;195;216
49;Zamora;257;Villanueva de Azoague;457;226;231
49;Zamora;258;Villanueva de Campeán;221;108;113
49;Zamora;259;Villanueva de las Peras;249;121;128
49;Zamora;260;Villanueva del Campo;1217;604;613
49;Zamora;263;Villar de Fallaves;121;68;53
49;Zamora;264;Villar del Buey;984;523;461
49;Zamora;261;Villaralbo;1551;779;772
49;Zamora;262;Villardeciervos;592;263;329
49;Zamora;265;Villardiegua de la Ribera;196;91;105
49;Zamora;266;Villárdiga;130;64;66
49;Zamora;267;Villardondiego;162;85;77
49;Zamora;268;Villarrín de Campos;672;339;333
49;Zamora;269;Villaseco del Pan;384;190;194
49;Zamora;270;Villavendimio;248;137;111
49;Zamora;272;Villaveza de Valverde;173;89;84
49;Zamora;271;Villaveza del Agua;315;162;153
49;Zamora;273;Viñas;349;186;163
49;Zamora;275;Zamora;64880;30871;34009
50;Zaragoza;001;Abanto;224;114;110
50;Zaragoza;002;Acered;319;169;150
50;Zaragoza;003;Agón;229;120;109
50;Zaragoza;004;Aguarón;756;375;381
50;Zaragoza;005;Aguilón;266;130;136
50;Zaragoza;006;Ainzón;1231;616;615
50;Zaragoza;007;Aladrén;54;27;27
50;Zaragoza;008;Alagón;5574;2752;2822
50;Zaragoza;009;Alarba;173;99;74
50;Zaragoza;010;Alberite de San Juan;116;59;57
50;Zaragoza;011;Albeta;147;71;76
50;Zaragoza;012;Alborge;135;65;70
50;Zaragoza;013;Alcalá de Ebro;345;171;174
50;Zaragoza;014;Alcalá de Moncayo;172;94;78
50;Zaragoza;015;Alconchel de Ariza;186;105;81
50;Zaragoza;016;Aldehuela de Liestos;82;43;39
50;Zaragoza;017;Alfajarín;1461;748;713
50;Zaragoza;018;Alfamén;1295;682;613
50;Zaragoza;019;Alforque;88;47;41
50;Zaragoza;020;Alhama de Aragón;1200;582;618
50;Zaragoza;021;Almochuel;52;31;21
50;Zaragoza;022;Almolda (La);749;368;381
50;Zaragoza;023;Almonacid de la Cuba;379;195;184
50;Zaragoza;024;Almonacid de la Sierra;839;427;412
50;Zaragoza;025;Almunia de Doña Godina (La);5097;2593;2504
50;Zaragoza;026;Alpartir;630;336;294
50;Zaragoza;027;Ambel;416;199;217
50;Zaragoza;028;Anento;102;53;49
50;Zaragoza;029;Aniñón;942;492;450
50;Zaragoza;030;Añón de Moncayo;344;199;145
50;Zaragoza;031;Aranda de Moncayo;259;144;115
50;Zaragoza;032;Arándiga;572;281;291
50;Zaragoza;033;Ardisa;75;36;39
50;Zaragoza;034;Ariza;1424;709;715
50;Zaragoza;035;Artieda;104;57;47
50;Zaragoza;036;Asín;114;57;57
50;Zaragoza;037;Atea;276;149;127
50;Zaragoza;038;Ateca;2126;1024;1102
50;Zaragoza;039;Azuara;825;435;390
50;Zaragoza;040;Badules;121;62;59
50;Zaragoza;041;Bagüés;21;11;10
50;Zaragoza;042;Balconchán;34;19;15
50;Zaragoza;043;Bárboles;347;179;168
50;Zaragoza;044;Bardallur;327;156;171
50;Zaragoza;045;Belchite;1691;848;843
50;Zaragoza;046;Belmonte de Gracián;347;189;158
50;Zaragoza;047;Berdejo;38;19;19
50;Zaragoza;048;Berrueco;43;25;18
50;Zaragoza;901;Biel;248;134;114
50;Zaragoza;050;Bijuesca;133;71;62
50;Zaragoza;051;Biota;1294;681;613
50;Zaragoza;052;Bisimbre;145;67;78
50;Zaragoza;053;Boquiñeni;1068;543;525
50;Zaragoza;054;Bordalba;111;61;50
50;Zaragoza;055;Borja;4050;1982;2068
50;Zaragoza;056;Botorrita;463;246;217
50;Zaragoza;057;Brea de Aragón;2034;1017;1017
50;Zaragoza;058;Bubierca;119;58;61
50;Zaragoza;059;Bujaraloz;1063;554;509
50;Zaragoza;060;Bulbuente;282;154;128
50;Zaragoza;061;Bureta;346;176;170
50;Zaragoza;062;Burgo de Ebro (El);1243;609;634
50;Zaragoza;063;Buste (El);134;67;67
50;Zaragoza;064;Cabañas de Ebro;556;281;275
50;Zaragoza;065;Cabolafuente;101;56;45
50;Zaragoza;066;Cadrete;948;492;456
50;Zaragoza;067;Calatayud;17441;8376;9065
50;Zaragoza;068;Calatorao;2640;1361;1279
50;Zaragoza;069;Calcena;106;56;50
50;Zaragoza;070;Calmarza;125;64;61
50;Zaragoza;071;Campillo de Aragón;227;126;101
50;Zaragoza;072;Carenas;246;122;124
50;Zaragoza;073;Cariñena;2924;1468;1456
50;Zaragoza;074;Caspe;8093;3994;4099
50;Zaragoza;075;Castejón de Alarba;138;77;61
50;Zaragoza;076;Castejón de las Armas;155;83;72
50;Zaragoza;077;Castejón de Valdejasa;395;213;182
50;Zaragoza;078;Castiliscar;459;226;233
50;Zaragoza;079;Cervera de la Cañada;377;182;195
50;Zaragoza;080;Cerveruela;4;2;2
50;Zaragoza;081;Cetina;805;402;403
50;Zaragoza;092;Chiprana;434;219;215
50;Zaragoza;093;Chodes;150;70;80
50;Zaragoza;082;Cimballa;141;68;73
50;Zaragoza;083;Cinco Olivas;155;76;79
50;Zaragoza;084;Clarés de Ribota;119;64;55
50;Zaragoza;085;Codo;323;164;159
50;Zaragoza;086;Codos;325;184;141
50;Zaragoza;087;Contamina;66;34;32
50;Zaragoza;088;Cosuenda;448;228;220
50;Zaragoza;089;Cuarte de Huerva;1385;713;672
50;Zaragoza;090;Cubel;263;130;133
50;Zaragoza;091;Cuerlas (Las);102;52;50
50;Zaragoza;094;Daroca;2375;1177;1198
50;Zaragoza;095;Ejea de los Caballeros;15423;7849;7574
50;Zaragoza;096;Embid de Ariza;81;44;37
50;Zaragoza;098;Encinacorba;348;188;160
50;Zaragoza;099;Épila;3867;1968;1899
50;Zaragoza;100;Erla;532;254;278
50;Zaragoza;101;Escatrón;1373;676;697
50;Zaragoza;102;Fabara;1331;706;625
50;Zaragoza;104;Farlete;499;254;245
50;Zaragoza;105;Fayón;436;221;215
50;Zaragoza;106;Fayos (Los);174;87;87
50;Zaragoza;107;Figueruelas;896;439;457
50;Zaragoza;108;Fombuena;13;10;3
50;Zaragoza;109;Frago (El);125;73;52
50;Zaragoza;110;Frasno (El);646;339;307
50;Zaragoza;111;Fréscano;275;136;139
50;Zaragoza;113;Fuendejalón;978;495;483
50;Zaragoza;114;Fuendetodos;167;93;74
50;Zaragoza;115;Fuentes de Ebro;3825;1970;1855
50;Zaragoza;116;Fuentes de Jiloca;407;212;195
50;Zaragoza;117;Gallocanta;191;97;94
50;Zaragoza;118;Gallur;3052;1525;1527
50;Zaragoza;119;Gelsa;1353;686;667
50;Zaragoza;120;Godojos;82;46;36
50;Zaragoza;121;Gotor;390;204;186
50;Zaragoza;122;Grisel;71;35;36
50;Zaragoza;123;Grisén;484;244;240
50;Zaragoza;124;Herrera de los Navarros;705;365;340
50;Zaragoza;125;Ibdes;575;299;276
50;Zaragoza;126;Illueca;3197;1598;1599
50;Zaragoza;128;Isuerre;65;33;32
50;Zaragoza;129;Jaraba;330;167;163
50;Zaragoza;130;Jarque;605;316;289
50;Zaragoza;131;Jaulín;307;152;155
50;Zaragoza;132;Joyosa (La);355;177;178
50;Zaragoza;133;Lagata;154;85;69
50;Zaragoza;134;Langa del Castillo;200;88;112
50;Zaragoza;135;Layana;186;91;95
50;Zaragoza;136;Lécera;993;487;506
50;Zaragoza;138;Lechón;64;36;28
50;Zaragoza;137;Leciñena;1463;729;734
50;Zaragoza;139;Letux;481;250;231
50;Zaragoza;140;Litago;191;107;84
50;Zaragoza;141;Lituénigo;127;61;66
50;Zaragoza;142;Lobera de Onsella;61;37;24
50;Zaragoza;143;Longares;870;444;426
50;Zaragoza;144;Longás;35;24;11
50;Zaragoza;146;Lucena de Jalón;306;152;154
50;Zaragoza;147;Luceni;1080;535;545
50;Zaragoza;148;Luesia;458;243;215
50;Zaragoza;149;Luesma;29;15;14
50;Zaragoza;150;Lumpiaque;999;523;476
50;Zaragoza;151;Luna;989;508;481
50;Zaragoza;152;Maella;2173;1102;1071
50;Zaragoza;153;Magallón;1375;712;663
50;Zaragoza;154;Mainar;185;102;83
50;Zaragoza;155;Malanquilla;139;70;69
50;Zaragoza;156;Maleján;317;164;153
50;Zaragoza;160;Mallén;3009;1516;1493
50;Zaragoza;157;Malón;520;262;258
50;Zaragoza;159;Maluenda;1070;532;538
50;Zaragoza;161;Manchones;171;86;85
50;Zaragoza;162;Mara;246;129;117
50;Zaragoza;163;María de Huerva;807;385;422
50;Zaragoza;902;Marracos;"";"";""
50;Zaragoza;164;Mediana de Aragón;537;264;273
50;Zaragoza;165;Mequinenza;2722;1378;1344
50;Zaragoza;166;Mesones de Isuela;443;222;221
50;Zaragoza;167;Mezalocha;336;179;157
50;Zaragoza;168;Mianos;41;22;19
50;Zaragoza;169;Miedes de Aragón;566;290;276
50;Zaragoza;170;Monegrillo;565;304;261
50;Zaragoza;171;Moneva;110;53;57
50;Zaragoza;172;Monreal de Ariza;337;173;164
50;Zaragoza;173;Monterde;201;99;102
50;Zaragoza;174;Montón;167;79;88
50;Zaragoza;175;Morata de Jalón;1716;849;867
50;Zaragoza;176;Morata de Jiloca;364;197;167
50;Zaragoza;177;Morés;545;278;267
50;Zaragoza;178;Moros;612;317;295
50;Zaragoza;179;Moyuela;422;212;210
50;Zaragoza;180;Mozota;120;57;63
50;Zaragoza;181;Muel;1180;583;597
50;Zaragoza;182;Muela (La);1013;538;475
50;Zaragoza;183;Munébrega;517;270;247
50;Zaragoza;184;Murero;164;87;77
50;Zaragoza;185;Murillo de Gállego;149;79;70
50;Zaragoza;186;Navardún;86;44;42
50;Zaragoza;187;Nigüella;139;69;70
50;Zaragoza;188;Nombrevilla;35;17;18
50;Zaragoza;189;Nonaspe;1127;567;560
50;Zaragoza;190;Novallas;798;395;403
50;Zaragoza;191;Novillas;730;370;360
50;Zaragoza;192;Nuévalos;297;170;127
50;Zaragoza;193;Nuez de Ebro;533;277;256
50;Zaragoza;194;Olvés;186;104;82
50;Zaragoza;195;Orcajo;53;26;27
50;Zaragoza;196;Orera;176;88;88
50;Zaragoza;197;Orés;132;71;61
50;Zaragoza;198;Oseja;29;11;18
50;Zaragoza;199;Osera de Ebro;348;168;180
50;Zaragoza;200;Paniza;768;383;385
50;Zaragoza;201;Paracuellos de Jiloca;549;260;289
50;Zaragoza;202;Paracuellos de la Ribera;353;168;185
50;Zaragoza;203;Pastriz;757;372;385
50;Zaragoza;204;Pedrola;2481;1276;1205
50;Zaragoza;205;Pedrosas (Las);112;55;57
50;Zaragoza;206;Perdiguera;477;251;226
50;Zaragoza;207;Piedratajada;226;115;111
50;Zaragoza;208;Pina de Ebro;2198;1107;1091
50;Zaragoza;209;Pinseque;1398;706;692
50;Zaragoza;210;Pintanos (Los);83;46;37
50;Zaragoza;211;Plasencia de Jalón;381;197;184
50;Zaragoza;212;Pleitas;80;43;37
50;Zaragoza;213;Plenas;180;90;90
50;Zaragoza;214;Pomer;24;10;14
50;Zaragoza;215;Pozuel de Ariza;33;20;13
50;Zaragoza;216;Pozuelo de Aragón;381;204;177
50;Zaragoza;217;Pradilla de Ebro;698;363;335
50;Zaragoza;218;Puebla de Albortón;151;78;73
50;Zaragoza;219;Puebla de Alfindén (La);1458;750;708
50;Zaragoza;220;Puendeluna;66;35;31
50;Zaragoza;221;Purujosa;35;19;16
50;Zaragoza;222;Quinto;2186;1108;1078
50;Zaragoza;223;Remolinos;1280;649;631
50;Zaragoza;224;Retascón;83;47;36
50;Zaragoza;225;Ricla;2044;1060;984
50;Zaragoza;227;Romanos;157;90;67
50;Zaragoza;228;Rueda de Jalón;367;193;174
50;Zaragoza;229;Ruesca;83;42;41
50;Zaragoza;241;Sabiñán;1041;502;539
50;Zaragoza;230;Sádaba;1864;952;912
50;Zaragoza;231;Salillas de Jalón;403;208;195
50;Zaragoza;232;Salvatierra de Esca;318;169;149
50;Zaragoza;233;Samper del Salz;104;52;52
50;Zaragoza;234;San Martín de la Virgen de Moncayo;313;167;146
50;Zaragoza;235;San Mateo de Gállego;1845;954;891
50;Zaragoza;236;Santa Cruz de Grío;235;131;104
50;Zaragoza;237;Santa Cruz de Moncayo;103;53;50
50;Zaragoza;238;Santa Eulalia de Gállego;134;68;66
50;Zaragoza;239;Santed;85;40;45
50;Zaragoza;240;Sástago;1666;837;829
50;Zaragoza;242;Sediles;106;55;51
50;Zaragoza;243;Sestrica;546;277;269
50;Zaragoza;244;Sierra de Luna;327;168;159
50;Zaragoza;245;Sigüés;189;98;91
50;Zaragoza;246;Sisamón;107;62;45
50;Zaragoza;247;Sobradiel;601;284;317
50;Zaragoza;248;Sos del Rey Católico;919;464;455
50;Zaragoza;249;Tabuenca;542;283;259
50;Zaragoza;250;Talamantes;62;33;29
50;Zaragoza;251;Tarazona;10581;5082;5499
50;Zaragoza;252;Tauste;7014;3517;3497
50;Zaragoza;253;Terrer;729;354;375
50;Zaragoza;254;Tierga;293;156;137
50;Zaragoza;255;Tobed;306;149;157
50;Zaragoza;256;Torralba de los Frailes;127;64;63
50;Zaragoza;257;Torralba de Ribota;251;140;111
50;Zaragoza;258;Torralbilla;81;41;40
50;Zaragoza;259;Torrehermosa;131;72;59
50;Zaragoza;260;Torrelapaja;56;29;27
50;Zaragoza;261;Torrellas;340;171;169
50;Zaragoza;262;Torres de Berrellén;1429;718;711
50;Zaragoza;263;Torrijo de la Cañada;480;257;223
50;Zaragoza;264;Tosos;253;133;120
50;Zaragoza;265;Trasmoz;79;39;40
50;Zaragoza;266;Trasobares;286;152;134
50;Zaragoza;267;Uncastillo;957;468;489
50;Zaragoza;268;Undués de Lerda;47;22;25
50;Zaragoza;269;Urrea de Jalón;381;186;195
50;Zaragoza;270;Urriés;76;41;35
50;Zaragoza;271;Used;450;229;221
50;Zaragoza;272;Utebo;7951;4006;3945
50;Zaragoza;274;Val de San Martín;70;30;40
50;Zaragoza;273;Valdehorna;80;41;39
50;Zaragoza;275;Valmadrid;73;38;35
50;Zaragoza;276;Valpalmas;231;117;114
50;Zaragoza;277;Valtorres;122;59;63
50;Zaragoza;278;Velilla de Ebro;288;146;142
50;Zaragoza;279;Velilla de Jiloca;153;77;76
50;Zaragoza;280;Vera de Moncayo;509;257;252
50;Zaragoza;281;Vierlas;108;52;56
50;Zaragoza;283;Villadoz;94;50;44
50;Zaragoza;284;Villafeliche;250;121;129
50;Zaragoza;285;Villafranca de Ebro;679;327;352
50;Zaragoza;286;Villalba de Perejil;103;52;51
50;Zaragoza;287;Villalengua;493;263;230
50;Zaragoza;288;Villanueva de Gállego;2497;1250;1247
50;Zaragoza;290;Villanueva de Huerva;667;330;337
50;Zaragoza;289;Villanueva de Jiloca;111;57;54
50;Zaragoza;291;Villar de los Navarros;199;101;98
50;Zaragoza;292;Villarreal de Huerva;214;118;96
50;Zaragoza;293;Villarroya de la Sierra;794;397;397
50;Zaragoza;294;Villarroya del Campo;75;38;37
50;Zaragoza;282;Vilueña (La);110;51;59
50;Zaragoza;295;Vistabella;33;15;18
50;Zaragoza;296;Zaida (La);658;329;329
50;Zaragoza;297;Zaragoza;593832;286780;307052
50;Zaragoza;298;Zuera;5321;2696;2625
51;Ceuta;001;Ceuta;68343;33583;34760
52;Melilla;001;Melilla;58104;28836;29268
