01;Álava;001;Alegría-Dulantzi;1234;640;594
01;Álava;002;Amurrio;9758;4866;4892
01;Álava;049;Añana;203;105;98
01;Álava;003;Aramaio;1345;704;641
01;Álava;006;Armiñón;139;73;66
01;Álava;037;Arraia-Maeztu;684;363;321
01;Álava;008;Arrazua-Ubarrundia;745;388;357
01;Álava;004;Artziniega;1293;648;645
01;Álava;009;Asparrena;1541;763;778
01;Álava;010;Ayala/Aiara;2008;1005;1003
01;Álava;011;Baños de Ebro/Mañueta;335;182;153
01;Álava;013;Barrundia;554;308;246
01;Álava;014;Berantevilla;403;209;194
01;Álava;016;Bernedo;540;313;227
01;Álava;017;Campezo/Kanpezu;1109;582;527
01;Álava;021;Elburgo/Burgelu;192;104;88
01;Álava;022;Elciego;921;462;459
01;Álava;023;Elvillar/Bilar;348;188;160
01;Álava;056;Harana/Valle de Arana;366;201;165
01;Álava;901;Iruña Oka/Iruña de Oca;1616;853;763
01;Álava;027;Iruraiz-Gauna;408;224;184
01;Álava;019;Kripan;200;104;96
01;Álava;020;Kuartango;343;195;148
01;Álava;028;Labastida/Bastida;1082;573;509
01;Álava;030;Lagrán;190;101;89
01;Álava;031;Laguardia;1423;727;696
01;Álava;032;Lanciego/Lantziego;650;339;311
01;Álava;902;Lantarón;829;448;381
01;Álava;033;Lapuebla de Labarca;861;430;431
01;Álava;058;Legutiano;1311;693;618
01;Álava;034;Leza;182;99;83
01;Álava;036;Llodio;19913;9999;9914
01;Álava;039;Moreda de Álava;283;155;128
01;Álava;041;Navaridas;227;125;102
01;Álava;042;Okondo;770;388;382
01;Álava;043;Oyón/Oion;2242;1130;1112
01;Álava;044;Peñacerrada-Urizaharra;251;140;111
01;Álava;046;Erriberagoitia/Ribera Alta;512;297;215
01;Álava;047;Ribera Baja/Erribera Beitia;465;247;218
01;Álava;051;Salvatierra/Agurain;3796;1929;1867
01;Álava;052;Samaniego;305;151;154
01;Álava;053;San Millán/Donemiliaga;691;377;314
01;Álava;054;Urkabustaiz;836;447;389
01;Álava;055;Valdegovía/Gaubea;883;492;391
01;Álava;057;Villabuena de Álava/Eskuernaga;345;170;175
01;Álava;059;Vitoria-Gasteiz;214234;105300;108934
01;Álava;060;Yécora/Lekora;254;126;128
01;Álava;061;Zalduondo;136;73;63
01;Álava;062;Zambrana;357;196;161
01;Álava;018;Zigoitia;1057;576;481
01;Álava;063;Zuia;1451;732;719
02;Albacete;001;Abengibre;1019;506;513
02;Albacete;002;Alatoz;683;357;326
02;Albacete;003;Albacete;143799;70234;73565
02;Albacete;004;Albatana;907;458;449
02;Albacete;005;Alborea;798;420;378
02;Albacete;006;Alcadozo;809;412;397
02;Albacete;007;Alcalá del Júcar;1563;799;764
02;Albacete;008;Alcaraz;1799;878;921
02;Albacete;009;Almansa;23507;11569;11938
02;Albacete;010;Alpera;2353;1209;1144
02;Albacete;011;Ayna;1086;545;541
02;Albacete;012;Balazote;2203;1116;1087
02;Albacete;014;Ballestero (El);595;294;301
02;Albacete;013;Balsa de Ves;270;146;124
02;Albacete;015;Barrax;1979;995;984
02;Albacete;016;Bienservida;952;481;471
02;Albacete;017;Bogarra;1448;755;693
02;Albacete;018;Bonete;1245;633;612
02;Albacete;019;Bonillo (El);3333;1692;1641
02;Albacete;020;Carcelén;676;356;320
02;Albacete;021;Casas de Juan Núñez;1322;689;633
02;Albacete;022;Casas de Lázaro;455;244;211
02;Albacete;023;Casas de Ves;962;489;473
02;Albacete;024;Casas-Ibáñez;4041;2034;2007
02;Albacete;025;Caudete;8765;4359;4406
02;Albacete;026;Cenizate;1091;567;524
02;Albacete;029;Chinchilla de Monte-Aragón;3153;1629;1524
02;Albacete;027;Corral-Rubio;481;247;234
02;Albacete;028;Cotillas;235;118;117
02;Albacete;030;Elche de la Sierra;4010;1984;2026
02;Albacete;032;Fuensanta;401;199;202
02;Albacete;033;Fuente-Álamo;2449;1245;1204
02;Albacete;034;Fuentealbilla;1842;933;909
02;Albacete;031;Férez;814;417;397
02;Albacete;035;Gineta (La);2083;1003;1080
02;Albacete;036;Golosalvo;140;67;73
02;Albacete;037;Hellín;26021;12899;13122
02;Albacete;038;Herrera (La);422;217;205
02;Albacete;039;Higueruela;1298;643;655
02;Albacete;040;Hoya-Gonzalo;770;384;386
02;Albacete;041;Jorquera;594;317;277
02;Albacete;042;Letur;1386;685;701
02;Albacete;043;Lezuza;1841;955;886
02;Albacete;044;Liétor;1758;908;850
02;Albacete;045;Madrigueras;4513;2290;2223
02;Albacete;046;Mahora;1397;690;707
02;Albacete;047;Masegoso;180;105;75
02;Albacete;048;Minaya;1772;891;881
02;Albacete;049;Molinicos;1444;743;701
02;Albacete;050;Montalvos;153;79;74
02;Albacete;051;Montealegre del Castillo;2153;1084;1069
02;Albacete;052;Motilleja;541;268;273
02;Albacete;053;Munera;4168;2107;2061
02;Albacete;054;Navas de Jorquera;540;276;264
02;Albacete;055;Nerpio;1928;1025;903
02;Albacete;056;Ontur;2469;1225;1244
02;Albacete;057;Ossa de Montiel;2876;1430;1446
02;Albacete;058;Paterna del Madera;623;333;290
02;Albacete;060;Peñas de San Pedro;1282;678;604
02;Albacete;059;Peñascosa;452;230;222
02;Albacete;062;Povedilla;745;392;353
02;Albacete;901;Pozo Cañada;"";"";""
02;Albacete;064;Pozo-Lorente;540;251;289
02;Albacete;063;Pozohondo;1911;986;925
02;Albacete;065;Pozuelo;684;356;328
02;Albacete;061;Pétrola;979;498;481
02;Albacete;066;Recueja (La);361;180;181
02;Albacete;067;Riópar;1436;738;698
02;Albacete;068;Robledo;459;237;222
02;Albacete;069;Roda (La);13523;6774;6749
02;Albacete;070;Salobre;644;331;313
02;Albacete;071;San Pedro;1336;674;662
02;Albacete;072;Socovos;2106;1078;1028
02;Albacete;073;Tarazona de la Mancha;5976;2988;2988
02;Albacete;074;Tobarra;7344;3652;3692
02;Albacete;075;Valdeganga;2022;1013;1009
02;Albacete;076;Vianos;497;243;254
02;Albacete;077;Villa de Ves;68;34;34
02;Albacete;078;Villalgordo del Júcar;1328;656;672
02;Albacete;079;Villamalea;3449;1769;1680
02;Albacete;080;Villapalacios;908;451;457
02;Albacete;081;Villarrobledo;22165;10855;11310
02;Albacete;082;Villatoya;194;101;93
02;Albacete;083;Villavaliente;307;158;149
02;Albacete;084;Villaverde de Guadalimar;570;302;268
02;Albacete;085;Viveros;595;309;286
02;Albacete;086;Yeste;5014;2563;2451
03;Alicante/Alacant;001;Adsubia;582;292;290
03;Alicante/Alacant;002;Agost;4017;2008;2009
03;Alicante/Alacant;003;Agres;656;342;314
03;Alicante/Alacant;004;Aigües;544;272;272
03;Alicante/Alacant;005;Albatera;8417;4213;4204
03;Alicante/Alacant;006;Alcalalí;842;422;420
03;Alicante/Alacant;007;Alcocer de Planes;122;52;70
03;Alicante/Alacant;008;Alcoleja;294;141;153
03;Alicante/Alacant;009;Alcoy/Alcoi;60921;29305;31616
03;Alicante/Alacant;010;Alfafara;391;190;201
03;Alicante/Alacant;011;Alfàs del Pi (L');12547;6127;6420
03;Alicante/Alacant;012;Algorfa;1140;581;559
03;Alicante/Alacant;013;Algueña;1425;685;740
03;Alicante/Alacant;014;Alicante/Alacant;274577;131776;142801
03;Alicante/Alacant;015;Almoradí;13479;6739;6740
03;Alicante/Alacant;016;Almudaina;125;62;63
03;Alicante/Alacant;017;Alqueria d'Asnar (L');407;198;209
03;Alicante/Alacant;018;Altea;13519;6630;6889
03;Alicante/Alacant;019;Aspe;16391;8199;8192
03;Alicante/Alacant;020;Balones;176;83;93
03;Alicante/Alacant;021;Banyeres de Mariola;7056;3517;3539
03;Alicante/Alacant;022;Benasau;210;106;104
03;Alicante/Alacant;023;Beneixama;1799;897;902
03;Alicante/Alacant;024;Benejúzar;5009;2481;2528
03;Alicante/Alacant;025;Benferri;1011;509;502
03;Alicante/Alacant;026;Beniarbeig;1208;592;616
03;Alicante/Alacant;027;Beniardá;224;107;117
03;Alicante/Alacant;028;Beniarrés;1464;738;726
03;Alicante/Alacant;030;Benidoleig;783;378;405
03;Alicante/Alacant;031;Benidorm;50040;24552;25488
03;Alicante/Alacant;032;Benifallim;169;82;87
03;Alicante/Alacant;033;Benifato;140;71;69
03;Alicante/Alacant;029;Benigembla;390;196;194
03;Alicante/Alacant;034;Benijófar;1592;773;819
03;Alicante/Alacant;035;Benilloba;961;490;471
03;Alicante/Alacant;036;Benillup;105;54;51
03;Alicante/Alacant;037;Benimantell;432;200;232
03;Alicante/Alacant;038;Benimarfull;408;186;222
03;Alicante/Alacant;039;Benimassot;122;62;60
03;Alicante/Alacant;040;Benimeli;329;169;160
03;Alicante/Alacant;041;Benissa;9154;4541;4613
03;Alicante/Alacant;042;Benitachell/Poble Nou de Benitatxell (el);1989;1001;988
03;Alicante/Alacant;043;Biar;3568;1720;1848
03;Alicante/Alacant;044;Bigastro;4721;2398;2323
03;Alicante/Alacant;045;Bolulla;306;152;154
03;Alicante/Alacant;046;Busot;1373;682;691
03;Alicante/Alacant;048;Callosa d'En Sarrià;6322;3178;3144
03;Alicante/Alacant;049;Callosa de Segura;15230;7556;7674
03;Alicante/Alacant;047;Calp;14216;7073;7143
03;Alicante/Alacant;050;Campello (El);15200;7546;7654
03;Alicante/Alacant;051;Campo de Mirra/Camp de Mirra (el);379;183;196
03;Alicante/Alacant;053;Castalla;7631;3764;3867
03;Alicante/Alacant;054;Castell de Castells;499;254;245
03;Alicante/Alacant;055;Catral;4881;2430;2451
03;Alicante/Alacant;052;Cañada;1088;521;567
03;Alicante/Alacant;056;Cocentaina;10737;5257;5480
03;Alicante/Alacant;057;Confrides;300;174;126
03;Alicante/Alacant;058;Cox;5750;2901;2849
03;Alicante/Alacant;059;Crevillent;23781;11945;11836
03;Alicante/Alacant;061;Daya Nueva;1189;610;579
03;Alicante/Alacant;062;Daya Vieja;183;92;91
03;Alicante/Alacant;064;Dolores;6127;3041;3086
03;Alicante/Alacant;063;Dénia;27469;13337;14132
03;Alicante/Alacant;065;Elche/Elx;191660;94407;97253
03;Alicante/Alacant;066;Elda;52751;25738;27013
03;Alicante/Alacant;067;Facheca;125;67;58
03;Alicante/Alacant;068;Famorca;73;34;39
03;Alicante/Alacant;069;Finestrat;1504;749;755
03;Alicante/Alacant;070;Formentera del Segura;2112;1038;1074
03;Alicante/Alacant;072;Gaianes;314;146;168
03;Alicante/Alacant;071;Gata de Gorgos;5070;2506;2564
03;Alicante/Alacant;073;Gorga;270;140;130
03;Alicante/Alacant;074;Granja de Rocamora;2076;1049;1027
03;Alicante/Alacant;075;Guadalest;169;88;81
03;Alicante/Alacant;076;Guardamar del Segura;8227;4077;4150
03;Alicante/Alacant;077;Hondón de las Nieves;1587;795;792
03;Alicante/Alacant;078;Hondón de los Frailes;550;273;277
03;Alicante/Alacant;079;Ibi;21076;10428;10648
03;Alicante/Alacant;080;Jacarilla;1504;766;738
03;Alicante/Alacant;081;Jalón/Xaló;2011;991;1020
03;Alicante/Alacant;083;Jijona/Xixona;7608;3582;4026
03;Alicante/Alacant;082;Jávea/Xàbia;21393;10587;10806
03;Alicante/Alacant;085;Llíber;527;261;266
03;Alicante/Alacant;084;Lorcha/Orxa (L');823;414;409
03;Alicante/Alacant;086;Millena;157;76;81
03;Alicante/Alacant;088;Monforte del Cid;5082;2635;2447
03;Alicante/Alacant;903;Montesinos (Los);2436;1223;1213
03;Alicante/Alacant;089;Monóvar/Monòver;12085;5897;6188
03;Alicante/Alacant;091;Murla;332;142;190
03;Alicante/Alacant;092;Muro de Alcoy;7104;3513;3591
03;Alicante/Alacant;090;Mutxamel;12779;6392;6387
03;Alicante/Alacant;093;Novelda;23188;11357;11831
03;Alicante/Alacant;094;Nucia (la);7010;3467;3543
03;Alicante/Alacant;095;Ondara;5149;2566;2583
03;Alicante/Alacant;096;Onil;6786;3386;3400
03;Alicante/Alacant;097;Orba;1576;772;804
03;Alicante/Alacant;099;Orihuela;50724;24978;25746
03;Alicante/Alacant;098;Orxeta;470;237;233
03;Alicante/Alacant;100;Parcent;767;377;390
03;Alicante/Alacant;101;Pedreguer;5853;2846;3007
03;Alicante/Alacant;102;Pego;10369;5219;5150
03;Alicante/Alacant;103;Penàguila;346;165;181
03;Alicante/Alacant;104;Petrer;26505;13189;13316
03;Alicante/Alacant;902;Pilar de la Horadada;9528;4983;4545
03;Alicante/Alacant;105;Pinoso;5970;2958;3012
03;Alicante/Alacant;106;Planes;822;405;417
03;Alicante/Alacant;901;Poblets (Els);1191;574;617
03;Alicante/Alacant;107;Polop;1995;975;1020
03;Alicante/Alacant;060;Quatretondeta;189;93;96
03;Alicante/Alacant;109;Rafal;3027;1498;1529
03;Alicante/Alacant;111;Redován;5268;2704;2564
03;Alicante/Alacant;112;Relleu;822;404;418
03;Alicante/Alacant;113;Rojales;7195;3553;3642
03;Alicante/Alacant;114;Romana (La);2005;1023;982
03;Alicante/Alacant;110;Ràfol d'Almúnia (El);368;178;190
03;Alicante/Alacant;115;Sagra;379;189;190
03;Alicante/Alacant;116;Salinas;1174;598;576
03;Alicante/Alacant;118;San Fulgencio;2888;1433;1455
03;Alicante/Alacant;904;San Isidro;1256;651;605
03;Alicante/Alacant;120;San Miguel de Salinas;3521;1803;1718
03;Alicante/Alacant;122;San Vicente del Raspeig/Sant Vicent del Raspeig;34986;17278;17708
03;Alicante/Alacant;117;Sanet y Negrals;566;257;309
03;Alicante/Alacant;119;Sant Joan d'Alacant;16008;7897;8111
03;Alicante/Alacant;121;Santa Pola;17099;8458;8641
03;Alicante/Alacant;123;Sax;8605;4312;4293
03;Alicante/Alacant;124;Sella;587;300;287
03;Alicante/Alacant;125;Senija;474;244;230
03;Alicante/Alacant;128;Teulada;8430;4197;4233
03;Alicante/Alacant;129;Tibi;1147;586;561
03;Alicante/Alacant;130;Tollos;47;29;18
03;Alicante/Alacant;131;Tormos;305;148;157
03;Alicante/Alacant;132;Torremanzanas/Torre de les Maçanes (la);749;368;381
03;Alicante/Alacant;133;Torrevieja;35998;17709;18289
03;Alicante/Alacant;127;Tárbena;721;360;361
03;Alicante/Alacant;134;Vall d'Alcalà (La);186;85;101
03;Alicante/Alacant;135;Vall de Ebo;343;176;167
03;Alicante/Alacant;136;Vall de Gallinera;682;346;336
03;Alicante/Alacant;137;Vall de Laguar (La);918;442;476
03;Alicante/Alacant;138;Verger (El);3627;1761;1866
03;Alicante/Alacant;139;Villajoyosa/Vila Joiosa (La);22866;11220;11646
03;Alicante/Alacant;140;Villena;31555;15517;16038
04;Almería;001;Abla;1529;754;775
04;Almería;002;Abrucena;1460;715;745
04;Almería;003;Adra;20898;10397;10501
04;Almería;004;Albánchez;626;315;311
04;Almería;005;Alboloduy;817;385;432
04;Almería;006;Albox;9456;4730;4726
04;Almería;007;Alcolea;858;440;418
04;Almería;008;Alcóntar;621;317;304
04;Almería;009;Alcudia de Monteagud;183;85;98
04;Almería;010;Alhabia;694;353;341
04;Almería;011;Alhama de Almería;3104;1548;1556
04;Almería;012;Alicún;249;121;128
04;Almería;013;Almería;170503;82674;87829
04;Almería;014;Almócita;193;99;94
04;Almería;015;Alsodux;113;54;59
04;Almería;016;Antas;2659;1314;1345
04;Almería;017;Arboleas;1550;790;760
04;Almería;018;Armuña de Almanzora;339;163;176
04;Almería;019;Bacares;287;154;133
04;Almería;020;Bayárcal;357;188;169
04;Almería;021;Bayarque;235;112;123
04;Almería;022;Bédar;552;293;259
04;Almería;023;Beires;133;64;69
04;Almería;024;Benahadux;2702;1306;1396
04;Almería;026;Benitagla;111;56;55
04;Almería;027;Benizalón;328;169;159
04;Almería;028;Bentarique;331;169;162
04;Almería;029;Berja;13043;6501;6542
04;Almería;030;Canjáyar;1783;899;884
04;Almería;031;Cantoria;3357;1694;1663
04;Almería;032;Carboneras;6215;3177;3038
04;Almería;033;Castro de Filabres;207;103;104
04;Almería;036;Chercos;289;150;139
04;Almería;037;Chirivel;1860;934;926
04;Almería;034;Cóbdar;274;139;135
04;Almería;035;Cuevas del Almanzora;9625;4843;4782
04;Almería;038;Dalías;3590;1781;1809
04;Almería;039;Darrical;76;41;35
04;Almería;902;Ejido (El);47610;24823;22787
04;Almería;041;Enix;223;113;110
04;Almería;043;Felix;562;280;282
04;Almería;044;Fines;1746;902;844
04;Almería;045;Fiñana;2644;1291;1353
04;Almería;046;Fondón;934;467;467
04;Almería;047;Gádor;2596;1287;1309
04;Almería;048;Gallardos (Los);1761;891;870
04;Almería;049;Garrucha;4867;2491;2376
04;Almería;050;Gérgal;1089;531;558
04;Almería;051;Huécija;537;269;268
04;Almería;052;Huércal de Almería;5366;2701;2665
04;Almería;053;Huércal-Overa;13756;6761;6995
04;Almería;054;Illar;489;235;254
04;Almería;055;Instinción;547;263;284
04;Almería;056;Laroya;108;54;54
04;Almería;057;Láujar de Andarax;1815;902;913
04;Almería;058;Líjar;516;257;259
04;Almería;059;Lubrín;1823;876;947
04;Almería;060;Lucainena de las Torres;588;291;297
04;Almería;061;Lúcar;799;393;406
04;Almería;062;Macael;5956;3039;2917
04;Almería;063;María;1658;849;809
04;Almería;064;Mojácar;4394;2165;2229
04;Almería;903;Mojonera (La);6460;3463;2997
04;Almería;065;Nacimiento;541;268;273
04;Almería;066;Níjar;15017;7788;7229
04;Almería;067;Ohanes;817;414;403
04;Almería;068;Olula de Castro;197;97;100
04;Almería;069;Olula del Río;6165;3099;3066
04;Almería;070;Oria;2240;1125;1115
04;Almería;071;Padules;488;242;246
04;Almería;072;Partaloa;394;191;203
04;Almería;073;Paterna del Río;335;181;154
04;Almería;074;Pechina;2564;1288;1276
04;Almería;075;Pulpí;5202;2626;2576
04;Almería;076;Purchena;1696;820;876
04;Almería;077;Rágol;395;184;211
04;Almería;078;Rioja;1180;588;592
04;Almería;079;Roquetas de Mar;37237;19061;18176
04;Almería;080;Santa Cruz de Marchena;215;98;117
04;Almería;081;Santa Fe de Mondújar;411;199;212
04;Almería;082;Senés;359;183;176
04;Almería;083;Serón;2742;1368;1374
04;Almería;084;Sierro;510;250;260
04;Almería;085;Somontín;508;255;253
04;Almería;086;Sorbas;2834;1442;1392
04;Almería;087;Suflí;233;116;117
04;Almería;088;Tabernas;3457;1729;1728
04;Almería;089;Taberno;1023;506;517
04;Almería;090;Tahal;415;217;198
04;Almería;091;Terque;444;224;220
04;Almería;092;Tíjola;3845;1940;1905
04;Almería;901;Tres Villas (Las);686;359;327
04;Almería;093;Turre;2157;1068;1089
04;Almería;094;Turrillas;289;148;141
04;Almería;095;Uleila del Campo;1007;514;493
04;Almería;096;Urrácal;345;169;176
04;Almería;097;Velefique;348;180;168
04;Almería;098;Vélez-Blanco;2317;1183;1134
04;Almería;099;Vélez-Rubio;6528;3149;3379
04;Almería;100;Vera;6453;3242;3211
04;Almería;101;Viator;3186;1569;1617
04;Almería;102;Vícar;14807;7803;7004
04;Almería;103;Zurgena;2123;1048;1075
05;Ávila;001;Adanero;332;179;153
05;Ávila;002;Adrada (La);2003;1039;964
05;Ávila;005;Albornos;276;145;131
05;Ávila;007;Aldeanueva de Santa Cruz;193;103;90
05;Ávila;008;Aldeaseca;362;183;179
05;Ávila;010;Aldehuela (La);291;141;150
05;Ávila;012;Amavida;203;101;102
05;Ávila;013;Arenal (El);1109;530;579
05;Ávila;014;Arenas de San Pedro;6609;3257;3352
05;Ávila;015;Arevalillo;152;77;75
05;Ávila;016;Arévalo;7359;3556;3803
05;Ávila;017;Aveinte;153;80;73
05;Ávila;018;Avellaneda;43;20;23
05;Ávila;019;Ávila;47187;22703;24484
05;Ávila;021;Barco de Ávila (El);2564;1251;1313
05;Ávila;022;Barraco (El);2010;1015;995
05;Ávila;023;Barromán;265;145;120
05;Ávila;024;Becedas;459;235;224
05;Ávila;025;Becedillas;182;96;86
05;Ávila;026;Bercial de Zapardiel;322;151;171
05;Ávila;027;Berlanas (Las);369;185;184
05;Ávila;029;Bernuy-Zapardiel;260;144;116
05;Ávila;030;Berrocalejo de Aragona;41;22;19
05;Ávila;033;Blascomillán;317;155;162
05;Ávila;034;Blasconuño de Matacabras;27;15;12
05;Ávila;035;Blascosancho;163;78;85
05;Ávila;036;Bohodón (El);215;107;108
05;Ávila;037;Bohoyo;504;254;250
05;Ávila;038;Bonilla de la Sierra;202;108;94
05;Ávila;039;Brabos;76;40;36
05;Ávila;040;Bularros;127;71;56
05;Ávila;041;Burgohondo;1253;634;619
05;Ávila;042;Cabezas de Alambre;257;136;121
05;Ávila;043;Cabezas del Pozo;179;102;77
05;Ávila;044;Cabezas del Villar;510;271;239
05;Ávila;045;Cabizuela;157;79;78
05;Ávila;046;Canales;68;37;31
05;Ávila;047;Candeleda;5176;2655;2521
05;Ávila;048;Cantiveros;191;96;95
05;Ávila;049;Cardeñosa;569;298;271
05;Ávila;051;Carrera (La);302;145;157
05;Ávila;052;Casas del Puerto de Villatoro;111;62;49
05;Ávila;053;Casasola;189;100;89
05;Ávila;054;Casavieja;1679;872;807
05;Ávila;055;Casillas;949;492;457
05;Ávila;056;Castellanos de Zapardiel;150;86;64
05;Ávila;057;Cebreros;3483;1747;1736
05;Ávila;058;Cepeda la Mora;150;81;69
05;Ávila;067;Chamartín;121;66;55
05;Ávila;059;Cillán;157;81;76
05;Ávila;060;Cisla;203;101;102
05;Ávila;061;Colilla (La);196;102;94
05;Ávila;062;Collado de Contreras;283;153;130
05;Ávila;063;Collado del Mirón;97;50;47
05;Ávila;064;Constanzana;203;105;98
05;Ávila;065;Crespos;779;404;375
05;Ávila;066;Cuevas del Valle;662;358;304
05;Ávila;903;Diego del Carpio;333;182;151
05;Ávila;069;Donjimeno;142;74;68
05;Ávila;070;Donvidas;70;34;36
05;Ávila;072;Espinosa de los Caballeros;114;64;50
05;Ávila;073;Flores de Ávila;453;236;217
05;Ávila;074;Fontíveros;1094;558;536
05;Ávila;075;Fresnedilla;123;55;68
05;Ávila;076;Fresno (El);441;231;210
05;Ávila;077;Fuente el Saúz;351;181;170
05;Ávila;078;Fuentes de Año;224;118;106
05;Ávila;079;Gallegos de Altamiros;109;58;51
05;Ávila;080;Gallegos de Sobrinos;114;54;60
05;Ávila;081;Garganta del Villar;84;48;36
05;Ávila;082;Gavilanes;751;432;319
05;Ávila;083;Gemuño;233;111;122
05;Ávila;085;Gil García;79;37;42
05;Ávila;084;Gilbuena;153;86;67
05;Ávila;086;Gimialcón;131;70;61
05;Ávila;087;Gotarrendura;190;72;118
05;Ávila;088;Grandes y San Martín;55;29;26
05;Ávila;089;Guisando;720;375;345
05;Ávila;090;Gutierre-Muñoz;137;68;69
05;Ávila;092;Hernansancho;235;118;117
05;Ávila;093;Herradón de Pinares;510;262;248
05;Ávila;094;Herreros de Suso;248;124;124
05;Ávila;095;Higuera de las Dueñas;320;176;144
05;Ávila;096;Hija de Dios (La);114;63;51
05;Ávila;097;Horcajada (La);861;425;436
05;Ávila;099;Horcajo de las Torres;867;476;391
05;Ávila;100;Hornillo (El);442;223;219
05;Ávila;102;Hoyo de Pinares (El);2525;1283;1242
05;Ávila;101;Hoyocasero;416;211;205
05;Ávila;103;Hoyorredondo;133;71;62
05;Ávila;106;Hoyos de Miguel Muñoz;62;33;29
05;Ávila;104;Hoyos del Collado;50;31;19
05;Ávila;105;Hoyos del Espino;400;219;181
05;Ávila;107;Hurtumpascual;119;65;54
05;Ávila;108;Junciana;100;48;52
05;Ávila;109;Langa;608;311;297
05;Ávila;110;Lanzahíta;933;485;448
05;Ávila;113;Llanos de Tormes (Los);146;76;70
05;Ávila;112;Losar del Barco (El);162;84;78
05;Ávila;114;Madrigal de las Altas Torres;2066;1056;1010
05;Ávila;115;Maello;657;326;331
05;Ávila;116;Malpartida de Corneja;239;116;123
05;Ávila;117;Mamblas;289;158;131
05;Ávila;118;Mancera de Arriba;156;76;80
05;Ávila;119;Manjabálago;78;44;34
05;Ávila;120;Marlín;53;29;24
05;Ávila;121;Martiherrero;208;116;92
05;Ávila;122;Martínez;255;132;123
05;Ávila;123;Mediana de Voltoya;111;64;47
05;Ávila;124;Medinilla;247;123;124
05;Ávila;125;Mengamuñoz;74;33;41
05;Ávila;126;Mesegar de Corneja;130;66;64
05;Ávila;127;Mijares;1031;526;505
05;Ávila;128;Mingorría;556;276;280
05;Ávila;129;Mirón (El);268;156;112
05;Ávila;130;Mironcillo;135;75;60
05;Ávila;131;Mirueña de los Infanzones;215;106;109
05;Ávila;132;Mombeltrán;1225;656;569
05;Ávila;133;Monsalupe;99;49;50
05;Ávila;134;Moraleja de Matacabras;73;35;38
05;Ávila;135;Muñana;586;303;283
05;Ávila;136;Muñico;156;83;73
05;Ávila;138;Muñogalindo;458;247;211
05;Ávila;139;Muñogrande;111;58;53
05;Ávila;140;Muñomer del Peco;143;78;65
05;Ávila;141;Muñopepe;106;56;50
05;Ávila;142;Muñosancho;180;82;98
05;Ávila;143;Muñotello;133;70;63
05;Ávila;144;Narrillos del Álamo;173;91;82
05;Ávila;145;Narrillos del Rebollar;82;41;41
05;Ávila;149;Narros de Saldueña;210;116;94
05;Ávila;147;Narros del Castillo;271;147;124
05;Ávila;148;Narros del Puerto;41;22;19
05;Ávila;152;Nava de Arévalo;1042;535;507
05;Ávila;153;Nava del Barco;202;106;96
05;Ávila;151;Navacepedilla de Corneja;150;87;63
05;Ávila;154;Navadijos;67;38;29
05;Ávila;155;Navaescurial;111;63;48
05;Ávila;156;Navahondilla;136;78;58
05;Ávila;157;Navalacruz;344;169;175
05;Ávila;158;Navalmoral;635;313;322
05;Ávila;159;Navalonguilla;469;238;231
05;Ávila;160;Navalosa;532;276;256
05;Ávila;161;Navalperal de Pinares;943;454;489
05;Ávila;162;Navalperal de Tormes;142;77;65
05;Ávila;163;Navaluenga;2034;1024;1010
05;Ávila;164;Navaquesera;44;26;18
05;Ávila;165;Navarredonda de Gredos;482;247;235
05;Ávila;166;Navarredondilla;308;151;157
05;Ávila;167;Navarrevisca;435;227;208
05;Ávila;168;Navas del Marqués (Las);4346;2176;2170
05;Ávila;169;Navatalgordo;423;208;215
05;Ávila;170;Navatejares;122;54;68
05;Ávila;171;Neila de San Miguel;135;70;65
05;Ávila;172;Niharra;204;102;102
05;Ávila;173;Ojos-Albos;53;26;27
05;Ávila;174;Orbita;111;55;56
05;Ávila;175;Oso (El);231;127;104
05;Ávila;176;Padiernos;260;135;125
05;Ávila;177;Pajares de Adaja;196;100;96
05;Ávila;178;Palacios de Goda;536;265;271
05;Ávila;179;Papatrigo;343;175;168
05;Ávila;180;Parral (El);137;75;62
05;Ávila;181;Pascualcobo;48;27;21
05;Ávila;182;Pedro Bernardo;1387;715;672
05;Ávila;183;Pedro-Rodríguez;228;112;116
05;Ávila;184;Peguerinos;326;171;155
05;Ávila;185;Peñalba de Ávila;136;78;58
05;Ávila;186;Piedrahíta;2271;1101;1170
05;Ávila;187;Piedralaves;2173;1101;1072
05;Ávila;188;Poveda;95;53;42
05;Ávila;189;Poyales del Hoyo;769;389;380
05;Ávila;190;Pozanco;58;32;26
05;Ávila;191;Pradosegar;191;102;89
05;Ávila;192;Puerto Castilla;144;80;64
05;Ávila;193;Rasueros;405;214;191
05;Ávila;194;Riocabado;212;116;96
05;Ávila;195;Riofrío;358;189;169
05;Ávila;196;Rivilla de Barajas;100;51;49
05;Ávila;197;Salobral;132;65;67
05;Ávila;198;Salvadiós;127;66;61
05;Ávila;199;San Bartolomé de Béjar;88;41;47
05;Ávila;200;San Bartolomé de Corneja;131;71;60
05;Ávila;201;San Bartolomé de Pinares;787;417;370
05;Ávila;206;San Esteban de los Patos;50;28;22
05;Ávila;208;San Esteban de Zapardiel;74;38;36
05;Ávila;207;San Esteban del Valle;954;496;458
05;Ávila;209;San García de Ingelmos;186;99;87
05;Ávila;901;San Juan de Gredos;426;217;209
05;Ávila;210;San Juan de la Encinilla;151;69;82
05;Ávila;211;San Juan de la Nava;704;367;337
05;Ávila;212;San Juan del Molinillo;342;191;151
05;Ávila;213;San Juan del Olmo;194;107;87
05;Ávila;214;San Lorenzo de Tormes;67;29;38
05;Ávila;215;San Martín de la Vega del Alberche;324;185;139
05;Ávila;216;San Martín del Pimpollar;356;192;164
05;Ávila;217;San Miguel de Corneja;132;61;71
05;Ávila;218;San Miguel de Serrezuela;232;123;109
05;Ávila;219;San Pascual;59;36;23
05;Ávila;220;San Pedro del Arroyo;478;246;232
05;Ávila;231;San Vicente de Arévalo;233;118;115
05;Ávila;204;Sanchidrián;793;401;392
05;Ávila;205;Sanchorreja;136;68;68
05;Ávila;222;Santa Cruz de Pinares;219;122;97
05;Ávila;221;Santa Cruz del Valle;656;332;324
05;Ávila;226;Santa María de los Caballeros;172;88;84
05;Ávila;224;Santa María del Arroyo;145;74;71
05;Ávila;225;Santa María del Berrocal;581;272;309
05;Ávila;902;Santa María del Cubillo;403;223;180
05;Ávila;227;Santa María del Tiétar;378;204;174
05;Ávila;228;Santiago del Collado;304;190;114
05;Ávila;904;Santiago del Tormes;323;160;163
05;Ávila;229;Santo Domingo de las Posadas;101;48;53
05;Ávila;230;Santo Tomé de Zabarcos;124;68;56
05;Ávila;232;Serrada (La);148;73;75
05;Ávila;233;Serranillos;453;239;214
05;Ávila;234;Sigeres;84;39;45
05;Ávila;235;Sinlabajos;264;137;127
05;Ávila;236;Solana de Ávila;234;126;108
05;Ávila;237;Solana de Rioalmar;304;161;143
05;Ávila;238;Solosancho;1101;578;523
05;Ávila;239;Sotalbo;266;136;130
05;Ávila;240;Sotillo de la Adrada;3507;1725;1782
05;Ávila;241;Tiemblo (El);3797;1894;1903
05;Ávila;242;Tiñosillos;765;409;356
05;Ávila;243;Tolbaños;147;73;74
05;Ávila;244;Tormellas;119;64;55
05;Ávila;245;Tornadizos de Ávila;361;179;182
05;Ávila;247;Torre (La);467;258;209
05;Ávila;246;Tórtoles;133;71;62
05;Ávila;249;Umbrías;180;93;87
05;Ávila;251;Vadillo de la Sierra;175;96;79
05;Ávila;252;Valdecasa;126;67;59
05;Ávila;253;Vega de Santa María;145;79;66
05;Ávila;254;Velayos;289;140;149
05;Ávila;256;Villaflor;175;90;85
05;Ávila;257;Villafranca de la Sierra;219;120;99
05;Ávila;905;Villanueva de Ávila;612;316;296
05;Ávila;258;Villanueva de Gómez;153;75;78
05;Ávila;259;Villanueva del Aceral;209;95;114
05;Ávila;260;Villanueva del Campillo;225;119;106
05;Ávila;261;Villar de Corneja;86;45;41
05;Ávila;262;Villarejo del Valle;510;262;248
05;Ávila;263;Villatoro;251;145;106
05;Ávila;264;Viñegra de Moraña;101;56;45
05;Ávila;265;Vita;122;75;47
05;Ávila;266;Zapardiel de la Cañada;220;112;108
05;Ávila;267;Zapardiel de la Ribera;142;72;70
06;Badajoz;001;Acedera;1023;541;482
06;Badajoz;002;Aceuchal;5201;2547;2654
06;Badajoz;003;Ahillones;1230;601;629
06;Badajoz;004;Alange;2031;1049;982
06;Badajoz;005;Albuera (La);1805;922;883
06;Badajoz;006;Alburquerque;5780;2926;2854
06;Badajoz;007;Alconchel;2347;1160;1187
06;Badajoz;008;Alconera;744;374;370
06;Badajoz;009;Aljucén;230;127;103
06;Badajoz;010;Almendral;1494;731;763
06;Badajoz;011;Almendralejo;27209;13283;13926
06;Badajoz;012;Arroyo de San Serván;4028;2051;1977
06;Badajoz;013;Atalaya;377;184;193
06;Badajoz;014;Azuaga;9274;4581;4693
06;Badajoz;015;Badajoz;122510;59198;63312
06;Badajoz;016;Barcarrota;3938;2007;1931
06;Badajoz;017;Baterno;413;210;203
06;Badajoz;018;Benquerencia de la Serena;1117;560;557
06;Badajoz;019;Berlanga;2716;1342;1374
06;Badajoz;020;Bienvenida;2371;1202;1169
06;Badajoz;021;Bodonal de la Sierra;1306;677;629
06;Badajoz;022;Burguillos del Cerro;3406;1670;1736
06;Badajoz;023;Cabeza del Buey;6222;3025;3197
06;Badajoz;024;Cabeza la Vaca;1684;831;853
06;Badajoz;025;Calamonte;5869;2948;2921
06;Badajoz;026;Calera de León;1159;579;580
06;Badajoz;027;Calzadilla de los Barros;819;407;412
06;Badajoz;028;Campanario;5915;2875;3040
06;Badajoz;029;Campillo de Llerena;1830;895;935
06;Badajoz;030;Capilla;227;105;122
06;Badajoz;031;Carmonita;685;356;329
06;Badajoz;032;Carrascalejo (El);34;18;16
06;Badajoz;033;Casas de Don Pedro;1827;910;917
06;Badajoz;034;Casas de Reina;254;119;135
06;Badajoz;035;Castilblanco;1403;699;704
06;Badajoz;036;Castuera;7951;4015;3936
06;Badajoz;042;Cheles;1379;687;692
06;Badajoz;037;Codosera (La);2406;1239;1167
06;Badajoz;038;Cordobilla de Lácara;1030;530;500
06;Badajoz;039;Coronada (La);2513;1255;1258
06;Badajoz;040;Corte de Peleas;1312;662;650
06;Badajoz;041;Cristina;558;297;261
06;Badajoz;043;Don Álvaro;680;334;346
06;Badajoz;044;Don Benito;31022;15333;15689
06;Badajoz;045;Entrín Bajo;684;338;346
06;Badajoz;046;Esparragalejo;1565;766;799
06;Badajoz;047;Esparragosa de la Serena;1146;570;576
06;Badajoz;048;Esparragosa de Lares;1247;617;630
06;Badajoz;049;Feria;1412;705;707
06;Badajoz;050;Fregenal de la Sierra;5416;2631;2785
06;Badajoz;051;Fuenlabrada de los Montes;2103;1037;1066
06;Badajoz;052;Fuente de Cantos;5075;2570;2505
06;Badajoz;053;Fuente del Arco;844;418;426
06;Badajoz;054;Fuente del Maestre;6876;3419;3457
06;Badajoz;055;Fuentes de León;2851;1379;1472
06;Badajoz;056;Garbayuela;605;319;286
06;Badajoz;057;Garlitos;796;409;387
06;Badajoz;058;Garrovilla (La);2710;1403;1307
06;Badajoz;059;Granja de Torrehermosa;2688;1355;1333
06;Badajoz;060;Guareña;7404;3746;3658
06;Badajoz;061;Haba (La);1491;750;741
06;Badajoz;062;Helechosa de los Montes;812;434;378
06;Badajoz;063;Herrera del Duque;4060;2052;2008
06;Badajoz;064;Higuera de la Serena;1294;653;641
06;Badajoz;065;Higuera de Llerena;495;240;255
06;Badajoz;066;Higuera de Vargas;2360;1193;1167
06;Badajoz;067;Higuera la Real;2854;1416;1438
06;Badajoz;068;Hinojosa del Valle;616;320;296
06;Badajoz;069;Hornachos;3731;1905;1826
06;Badajoz;070;Jerez de los Caballeros;9429;4704;4725
06;Badajoz;071;Lapa (La);352;178;174
06;Badajoz;073;Llera;1037;540;497
06;Badajoz;074;Llerena;5730;2775;2955
06;Badajoz;072;Lobón;2718;1392;1326
06;Badajoz;075;Magacela;751;388;363
06;Badajoz;076;Maguilla;1171;591;580
06;Badajoz;077;Malcocinado;570;298;272
06;Badajoz;078;Malpartida de la Serena;831;427;404
06;Badajoz;079;Manchita;770;390;380
06;Badajoz;080;Medellín;2487;1248;1239
06;Badajoz;081;Medina de las Torres;1589;795;794
06;Badajoz;082;Mengabril;458;230;228
06;Badajoz;083;Mérida;51830;25381;26449
06;Badajoz;084;Mirandilla;1329;675;654
06;Badajoz;085;Monesterio;5120;2568;2552
06;Badajoz;086;Montemolín;1765;883;882
06;Badajoz;087;Monterrubio de la Serena;3210;1566;1644
06;Badajoz;088;Montijo;15480;7629;7851
06;Badajoz;089;Morera (La);772;383;389
06;Badajoz;090;Nava de Santiago (La);1173;591;582
06;Badajoz;091;Navalvillar de Pela;5083;2567;2516
06;Badajoz;092;Nogales;816;405;411
06;Badajoz;093;Oliva de la Frontera;6065;3035;3030
06;Badajoz;094;Oliva de Mérida;2052;1026;1026
06;Badajoz;095;Olivenza;10499;5173;5326
06;Badajoz;096;Orellana de la Sierra;416;211;205
06;Badajoz;097;Orellana la Vieja;3835;1924;1911
06;Badajoz;098;Palomas;708;380;328
06;Badajoz;099;Parra (La);1419;725;694
06;Badajoz;100;Peñalsordo;1672;797;875
06;Badajoz;101;Peraleda del Zaucejo;690;352;338
06;Badajoz;102;Puebla de Alcocer;1550;768;782
06;Badajoz;103;Puebla de la Calzada;5481;2716;2765
06;Badajoz;104;Puebla de la Reina;894;453;441
06;Badajoz;107;Puebla de Obando;2020;1022;998
06;Badajoz;108;Puebla de Sancho Pérez;3053;1537;1516
06;Badajoz;105;Puebla del Maestre;975;480;495
06;Badajoz;106;Puebla del Prior;602;303;299
06;Badajoz;902;Pueblonuevo del Guadiana;"";"";""
06;Badajoz;109;Quintana de la Serena;5405;2711;2694
06;Badajoz;110;Reina;245;131;114
06;Badajoz;111;Rena;677;345;332
06;Badajoz;112;Retamal de Llerena;604;310;294
06;Badajoz;113;Ribera del Fresno;3443;1664;1779
06;Badajoz;114;Risco;249;121;128
06;Badajoz;115;Roca de la Sierra (La);1629;798;831
06;Badajoz;116;Salvaleón;2350;1188;1162
06;Badajoz;117;Salvatierra de los Barros;2012;998;1014
06;Badajoz;119;San Pedro de Mérida;798;416;382
06;Badajoz;123;San Vicente de Alcántara;6021;2984;3037
06;Badajoz;118;Sancti-Spíritus;373;171;202
06;Badajoz;120;Santa Amalia;4347;2174;2173
06;Badajoz;121;Santa Marta;4084;2030;2054
06;Badajoz;122;Santos de Maimona (Los);8004;3994;4010
06;Badajoz;124;Segura de León;2325;1156;1169
06;Badajoz;125;Siruela;2509;1232;1277
06;Badajoz;126;Solana de los Barros;2877;1454;1423
06;Badajoz;127;Talarrubias;3751;1851;1900
06;Badajoz;128;Talavera la Real;5288;2684;2604
06;Badajoz;129;Táliga;773;397;376
06;Badajoz;130;Tamurejo;286;143;143
06;Badajoz;131;Torre de Miguel Sesmero;1275;626;649
06;Badajoz;132;Torremayor;1131;561;570
06;Badajoz;133;Torremejía;2017;1018;999
06;Badajoz;134;Trasierra;702;372;330
06;Badajoz;135;Trujillanos;1257;654;603
06;Badajoz;136;Usagre;2123;1074;1049
06;Badajoz;137;Valdecaballeros;1449;720;729
06;Badajoz;901;Valdelacalzada;2580;1333;1247
06;Badajoz;138;Valdetorres;1385;703;682
06;Badajoz;139;Valencia de las Torres;878;440;438
06;Badajoz;140;Valencia del Mombuey;874;429;445
06;Badajoz;141;Valencia del Ventoso;2445;1211;1234
06;Badajoz;146;Valle de la Serena;1662;813;849
06;Badajoz;147;Valle de Matamoros;540;261;279
06;Badajoz;148;Valle de Santa Ana;1288;655;633
06;Badajoz;142;Valverde de Burguillos;405;207;198
06;Badajoz;143;Valverde de Leganés;3705;1886;1819
06;Badajoz;144;Valverde de Llerena;885;438;447
06;Badajoz;145;Valverde de Mérida;1124;569;555
06;Badajoz;149;Villafranca de los Barros;12391;6085;6306
06;Badajoz;150;Villagarcía de la Torre;1056;538;518
06;Badajoz;151;Villagonzalo;1515;734;781
06;Badajoz;152;Villalba de los Barros;1748;897;851
06;Badajoz;153;Villanueva de la Serena;23833;11746;12087
06;Badajoz;154;Villanueva del Fresno;3449;1735;1714
06;Badajoz;156;Villar de Rena;1737;916;821
06;Badajoz;155;Villar del Rey;2347;1211;1136
06;Badajoz;157;Villarta de los Montes;740;369;371
06;Badajoz;158;Zafra;14884;7148;7736
06;Badajoz;159;Zahínos;3211;1608;1603
06;Badajoz;160;Zalamea de la Serena;5063;2502;2561
06;Badajoz;162;Zarza (La);3688;1858;1830
06;Badajoz;161;Zarza-Capilla;545;283;262
07;Balears (Illes);002;Alaior;6705;3320;3385
07;Balears (Illes);001;Alaró;3840;1836;2004
07;Balears (Illes);003;Alcúdia;10284;5169;5115
07;Balears (Illes);004;Algaida;3461;1716;1745
07;Balears (Illes);005;Andratx;8098;4044;4054
07;Balears (Illes);901;Ariany;801;372;429
07;Balears (Illes);006;Artà;5971;2969;3002
07;Balears (Illes);007;Banyalbufar;520;266;254
07;Balears (Illes);008;Binissalem;4885;2366;2519
07;Balears (Illes);009;Búger;926;458;468
07;Balears (Illes);010;Bunyola;4332;2151;2181
07;Balears (Illes);011;Calvià;28748;14402;14346
07;Balears (Illes);012;Campanet;2255;1104;1151
07;Balears (Illes);013;Campos;6735;3339;3396
07;Balears (Illes);014;Capdepera;6321;3155;3166
07;Balears (Illes);064;Castell (Es);5720;2849;2871
07;Balears (Illes);015;Ciutadella de Menorca;21296;10603;10693
07;Balears (Illes);016;Consell;2172;1062;1110
07;Balears (Illes);017;Costitx;824;405;419
07;Balears (Illes);018;Deyá;583;296;287
07;Balears (Illes);026;Eivissa;29447;14597;14850
07;Balears (Illes);019;Escorca;302;163;139
07;Balears (Illes);020;Esporles;3507;1727;1780
07;Balears (Illes);021;Estellencs;354;181;173
07;Balears (Illes);022;Felanitx;14123;6986;7137
07;Balears (Illes);023;Ferreries;3828;1998;1830
07;Balears (Illes);024;Formentera;5353;2697;2656
07;Balears (Illes);025;Fornalutx;507;249;258
07;Balears (Illes);027;Inca;21129;10348;10781
07;Balears (Illes);028;Lloret de Vistalegre;818;406;412
07;Balears (Illes);029;Lloseta;4544;2250;2294
07;Balears (Illes);030;Llubí;1904;925;979
07;Balears (Illes);031;Llucmajor;20474;10141;10333
07;Balears (Illes);032;Maó;21884;10648;11236
07;Balears (Illes);033;Manacor;30018;14888;15130
07;Balears (Illes);034;Mancor de la Vall;903;439;464
07;Balears (Illes);035;Maria de la Salut;1763;864;899
07;Balears (Illes);036;Marratxí;16180;8112;8068
07;Balears (Illes);037;Mercadal (Es);2572;1281;1291
07;Balears (Illes);902;Migjorn Gran (Es);1076;550;526
07;Balears (Illes);038;Montuïri;2190;1070;1120
07;Balears (Illes);039;Muro;6060;2988;3072
07;Balears (Illes);040;Palma de Mallorca;304250;147128;157122
07;Balears (Illes);041;Petra;2592;1261;1331
07;Balears (Illes);044;Pobla (Sa);10213;5272;4941
07;Balears (Illes);042;Pollença;12945;6430;6515
07;Balears (Illes);043;Porreres;4217;2099;2118
07;Balears (Illes);045;Puigpunyent;1084;535;549
07;Balears (Illes);059;Salines (Ses);3009;1521;1488
07;Balears (Illes);046;Sant Antoni de Portmany;14292;7165;7127
07;Balears (Illes);049;Sant Joan;1655;813;842
07;Balears (Illes);050;Sant Joan de Labritja;3835;1938;1897
07;Balears (Illes);048;Sant Josep de sa Talaia;11841;6051;5790
07;Balears (Illes);051;Sant Llorenç des Cardassar;5282;2614;2668
07;Balears (Illes);052;Sant Lluís;3928;1977;1951
07;Balears (Illes);053;Santa Eugènia;1033;514;519
07;Balears (Illes);054;Santa Eulalia del Río;19452;9795;9657
07;Balears (Illes);055;Santa Margalida;6789;3345;3444
07;Balears (Illes);056;Santa María del Camí;4394;2176;2218
07;Balears (Illes);057;Santanyí;7702;3862;3840
07;Balears (Illes);058;Selva;2901;1420;1481
07;Balears (Illes);047;Sencelles;1896;960;936
07;Balears (Illes);060;Sineu;2568;1268;1300
07;Balears (Illes);061;Sóller;10515;5165;5350
07;Balears (Illes);062;Son Servera;6872;3403;3469
07;Balears (Illes);063;Valldemossa;1511;719;792
07;Balears (Illes);065;Vilafranca de Bonany;2190;1070;1120
08;Barcelona;001;Abrera;7003;3593;3410
08;Barcelona;002;Aguilar de Segarra;206;100;106
08;Barcelona;014;Aiguafreda;2090;1019;1071
08;Barcelona;003;Alella;7696;3768;3928
08;Barcelona;004;Alpens;256;139;117
08;Barcelona;005;Ametlla del Vallès (L');4771;2328;2443
08;Barcelona;006;Arenys de Mar;11827;5672;6155
08;Barcelona;007;Arenys de Munt;5483;2697;2786
08;Barcelona;008;Argençola;163;84;79
08;Barcelona;009;Argentona;8676;4316;4360
08;Barcelona;010;Artés;4308;2133;2175
08;Barcelona;011;Avià;1810;912;898
08;Barcelona;012;Avinyó;2003;989;1014
08;Barcelona;013;Avinyonet del Penedès;1185;615;570
08;Barcelona;015;Badalona;210987;104191;106796
08;Barcelona;904;Badia del Vallès;17058;8596;8462
08;Barcelona;016;Bagà;2114;1020;1094
08;Barcelona;017;Balenyà;3025;1514;1511
08;Barcelona;018;Balsareny;3304;1622;1682
08;Barcelona;252;Barberà del Vallès;25484;12835;12649
08;Barcelona;019;Barcelona;1508805;704977;803828
08;Barcelona;020;Begues;3105;1581;1524
08;Barcelona;021;Bellprat;87;48;39
08;Barcelona;022;Berga;14207;6933;7274
08;Barcelona;023;Bigues i Riells;3969;2036;1933
08;Barcelona;024;Borredà;471;223;248
08;Barcelona;025;Bruc (El);876;447;429
08;Barcelona;026;Brull (El);196;105;91
08;Barcelona;027;Cabanyes (Les);468;253;215
08;Barcelona;029;Cabrera de Mar;3417;1730;1687
08;Barcelona;028;Cabrera d'Igualada;341;189;152
08;Barcelona;030;Cabrils;3756;1805;1951
08;Barcelona;031;Calaf;3148;1541;1607
08;Barcelona;034;Calders;647;339;308
08;Barcelona;033;Caldes de Montbui;12788;6299;6489
08;Barcelona;032;Caldes d'Estrac;1751;837;914
08;Barcelona;035;Calella;11687;5521;6166
08;Barcelona;037;Calldetenes;1802;912;890
08;Barcelona;038;Callús;1345;660;685
08;Barcelona;036;Calonge de Segarra;185;100;85
08;Barcelona;039;Campins;242;114;128
08;Barcelona;040;Canet de Mar;9455;4611;4844
08;Barcelona;041;Canovelles;13287;6668;6619
08;Barcelona;042;Cànoves i Samalús;1552;787;765
08;Barcelona;043;Canyelles;1291;689;602
08;Barcelona;044;Capellades;5021;2442;2579
08;Barcelona;045;Capolat;69;40;29
08;Barcelona;046;Cardedeu;10805;5373;5432
08;Barcelona;047;Cardona;5882;2849;3033
08;Barcelona;048;Carme;685;353;332
08;Barcelona;049;Casserres;1612;773;839
08;Barcelona;057;Castell de l'Areny;52;32;20
08;Barcelona;052;Castellar de n'Hug;172;88;84
08;Barcelona;050;Castellar del Riu;91;53;38
08;Barcelona;051;Castellar del Vallès;15845;7906;7939
08;Barcelona;053;Castellbell i el Vilar;2789;1381;1408
08;Barcelona;054;Castellbisbal;6271;3221;3050
08;Barcelona;055;Castellcir;307;168;139
08;Barcelona;056;Castelldefels;38509;19188;19321
08;Barcelona;058;Castellet i la Gornal;1241;622;619
08;Barcelona;060;Castellfollit de Riubregós;238;116;122
08;Barcelona;059;Castellfollit del Boix;337;168;169
08;Barcelona;061;Castellgalí;782;398;384
08;Barcelona;062;Castellnou de Bages;378;200;178
08;Barcelona;063;Castellolí;424;218;206
08;Barcelona;064;Castellterçol;1970;956;1014
08;Barcelona;065;Castellví de la Marca;1461;741;720
08;Barcelona;066;Castellví de Rosanes;933;478;455
08;Barcelona;067;Centelles;5771;2846;2925
08;Barcelona;268;Cercs;1496;730;766
08;Barcelona;266;Cerdanyola del Vallès;50503;25310;25193
08;Barcelona;068;Cervelló;7069;3549;3520
08;Barcelona;069;Collbató;1566;842;724
08;Barcelona;070;Collsuspina;246;126;120
08;Barcelona;071;Copons;265;129;136
08;Barcelona;072;Corbera de Llobregat;7600;3844;3756
08;Barcelona;073;Cornellà de Llobregat;82490;40558;41932
08;Barcelona;074;Cubelles;4715;2144;2571
08;Barcelona;075;Dosrius;2269;1192;1077
08;Barcelona;076;Esparreguera;14501;7262;7239
08;Barcelona;077;Esplugues de Llobregat;46810;23092;23718
08;Barcelona;078;Espunyola (L');283;146;137
08;Barcelona;079;Estany (L');382;184;198
08;Barcelona;134;Figaró-Montmany;763;388;375
08;Barcelona;080;Fígols;53;30;23
08;Barcelona;082;Fogars de la Selva;573;297;276
08;Barcelona;081;Fogars de Montclús;313;165;148
08;Barcelona;083;Folgueroles;1322;657;665
08;Barcelona;084;Fonollosa;816;410;406
08;Barcelona;085;Font-rubí;1186;612;574
08;Barcelona;086;Franqueses del Vallès (Les);10810;5426;5384
08;Barcelona;090;Gaià;160;86;74
08;Barcelona;087;Gallifa;150;82;68
08;Barcelona;088;Garriga (La);10476;5059;5417
08;Barcelona;089;Gavà;37985;18925;19060
08;Barcelona;091;Gelida;3903;1917;1986
08;Barcelona;092;Gironella;5037;2446;2591
08;Barcelona;093;Gisclareny;30;16;14
08;Barcelona;094;Granada (La);1299;626;673
08;Barcelona;095;Granera;57;35;22
08;Barcelona;096;Granollers;50951;24894;26057
08;Barcelona;097;Gualba;685;352;333
08;Barcelona;099;Guardiola de Berguedà;1014;508;506
08;Barcelona;100;Gurb;1823;928;895
08;Barcelona;101;Hospitalet de Llobregat (L');255050;124948;130102
08;Barcelona;162;Hostalets de Pierola (Els);1138;581;557
08;Barcelona;102;Igualada;32512;15737;16775
08;Barcelona;103;Jorba;561;269;292
08;Barcelona;104;Llacuna (La);842;436;406
08;Barcelona;105;Llagosta (La);11264;5574;5690
08;Barcelona;107;Lliçà d'Amunt;7668;3965;3703
08;Barcelona;108;Lliçà de Vall;4513;2310;2203
08;Barcelona;106;Llinars del Vallès;6040;3109;2931
08;Barcelona;109;Lluçà;272;148;124
08;Barcelona;110;Malgrat de Mar;12707;6276;6431
08;Barcelona;111;Malla;255;125;130
08;Barcelona;112;Manlleu;17035;8431;8604
08;Barcelona;113;Manresa;64385;30926;33459
08;Barcelona;242;Marganell;215;93;122
08;Barcelona;114;Martorell;17822;8905;8917
08;Barcelona;115;Martorelles;4937;2504;2433
08;Barcelona;116;Masies de Roda (Les);637;314;323
08;Barcelona;117;Masies de Voltregà (Les);2585;1272;1313
08;Barcelona;118;Masnou (El);20387;9829;10558
08;Barcelona;119;Masquefa;3369;1687;1682
08;Barcelona;120;Matadepera;6082;3065;3017
08;Barcelona;121;Mataró;102018;49976;52042
08;Barcelona;122;Mediona;1248;640;608
08;Barcelona;138;Moià;3806;1870;1936
08;Barcelona;123;Molins de Rei;18752;9231;9521
08;Barcelona;124;Mollet del Vallès;41911;20935;20976
08;Barcelona;128;Monistrol de Calders;597;294;303
08;Barcelona;127;Monistrol de Montserrat;2508;1267;1241
08;Barcelona;125;Montcada i Reixac;27068;13413;13655
08;Barcelona;130;Montclar;128;65;63
08;Barcelona;131;Montesquiu;850;422;428
08;Barcelona;126;Montgat;7659;3750;3909
08;Barcelona;132;Montmajor;499;254;245
08;Barcelona;133;Montmaneu;217;119;98
08;Barcelona;135;Montmeló;7675;3790;3885
08;Barcelona;136;Montornès del Vallès;11970;6001;5969
08;Barcelona;137;Montseny;286;152;134
08;Barcelona;129;Muntanyola;242;131;111
08;Barcelona;139;Mura;218;116;102
08;Barcelona;140;Navarcles;5225;2579;2646
08;Barcelona;141;Navàs;5812;2871;2941
08;Barcelona;142;Nou de Berguedà (La);155;84;71
08;Barcelona;143;Òdena;2656;1327;1329
08;Barcelona;145;Olèrdola;1893;967;926
08;Barcelona;146;Olesa de Bonesvalls;719;377;342
08;Barcelona;147;Olesa de Montserrat;15797;7907;7890
08;Barcelona;148;Olivella;954;519;435
08;Barcelona;149;Olost;1204;590;614
08;Barcelona;144;Olvan;950;460;490
08;Barcelona;150;Orís;230;118;112
08;Barcelona;151;Oristà;665;329;336
08;Barcelona;152;Orpí;149;78;71
08;Barcelona;153;Òrrius;420;217;203
08;Barcelona;154;Pacs del Penedès;620;314;306
08;Barcelona;155;Palafolls;4069;2025;2044
08;Barcelona;156;Palau-solità i Plegamans;9689;4936;4753
08;Barcelona;157;Pallejà;6846;3414;3432
08;Barcelona;905;Palma de Cervelló (La);"";"";""
08;Barcelona;158;Papiol (El);3434;1691;1743
08;Barcelona;159;Parets del Vallès;12601;6361;6240
08;Barcelona;160;Perafita;319;160;159
08;Barcelona;161;Piera;7574;3836;3738
08;Barcelona;163;Pineda de Mar;17884;8891;8993
08;Barcelona;164;Pla del Penedès (El);953;475;478
08;Barcelona;165;Pobla de Claramunt (La);1687;851;836
08;Barcelona;166;Pobla de Lillet (La);1566;765;801
08;Barcelona;167;Polinyà;3956;2030;1926
08;Barcelona;182;Pont de Vilomara i Rocafort (El);2396;1206;1190
08;Barcelona;168;Pontons;291;154;137
08;Barcelona;169;Prat de Llobregat (El);63255;31558;31697
08;Barcelona;171;Prats de Lluçanès;2790;1374;1416
08;Barcelona;170;Prats de Rei (Els);552;273;279
08;Barcelona;230;Premià de Dalt;7774;3899;3875
08;Barcelona;172;Premià de Mar;24420;12205;12215
08;Barcelona;174;Puigdàlber;319;146;173
08;Barcelona;175;Puig-reig;4578;2210;2368
08;Barcelona;176;Pujalt;179;91;88
08;Barcelona;177;Quar (La);56;29;27
08;Barcelona;178;Rajadell;336;179;157
08;Barcelona;179;Rellinars;326;164;162
08;Barcelona;180;Ripollet;28903;14458;14445
08;Barcelona;181;Roca del Vallès (La);6728;3360;3368
08;Barcelona;183;Roda de Ter;5002;2411;2591
08;Barcelona;184;Rubí;54085;27058;27027
08;Barcelona;185;Rubió;121;62;59
08;Barcelona;901;Rupit i Pruit;357;179;178
08;Barcelona;187;Sabadell;185798;90347;95451
08;Barcelona;188;Sagàs;162;85;77
08;Barcelona;190;Saldes;348;193;155
08;Barcelona;191;Sallent;7360;3553;3807
08;Barcelona;194;Sant Adrià de Besòs;33361;16475;16886
08;Barcelona;195;Sant Agustí de Lluçanès;105;54;51
08;Barcelona;196;Sant Andreu de la Barca;18332;9347;8985
08;Barcelona;197;Sant Andreu de Llavaneres;6194;3074;3120
08;Barcelona;198;Sant Antoni de Vilamajor;2822;1391;1431
08;Barcelona;199;Sant Bartomeu del Grau;1215;649;566
08;Barcelona;200;Sant Boi de Llobregat;78005;38883;39122
08;Barcelona;201;Sant Boi de Lluçanès;565;274;291
08;Barcelona;203;Sant Cebrià de Vallalta;1322;719;603
08;Barcelona;202;Sant Celoni;12890;6420;6470
08;Barcelona;204;Sant Climent de Llobregat;2476;1220;1256
08;Barcelona;205;Sant Cugat del Vallès;47210;23318;23892
08;Barcelona;206;Sant Cugat Sesgarrigues;752;403;349
08;Barcelona;207;Sant Esteve de Palautordera;1282;650;632
08;Barcelona;208;Sant Esteve Sesrovires;4486;2497;1989
08;Barcelona;210;Sant Feliu de Codines;4007;1956;2051
08;Barcelona;211;Sant Feliu de Llobregat;35797;17647;18150
08;Barcelona;212;Sant Feliu Sasserra;642;319;323
08;Barcelona;209;Sant Fost de Campsentelles;5711;2890;2821
08;Barcelona;213;Sant Fruitós de Bages;5300;2643;2657
08;Barcelona;215;Sant Hipòlit de Voltregà;2909;1425;1484
08;Barcelona;193;Sant Iscle de Vallalta;712;374;338
08;Barcelona;216;Sant Jaume de Frontanyà;30;16;14
08;Barcelona;218;Sant Joan de Vilatorrada;8446;4227;4219
08;Barcelona;217;Sant Joan Despí;26805;13226;13579
08;Barcelona;903;Sant Julià de Cerdanyola;217;114;103
08;Barcelona;220;Sant Julià de Vilatorta;2063;1005;1058
08;Barcelona;221;Sant Just Desvern;13306;6408;6898
08;Barcelona;222;Sant Llorenç d'Hortons;1301;660;641
08;Barcelona;223;Sant Llorenç Savall;2037;988;1049
08;Barcelona;225;Sant Martí d'Albars;125;65;60
08;Barcelona;224;Sant Martí de Centelles;683;345;338
08;Barcelona;226;Sant Martí de Tous;946;469;477
08;Barcelona;227;Sant Martí Sarroca;2486;1261;1225
08;Barcelona;228;Sant Martí Sesgueioles;371;183;188
08;Barcelona;229;Sant Mateu de Bages;513;263;250
08;Barcelona;231;Sant Pere de Ribes;18695;9403;9292
08;Barcelona;232;Sant Pere de Riudebitlles;2144;1055;1089
08;Barcelona;233;Sant Pere de Torelló;2135;1021;1114
08;Barcelona;234;Sant Pere de Vilamajor;1882;966;916
08;Barcelona;189;Sant Pere Sallavinera;167;82;85
08;Barcelona;235;Sant Pol de Mar;2819;1421;1398
08;Barcelona;236;Sant Quintí de Mediona;1568;773;795
08;Barcelona;237;Sant Quirze de Besora;2011;987;1024
08;Barcelona;238;Sant Quirze del Vallès;10342;5126;5216
08;Barcelona;239;Sant Quirze Safaja;282;149;133
08;Barcelona;240;Sant Sadurní d'Anoia;9205;4586;4619
08;Barcelona;241;Sant Sadurní d'Osormort;74;39;35
08;Barcelona;098;Sant Salvador de Guardiola;1651;829;822
08;Barcelona;262;Sant Vicenç de Castellet;7419;3547;3872
08;Barcelona;264;Sant Vicenç de Montalt;2248;1120;1128
08;Barcelona;265;Sant Vicenç de Torelló;1725;819;906
08;Barcelona;263;Sant Vicenç dels Horts;22621;11363;11258
08;Barcelona;243;Santa Cecilia de Voltregà;199;111;88
08;Barcelona;244;Santa Coloma de Cervelló;3358;1647;1711
08;Barcelona;245;Santa Coloma de Gramenet;123175;61267;61908
08;Barcelona;246;Santa Eugènia de Berga;1905;970;935
08;Barcelona;247;Santa Eulàlia de Riuprimer;845;434;411
08;Barcelona;248;Santa Eulàlia de Ronçana;4049;2051;1998
08;Barcelona;249;Santa Fe del Penedès;233;111;122
08;Barcelona;250;Santa Margarida de Montbui;9113;4548;4565
08;Barcelona;251;Santa Margarida i els Monjos;4230;2149;2081
08;Barcelona;253;Santa Maria de Besora;166;84;82
08;Barcelona;254;Santa Maria de Corcó;2038;1022;1016
08;Barcelona;256;Santa Maria de Martorelles;658;315;343
08;Barcelona;255;Santa Maria de Merlès;183;91;92
08;Barcelona;257;Santa Maria de Miralles;96;49;47
08;Barcelona;259;Santa Maria de Palautordera;5456;2739;2717
08;Barcelona;258;Santa Maria d'Oló;990;508;482
08;Barcelona;260;Santa Perpètua de Mogoda;18124;9180;8944
08;Barcelona;261;Santa Susanna;1453;722;731
08;Barcelona;192;Santpedor;5062;2482;2580
08;Barcelona;267;Sentmenat;5253;2606;2647
08;Barcelona;269;Seva;2238;1133;1105
08;Barcelona;270;Sitges;16801;8323;8478
08;Barcelona;271;Sobremunt;90;41;49
08;Barcelona;272;Sora;181;97;84
08;Barcelona;273;Subirats;2307;1162;1145
08;Barcelona;274;Súria;6282;3082;3200
08;Barcelona;276;Tagamanent;180;99;81
08;Barcelona;277;Talamanca;84;45;39
08;Barcelona;278;Taradell;4755;2349;2406
08;Barcelona;275;Tavèrnoles;241;114;127
08;Barcelona;280;Tavertet;133;67;66
08;Barcelona;281;Teià;4669;2370;2299
08;Barcelona;279;Terrassa;163862;79779;84083
08;Barcelona;282;Tiana;5172;2571;2601
08;Barcelona;283;Tona;5765;2839;2926
08;Barcelona;284;Tordera;8918;4497;4421
08;Barcelona;285;Torelló;11952;5822;6130
08;Barcelona;286;Torre de Claramunt (La);2011;1044;967
08;Barcelona;287;Torrelavit;1176;600;576
08;Barcelona;288;Torrelles de Foix;1603;847;756
08;Barcelona;289;Torrelles de Llobregat;3114;1559;1555
08;Barcelona;290;Ullastrell;961;490;471
08;Barcelona;291;Vacarisses;1711;902;809
08;Barcelona;292;Vallbona d'Anoia;1037;521;516
08;Barcelona;293;Vallcebre;274;151;123
08;Barcelona;294;Vallgorguina;1065;533;532
08;Barcelona;295;Vallirana;8407;4237;4170
08;Barcelona;296;Vallromanes;1079;554;525
08;Barcelona;297;Veciana;173;90;83
08;Barcelona;298;Vic;30397;14597;15800
08;Barcelona;299;Vilada;548;280;268
08;Barcelona;301;Viladecans;53235;26781;26454
08;Barcelona;300;Viladecavalls;4882;2445;2437
08;Barcelona;305;Vilafranca del Penedès;28553;13964;14589
08;Barcelona;306;Vilalba Sasserra;338;173;165
08;Barcelona;303;Vilanova de Sau;311;146;165
08;Barcelona;302;Vilanova del Camí;10060;5063;4997
08;Barcelona;902;Vilanova del Vallès;1999;1010;989
08;Barcelona;307;Vilanova i la Geltrú;47979;23572;24407
08;Barcelona;214;Vilassar de Dalt;7208;3513;3695
08;Barcelona;219;Vilassar de Mar;14821;7295;7526
08;Barcelona;304;Vilobí del Penedès;852;437;415
08;Barcelona;308;Viver i Serrateix;191;100;91
09;Burgos;001;Abajas;37;18;19
09;Burgos;003;Adrada de Haza;307;165;142
09;Burgos;006;Aguas Cándidas;96;52;44
09;Burgos;007;Aguilar de Bureba;97;53;44
09;Burgos;009;Albillos;162;90;72
09;Burgos;010;Alcocero de Mola;63;39;24
09;Burgos;011;Alfoz de Bricia;146;68;78
09;Burgos;907;Alfoz de Quintanadueñas;579;300;279
09;Burgos;012;Alfoz de Santa Gadea;156;83;73
09;Burgos;013;Altable;63;39;24
09;Burgos;014;Altos (Los);245;136;109
09;Burgos;016;Ameyugo;51;27;24
09;Burgos;017;Anguix;162;81;81
09;Burgos;018;Aranda de Duero;29222;14518;14704
09;Burgos;019;Arandilla;198;113;85
09;Burgos;020;Arauzo de Miel;409;223;186
09;Burgos;021;Arauzo de Salce;83;48;35
09;Burgos;022;Arauzo de Torre;113;60;53
09;Burgos;023;Arcos;249;135;114
09;Burgos;024;Arenillas de Riopisuerga;235;126;109
09;Burgos;025;Arija;261;125;136
09;Burgos;026;Arlanzón;439;232;207
09;Burgos;027;Arraya de Oca;53;27;26
09;Burgos;029;Atapuerca;202;107;95
09;Burgos;030;Ausines (Los);140;78;62
09;Burgos;032;Avellanosa de Muñó;175;94;81
09;Burgos;033;Bahabón de Esgueva;156;89;67
09;Burgos;034;Balbases (Los);390;200;190
09;Burgos;035;Baños de Valdearados;512;282;230
09;Burgos;036;Bañuelos de Bureba;51;31;20
09;Burgos;037;Barbadillo de Herreros;168;94;74
09;Burgos;038;Barbadillo del Mercado;183;105;78
09;Burgos;039;Barbadillo del Pez;118;61;57
09;Burgos;041;Barrio de Muñó;35;21;14
09;Burgos;043;Barrios de Bureba (Los);280;148;132
09;Burgos;044;Barrios de Colina;80;46;34
09;Burgos;045;Basconcillos del Tozo;403;217;186
09;Burgos;046;Bascuñana;74;41;33
09;Burgos;047;Belbimbre;75;39;36
09;Burgos;048;Belorado;2135;1076;1059
09;Burgos;050;Berberana;88;44;44
09;Burgos;051;Berlangas de Roa;282;147;135
09;Burgos;052;Berzosa de Bureba;60;34;26
09;Burgos;054;Bozoó;105;58;47
09;Burgos;055;Brazacorta;112;63;49
09;Burgos;056;Briviesca;6101;3016;3085
09;Burgos;057;Bugedo;104;78;26
09;Burgos;058;Buniel;173;96;77
09;Burgos;059;Burgos;163156;78917;84239
09;Burgos;060;Busto de Bureba;267;140;127
09;Burgos;061;Cabañes de Esgueva;303;157;146
09;Burgos;062;Cabezón de la Sierra;80;37;43
09;Burgos;063;Cabia;239;124;115
09;Burgos;064;Caleruega;443;233;210
09;Burgos;065;Campillo de Aranda;200;108;92
09;Burgos;066;Campolara;106;57;49
09;Burgos;067;Canicosa de la Sierra;669;342;327
09;Burgos;068;Cantabrana;61;34;27
09;Burgos;070;Carazo;48;25;23
09;Burgos;071;Carcedo de Bureba;46;24;22
09;Burgos;072;Carcedo de Burgos;139;81;58
09;Burgos;073;Cardeñadijo;467;244;223
09;Burgos;074;Cardeñajimeno;353;192;161
09;Burgos;075;Cardeñuela Riopico;78;38;40
09;Burgos;076;Carrias;51;34;17
09;Burgos;077;Cascajares de Bureba;67;36;31
09;Burgos;078;Cascajares de la Sierra;25;11;14
09;Burgos;079;Castellanos de Castro;71;39;32
09;Burgos;083;Castil de Peones;37;17;20
09;Burgos;082;Castildelgado;83;43;40
09;Burgos;084;Castrillo de la Reina;311;188;123
09;Burgos;085;Castrillo de la Vega;598;320;278
09;Burgos;088;Castrillo de Riopisuerga;97;55;42
09;Burgos;086;Castrillo del Val;347;193;154
09;Burgos;090;Castrillo Matajudíos;84;43;41
09;Burgos;091;Castrojeriz;1105;561;544
09;Burgos;093;Cayuela;126;76;50
09;Burgos;094;Cebrecos;79;46;33
09;Burgos;095;Celada del Camino;92;42;50
09;Burgos;098;Cerezo de Río Tirón;818;439;379
09;Burgos;100;Cerratón de Juarros;71;39;32
09;Burgos;101;Ciadoncha;139;83;56
09;Burgos;102;Cillaperlata;85;48;37
09;Burgos;103;Cilleruelo de Abajo;369;205;164
09;Burgos;104;Cilleruelo de Arriba;83;43;40
09;Burgos;105;Ciruelos de Cervera;174;90;84
09;Burgos;108;Cogollos;226;125;101
09;Burgos;109;Condado de Treviño;852;470;382
09;Burgos;110;Contreras;119;74;45
09;Burgos;112;Coruña del Conde;166;92;74
09;Burgos;113;Covarrubias;655;342;313
09;Burgos;114;Cubillo del Campo;76;41;35
09;Burgos;115;Cubo de Bureba;136;72;64
09;Burgos;117;Cueva de Roa (La);122;70;52
09;Burgos;119;Cuevas de San Clemente;70;33;37
09;Burgos;120;Encío;58;30;28
09;Burgos;122;Espinosa de Cervera;120;72;48
09;Burgos;124;Espinosa de los Monteros;2303;1177;1126
09;Burgos;123;Espinosa del Camino;52;27;25
09;Burgos;125;Estépar;852;456;396
09;Burgos;127;Fontioso;103;57;46
09;Burgos;128;Frandovínez;85;47;38
09;Burgos;129;Fresneda de la Sierra Tirón;107;56;51
09;Burgos;130;Fresneña;123;68;55
09;Burgos;131;Fresnillo de las Dueñas;305;158;147
09;Burgos;132;Fresno de Río Tirón;273;158;115
09;Burgos;133;Fresno de Rodilla;35;22;13
09;Burgos;134;Frías;330;181;149
09;Burgos;135;Fuentebureba;90;44;46
09;Burgos;136;Fuentecén;307;167;140
09;Burgos;137;Fuentelcésped;205;100;105
09;Burgos;138;Fuentelisendo;118;58;60
09;Burgos;139;Fuentemolinos;132;74;58
09;Burgos;140;Fuentenebro;206;108;98
09;Burgos;141;Fuentespina;589;310;279
09;Burgos;143;Galbarros;32;22;10
09;Burgos;144;Gallega (La);98;60;38
09;Burgos;148;Grijalba;139;70;69
09;Burgos;149;Grisaleña;53;32;21
09;Burgos;151;Gumiel de Izán;652;349;303
09;Burgos;152;Gumiel de Mercado;406;220;186
09;Burgos;154;Hacinas;225;117;108
09;Burgos;155;Haza;45;22;23
09;Burgos;159;Hontanas;80;43;37
09;Burgos;160;Hontangas;156;88;68
09;Burgos;162;Hontoria de la Cantera;127;65;62
09;Burgos;164;Hontoria de Valdearados;242;149;93
09;Burgos;163;Hontoria del Pinar;943;505;438
09;Burgos;166;Hormazas (Las);156;85;71
09;Burgos;167;Hornillos del Camino;81;46;35
09;Burgos;168;Horra (La);477;249;228
09;Burgos;169;Hortigüela;125;78;47
09;Burgos;170;Hoyales de Roa;324;161;163
09;Burgos;172;Huérmeces;159;88;71
09;Burgos;173;Huerta de Arriba;197;103;94
09;Burgos;174;Huerta de Rey;1203;630;573
09;Burgos;175;Humada;246;140;106
09;Burgos;176;Hurones;60;38;22
09;Burgos;177;Ibeas de Juarros;966;529;437
09;Burgos;178;Ibrillos;104;59;45
09;Burgos;179;Iglesiarrubia;68;36;32
09;Burgos;180;Iglesias;195;99;96
09;Burgos;181;Isar;436;201;235
09;Burgos;182;Itero del Castillo;127;67;60
09;Burgos;183;Jaramillo de la Fuente;34;18;16
09;Burgos;184;Jaramillo Quemado;19;15;4
09;Burgos;189;Junta de Traslaloma;218;113;105
09;Burgos;190;Junta de Villalba de Losa;97;50;47
09;Burgos;191;Jurisdicción de Lara;84;48;36
09;Burgos;192;Jurisdicción de San Zadornil;86;39;47
09;Burgos;194;Lerma;2495;1256;1239
09;Burgos;195;Llano de Bureba;68;40;28
09;Burgos;196;Madrigal del Monte;191;102;89
09;Burgos;197;Madrigalejo del Monte;175;95;80
09;Burgos;198;Mahamud;168;84;84
09;Burgos;199;Mambrilla de Castrejón;166;87;79
09;Burgos;200;Mambrillas de Lara;81;42;39
09;Burgos;201;Mamolar;74;38;36
09;Burgos;202;Manciles;49;26;23
09;Burgos;206;Mazuela;88;47;41
09;Burgos;208;Mecerreyes;319;164;155
09;Burgos;209;Medina de Pomar;5512;2745;2767
09;Burgos;211;Melgar de Fernamental;2057;1040;1017
09;Burgos;213;Merindad de Cuesta-Urria;524;292;232
09;Burgos;214;Merindad de Montija;1008;555;453
09;Burgos;906;Merindad de Río Ubierna;1253;658;595
09;Burgos;215;Merindad de Sotoscueva;652;345;307
09;Burgos;216;Merindad de Valdeporres;541;276;265
09;Burgos;217;Merindad de Valdivielso;581;301;280
09;Burgos;218;Milagros;457;239;218
09;Burgos;219;Miranda de Ebro;35502;17591;17911
09;Burgos;220;Miraveche;121;65;56
09;Burgos;221;Modúbar de la Emparedada;240;134;106
09;Burgos;223;Monasterio de la Sierra;37;22;15
09;Burgos;224;Monasterio de Rodilla;217;120;97
09;Burgos;225;Moncalvillo;134;77;57
09;Burgos;226;Monterrubio de la Demanda;95;51;44
09;Burgos;227;Montorio;179;91;88
09;Burgos;228;Moradillo de Roa;234;123;111
09;Burgos;229;Nava de Roa;295;155;140
09;Burgos;230;Navas de Bureba;54;27;27
09;Burgos;231;Nebreda;113;69;44
09;Burgos;232;Neila;244;118;126
09;Burgos;235;Olmedillo de Roa;241;124;117
09;Burgos;236;Olmillos de Muñó;48;26;22
09;Burgos;238;Oña;1798;915;883
09;Burgos;239;Oquillas;81;42;39
09;Burgos;241;Orbaneja Riopico;137;76;61
09;Burgos;242;Padilla de Abajo;106;63;43
09;Burgos;243;Padilla de Arriba;138;75;63
09;Burgos;244;Padrones de Bureba;86;46;40
09;Burgos;246;Palacios de la Sierra;919;477;442
09;Burgos;247;Palacios de Riopisuerga;35;16;19
09;Burgos;248;Palazuelos de la Sierra;67;34;33
09;Burgos;249;Palazuelos de Muñó;75;42;33
09;Burgos;250;Pampliega;433;219;214
09;Burgos;251;Pancorbo;519;271;248
09;Burgos;253;Pardilla;123;66;57
09;Burgos;255;Partido de la Sierra en Tobalina;90;56;34
09;Burgos;256;Pedrosa de Duero;607;314;293
09;Burgos;259;Pedrosa de Río Úrbel;301;171;130
09;Burgos;257;Pedrosa del Páramo;117;66;51
09;Burgos;258;Pedrosa del Príncipe;309;162;147
09;Burgos;261;Peñaranda de Duero;617;329;288
09;Burgos;262;Peral de Arlanza;279;142;137
09;Burgos;265;Piérnigas;48;31;17
09;Burgos;266;Pineda de la Sierra;129;68;61
09;Burgos;267;Pineda Trasmonte;202;106;96
09;Burgos;268;Pinilla de los Barruecos;133;76;57
09;Burgos;269;Pinilla de los Moros;50;33;17
09;Burgos;270;Pinilla Trasmonte;238;128;110
09;Burgos;272;Poza de la Sal;389;196;193
09;Burgos;273;Prádanos de Bureba;78;44;34
09;Burgos;274;Pradoluengo;1746;851;895
09;Burgos;275;Presencio;286;151;135
09;Burgos;276;Puebla de Arganzón (La);265;145;120
09;Burgos;277;Puentedura;133;70;63
09;Burgos;279;Quemada;263;148;115
09;Burgos;281;Quintana del Pidio;192;102;90
09;Burgos;280;Quintanabureba;38;21;17
09;Burgos;283;Quintanaélez;124;63;61
09;Burgos;287;Quintanaortuño;109;55;54
09;Burgos;288;Quintanapalla;126;67;59
09;Burgos;289;Quintanar de la Sierra;2220;1145;1075
09;Burgos;292;Quintanavides;86;39;47
09;Burgos;294;Quintanilla de la Mata;177;99;78
09;Burgos;901;Quintanilla del Agua y Tordueles;620;327;293
09;Burgos;295;Quintanilla del Coco;129;67;62
09;Burgos;298;Quintanilla San García;120;58;62
09;Burgos;301;Quintanilla Vivar;369;185;184
09;Burgos;297;Quintanillas (Las);356;194;162
09;Burgos;302;Rabanera del Pinar;146;79;67
09;Burgos;303;Rábanos;97;58;39
09;Burgos;304;Rabé de las Calzadas;177;93;84
09;Burgos;306;Rebolledo de la Torre;176;94;82
09;Burgos;307;Redecilla del Camino;156;91;65
09;Burgos;308;Redecilla del Campo;105;55;50
09;Burgos;309;Regumiel de la Sierra;513;258;255
09;Burgos;310;Reinoso;26;18;8
09;Burgos;311;Retuerta;77;43;34
09;Burgos;314;Revilla del Campo;140;70;70
09;Burgos;316;Revilla Vallejera;183;103;80
09;Burgos;312;Revilla y Ahedo (La);130;71;59
09;Burgos;315;Revillarruz;148;72;76
09;Burgos;317;Rezmondo;26;11;15
09;Burgos;318;Riocavado de la Sierra;76;41;35
09;Burgos;321;Roa;2329;1192;1137
09;Burgos;323;Rojas;108;60;48
09;Burgos;325;Royuela de Río Franco;354;195;159
09;Burgos;326;Rubena;157;78;79
09;Burgos;327;Rublacedo de Abajo;42;21;21
09;Burgos;328;Rucandio;123;62;61
09;Burgos;329;Salas de Bureba;182;100;82
09;Burgos;330;Salas de los Infantes;2076;1036;1040
09;Burgos;332;Saldaña de Burgos;104;57;47
09;Burgos;334;Salinillas de Bureba;73;40;33
09;Burgos;335;San Adrián de Juarros;44;20;24
09;Burgos;337;San Juan del Monte;167;91;76
09;Burgos;338;San Mamés de Burgos;168;95;73
09;Burgos;339;San Martín de Rubiales;280;149;131
09;Burgos;340;San Millán de Lara;88;53;35
09;Burgos;360;San Vicente del Valle;39;25;14
09;Burgos;343;Santa Cecilia;139;78;61
09;Burgos;345;Santa Cruz de la Salceda;209;111;98
09;Burgos;346;Santa Cruz del Valle Urbión;133;81;52
09;Burgos;347;Santa Gadea del Cid;198;105;93
09;Burgos;348;Santa Inés;207;107;100
09;Burgos;350;Santa María del Campo;730;370;360
09;Burgos;351;Santa María del Invierno;54;31;23
09;Burgos;352;Santa María del Mercadillo;210;124;86
09;Burgos;353;Santa María Rivarredonda;144;77;67
09;Burgos;354;Santa Olalla de Bureba;37;19;18
09;Burgos;355;Santibáñez de Esgueva;187;95;92
09;Burgos;356;Santibáñez del Val;64;38;26
09;Burgos;358;Santo Domingo de Silos;323;200;123
09;Burgos;361;Sargentes de la Lora;197;104;93
09;Burgos;362;Sarracín;150;86;64
09;Burgos;363;Sasamón;1593;867;726
09;Burgos;365;Sequera de Haza (La);70;39;31
09;Burgos;366;Solarana;120;66;54
09;Burgos;368;Sordillos;35;22;13
09;Burgos;369;Sotillo de la Ribera;626;344;282
09;Burgos;372;Sotragero;157;84;73
09;Burgos;373;Sotresgudo;800;424;376
09;Burgos;374;Susinos del Páramo;105;57;48
09;Burgos;375;Tamarón;49;29;20
09;Burgos;377;Tardajos;712;389;323
09;Burgos;378;Tejada;55;32;23
09;Burgos;380;Terradillos de Esgueva;134;67;67
09;Burgos;381;Tinieblas de la Sierra;39;20;19
09;Burgos;382;Tobar;49;27;22
09;Burgos;384;Tordómar;425;233;192
09;Burgos;386;Torrecilla del Monte;77;44;33
09;Burgos;387;Torregalindo;157;88;69
09;Burgos;388;Torrelara;33;15;18
09;Burgos;389;Torrepadre;165;90;75
09;Burgos;390;Torresandino;830;450;380
09;Burgos;391;Tórtoles de Esgueva;580;314;266
09;Burgos;392;Tosantos;80;40;40
09;Burgos;394;Trespaderne;1170;619;551
09;Burgos;395;Tubilla del Agua;168;103;65
09;Burgos;396;Tubilla del Lago;221;119;102
09;Burgos;398;Úrbel del Castillo;103;57;46
09;Burgos;400;Vadocondes;484;252;232
09;Burgos;403;Valdeande;179;103;76
09;Burgos;405;Valdezate;210;109;101
09;Burgos;406;Valdorros;124;73;51
09;Burgos;408;Vallarta de Bureba;76;44;32
09;Burgos;904;Valle de las Navas;635;355;280
09;Burgos;908;Valle de Losa;722;414;308
09;Burgos;409;Valle de Manzanedo;126;64;62
09;Burgos;410;Valle de Mena;3472;1773;1699
09;Burgos;411;Valle de Oca;221;109;112
09;Burgos;902;Valle de Santibáñez;659;336;323
09;Burgos;905;Valle de Sedano;530;285;245
09;Burgos;412;Valle de Tobalina;1096;577;519
09;Burgos;413;Valle de Valdebezana;808;440;368
09;Burgos;414;Valle de Valdelaguna;258;137;121
09;Burgos;415;Valle de Valdelucio;388;207;181
09;Burgos;416;Valle de Zamanzas;85;50;35
09;Burgos;417;Vallejera;59;31;28
09;Burgos;418;Valles de Palenzuela;114;59;55
09;Burgos;419;Valluércanes;133;75;58
09;Burgos;407;Valmala;35;16;19
09;Burgos;422;Vid de Bureba (La);44;23;21
09;Burgos;421;Vid y Barrios (La);353;202;151
09;Burgos;423;Vileña;46;28;18
09;Burgos;427;Villadiego;2090;1133;957
09;Burgos;428;Villaescusa de Roa;182;98;84
09;Burgos;429;Villaescusa la Sombría;59;36;23
09;Burgos;430;Villaespasa;33;17;16
09;Burgos;431;Villafranca Montes de Oca;211;111;100
09;Burgos;432;Villafruela;318;178;140
09;Burgos;433;Villagalijo;82;46;36
09;Burgos;434;Villagonzalo Pedernales;658;333;325
09;Burgos;437;Villahoz;434;218;216
09;Burgos;438;Villalba de Duero;561;309;252
09;Burgos;439;Villalbilla de Burgos;651;344;307
09;Burgos;440;Villalbilla de Gumiel;144;81;63
09;Burgos;441;Villaldemiro;97;44;53
09;Burgos;442;Villalmanzo;490;259;231
09;Burgos;443;Villamayor de los Montes;268;129;139
09;Burgos;444;Villamayor de Treviño;116;66;50
09;Burgos;445;Villambistia;82;47;35
09;Burgos;446;Villamedianilla;29;15;14
09;Burgos;447;Villamiel de la Sierra;39;22;17
09;Burgos;448;Villangómez;347;185;162
09;Burgos;449;Villanueva de Argaño;117;62;55
09;Burgos;450;Villanueva de Carazo;24;15;9
09;Burgos;451;Villanueva de Gumiel;313;161;152
09;Burgos;454;Villanueva de Teba;78;43;35
09;Burgos;455;Villaquirán de la Puebla;78;44;34
09;Burgos;456;Villaquirán de los Infantes;222;114;108
09;Burgos;903;Villarcayo de Merindad de Castilla la Vieja;3934;1973;1961
09;Burgos;458;Villariezo;169;89;80
09;Burgos;460;Villasandino;275;136;139
09;Burgos;463;Villasur de Herreros;322;178;144
09;Burgos;464;Villatuelda;77;42;35
09;Burgos;466;Villaverde del Monte;207;111;96
09;Burgos;467;Villaverde-Mogina;139;85;54
09;Burgos;471;Villayerno Morquillas;141;72;69
09;Burgos;472;Villazopeque;100;55;45
09;Burgos;473;Villegas;135;75;60
09;Burgos;476;Villoruebo;54;34;20
09;Burgos;424;Viloria de Rioja;71;39;32
09;Burgos;425;Vilviestre del Pinar;810;415;395
09;Burgos;478;Vizcaínos;72;38;34
09;Burgos;480;Zael;156;82;74
09;Burgos;482;Zarzosa de Río Pisuerga;66;37;29
09;Burgos;483;Zazuar;287;148;139
09;Burgos;485;Zuñeda;88;44;44
10;Cáceres;001;Abadía;283;160;123
10;Cáceres;002;Abertura;519;277;242
10;Cáceres;003;Acebo;831;438;393
10;Cáceres;004;Acehúche;1007;504;503
10;Cáceres;005;Aceituna;739;375;364
10;Cáceres;006;Ahigal;1666;858;808
10;Cáceres;903;Alagón del Río;"";"";""
10;Cáceres;007;Albalá del Caudillo;890;436;454
10;Cáceres;008;Alcántara;1876;961;915
10;Cáceres;009;Alcollarín;382;181;201
10;Cáceres;010;Alcuéscar;3144;1635;1509
10;Cáceres;012;Aldea del Cano;762;372;390
10;Cáceres;013;Aldea del Obispo (La);429;224;205
10;Cáceres;011;Aldeacentenera;1017;506;511
10;Cáceres;014;Aldeanueva de la Vera;2584;1287;1297
10;Cáceres;015;Aldeanueva del Camino;935;451;484
10;Cáceres;016;Aldehuela de Jerte;392;224;168
10;Cáceres;017;Alía;1454;720;734
10;Cáceres;018;Aliseda;2414;1208;1206
10;Cáceres;019;Almaraz;1439;738;701
10;Cáceres;020;Almoharín;2047;1016;1031
10;Cáceres;021;Arroyo de la Luz;6645;3329;3316
10;Cáceres;023;Arroyomolinos;1101;557;544
10;Cáceres;022;Arroyomolinos de la Vera;616;307;309
10;Cáceres;024;Baños de Montemayor;716;327;389
10;Cáceres;025;Barrado;578;296;282
10;Cáceres;026;Belvís de Monroy;619;319;300
10;Cáceres;027;Benquerencia;105;60;45
10;Cáceres;028;Berrocalejo;134;59;75
10;Cáceres;029;Berzocana;689;346;343
10;Cáceres;030;Bohonal de Ibor;620;310;310
10;Cáceres;031;Botija;190;87;103
10;Cáceres;032;Brozas;2448;1223;1225
10;Cáceres;033;Cabañas del Castillo;612;311;301
10;Cáceres;034;Cabezabellosa;530;265;265
10;Cáceres;035;Cabezuela del Valle;2438;1262;1176
10;Cáceres;036;Cabrero;463;243;220
10;Cáceres;037;Cáceres;77768;37434;40334
10;Cáceres;038;Cachorrilla;105;50;55
10;Cáceres;039;Cadalso;621;318;303
10;Cáceres;040;Calzadilla;577;291;286
10;Cáceres;041;Caminomorisco;1298;690;608
10;Cáceres;042;Campillo de Deleitosa;155;76;79
10;Cáceres;043;Campo Lugar;1250;628;622
10;Cáceres;044;Cañamero;1992;1028;964
10;Cáceres;045;Cañaveral;1593;783;810
10;Cáceres;046;Carbajo;310;169;141
10;Cáceres;047;Carcaboso;1313;687;626
10;Cáceres;048;Carrascalejo;455;227;228
10;Cáceres;049;Casar de Cáceres;4753;2379;2374
10;Cáceres;050;Casar de Palomero;1411;704;707
10;Cáceres;051;Casares de las Hurdes;904;461;443
10;Cáceres;052;Casas de Don Antonio;239;111;128
10;Cáceres;053;Casas de Don Gómez;392;196;196
10;Cáceres;056;Casas de Millán;848;437;411
10;Cáceres;057;Casas de Miravete;169;89;80
10;Cáceres;054;Casas del Castañar;748;372;376
10;Cáceres;055;Casas del Monte;928;479;449
10;Cáceres;058;Casatejada;1338;673;665
10;Cáceres;059;Casillas de Coria;564;265;299
10;Cáceres;060;Castañar de Ibor;1397;705;692
10;Cáceres;061;Ceclavín;2284;1170;1114
10;Cáceres;062;Cedillo;581;299;282
10;Cáceres;063;Cerezo;248;116;132
10;Cáceres;064;Cilleros;2218;1114;1104
10;Cáceres;065;Collado;238;118;120
10;Cáceres;066;Conquista de la Sierra;204;99;105
10;Cáceres;067;Coria;11900;5866;6034
10;Cáceres;068;Cuacos de Yuste;892;470;422
10;Cáceres;069;Cumbre (La);1190;586;604
10;Cáceres;070;Deleitosa;961;474;487
10;Cáceres;071;Descargamaría;270;133;137
10;Cáceres;072;Eljas;1284;651;633
10;Cáceres;073;Escurial;986;493;493
10;Cáceres;075;Fresnedoso de Ibor;395;193;202
10;Cáceres;076;Galisteo;2008;1019;989
10;Cáceres;077;Garciaz;1056;531;525
10;Cáceres;078;Garganta (La);641;334;307
10;Cáceres;079;Garganta la Olla;1207;635;572
10;Cáceres;080;Gargantilla;526;270;256
10;Cáceres;081;Gargüera;211;107;104
10;Cáceres;082;Garrovillas de Alconétar;2557;1229;1328
10;Cáceres;083;Garvín;119;73;46
10;Cáceres;084;Gata;2013;1004;1009
10;Cáceres;085;Gordo (El);309;152;157
10;Cáceres;086;Granja (La);450;241;209
10;Cáceres;087;Guadalupe;2457;1218;1239
10;Cáceres;088;Guijo de Coria;310;160;150
10;Cáceres;089;Guijo de Galisteo;1841;939;902
10;Cáceres;090;Guijo de Granadilla;788;388;400
10;Cáceres;091;Guijo de Santa Bárbara;517;257;260
10;Cáceres;092;Herguijuela;467;229;238
10;Cáceres;093;Hernán-Pérez;514;269;245
10;Cáceres;094;Herrera de Alcántara;350;175;175
10;Cáceres;095;Herreruela;491;258;233
10;Cáceres;096;Hervás;3965;1911;2054
10;Cáceres;097;Higuera;127;71;56
10;Cáceres;098;Hinojal;460;219;241
10;Cáceres;099;Holguera;865;442;423
10;Cáceres;100;Hoyos;1038;528;510
10;Cáceres;101;Huélaga;213;107;106
10;Cáceres;102;Ibahernando;785;385;400
10;Cáceres;103;Jaraicejo;692;339;353
10;Cáceres;104;Jaraíz de la Vera;7012;3574;3438
10;Cáceres;105;Jarandilla de la Vera;3325;1668;1657
10;Cáceres;106;Jarilla;205;112;93
10;Cáceres;107;Jerte;1372;716;656
10;Cáceres;108;Ladrillar;384;209;175
10;Cáceres;109;Logrosán;2618;1319;1299
10;Cáceres;110;Losar de la Vera;3114;1589;1525
10;Cáceres;111;Madrigal de la Vera;1836;951;885
10;Cáceres;112;Madrigalejo;2317;1139;1178
10;Cáceres;113;Madroñera;3200;1602;1598
10;Cáceres;114;Majadas;1246;660;586
10;Cáceres;115;Malpartida de Cáceres;4338;2178;2160
10;Cáceres;116;Malpartida de Plasencia;4342;2112;2230
10;Cáceres;117;Marchagaz;401;195;206
10;Cáceres;118;Mata de Alcántara;401;201;200
10;Cáceres;119;Membrío;948;449;499
10;Cáceres;120;Mesas de Ibor;201;109;92
10;Cáceres;121;Miajadas;9907;4949;4958
10;Cáceres;122;Millanes;263;146;117
10;Cáceres;123;Mirabel;893;443;450
10;Cáceres;124;Mohedas de Granadilla;1169;597;572
10;Cáceres;125;Monroy;1278;639;639
10;Cáceres;126;Montánchez;2306;1141;1165
10;Cáceres;127;Montehermoso;5368;2701;2667
10;Cáceres;128;Moraleja;8273;4104;4169
10;Cáceres;129;Morcillo;528;266;262
10;Cáceres;130;Navaconcejo;2182;1101;1081
10;Cáceres;131;Navalmoral de la Mata;15819;7797;8022
10;Cáceres;132;Navalvillar de Ibor;573;289;284
10;Cáceres;133;Navas del Madroño;1661;837;824
10;Cáceres;134;Navezuelas;755;394;361
10;Cáceres;135;Nuñomoral;2002;1054;948
10;Cáceres;136;Oliva de Plasencia;340;171;169
10;Cáceres;137;Palomero;598;312;286
10;Cáceres;138;Pasarón de la Vera;730;369;361
10;Cáceres;139;Pedroso de Acim;149;79;70
10;Cáceres;140;Peraleda de la Mata;1468;734;734
10;Cáceres;141;Peraleda de San Román;456;226;230
10;Cáceres;142;Perales del Puerto;1055;520;535
10;Cáceres;143;Pescueza;246;120;126
10;Cáceres;144;Pesga (La);1295;673;622
10;Cáceres;145;Piedras Albas;236;111;125
10;Cáceres;146;Pinofranqueado;1824;973;851
10;Cáceres;147;Piornal;1581;787;794
10;Cáceres;148;Plasencia;37299;18282;19017
10;Cáceres;149;Plasenzuela;544;249;295
10;Cáceres;150;Portaje;425;205;220
10;Cáceres;151;Portezuelo;339;161;178
10;Cáceres;152;Pozuelo de Zarzón;660;324;336
10;Cáceres;153;Puerto de Santa Cruz;436;210;226
10;Cáceres;154;Rebollar;251;129;122
10;Cáceres;155;Riolobos;1571;831;740
10;Cáceres;156;Robledillo de Gata;187;93;94
10;Cáceres;157;Robledillo de la Vera;372;182;190
10;Cáceres;158;Robledillo de Trujillo;513;267;246
10;Cáceres;159;Robledollano;466;252;214
10;Cáceres;160;Romangordo;210;97;113
10;Cáceres;901;Rosalejo;1875;1057;818
10;Cáceres;161;Ruanes;105;55;50
10;Cáceres;162;Salorino;891;439;452
10;Cáceres;163;Salvatierra de Santiago;476;246;230
10;Cáceres;164;San Martín de Trevejo;1025;522;503
10;Cáceres;165;Santa Ana;406;203;203
10;Cáceres;166;Santa Cruz de la Sierra;387;199;188
10;Cáceres;167;Santa Cruz de Paniagua;478;256;222
10;Cáceres;168;Santa Marta de Magasca;386;194;192
10;Cáceres;169;Santiago de Alcántara;818;409;409
10;Cáceres;170;Santiago del Campo;337;175;162
10;Cáceres;171;Santibáñez el Alto;535;274;261
10;Cáceres;172;Santibáñez el Bajo;1033;536;497
10;Cáceres;173;Saucedilla;617;310;307
10;Cáceres;174;Segura de Toro;225;119;106
10;Cáceres;175;Serradilla;2027;1019;1008
10;Cáceres;176;Serrejón;523;270;253
10;Cáceres;177;Sierra de Fuentes;1689;830;859
10;Cáceres;178;Talaván;1066;522;544
10;Cáceres;179;Talaveruela de la Vera;492;233;259
10;Cáceres;180;Talayuela;7122;3978;3144
10;Cáceres;181;Tejeda de Tiétar;1036;560;476
10;Cáceres;182;Toril;213;132;81
10;Cáceres;183;Tornavacas;1416;744;672
10;Cáceres;184;Torno (El);1033;534;499
10;Cáceres;187;Torre de Don Miguel;718;353;365
10;Cáceres;188;Torre de Santa María;773;372;401
10;Cáceres;185;Torrecilla de los Ángeles;708;359;349
10;Cáceres;186;Torrecillas de la Tiesa;1278;646;632
10;Cáceres;190;Torrejón el Rubio;743;377;366
10;Cáceres;189;Torrejoncillo;3671;1791;1880
10;Cáceres;191;Torremenga;581;296;285
10;Cáceres;192;Torremocha;1285;612;673
10;Cáceres;193;Torreorgaz;1604;814;790
10;Cáceres;194;Torrequemada;603;286;317
10;Cáceres;195;Trujillo;9315;4438;4877
10;Cáceres;196;Valdastillas;440;217;223
10;Cáceres;197;Valdecañas de Tajo;149;82;67
10;Cáceres;198;Valdefuentes;1606;786;820
10;Cáceres;199;Valdehúncar;180;86;94
10;Cáceres;200;Valdelacasa de Tajo;618;284;334
10;Cáceres;201;Valdemorales;291;144;147
10;Cáceres;202;Valdeobispo;853;419;434
10;Cáceres;203;Valencia de Alcántara;6578;3241;3337
10;Cáceres;204;Valverde de la Vera;594;306;288
10;Cáceres;205;Valverde del Fresno;2773;1403;1370
10;Cáceres;902;Vegaviana;"";"";""
10;Cáceres;206;Viandar de la Vera;342;160;182
10;Cáceres;207;Villa del Campo;664;331;333
10;Cáceres;208;Villa del Rey;185;98;87
10;Cáceres;209;Villamesías;419;211;208
10;Cáceres;210;Villamiel;826;411;415
10;Cáceres;211;Villanueva de la Sierra;638;302;336
10;Cáceres;212;Villanueva de la Vera;2075;1026;1049
10;Cáceres;214;Villar de Plasencia;307;148;159
10;Cáceres;213;Villar del Pedroso;877;440;437
10;Cáceres;215;Villasbuenas de Gata;545;281;264
10;Cáceres;216;Zarza de Granadilla;1895;979;916
10;Cáceres;217;Zarza de Montánchez;662;335;327
10;Cáceres;218;Zarza la Mayor;1737;861;876
10;Cáceres;219;Zorita;2094;1030;1064
11;Cádiz;001;Alcalá de los Gazules;5689;2937;2752
11;Cádiz;002;Alcalá del Valle;5208;2664;2544
11;Cádiz;003;Algar;1906;1022;884
11;Cádiz;004;Algeciras;101907;50108;51799
11;Cádiz;005;Algodonales;5691;2929;2762
11;Cádiz;006;Arcos de la Frontera;28110;14074;14036
11;Cádiz;007;Barbate;21888;10935;10953
11;Cádiz;008;Barrios (Los);15507;7850;7657
11;Cádiz;901;Benalup-Casas Viejas;5971;3055;2916
11;Cádiz;009;Benaocaz;597;302;295
11;Cádiz;010;Bornos;8054;3988;4066
11;Cádiz;011;Bosque (El);1802;930;872
11;Cádiz;013;Castellar de la Frontera;2388;1215;1173
11;Cádiz;015;Chiclana de la Frontera;53001;26899;26102
11;Cádiz;016;Chipiona;15518;7887;7631
11;Cádiz;014;Conil de la Frontera;16687;8445;8242
11;Cádiz;012;Cádiz;145595;70051;75544
11;Cádiz;017;Espera;3969;2049;1920
11;Cádiz;018;Gastor (El);2010;1068;942
11;Cádiz;019;Grazalema;2298;1178;1120
11;Cádiz;020;Jerez de la Frontera;182269;89096;93173
11;Cádiz;021;Jimena de la Frontera;8999;4625;4374
11;Cádiz;022;Línea de la Concepción (La);59293;28749;30544
11;Cádiz;023;Medina-Sidonia;10750;5528;5222
11;Cádiz;024;Olvera;8991;4485;4506
11;Cádiz;025;Paterna de Rivera;5093;2627;2466
11;Cádiz;026;Prado del Rey;5726;2860;2866
11;Cádiz;028;Puerto Real;33069;16689;16380
11;Cádiz;029;Puerto Serrano;6673;3441;3232
11;Cádiz;027;Puerto de Santa María (El);72460;36284;36176
11;Cádiz;030;Rota;24197;12223;11974
11;Cádiz;031;San Fernando;85882;42429;43453
11;Cádiz;902;San José del Valle;4299;2196;2103
11;Cádiz;033;San Roque;22168;11091;11077
11;Cádiz;032;Sanlúcar de Barrameda;61088;30617;30471
11;Cádiz;034;Setenil de las Bodegas;3138;1601;1537
11;Cádiz;035;Tarifa;14993;7577;7416
11;Cádiz;036;Torre Alháquime;1018;521;497
11;Cádiz;037;Trebujena;6915;3505;3410
11;Cádiz;038;Ubrique;18102;8949;9153
11;Cádiz;039;Vejer de la Frontera;12823;6505;6318
11;Cádiz;040;Villaluenga del Rosario;511;267;244
11;Cádiz;041;Villamartín;11967;6017;5950
11;Cádiz;042;Zahara;1542;795;747
12;Castellón/Castelló;003;Albocàsser;1399;670;729
12;Castellón/Castelló;004;Alcalà de Xivert;4915;2469;2446
12;Castellón/Castelló;005;Alcora (L');8662;4404;4258
12;Castellón/Castelló;006;Alcudia de Veo;181;85;96
12;Castellón/Castelló;007;Alfondeguilla;922;451;471
12;Castellón/Castelló;008;Algimia de Almonacid;313;178;135
12;Castellón/Castelló;009;Almazora/Almassora;16306;8054;8252
12;Castellón/Castelló;010;Almedíjar;300;144;156
12;Castellón/Castelló;011;Almenara;5018;2471;2547
12;Castellón/Castelló;901;Alquerías del Niño Perdido;3508;1693;1815
12;Castellón/Castelló;012;Altura;3093;1545;1548
12;Castellón/Castelló;013;Arañuel;133;68;65
12;Castellón/Castelló;014;Ares del Maestre;281;134;147
12;Castellón/Castelló;015;Argelita;110;53;57
12;Castellón/Castelló;016;Artana;1909;956;953
12;Castellón/Castelló;001;Atzeneta del Maestrat;1486;753;733
12;Castellón/Castelló;017;Ayódar;221;120;101
12;Castellón/Castelló;018;Azuébar;375;190;185
12;Castellón/Castelló;002;Aín;130;68;62
12;Castellón/Castelló;020;Barracas;171;96;75
12;Castellón/Castelló;022;Bejís;368;203;165
12;Castellón/Castelló;024;Benafer;153;83;70
12;Castellón/Castelló;025;Benafigos;238;127;111
12;Castellón/Castelló;026;Benasal;1405;678;727
12;Castellón/Castelló;027;Benicarló;19229;9467;9762
12;Castellón/Castelló;028;Benicasim/Benicàssim;9913;5042;4871
12;Castellón/Castelló;029;Benlloch;876;448;428
12;Castellón/Castelló;021;Betxí;5284;2685;2599
12;Castellón/Castelló;031;Borriol;3129;1565;1564
12;Castellón/Castelló;032;Borriana/Burriana;26211;12725;13486
12;Castellón/Castelló;033;Cabanes;2364;1159;1205
12;Castellón/Castelló;036;Canet lo Roig;934;450;484
12;Castellón/Castelló;037;Castell de Cabres;24;12;12
12;Castellón/Castelló;038;Castellfort;245;128;117
12;Castellón/Castelló;039;Castellnovo;1037;503;534
12;Castellón/Castelló;040;Castellón de la Plana/Castelló de la Plana;135729;66044;69685
12;Castellón/Castelló;041;Castillo de Villamalefa;137;69;68
12;Castellón/Castelló;042;Catí;912;472;440
12;Castellón/Castelló;043;Caudiel;712;348;364
12;Castellón/Castelló;044;Cervera del Maestre;746;362;384
12;Castellón/Castelló;052;Chert/Xert;938;457;481
12;Castellón/Castelló;053;Chilches/Xilxes;2216;1121;1095
12;Castellón/Castelló;055;Chodos/Xodos;161;87;74
12;Castellón/Castelló;056;Chóvar;398;204;194
12;Castellón/Castelló;045;Cinctorres;591;274;317
12;Castellón/Castelló;046;Cirat;302;156;146
12;Castellón/Castelló;048;Cortes de Arenoso;411;224;187
12;Castellón/Castelló;049;Costur;466;234;232
12;Castellón/Castelló;050;Coves de Vinromà (les);1857;933;924
12;Castellón/Castelló;051;Culla;844;420;424
12;Castellón/Castelló;034;Càlig;1774;865;909
12;Castellón/Castelló;057;Eslida;775;366;409
12;Castellón/Castelló;058;Espadilla;85;40;45
12;Castellón/Castelló;059;Fanzara;282;138;144
12;Castellón/Castelló;060;Figueroles;556;274;282
12;Castellón/Castelló;061;Forcall;554;271;283
12;Castellón/Castelló;063;Fuente la Reina;32;14;18
12;Castellón/Castelló;064;Fuentes de Ayódar;98;49;49
12;Castellón/Castelló;065;Gaibiel;217;115;102
12;Castellón/Castelló;066;Gatova;"";"";""
12;Castellón/Castelló;067;Geldo;700;351;349
12;Castellón/Castelló;068;Herbés;115;55;60
12;Castellón/Castelló;069;Higueras;46;27;19
12;Castellón/Castelló;070;Jana (La);848;424;424
12;Castellón/Castelló;071;Jérica;1591;811;780
12;Castellón/Castelló;074;Llosa (La);937;470;467
12;Castellón/Castelló;072;Lucena del Cid;1629;795;834
12;Castellón/Castelló;073;Ludiente;235;116;119
12;Castellón/Castelló;075;Mata de Morella (La);208;101;107
12;Castellón/Castelló;076;Matet;151;78;73
12;Castellón/Castelló;077;Moncofa;3610;1818;1792
12;Castellón/Castelló;079;Montanejos;404;206;198
12;Castellón/Castelló;078;Montán;346;171;175
12;Castellón/Castelló;080;Morella;2797;1352;1445
12;Castellón/Castelló;081;Navajas;484;237;247
12;Castellón/Castelló;082;Nules;11493;5714;5779
12;Castellón/Castelló;083;Olocau del Rey;158;85;73
12;Castellón/Castelló;084;Onda;18680;9392;9288
12;Castellón/Castelló;085;Oropesa del Mar/Orpesa;2578;1322;1256
12;Castellón/Castelló;087;Palanques;23;14;9
12;Castellón/Castelló;088;Pavías;62;39;23
12;Castellón/Castelló;089;Peníscola/Peñíscola;3821;1886;1935
12;Castellón/Castelló;090;Pina de Montalgrao;175;91;84
12;Castellón/Castelló;094;Pobla Tornesa (La);529;260;269
12;Castellón/Castelló;093;Pobla de Benifassà (La);202;103;99
12;Castellón/Castelló;091;Portell de Morella;277;138;139
12;Castellón/Castelló;092;Puebla de Arenoso;178;91;87
12;Castellón/Castelló;095;Ribesalbes;1310;648;662
12;Castellón/Castelló;096;Rossell;1206;611;595
12;Castellón/Castelló;097;Sacañet;124;64;60
12;Castellón/Castelló;098;Salzadella (La);824;403;421
12;Castellón/Castelló;101;San Rafael del Río;492;251;241
12;Castellón/Castelló;902;Sant Joan de Moró;1669;840;829
12;Castellón/Castelló;099;Sant Jordi/San Jorge;573;275;298
12;Castellón/Castelló;100;Sant Mateu;1779;883;896
12;Castellón/Castelló;102;Santa Magdalena de Pulpis;728;364;364
12;Castellón/Castelló;103;Sarratella;109;59;50
12;Castellón/Castelló;104;Segorbe;7657;3703;3954
12;Castellón/Castelló;105;Sierra Engarcerán;1090;573;517
12;Castellón/Castelló;106;Soneja;1416;712;704
12;Castellón/Castelló;107;Sot de Ferrer;412;207;205
12;Castellón/Castelló;108;Sueras/Suera;568;282;286
12;Castellón/Castelló;109;Tales;770;365;405
12;Castellón/Castelló;110;Teresa;382;192;190
12;Castellón/Castelló;112;Todolella;138;82;56
12;Castellón/Castelló;113;Toga;110;49;61
12;Castellón/Castelló;115;Toro (El);364;193;171
12;Castellón/Castelló;116;Torralba del Pinar;71;36;35
12;Castellón/Castelló;120;Torre d'en Doménech (La);260;131;129
12;Castellón/Castelló;119;Torre d'En Besora (La);227;117;110
12;Castellón/Castelló;117;Torreblanca;4583;2298;2285
12;Castellón/Castelló;118;Torrechiva;63;38;25
12;Castellón/Castelló;114;Torás;278;151;127
12;Castellón/Castelló;121;Traiguera;1597;822;775
12;Castellón/Castelló;111;Tírig;575;286;289
12;Castellón/Castelló;122;Useras/Useres (Les);1094;557;537
12;Castellón/Castelló;124;Vall d'Alba;1853;927;926
12;Castellón/Castelló;126;Vall d'Uixó (La);28283;13972;14311
12;Castellón/Castelló;125;Vall de Almonacid;288;148;140
12;Castellón/Castelló;123;Vallat;43;19;24
12;Castellón/Castelló;127;Vallibona;108;58;50
12;Castellón/Castelló;128;Vilafamés;1422;761;661
12;Castellón/Castelló;132;Vilanova d'Alcolea;669;335;334
12;Castellón/Castelló;134;Vilar de Canes;188;93;95
12;Castellón/Castelló;129;Villafranca del Cid;2740;1333;1407
12;Castellón/Castelló;130;Villahermosa del Río;474;262;212
12;Castellón/Castelló;131;Villamalur;161;88;73
12;Castellón/Castelló;133;Villanueva de Viver;95;50;45
12;Castellón/Castelló;135;Vila-real;39550;19619;19931
12;Castellón/Castelló;136;Villavieja;3413;1691;1722
12;Castellón/Castelló;137;Villores;72;36;36
12;Castellón/Castelló;138;Vinaròs;20940;10216;10724
12;Castellón/Castelló;139;Vistabella del Maestrazgo;475;235;240
12;Castellón/Castelló;140;Viver;1202;610;592
12;Castellón/Castelló;141;Zorita del Maestrazgo;146;72;74
12;Castellón/Castelló;142;Zucaina;223;128;95
13;Ciudad Real;001;Abenójar;1834;920;914
13;Ciudad Real;002;Agudo;2171;1101;1070
13;Ciudad Real;003;Alamillo;693;347;346
13;Ciudad Real;004;Albaladejo;1753;872;881
13;Ciudad Real;005;Alcázar de San Juan;25961;12652;13309
13;Ciudad Real;006;Alcoba;783;409;374
13;Ciudad Real;007;Alcolea de Calatrava;1626;814;812
13;Ciudad Real;008;Alcubillas;714;337;377
13;Ciudad Real;009;Aldea del Rey;2240;1095;1145
13;Ciudad Real;010;Alhambra;1341;680;661
13;Ciudad Real;011;Almadén;7498;3615;3883
13;Ciudad Real;012;Almadenejos;601;321;280
13;Ciudad Real;013;Almagro;8436;4078;4358
13;Ciudad Real;014;Almedina;768;377;391
13;Ciudad Real;015;Almodóvar del Campo;7727;3820;3907
13;Ciudad Real;016;Almuradiel;1042;475;567
13;Ciudad Real;017;Anchuras;455;251;204
13;Ciudad Real;903;Arenales de San Gregorio;"";"";""
13;Ciudad Real;018;Arenas de San Juan;1085;539;546
13;Ciudad Real;019;Argamasilla de Alba;6631;3278;3353
13;Ciudad Real;020;Argamasilla de Calatrava;5472;2765;2707
13;Ciudad Real;021;Arroba de los Montes;694;355;339
13;Ciudad Real;022;Ballesteros de Calatrava;584;288;296
13;Ciudad Real;023;Bolaños de Calatrava;10547;5244;5303
13;Ciudad Real;024;Brazatortas;1279;641;638
13;Ciudad Real;025;Cabezarados;395;208;187
13;Ciudad Real;026;Cabezarrubias del Puerto;678;347;331
13;Ciudad Real;027;Calzada de Calatrava;4934;2412;2522
13;Ciudad Real;028;Campo de Criptana;13892;6798;7094
13;Ciudad Real;029;Cañada de Calatrava;88;49;39
13;Ciudad Real;030;Caracuel de Calatrava;175;98;77
13;Ciudad Real;031;Carrión de Calatrava;2620;1293;1327
13;Ciudad Real;032;Carrizosa;1725;869;856
13;Ciudad Real;033;Castellar de Santiago;2252;1097;1155
13;Ciudad Real;038;Chillón;2438;1186;1252
13;Ciudad Real;034;Ciudad Real;59392;28110;31282
13;Ciudad Real;035;Corral de Calatrava;1328;674;654
13;Ciudad Real;036;Cortijos (Los);1100;539;561
13;Ciudad Real;037;Cózar;1373;668;705
13;Ciudad Real;039;Daimiel;16929;8250;8679
13;Ciudad Real;040;Fernán Caballero;1072;512;560
13;Ciudad Real;041;Fontanarejo;400;208;192
13;Ciudad Real;042;Fuencaliente;1333;712;621
13;Ciudad Real;043;Fuenllana;337;155;182
13;Ciudad Real;044;Fuente el Fresno;3486;1719;1767
13;Ciudad Real;045;Granátula de Calatrava;1022;483;539
13;Ciudad Real;046;Guadalmez;1093;563;530
13;Ciudad Real;047;Herencia;7073;3550;3523
13;Ciudad Real;048;Hinojosas de Calatrava;805;383;422
13;Ciudad Real;049;Horcajo de los Montes;1116;554;562
13;Ciudad Real;050;Labores (Las);700;349;351
13;Ciudad Real;904;Llanos del Caudillo;"";"";""
13;Ciudad Real;051;Luciana;469;240;229
13;Ciudad Real;052;Malagón;8197;4047;4150
13;Ciudad Real;053;Manzanares;18097;8838;9259
13;Ciudad Real;054;Membrilla;6642;3288;3354
13;Ciudad Real;055;Mestanza;1003;490;513
13;Ciudad Real;056;Miguelturra;8866;4400;4466
13;Ciudad Real;057;Montiel;1768;888;880
13;Ciudad Real;058;Moral de Calatrava;5194;2534;2660
13;Ciudad Real;059;Navalpino;331;162;169
13;Ciudad Real;060;Navas de Estena;451;245;206
13;Ciudad Real;061;Pedro Muñoz;7188;3580;3608
13;Ciudad Real;062;Picón;647;338;309
13;Ciudad Real;063;Piedrabuena;5181;2614;2567
13;Ciudad Real;064;Poblete;762;379;383
13;Ciudad Real;065;Porzuna;3970;1987;1983
13;Ciudad Real;066;Pozuelo de Calatrava;2515;1246;1269
13;Ciudad Real;067;Pozuelos de Calatrava (Los);597;295;302
13;Ciudad Real;068;Puebla de Don Rodrigo;1324;696;628
13;Ciudad Real;069;Puebla del Príncipe;1101;552;549
13;Ciudad Real;070;Puerto Lápice;1041;521;520
13;Ciudad Real;071;Puertollano;50772;24691;26081
13;Ciudad Real;072;Retuerta del Bullaque;1094;571;523
13;Ciudad Real;901;Robledo (El);1119;595;524
13;Ciudad Real;902;Ruidera;611;324;287
13;Ciudad Real;073;Saceruela;783;414;369
13;Ciudad Real;074;San Carlos del Valle;1260;625;635
13;Ciudad Real;075;San Lorenzo de Calatrava;324;164;160
13;Ciudad Real;076;Santa Cruz de los Cáñamos;687;346;341
13;Ciudad Real;077;Santa Cruz de Mudela;4795;2337;2458
13;Ciudad Real;078;Socuéllamos;11046;5405;5641
13;Ciudad Real;080;Solana del Pino;596;304;292
13;Ciudad Real;079;Solana (La);14845;7414;7431
13;Ciudad Real;081;Terrinches;994;482;512
13;Ciudad Real;082;Tomelloso;29586;14467;15119
13;Ciudad Real;083;Torralba de Calatrava;2993;1451;1542
13;Ciudad Real;084;Torre de Juan Abad;1521;750;771
13;Ciudad Real;085;Torrenueva;3231;1624;1607
13;Ciudad Real;086;Valdemanco del Esteras;329;164;165
13;Ciudad Real;087;Valdepeñas;26217;12662;13555
13;Ciudad Real;088;Valenzuela de Calatrava;828;408;420
13;Ciudad Real;089;Villahermosa;2766;1319;1447
13;Ciudad Real;090;Villamanrique;1707;844;863
13;Ciudad Real;091;Villamayor de Calatrava;667;332;335
13;Ciudad Real;092;Villanueva de la Fuente;2791;1376;1415
13;Ciudad Real;093;Villanueva de los Infantes;5792;2774;3018
13;Ciudad Real;094;Villanueva de San Carlos;516;260;256
13;Ciudad Real;095;Villar del Pozo;106;55;51
13;Ciudad Real;096;Villarrubia de los Ojos;9539;4746;4793
13;Ciudad Real;097;Villarta de San Juan;2997;1509;1488
13;Ciudad Real;098;Viso del Marqués;3125;1542;1583
14;Córdoba;001;Adamuz;4466;2241;2225
14;Córdoba;002;Aguilar de la Frontera;13334;6596;6738
14;Córdoba;003;Alcaracejos;1478;733;745
14;Córdoba;004;Almedinilla;2572;1279;1293
14;Córdoba;005;Almodóvar del Río;7237;3599;3638
14;Córdoba;006;Añora;1650;810;840
14;Córdoba;007;Baena;18736;9275;9461
14;Córdoba;008;Belalcázar;3943;1906;2037
14;Córdoba;009;Belmez;4115;1980;2135
14;Córdoba;010;Benamejí;4682;2338;2344
14;Córdoba;011;Blázquez (Los);716;363;353
14;Córdoba;012;Bujalance;8163;4020;4143
14;Córdoba;013;Cabra;20707;10085;10622
14;Córdoba;015;Carcabuey;2887;1439;1448
14;Córdoba;016;Cardeña;2009;1011;998
14;Córdoba;017;Carlota (La);10023;5005;5018
14;Córdoba;018;Carpio (El);4497;2206;2291
14;Córdoba;019;Castro del Río;8036;3913;4123
14;Córdoba;014;Cañete de las Torres;3420;1699;1721
14;Córdoba;020;Conquista;530;260;270
14;Córdoba;021;Córdoba;306248;147344;158904
14;Córdoba;023;Dos Torres;2564;1259;1305
14;Córdoba;022;Doña Mencía;5007;2491;2516
14;Córdoba;024;Encinas Reales;2333;1147;1186
14;Córdoba;025;Espejo;4065;2019;2046
14;Córdoba;026;Espiel;2500;1244;1256
14;Córdoba;027;Fernán-Núñez;9442;4705;4737
14;Córdoba;029;Fuente Obejuna;6243;3198;3045
14;Córdoba;030;Fuente Palmera;9711;4892;4819
14;Córdoba;028;Fuente la Lancha;444;224;220
14;Córdoba;031;Fuente-Tójar;859;402;457
14;Córdoba;032;Granjuela (La);519;274;245
14;Córdoba;033;Guadalcázar;1161;589;572
14;Córdoba;034;Guijo (El);416;217;199
14;Córdoba;035;Hinojosa del Duque;8042;3877;4165
14;Córdoba;036;Hornachuelos;5006;2530;2476
14;Córdoba;037;Iznájar;5271;2643;2628
14;Córdoba;038;Lucena;34786;17272;17514
14;Córdoba;039;Luque;3422;1685;1737
14;Córdoba;040;Montalbán de Córdoba;4639;2328;2311
14;Córdoba;041;Montemayor;3801;1907;1894
14;Córdoba;042;Montilla;22949;11324;11625
14;Córdoba;043;Montoro;9394;4584;4810
14;Córdoba;044;Monturque;1937;970;967
14;Córdoba;045;Moriles;3765;1869;1896
14;Córdoba;046;Nueva Carteya;5797;2888;2909
14;Córdoba;047;Obejo;1494;754;740
14;Córdoba;048;Palenciana;1563;780;783
14;Córdoba;049;Palma del Río;19011;9506;9505
14;Córdoba;050;Pedro Abad;2889;1450;1439
14;Córdoba;051;Pedroche;1862;928;934
14;Córdoba;052;Peñarroya-Pueblonuevo;13844;6624;7220
14;Córdoba;053;Posadas;7107;3541;3566
14;Córdoba;054;Pozoblanco;16042;7720;8322
14;Córdoba;055;Priego de Córdoba;21732;10635;11097
14;Córdoba;056;Puente Genil;27472;13444;14028
14;Córdoba;057;Rambla (La);7199;3580;3619
14;Córdoba;058;Rute;10047;4944;5103
14;Córdoba;059;San Sebastián de los Ballesteros;837;431;406
14;Córdoba;061;Santa Eufemia;1204;615;589
14;Córdoba;060;Santaella;5854;2941;2913
14;Córdoba;062;Torrecampo;1436;707;729
14;Córdoba;063;Valenzuela;1484;704;780
14;Córdoba;064;Valsequillo;488;238;250
14;Córdoba;065;Victoria (La);1781;877;904
14;Córdoba;066;Villa del Río;7163;3641;3522
14;Córdoba;067;Villafranca de Córdoba;3777;1949;1828
14;Córdoba;068;Villaharta;629;313;316
14;Córdoba;069;Villanueva de Córdoba;10164;4960;5204
14;Córdoba;070;Villanueva del Duque;1895;885;1010
14;Córdoba;071;Villanueva del Rey;1259;654;605
14;Córdoba;072;Villaralto;1597;771;826
14;Córdoba;073;Villaviciosa de Córdoba;3911;2018;1893
14;Córdoba;074;Viso (El);3208;1537;1671
14;Córdoba;075;Zuheros;930;462;468
15;Coruña (A);001;Abegondo;5467;2729;2738
15;Coruña (A);002;Ames;13288;6453;6835
15;Coruña (A);003;Aranga;2466;1231;1235
15;Coruña (A);004;Ares;4576;2267;2309
15;Coruña (A);005;Arteixo;20898;10457;10441
15;Coruña (A);006;Arzúa;7014;3457;3557
15;Coruña (A);007;Baña (A);5836;2834;3002
15;Coruña (A);008;Bergondo;5732;2769;2963
15;Coruña (A);009;Betanzos;12299;5790;6509
15;Coruña (A);010;Boimorto;2722;1385;1337
15;Coruña (A);011;Boiro;17932;8718;9214
15;Coruña (A);012;Boqueixón;4314;2122;2192
15;Coruña (A);013;Brión;6378;3037;3341
15;Coruña (A);014;Cabana de Bergantiños;6009;3003;3006
15;Coruña (A);015;Cabanas;3226;1559;1667
15;Coruña (A);016;Camariñas;7349;3672;3677
15;Coruña (A);017;Cambre;14972;7339;7633
15;Coruña (A);018;Capela (A);1642;810;832
15;Coruña (A);019;Carballo;27287;13240;14047
15;Coruña (A);901;Cariño;5316;2600;2716
15;Coruña (A);020;Carnota;6140;2951;3189
15;Coruña (A);021;Carral;5184;2514;2670
15;Coruña (A);022;Cedeira;7750;3828;3922
15;Coruña (A);023;Cee;7352;3566;3786
15;Coruña (A);024;Cerceda;5654;2749;2905
15;Coruña (A);025;Cerdido;1768;854;914
15;Coruña (A);026;Cesuras;2794;1392;1402
15;Coruña (A);027;Coirós;1565;768;797
15;Coruña (A);028;Corcubión;2015;984;1031
15;Coruña (A);029;Coristanco;8416;4179;4237
15;Coruña (A);030;A Coruña;243785;113992;129793
15;Coruña (A);031;Culleredo;18513;9063;9450
15;Coruña (A);032;Curtis;4622;2265;2357
15;Coruña (A);033;Dodro;3404;1660;1744
15;Coruña (A);034;Dumbría;4928;2398;2530
15;Coruña (A);035;Fene;15010;7400;7610
15;Coruña (A);036;Ferrol;83048;38902;44146
15;Coruña (A);037;Fisterra;5397;2719;2678
15;Coruña (A);038;Frades;3179;1594;1585
15;Coruña (A);039;Irixoa;1808;894;914
15;Coruña (A);041;Laracha (A);10791;5304;5487
15;Coruña (A);040;Laxe;3616;1797;1819
15;Coruña (A);042;Lousame;4461;2169;2292
15;Coruña (A);043;Malpica de Bergantiños;7443;3637;3806
15;Coruña (A);045;Mazaricos;7010;3404;3606
15;Coruña (A);044;Mañón;2072;1017;1055
15;Coruña (A);046;Melide;8625;4267;4358
15;Coruña (A);047;Mesía;3521;1762;1759
15;Coruña (A);048;Miño;4817;2284;2533
15;Coruña (A);049;Moeche;1601;769;832
15;Coruña (A);050;Monfero;2847;1458;1389
15;Coruña (A);051;Mugardos;6200;2979;3221
15;Coruña (A);053;Muros;11065;5301;5764
15;Coruña (A);052;Muxía;6634;3256;3378
15;Coruña (A);054;Narón;31207;15076;16131
15;Coruña (A);055;Neda;6221;3017;3204
15;Coruña (A);056;Negreira;6707;3201;3506
15;Coruña (A);057;Noia;14422;6941;7481
15;Coruña (A);058;Oleiros;23057;11128;11929
15;Coruña (A);059;Ordes;11893;5802;6091
15;Coruña (A);060;Oroso;4537;2253;2284
15;Coruña (A);061;Ortigueira;8893;4234;4659
15;Coruña (A);062;Outes;9283;4480;4803
15;Coruña (A);063;Oza dos Ríos;3263;1591;1672
15;Coruña (A);064;Paderne;2802;1331;1471
15;Coruña (A);065;Padrón;10066;4877;5189
15;Coruña (A);066;Pino (O);5056;2516;2540
15;Coruña (A);067;Pobra do Caramiñal (A);10165;4845;5320
15;Coruña (A);068;Ponteceso;7663;3809;3854
15;Coruña (A);069;Pontedeume;8881;4269;4612
15;Coruña (A);070;Pontes de García Rodríguez (As);12664;6373;6291
15;Coruña (A);071;Porto do Son;10586;5184;5402
15;Coruña (A);072;Rianxo;12193;5987;6206
15;Coruña (A);073;Ribeira;26572;13098;13474
15;Coruña (A);074;Rois;5356;2566;2790
15;Coruña (A);075;Sada;9997;4838;5159
15;Coruña (A);076;San Sadurniño;3504;1717;1787
15;Coruña (A);077;Santa Comba;11109;5409;5700
15;Coruña (A);078;Santiago de Compostela;93672;43988;49684
15;Coruña (A);079;Santiso;2324;1203;1121
15;Coruña (A);080;Sobrado;2706;1405;1301
15;Coruña (A);081;Somozas (As);1543;766;777
15;Coruña (A);082;Teo;13915;6786;7129
15;Coruña (A);083;Toques;1735;899;836
15;Coruña (A);084;Tordoia;5334;2563;2771
15;Coruña (A);085;Touro;5126;2507;2619
15;Coruña (A);086;Trazo;3956;1964;1992
15;Coruña (A);088;Val do Dubra;5174;2547;2627
15;Coruña (A);087;Valdoviño;6736;3315;3421
15;Coruña (A);089;Vedra;5156;2472;2684
15;Coruña (A);091;Vilarmaior;1435;724;711
15;Coruña (A);090;Vilasantar;1748;890;858
15;Coruña (A);092;Vimianzo;9379;4626;4753
15;Coruña (A);093;Zas;6508;3176;3332
16;Cuenca;001;Abia de la Obispalía;93;50;43
16;Cuenca;002;Acebrón (El);289;147;142
16;Cuenca;003;Alarcón;215;109;106
16;Cuenca;004;Albaladejo del Cuende;412;220;192
16;Cuenca;005;Albalate de las Nogueras;402;218;184
16;Cuenca;006;Albendea;197;97;100
16;Cuenca;007;Alberca de Záncara (La);1769;874;895
16;Cuenca;008;Alcalá de la Vega;166;90;76
16;Cuenca;009;Alcantud;136;72;64
16;Cuenca;011;Alcohujate;65;34;31
16;Cuenca;012;Alconchel de la Estrella;230;118;112
16;Cuenca;010;Alcázar del Rey;279;138;141
16;Cuenca;013;Algarra;38;18;20
16;Cuenca;014;Aliaguilla;885;465;420
16;Cuenca;015;Almarcha (La);639;316;323
16;Cuenca;016;Almendros;357;182;175
16;Cuenca;017;Almodóvar del Pinar;532;284;248
16;Cuenca;018;Almonacid del Marquesado;587;302;285
16;Cuenca;019;Altarejos;344;176;168
16;Cuenca;020;Arandilla del Arroyo;55;24;31
16;Cuenca;905;Arcas del Villar;606;301;305
16;Cuenca;022;Arcos de la Sierra;123;67;56
16;Cuenca;024;Arguisuelas;213;113;100
16;Cuenca;025;Arrancacepas;38;20;18
16;Cuenca;026;Atalaya del Cañavate;133;68;65
16;Cuenca;027;Barajas de Melo;719;348;371
16;Cuenca;029;Barchín del Hoyo;145;80;65
16;Cuenca;030;Bascuñana de San Pedro;37;21;16
16;Cuenca;031;Beamud;111;63;48
16;Cuenca;032;Belinchón;344;176;168
16;Cuenca;033;Belmonte;2539;1199;1340
16;Cuenca;034;Belmontejo;282;139;143
16;Cuenca;035;Beteta;411;201;210
16;Cuenca;036;Boniches;233;115;118
16;Cuenca;038;Buciegas;88;45;43
16;Cuenca;039;Buenache de Alarcón;641;328;313
16;Cuenca;040;Buenache de la Sierra;110;69;41
16;Cuenca;041;Buendía;568;279;289
16;Cuenca;042;Campillo de Altobuey;1687;836;851
16;Cuenca;043;Campillos-Paravientos;153;83;70
16;Cuenca;044;Campillos-Sierra;96;50;46
16;Cuenca;901;Campos del Paraíso;1189;559;630
16;Cuenca;045;Canalejas del Arroyo;333;175;158
16;Cuenca;055;Carboneras de Guadazaón;1024;545;479
16;Cuenca;056;Cardenete;712;365;347
16;Cuenca;057;Carrascosa;118;70;48
16;Cuenca;058;Carrascosa de Haro;162;81;81
16;Cuenca;060;Casas de Benítez;1121;536;585
16;Cuenca;061;Casas de Fernando Alonso;1370;674;696
16;Cuenca;062;Casas de Garcimolina;26;11;15
16;Cuenca;063;Casas de Guijarro;158;81;77
16;Cuenca;064;Casas de Haro;908;465;443
16;Cuenca;065;Casas de los Pinos;532;255;277
16;Cuenca;066;Casasimarro;3049;1562;1487
16;Cuenca;067;Castejón;239;120;119
16;Cuenca;068;Castillejo de Iniesta;205;112;93
16;Cuenca;070;Castillejo-Sierra;56;25;31
16;Cuenca;072;Castillo de Garcimuñoz;241;123;118
16;Cuenca;071;Castillo-Albaráñez;33;17;16
16;Cuenca;047;Cañada Juncosa;360;189;171
16;Cuenca;046;Cañada del Hoyo;370;194;176
16;Cuenca;048;Cañamares;595;319;276
16;Cuenca;049;Cañavate (El);279;140;139
16;Cuenca;050;Cañaveras;424;215;209
16;Cuenca;051;Cañaveruelas;256;129;127
16;Cuenca;052;Cañete;843;414;429
16;Cuenca;053;Cañizares;617;326;291
16;Cuenca;073;Cervera del Llano;320;157;163
16;Cuenca;023;Chillarón de Cuenca;307;164;143
16;Cuenca;081;Chumillas;47;31;16
16;Cuenca;074;Cierva (La);60;33;27
16;Cuenca;078;Cuenca;43733;20969;22764
16;Cuenca;079;Cueva del Hierro;45;26;19
16;Cuenca;082;Enguídanos;554;285;269
16;Cuenca;083;Fresneda de Altarejos;94;52;42
16;Cuenca;084;Fresneda de la Sierra;75;37;38
16;Cuenca;085;Frontera (La);217;109;108
16;Cuenca;086;Fuente de Pedro Naharro;1226;607;619
16;Cuenca;087;Fuentelespino de Haro;335;182;153
16;Cuenca;088;Fuentelespino de Moya;158;81;77
16;Cuenca;904;Fuentenava de Jábaga;283;149;134
16;Cuenca;089;Fuentes;514;271;243
16;Cuenca;091;Fuertescusa;127;71;56
16;Cuenca;092;Gabaldón;182;101;81
16;Cuenca;093;Garaballa;159;82;77
16;Cuenca;094;Gascueña;167;79;88
16;Cuenca;095;Graja de Campalbo;146;80;66
16;Cuenca;096;Graja de Iniesta;355;189;166
16;Cuenca;097;Henarejos;290;139;151
16;Cuenca;098;Herrumblar (El);782;405;377
16;Cuenca;099;Hinojosa (La);364;176;188
16;Cuenca;100;Hinojosos (Los);1129;558;571
16;Cuenca;101;Hito (El);246;125;121
16;Cuenca;102;Honrubia;1647;809;838
16;Cuenca;103;Hontanaya;494;245;249
16;Cuenca;104;Hontecillas;99;48;51
16;Cuenca;106;Horcajo de Santiago;3603;1788;1815
16;Cuenca;108;Huelves;80;36;44
16;Cuenca;110;Huerta de la Obispalía;155;85;70
16;Cuenca;111;Huerta del Marquesado;218;122;96
16;Cuenca;112;Huete;2337;1190;1147
16;Cuenca;107;Huélamo;165;84;81
16;Cuenca;109;Huérguina;106;51;55
16;Cuenca;113;Iniesta;3792;1850;1942
16;Cuenca;115;Laguna del Marquesado;79;43;36
16;Cuenca;116;Lagunaseca;114;53;61
16;Cuenca;117;Landete;1652;820;832
16;Cuenca;118;Ledaña;2018;997;1021
16;Cuenca;119;Leganiel;251;128;123
16;Cuenca;121;Majadas (Las);392;193;199
16;Cuenca;122;Mariana;334;169;165
16;Cuenca;123;Masegosa;135;71;64
16;Cuenca;124;Mesas (Las);2579;1322;1257
16;Cuenca;125;Minglanilla;2364;1196;1168
16;Cuenca;126;Mira;1152;585;567
16;Cuenca;128;Monreal del Llano;91;47;44
16;Cuenca;129;Montalbanejo;218;102;116
16;Cuenca;130;Montalbo;765;400;365
16;Cuenca;131;Monteagudo de las Salinas;122;70;52
16;Cuenca;132;Mota de Altarejos;60;37;23
16;Cuenca;133;Mota del Cuervo;5502;2725;2777
16;Cuenca;134;Motilla del Palancar;5013;2502;2511
16;Cuenca;135;Moya;280;153;127
16;Cuenca;137;Narboneta;115;60;55
16;Cuenca;139;Olivares de Júcar;600;302;298
16;Cuenca;140;Olmeda de la Cuesta;54;30;24
16;Cuenca;141;Olmeda del Rey;254;122;132
16;Cuenca;142;Olmedilla de Alarcón;218;111;107
16;Cuenca;143;Olmedilla de Eliz;36;19;17
16;Cuenca;145;Osa de la Vega;682;346;336
16;Cuenca;147;Pajaroncillo;98;52;46
16;Cuenca;146;Pajarón;140;72;68
16;Cuenca;148;Palomares del Campo;1038;508;530
16;Cuenca;149;Palomera;172;83;89
16;Cuenca;150;Paracuellos;160;74;86
16;Cuenca;151;Paredes;75;38;37
16;Cuenca;152;Parra de las Vegas (La);66;34;32
16;Cuenca;153;Pedernoso (El);1353;676;677
16;Cuenca;154;Pedroñeras (Las);6448;3281;3167
16;Cuenca;155;Peral (El);728;371;357
16;Cuenca;156;Peraleja (La);161;83;78
16;Cuenca;157;Pesquera (La);280;146;134
16;Cuenca;158;Picazo (El);737;365;372
16;Cuenca;159;Pinarejo;490;255;235
16;Cuenca;160;Pineda de Gigüela;171;89;82
16;Cuenca;161;Piqueras del Castillo;90;50;40
16;Cuenca;162;Portalrubio de Guadamejud;105;50;55
16;Cuenca;163;Portilla;100;52;48
16;Cuenca;165;Poyatos;119;66;53
16;Cuenca;166;Pozoamargo;328;154;174
16;Cuenca;908;Pozorrubielos de la Mancha;299;150;149
16;Cuenca;167;Pozorrubio;547;260;287
16;Cuenca;169;Pozuelo (El);106;54;52
16;Cuenca;170;Priego;1025;531;494
16;Cuenca;171;Provencio (El);2626;1301;1325
16;Cuenca;172;Puebla de Almenara;580;302;278
16;Cuenca;173;Puebla de Don Francisco;383;189;194
16;Cuenca;174;Puebla del Salvador;317;170;147
16;Cuenca;175;Quintanar del Rey;6077;3102;2975
16;Cuenca;176;Rada de Haro;67;33;34
16;Cuenca;177;Reíllo;154;76;78
16;Cuenca;181;Rozalén del Monte;126;64;62
16;Cuenca;185;Saceda-Trasierra;95;52;43
16;Cuenca;186;Saelices;730;372;358
16;Cuenca;187;Salinas del Manzano;135;78;57
16;Cuenca;188;Salmeroncillos;190;98;92
16;Cuenca;189;Salvacañete;351;192;159
16;Cuenca;190;San Clemente;6568;3211;3357
16;Cuenca;191;San Lorenzo de la Parrilla;1536;775;761
16;Cuenca;192;San Martín de Boniches;111;56;55
16;Cuenca;193;San Pedro Palmiches;111;60;51
16;Cuenca;194;Santa Cruz de Moya;446;222;224
16;Cuenca;196;Santa María de los Llanos;867;442;425
16;Cuenca;195;Santa María del Campo Rus;823;407;416
16;Cuenca;197;Santa María del Val;127;66;61
16;Cuenca;198;Sisante;1823;919;904
16;Cuenca;199;Solera de Gabaldón;45;24;21
16;Cuenca;909;Sotorribas;984;484;500
16;Cuenca;202;Talayuelas;1197;613;584
16;Cuenca;203;Tarancón;11304;5557;5747
16;Cuenca;205;Tejadillos;185;92;93
16;Cuenca;206;Tinajas;380;207;173
16;Cuenca;209;Torralba;202;101;101
16;Cuenca;211;Torrejoncillo del Rey;753;360;393
16;Cuenca;212;Torrubia del Campo;373;174;199
16;Cuenca;213;Torrubia del Castillo;46;23;23
16;Cuenca;215;Tragacete;387;206;181
16;Cuenca;216;Tresjuncos;546;276;270
16;Cuenca;217;Tribaldos;140;67;73
16;Cuenca;204;Tébar;407;223;184
16;Cuenca;218;Uclés;300;139;161
16;Cuenca;219;Uña;143;69;74
16;Cuenca;906;Valdecolmenas (Los);137;71;66
16;Cuenca;224;Valdemeca;117;59;58
16;Cuenca;225;Valdemorillo de la Sierra;108;57;51
16;Cuenca;227;Valdemoro-Sierra;174;101;73
16;Cuenca;228;Valdeolivas;319;170;149
16;Cuenca;902;Valdetórtola;152;85;67
16;Cuenca;903;Valeras (Las);1443;716;727
16;Cuenca;231;Valhermoso de la Fuente;64;29;35
16;Cuenca;234;Valsalobre;58;29;29
16;Cuenca;236;Valverde de Júcar;1410;708;702
16;Cuenca;237;Valverdejo;154;79;75
16;Cuenca;238;Vara de Rey;751;371;380
16;Cuenca;239;Vega del Codorno;241;127;114
16;Cuenca;240;Vellisca;192;94;98
16;Cuenca;242;Villaconejos de Trabaque;544;280;264
16;Cuenca;243;Villaescusa de Haro;632;321;311
16;Cuenca;244;Villagarcía del Llano;998;495;503
16;Cuenca;245;Villalba de la Sierra;528;264;264
16;Cuenca;246;Villalba del Rey;742;382;360
16;Cuenca;247;Villalgordo del Marquesado;146;73;73
16;Cuenca;248;Villalpardo;1123;558;565
16;Cuenca;249;Villamayor de Santiago;2827;1403;1424
16;Cuenca;250;Villanueva de Guadamejud;130;65;65
16;Cuenca;251;Villanueva de la Jara;2475;1248;1227
16;Cuenca;253;Villar de Cañas;458;225;233
16;Cuenca;254;Villar de Domingo García;294;157;137
16;Cuenca;263;Villar de Olalla;877;454;423
16;Cuenca;255;Villar de la Encina;242;122;120
16;Cuenca;258;Villar del Humo;502;267;235
16;Cuenca;259;Villar del Infantado;49;29;20
16;Cuenca;910;Villar y Velasco;141;75;66
16;Cuenca;264;Villarejo de Fuentes;838;399;439
16;Cuenca;265;Villarejo de la Peñuela;36;17;19
16;Cuenca;266;Villarejo-Periesteban;553;280;273
16;Cuenca;269;Villares del Saz;748;377;371
16;Cuenca;270;Villarrubio;235;121;114
16;Cuenca;271;Villarta;813;421;392
16;Cuenca;272;Villas de la Ventosa;399;221;178
16;Cuenca;273;Villaverde y Pasaconsol;442;218;224
16;Cuenca;275;Vindel;26;17;9
16;Cuenca;274;Víllora;262;124;138
16;Cuenca;276;Yémeda;31;13;18
16;Cuenca;277;Zafra de Záncara;235;121;114
16;Cuenca;278;Zafrilla;139;67;72
16;Cuenca;279;Zarza de Tajo;278;128;150
16;Cuenca;280;Zarzuela;300;147;153
17;Girona;001;Agullana;619;329;290
17;Girona;002;Aiguaviva;432;215;217
17;Girona;003;Albanyà;123;64;59
17;Girona;004;Albons;513;264;249
17;Girona;006;Alp;1012;525;487
17;Girona;007;Amer;2276;1126;1150
17;Girona;008;Anglès;4785;2427;2358
17;Girona;009;Arbúcies;4317;2139;2178
17;Girona;010;Argelaguer;361;190;171
17;Girona;011;Armentera (L');749;367;382
17;Girona;012;Avinyonet de Puigventós;473;238;235
17;Girona;015;Banyoles;14395;6989;7406
17;Girona;016;Bàscara;770;397;373
17;Girona;013;Begur;3039;1542;1497
17;Girona;018;Bellcaire d'Empordà;487;243;244
17;Girona;019;Besalú;2031;991;1040
17;Girona;020;Bescanó;2970;1493;1477
17;Girona;021;Beuda;120;65;55
17;Girona;022;Bisbal d'Empordà (La);8007;3901;4106
17;Girona;234;Biure;223;112;111
17;Girona;023;Blanes;27713;13902;13811
17;Girona;029;Boadella d'Empordà;220;109;111
17;Girona;024;Bolvir;245;118;127
17;Girona;025;Bordils;1309;642;667
17;Girona;026;Borrassà;503;246;257
17;Girona;027;Breda;3243;1651;1592
17;Girona;028;Brunyola;376;190;186
17;Girona;031;Cabanelles;227;126;101
17;Girona;030;Cabanes;770;386;384
17;Girona;032;Cadaqués;1852;895;957
17;Girona;033;Caldes de Malavella;3598;1795;1803
17;Girona;034;Calonge;5832;2898;2934
17;Girona;035;Camós;621;311;310
17;Girona;036;Campdevànol;3347;1642;1705
17;Girona;037;Campelles;127;65;62
17;Girona;038;Campllong;280;144;136
17;Girona;039;Camprodon;2308;1141;1167
17;Girona;040;Canet d'Adri;503;255;248
17;Girona;041;Cantallops;265;131;134
17;Girona;042;Capmany;394;200;194
17;Girona;044;Cassà de la Selva;7428;3674;3754
17;Girona;046;Castellfollit de la Roca;1006;485;521
17;Girona;047;Castelló d'Empúries;4830;2467;2363
17;Girona;048;Castell-Platja d'Aro;5177;2627;2550
17;Girona;189;Cellera de Ter (La);2034;994;1040
17;Girona;049;Celrà;2522;1225;1297
17;Girona;050;Cervià de Ter;657;321;336
17;Girona;051;Cistella;211;105;106
17;Girona;054;Colera;422;212;210
17;Girona;055;Colomers;212;104;108
17;Girona;057;Corçà;1151;582;569
17;Girona;056;Cornellà del Terri;1806;905;901
17;Girona;058;Crespià;213;103;110
17;Girona;901;Cruïlles, Monells i Sant Sadurní de l'Heura;1099;540;559
17;Girona;060;Darnius;531;282;249
17;Girona;061;Das;145;79;66
17;Girona;062;Escala (L');5266;2616;2650
17;Girona;063;Espinelves;175;92;83
17;Girona;064;Espolla;396;199;197
17;Girona;065;Esponellà;404;200;204
17;Girona;005;Far d'Empordà (El);402;200;202
17;Girona;066;Figueres;33157;16146;17011
17;Girona;067;Flaçà;851;422;429
17;Girona;068;Foixà;317;157;160
17;Girona;069;Fontanals de Cerdanya;376;186;190
17;Girona;070;Fontanilles;119;64;55
17;Girona;071;Fontcoberta;1015;520;495
17;Girona;902;Forallac;1633;793;840
17;Girona;073;Fornells de la Selva;1308;635;673
17;Girona;074;Fortià;485;232;253
17;Girona;075;Garrigàs;319;169;150
17;Girona;076;Garrigoles;149;84;65
17;Girona;077;Garriguella;666;333;333
17;Girona;078;Ger;288;153;135
17;Girona;079;Girona;70576;33883;36693
17;Girona;080;Gombrèn;241;110;131
17;Girona;081;Gualta;270;136;134
17;Girona;082;Guils de Cerdanya;304;155;149
17;Girona;083;Hostalric;2919;1445;1474
17;Girona;084;Isòvol;189;99;90
17;Girona;085;Jafre;340;174;166
17;Girona;086;Jonquera (La);2384;1185;1199
17;Girona;087;Juià;259;119;140
17;Girona;088;Lladó;498;253;245
17;Girona;089;Llagostera;5410;2722;2688
17;Girona;090;Llambilles;448;229;219
17;Girona;091;Llanars;448;232;216
17;Girona;092;Llançà;3843;1925;1918
17;Girona;093;Llers;833;427;406
17;Girona;094;Llívia;924;479;445
17;Girona;095;Lloret de Mar;16674;8266;8408
17;Girona;096;Llosses (Les);269;145;124
17;Girona;102;Maçanet de Cabrenys;641;328;313
17;Girona;103;Maçanet de la Selva;3263;1652;1611
17;Girona;097;Madremanya;182;77;105
17;Girona;098;Maià de Montcal;320;159;161
17;Girona;100;Masarac;247;122;125
17;Girona;101;Massanes;490;249;241
17;Girona;099;Meranges;70;41;29
17;Girona;105;Mieres;300;156;144
17;Girona;106;Mollet de Peralada;183;97;86
17;Girona;107;Molló;333;176;157
17;Girona;109;Montagut i Oix;771;403;368
17;Girona;110;Mont-ras;1500;789;711
17;Girona;111;Navata;685;337;348
17;Girona;112;Ogassa;245;143;102
17;Girona;114;Olot;27482;13154;14328
17;Girona;115;Ordis;283;145;138
17;Girona;116;Osor;509;276;233
17;Girona;117;Palafrugell;17303;8664;8639
17;Girona;118;Palamós;14239;6984;7255
17;Girona;119;Palau de Santa Eulàlia;94;52;42
17;Girona;121;Palau-sator;286;142;144
17;Girona;120;Palau-saverdera;753;383;370
17;Girona;122;Palmerola;"";"";""
17;Girona;123;Palol de Revardit;365;186;179
17;Girona;124;Pals;1770;899;871
17;Girona;125;Pardines;139;70;69
17;Girona;126;Parlavà;337;176;161
17;Girona;128;Pau;393;190;203
17;Girona;129;Pedret i Marzà;112;55;57
17;Girona;130;Pera (La);355;188;167
17;Girona;132;Peralada;1147;597;550
17;Girona;133;Planes d'Hostoles (Les);1743;860;883
17;Girona;134;Planoles;265;138;127
17;Girona;135;Pont de Molins;432;224;208
17;Girona;136;Pontós;216;121;95
17;Girona;137;Porqueres;3279;1645;1634
17;Girona;140;Port de la Selva (El);813;390;423
17;Girona;138;Portbou;1614;808;806
17;Girona;139;Preses (Les);1327;645;682
17;Girona;141;Puigcerdà;6356;3157;3199
17;Girona;142;Quart;2123;1080;1043
17;Girona;043;Queralbs;192;106;86
17;Girona;143;Rabós;148;72;76
17;Girona;144;Regencós;278;154;124
17;Girona;145;Ribes de Freser;2156;1051;1105
17;Girona;146;Riells i Viabrea;1429;740;689
17;Girona;147;Ripoll;10908;5296;5612
17;Girona;148;Riudarenes;1215;610;605
17;Girona;149;Riudaura;389;196;193
17;Girona;150;Riudellots de la Selva;1465;743;722
17;Girona;151;Riumors;198;96;102
17;Girona;152;Roses;11483;5769;5714
17;Girona;153;Rupià;184;99;85
17;Girona;154;Sales de Llierca;66;39;27
17;Girona;155;Salt;21519;10625;10894
17;Girona;157;Sant Andreu Salou;146;74;72
17;Girona;183;Sant Aniol de Finestres;251;134;117
17;Girona;158;Sant Climent Sescebes;398;202;196
17;Girona;159;Sant Feliu de Buixalleu;672;357;315
17;Girona;160;Sant Feliu de Guíxols;17779;8665;9114
17;Girona;161;Sant Feliu de Pallerols;1101;535;566
17;Girona;162;Sant Ferriol;188;105;83
17;Girona;163;Sant Gregori;2130;1111;1019
17;Girona;164;Sant Hilari Sacalm;5064;2549;2515
17;Girona;165;Sant Jaume de Llierca;761;378;383
17;Girona;167;Sant Joan de les Abadesses;3794;1855;1939
17;Girona;168;Sant Joan de Mollet;367;179;188
17;Girona;185;Sant Joan les Fonts;2745;1362;1383
17;Girona;166;Sant Jordi Desvalls;588;296;292
17;Girona;169;Sant Julià de Ramis;1942;982;960
17;Girona;903;Sant Julià del Llor i Bonmatí;914;453;461
17;Girona;171;Sant Llorenç de la Muga;131;66;65
17;Girona;172;Sant Martí de Llémena;372;190;182
17;Girona;173;Sant Martí Vell;185;95;90
17;Girona;174;Sant Miquel de Campmajor;208;113;95
17;Girona;175;Sant Miquel de Fluvià;576;294;282
17;Girona;176;Sant Mori;142;69;73
17;Girona;177;Sant Pau de Segúries;648;322;326
17;Girona;178;Sant Pere Pescador;1330;717;613
17;Girona;180;Santa Coloma de Farners;8404;4254;4150
17;Girona;181;Santa Cristina d'Aro;2443;1273;1170
17;Girona;182;Santa Llogaia d'Àlguema;301;156;145
17;Girona;184;Santa Pau;1445;730;715
17;Girona;186;Sarrià de Ter;3032;1486;1546
17;Girona;187;Saus, Camallera i Llampaies;703;350;353
17;Girona;188;Selva de Mar (La);182;91;91
17;Girona;190;Serinyà;776;395;381
17;Girona;191;Serra de Daró;174;85;89
17;Girona;192;Setcases;160;81;79
17;Girona;193;Sils;2724;1382;1342
17;Girona;052;Siurana;153;73;80
17;Girona;194;Susqueda;87;51;36
17;Girona;195;Tallada d'Empordà (La);327;169;158
17;Girona;196;Terrades;192;90;102
17;Girona;197;Torrent;176;89;87
17;Girona;198;Torroella de Fluvià;316;172;144
17;Girona;199;Torroella de Montgrí;7726;3898;3828
17;Girona;200;Tortellà;683;349;334
17;Girona;201;Toses;139;85;54
17;Girona;202;Tossa de Mar;3853;1904;1949
17;Girona;204;Ullà;787;403;384
17;Girona;205;Ullastret;243;128;115
17;Girona;203;Ultramort;188;101;87
17;Girona;206;Urús;141;71;70
17;Girona;014;Vajol (La);84;46;38
17;Girona;208;Vall de Bianya (La);1076;524;552
17;Girona;207;Vall d'en Bas (La);2542;1293;1249
17;Girona;170;Vallfogona de Ripollès;230;117;113
17;Girona;209;Vall-llobrega;295;153;142
17;Girona;210;Ventalló;547;286;261
17;Girona;211;Verges;1090;542;548
17;Girona;212;Vidrà;172;86;86
17;Girona;213;Vidreres;4095;2036;2059
17;Girona;214;Vilabertran;795;395;400
17;Girona;215;Vilablareix;1323;653;670
17;Girona;217;Viladamat;401;204;197
17;Girona;216;Viladasens;182;97;85
17;Girona;218;Vilademuls;751;378;373
17;Girona;220;Viladrau;866;440;426
17;Girona;221;Vilafant;3467;1715;1752
17;Girona;223;Vilajuïga;856;425;431
17;Girona;224;Vilallonga de Ter;416;222;194
17;Girona;225;Vilamacolum;252;121;131
17;Girona;226;Vilamalla;606;308;298
17;Girona;227;Vilamaniscle;128;67;61
17;Girona;228;Vilanant;271;139;132
17;Girona;230;Vila-sacra;351;165;186
17;Girona;222;Vilaür;117;57;60
17;Girona;233;Vilobí d'Onyar;2141;1116;1025
17;Girona;232;Vilopriu;161;80;81
18;Granada;001;Agrón;440;228;212
18;Granada;002;Alamedilla;1007;508;499
18;Granada;003;Albolote;12455;6259;6196
18;Granada;004;Albondón;1192;588;604
18;Granada;005;Albuñán;509;256;253
18;Granada;006;Albuñol;5566;2782;2784
18;Granada;007;Albuñuelas;1329;678;651
18;Granada;010;Aldeire;788;400;388
18;Granada;011;Alfacar;4211;2138;2073
18;Granada;012;Algarinejo;5323;2721;2602
18;Granada;013;Alhama de Granada;5983;3010;2973
18;Granada;014;Alhendín;4107;2061;2046
18;Granada;015;Alicún de Ortega;783;406;377
18;Granada;016;Almegíjar;430;217;213
18;Granada;017;Almuñécar;21472;10561;10911
18;Granada;904;Alpujarra de la Sierra;1219;619;600
18;Granada;018;Alquife;1018;507;511
18;Granada;020;Arenas del Rey;2065;1064;1001
18;Granada;021;Armilla;12859;6343;6516
18;Granada;022;Atarfe;10516;5166;5350
18;Granada;023;Baza;20685;10140;10545
18;Granada;024;Beas de Granada;1007;524;483
18;Granada;025;Beas de Guadix;397;210;187
18;Granada;027;Benalúa;3357;1683;1674
18;Granada;028;Benalúa de las Villas;1394;691;703
18;Granada;029;Benamaurel;2507;1283;1224
18;Granada;030;Bérchules;871;463;408
18;Granada;032;Bubión;393;191;202
18;Granada;033;Busquístar;378;205;173
18;Granada;034;Cacín;835;423;412
18;Granada;035;Cádiar;1754;909;845
18;Granada;036;Cájar;2768;1307;1461
18;Granada;114;Calahorra (La);957;473;484
18;Granada;037;Calicasas;624;317;307
18;Granada;038;Campotéjar;1440;728;712
18;Granada;039;Caniles;5303;2598;2705
18;Granada;040;Cáñar;314;150;164
18;Granada;042;Capileira;572;279;293
18;Granada;043;Carataunas;203;105;98
18;Granada;044;Cástaras;328;168;160
18;Granada;045;Castilléjar;2120;1055;1065
18;Granada;046;Castril;3067;1570;1497
18;Granada;047;Cenes de la Vega;4006;2037;1969
18;Granada;059;Chauchina;3969;1959;2010
18;Granada;061;Chimeneas;1549;777;772
18;Granada;062;Churriana de la Vega;6458;3191;3267
18;Granada;048;Cijuela;1495;739;756
18;Granada;049;Cogollos de Guadix;798;418;380
18;Granada;050;Cogollos de la Vega;2035;1027;1008
18;Granada;051;Colomera;1708;874;834
18;Granada;053;Cortes de Baza;3059;1565;1494
18;Granada;054;Cortes y Graena;1026;521;505
18;Granada;912;Cuevas del Campo;2314;1143;1171
18;Granada;056;Cúllar;5229;2602;2627
18;Granada;057;Cúllar Vega;2656;1319;1337
18;Granada;063;Darro;1628;799;829
18;Granada;064;Dehesas de Guadix;713;358;355
18;Granada;066;Deifontes;2539;1267;1272
18;Granada;067;Diezma;981;518;463
18;Granada;068;Dílar;1555;772;783
18;Granada;069;Dólar;645;318;327
18;Granada;070;Dúdar;289;147;142
18;Granada;071;Dúrcal;6062;3002;3060
18;Granada;072;Escúzar;886;450;436
18;Granada;074;Ferreira;398;181;217
18;Granada;076;Fonelas;1306;656;650
18;Granada;078;Freila;1133;572;561
18;Granada;079;Fuente Vaqueros;3974;1971;2003
18;Granada;905;Gabias (Las);7576;3793;3783
18;Granada;082;Galera;1426;712;714
18;Granada;083;Gobernador;396;199;197
18;Granada;084;Gójar;3160;1603;1557
18;Granada;085;Gor;1251;621;630
18;Granada;086;Gorafe;583;280;303
18;Granada;087;Granada;245640;114904;130736
18;Granada;088;Guadahortuna;2334;1198;1136
18;Granada;089;Guadix;20310;10077;10233
18;Granada;906;Guajares (Los);1382;709;673
18;Granada;093;Gualchos;2990;1507;1483
18;Granada;094;Güejar Sierra;2713;1369;1344
18;Granada;095;Güevéjar;1502;749;753
18;Granada;096;Huélago;683;353;330
18;Granada;097;Huéneja;1329;654;675
18;Granada;098;Huéscar;8369;4161;4208
18;Granada;099;Huétor de Santillán;1687;878;809
18;Granada;100;Huétor Tájar;8171;4080;4091
18;Granada;101;Huétor Vega;7984;4002;3982
18;Granada;102;Illora;10797;5416;5381
18;Granada;103;Itrabo;1052;516;536
18;Granada;105;Iznalloz;6705;3399;3306
18;Granada;107;Jayena;1479;754;725
18;Granada;108;Jerez del Marquesado;1214;613;601
18;Granada;109;Jete;754;363;391
18;Granada;111;Jun;1553;786;767
18;Granada;112;Juviles;187;96;91
18;Granada;115;Láchar;2335;1184;1151
18;Granada;116;Lanjarón;3971;1976;1995
18;Granada;117;Lanteira;683;341;342
18;Granada;119;Lecrín;2424;1191;1233
18;Granada;120;Lentegí;356;166;190
18;Granada;121;Lobras;190;92;98
18;Granada;122;Loja;20032;9911;10121
18;Granada;123;Lugros;426;223;203
18;Granada;124;Lújar;572;308;264
18;Granada;126;Malahá (La);1702;856;846
18;Granada;127;Maracena;14095;7011;7084
18;Granada;128;Marchal;452;214;238
18;Granada;132;Moclín;4742;2354;2388
18;Granada;133;Molvízar;2640;1301;1339
18;Granada;134;Monachil;5074;2569;2505
18;Granada;135;Montefrío;7426;3758;3668
18;Granada;136;Montejícar;3006;1527;1479
18;Granada;137;Montillana;1420;716;704
18;Granada;138;Moraleda de Zafayona;2724;1393;1331
18;Granada;909;Morelábor;953;482;471
18;Granada;140;Motril;50316;24841;25475
18;Granada;141;Murtas;906;474;432
18;Granada;903;Nevada;1418;718;700
18;Granada;143;Nigüelas;1139;570;569
18;Granada;144;Nívar;646;323;323
18;Granada;145;Ogíjares;7607;3825;3782
18;Granada;146;Orce;1478;746;732
18;Granada;147;Órgiva;5147;2591;2556
18;Granada;148;Otívar;1108;556;552
18;Granada;149;Otura;3499;1749;1750
18;Granada;150;Padul;6673;3323;3350
18;Granada;151;Pampaneira;335;171;164
18;Granada;152;Pedro Martínez;1523;776;747
18;Granada;153;Peligros;6983;3452;3531
18;Granada;154;Peza (La);1467;769;698
18;Granada;910;Pinar (El);1286;652;634
18;Granada;157;Pinos Genil;1176;612;564
18;Granada;158;Pinos Puente;13275;6665;6610
18;Granada;159;Píñar;1422;732;690
18;Granada;161;Polícar;260;131;129
18;Granada;162;Polopos;1252;647;605
18;Granada;163;Pórtugos;440;216;224
18;Granada;164;Puebla de Don Fadrique;2643;1327;1316
18;Granada;165;Pulianas;3335;1683;1652
18;Granada;167;Purullena;2196;1074;1122
18;Granada;168;Quéntar;1134;576;558
18;Granada;170;Rubite;421;222;199
18;Granada;171;Salar;2753;1360;1393
18;Granada;173;Salobreña;10104;5025;5079
18;Granada;174;Santa Cruz del Comercio;560;289;271
18;Granada;175;Santa Fe;12349;6063;6286
18;Granada;176;Soportújar;288;151;137
18;Granada;177;Sorvilán;694;349;345
18;Granada;901;Taha (La);787;396;391
18;Granada;178;Torre-Cardela;1240;609;631
18;Granada;179;Torvizcón;1022;517;505
18;Granada;180;Trevélez;800;419;381
18;Granada;181;Turón;387;218;169
18;Granada;182;Ugíjar;2625;1298;1327
18;Granada;907;Valle del Zalabí;2431;1203;1228
18;Granada;902;Valle (El);1431;695;736
18;Granada;183;Válor;1024;515;509
18;Granada;911;Vegas del Genil;2753;1385;1368
18;Granada;184;Vélez de Benaudalla;2688;1317;1371
18;Granada;185;Ventas de Huelma;702;347;355
18;Granada;908;Villamena;1013;478;535
18;Granada;187;Villanueva de las Torres;1012;527;485
18;Granada;188;Villanueva Mesía;1922;959;963
18;Granada;189;Víznar;742;373;369
18;Granada;192;Zafarraya;2227;1147;1080
18;Granada;913;Zagra;1187;583;604
18;Granada;193;Zubia (La);11887;5832;6055
18;Granada;194;Zújar;2933;1501;1432
19;Guadalajara;001;Abánades;125;67;58
19;Guadalajara;002;Ablanque;157;79;78
19;Guadalajara;003;Adobes;45;26;19
19;Guadalajara;004;Alaminos;97;43;54
19;Guadalajara;005;Alarilla;123;72;51
19;Guadalajara;006;Albalate de Zorita;1010;533;477
19;Guadalajara;007;Albares;520;259;261
19;Guadalajara;008;Albendiego;52;28;24
19;Guadalajara;009;Alcocer;300;154;146
19;Guadalajara;010;Alcolea de las Peñas;33;17;16
19;Guadalajara;011;Alcolea del Pinar;409;199;210
19;Guadalajara;013;Alcoroches;211;113;98
19;Guadalajara;015;Aldeanueva de Guadalajara;107;46;61
19;Guadalajara;016;Algar de Mesa;92;50;42
19;Guadalajara;017;Algora;113;64;49
19;Guadalajara;018;Alhóndiga;256;141;115
19;Guadalajara;019;Alique;37;11;26
19;Guadalajara;020;Almadrones;91;54;37
19;Guadalajara;021;Almoguera;862;449;413
19;Guadalajara;022;Almonacid de Zorita;977;476;501
19;Guadalajara;023;Alocén;156;74;82
19;Guadalajara;024;Alovera;1422;723;699
19;Guadalajara;027;Alustante;284;156;128
19;Guadalajara;031;Angón;43;25;18
19;Guadalajara;032;Anguita;316;163;153
19;Guadalajara;033;Anquela del Ducado;89;44;45
19;Guadalajara;034;Anquela del Pedregal;27;17;10
19;Guadalajara;036;Aranzueque;369;184;185
19;Guadalajara;037;Arbancón;210;118;92
19;Guadalajara;038;Arbeteta;52;26;26
19;Guadalajara;039;Argecilla;116;68;48
19;Guadalajara;040;Armallones;54;32;22
19;Guadalajara;041;Armuña de Tajuña;116;63;53
19;Guadalajara;042;Arroyo de las Fraguas;53;24;29
19;Guadalajara;043;Atanzón;110;63;47
19;Guadalajara;044;Atienza;494;259;235
19;Guadalajara;045;Auñón;266;140;126
19;Guadalajara;046;Azuqueca de Henares;16013;8111;7902
19;Guadalajara;047;Baides;97;50;47
19;Guadalajara;048;Baños de Tajo;31;20;11
19;Guadalajara;049;Bañuelos;32;18;14
19;Guadalajara;050;Barriopedro;36;15;21
19;Guadalajara;051;Berninches;125;71;54
19;Guadalajara;052;Bodera (La);58;34;24
19;Guadalajara;053;Brihuega;3101;1577;1524
19;Guadalajara;054;Budia;296;156;140
19;Guadalajara;055;Bujalaro;88;46;42
19;Guadalajara;057;Bustares;108;59;49
19;Guadalajara;058;Cabanillas del Campo;2285;1177;1108
19;Guadalajara;059;Campillo de Dueñas;151;88;63
19;Guadalajara;060;Campillo de Ranas;121;61;60
19;Guadalajara;061;Campisábalos;66;33;33
19;Guadalajara;064;Canredondo;108;55;53
19;Guadalajara;065;Cantalojas;155;82;73
19;Guadalajara;066;Cañizar;125;60;65
19;Guadalajara;067;Cardoso de la Sierra (El);103;66;37
19;Guadalajara;070;Casa de Uceda;119;63;56
19;Guadalajara;071;Casar (El);2222;1127;1095
19;Guadalajara;073;Casas de San Galindo;41;22;19
19;Guadalajara;074;Caspueñas;81;49;32
19;Guadalajara;075;Castejón de Henares;129;68;61
19;Guadalajara;076;Castellar de la Muela;55;26;29
19;Guadalajara;078;Castilforte;53;31;22
19;Guadalajara;079;Castilnuevo;12;5;7
19;Guadalajara;080;Cendejas de Enmedio;129;66;63
19;Guadalajara;081;Cendejas de la Torre;113;67;46
19;Guadalajara;082;Centenera;75;41;34
19;Guadalajara;103;Checa;427;227;200
19;Guadalajara;104;Chequilla;21;10;11
19;Guadalajara;106;Chillarón del Rey;137;72;65
19;Guadalajara;105;Chiloeches;1137;604;533
19;Guadalajara;086;Cifuentes;2405;1220;1185
19;Guadalajara;087;Cincovillas;38;20;18
19;Guadalajara;088;Ciruelas;92;47;45
19;Guadalajara;089;Ciruelos del Pinar;67;36;31
19;Guadalajara;090;Cobeta;129;65;64
19;Guadalajara;091;Cogollor;61;35;26
19;Guadalajara;092;Cogolludo;629;346;283
19;Guadalajara;095;Condemios de Abajo;32;18;14
19;Guadalajara;096;Condemios de Arriba;183;96;87
19;Guadalajara;097;Congostrina;43;18;25
19;Guadalajara;098;Copernal;32;17;15
19;Guadalajara;099;Corduente;481;263;218
19;Guadalajara;102;Cubillo de Uceda (El);142;71;71
19;Guadalajara;107;Driebes;364;190;174
19;Guadalajara;108;Durón;110;53;57
19;Guadalajara;109;Embid;66;36;30
19;Guadalajara;110;Escamilla;146;66;80
19;Guadalajara;111;Escariche;220;116;104
19;Guadalajara;112;Escopete;68;25;43
19;Guadalajara;113;Espinosa de Henares;543;263;280
19;Guadalajara;114;Esplegares;63;37;26
19;Guadalajara;115;Establés;55;30;25
19;Guadalajara;116;Estriégana;29;16;13
19;Guadalajara;117;Fontanar;902;460;442
19;Guadalajara;118;Fuembellida;17;10;7
19;Guadalajara;119;Fuencemillán;130;68;62
19;Guadalajara;120;Fuentelahiguera de Albatages;194;102;92
19;Guadalajara;121;Fuentelencina;166;86;80
19;Guadalajara;122;Fuentelsaz;156;76;80
19;Guadalajara;123;Fuentelviejo;81;40;41
19;Guadalajara;124;Fuentenovilla;227;126;101
19;Guadalajara;125;Gajanejos;96;52;44
19;Guadalajara;126;Galápagos;230;118;112
19;Guadalajara;127;Galve de Sorbe;169;83;86
19;Guadalajara;129;Gascueña de Bornova;50;26;24
19;Guadalajara;130;Guadalajara;67108;33019;34089
19;Guadalajara;132;Henche;77;37;40
19;Guadalajara;133;Heras de Ayuso;126;65;61
19;Guadalajara;134;Herrería;42;21;21
19;Guadalajara;135;Hiendelaencina;147;76;71
19;Guadalajara;136;Hijes;27;14;13
19;Guadalajara;138;Hita;290;158;132
19;Guadalajara;139;Hombrados;54;32;22
19;Guadalajara;142;Hontoba;185;86;99
19;Guadalajara;143;Horche;1375;694;681
19;Guadalajara;145;Hortezuela de Océn;84;45;39
19;Guadalajara;146;Huerce (La);42;24;18
19;Guadalajara;147;Huérmeces del Cerro;70;41;29
19;Guadalajara;148;Huertahernando;70;41;29
19;Guadalajara;150;Hueva;151;74;77
19;Guadalajara;151;Humanes;1250;639;611
19;Guadalajara;152;Illana;702;370;332
19;Guadalajara;153;Iniéstola;20;12;8
19;Guadalajara;154;Inviernas (Las);98;57;41
19;Guadalajara;155;Irueste;75;37;38
19;Guadalajara;156;Jadraque;1247;635;612
19;Guadalajara;157;Jirueque;61;34;27
19;Guadalajara;159;Ledanca;152;78;74
19;Guadalajara;160;Loranca de Tajuña;305;159;146
19;Guadalajara;161;Lupiana;278;150;128
19;Guadalajara;162;Luzaga;124;58;66
19;Guadalajara;163;Luzón;93;44;49
19;Guadalajara;165;Majaelrayo;58;29;29
19;Guadalajara;166;Málaga del Fresno;223;112;111
19;Guadalajara;167;Malaguilla;156;94;62
19;Guadalajara;168;Mandayona;472;228;244
19;Guadalajara;169;Mantiel;74;33;41
19;Guadalajara;170;Maranchón;262;134;128
19;Guadalajara;171;Marchamalo;"";"";""
19;Guadalajara;172;Masegoso de Tajuña;105;51;54
19;Guadalajara;173;Matarrubia;50;32;18
19;Guadalajara;174;Matillas;225;117;108
19;Guadalajara;175;Mazarete;87;45;42
19;Guadalajara;176;Mazuecos;395;197;198
19;Guadalajara;177;Medranda;150;74;76
19;Guadalajara;178;Megina;87;42;45
19;Guadalajara;179;Membrillera;103;49;54
19;Guadalajara;181;Miedes de Atienza;115;60;55
19;Guadalajara;182;Mierla (La);44;25;19
19;Guadalajara;184;Millana;121;61;60
19;Guadalajara;183;Milmarcos;102;54;48
19;Guadalajara;185;Miñosa (La);48;27;21
19;Guadalajara;186;Mirabueno;123;66;57
19;Guadalajara;187;Miralrío;85;47;38
19;Guadalajara;188;Mochales;127;60;67
19;Guadalajara;189;Mohernando;142;82;60
19;Guadalajara;190;Molina de Aragón;3529;1801;1728
19;Guadalajara;191;Monasterio;21;10;11
19;Guadalajara;192;Mondéjar;2114;1060;1054
19;Guadalajara;193;Montarrón;64;37;27
19;Guadalajara;194;Moratilla de los Meleros;115;60;55
19;Guadalajara;195;Morenilla;58;38;20
19;Guadalajara;196;Muduex;125;66;59
19;Guadalajara;197;Navas de Jadraque (Las);22;14;8
19;Guadalajara;198;Negredo;25;11;14
19;Guadalajara;199;Ocentejo;49;20;29
19;Guadalajara;200;Olivar (El);114;58;56
19;Guadalajara;201;Olmeda de Cobeta;84;33;51
19;Guadalajara;202;Olmeda de Jadraque (La);22;11;11
19;Guadalajara;203;Ordial (El);49;21;28
19;Guadalajara;204;Orea;276;151;125
19;Guadalajara;208;Pálmaces de Jadraque;63;33;30
19;Guadalajara;209;Pardos;67;33;34
19;Guadalajara;210;Paredes de Sigüenza;76;40;36
19;Guadalajara;211;Pareja;481;236;245
19;Guadalajara;212;Pastrana;1209;619;590
19;Guadalajara;213;Pedregal (El);114;62;52
19;Guadalajara;214;Peñalén;160;86;74
19;Guadalajara;215;Peñalver;237;135;102
19;Guadalajara;216;Peralejos de las Truchas;170;87;83
19;Guadalajara;217;Peralveche;95;50;45
19;Guadalajara;218;Pinilla de Jadraque;106;54;52
19;Guadalajara;219;Pinilla de Molina;28;19;9
19;Guadalajara;220;Pioz;380;202;178
19;Guadalajara;221;Piqueras;57;33;24
19;Guadalajara;222;Pobo de Dueñas (El);189;104;85
19;Guadalajara;223;Poveda de la Sierra;207;109;98
19;Guadalajara;224;Pozo de Almoguera;212;108;104
19;Guadalajara;225;Pozo de Guadalajara;401;211;190
19;Guadalajara;226;Prádena de Atienza;42;25;17
19;Guadalajara;227;Prados Redondos;92;57;35
19;Guadalajara;228;Puebla de Beleña;37;24;13
19;Guadalajara;229;Puebla de Valles;73;39;34
19;Guadalajara;230;Quer;107;55;52
19;Guadalajara;231;Rebollosa de Jadraque;40;21;19
19;Guadalajara;232;Recuenco (El);101;51;50
19;Guadalajara;233;Renera;70;36;34
19;Guadalajara;234;Retiendas;54;26;28
19;Guadalajara;235;Riba de Saelices;197;108;89
19;Guadalajara;237;Rillo de Gallo;72;40;32
19;Guadalajara;238;Riofrío del Llano;81;44;37
19;Guadalajara;239;Robledillo de Mohernando;168;86;82
19;Guadalajara;240;Robledo de Corpes;76;39;37
19;Guadalajara;241;Romanillos de Atienza;70;42;28
19;Guadalajara;242;Romanones;145;82;63
19;Guadalajara;243;Rueda de la Sierra;76;40;36
19;Guadalajara;244;Sacecorbo;143;81;62
19;Guadalajara;245;Sacedón;1585;801;784
19;Guadalajara;246;Saelices de la Sal;72;36;36
19;Guadalajara;247;Salmerón;287;149;138
19;Guadalajara;248;San Andrés del Congosto;99;48;51
19;Guadalajara;249;San Andrés del Rey;50;20;30
19;Guadalajara;250;Santiuste;25;11;14
19;Guadalajara;251;Saúca;66;35;31
19;Guadalajara;252;Sayatón;199;106;93
19;Guadalajara;254;Selas;60;28;32
19;Guadalajara;901;Semillas;34;17;17
19;Guadalajara;255;Setiles;179;97;82
19;Guadalajara;256;Sienes;107;60;47
19;Guadalajara;257;Sigüenza;4880;2437;2443
19;Guadalajara;258;Solanillos del Extremo;127;66;61
19;Guadalajara;259;Somolinos;36;19;17
19;Guadalajara;260;Sotillo (El);52;31;21
19;Guadalajara;261;Sotodosos;70;35;35
19;Guadalajara;262;Tamajón;207;101;106
19;Guadalajara;263;Taragudo;30;17;13
19;Guadalajara;264;Taravilla;77;38;39
19;Guadalajara;265;Tartanedo;210;103;107
19;Guadalajara;266;Tendilla;370;191;179
19;Guadalajara;267;Terzaga;42;27;15
19;Guadalajara;268;Tierzo;42;22;20
19;Guadalajara;269;Toba (La);122;69;53
19;Guadalajara;271;Tordellego;78;39;39
19;Guadalajara;270;Tordelrábano;18;9;9
19;Guadalajara;272;Tordesilos;150;79;71
19;Guadalajara;274;Torija;382;180;202
19;Guadalajara;279;Torre del Burgo;69;38;31
19;Guadalajara;277;Torrecuadrada de Molina;22;13;9
19;Guadalajara;278;Torrecuadradilla;76;46;30
19;Guadalajara;280;Torrejón del Rey;814;426;388
19;Guadalajara;281;Torremocha de Jadraque;18;11;7
19;Guadalajara;282;Torremocha del Campo;343;190;153
19;Guadalajara;283;Torremocha del Pinar;70;33;37
19;Guadalajara;284;Torremochuela;12;6;6
19;Guadalajara;285;Torrubia;46;24;22
19;Guadalajara;286;Tórtola de Henares;399;205;194
19;Guadalajara;287;Tortuera;247;129;118
19;Guadalajara;288;Tortuero;42;25;17
19;Guadalajara;289;Traíd;70;34;36
19;Guadalajara;290;Trijueque;570;308;262
19;Guadalajara;291;Trillo;1467;754;713
19;Guadalajara;293;Uceda;791;391;400
19;Guadalajara;294;Ujados;38;20;18
19;Guadalajara;296;Utande;59;38;21
19;Guadalajara;297;Valdarachas;27;10;17
19;Guadalajara;298;Valdearenas;62;30;32
19;Guadalajara;299;Valdeavellano;103;55;48
19;Guadalajara;300;Valdeaveruelo;234;129;105
19;Guadalajara;301;Valdeconcha;51;29;22
19;Guadalajara;302;Valdegrudas;57;29;28
19;Guadalajara;303;Valdelcubo;75;44;31
19;Guadalajara;304;Valdenuño Fernández;135;72;63
19;Guadalajara;305;Valdepeñas de la Sierra;245;135;110
19;Guadalajara;306;Valderrebollo;43;22;21
19;Guadalajara;307;Valdesotos;45;18;27
19;Guadalajara;308;Valfermoso de Tajuña;111;58;53
19;Guadalajara;309;Valhermoso;35;20;15
19;Guadalajara;310;Valtablado del Río;16;10;6
19;Guadalajara;311;Valverde de los Arroyos;88;47;41
19;Guadalajara;314;Viana de Jadraque;64;37;27
19;Guadalajara;317;Villanueva de Alcorón;300;167;133
19;Guadalajara;318;Villanueva de Argecilla;44;24;20
19;Guadalajara;319;Villanueva de la Torre;330;166;164
19;Guadalajara;321;Villares de Jadraque;57;30;27
19;Guadalajara;322;Villaseca de Henares;82;40;42
19;Guadalajara;323;Villaseca de Uceda;65;35;30
19;Guadalajara;324;Villel de Mesa;271;141;130
19;Guadalajara;325;Viñuelas;123;72;51
19;Guadalajara;326;Yebes;181;128;53
19;Guadalajara;327;Yebra;576;295;281
19;Guadalajara;329;Yélamos de Abajo;101;50;51
19;Guadalajara;330;Yélamos de Arriba;149;72;77
19;Guadalajara;331;Yunquera de Henares;2041;1040;1001
19;Guadalajara;332;Yunta (La);180;90;90
19;Guadalajara;333;Zaorejas;206;117;89
19;Guadalajara;334;Zarzuela de Jadraque;31;15;16
19;Guadalajara;335;Zorita de los Canes;88;48;40
20;Guipúzcoa;001;Abaltzisketa;259;149;110
20;Guipúzcoa;002;Aduna;311;164;147
20;Guipúzcoa;016;Aia;1646;922;724
20;Guipúzcoa;003;Aizarnazabal;551;293;258
20;Guipúzcoa;004;Albiztur;296;159;137
20;Guipúzcoa;005;Alegia;1662;854;808
20;Guipúzcoa;006;Alkiza;260;150;110
20;Guipúzcoa;906;Altzaga;95;49;46
20;Guipúzcoa;007;Altzo;321;177;144
20;Guipúzcoa;008;Amezketa;1005;530;475
20;Guipúzcoa;009;Andoain;14540;7243;7297
20;Guipúzcoa;010;Anoeta;1776;909;867
20;Guipúzcoa;011;Antzuola;1936;1000;936
20;Guipúzcoa;012;Arama;158;77;81
20;Guipúzcoa;013;Aretxabaleta;5943;3033;2910
20;Guipúzcoa;055;Arrasate/Mondragón;24571;12300;12271
20;Guipúzcoa;014;Asteasu;1192;639;553
20;Guipúzcoa;903;Astigarraga;3178;1569;1609
20;Guipúzcoa;015;Ataun;1589;815;774
20;Guipúzcoa;017;Azkoitia;10240;5098;5142
20;Guipúzcoa;018;Azpeitia;13536;6784;6752
20;Guipúzcoa;904;Baliarrain;94;45;49
20;Guipúzcoa;019;Beasain;12331;6162;6169
20;Guipúzcoa;020;Beizama;164;91;73
20;Guipúzcoa;021;Belauntza;286;154;132
20;Guipúzcoa;022;Berastegi;932;507;425
20;Guipúzcoa;074;Bergara;15317;7618;7699
20;Guipúzcoa;023;Berrobi;565;306;259
20;Guipúzcoa;024;Bidegoyan;421;238;183
20;Guipúzcoa;029;Deba;5042;2569;2473
20;Guipúzcoa;069;Donostia/San Sebastián;176908;82986;93922
20;Guipúzcoa;030;Eibar;30314;14850;15464
20;Guipúzcoa;031;Elduain;227;123;104
20;Guipúzcoa;033;Elgeta;982;506;476
20;Guipúzcoa;032;Elgoibar;10989;5483;5506
20;Guipúzcoa;067;Errenteria;39663;19505;20158
20;Guipúzcoa;066;Errezil;639;353;286
20;Guipúzcoa;034;Eskoriatza;3999;2075;1924
20;Guipúzcoa;035;Ezkio-Itsaso;538;280;258
20;Guipúzcoa;038;Gabiria;428;236;192
20;Guipúzcoa;037;Gaintza;136;82;54
20;Guipúzcoa;907;Gaztelu;144;84;60
20;Guipúzcoa;039;Getaria;2397;1208;1189
20;Guipúzcoa;040;Hernani;18627;9268;9359
20;Guipúzcoa;041;Hernialde;301;152;149
20;Guipúzcoa;036;Hondarribia;14453;7197;7256
20;Guipúzcoa;042;Ibarra;4287;2226;2061
20;Guipúzcoa;043;Idiazabal;2020;1030;990
20;Guipúzcoa;044;Ikaztegieta;380;197;183
20;Guipúzcoa;045;Irún;55215;27002;28213
20;Guipúzcoa;046;Irura;726;365;361
20;Guipúzcoa;047;Itsasondo;628;316;312
20;Guipúzcoa;048;Larraul;135;80;55
20;Guipúzcoa;902;Lasarte-Oria;17861;8881;8980
20;Guipúzcoa;049;Lazkao;4902;2521;2381
20;Guipúzcoa;050;Leaburu;377;205;172
20;Guipúzcoa;051;Legazpi;9278;4762;4516
20;Guipúzcoa;052;Legorreta;1420;715;705
20;Guipúzcoa;068;Leintz-Gatzaga;250;140;110
20;Guipúzcoa;053;Lezo;5753;2838;2915
20;Guipúzcoa;054;Lizartza;644;341;303
20;Guipúzcoa;901;Mendaro;1308;674;634
20;Guipúzcoa;057;Mutiloa;168;86;82
20;Guipúzcoa;056;Mutriku;4774;2373;2401
20;Guipúzcoa;063;Oiartzun;8878;4446;4432
20;Guipúzcoa;058;Olaberria;1010;521;489
20;Guipúzcoa;076;Ordizia;9120;4459;4661
20;Guipúzcoa;905;Orendain;156;91;65
20;Guipúzcoa;060;Orexa;79;40;39
20;Guipúzcoa;061;Orio;4266;2166;2100
20;Guipúzcoa;062;Ormaiztegi;1182;596;586
20;Guipúzcoa;059;Oñati;10564;5281;5283
20;Guipúzcoa;064;Pasaia;17300;8416;8884
20;Guipúzcoa;070;Segura;1263;626;637
20;Guipúzcoa;065;Soraluze/Placencia de las Armas;4430;2200;2230
20;Guipúzcoa;071;Tolosa;17979;8636;9343
20;Guipúzcoa;072;Urnieta;5120;2622;2498
20;Guipúzcoa;077;Urretxu;6242;3149;3093
20;Guipúzcoa;073;Usurbil;5265;2706;2559
20;Guipúzcoa;075;Villabona;5370;2727;2643
20;Guipúzcoa;078;Zaldibia;1573;817;756
20;Guipúzcoa;079;Zarautz;19202;9482;9720
20;Guipúzcoa;025;Zegama;1348;686;662
20;Guipúzcoa;026;Zerain;233;115;118
20;Guipúzcoa;027;Zestoa;3252;1688;1564
20;Guipúzcoa;028;Zizurkil;2684;1358;1326
20;Guipúzcoa;081;Zumaia;8280;4143;4137
20;Guipúzcoa;080;Zumarraga;10324;5185;5139
21;Huelva;001;Alájar;804;406;398
21;Huelva;002;Aljaraque;9587;4808;4779
21;Huelva;003;Almendro (El);862;448;414
21;Huelva;004;Almonaster la Real;2057;1010;1047
21;Huelva;005;Almonte;16264;8156;8108
21;Huelva;006;Alosno;5054;2436;2618
21;Huelva;007;Aracena;6708;3292;3416
21;Huelva;008;Aroche;3581;1771;1810
21;Huelva;009;Arroyomolinos de León;1168;599;569
21;Huelva;010;Ayamonte;17566;8613;8953
21;Huelva;011;Beas;4232;2117;2115
21;Huelva;012;Berrocal;428;213;215
21;Huelva;013;Bollullos Par del Condado;12741;6333;6408
21;Huelva;014;Bonares;5056;2559;2497
21;Huelva;015;Cabezas Rubias;1009;517;492
21;Huelva;016;Cala;1493;748;745
21;Huelva;017;Calañas;4974;2465;2509
21;Huelva;018;Campillo (El);2452;1184;1268
21;Huelva;019;Campofrío;871;443;428
21;Huelva;020;Cañaveral de León;539;263;276
21;Huelva;021;Cartaya;11435;5676;5759
21;Huelva;022;Castaño del Robledo;201;105;96
21;Huelva;023;Cerro de Andévalo (El);2785;1365;1420
21;Huelva;030;Chucena;1930;978;952
21;Huelva;024;Corteconcepción;689;356;333
21;Huelva;025;Cortegana;5206;2588;2618
21;Huelva;026;Cortelazor;338;170;168
21;Huelva;027;Cumbres de Enmedio;60;31;29
21;Huelva;028;Cumbres de San Bartolomé;597;299;298
21;Huelva;029;Cumbres Mayores;2184;1078;1106
21;Huelva;031;Encinasola;1945;958;987
21;Huelva;032;Escacena del Campo;2226;1099;1127
21;Huelva;033;Fuenteheridos;676;340;336
21;Huelva;034;Galaroza;1594;774;820
21;Huelva;035;Gibraleón;11166;5623;5543
21;Huelva;036;Granada de Río-Tinto (La);234;119;115
21;Huelva;037;Granado (El);680;365;315
21;Huelva;038;Higuera de la Sierra;1291;648;643
21;Huelva;039;Hinojales;441;217;224
21;Huelva;040;Hinojos;3482;1771;1711
21;Huelva;041;Huelva;140675;68072;72603
21;Huelva;042;Isla Cristina;17310;8635;8675
21;Huelva;043;Jabugo;2595;1298;1297
21;Huelva;044;Lepe;18325;9361;8964
21;Huelva;045;Linares de la Sierra;301;143;158
21;Huelva;046;Lucena del Puerto;2180;1117;1063
21;Huelva;047;Manzanilla;2523;1260;1263
21;Huelva;048;Marines (Los);329;164;165
21;Huelva;049;Minas de Riotinto;5212;2482;2730
21;Huelva;050;Moguer;13371;6766;6605
21;Huelva;051;Nava (La);328;168;160
21;Huelva;052;Nerva;6594;3191;3403
21;Huelva;053;Niebla;3846;1955;1891
21;Huelva;054;Palma del Condado (La);9749;4815;4934
21;Huelva;055;Palos de la Frontera;6884;3483;3401
21;Huelva;056;Paterna del Campo;3883;1995;1888
21;Huelva;057;Paymogo;1294;617;677
21;Huelva;058;Puebla de Guzmán;3275;1646;1629
21;Huelva;059;Puerto Moral;242;119;123
21;Huelva;060;Punta Umbría;10998;5603;5395
21;Huelva;061;Rociana del Condado;6348;3231;3117
21;Huelva;062;Rosal de la Frontera;1915;915;1000
21;Huelva;063;San Bartolomé de la Torre;2940;1496;1444
21;Huelva;064;San Juan del Puerto;5990;2997;2993
21;Huelva;066;San Silvestre de Guzmán;660;327;333
21;Huelva;065;Sanlúcar de Guadiana;392;191;201
21;Huelva;067;Santa Ana la Real;495;235;260
21;Huelva;068;Santa Bárbara de Casa;1401;702;699
21;Huelva;069;Santa Olalla del Cala;2285;1158;1127
21;Huelva;070;Trigueros;7280;3629;3651
21;Huelva;071;Valdelarco;283;137;146
21;Huelva;072;Valverde del Camino;12609;6112;6497
21;Huelva;073;Villablanca;2072;1075;997
21;Huelva;074;Villalba del Alcor;3618;1793;1825
21;Huelva;075;Villanueva de las Cruces;460;220;240
21;Huelva;076;Villanueva de los Castillejos;2684;1316;1368
21;Huelva;077;Villarrasa;2092;1070;1022
21;Huelva;078;Zalamea la Real;3545;1741;1804
21;Huelva;079;Zufre;1146;600;546
22;Huesca;001;Abiego;305;149;156
22;Huesca;002;Abizanda;136;72;64
22;Huesca;003;Adahuesca;171;88;83
22;Huesca;004;Agüero;163;86;77
22;Huesca;907;Aínsa-Sobrarbe;1512;787;725
22;Huesca;006;Aisa;354;193;161
22;Huesca;007;Albalate de Cinca;1107;566;541
22;Huesca;008;Albalatillo;271;137;134
22;Huesca;009;Albelda;975;497;478
22;Huesca;011;Albero Alto;101;53;48
22;Huesca;012;Albero Bajo;117;64;53
22;Huesca;013;Alberuela de Tubo;404;205;199
22;Huesca;014;Alcalá de Gurrea;370;185;185
22;Huesca;015;Alcalá del Obispo;353;178;175
22;Huesca;016;Alcampell;1015;505;510
22;Huesca;017;Alcolea de Cinca;1245;638;607
22;Huesca;018;Alcubierre;483;258;225
22;Huesca;019;Alerre;167;88;79
22;Huesca;020;Alfántega;131;66;65
22;Huesca;021;Almudévar;2379;1234;1145
22;Huesca;022;Almunia de San Juan;704;353;351
22;Huesca;023;Almuniente;644;333;311
22;Huesca;024;Alquézar;303;152;151
22;Huesca;025;Altorricón;1454;745;709
22;Huesca;027;Angüés;461;253;208
22;Huesca;028;Ansó;509;256;253
22;Huesca;029;Antillón;171;80;91
22;Huesca;032;Aragüés del Puerto;144;90;54
22;Huesca;035;Arén;418;217;201
22;Huesca;036;Argavieso;121;69;52
22;Huesca;037;Arguis;59;32;27
22;Huesca;039;Ayerbe;1142;588;554
22;Huesca;040;Azanuy-Alins;204;98;106
22;Huesca;041;Azara;231;113;118
22;Huesca;042;Azlor;174;88;86
22;Huesca;043;Baélls;160;84;76
22;Huesca;044;Bailo;338;199;139
22;Huesca;045;Baldellou;159;86;73
22;Huesca;046;Ballobar;1102;562;540
22;Huesca;047;Banastás;170;87;83
22;Huesca;048;Barbastro;14520;7044;7476
22;Huesca;049;Barbués;121;62;59
22;Huesca;050;Barbuñales;110;55;55
22;Huesca;051;Bárcabo;114;63;51
22;Huesca;052;Belver de Cinca;1406;748;658
22;Huesca;053;Benabarre;1195;616;579
22;Huesca;054;Benasque;1219;638;581
22;Huesca;055;Berbegal;486;245;241
22;Huesca;057;Bielsa;472;245;227
22;Huesca;058;Bierge;224;129;95
22;Huesca;059;Biescas;1240;644;596
22;Huesca;060;Binaced;1622;831;791
22;Huesca;061;Binéfar;8130;4065;4065
22;Huesca;062;Bisaurri;223;126;97
22;Huesca;063;Biscarrués;249;132;117
22;Huesca;064;Blecua y Torres;187;98;89
22;Huesca;066;Boltaña;881;445;436
22;Huesca;067;Bonansa;72;37;35
22;Huesca;068;Borau;78;42;36
22;Huesca;069;Broto;522;265;257
22;Huesca;072;Caldearenas;267;150;117
22;Huesca;074;Campo;376;175;201
22;Huesca;075;Camporrélls;263;130;133
22;Huesca;076;Canal de Berdún;429;237;192
22;Huesca;077;Candasnos;572;296;276
22;Huesca;078;Canfranc;509;269;240
22;Huesca;079;Capdesaso;194;92;102
22;Huesca;080;Capella;406;209;197
22;Huesca;081;Casbas de Huesca;322;171;151
22;Huesca;083;Castejón de Monegros;754;375;379
22;Huesca;084;Castejón de Sos;514;267;247
22;Huesca;082;Castejón del Puente;407;213;194
22;Huesca;085;Castelflorite;157;83;74
22;Huesca;086;Castiello de Jaca;156;80;76
22;Huesca;087;Castigaleu;104;61;43
22;Huesca;088;Castillazuelo;239;115;124
22;Huesca;089;Castillonroy;444;220;224
22;Huesca;094;Chalamera;179;92;87
22;Huesca;095;Chía;121;67;54
22;Huesca;096;Chimillas;162;88;74
22;Huesca;090;Colungo;129;69;60
22;Huesca;099;Esplús;811;394;417
22;Huesca;102;Estada;198;103;95
22;Huesca;103;Estadilla;968;486;482
22;Huesca;105;Estopiñán del Castillo;195;102;93
22;Huesca;106;Fago;43;28;15
22;Huesca;107;Fanlo;107;63;44
22;Huesca;109;Fiscal;244;136;108
22;Huesca;110;Fonz;1169;604;565
22;Huesca;111;Foradada del Toscar;260;126;134
22;Huesca;112;Fraga;11783;5890;5893
22;Huesca;113;Fueva (La);622;330;292
22;Huesca;114;Gistaín;187;109;78
22;Huesca;115;Grado (El);586;308;278
22;Huesca;116;Grañén;2062;1047;1015
22;Huesca;117;Graus;3300;1672;1628
22;Huesca;119;Gurrea de Gállego;1895;961;934
22;Huesca;122;Hoz de Jaca;80;33;47
22;Huesca;908;Hoz y Costean;275;147;128
22;Huesca;124;Huerto;268;146;122
22;Huesca;125;Huesca;45607;21940;23667
22;Huesca;126;Ibieca;110;60;50
22;Huesca;127;Igriés;193;105;88
22;Huesca;128;Ilche;294;151;143
22;Huesca;129;Isábena;268;140;128
22;Huesca;130;Jaca;11310;5615;5695
22;Huesca;131;Jasa;137;74;63
22;Huesca;133;Labuerda;180;96;84
22;Huesca;135;Laluenga;271;142;129
22;Huesca;136;Lalueza;1292;702;590
22;Huesca;137;Lanaja;1651;868;783
22;Huesca;139;Laperdiguera;103;53;50
22;Huesca;141;Lascellas-Ponzano;169;88;81
22;Huesca;142;Lascuarre;173;93;80
22;Huesca;143;Laspaúles;284;159;125
22;Huesca;144;Laspuña;278;154;124
22;Huesca;149;Loarre;412;216;196
22;Huesca;150;Loporzano;537;272;265
22;Huesca;151;Loscorrales;127;69;58
22;Huesca;905;Lupiñén-Ortilla;366;197;169
22;Huesca;155;Monesma y Cajigar;105;54;51
22;Huesca;156;Monflorite-Lascasas;193;105;88
22;Huesca;157;Montanuy;322;182;140
22;Huesca;158;Monzón;14576;7340;7236
22;Huesca;160;Naval;301;151;150
22;Huesca;162;Novales;197;97;100
22;Huesca;163;Nueno;217;123;94
22;Huesca;164;Olvena;53;22;31
22;Huesca;165;Ontiñena;682;350;332
22;Huesca;167;Osso de Cinca;738;394;344
22;Huesca;168;Palo;33;16;17
22;Huesca;170;Panticosa;613;313;300
22;Huesca;172;Peñalba;817;408;409
22;Huesca;173;Peñas de Riglos (Las);298;165;133
22;Huesca;174;Peralta de Alcofea;762;377;385
22;Huesca;175;Peralta de Calasanz;306;165;141
22;Huesca;176;Peraltilla;180;95;85
22;Huesca;177;Perarrúa;147;72;75
22;Huesca;178;Pertusa;147;75;72
22;Huesca;181;Piracés;100;64;36
22;Huesca;182;Plan;312;173;139
22;Huesca;184;Poleñino;253;127;126
22;Huesca;186;Pozán de Vero;257;126;131
22;Huesca;187;Puebla de Castro (La);306;158;148
22;Huesca;188;Puente de Montañana;142;71;71
22;Huesca;902;Puente la Reina de Jaca;269;136;133
22;Huesca;189;Puértolas;219;128;91
22;Huesca;190;Pueyo de Araguás (El);184;113;71
22;Huesca;193;Pueyo de Santa Cruz;371;192;179
22;Huesca;195;Quicena;146;72;74
22;Huesca;197;Robres;709;366;343
22;Huesca;199;Sabiñánigo;8759;4439;4320
22;Huesca;200;Sahún;323;174;149
22;Huesca;201;Salas Altas;403;212;191
22;Huesca;202;Salas Bajas;180;80;100
22;Huesca;203;Salillas;130;67;63
22;Huesca;204;Sallent de Gállego;983;514;469
22;Huesca;205;San Esteban de Litera;658;331;327
22;Huesca;207;San Juan de Plan;166;90;76
22;Huesca;903;San Miguel del Cinca;918;477;441
22;Huesca;206;Sangarrén;285;143;142
22;Huesca;208;Santa Cilia;205;110;95
22;Huesca;209;Santa Cruz de la Serós;162;93;69
22;Huesca;906;Santa María de Dulcis;214;109;105
22;Huesca;212;Santaliestra y San Quílez;101;58;43
22;Huesca;213;Sariñena;4058;2022;2036
22;Huesca;214;Secastilla;168;78;90
22;Huesca;215;Seira;202;101;101
22;Huesca;217;Sena;615;323;292
22;Huesca;218;Senés de Alcubierre;60;31;29
22;Huesca;220;Sesa;281;144;137
22;Huesca;221;Sesué;117;63;54
22;Huesca;222;Siétamo;361;204;157
22;Huesca;223;Sopeira;113;59;54
22;Huesca;904;Sotonera (La);1127;599;528
22;Huesca;225;Tamarite de Litera;3867;1918;1949
22;Huesca;226;Tardienta;1087;560;527
22;Huesca;227;Tella-Sin;293;154;139
22;Huesca;228;Tierz;183;92;91
22;Huesca;229;Tolva;220;119;101
22;Huesca;230;Torla;344;183;161
22;Huesca;232;Torralba de Aragón;136;63;73
22;Huesca;233;Torre la Ribera;120;68;52
22;Huesca;234;Torrente de Cinca;1142;565;577
22;Huesca;235;Torres de Alcanadre;139;82;57
22;Huesca;236;Torres de Barbués;370;185;185
22;Huesca;239;Tramaced;104;61;43
22;Huesca;242;Valfarta;109;58;51
22;Huesca;243;Valle de Bardají;57;29;28
22;Huesca;901;Valle de Hecho;1005;536;469
22;Huesca;244;Valle de Lierp;63;34;29
22;Huesca;245;Velilla de Cinca;499;243;256
22;Huesca;909;Vencillón;481;247;234
22;Huesca;246;Veracruz;116;64;52
22;Huesca;247;Viacamp y Litera;32;21;11
22;Huesca;248;Vicién;126;70;56
22;Huesca;249;Villanova;113;62;51
22;Huesca;250;Villanúa;317;160;157
22;Huesca;251;Villanueva de Sigena;492;256;236
22;Huesca;252;Yebra de Basa;172;105;67
22;Huesca;253;Yésero;70;37;33
22;Huesca;254;Zaidín;1698;851;847
23;Jaén;001;Albanchez de Mágina;1540;768;772
23;Jaén;002;Alcalá la Real;21558;10692;10866
23;Jaén;003;Alcaudete;11367;5623;5744
23;Jaén;004;Aldeaquemada;622;311;311
23;Jaén;005;Andújar;37705;18655;19050
23;Jaén;006;Arjona;5660;2839;2821
23;Jaén;007;Arjonilla;4072;2040;2032
23;Jaén;008;Arquillos;1900;950;950
23;Jaén;905;Arroyo del Ojanco;"";"";""
23;Jaén;009;Baeza;16012;7856;8156
23;Jaén;010;Bailén;17408;8733;8675
23;Jaén;011;Baños de la Encina;2756;1413;1343
23;Jaén;012;Beas de Segura;8261;4145;4116
23;Jaén;902;Bedmar y Garcíez;3234;1632;1602
23;Jaén;014;Begíjar;3111;1572;1539
23;Jaén;015;Bélmez de la Moraleda;2011;989;1022
23;Jaén;016;Benatae;585;295;290
23;Jaén;017;Cabra del Santo Cristo;2280;1166;1114
23;Jaén;018;Cambil;3297;1734;1563
23;Jaén;019;Campillo de Arenas;2291;1157;1134
23;Jaén;020;Canena;2137;1037;1100
23;Jaén;021;Carboneros;700;345;355
23;Jaén;901;Cárcheles;1564;776;788
23;Jaén;024;Carolina (La);15048;7380;7668
23;Jaén;025;Castellar;3695;1860;1835
23;Jaén;026;Castillo de Locubín;5667;2805;2862
23;Jaén;027;Cazalilla;867;422;445
23;Jaén;028;Cazorla;9690;4741;4949
23;Jaén;029;Chiclana de Segura;1679;845;834
23;Jaén;030;Chilluévar;1811;896;915
23;Jaén;031;Escañuela;1005;498;507
23;Jaén;032;Espelúy;814;396;418
23;Jaén;033;Frailes;1891;955;936
23;Jaén;034;Fuensanta de Martos;3391;1650;1741
23;Jaén;035;Fuerte del Rey;1183;583;600
23;Jaén;037;Génave;720;367;353
23;Jaén;038;Guardia de Jaén (La);2051;1060;991
23;Jaén;039;Guarromán;2874;1410;1464
23;Jaén;041;Higuera de Calatrava;707;366;341
23;Jaén;042;Hinojares;524;257;267
23;Jaén;043;Hornos;761;377;384
23;Jaén;044;Huelma;6021;3026;2995
23;Jaén;045;Huesa;2764;1409;1355
23;Jaén;046;Ibros;3158;1593;1565
23;Jaén;047;Iruela (La);2106;1074;1032
23;Jaén;048;Iznatoraf;1218;595;623
23;Jaén;049;Jabalquinto;2631;1305;1326
23;Jaén;050;Jaén;104776;50470;54306
23;Jaén;051;Jamilena;3306;1676;1630
23;Jaén;052;Jimena;1604;780;824
23;Jaén;053;Jódar;12060;5970;6090
23;Jaén;040;Lahiguera;1919;934;985
23;Jaén;054;Larva;546;281;265
23;Jaén;055;Linares;60222;29415;30807
23;Jaén;056;Lopera;4004;1973;2031
23;Jaén;057;Lupión;1107;519;588
23;Jaén;058;Mancha Real;8913;4468;4445
23;Jaén;059;Marmolejo;7707;3879;3828
23;Jaén;060;Martos;22307;10779;11528
23;Jaén;061;Mengíbar;8563;4314;4249
23;Jaén;062;Montizón;2015;1016;999
23;Jaén;063;Navas de San Juan;5363;2650;2713
23;Jaén;064;Noalejo;2408;1210;1198
23;Jaén;065;Orcera;2389;1213;1176
23;Jaén;066;Peal de Becerro;5147;2551;2596
23;Jaén;067;Pegalajar;3136;1569;1567
23;Jaén;069;Porcuna;7008;3504;3504
23;Jaén;070;Pozo Alcón;6385;3238;3147
23;Jaén;071;Puente de Génave;2073;1037;1036
23;Jaén;072;Puerta de Segura (La);2818;1405;1413
23;Jaén;073;Quesada;6256;3085;3171
23;Jaén;074;Rus;3773;1888;1885
23;Jaén;075;Sabiote;4325;2107;2218
23;Jaén;076;Santa Elena;1077;577;500
23;Jaén;077;Santiago de Calatrava;942;469;473
23;Jaén;904;Santiago-Pontones;5021;2536;2485
23;Jaén;079;Santisteban del Puerto;5058;2561;2497
23;Jaén;080;Santo Tomé;2503;1257;1246
23;Jaén;081;Segura de la Sierra;2196;1087;1109
23;Jaén;082;Siles;2871;1433;1438
23;Jaén;084;Sorihuela del Guadalimar;1283;647;636
23;Jaén;086;Torre del Campo;12301;6123;6178
23;Jaén;085;Torreblascopedro;3033;1496;1537
23;Jaén;087;Torredonjimeno;13688;6675;7013
23;Jaén;088;Torreperogil;7490;3660;3830
23;Jaén;090;Torres;1882;950;932
23;Jaén;091;Torres de Albánchez;1075;538;537
23;Jaén;092;Úbeda;32086;15707;16379
23;Jaén;093;Valdepeñas de Jaén;4560;2290;2270
23;Jaén;094;Vilches;5162;2573;2589
23;Jaén;095;Villacarrillo;11107;5533;5574
23;Jaén;096;Villanueva de la Reina;3301;1624;1677
23;Jaén;097;Villanueva del Arzobispo;8495;4181;4314
23;Jaén;098;Villardompardo;1279;620;659
23;Jaén;099;Villares (Los);4968;2462;2506
23;Jaén;101;Villarrodrigo;617;304;313
23;Jaén;903;Villatorres;4079;2027;2052
24;León;001;Acebedo;305;165;140
24;León;002;Algadefe;388;199;189
24;León;003;Alija del Infantado;1051;524;527
24;León;004;Almanza;807;423;384
24;León;005;Antigua (La);668;349;319
24;León;006;Ardón;728;381;347
24;León;007;Arganza;962;465;497
24;León;008;Astorga;12564;5950;6614
24;León;009;Balboa;501;268;233
24;León;010;Bañeza (La);10492;5108;5384
24;León;011;Barjas;458;248;210
24;León;012;Barrios de Luna (Los);368;184;184
24;León;014;Bembibre;11104;5532;5572
24;León;015;Benavides;3096;1588;1508
24;León;016;Benuza;728;380;348
24;León;017;Bercianos del Páramo;904;449;455
24;León;018;Bercianos del Real Camino;242;121;121
24;León;019;Berlanga del Bierzo;459;220;239
24;León;020;Boca de Huérgano;663;367;296
24;León;021;Boñar;2664;1301;1363
24;León;022;Borrenes;551;281;270
24;León;023;Brazuelo;370;176;194
24;León;024;Burgo Ranero (El);1002;526;476
24;León;025;Burón;415;215;200
24;León;026;Bustillo del Páramo;1999;996;1003
24;León;027;Cabañas Raras;1305;668;637
24;León;028;Cabreros del Río;647;336;311
24;León;029;Cabrillanes;1209;588;621
24;León;030;Cacabelos;4846;2425;2421
24;León;031;Calzada del Coto;316;172;144
24;León;032;Campazas;182;90;92
24;León;033;Campo de Villavidel;360;187;173
24;León;034;Camponaraya;3226;1568;1658
24;León;036;Candín;444;242;202
24;León;037;Cármenes;458;232;226
24;León;038;Carracedelo;3533;1751;1782
24;León;039;Carrizo;2829;1427;1402
24;León;040;Carrocera;647;323;324
24;León;041;Carucedo;674;320;354
24;León;042;Castilfalé;107;57;50
24;León;043;Castrillo de Cabrera;203;101;102
24;León;044;Castrillo de la Valduerna;257;113;144
24;León;046;Castrocalbón;1449;741;708
24;León;047;Castrocontrigo;1209;595;614
24;León;049;Castropodame;1873;936;937
24;León;050;Castrotierra de Valmadrigal;172;88;84
24;León;051;Cea;787;403;384
24;León;052;Cebanico;276;149;127
24;León;053;Cebrones del Río;754;386;368
24;León;065;Chozas de Abajo;2203;1122;1081
24;León;054;Cimanes de la Vega;725;355;370
24;León;055;Cimanes del Tejar;1113;557;556
24;León;056;Cistierna;4509;2233;2276
24;León;057;Congosto;1788;859;929
24;León;058;Corbillos de los Oteros;318;164;154
24;León;059;Corullón;1302;633;669
24;León;060;Crémenes;1319;629;690
24;León;061;Cuadros;1661;789;872
24;León;062;Cubillas de los Oteros;232;115;117
24;León;063;Cubillas de Rueda;653;337;316
24;León;064;Cubillos del Sil;1539;803;736
24;León;066;Destriana;935;450;485
24;León;067;Encinedo;1147;586;561
24;León;068;Ercina (La);759;373;386
24;León;069;Escobar de Campos;89;52;37
24;León;070;Fabero;6120;3089;3031
24;León;071;Folgoso de la Ribera;1442;702;740
24;León;073;Fresno de la Vega;745;370;375
24;León;074;Fuentes de Carbajal;149;75;74
24;León;076;Garrafe de Torío;1097;561;536
24;León;077;Gordaliza del Pino;385;195;190
24;León;078;Gordoncillo;688;340;348
24;León;079;Gradefes;1383;678;705
24;León;080;Grajal de Campos;308;132;176
24;León;081;Gusendos de los Oteros;246;121;125
24;León;082;Hospital de Órbigo;1195;591;604
24;León;083;Igüeña;2148;1129;1019
24;León;084;Izagre;278;139;139
24;León;086;Joarilla de las Matas;475;246;229
24;León;087;Laguna Dalga;971;480;491
24;León;088;Laguna de Negrillos;1656;847;809
24;León;089;León;145242;68024;77218
24;León;092;Llamas de la Ribera;1297;656;641
24;León;090;Lucillo;560;282;278
24;León;091;Luyego;1030;493;537
24;León;093;Magaz de Cepeda;579;284;295
24;León;094;Mansilla de las Mulas;1785;896;889
24;León;095;Mansilla Mayor;413;199;214
24;León;096;Maraña;191;100;91
24;León;097;Matadeón de los Oteros;326;165;161
24;León;098;Matallana de Torío;1778;886;892
24;León;099;Matanza;333;164;169
24;León;100;Molinaseca;815;422;393
24;León;101;Murias de Paredes;760;356;404
24;León;102;Noceda del Bierzo;1012;502;510
24;León;103;Oencia;557;300;257
24;León;104;Omañas (Las);494;246;248
24;León;105;Onzonilla;1435;711;724
24;León;106;Oseja de Sajambre;356;197;159
24;León;107;Pajares de los Oteros;403;208;195
24;León;108;Palacios de la Valduerna;570;275;295
24;León;109;Palacios del Sil;1570;789;781
24;León;110;Páramo del Sil;1959;992;967
24;León;112;Peranzanes;373;208;165
24;León;113;Pobladura de Pelayo García;609;312;297
24;León;114;Pola de Gordón (La);5471;2655;2816
24;León;115;Ponferrada;61575;30104;31471
24;León;116;Posada de Valdeón;511;269;242
24;León;117;Pozuelo del Páramo;707;368;339
24;León;118;Prado de la Guzpeña;181;98;83
24;León;119;Priaranza del Bierzo;1021;525;496
24;León;120;Prioro;512;269;243
24;León;121;Puebla de Lillo;706;378;328
24;León;122;Puente de Domingo Flórez;1980;1040;940
24;León;123;Quintana del Castillo;1185;616;569
24;León;124;Quintana del Marco;580;297;283
24;León;125;Quintana y Congosto;900;467;433
24;León;127;Regueras de Arriba;430;223;207
24;León;129;Reyero;165;86;79
24;León;130;Riaño;540;294;246
24;León;131;Riego de la Vega;1171;576;595
24;León;132;Riello;1093;558;535
24;León;133;Rioseco de Tapia;615;325;290
24;León;134;Robla (La);5227;2614;2613
24;León;136;Roperuelos del Páramo;867;431;436
24;León;137;Sabero;2026;1008;1018
24;León;139;Sahagún;3298;1592;1706
24;León;141;San Adrián del Valle;173;81;92
24;León;142;San Andrés del Rabanedo;23226;11299;11927
24;León;144;San Cristóbal de la Polantera;1178;594;584
24;León;145;San Emiliano;1030;525;505
24;León;146;San Esteban de Nogales;390;185;205
24;León;148;San Justo de la Vega;2365;1190;1175
24;León;149;San Millán de los Caballeros;201;105;96
24;León;150;San Pedro Bercianos;400;196;204
24;León;143;Sancedo;620;310;310
24;León;151;Santa Colomba de Curueño;712;339;373
24;León;152;Santa Colomba de Somoza;495;247;248
24;León;153;Santa Cristina de Valmadrigal;407;206;201
24;León;154;Santa Elena de Jamuz;1458;738;720
24;León;155;Santa María de la Isla;746;388;358
24;León;158;Santa María de Ordás;483;248;235
24;León;156;Santa María del Monte de Cea;422;209;213
24;León;157;Santa María del Páramo;3151;1509;1642
24;León;159;Santa Marina del Rey;2689;1339;1350
24;León;160;Santas Martas;1072;561;511
24;León;161;Santiago Millas;359;186;173
24;León;162;Santovenia de la Valdoncina;1523;746;777
24;León;163;Sariegos;2122;1061;1061
24;León;164;Sena de Luna;547;275;272
24;León;165;Sobrado;570;289;281
24;León;166;Soto de la Vega;2101;1070;1031
24;León;167;Soto y Amío;1150;564;586
24;León;168;Toral de los Guzmanes;729;381;348
24;León;169;Toreno;4481;2313;2168
24;León;170;Torre del Bierzo;3399;1697;1702
24;León;171;Trabadelo;633;330;303
24;León;172;Truchas;863;440;423
24;León;173;Turcia;1434;714;720
24;León;174;Urdiales del Páramo;771;395;376
24;León;185;Val de San Lorenzo;825;402;423
24;León;175;Valdefresno;1608;816;792
24;León;176;Valdefuentes del Páramo;477;247;230
24;León;177;Valdelugueros;491;265;226
24;León;178;Valdemora;131;62;69
24;León;179;Valdepiélago;423;205;218
24;León;180;Valdepolo;1684;874;810
24;León;181;Valderas;2305;1185;1120
24;León;182;Valderrey;692;333;359
24;León;183;Valderrueda;1421;716;705
24;León;184;Valdesamario;314;161;153
24;León;187;Valdevimbre;1288;648;640
24;León;188;Valencia de Don Juan;3826;1893;1933
24;León;191;Vallecillo;190;98;92
24;León;189;Valverde de la Virgen;4116;2063;2053
24;León;190;Valverde-Enrique;251;124;127
24;León;193;Vecilla (La);484;251;233
24;León;196;Vega de Espinareda;3123;1584;1539
24;León;197;Vega de Infanzones;864;426;438
24;León;198;Vega de Valcarce;998;503;495
24;León;194;Vegacervera;371;192;179
24;León;199;Vegaquemada;586;273;313
24;León;201;Vegas del Condado;1440;739;701
24;León;202;Villablino;15284;7715;7569
24;León;203;Villabraz;176;92;84
24;León;205;Villadangos del Páramo;996;501;495
24;León;206;Villadecanes;2408;1207;1201
24;León;207;Villademor de la Vega;492;262;230
24;León;209;Villafranca del Bierzo;4130;2043;2087
24;León;210;Villagatón;912;478;434
24;León;211;Villamandos;475;224;251
24;León;901;Villamanín;1362;674;688
24;León;212;Villamañán;1488;746;742
24;León;213;Villamartín de Don Sancho;218;115;103
24;León;214;Villamejil;1024;516;508
24;León;215;Villamol;270;134;136
24;León;216;Villamontán de la Valduerna;1170;591;579
24;León;217;Villamoratiel de las Matas;201;112;89
24;León;218;Villanueva de las Manzanas;656;322;334
24;León;219;Villaobispo de Otero;763;388;375
24;León;902;Villaornate y Castro;584;310;274
24;León;221;Villaquejida;1110;583;527
24;León;222;Villaquilambre;7048;3558;3490
24;León;223;Villarejo de Órbigo;3616;1766;1850
24;León;224;Villares de Órbigo;1028;520;508
24;León;225;Villasabariego;1204;605;599
24;León;226;Villaselán;348;191;157
24;León;227;Villaturiel;1803;923;880
24;León;228;Villazala;1101;580;521
24;León;229;Villazanzo de Valderaduey;744;410;334
24;León;230;Zotes del Páramo;734;374;360
25;Lleida;001;Abella de la Conca;186;102;84
25;Lleida;002;Àger;553;292;261
25;Lleida;003;Agramunt;4925;2489;2436
25;Lleida;038;Aitona;2183;1078;1105
25;Lleida;004;Alamús (Els);671;334;337
25;Lleida;005;Alàs i Cerc;409;220;189
25;Lleida;006;Albagés (L');507;265;242
25;Lleida;007;Albatàrrec;1007;499;508
25;Lleida;008;Albesa;1482;724;758
25;Lleida;009;Albi (L');791;405;386
25;Lleida;010;Alcanó;266;134;132
25;Lleida;011;Alcarràs;4715;2343;2372
25;Lleida;012;Alcoletge;1618;815;803
25;Lleida;013;Alfarràs;2947;1436;1511
25;Lleida;014;Alfés;345;184;161
25;Lleida;015;Algerri;522;256;266
25;Lleida;016;Alguaire;2825;1432;1393
25;Lleida;017;Alins;287;138;149
25;Lleida;019;Almacelles;5475;2774;2701
25;Lleida;020;Almatret;516;269;247
25;Lleida;021;Almenar;3439;1751;1688
25;Lleida;022;Alòs de Balaguer;188;109;79
25;Lleida;023;Alpicat;3412;1675;1737
25;Lleida;024;Alt Àneu;375;206;169
25;Lleida;027;Anglesola;1211;615;596
25;Lleida;029;Arbeca;2313;1155;1158
25;Lleida;031;Arres;64;34;30
25;Lleida;032;Arsèguel;101;52;49
25;Lleida;033;Artesa de Lleida;1217;611;606
25;Lleida;034;Artesa de Segre;3068;1570;1498
25;Lleida;036;Aspa;251;125;126
25;Lleida;037;Avellanes i Santa Linya (Les);460;243;217
25;Lleida;039;Baix Pallars;351;196;155
25;Lleida;040;Balaguer;13103;6421;6682
25;Lleida;041;Barbens;752;386;366
25;Lleida;042;Baronia de Rialb (La);251;127;124
25;Lleida;044;Bassella;341;174;167
25;Lleida;045;Bausen;70;41;29
25;Lleida;046;Belianes;558;269;289
25;Lleida;170;Bellaguarda;366;187;179
25;Lleida;047;Bellcaire d'Urgell;1369;654;715
25;Lleida;048;Bell-lloc d'Urgell;2119;1046;1073
25;Lleida;049;Bellmunt d'Urgell;233;116;117
25;Lleida;050;Bellpuig;3927;1941;1986
25;Lleida;051;Bellver de Cerdanya;1535;802;733
25;Lleida;052;Bellvís;2161;1073;1088
25;Lleida;053;Benavent de Segrià;786;407;379
25;Lleida;055;Biosca;265;130;135
25;Lleida;057;Bòrdes (Es);220;119;101
25;Lleida;058;Borges Blanques (Les);5190;2570;2620
25;Lleida;059;Bossòst;822;407;415
25;Lleida;056;Bovera;426;216;210
25;Lleida;060;Cabanabona;101;46;55
25;Lleida;061;Cabó;127;70;57
25;Lleida;062;Camarasa;897;449;448
25;Lleida;063;Canejan;104;56;48
25;Lleida;904;Castell de Mur;157;82;75
25;Lleida;064;Castellar de la Ribera;147;70;77
25;Lleida;067;Castelldans;949;488;461
25;Lleida;068;Castellnou de Seana;738;349;389
25;Lleida;069;Castelló de Farfanya;597;298;299
25;Lleida;070;Castellserà;1139;562;577
25;Lleida;071;Cava;61;36;25
25;Lleida;072;Cervera;7153;3505;3648
25;Lleida;073;Cervià de les Garrigues;862;447;415
25;Lleida;074;Ciutadilla;218;113;105
25;Lleida;075;Clariana de Cardener;148;77;71
25;Lleida;076;Cogul (El);230;116;114
25;Lleida;077;Coll de Nargó;606;321;285
25;Lleida;163;Coma i la Pedra (La);222;137;85
25;Lleida;161;Conca de Dalt;437;228;209
25;Lleida;078;Corbins;1037;523;514
25;Lleida;079;Cubells;360;182;178
25;Lleida;081;Espluga Calba (L');445;235;210
25;Lleida;082;Espot;272;143;129
25;Lleida;088;Estamariu;135;70;65
25;Lleida;085;Estaràs;165;89;76
25;Lleida;086;Esterri d'Àneu;611;293;318
25;Lleida;087;Esterri de Cardós;80;41;39
25;Lleida;089;Farrera;88;48;40
25;Lleida;908;Fígols i Alinyà;306;165;141
25;Lleida;092;Floresta (La);177;92;85
25;Lleida;093;Fondarella;653;327;326
25;Lleida;094;Foradada;175;101;74
25;Lleida;096;Fuliola (La);1264;636;628
25;Lleida;097;Fulleda;117;62;55
25;Lleida;098;Gavet de la Conca;335;163;172
25;Lleida;912;Gimenells i el Pla de la Font;1162;612;550
25;Lleida;099;Golmés;1276;612;664
25;Lleida;100;Gósol;210;116;94
25;Lleida;101;Granadella (La);839;428;411
25;Lleida;102;Granja d'Escarp (La);1115;587;528
25;Lleida;103;Granyanella;137;69;68
25;Lleida;105;Granyena de les Garrigues;179;91;88
25;Lleida;104;Granyena de Segarra;174;91;83
25;Lleida;109;Guimerà;397;197;200
25;Lleida;903;Guingueta d'Àneu (La);270;137;133
25;Lleida;110;Guissona;2928;1513;1415
25;Lleida;111;Guixers;148;90;58
25;Lleida;115;Isona i Conca Dellà;1272;670;602
25;Lleida;112;Ivars de Noguera;340;170;170
25;Lleida;113;Ivars d'Urgell;1715;870;845
25;Lleida;114;Ivorra;154;82;72
25;Lleida;910;Josa i Tuixén;141;78;63
25;Lleida;118;Juncosa;582;310;272
25;Lleida;119;Juneda;2996;1517;1479
25;Lleida;121;Les;673;338;335
25;Lleida;122;Linyola;2385;1184;1201
25;Lleida;123;Lladorre;212;109;103
25;Lleida;124;Lladurs;238;129;109
25;Lleida;125;Llardecans;650;333;317
25;Lleida;126;Llavorsí;273;141;132
25;Lleida;120;Lleida;112035;54564;57471
25;Lleida;127;Lles de Cerdanya;291;162;129
25;Lleida;128;Llimiana;136;72;64
25;Lleida;129;Llobera;240;125;115
25;Lleida;133;Maials;1017;517;500
25;Lleida;130;Maldà;300;152;148
25;Lleida;131;Massalcoreig;658;319;339
25;Lleida;132;Massoteres;169;85;84
25;Lleida;134;Menàrguens;836;423;413
25;Lleida;135;Miralcamp;1254;601;653
25;Lleida;137;Mollerussa;9400;4676;4724
25;Lleida;136;Molsosa (La);136;70;66
25;Lleida;139;Montellà i Martinet;493;251;242
25;Lleida;140;Montferrer i Castellbò;730;392;338
25;Lleida;138;Montgai;813;413;400
25;Lleida;142;Montoliu de Lleida;486;236;250
25;Lleida;141;Montoliu de Segarra;208;112;96
25;Lleida;143;Montornès de Segarra;105;48;57
25;Lleida;145;Nalec;104;48;56
25;Lleida;025;Naut Aran;1337;703;634
25;Lleida;146;Navès;264;129;135
25;Lleida;148;Odèn;285;162;123
25;Lleida;149;Oliana;1844;950;894
25;Lleida;150;Oliola;196;114;82
25;Lleida;151;Olius;482;237;245
25;Lleida;152;Oluges (Les);195;102;93
25;Lleida;153;Omellons (Els);271;135;136
25;Lleida;154;Omells de na Gaia (Els);152;86;66
25;Lleida;155;Organyà;1010;513;497
25;Lleida;156;Os de Balaguer;773;410;363
25;Lleida;157;Ossó de Sió;214;104;110
25;Lleida;158;Palau d'Anglesola (El);1623;815;808
25;Lleida;164;Penelles;573;308;265
25;Lleida;165;Peramola;375;196;179
25;Lleida;166;Pinell de Solsonès;232;123;109
25;Lleida;167;Pinós;325;181;144
25;Lleida;911;Plans de Sió (Els);609;312;297
25;Lleida;168;Poal (El);629;329;300
25;Lleida;169;Pobla de Cérvoles (La);198;113;85
25;Lleida;171;Pobla de Segur (La);2997;1448;1549
25;Lleida;030;Pont de Bar (El);142;76;66
25;Lleida;173;Pont de Suert (El);2167;1093;1074
25;Lleida;172;Ponts;2292;1148;1144
25;Lleida;174;Portella (La);585;312;273
25;Lleida;175;Prats i Sansor;180;98;82
25;Lleida;176;Preixana;437;221;216
25;Lleida;177;Preixens;521;251;270
25;Lleida;179;Prullans;208;107;101
25;Lleida;180;Puiggròs;254;129;125
25;Lleida;181;Puigverd d'Agramunt;223;118;105
25;Lleida;182;Puigverd de Lleida;1005;497;508
25;Lleida;183;Rialp;527;274;253
25;Lleida;905;Ribera d'Ondara;531;275;256
25;Lleida;185;Ribera d'Urgellet;743;391;352
25;Lleida;186;Riner;276;139;137
25;Lleida;913;Riu de Cerdanya;"";"";""
25;Lleida;189;Rosselló;1733;851;882
25;Lleida;190;Salàs de Pallars;358;182;176
25;Lleida;191;Sanaüja;462;227;235
25;Lleida;196;Sant Esteve de la Sarga;116;70;46
25;Lleida;192;Sant Guim de Freixenet;1056;515;541
25;Lleida;197;Sant Guim de la Plana;206;105;101
25;Lleida;193;Sant Llorenç de Morunys;900;444;456
25;Lleida;902;Sant Martí de Riucorb;736;378;358
25;Lleida;194;Sant Ramon;560;273;287
25;Lleida;201;Sarroca de Bellera;147;82;65
25;Lleida;200;Sarroca de Lleida;486;248;238
25;Lleida;202;Senterada;117;62;55
25;Lleida;035;Sentiu de Sió (La);468;224;244
25;Lleida;204;Seròs;1800;969;831
25;Lleida;203;Seu d'Urgell (La);10711;5230;5481
25;Lleida;205;Sidamon;455;232;223
25;Lleida;206;Soleràs (El);424;214;210
25;Lleida;207;Solsona;7128;3574;3554
25;Lleida;208;Soriguera;309;164;145
25;Lleida;209;Sort;1718;865;853
25;Lleida;210;Soses;1504;778;726
25;Lleida;211;Sudanell;736;394;342
25;Lleida;212;Sunyer;314;154;160
25;Lleida;215;Talarn;365;191;174
25;Lleida;216;Talavera;304;156;148
25;Lleida;217;Tàrrega;11855;5770;6085
25;Lleida;218;Tarrés;108;57;51
25;Lleida;219;Tarroja de Segarra;200;103;97
25;Lleida;220;Térmens;1401;709;692
25;Lleida;221;Tírvia;116;61;55
25;Lleida;222;Tiurana;22;15;7
25;Lleida;223;Torà;1143;581;562
25;Lleida;224;Torms (Els);198;109;89
25;Lleida;225;Tornabous;830;422;408
25;Lleida;227;Torre de Cabdella (La);691;342;349
25;Lleida;226;Torrebesses;339;166;173
25;Lleida;228;Torrefarrera;1593;810;783
25;Lleida;907;Torrefeta i Florejacs;683;334;349
25;Lleida;230;Torregrossa;2239;1105;1134
25;Lleida;231;Torrelameu;585;315;270
25;Lleida;232;Torres de Segre;1786;901;885
25;Lleida;233;Torre-serona;310;158;152
25;Lleida;234;Tremp;5503;2702;2801
25;Lleida;043;Vall de Boí (La);757;429;328
25;Lleida;901;Vall de Cardós;326;168;158
25;Lleida;238;Vallbona de les Monges;272;133;139
25;Lleida;240;Vallfogona de Balaguer;1430;722;708
25;Lleida;906;Valls d'Aguilar (Les);302;157;145
25;Lleida;239;Valls de Valira (Les);748;401;347
25;Lleida;909;Vansa i Fórnols (La);174;88;86
25;Lleida;242;Verdú;994;479;515
25;Lleida;243;Vielha e Mijaran;3692;1875;1817
25;Lleida;244;Vilagrassa;425;220;205
25;Lleida;245;Vilaller;618;328;290
25;Lleida;247;Vilamòs;148;72;76
25;Lleida;248;Vilanova de Bellpuig;1184;582;602
25;Lleida;254;Vilanova de la Barca;962;471;491
25;Lleida;249;Vilanova de l'Aguda;296;156;140
25;Lleida;250;Vilanova de Meià;485;253;232
25;Lleida;251;Vilanova de Segrià;705;351;354
25;Lleida;252;Vila-sana;533;261;272
25;Lleida;253;Vilosell (El);201;89;112
25;Lleida;255;Vinaixa;650;319;331
26;Rioja (La);001;Ábalos;289;168;121
26;Rioja (La);002;Agoncillo;885;461;424
26;Rioja (La);003;Aguilar del Río Alhama;728;371;357
26;Rioja (La);004;Ajamil de Cameros;79;53;26
26;Rioja (La);005;Albelda de Iregua;2267;1147;1120
26;Rioja (La);006;Alberite;1985;993;992
26;Rioja (La);007;Alcanadre;836;428;408
26;Rioja (La);008;Aldeanueva de Ebro;2523;1303;1220
26;Rioja (La);009;Alesanco;510;262;248
26;Rioja (La);010;Alesón;146;72;74
26;Rioja (La);011;Alfaro;9257;4621;4636
26;Rioja (La);012;Almarza de Cameros;40;25;15
26;Rioja (La);013;Anguciana;318;163;155
26;Rioja (La);014;Anguiano;643;359;284
26;Rioja (La);015;Arenzana de Abajo;331;173;158
26;Rioja (La);016;Arenzana de Arriba;41;23;18
26;Rioja (La);017;Arnedillo;433;205;228
26;Rioja (La);018;Arnedo;12715;6316;6399
26;Rioja (La);019;Arrúbal;440;228;212
26;Rioja (La);020;Ausejo;777;410;367
26;Rioja (La);021;Autol;3381;1725;1656
26;Rioja (La);022;Azofra;365;197;168
26;Rioja (La);023;Badarán;771;408;363
26;Rioja (La);024;Bañares;443;222;221
26;Rioja (La);026;Baños de Río Tobía;1845;934;911
26;Rioja (La);025;Baños de Rioja;117;68;49
26;Rioja (La);027;Berceo;228;136;92
26;Rioja (La);028;Bergasa;195;106;89
26;Rioja (La);029;Bergasillas Bajera;33;19;14
26;Rioja (La);030;Bezares;33;20;13
26;Rioja (La);031;Bobadilla;175;96;79
26;Rioja (La);032;Brieva de Cameros;77;45;32
26;Rioja (La);033;Briñas;197;98;99
26;Rioja (La);034;Briones;840;440;400
26;Rioja (La);035;Cabezón de Cameros;32;21;11
26;Rioja (La);036;Calahorra;18926;9161;9765
26;Rioja (La);037;Camprovín;239;128;111
26;Rioja (La);038;Canales de la Sierra;107;58;49
26;Rioja (La);039;Canillas de Río Tuerto;75;36;39
26;Rioja (La);040;Cañas;119;55;64
26;Rioja (La);041;Cárdenas;253;126;127
26;Rioja (La);042;Casalarreina;909;459;450
26;Rioja (La);043;Castañares de Rioja;496;256;240
26;Rioja (La);044;Castroviejo;63;32;31
26;Rioja (La);045;Cellorigo;20;11;9
26;Rioja (La);046;Cenicero;2102;1068;1034
26;Rioja (La);047;Cervera del Río Alhama;3381;1737;1644
26;Rioja (La);048;Cidamón;50;27;23
26;Rioja (La);049;Cihuri;149;78;71
26;Rioja (La);050;Cirueña;132;77;55
26;Rioja (La);051;Clavijo;202;105;97
26;Rioja (La);052;Cordovín;224;116;108
26;Rioja (La);053;Corera;257;126;131
26;Rioja (La);054;Cornago;637;347;290
26;Rioja (La);055;Corporales;64;33;31
26;Rioja (La);056;Cuzcurrita de Río Tirón;482;261;221
26;Rioja (La);057;Daroca de Rioja;61;37;24
26;Rioja (La);058;Enciso;188;114;74
26;Rioja (La);059;Entrena;1121;583;538
26;Rioja (La);060;Estollo;156;87;69
26;Rioja (La);061;Ezcaray;1812;948;864
26;Rioja (La);062;Foncea;130;68;62
26;Rioja (La);063;Fonzaleche;175;104;71
26;Rioja (La);064;Fuenmayor;2120;1055;1065
26;Rioja (La);065;Galbárruli;69;38;31
26;Rioja (La);066;Galilea;286;149;137
26;Rioja (La);067;Gallinero de Cameros;31;20;11
26;Rioja (La);068;Gimileo;95;47;48
26;Rioja (La);069;Grañón;439;230;209
26;Rioja (La);070;Grávalos;288;146;142
26;Rioja (La);071;Haro;9119;4503;4616
26;Rioja (La);072;Herce;378;188;190
26;Rioja (La);073;Herramélluri;179;96;83
26;Rioja (La);074;Hervías;204;108;96
26;Rioja (La);075;Hormilla;497;261;236
26;Rioja (La);076;Hormilleja;188;93;95
26;Rioja (La);077;Hornillos de Cameros;26;14;12
26;Rioja (La);078;Hornos de Moncalvillo;98;48;50
26;Rioja (La);079;Huércanos;895;457;438
26;Rioja (La);080;Igea;820;445;375
26;Rioja (La);081;Jalón de Cameros;33;19;14
26;Rioja (La);082;Laguna de Cameros;169;98;71
26;Rioja (La);083;Lagunilla del Jubera;386;208;178
26;Rioja (La);084;Lardero;3729;1859;1870
26;Rioja (La);086;Ledesma de la Cogolla;20;13;7
26;Rioja (La);087;Leiva;315;157;158
26;Rioja (La);088;Leza de Río Leza;33;22;11
26;Rioja (La);089;Logroño;123841;59526;64315
26;Rioja (La);091;Lumbreras;183;112;71
26;Rioja (La);092;Manjarrés;152;86;66
26;Rioja (La);093;Mansilla de la Sierra;54;37;17
26;Rioja (La);094;Manzanares de Rioja;132;70;62
26;Rioja (La);095;Matute;174;83;91
26;Rioja (La);096;Medrano;218;116;102
26;Rioja (La);098;Munilla;120;64;56
26;Rioja (La);099;Murillo de Río Leza;1573;798;775
26;Rioja (La);100;Muro de Aguas;74;44;30
26;Rioja (La);101;Muro en Cameros;43;28;15
26;Rioja (La);102;Nájera;6952;3452;3500
26;Rioja (La);103;Nalda;907;477;430
26;Rioja (La);104;Navajún;19;12;7
26;Rioja (La);105;Navarrete;2028;1027;1001
26;Rioja (La);106;Nestares;77;41;36
26;Rioja (La);107;Nieva de Cameros;122;64;58
26;Rioja (La);109;Ochánduri;108;55;53
26;Rioja (La);108;Ocón;353;201;152
26;Rioja (La);110;Ojacastro;241;142;99
26;Rioja (La);111;Ollauri;329;182;147
26;Rioja (La);112;Ortigosa de Cameros;338;176;162
26;Rioja (La);113;Pazuengos;51;33;18
26;Rioja (La);114;Pedroso;119;65;54
26;Rioja (La);115;Pinillos;31;17;14
26;Rioja (La);117;Pradejón;2904;1504;1400
26;Rioja (La);118;Pradillo;101;56;45
26;Rioja (La);119;Préjano;222;111;111
26;Rioja (La);120;Quel;1934;999;935
26;Rioja (La);121;Rabanera;64;40;24
26;Rioja (La);122;Rasillo de Cameros (El);125;63;62
26;Rioja (La);123;Redal (El);216;106;110
26;Rioja (La);124;Ribafrecha;1028;555;473
26;Rioja (La);125;Rincón de Soto;3343;1680;1663
26;Rioja (La);126;Robres del Castillo;20;13;7
26;Rioja (La);127;Rodezno;324;170;154
26;Rioja (La);128;Sajazarra;161;83;78
26;Rioja (La);129;San Asensio;1345;703;642
26;Rioja (La);130;San Millán de la Cogolla;288;179;109
26;Rioja (La);131;San Millán de Yécora;63;38;25
26;Rioja (La);132;San Román de Cameros;178;100;78
26;Rioja (La);139;San Torcuato;110;58;52
26;Rioja (La);142;San Vicente de la Sonsierra;1119;573;546
26;Rioja (La);134;Santa Coloma;153;95;58
26;Rioja (La);135;Santa Engracia del Jubera;232;139;93
26;Rioja (La);136;Santa Eulalia Bajera;111;62;49
26;Rioja (La);138;Santo Domingo de la Calzada;5661;2831;2830
26;Rioja (La);140;Santurde de Rioja;329;164;165
26;Rioja (La);141;Santurdejo;218;122;96
26;Rioja (La);143;Sojuela;93;54;39
26;Rioja (La);144;Sorzano;249;129;120
26;Rioja (La);145;Sotés;267;143;124
26;Rioja (La);146;Soto en Cameros;151;80;71
26;Rioja (La);147;Terroba;37;21;16
26;Rioja (La);148;Tirgo;282;144;138
26;Rioja (La);149;Tobía;62;37;25
26;Rioja (La);150;Tormantos;222;119;103
26;Rioja (La);153;Torre en Cameros;11;8;3
26;Rioja (La);151;Torrecilla en Cameros;554;293;261
26;Rioja (La);152;Torrecilla sobre Alesanco;90;46;44
26;Rioja (La);154;Torremontalbo;15;9;6
26;Rioja (La);155;Treviana;284;150;134
26;Rioja (La);157;Tricio;389;189;200
26;Rioja (La);158;Tudelilla;464;236;228
26;Rioja (La);160;Uruñuela;753;390;363
26;Rioja (La);161;Valdemadera;19;10;9
26;Rioja (La);162;Valgañón;182;99;83
26;Rioja (La);163;Ventosa;136;74;62
26;Rioja (La);164;Ventrosa;105;47;58
26;Rioja (La);165;Viguera;376;215;161
26;Rioja (La);166;Villalba de Rioja;161;95;66
26;Rioja (La);167;Villalobar de Rioja;136;82;54
26;Rioja (La);168;Villamediana de Iregua;1945;990;955
26;Rioja (La);169;Villanueva de Cameros;126;67;59
26;Rioja (La);170;Villar de Arnedo (El);697;335;362
26;Rioja (La);171;Villar de Torre;338;175;163
26;Rioja (La);172;Villarejo;46;26;20
26;Rioja (La);173;Villarroya;9;4;5
26;Rioja (La);174;Villarta-Quintana;225;113;112
26;Rioja (La);175;Villavelayo;82;48;34
26;Rioja (La);176;Villaverde de Rioja;105;59;46
26;Rioja (La);177;Villoslada de Cameros;391;226;165
26;Rioja (La);178;Viniegra de Abajo;131;70;61
26;Rioja (La);179;Viniegra de Arriba;56;35;21
26;Rioja (La);180;Zarratón;275;145;130
26;Rioja (La);181;Zarzosa;18;13;5
26;Rioja (La);183;Zorraquín;49;27;22
27;Lugo;001;Abadín;3647;1718;1929
27;Lugo;002;Alfoz;2553;1241;1312
27;Lugo;003;Antas de Ulla;2969;1422;1547
27;Lugo;004;Baleira;2055;1065;990
27;Lugo;901;Baralla;3488;1799;1689
27;Lugo;005;Barreiros;3574;1710;1864
27;Lugo;006;Becerreá;3897;1969;1928
27;Lugo;007;Begonte;4084;2014;2070
27;Lugo;008;Bóveda;2185;1058;1127
27;Lugo;902;Burela;7925;3939;3986
27;Lugo;009;Carballedo;3517;1745;1772
27;Lugo;010;Castro de Rei;5833;2937;2896
27;Lugo;011;Castroverde;3650;1874;1776
27;Lugo;012;Cervantes;2414;1310;1104
27;Lugo;013;Cervo;5143;2584;2559
27;Lugo;016;Chantada;10227;4984;5243
27;Lugo;014;Corgo (O);4556;2281;2275
27;Lugo;015;Cospeito;6122;3002;3120
27;Lugo;017;Folgoso do Courel;1704;870;834
27;Lugo;018;Fonsagrada (A);5948;3131;2817
27;Lugo;019;Foz;9516;4554;4962
27;Lugo;020;Friol;4911;2462;2449
27;Lugo;022;Guitiriz;6589;3277;3312
27;Lugo;023;Guntín;3732;1860;1872
27;Lugo;024;Incio (O);2722;1338;1384
27;Lugo;026;Láncara;3455;1797;1658
27;Lugo;027;Lourenzá;2980;1444;1536
27;Lugo;028;Lugo;85174;40129;45045
27;Lugo;029;Meira;1837;905;932
27;Lugo;030;Mondoñedo;5398;2502;2896
27;Lugo;031;Monforte de Lemos;19180;9184;9996
27;Lugo;032;Monterroso;4484;2221;2263
27;Lugo;033;Muras;1218;599;619
27;Lugo;034;Navia de Suarna;2116;1145;971
27;Lugo;035;Negueira de Muñiz;310;159;151
27;Lugo;037;Nogais (As);1738;907;831
27;Lugo;038;Ourol;1663;803;860
27;Lugo;039;Outeiro de Rei;4115;2063;2052
27;Lugo;040;Palas de Rei;4537;2237;2300
27;Lugo;041;Pantón;3737;1778;1959
27;Lugo;042;Paradela;2867;1433;1434
27;Lugo;043;Páramo (O);2018;1040;978
27;Lugo;044;Pastoriza (A);4197;2096;2101
27;Lugo;045;Pedrafita do Cebreiro;1716;920;796
27;Lugo;047;Pobra do Brollón (A);2885;1404;1481
27;Lugo;046;Pol;2312;1130;1182
27;Lugo;048;Pontenova (A);3528;1722;1806
27;Lugo;049;Portomarín;2171;1074;1097
27;Lugo;050;Quiroga;4702;2341;2361
27;Lugo;056;Rábade;1588;796;792
27;Lugo;051;Ribadeo;8813;4125;4688
27;Lugo;052;Ribas de Sil;1588;763;825
27;Lugo;053;Ribeira de Piquín;986;487;499
27;Lugo;054;Riotorto;2046;1009;1037
27;Lugo;055;Samos;2242;1185;1057
27;Lugo;057;Sarria;13023;6378;6645
27;Lugo;058;Saviñao (O);5373;2630;2743
27;Lugo;059;Sober;3331;1600;1731
27;Lugo;060;Taboada;4503;2200;2303
27;Lugo;061;Trabada;1817;870;947
27;Lugo;062;Triacastela;970;484;486
27;Lugo;063;Valadouro (O);2603;1290;1313
27;Lugo;064;Vicedo (O);2564;1247;1317
27;Lugo;065;Vilalba;15797;7684;8113
27;Lugo;066;Viveiro;15209;7362;7847
27;Lugo;021;Xermade;2938;1446;1492
27;Lugo;025;Xove;3613;1817;1796
28;Madrid;001;Acebeda (La);53;28;25
28;Madrid;002;Ajalvir;1622;842;780
28;Madrid;003;Alameda del Valle;166;93;73
28;Madrid;004;Álamo (El);3878;1991;1887
28;Madrid;005;Alcalá de Henares;163386;81302;82084
28;Madrid;006;Alcobendas;83031;40979;42052
28;Madrid;007;Alcorcón;141465;69960;71505
28;Madrid;008;Aldea del Fresno;1236;634;602
28;Madrid;009;Algete;12335;6293;6042
28;Madrid;010;Alpedrete;5211;2611;2600
28;Madrid;011;Ambite;290;144;146
28;Madrid;012;Anchuelo;596;327;269
28;Madrid;013;Aranjuez;38900;18804;20096
28;Madrid;014;Arganda del Rey;29224;14491;14733
28;Madrid;015;Arroyomolinos;2709;1368;1341
28;Madrid;016;Atazar (El);96;52;44
28;Madrid;017;Batres;639;322;317
28;Madrid;018;Becerril de la Sierra;2707;1406;1301
28;Madrid;019;Belmonte de Tajo;1142;576;566
28;Madrid;021;Berrueco (El);318;168;150
28;Madrid;020;Berzosa del Lozoya;116;58;58
28;Madrid;022;Boadilla del Monte;17814;9029;8785
28;Madrid;023;Boalo (El);2451;1236;1215
28;Madrid;024;Braojos;155;81;74
28;Madrid;025;Brea de Tajo;489;247;242
28;Madrid;026;Brunete;3940;1947;1993
28;Madrid;027;Buitrago del Lozoya;1403;686;717
28;Madrid;028;Bustarviejo;1345;685;660
28;Madrid;029;Cabanillas de la Sierra;410;208;202
28;Madrid;030;Cabrera (La);1337;662;675
28;Madrid;031;Cadalso de los Vidrios;2217;1131;1086
28;Madrid;032;Camarma de Esteruelas;2086;1040;1046
28;Madrid;033;Campo Real;2548;1287;1261
28;Madrid;034;Canencia;474;246;228
28;Madrid;035;Carabaña;1063;528;535
28;Madrid;036;Casarrubuelos;622;341;281
28;Madrid;037;Cenicientos;1898;943;955
28;Madrid;038;Cercedilla;5051;2472;2579
28;Madrid;039;Cervera de Buitrago;97;53;44
28;Madrid;051;Chapinería;1145;583;562
28;Madrid;052;Chinchón;3849;1912;1937
28;Madrid;040;Ciempozuelos;12445;6305;6140
28;Madrid;041;Cobeña;2074;1050;1024
28;Madrid;046;Collado Mediano;3681;1859;1822
28;Madrid;047;Collado Villalba;36950;18363;18587
28;Madrid;043;Colmenar de Oreja;5596;2737;2859
28;Madrid;042;Colmenar del Arroyo;816;382;434
28;Madrid;045;Colmenar Viejo;28328;14041;14287
28;Madrid;044;Colmenarejo;3558;1792;1766
28;Madrid;048;Corpa;384;196;188
28;Madrid;049;Coslada;76001;37788;38213
28;Madrid;050;Cubas de la Sagra;1149;567;582
28;Madrid;053;Daganzo de Arriba;2429;1225;1204
28;Madrid;054;Escorial (El);8554;4265;4289
28;Madrid;055;Estremera;1076;555;521
28;Madrid;056;Fresnedillas de la Oliva;635;320;315
28;Madrid;057;Fresno de Torote;499;262;237
28;Madrid;058;Fuenlabrada;163567;82166;81401
28;Madrid;059;Fuente el Saz de Jarama;3208;1647;1561
28;Madrid;060;Fuentidueña de Tajo;1398;680;718
28;Madrid;061;Galapagar;16503;8324;8179
28;Madrid;062;Garganta de los Montes;329;167;162
28;Madrid;063;Gargantilla del Lozoya y Pinilla de Buitrago;212;123;89
28;Madrid;064;Gascones;102;54;48
28;Madrid;065;Getafe;143153;71183;71970
28;Madrid;066;Griñón;3748;1939;1809
28;Madrid;067;Guadalix de la Sierra;2481;1265;1216
28;Madrid;068;Guadarrama;7830;3857;3973
28;Madrid;069;Hiruela (La);56;30;26
28;Madrid;070;Horcajo de la Sierra-Aoslos;127;71;56
28;Madrid;071;Horcajuelo de la Sierra;91;45;46
28;Madrid;072;Hoyo de Manzanares;5080;2570;2510
28;Madrid;073;Humanes de Madrid;8305;4244;4061
28;Madrid;074;Leganés;174593;87000;87593
28;Madrid;075;Loeches;2672;1338;1334
28;Madrid;076;Lozoya;444;232;212
28;Madrid;901;Lozoyuela-Navas-Sieteiglesias;622;330;292
28;Madrid;078;Madarcos;36;17;19
28;Madrid;079;Madrid;2866850;1338558;1528292
28;Madrid;080;Majadahonda;40042;19489;20553
28;Madrid;082;Manzanares el Real;3087;1577;1510
28;Madrid;083;Meco;4142;2099;2043
28;Madrid;084;Mejorada del Campo;14677;7378;7299
28;Madrid;085;Miraflores de la Sierra;3365;1693;1672
28;Madrid;086;Molar (El);3422;1789;1633
28;Madrid;087;Molinos (Los);2957;1418;1539
28;Madrid;088;Montejo de la Sierra;279;130;149
28;Madrid;089;Moraleja de Enmedio;2289;1135;1154
28;Madrid;090;Moralzarzal;3672;1867;1805
28;Madrid;091;Morata de Tajuña;5438;2643;2795
28;Madrid;092;Móstoles;196173;97345;98828
28;Madrid;093;Navacerrada;1778;875;903
28;Madrid;094;Navalafuente;459;253;206
28;Madrid;095;Navalagamella;939;477;462
28;Madrid;096;Navalcarnero;11601;5874;5727
28;Madrid;097;Navarredonda y San Mamés;99;52;47
28;Madrid;099;Navas del Rey;1440;734;706
28;Madrid;100;Nuevo Baztán;2108;1077;1031
28;Madrid;101;Olmeda de las Fuentes;146;80;66
28;Madrid;102;Orusco de Tajuña;670;342;328
28;Madrid;104;Paracuellos de Jarama;5293;2705;2588
28;Madrid;106;Parla;69163;34531;34632
28;Madrid;107;Patones;360;184;176
28;Madrid;108;Pedrezuela;1154;616;538
28;Madrid;109;Pelayos de la Presa;1198;589;609
28;Madrid;110;Perales de Tajuña;1991;962;1029
28;Madrid;111;Pezuela de las Torres;540;277;263
28;Madrid;112;Pinilla del Valle;167;92;75
28;Madrid;113;Pinto;25038;12437;12601
28;Madrid;114;Piñuécar-Gandullas;160;75;85
28;Madrid;115;Pozuelo de Alarcón;60120;29425;30695
28;Madrid;116;Pozuelo del Rey;252;133;119
28;Madrid;117;Prádena del Rincón;110;60;50
28;Madrid;118;Puebla de la Sierra;78;45;33
28;Madrid;902;Puentes Viejas;414;218;196
28;Madrid;119;Quijorna;829;437;392
28;Madrid;120;Rascafría;1459;757;702
28;Madrid;121;Redueña;163;79;84
28;Madrid;122;Ribatejada;307;168;139
28;Madrid;123;Rivas-Vaciamadrid;22620;11258;11362
28;Madrid;124;Robledillo de la Jara;84;42;42
28;Madrid;125;Robledo de Chavela;2139;1063;1076
28;Madrid;126;Robregordo;88;43;45
28;Madrid;127;Rozas de Madrid (Las);45280;22129;23151
28;Madrid;128;Rozas de Puerto Real;319;168;151
28;Madrid;129;San Agustín del Guadalix;4603;2341;2262
28;Madrid;130;San Fernando de Henares;29688;14882;14806
28;Madrid;131;San Lorenzo de El Escorial;10828;5234;5594
28;Madrid;132;San Martín de la Vega;8995;4585;4410
28;Madrid;133;San Martín de Valdeiglesias;5969;2958;3011
28;Madrid;134;San Sebastián de los Reyes;57632;28690;28942
28;Madrid;135;Santa María de la Alameda;752;415;337
28;Madrid;136;Santorcaz;529;273;256
28;Madrid;137;Santos de la Humosa (Los);918;469;449
28;Madrid;138;Serna del Monte (La);111;59;52
28;Madrid;140;Serranillos del Valle;810;419;391
28;Madrid;141;Sevilla la Nueva;2650;1368;1282
28;Madrid;143;Somosierra;99;55;44
28;Madrid;144;Soto del Real;3992;2028;1964
28;Madrid;145;Talamanca de Jarama;1334;654;680
28;Madrid;146;Tielmes;1973;1001;972
28;Madrid;147;Titulcia;918;457;461
28;Madrid;148;Torrejón de Ardoz;88821;44315;44506
28;Madrid;149;Torrejón de la Calzada;3219;1557;1662
28;Madrid;150;Torrejón de Velasco;1504;774;730
28;Madrid;151;Torrelaguna;2612;1256;1356
28;Madrid;152;Torrelodones;10743;5264;5479
28;Madrid;153;Torremocha de Jarama;322;162;160
28;Madrid;154;Torres de la Alameda;3925;1970;1955
28;Madrid;903;Tres Cantos;27715;13742;13973
28;Madrid;155;Valdaracete;650;318;332
28;Madrid;156;Valdeavero;556;291;265
28;Madrid;157;Valdelaguna;540;294;246
28;Madrid;158;Valdemanco;515;272;243
28;Madrid;159;Valdemaqueda;553;277;276
28;Madrid;160;Valdemorillo;3997;2045;1952
28;Madrid;161;Valdemoro;21240;10630;10610
28;Madrid;162;Valdeolmos-Alalpardo;1625;853;772
28;Madrid;163;Valdepiélagos;327;168;159
28;Madrid;164;Valdetorres de Jarama;1662;854;808
28;Madrid;165;Valdilecha;1797;907;890
28;Madrid;166;Valverde de Alcalá;265;140;125
28;Madrid;167;Velilla de San Antonio;4597;2321;2276
28;Madrid;168;Vellón (El);1045;536;509
28;Madrid;169;Venturada;539;274;265
28;Madrid;171;Villa del Prado;3758;1905;1853
28;Madrid;170;Villaconejos;2909;1476;1433
28;Madrid;172;Villalbilla;3586;1839;1747
28;Madrid;173;Villamanrique de Tajo;585;293;292
28;Madrid;174;Villamanta;1499;753;746
28;Madrid;175;Villamantilla;338;174;164
28;Madrid;176;Villanueva de la Cañada;7913;3912;4001
28;Madrid;178;Villanueva de Perales;444;250;194
28;Madrid;177;Villanueva del Pardillo;2887;1469;1418
28;Madrid;179;Villar del Olmo;1010;518;492
28;Madrid;180;Villarejo de Salvanés;5384;2675;2709
28;Madrid;181;Villaviciosa de Odón;17019;8441;8578
28;Madrid;182;Villavieja del Lozoya;180;86;94
28;Madrid;183;Zarzalejo;1002;516;486
29;Málaga;001;Alameda;4960;2494;2466
29;Málaga;002;Alcaucín;1484;760;724
29;Málaga;003;Alfarnate;1447;742;705
29;Málaga;004;Alfarnatejo;422;234;188
29;Málaga;005;Algarrobo;4735;2389;2346
29;Málaga;006;Algatocín;1014;529;485
29;Málaga;007;Alhaurín de la Torre;16914;8477;8437
29;Málaga;008;Alhaurín el Grande;16859;8381;8478
29;Málaga;009;Almáchar;1967;1015;952
29;Málaga;010;Almargen;2146;1083;1063
29;Málaga;011;Almogía;4263;2169;2094
29;Málaga;012;Álora;12862;6459;6403
29;Málaga;013;Alozaina;2274;1190;1084
29;Málaga;014;Alpandeire;303;153;150
29;Málaga;015;Antequera;40181;19592;20589
29;Málaga;016;Árchez;341;179;162
29;Málaga;017;Archidona;8246;4124;4122
29;Málaga;018;Ardales;3030;1516;1514
29;Málaga;019;Arenas;1218;645;573
29;Málaga;020;Arriate;3430;1702;1728
29;Málaga;021;Atajate;177;97;80
29;Málaga;022;Benadalid;264;145;119
29;Málaga;023;Benahavís;1721;855;866
29;Málaga;024;Benalauría;521;277;244
29;Málaga;025;Benalmádena;27147;13291;13856
29;Málaga;026;Benamargosa;1590;811;779
29;Málaga;027;Benamocarra;2779;1423;1356
29;Málaga;028;Benaoján;1704;842;862
29;Málaga;029;Benarrabá;647;322;325
29;Málaga;030;Borge (El);1046;537;509
29;Málaga;031;Burgo (El);2070;1070;1000
29;Málaga;032;Campillos;7737;3875;3862
29;Málaga;033;Canillas de Aceituno;2327;1169;1158
29;Málaga;034;Canillas de Albaida;659;347;312
29;Málaga;035;Cañete la Real;2247;1154;1093
29;Málaga;036;Carratraca;870;433;437
29;Málaga;037;Cartajima;257;137;120
29;Málaga;038;Cártama;12713;6412;6301
29;Málaga;039;Casabermeja;3034;1583;1451
29;Málaga;040;Casarabonela;2600;1344;1256
29;Málaga;041;Casares;3206;1658;1548
29;Málaga;042;Coín;17572;8753;8819
29;Málaga;043;Colmenar;3138;1561;1577
29;Málaga;044;Comares;1405;719;686
29;Málaga;045;Cómpeta;2684;1361;1323
29;Málaga;046;Cortes de la Frontera;3643;1818;1825
29;Málaga;047;Cuevas Bajas;1516;716;800
29;Málaga;049;Cuevas de San Marcos;4079;2039;2040
29;Málaga;048;Cuevas del Becerro;2038;1049;989
29;Málaga;050;Cútar;615;306;309
29;Málaga;051;Estepona;37557;18654;18903
29;Málaga;052;Faraján;310;159;151
29;Málaga;053;Frigiliana;2149;1054;1095
29;Málaga;054;Fuengirola;41713;20196;21517
29;Málaga;055;Fuente de Piedra;2059;1008;1051
29;Málaga;056;Gaucín;1660;857;803
29;Málaga;057;Genalguacil;624;322;302
29;Málaga;058;Guaro;2011;1019;992
29;Málaga;059;Humilladero;2514;1273;1241
29;Málaga;060;Igualeja;969;483;486
29;Málaga;061;Istán;1320;660;660
29;Málaga;062;Iznate;754;390;364
29;Málaga;063;Jimera de Líbar;428;209;219
29;Málaga;064;Jubrique;866;436;430
29;Málaga;065;Júzcar;219;124;95
29;Málaga;066;Macharaviaya;324;173;151
29;Málaga;067;Málaga;549135;263864;285271
29;Málaga;068;Manilva;5131;2621;2510
29;Málaga;069;Marbella;98823;48698;50125
29;Málaga;070;Mijas;35423;17753;17670
29;Málaga;071;Moclinejo;1021;519;502
29;Málaga;072;Mollina;3276;1618;1658
29;Málaga;073;Monda;1620;841;779
29;Málaga;074;Montejaque;1069;527;542
29;Málaga;075;Nerja;14965;7369;7596
29;Málaga;076;Ojén;2004;1055;949
29;Málaga;077;Parauta;252;136;116
29;Málaga;079;Periana;3466;1790;1676
29;Málaga;080;Pizarra;6586;3311;3275
29;Málaga;081;Pujerra;347;194;153
29;Málaga;082;Rincón de la Victoria;19247;9562;9685
29;Málaga;083;Riogordo;2662;1355;1307
29;Málaga;084;Ronda;34385;16830;17555
29;Málaga;085;Salares;237;118;119
29;Málaga;086;Sayalonga;1138;591;547
29;Málaga;087;Sedella;526;287;239
29;Málaga;088;Sierra de Yeguas;3203;1607;1596
29;Málaga;089;Teba;4386;2226;2160
29;Málaga;090;Tolox;2571;1333;1238
29;Málaga;901;Torremolinos;35408;17314;18094
29;Málaga;091;Torrox;11869;5889;5980
29;Málaga;092;Totalán;609;315;294
29;Málaga;093;Valle de Abdalajís;3081;1552;1529
29;Málaga;094;Vélez-Málaga;53071;26392;26679
29;Málaga;095;Villanueva de Algaidas;4175;2049;2126
29;Málaga;098;Villanueva de Tapia;1642;828;814
29;Málaga;096;Villanueva del Rosario;3270;1600;1670
29;Málaga;097;Villanueva del Trabuco;4674;2364;2310
29;Málaga;099;Viñuela;1165;590;575
29;Málaga;100;Yunquera;3274;1698;1576
30;Murcia;001;Abanilla;6130;3026;3104
30;Murcia;002;Abarán;12002;5938;6064
30;Murcia;003;Águilas;25702;12824;12878
30;Murcia;004;Albudeite;1328;666;662
30;Murcia;005;Alcantarilla;31872;15570;16302
30;Murcia;902;Alcázares (Los);5501;2762;2739
30;Murcia;006;Aledo;991;507;484
30;Murcia;007;Alguazas;6973;3452;3521
30;Murcia;008;Alhama de Murcia;15318;7621;7697
30;Murcia;009;Archena;14163;7031;7132
30;Murcia;010;Beniel;7862;3901;3961
30;Murcia;011;Blanca;5690;2811;2879
30;Murcia;012;Bullas;10488;5293;5195
30;Murcia;013;Calasparra;8917;4475;4442
30;Murcia;014;Campos del Río;2019;990;1029
30;Murcia;015;Caravaca de la Cruz;21824;10844;10980
30;Murcia;016;Cartagena;170483;83828;86655
30;Murcia;017;Cehegín;14085;7031;7054
30;Murcia;018;Ceutí;6924;3497;3427
30;Murcia;019;Cieza;31680;15442;16238
30;Murcia;020;Fortuna;6295;3212;3083
30;Murcia;021;Fuente Álamo de Murcia;9046;4523;4523
30;Murcia;022;Jumilla;20439;10143;10296
30;Murcia;023;Librilla;3759;1849;1910
30;Murcia;024;Lorca;69045;34099;34946
30;Murcia;025;Lorquí;5424;2671;2753
30;Murcia;026;Mazarrón;16142;8136;8006
30;Murcia;027;Molina de Segura;41109;20264;20845
30;Murcia;028;Moratalla;8621;4369;4252
30;Murcia;029;Mula;13386;6636;6750
30;Murcia;030;Murcia;345759;168065;177694
30;Murcia;031;Ojós;608;303;305
30;Murcia;032;Pliego;3373;1723;1650
30;Murcia;033;Puerto Lumbreras;10474;5091;5383
30;Murcia;034;Ricote;1603;778;825
30;Murcia;035;San Javier;16773;8561;8212
30;Murcia;036;San Pedro del Pinatar;13644;6704;6940
30;Murcia;901;Santomera;9978;4996;4982
30;Murcia;037;Torre-Pacheco;20345;10797;9548
30;Murcia;038;Torres de Cotillas (Las);15093;7557;7536
30;Murcia;039;Totana;21441;10718;10723
30;Murcia;040;Ulea;1010;505;505
30;Murcia;041;Unión (La);14046;6952;7094
30;Murcia;042;Villanueva del Río Segura;1469;701;768
30;Murcia;043;Yecla;28415;14207;14208
31;Navarra;001;Abáigar;95;51;44
31;Navarra;002;Abárzuza;508;249;259
31;Navarra;003;Abaurregaina/Abaurrea Alta;192;111;81
31;Navarra;004;Abaurrepea/Abaurrea Baja;48;33;15
31;Navarra;005;Aberin;365;192;173
31;Navarra;006;Ablitas;2231;1140;1091
31;Navarra;007;Adiós;125;61;64
31;Navarra;008;Aguilar de Codés;112;61;51
31;Navarra;009;Aibar/Oibar;933;487;446
31;Navarra;011;Allín;819;429;390
31;Navarra;012;Allo;1049;516;533
31;Navarra;010;Altsasu/Alsasua;7004;3543;3461
31;Navarra;013;Améscoa Baja;844;443;401
31;Navarra;014;Ancín/Antzin;276;139;137
31;Navarra;015;Andosilla;2511;1258;1253
31;Navarra;016;Ansoáin/Antsoain;5396;2745;2651
31;Navarra;017;Anue;449;261;188
31;Navarra;018;Añorbe;401;220;181
31;Navarra;019;Aoiz/Agoitz;1848;913;935
31;Navarra;020;Araitz;613;359;254
31;Navarra;025;Arakil;856;451;405
31;Navarra;021;Aranarache/Aranaratxe;93;46;47
31;Navarra;023;Aranguren;2786;1452;1334
31;Navarra;024;Arano;154;80;74
31;Navarra;022;Arantza;714;397;317
31;Navarra;026;Aras;227;118;109
31;Navarra;027;Arbizu;919;477;442
31;Navarra;028;Arce/Artzi;317;179;138
31;Navarra;029;Arcos (Los);1346;669;677
31;Navarra;030;Arellano;205;109;96
31;Navarra;031;Areso;310;159;151
31;Navarra;032;Arguedas;2221;1102;1119
31;Navarra;033;Aria;69;43;26
31;Navarra;034;Aribe;70;34;36
31;Navarra;035;Armañanzas;100;52;48
31;Navarra;036;Arróniz;1212;634;578
31;Navarra;037;Arruazu;110;60;50
31;Navarra;038;Artajona;1676;884;792
31;Navarra;039;Artazu;86;48;38
31;Navarra;040;Atez;213;131;82
31;Navarra;058;Auritz/Burguete;320;146;174
31;Navarra;041;Ayegui/Aiegi;849;440;409
31;Navarra;042;Azagra;3496;1749;1747
31;Navarra;043;Azuelo;63;30;33
31;Navarra;044;Bakaiku;359;199;160
31;Navarra;901;Barañain;18936;9330;9606
31;Navarra;045;Barásoain;465;229;236
31;Navarra;046;Barbarin;106;50;56
31;Navarra;047;Bargota;396;201;195
31;Navarra;048;Barillas;211;101;110
31;Navarra;049;Basaburua;682;391;291
31;Navarra;050;Baztan;7806;3969;3837
31;Navarra;137;Beintza-Labaien;303;169;134
31;Navarra;051;Beire;349;168;181
31;Navarra;052;Belascoáin;96;48;48
31;Navarra;250;Bera;3480;1769;1711
31;Navarra;053;Berbinzana;714;363;351
31;Navarra;905;Beriáin;2317;1150;1167
31;Navarra;902;Berrioplano;1057;528;529
31;Navarra;903;Berriozar;5500;2814;2686
31;Navarra;054;Bertizarana;651;326;325
31;Navarra;055;Betelu;334;188;146
31;Navarra;253;Bidaurreta;101;62;39
31;Navarra;056;Biurrun-Olcoz;173;90;83
31;Navarra;057;Buñuel;2390;1171;1219
31;Navarra;059;Burgui/Burgi;253;140;113
31;Navarra;060;Burlada/Burlata;15366;7593;7773
31;Navarra;061;Busto (El);105;55;50
31;Navarra;062;Cabanillas;1464;747;717
31;Navarra;063;Cabredo;130;68;62
31;Navarra;064;Cadreita;1873;920;953
31;Navarra;065;Caparroso;2331;1140;1191
31;Navarra;066;Cárcar;1257;612;645
31;Navarra;067;Carcastillo;2670;1333;1337
31;Navarra;068;Cascante;3555;1745;1810
31;Navarra;069;Cáseda;1078;535;543
31;Navarra;070;Castejón;3173;1582;1591
31;Navarra;071;Castillonuevo;27;17;10
31;Navarra;072;Cintruénigo;5430;2696;2734
31;Navarra;074;Cirauqui/Zirauki;454;252;202
31;Navarra;075;Ciriza;52;19;33
31;Navarra;076;Cizur;1105;555;550
31;Navarra;077;Corella;6329;3161;3168
31;Navarra;078;Cortes;3196;1625;1571
31;Navarra;079;Desojo;151;84;67
31;Navarra;080;Dicastillo;708;372;336
31;Navarra;081;Donamaria;394;195;199
31;Navarra;221;Doneztebe/Santesteban;1291;648;643
31;Navarra;083;Echarri;58;31;27
31;Navarra;086;Egüés;8467;4267;4200
31;Navarra;087;Elgorriaga;198;99;99
31;Navarra;089;Enériz/Eneritz;185;93;92
31;Navarra;090;Eratsun;189;116;73
31;Navarra;091;Ergoiena;491;277;214
31;Navarra;092;Erro;787;427;360
31;Navarra;094;Eslava;196;99;97
31;Navarra;095;Esparza de Salazar/Espartza Zaraitzu;122;64;58
31;Navarra;096;Espronceda;178;100;78
31;Navarra;097;Estella/Lizarra;12552;6051;6501
31;Navarra;098;Esteribar;1475;781;694
31;Navarra;099;Etayo;95;49;46
31;Navarra;082;Etxalar;837;433;404
31;Navarra;084;Etxarri-Aranatz;2372;1223;1149
31;Navarra;085;Etxauri;383;197;186
31;Navarra;100;Eulate;403;206;197
31;Navarra;101;Ezcabarte;1085;575;510
31;Navarra;093;Ezcároz/Ezkaroze;364;197;167
31;Navarra;102;Ezkurra;253;157;96
31;Navarra;103;Ezprogui;67;34;33
31;Navarra;104;Falces;2661;1316;1345
31;Navarra;105;Fitero;2083;1041;1042
31;Navarra;106;Fontellas;651;330;321
31;Navarra;107;Funes;2112;1068;1044
31;Navarra;108;Fustiñana;2295;1153;1142
31;Navarra;109;Galar;1032;545;487
31;Navarra;110;Gallipienzo;161;93;68
31;Navarra;111;Gallués/Galoze;124;76;48
31;Navarra;112;Garaioa;126;69;57
31;Navarra;113;Garde;201;110;91
31;Navarra;114;Garínoain;299;161;138
31;Navarra;115;Garralda;227;119;108
31;Navarra;116;Genevilla;127;67;60
31;Navarra;117;Goizueta;949;512;437
31;Navarra;118;Goñi;206;115;91
31;Navarra;119;Güesa/Gorza;79;45;34
31;Navarra;120;Guesálaz/Gesalatz;458;269;189
31;Navarra;121;Guirguillano;80;44;36
31;Navarra;256;Hiriberri/Villanueva de Aezkoa;156;82;74
31;Navarra;122;Huarte/Uharte;2750;1389;1361
31;Navarra;124;Ibargoiti;218;126;92
31;Navarra;259;Igantzi;595;312;283
31;Navarra;125;Igúzquiza;343;170;173
31;Navarra;126;Imotz;405;223;182
31;Navarra;127;Irañeta;161;85;76
31;Navarra;904;Irurtzun;1991;1019;972
31;Navarra;128;Isaba/Izaba;562;272;290
31;Navarra;129;Ituren;462;233;229
31;Navarra;130;Iturmendi;360;186;174
31;Navarra;131;Iza/Itza;660;344;316
31;Navarra;132;Izagaondoa;178;107;71
31;Navarra;133;Izalzu/Itzaltzu;49;27;22
31;Navarra;134;Jaurrieta;268;145;123
31;Navarra;135;Javier;143;62;81
31;Navarra;136;Juslapeña;464;256;208
31;Navarra;138;Lakuntza;1003;518;485
31;Navarra;139;Lana;213;120;93
31;Navarra;140;Lantz;122;77;45
31;Navarra;141;Lapoblación;183;102;81
31;Navarra;142;Larraga;1900;993;907
31;Navarra;143;Larraona;164;83;81
31;Navarra;144;Larraun;1120;616;504
31;Navarra;145;Lazagurría;245;130;115
31;Navarra;146;Leache;50;29;21
31;Navarra;147;Legarda;71;41;30
31;Navarra;148;Legaria;152;83;69
31;Navarra;149;Leitza;3086;1604;1482
31;Navarra;908;Lekunberri;846;431;415
31;Navarra;150;Leoz/Leotz;260;158;102
31;Navarra;151;Lerga;87;46;41
31;Navarra;152;Lerín;1932;956;976
31;Navarra;153;Lesaka;2728;1435;1293
31;Navarra;154;Lezáun;262;148;114
31;Navarra;155;Liédena;322;156;166
31;Navarra;156;Lizoáin-Arriasgoiti;231;130;101
31;Navarra;157;Lodosa;4607;2333;2274
31;Navarra;158;Lónguida/Longida;288;151;137
31;Navarra;159;Lumbier;1420;753;667
31;Navarra;160;Luquin;132;73;59
31;Navarra;248;Luzaide/Valcarlos;467;232;235
31;Navarra;161;Mañeru;365;182;183
31;Navarra;162;Marañón;76;40;36
31;Navarra;163;Marcilla;2384;1202;1182
31;Navarra;164;Mélida;844;429;415
31;Navarra;165;Mendavia;3521;1753;1768
31;Navarra;166;Mendaza;401;186;215
31;Navarra;167;Mendigorría;901;463;438
31;Navarra;168;Metauten;311;170;141
31;Navarra;169;Milagro;2585;1265;1320
31;Navarra;170;Mirafuentes;57;28;29
31;Navarra;171;Miranda de Arga;978;490;488
31;Navarra;172;Monreal;295;156;139
31;Navarra;173;Monteagudo;1189;596;593
31;Navarra;174;Morentin;120;57;63
31;Navarra;175;Mues;119;64;55
31;Navarra;176;Murchante;2997;1477;1520
31;Navarra;177;Murieta;281;156;125
31;Navarra;178;Murillo el Cuende;669;360;309
31;Navarra;179;Murillo el Fruto;780;389;391
31;Navarra;180;Muruzábal;212;109;103
31;Navarra;181;Navascués;222;134;88
31;Navarra;182;Nazar;59;33;26
31;Navarra;088;Noáin (Valle de Elorz)/Noain (Elortzibar);3857;1924;1933
31;Navarra;183;Obanos;750;362;388
31;Navarra;185;Ochagavía/Otsagabia;701;360;341
31;Navarra;184;Oco;91;53;38
31;Navarra;186;Odieta;329;178;151
31;Navarra;187;Oitz;159;94;65
31;Navarra;188;Olaibar;169;92;77
31;Navarra;189;Olazti/Olazagutía;1622;832;790
31;Navarra;190;Olejua;58;28;30
31;Navarra;191;Olite/Erriberri;3106;1557;1549
31;Navarra;194;Ollo;363;209;154
31;Navarra;192;Olóriz/Oloritz;172;97;75
31;Navarra;193;Cendea de Olza/Oltza Zendea;1216;613;603
31;Navarra;195;Orbaitzeta;243;135;108
31;Navarra;196;Orbara;67;36;31
31;Navarra;906;Orcoyen;1250;642;608
31;Navarra;197;Orísoain;98;52;46
31;Navarra;198;Oronz/Orontze;53;29;24
31;Navarra;199;Oroz-Betelu/Orotz-Betelu;232;129;103
31;Navarra;211;Orreaga/Roncesvalles;32;18;14
31;Navarra;200;Oteiza;921;482;439
31;Navarra;201;Pamplona/Iruña;166279;79101;87178
31;Navarra;202;Peralta/Azkoien;4668;2324;2344
31;Navarra;203;Petilla de Aragón;52;27;25
31;Navarra;204;Piedramillera;75;42;33
31;Navarra;205;Pitillas;614;312;302
31;Navarra;206;Puente la Reina/Gares;2120;1052;1068
31;Navarra;207;Pueyo;333;175;158
31;Navarra;208;Ribaforada;3165;1640;1525
31;Navarra;209;Romanzado;161;92;69
31;Navarra;210;Roncal/Erronkari;364;185;179
31;Navarra;212;Sada;255;139;116
31;Navarra;213;Saldías;157;85;72
31;Navarra;214;Salinas de Oro/Jaitz;107;65;42
31;Navarra;215;San Adrián;5241;2538;2703
31;Navarra;217;San Martín de Unx;494;263;231
31;Navarra;216;Sangüesa/Zangoza;4553;2338;2215
31;Navarra;219;Sansol;127;63;64
31;Navarra;220;Santacara;1049;539;510
31;Navarra;222;Sarriés/Sartze;84;49;35
31;Navarra;223;Sartaguda;1376;691;685
31;Navarra;224;Sesma;1408;697;711
31;Navarra;225;Sorlada;53;27;26
31;Navarra;226;Sunbilla;659;343;316
31;Navarra;227;Tafalla;10017;4901;5116
31;Navarra;228;Tiebas-Muruarte de Reta;594;318;276
31;Navarra;229;Tirapu;70;38;32
31;Navarra;230;Torralba del Río;158;86;72
31;Navarra;231;Torres del Río;198;98;100
31;Navarra;232;Tudela;26857;12995;13862
31;Navarra;233;Tulebras;102;35;67
31;Navarra;234;Ucar;114;62;52
31;Navarra;123;Uharte-Arakil;794;421;373
31;Navarra;235;Ujué;254;131;123
31;Navarra;236;Ultzama;1646;831;815
31;Navarra;237;Unciti;231;132;99
31;Navarra;238;Unzué;132;77;55
31;Navarra;239;Urdazubi/Urdax;420;202;218
31;Navarra;240;Urdiain;638;327;311
31;Navarra;241;Urraul Alto;150;87;63
31;Navarra;242;Urraul Bajo;284;130;154
31;Navarra;244;Urrotz;216;119;97
31;Navarra;243;Urroz;363;181;182
31;Navarra;245;Urzainqui/Urzainki;111;58;53
31;Navarra;246;Uterga;141;67;74
31;Navarra;247;Uztárroz/Uztarroze;289;145;144
31;Navarra;249;Valtierra;2459;1208;1251
31;Navarra;251;Viana;3389;1730;1659
31;Navarra;252;Vidángoz/Bidankoze;117;61;56
31;Navarra;254;Villafranca;2515;1208;1307
31;Navarra;255;Villamayor de Monjardín;118;66;52
31;Navarra;257;Villatuerta;786;399;387
31;Navarra;258;Villava/Atarrabia;8570;4287;4283
31;Navarra;260;Valle de Yerri/Deierri;1528;812;716
31;Navarra;261;Yesa;272;155;117
31;Navarra;262;Zabalza/Zabaltza;141;62;79
31;Navarra;073;Ziordia;372;173;199
31;Navarra;907;Zizur Mayor/Zizur Nagusia;8248;4121;4127
31;Navarra;263;Zubieta;321;186;135
31;Navarra;264;Zugarramurdi;247;131;116
31;Navarra;265;Zúñiga;130;74;56
32;Ourense;001;Allariz;5178;2485;2693
32;Ourense;002;Amoeiro;2291;1116;1175
32;Ourense;003;Arnoia (A);1209;569;640
32;Ourense;004;Avión;3001;1328;1673
32;Ourense;005;Baltar;1361;680;681
32;Ourense;006;Bande;2798;1327;1471
32;Ourense;007;Baños de Molgas;2292;1135;1157
32;Ourense;008;Barbadás;5239;2516;2723
32;Ourense;009;Barco de Valdeorras (O);11828;5887;5941
32;Ourense;010;Beade;608;298;310
32;Ourense;011;Beariz;1735;794;941
32;Ourense;012;Blancos (Os);1269;637;632
32;Ourense;013;Boborás;3712;1719;1993
32;Ourense;014;Bola (A);1648;772;876
32;Ourense;015;Bolo (O);1655;817;838
32;Ourense;016;Calvos de Randín;1394;681;713
32;Ourense;018;Carballeda de Avia;1792;859;933
32;Ourense;017;Carballeda de Valdeorras;2397;1212;1185
32;Ourense;019;Carballiño (O);12146;5782;6364
32;Ourense;020;Cartelle;4073;1974;2099
32;Ourense;022;Castrelo de Miño;2121;1013;1108
32;Ourense;021;Castrelo do Val;1327;657;670
32;Ourense;023;Castro Caldelas;2028;1024;1004
32;Ourense;024;Celanova;6065;2877;3188
32;Ourense;025;Cenlle;1833;869;964
32;Ourense;029;Chandrexa de Queixa;984;541;443
32;Ourense;026;Coles;3082;1511;1571
32;Ourense;027;Cortegada;1484;701;783
32;Ourense;028;Cualedro;2542;1286;1256
32;Ourense;030;Entrimo;1523;682;841
32;Ourense;031;Esgos;1438;693;745
32;Ourense;033;Gomesende;1271;591;680
32;Ourense;034;Gudiña (A);1866;945;921
32;Ourense;035;Irixo (O);2284;1037;1247
32;Ourense;038;Larouco;634;300;334
32;Ourense;039;Laza;2194;1089;1105
32;Ourense;040;Leiro;2100;999;1101
32;Ourense;041;Lobeira;1298;633;665
32;Ourense;042;Lobios;2797;1338;1459
32;Ourense;043;Maceda;3467;1660;1807
32;Ourense;044;Manzaneda;1417;730;687
32;Ourense;045;Maside;3473;1629;1844
32;Ourense;046;Melón;1691;749;942
32;Ourense;047;Merca (A);2458;1168;1290
32;Ourense;048;Mezquita (A);1596;793;803
32;Ourense;049;Montederramo;1384;708;676
32;Ourense;050;Monterrei;3563;1781;1782
32;Ourense;051;Muíños;2207;1067;1140
32;Ourense;052;Nogueira de Ramuín;2713;1278;1435
32;Ourense;053;Oímbra;2054;1015;1039
32;Ourense;054;Ourense;107060;50368;56692
32;Ourense;055;Paderne de Allariz;1781;834;947
32;Ourense;056;Padrenda;2843;1352;1491
32;Ourense;057;Parada de Sil;980;477;503
32;Ourense;058;Pereiro de Aguiar (O);4718;2294;2424
32;Ourense;059;Peroxa (A);2677;1260;1417
32;Ourense;060;Petín;1187;570;617
32;Ourense;061;Piñor;1722;861;861
32;Ourense;063;Pobra de Trives (A);3044;1539;1505
32;Ourense;064;Pontedeva;807;373;434
32;Ourense;062;Porqueira;1229;601;628
32;Ourense;065;Punxín;1025;486;539
32;Ourense;066;Quintela de Leirado;1030;474;556
32;Ourense;067;Rairiz de Veiga;2001;979;1022
32;Ourense;068;Ramirás;2100;970;1130
32;Ourense;069;Ribadavia;5650;2698;2952
32;Ourense;071;Riós;2467;1238;1229
32;Ourense;072;Rúa (A);5018;2462;2556
32;Ourense;073;Rubiá;1937;962;975
32;Ourense;074;San Amaro;1656;803;853
32;Ourense;075;San Cibrao das Viñas;3310;1603;1707
32;Ourense;076;San Cristovo de Cea;3447;1682;1765
32;Ourense;070;San Xoán de Río;1137;546;591
32;Ourense;077;Sandiás;1749;810;939
32;Ourense;078;Sarreaus;2099;1050;1049
32;Ourense;079;Taboadela;1756;876;880
32;Ourense;080;Teixeira (A);627;299;328
32;Ourense;081;Toén;2636;1321;1315
32;Ourense;082;Trasmiras;1914;930;984
32;Ourense;083;Veiga (A);1538;762;776
32;Ourense;084;Verea;1505;712;793
32;Ourense;085;Verín;12271;6000;6271
32;Ourense;086;Viana do Bolo;4389;2178;2211
32;Ourense;087;Vilamarín;2269;1095;1174
32;Ourense;088;Vilamartín de Valdeorras;2537;1250;1287
32;Ourense;089;Vilar de Barrio;2265;1137;1128
32;Ourense;090;Vilar de Santos;1058;520;538
32;Ourense;091;Vilardevós;3079;1557;1522
32;Ourense;092;Vilariño de Conso;877;481;396
32;Ourense;032;Xinzo de Limia;9716;4834;4882
32;Ourense;036;Xunqueira de Ambía;2150;1040;1110
32;Ourense;037;Xunqueira de Espadanedo;1132;542;590
33;Asturias;001;Allande;2613;1335;1278
33;Asturias;002;Aller;16347;8120;8227
33;Asturias;003;Amieva;958;504;454
33;Asturias;004;Avilés;85696;41237;44459
33;Asturias;005;Belmonte de Miranda;2456;1267;1189
33;Asturias;006;Bimenes;2285;1080;1205
33;Asturias;007;Boal;2720;1344;1376
33;Asturias;008;Cabrales;2393;1217;1176
33;Asturias;009;Cabranes;1344;661;683
33;Asturias;010;Candamo;2688;1297;1391
33;Asturias;012;Cangas de Onís;6285;3078;3207
33;Asturias;011;Cangas del Narcea;18110;9217;8893
33;Asturias;013;Caravia;577;292;285
33;Asturias;014;Carreño;10533;5129;5404
33;Asturias;015;Caso;2118;1110;1008
33;Asturias;016;Castrillón;22361;10838;11523
33;Asturias;017;Castropol;4547;2172;2375
33;Asturias;018;Coaña;3846;1867;1979
33;Asturias;019;Colunga;4681;2294;2387
33;Asturias;020;Corvera de Asturias;16502;8155;8347
33;Asturias;021;Cudillero;6218;3047;3171
33;Asturias;022;Degaña;1605;850;755
33;Asturias;023;Franco (El);4193;2044;2149
33;Asturias;024;Gijón;264381;125734;138647
33;Asturias;025;Gozón;11410;5535;5875
33;Asturias;026;Grado;12051;5805;6246
33;Asturias;027;Grandas de Salime;1387;716;671
33;Asturias;028;Ibias;2307;1237;1070
33;Asturias;029;Illano;689;364;325
33;Asturias;030;Illas;1225;642;583
33;Asturias;031;Langreo;50597;24269;26328
33;Asturias;032;Laviana;15085;7335;7750
33;Asturias;033;Lena;14323;6998;7325
33;Asturias;035;Llanera;11407;5600;5807
33;Asturias;036;Llanes;13184;6299;6885
33;Asturias;037;Mieres;51423;24752;26671
33;Asturias;038;Morcín;2933;1428;1505
33;Asturias;039;Muros de Nalón;2497;1173;1324
33;Asturias;040;Nava;5681;2781;2900
33;Asturias;041;Navia;9136;4392;4744
33;Asturias;042;Noreña;4207;2005;2202
33;Asturias;043;Onís;915;464;451
33;Asturias;044;Oviedo;200049;93426;106623
33;Asturias;045;Parres;5574;2707;2867
33;Asturias;046;Peñamellera Alta;783;389;394
33;Asturias;047;Peñamellera Baja;1683;840;843
33;Asturias;048;Pesoz;268;134;134
33;Asturias;049;Piloña;9215;4468;4747
33;Asturias;050;Ponga;788;454;334
33;Asturias;051;Pravia;9694;4652;5042
33;Asturias;052;Proaza;960;489;471
33;Asturias;053;Quirós;1738;908;830
33;Asturias;054;Regueras (Las);2268;1117;1151
33;Asturias;055;Ribadedeva;1916;928;988
33;Asturias;056;Ribadesella;6295;3016;3279
33;Asturias;057;Ribera de Arriba;2095;1028;1067
33;Asturias;058;Riosa;2663;1365;1298
33;Asturias;059;Salas;7416;3641;3775
33;Asturias;061;San Martín de Oscos;560;293;267
33;Asturias;060;San Martín del Rey Aurelio;22129;10653;11476
33;Asturias;063;San Tirso de Abres;675;331;344
33;Asturias;062;Santa Eulalia de Oscos;607;310;297
33;Asturias;064;Santo Adriano;357;183;174
33;Asturias;065;Sariego;1452;716;736
33;Asturias;066;Siero;46315;22430;23885
33;Asturias;067;Sobrescobio;769;402;367
33;Asturias;068;Somiedo;1664;875;789
33;Asturias;069;Soto del Barco;4450;2104;2346
33;Asturias;070;Tapia de Casariego;4455;2124;2331
33;Asturias;071;Taramundi;975;476;499
33;Asturias;072;Teverga;2335;1205;1130
33;Asturias;073;Tineo;13578;6855;6723
33;Asturias;034;Valdés;16073;7873;8200
33;Asturias;074;Vegadeo;5030;2407;2623
33;Asturias;075;Villanueva de Oscos;428;219;209
33;Asturias;076;Villaviciosa;14465;7125;7340
33;Asturias;077;Villayón;2040;1048;992
33;Asturias;078;Yernes y Tameza;209;106;103
34;Palencia;001;Abarca de Campos;51;25;26
34;Palencia;003;Abia de las Torres;233;117;116
34;Palencia;004;Aguilar de Campoo;7741;3841;3900
34;Palencia;005;Alar del Rey;1334;638;696
34;Palencia;006;Alba de Cerrato;115;52;63
34;Palencia;009;Amayuelas de Arriba;44;26;18
34;Palencia;010;Ampudia;719;376;343
34;Palencia;011;Amusco;618;338;280
34;Palencia;012;Antigüedad;456;248;208
34;Palencia;015;Arconada;81;43;38
34;Palencia;017;Astudillo;1340;697;643
34;Palencia;018;Autilla del Pino;253;130;123
34;Palencia;019;Autillo de Campos;198;91;107
34;Palencia;020;Ayuela;90;54;36
34;Palencia;022;Baltanás;1628;844;784
34;Palencia;024;Baquerín de Campos;41;25;16
34;Palencia;025;Bárcena de Campos;72;32;40
34;Palencia;027;Barruelo de Santullán;2052;964;1088
34;Palencia;028;Báscones de Ojeda;225;111;114
34;Palencia;029;Becerril de Campos;1182;574;608
34;Palencia;031;Belmonte de Campos;63;30;33
34;Palencia;032;Berzosilla;77;33;44
34;Palencia;033;Boada de Campos;29;16;13
34;Palencia;035;Boadilla de Rioseco;198;100;98
34;Palencia;034;Boadilla del Camino;204;110;94
34;Palencia;036;Brañosera;317;166;151
34;Palencia;037;Buenavista de Valdavia;467;234;233
34;Palencia;038;Bustillo de la Vega;385;205;180
34;Palencia;039;Bustillo del Páramo de Carrión;103;54;49
34;Palencia;041;Calahorra de Boedo;151;74;77
34;Palencia;042;Calzada de los Molinos;396;214;182
34;Palencia;045;Capillas;127;60;67
34;Palencia;046;Cardeñosa de Volpejera;58;30;28
34;Palencia;047;Carrión de los Condes;2545;1196;1349
34;Palencia;048;Castil de Vela;117;56;61
34;Palencia;049;Castrejón de la Peña;659;348;311
34;Palencia;050;Castrillo de Don Juan;363;201;162
34;Palencia;051;Castrillo de Onielo;198;96;102
34;Palencia;052;Castrillo de Villavega;329;170;159
34;Palencia;053;Castromocho;277;142;135
34;Palencia;055;Cervatos de la Cueza;418;217;201
34;Palencia;056;Cervera de Pisuerga;2796;1425;1371
34;Palencia;057;Cevico de la Torre;739;361;378
34;Palencia;058;Cevico Navero;310;163;147
34;Palencia;059;Cisneros;666;319;347
34;Palencia;060;Cobos de Cerrato;269;132;137
34;Palencia;061;Collazos de Boedo;176;96;80
34;Palencia;062;Congosto de Valdavia;279;156;123
34;Palencia;063;Cordovilla la Real;122;70;52
34;Palencia;066;Cubillas de Cerrato;111;54;57
34;Palencia;067;Dehesa de Montejo;264;154;110
34;Palencia;068;Dehesa de Romanos;53;28;25
34;Palencia;069;Dueñas;2985;1524;1461
34;Palencia;070;Espinosa de Cerrato;277;144;133
34;Palencia;071;Espinosa de Villagonzalo;290;143;147
34;Palencia;072;Frechilla;276;129;147
34;Palencia;073;Fresno del Río;204;104;100
34;Palencia;074;Frómista;1041;522;519
34;Palencia;076;Fuentes de Nava;851;420;431
34;Palencia;077;Fuentes de Valdepero;251;137;114
34;Palencia;079;Grijota;794;396;398
34;Palencia;080;Guardo;8779;4446;4333
34;Palencia;081;Guaza de Campos;85;40;45
34;Palencia;082;Hérmedes de Cerrato;155;72;83
34;Palencia;083;Herrera de Pisuerga;2761;1383;1378
34;Palencia;084;Herrera de Valdecañas;200;99;101
34;Palencia;086;Hontoria de Cerrato;134;69;65
34;Palencia;087;Hornillos de Cerrato;148;67;81
34;Palencia;088;Husillos;229;127;102
34;Palencia;089;Itero de la Vega;258;135;123
34;Palencia;091;Lagartos;178;95;83
34;Palencia;092;Lantadilla;572;276;296
34;Palencia;094;Ledigos;114;58;56
34;Palencia;903;Loma de Ucieza;364;190;174
34;Palencia;096;Lomas;59;29;30
34;Palencia;098;Magaz de Pisuerga;739;386;353
34;Palencia;099;Manquillos;81;43;38
34;Palencia;100;Mantinos;211;109;102
34;Palencia;101;Marcilla de Campos;83;37;46
34;Palencia;102;Mazariegos;292;156;136
34;Palencia;103;Mazuecos de Valdeginate;148;76;72
34;Palencia;104;Melgar de Yuso;426;235;191
34;Palencia;106;Meneses de Campos;163;88;75
34;Palencia;107;Micieces de Ojeda;115;61;54
34;Palencia;108;Monzón de Campos;807;420;387
34;Palencia;109;Moratinos;95;49;46
34;Palencia;110;Mudá;142;70;72
34;Palencia;112;Nogal de las Huertas;80;44;36
34;Palencia;113;Olea de Boedo;49;24;25
34;Palencia;114;Olmos de Ojeda;365;204;161
34;Palencia;116;Osornillo;106;55;51
34;Palencia;901;Osorno la Mayor;1839;979;860
34;Palencia;120;Palencia;78831;37746;41085
34;Palencia;121;Palenzuela;344;181;163
34;Palencia;122;Páramo de Boedo;122;63;59
34;Palencia;123;Paredes de Nava;2549;1265;1284
34;Palencia;124;Payo de Ojeda;101;60;41
34;Palencia;125;Pedraza de Campos;146;75;71
34;Palencia;126;Pedrosa de la Vega;398;213;185
34;Palencia;127;Perales;137;74;63
34;Palencia;904;Pernía (La);493;264;229
34;Palencia;129;Pino del Río;269;153;116
34;Palencia;130;Piña de Campos;317;172;145
34;Palencia;131;Población de Arroyo;96;51;45
34;Palencia;132;Población de Campos;227;125;102
34;Palencia;133;Población de Cerrato;129;69;60
34;Palencia;134;Polentinos;98;53;45
34;Palencia;135;Pomar de Valdivia;543;279;264
34;Palencia;136;Poza de la Vega;290;163;127
34;Palencia;137;Pozo de Urama;43;25;18
34;Palencia;139;Prádanos de Ojeda;266;138;128
34;Palencia;140;Puebla de Valdavia (La);174;88;86
34;Palencia;141;Quintana del Puente;285;150;135
34;Palencia;143;Quintanilla de Onsoña;272;157;115
34;Palencia;146;Reinoso de Cerrato;86;51;35
34;Palencia;147;Renedo de la Vega;294;169;125
34;Palencia;149;Requena de Campos;56;28;28
34;Palencia;151;Respenda de la Peña;305;163;142
34;Palencia;152;Revenga de Campos;200;94;106
34;Palencia;154;Revilla de Collazos;103;56;47
34;Palencia;155;Ribas de Campos;228;119;109
34;Palencia;156;Riberos de la Cueza;97;50;47
34;Palencia;157;Saldaña;3183;1613;1570
34;Palencia;158;Salinas de Pisuerga;296;162;134
34;Palencia;159;San Cebrián de Campos;567;324;243
34;Palencia;160;San Cebrián de Mudá;218;106;112
34;Palencia;161;San Cristóbal de Boedo;54;30;24
34;Palencia;163;San Mamés de Campos;123;51;72
34;Palencia;165;San Román de la Cuba;137;71;66
34;Palencia;167;Santa Cecilia del Alcor;184;100;84
34;Palencia;168;Santa Cruz de Boedo;73;40;33
34;Palencia;169;Santervás de la Vega;584;319;265
34;Palencia;170;Santibáñez de Ecla;109;45;64
34;Palencia;171;Santibáñez de la Peña;1636;829;807
34;Palencia;174;Santoyo;298;147;151
34;Palencia;175;Serna (La);135;77;58
34;Palencia;177;Soto de Cerrato;243;121;122
34;Palencia;176;Sotobañado y Priorato;187;100;87
34;Palencia;178;Tabanera de Cerrato;182;91;91
34;Palencia;179;Tabanera de Valdavia;57;24;33
34;Palencia;180;Támara de Campos;108;55;53
34;Palencia;181;Tariego de Cerrato;573;298;275
34;Palencia;182;Torquemada;1266;641;625
34;Palencia;184;Torremormojón;84;41;43
34;Palencia;185;Triollo;102;54;48
34;Palencia;186;Valbuena de Pisuerga;78;46;32
34;Palencia;189;Valdeolmillos;96;48;48
34;Palencia;190;Valderrábano;83;48;35
34;Palencia;192;Valde-Ucieza;139;79;60
34;Palencia;196;Valle de Cerrato;135;74;61
34;Palencia;902;Valle del Retortillo;235;118;117
34;Palencia;199;Velilla del Río Carrión;1976;1003;973
34;Palencia;023;Venta de Baños;6461;3210;3251
34;Palencia;201;Vertavillo;259;145;114
34;Palencia;093;Vid de Ojeda (La);146;86;60
34;Palencia;202;Villabasta de Valdavia;44;20;24
34;Palencia;204;Villacidaler;79;40;39
34;Palencia;205;Villaconancio;96;52;44
34;Palencia;206;Villada;1400;682;718
34;Palencia;208;Villaeles de Valdavia;90;48;42
34;Palencia;210;Villahán;147;78;69
34;Palencia;211;Villaherreros;304;144;160
34;Palencia;213;Villalaco;90;39;51
34;Palencia;214;Villalba de Guardo;238;129;109
34;Palencia;215;Villalcázar de Sirga;245;114;131
34;Palencia;216;Villalcón;102;49;53
34;Palencia;217;Villalobón;292;155;137
34;Palencia;218;Villaluenga de la Vega;686;391;295
34;Palencia;220;Villamartín de Campos;171;90;81
34;Palencia;221;Villamediana;249;128;121
34;Palencia;222;Villameriel;170;91;79
34;Palencia;223;Villamoronta;350;185;165
34;Palencia;224;Villamuera de la Cueza;77;45;32
34;Palencia;225;Villamuriel de Cerrato;4349;2229;2120
34;Palencia;227;Villanueva del Rebollar;116;60;56
34;Palencia;228;Villanuño de Valdavia;138;76;62
34;Palencia;229;Villaprovedo;110;64;46
34;Palencia;230;Villarmentero de Campos;19;10;9
34;Palencia;231;Villarrabé;289;146;143
34;Palencia;232;Villarramiel;1122;549;573
34;Palencia;233;Villasarracino;308;157;151
34;Palencia;234;Villasila de Valdavia;117;67;50
34;Palencia;236;Villaturde;281;139;142
34;Palencia;237;Villaumbrales;910;475;435
34;Palencia;238;Villaviudas;510;246;264
34;Palencia;240;Villerías de Campos;136;71;65
34;Palencia;241;Villodre;50;30;20
34;Palencia;242;Villodrigo;138;67;71
34;Palencia;243;Villoldo;521;275;246
34;Palencia;245;Villota del Páramo;495;287;208
34;Palencia;246;Villovieco;141;70;71
35;Palmas (Las);001;Agaete;6028;3052;2976
35;Palmas (Las);002;Agüimes;18284;9290;8994
35;Palmas (Las);003;Antigua;3004;1577;1427
35;Palmas (Las);004;Arrecife;38091;19266;18825
35;Palmas (Las);005;Artenara;1250;645;605
35;Palmas (Las);006;Arucas;29719;14991;14728
35;Palmas (Las);007;Betancuria;592;305;287
35;Palmas (Las);008;Firgas;6526;3300;3226
35;Palmas (Las);009;Gáldar;21704;10878;10826
35;Palmas (Las);010;Haría;3531;1814;1717
35;Palmas (Las);011;Ingenio;24394;12221;12173
35;Palmas (Las);016;Las Palmas de Gran Canaria;355563;174894;180669
35;Palmas (Las);012;Mogán;10398;5356;5042
35;Palmas (Las);013;Moya;8663;4371;4292
35;Palmas (Las);014;Oliva (La);6956;3596;3360
35;Palmas (Las);015;Pájara;5812;3057;2755
35;Palmas (Las);017;Puerto del Rosario;19030;10001;9029
35;Palmas (Las);018;San Bartolomé;9852;5052;4800
35;Palmas (Las);019;San Bartolomé de Tirajana;35443;18186;17257
35;Palmas (Las);020;San Nicolás de Tolentino;8082;4056;4026
35;Palmas (Las);021;Santa Brígida;16809;8392;8417
35;Palmas (Las);022;Santa Lucía de Tirajana;40127;20364;19763
35;Palmas (Las);023;Santa María de Guía de Gran Canaria;13117;6483;6634
35;Palmas (Las);024;Teguise;8691;4455;4236
35;Palmas (Las);025;Tejeda;2552;1295;1257
35;Palmas (Las);026;Telde;84389;42277;42112
35;Palmas (Las);027;Teror;11225;5691;5534
35;Palmas (Las);028;Tías;10096;5184;4912
35;Palmas (Las);029;Tinajo;3755;1925;1830
35;Palmas (Las);030;Tuineje;7544;3914;3630
35;Palmas (Las);032;Valleseco;4383;2241;2142
35;Palmas (Las);031;Valsequillo de Gran Canaria;7796;3975;3821
35;Palmas (Las);033;Vega de San Mateo;7316;3771;3545
35;Palmas (Las);034;Yaiza;3363;1798;1565
36;Pontevedra;020;Agolada;4915;2392;2523
36;Pontevedra;001;Arbo;5019;2474;2545
36;Pontevedra;003;Baiona;10499;5129;5370
36;Pontevedra;002;Barro;3570;1710;1860
36;Pontevedra;004;Bueu;12599;6192;6407
36;Pontevedra;005;Caldas de Reis;9307;4479;4828
36;Pontevedra;006;Cambados;12936;6298;6638
36;Pontevedra;007;Campo Lameiro;2461;1175;1286
36;Pontevedra;008;Cangas;23231;11466;11765
36;Pontevedra;009;Cañiza (A);7695;3664;4031
36;Pontevedra;010;Catoira;3612;1771;1841
36;Pontevedra;011;Cerdedo;2771;1204;1567
36;Pontevedra;012;Cotobade;5123;2337;2786
36;Pontevedra;013;Covelo;4501;2076;2425
36;Pontevedra;014;Crecente;3060;1392;1668
36;Pontevedra;015;Cuntis;5834;2682;3152
36;Pontevedra;016;Dozón;2538;1260;1278
36;Pontevedra;017;Estrada (A);22492;10622;11870
36;Pontevedra;018;Forcarei;5301;2512;2789
36;Pontevedra;019;Fornelos de Montes;2410;1099;1311
36;Pontevedra;021;Gondomar;11147;5469;5678
36;Pontevedra;022;Grove (O);11035;5478;5557
36;Pontevedra;023;Guarda (A);9921;4757;5164
36;Pontevedra;901;Illa de Arousa (A);"";"";""
36;Pontevedra;024;Lalín;20515;9987;10528
36;Pontevedra;025;Lama (A);2988;1352;1636
36;Pontevedra;026;Marín;24731;12200;12531
36;Pontevedra;027;Meaño;5504;2638;2866
36;Pontevedra;028;Meis;5017;2352;2665
36;Pontevedra;029;Moaña;17687;8564;9123
36;Pontevedra;030;Mondariz;6347;3006;3341
36;Pontevedra;031;Mondariz-Balneario;636;300;336
36;Pontevedra;032;Moraña;4524;2151;2373
36;Pontevedra;033;Mos;13755;6664;7091
36;Pontevedra;034;Neves (As);5033;2380;2653
36;Pontevedra;035;Nigrán;15197;7433;7764
36;Pontevedra;036;Oia;3156;1566;1590
36;Pontevedra;037;Pazos de Borbén;3285;1535;1750
36;Pontevedra;041;Poio;13683;6633;7050
36;Pontevedra;043;Ponte Caldelas;6963;3252;3711
36;Pontevedra;042;Ponteareas;17360;8301;9059
36;Pontevedra;044;Pontecesures;2881;1416;1465
36;Pontevedra;038;Pontevedra;74287;35183;39104
36;Pontevedra;039;Porriño (O);15749;7575;8174
36;Pontevedra;040;Portas;3231;1509;1722
36;Pontevedra;045;Redondela;28893;13991;14902
36;Pontevedra;046;Ribadumia;4079;1975;2104
36;Pontevedra;047;Rodeiro;4578;2329;2249
36;Pontevedra;048;Rosal (O);5866;2834;3032
36;Pontevedra;049;Salceda de Caselas;6074;2950;3124
36;Pontevedra;050;Salvaterra de Miño;8778;4193;4585
36;Pontevedra;051;Sanxenxo;16034;7884;8150
36;Pontevedra;052;Silleda;9527;4590;4937
36;Pontevedra;053;Soutomaior;5236;2494;2742
36;Pontevedra;054;Tomiño;10478;5091;5387
36;Pontevedra;055;Tui;16003;7613;8390
36;Pontevedra;056;Valga;6442;3155;3287
36;Pontevedra;057;Vigo;286774;136332;150442
36;Pontevedra;059;Vila de Cruces;7624;3740;3884
36;Pontevedra;058;Vilaboa;5639;2761;2878
36;Pontevedra;060;Vilagarcía de Arousa;33375;16144;17231
36;Pontevedra;061;Vilanova de Arousa;15198;7387;7811
37;Salamanca;001;Abusejo;280;139;141
37;Salamanca;002;Agallas;187;98;89
37;Salamanca;003;Ahigal de los Aceiteros;216;109;107
37;Salamanca;004;Ahigal de Villarino;49;26;23
37;Salamanca;005;Alameda de Gardón (La);184;87;97
37;Salamanca;006;Alamedilla (La);239;116;123
37;Salamanca;007;Alaraz;698;360;338
37;Salamanca;008;Alba de Tormes;4647;2292;2355
37;Salamanca;009;Alba de Yeltes;308;151;157
37;Salamanca;010;Alberca (La);1106;576;530
37;Salamanca;011;Alberguería de Argañán (La);208;107;101
37;Salamanca;012;Alconada;238;118;120
37;Salamanca;015;Aldea del Obispo;434;223;211
37;Salamanca;013;Aldeacipreste;276;151;125
37;Salamanca;014;Aldeadávila de la Ribera;1741;886;855
37;Salamanca;016;Aldealengua;513;259;254
37;Salamanca;017;Aldeanueva de Figueroa;362;178;184
37;Salamanca;018;Aldeanueva de la Sierra;103;50;53
37;Salamanca;019;Aldearrodrigo;227;117;110
37;Salamanca;020;Aldearrubia;526;284;242
37;Salamanca;021;Aldeaseca de Alba;149;73;76
37;Salamanca;022;Aldeaseca de la Frontera;373;185;188
37;Salamanca;023;Aldeatejada;588;289;299
37;Salamanca;024;Aldeavieja de Tormes;133;66;67
37;Salamanca;025;Aldehuela de la Bóveda;395;194;201
37;Salamanca;026;Aldehuela de Yeltes;355;177;178
37;Salamanca;027;Almenara de Tormes;253;127;126
37;Salamanca;028;Almendra;213;108;105
37;Salamanca;029;Anaya de Alba;338;184;154
37;Salamanca;030;Añover de Tormes;123;65;58
37;Salamanca;031;Arabayona de Mógica;551;296;255
37;Salamanca;032;Arapiles;520;252;268
37;Salamanca;033;Arcediano;105;52;53
37;Salamanca;034;Arco (El);113;59;54
37;Salamanca;035;Armenteros;346;171;175
37;Salamanca;037;Atalaya (La);160;87;73
37;Salamanca;038;Babilafuente;1013;546;467
37;Salamanca;039;Bañobárez;476;246;230
37;Salamanca;040;Barbadillo;591;286;305
37;Salamanca;041;Barbalos;123;63;60
37;Salamanca;042;Barceo;76;40;36
37;Salamanca;044;Barruecopardo;606;309;297
37;Salamanca;045;Bastida (La);46;23;23
37;Salamanca;046;Béjar;16662;7938;8724
37;Salamanca;047;Beleña;153;84;69
37;Salamanca;049;Bermellar;227;105;122
37;Salamanca;050;Berrocal de Huebra;135;65;70
37;Salamanca;051;Berrocal de Salvatierra;150;74;76
37;Salamanca;052;Boada;484;247;237
37;Salamanca;054;Bodón (El);355;183;172
37;Salamanca;055;Bogajo;222;116;106
37;Salamanca;056;Bouza (La);72;36;36
37;Salamanca;057;Bóveda del Río Almar;313;166;147
37;Salamanca;058;Brincones;124;60;64
37;Salamanca;059;Buenamadre;187;97;90
37;Salamanca;060;Buenavista;80;43;37
37;Salamanca;061;Cabaco (El);314;158;156
37;Salamanca;063;Cabeza de Béjar (La);121;63;58
37;Salamanca;065;Cabeza del Caballo;505;257;248
37;Salamanca;062;Cabezabellosa de la Calzada;144;77;67
37;Salamanca;067;Cabrerizos;1434;715;719
37;Salamanca;068;Cabrillas;570;267;303
37;Salamanca;069;Calvarrasa de Abajo;997;494;503
37;Salamanca;070;Calvarrasa de Arriba;661;345;316
37;Salamanca;071;Calzada de Béjar (La);107;56;51
37;Salamanca;072;Calzada de Don Diego;262;134;128
37;Salamanca;073;Calzada de Valdunciel;627;309;318
37;Salamanca;074;Campillo de Azaba;290;145;145
37;Salamanca;077;Campo de Peñaranda (El);427;225;202
37;Salamanca;078;Candelario;1157;566;591
37;Salamanca;079;Canillas de Abajo;119;68;51
37;Salamanca;080;Cantagallo;290;141;149
37;Salamanca;081;Cantalapiedra;1413;691;722
37;Salamanca;082;Cantalpino;1233;665;568
37;Salamanca;083;Cantaracillo;301;154;147
37;Salamanca;085;Carbajosa de la Sagrada;1126;577;549
37;Salamanca;086;Carpio de Azaba;115;58;57
37;Salamanca;087;Carrascal de Barregas;376;191;185
37;Salamanca;088;Carrascal del Obispo;271;134;137
37;Salamanca;089;Casafranca;89;41;48
37;Salamanca;090;Casas del Conde (Las);92;44;48
37;Salamanca;091;Casillas de Flores;297;142;155
37;Salamanca;092;Castellanos de Moriscos;377;176;201
37;Salamanca;185;Castellanos de Villiquera;565;294;271
37;Salamanca;096;Castillejo de Martín Viejo;356;184;172
37;Salamanca;097;Castraz;72;46;26
37;Salamanca;098;Cepeda;554;265;289
37;Salamanca;099;Cereceda de la Sierra;109;59;50
37;Salamanca;100;Cerezal de Peñahorcada;148;80;68
37;Salamanca;101;Cerralbo;269;143;126
37;Salamanca;102;Cerro (El);594;302;292
37;Salamanca;103;Cespedosa de Tormes;718;377;341
37;Salamanca;114;Chagarcía Medianero;164;85;79
37;Salamanca;104;Cilleros de la Bastida;47;22;25
37;Salamanca;106;Cipérez;476;238;238
37;Salamanca;107;Ciudad Rodrigo;14901;7180;7721
37;Salamanca;108;Coca de Alba;168;73;95
37;Salamanca;109;Colmenar de Montemayor;289;166;123
37;Salamanca;110;Cordovilla;147;80;67
37;Salamanca;112;Cristóbal;259;134;125
37;Salamanca;113;Cubo de Don Sancho (El);620;327;293
37;Salamanca;115;Dios le Guarde;172;97;75
37;Salamanca;116;Doñinos de Ledesma;110;58;52
37;Salamanca;117;Doñinos de Salamanca;684;348;336
37;Salamanca;118;Ejeme;212;115;97
37;Salamanca;120;Encina de San Silvestre;128;64;64
37;Salamanca;119;Encina (La);227;121;106
37;Salamanca;121;Encinas de Abajo;689;351;338
37;Salamanca;122;Encinas de Arriba;299;146;153
37;Salamanca;123;Encinasola de los Comendadores;315;164;151
37;Salamanca;124;Endrinal;311;172;139
37;Salamanca;125;Escurial de la Sierra;320;157;163
37;Salamanca;126;Espadaña;58;30;28
37;Salamanca;127;Espeja;319;166;153
37;Salamanca;128;Espino de la Orbada;383;196;187
37;Salamanca;129;Florida de Liébana;252;137;115
37;Salamanca;130;Forfoleda;252;129;123
37;Salamanca;131;Frades de la Sierra;299;153;146
37;Salamanca;132;Fregeneda (La);601;292;309
37;Salamanca;133;Fresnedoso;138;64;74
37;Salamanca;134;Fresno Alhándiga;353;192;161
37;Salamanca;135;Fuente de San Esteban (La);1594;818;776
37;Salamanca;136;Fuenteguinaldo;1012;513;499
37;Salamanca;137;Fuenteliante;165;75;90
37;Salamanca;138;Fuenterroble de Salvatierra;283;142;141
37;Salamanca;139;Fuentes de Béjar;349;144;205
37;Salamanca;140;Fuentes de Oñoro;1520;722;798
37;Salamanca;141;Gajates;282;143;139
37;Salamanca;142;Galindo y Perahuy;242;131;111
37;Salamanca;143;Galinduste;588;287;301
37;Salamanca;144;Galisancho;624;340;284
37;Salamanca;145;Gallegos de Argañán;431;224;207
37;Salamanca;146;Gallegos de Solmirón;214;104;110
37;Salamanca;147;Garcibuey;303;169;134
37;Salamanca;148;Garcihernández;615;329;286
37;Salamanca;149;Garcirrey;113;56;57
37;Salamanca;150;Gejuelo del Barro;51;29;22
37;Salamanca;151;Golpejas;219;112;107
37;Salamanca;152;Gomecello;583;303;280
37;Salamanca;154;Guadramiro;240;137;103
37;Salamanca;155;Guijo de Ávila;121;66;55
37;Salamanca;156;Guijuelo;5002;2489;2513
37;Salamanca;157;Herguijuela de Ciudad Rodrigo;166;86;80
37;Salamanca;158;Herguijuela de la Sierra;352;175;177
37;Salamanca;159;Herguijuela del Campo;138;68;70
37;Salamanca;160;Hinojosa de Duero;894;440;454
37;Salamanca;161;Horcajo de Montemayor;208;106;102
37;Salamanca;162;Horcajo Medianero;393;200;193
37;Salamanca;163;Hoya (La);23;17;6
37;Salamanca;164;Huerta;270;144;126
37;Salamanca;165;Iruelos;72;31;41
37;Salamanca;166;Ituero de Azaba;312;168;144
37;Salamanca;167;Juzbado;181;93;88
37;Salamanca;168;Lagunilla;684;366;318
37;Salamanca;169;Larrodrigo;332;176;156
37;Salamanca;170;Ledesma;2008;992;1016
37;Salamanca;171;Ledrada;608;305;303
37;Salamanca;172;Linares de Riofrío;1084;548;536
37;Salamanca;173;Lumbrales;2315;1153;1162
37;Salamanca;175;Machacón;543;273;270
37;Salamanca;174;Macotera;1813;918;895
37;Salamanca;176;Madroñal;170;88;82
37;Salamanca;177;Maíllo (El);473;233;240
37;Salamanca;178;Malpartida;175;97;78
37;Salamanca;179;Mancera de Abajo;395;201;194
37;Salamanca;180;Manzano (El);108;57;51
37;Salamanca;181;Martiago;412;213;199
37;Salamanca;183;Martín de Yeltes;583;299;284
37;Salamanca;182;Martinamor;87;44;43
37;Salamanca;184;Masueco;501;251;250
37;Salamanca;186;Mata de Ledesma (La);155;74;81
37;Salamanca;187;Matilla de los Caños del Río;702;365;337
37;Salamanca;188;Maya (La);272;143;129
37;Salamanca;189;Membribe de la Sierra;102;52;50
37;Salamanca;190;Mieza;379;189;190
37;Salamanca;191;Milano (El);193;99;94
37;Salamanca;192;Miranda de Azán;351;150;201
37;Salamanca;193;Miranda del Castañar;653;340;313
37;Salamanca;194;Mogarraz;379;178;201
37;Salamanca;195;Molinillo;80;37;43
37;Salamanca;196;Monforte de la Sierra;113;63;50
37;Salamanca;197;Monleón;135;77;58
37;Salamanca;198;Monleras;277;140;137
37;Salamanca;199;Monsagro;250;141;109
37;Salamanca;200;Montejo;241;130;111
37;Salamanca;201;Montemayor del Río;378;189;189
37;Salamanca;202;Monterrubio de Armuña;339;167;172
37;Salamanca;203;Monterrubio de la Sierra;173;91;82
37;Salamanca;204;Morasverdes;473;235;238
37;Salamanca;205;Morille;202;108;94
37;Salamanca;206;Moríñigo;147;78;69
37;Salamanca;207;Moriscos;143;73;70
37;Salamanca;208;Moronta;147;75;72
37;Salamanca;209;Mozárbez;401;207;194
37;Salamanca;211;Narros de Matalayegua;320;174;146
37;Salamanca;213;Nava de Béjar;125;63;62
37;Salamanca;214;Nava de Francia;167;87;80
37;Salamanca;215;Nava de Sotrobal;212;112;100
37;Salamanca;212;Navacarros;123;65;58
37;Salamanca;216;Navales;416;239;177
37;Salamanca;217;Navalmoral de Béjar;82;38;44
37;Salamanca;218;Navamorales;192;102;90
37;Salamanca;219;Navarredonda de la Rinconada;276;133;143
37;Salamanca;221;Navasfrías;752;372;380
37;Salamanca;222;Negrilla de Palencia;141;67;74
37;Salamanca;223;Olmedo de Camaces;213;101;112
37;Salamanca;224;Orbada (La);298;150;148
37;Salamanca;225;Pajares de la Laguna;152;76;76
37;Salamanca;226;Palacios del Arzobispo;247;128;119
37;Salamanca;228;Palaciosrubios;570;305;265
37;Salamanca;229;Palencia de Negrilla;216;107;109
37;Salamanca;230;Parada de Arriba;248;134;114
37;Salamanca;231;Parada de Rubiales;363;187;176
37;Salamanca;232;Paradinas de San Juan;663;354;309
37;Salamanca;233;Pastores;65;35;30
37;Salamanca;234;Payo (El);532;253;279
37;Salamanca;235;Pedraza de Alba;304;160;144
37;Salamanca;236;Pedrosillo de Alba;291;148;143
37;Salamanca;237;Pedrosillo de los Aires;471;254;217
37;Salamanca;238;Pedrosillo el Ralo;146;71;75
37;Salamanca;239;Pedroso de la Armuña (El);332;165;167
37;Salamanca;240;Pelabravo;712;362;350
37;Salamanca;241;Pelarrodríguez;211;121;90
37;Salamanca;242;Pelayos;90;45;45
37;Salamanca;243;Peña (La);167;79;88
37;Salamanca;244;Peñacaballera;231;112;119
37;Salamanca;245;Peñaparda;513;250;263
37;Salamanca;246;Peñaranda de Bracamonte;6291;3078;3213
37;Salamanca;247;Peñarandilla;289;148;141
37;Salamanca;248;Peralejos de Abajo;214;101;113
37;Salamanca;249;Peralejos de Arriba;76;42;34
37;Salamanca;250;Pereña de la Ribera;554;281;273
37;Salamanca;251;Peromingo;167;80;87
37;Salamanca;252;Pinedas;213;108;105
37;Salamanca;253;Pino de Tormes (El);181;94;87
37;Salamanca;254;Pitiegua;271;131;140
37;Salamanca;255;Pizarral;97;46;51
37;Salamanca;256;Poveda de las Cintas;364;196;168
37;Salamanca;257;Pozos de Hinojo;95;52;43
37;Salamanca;258;Puebla de Azaba;316;164;152
37;Salamanca;259;Puebla de San Medel;74;39;35
37;Salamanca;260;Puebla de Yeltes;269;143;126
37;Salamanca;261;Puente del Congosto;370;185;185
37;Salamanca;262;Puertas;117;62;55
37;Salamanca;263;Puerto de Béjar;516;240;276
37;Salamanca;264;Puerto Seguro;122;59;63
37;Salamanca;265;Rágama;326;167;159
37;Salamanca;266;Redonda (La);123;56;67
37;Salamanca;267;Retortillo;275;129;146
37;Salamanca;268;Rinconada de la Sierra (La);179;89;90
37;Salamanca;269;Robleda;602;322;280
37;Salamanca;270;Robliza de Cojos;194;98;96
37;Salamanca;271;Rollán;607;313;294
37;Salamanca;272;Saelices el Chico;204;107;97
37;Salamanca;273;Sagrada (La);207;105;102
37;Salamanca;303;Sahugo (El);307;159;148
37;Salamanca;274;Salamanca;159225;74850;84375
37;Salamanca;275;Saldeana;197;109;88
37;Salamanca;276;Salmoral;371;191;180
37;Salamanca;277;Salvatierra de Tormes;64;32;32
37;Salamanca;278;San Cristóbal de la Cuesta;337;173;164
37;Salamanca;284;San Esteban de la Sierra;469;238;231
37;Salamanca;285;San Felices de los Gallegos;683;344;339
37;Salamanca;286;San Martín del Castañar;283;142;141
37;Salamanca;287;San Miguel de Valero;447;231;216
37;Salamanca;036;San Miguel del Robledo;101;48;53
37;Salamanca;288;San Morales;203;110;93
37;Salamanca;289;San Muñoz;380;190;190
37;Salamanca;291;San Pedro de Rozados;389;195;194
37;Salamanca;290;San Pedro del Valle;134;66;68
37;Salamanca;292;San Pelayo de Guareña;114;58;56
37;Salamanca;280;Sanchón de la Ribera;132;71;61
37;Salamanca;281;Sanchón de la Sagrada;59;33;26
37;Salamanca;282;Sanchotello;345;174;171
37;Salamanca;279;Sancti-Spíritus;1243;640;603
37;Salamanca;283;Sando;191;103;88
37;Salamanca;293;Santa María de Sando;211;108;103
37;Salamanca;294;Santa Marta de Tormes;9392;4687;4705
37;Salamanca;296;Santiago de la Puebla;609;317;292
37;Salamanca;297;Santibáñez de Béjar;722;355;367
37;Salamanca;298;Santibáñez de la Sierra;264;145;119
37;Salamanca;299;Santiz;302;156;146
37;Salamanca;300;Santos (Los);808;421;387
37;Salamanca;301;Sardón de los Frailes;106;57;49
37;Salamanca;302;Saucelle;484;242;242
37;Salamanca;304;Sepulcro-Hilario;333;168;165
37;Salamanca;305;Sequeros;261;114;147
37;Salamanca;306;Serradilla del Arroyo;475;239;236
37;Salamanca;307;Serradilla del Llano;298;153;145
37;Salamanca;309;Sierpe (La);57;30;27
37;Salamanca;310;Sieteiglesias de Tormes;181;92;89
37;Salamanca;311;Sobradillo;403;197;206
37;Salamanca;312;Sorihuela;411;205;206
37;Salamanca;313;Sotoserrano;716;372;344
37;Salamanca;314;Tabera de Abajo;120;61;59
37;Salamanca;315;Tala (La);151;77;74
37;Salamanca;316;Tamames;1074;550;524
37;Salamanca;317;Tarazona de Guareña;450;236;214
37;Salamanca;318;Tardáguila;271;145;126
37;Salamanca;319;Tejado (El);186;92;94
37;Salamanca;320;Tejeda y Segoyuela;132;70;62
37;Salamanca;321;Tenebrón;240;123;117
37;Salamanca;322;Terradillos;2842;1447;1395
37;Salamanca;323;Topas;722;367;355
37;Salamanca;324;Tordillos;608;305;303
37;Salamanca;325;Tornadizo (El);154;79;75
37;Salamanca;327;Torresmenudas;245;118;127
37;Salamanca;328;Trabanca;261;133;128
37;Salamanca;329;Tremedal de Tormes;57;28;29
37;Salamanca;330;Valdecarros;470;247;223
37;Salamanca;331;Valdefuentes de Sangusín;344;173;171
37;Salamanca;332;Valdehijaderos;130;72;58
37;Salamanca;333;Valdelacasa;372;198;174
37;Salamanca;334;Valdelageve;136;71;65
37;Salamanca;335;Valdelosa;511;244;267
37;Salamanca;336;Valdemierque;77;39;38
37;Salamanca;337;Valderrodrigo;190;89;101
37;Salamanca;338;Valdunciel;123;58;65
37;Salamanca;339;Valero;494;250;244
37;Salamanca;343;Vallejera de Riofrío;54;24;30
37;Salamanca;340;Valsalabroso;235;124;111
37;Salamanca;341;Valverde de Valdelacasa;82;39;43
37;Salamanca;342;Valverdón;270;135;135
37;Salamanca;344;Vecinos;307;153;154
37;Salamanca;345;Vega de Tirados;235;120;115
37;Salamanca;346;Veguillas (Las);314;155;159
37;Salamanca;347;Vellés (La);511;262;249
37;Salamanca;348;Ventosa del Río Almar;175;84;91
37;Salamanca;349;Vídola (La);202;100;102
37;Salamanca;351;Villaflores;483;245;238
37;Salamanca;352;Villagonzalo de Tormes;251;137;114
37;Salamanca;353;Villalba de los Llanos;204;113;91
37;Salamanca;354;Villamayor;2337;1208;1129
37;Salamanca;355;Villanueva del Conde;264;139;125
37;Salamanca;356;Villar de Argañán;114;57;57
37;Salamanca;357;Villar de Ciervo;434;229;205
37;Salamanca;358;Villar de Gallimazo;234;118;116
37;Salamanca;359;Villar de la Yegua;333;152;181
37;Salamanca;360;Villar de Peralonso;366;172;194
37;Salamanca;361;Villar de Samaniego;132;69;63
37;Salamanca;362;Villares de la Reina;1920;954;966
37;Salamanca;363;Villares de Yeltes;187;88;99
37;Salamanca;364;Villarino de los Aires;1171;576;595
37;Salamanca;365;Villarmayor;252;128;124
37;Salamanca;366;Villarmuerto;70;40;30
37;Salamanca;367;Villasbuenas;331;165;166
37;Salamanca;368;Villasdardo;26;12;14
37;Salamanca;369;Villaseco de los Gamitos;211;107;104
37;Salamanca;370;Villaseco de los Reyes;470;243;227
37;Salamanca;371;Villasrubias;402;219;183
37;Salamanca;372;Villaverde de Guareña;203;99;104
37;Salamanca;373;Villavieja de Yeltes;1208;601;607
37;Salamanca;374;Villoria;1414;701;713
37;Salamanca;375;Villoruela;1026;511;515
37;Salamanca;350;Vilvestre;647;320;327
37;Salamanca;376;Vitigudino;3183;1559;1624
37;Salamanca;377;Yecla de Yeltes;385;190;195
37;Salamanca;378;Zamarra;171;88;83
37;Salamanca;379;Zamayón;212;121;91
37;Salamanca;380;Zarapicos;70;39;31
37;Salamanca;381;Zarza de Pumareda (La);219;123;96
37;Salamanca;382;Zorita de la Frontera;303;166;137
38;Santa Cruz de Tenerife;001;Adeje;14029;7066;6963
38;Santa Cruz de Tenerife;002;Agulo;1157;571;586
38;Santa Cruz de Tenerife;003;Alajeró;1155;601;554
38;Santa Cruz de Tenerife;004;Arafo;4667;2262;2405
38;Santa Cruz de Tenerife;005;Arico;5064;2592;2472
38;Santa Cruz de Tenerife;006;Arona;28208;14115;14093
38;Santa Cruz de Tenerife;007;Barlovento;2488;1250;1238
38;Santa Cruz de Tenerife;008;Breña Alta;5816;2872;2944
38;Santa Cruz de Tenerife;009;Breña Baja;3746;1856;1890
38;Santa Cruz de Tenerife;010;Buenavista del Norte;5664;2879;2785
38;Santa Cruz de Tenerife;011;Candelaria;12392;6141;6251
38;Santa Cruz de Tenerife;012;Fasnia;2434;1229;1205
38;Santa Cruz de Tenerife;013;Frontera;4409;2241;2168
38;Santa Cruz de Tenerife;014;Fuencaliente de la Palma;1735;883;852
38;Santa Cruz de Tenerife;015;Garachico;5728;2823;2905
38;Santa Cruz de Tenerife;016;Garafía;2002;1019;983
38;Santa Cruz de Tenerife;017;Granadilla de Abona;18508;9253;9255
38;Santa Cruz de Tenerife;018;Guancha (La);5232;2611;2621
38;Santa Cruz de Tenerife;019;Guía de Isora;12560;6144;6416
38;Santa Cruz de Tenerife;020;Güímar;14014;6880;7134
38;Santa Cruz de Tenerife;021;Hermigua;2150;1112;1038
38;Santa Cruz de Tenerife;022;Icod de los Vinos;21364;10511;10853
38;Santa Cruz de Tenerife;024;Llanos de Aridane (Los);17944;8817;9127
38;Santa Cruz de Tenerife;025;Matanza de Acentejo (La);6451;3279;3172
38;Santa Cruz de Tenerife;026;Orotava (La);35642;17638;18004
38;Santa Cruz de Tenerife;027;Paso (El);7006;3539;3467
38;Santa Cruz de Tenerife;901;Pinar de el Hierro (El);"";"";""
38;Santa Cruz de Tenerife;028;Puerto de la Cruz;24542;11887;12655
38;Santa Cruz de Tenerife;029;Puntagorda;1798;885;913
38;Santa Cruz de Tenerife;030;Puntallana;2201;1087;1114
38;Santa Cruz de Tenerife;031;Realejos (Los);32599;16124;16475
38;Santa Cruz de Tenerife;032;Rosario (El);10880;5453;5427
38;Santa Cruz de Tenerife;033;San Andrés y Sauces;5438;2777;2661
38;Santa Cruz de Tenerife;023;San Cristóbal de La Laguna;121769;59697;62072
38;Santa Cruz de Tenerife;034;San Juan de la Rambla;4743;2343;2400
38;Santa Cruz de Tenerife;035;San Miguel de Abona;5776;2902;2874
38;Santa Cruz de Tenerife;036;San Sebastián de la Gomera;6199;3108;3091
38;Santa Cruz de Tenerife;037;Santa Cruz de la Palma;17265;8330;8935
38;Santa Cruz de Tenerife;038;Santa Cruz de Tenerife;203787;97817;105970
38;Santa Cruz de Tenerife;039;Santa Úrsula;9591;4769;4822
38;Santa Cruz de Tenerife;040;Santiago del Teide;7506;3816;3690
38;Santa Cruz de Tenerife;041;Sauzal (El);7034;3498;3536
38;Santa Cruz de Tenerife;042;Silos (Los);5257;2602;2655
38;Santa Cruz de Tenerife;043;Tacoronte;19056;9538;9518
38;Santa Cruz de Tenerife;044;Tanque (El);3247;1626;1621
38;Santa Cruz de Tenerife;045;Tazacorte;6909;3479;3430
38;Santa Cruz de Tenerife;046;Tegueste;8558;4251;4307
38;Santa Cruz de Tenerife;047;Tijarafe;2658;1343;1315
38;Santa Cruz de Tenerife;049;Valle Gran Rey;3631;1847;1784
38;Santa Cruz de Tenerife;050;Vallehermoso;2716;1350;1366
38;Santa Cruz de Tenerife;048;Valverde;3929;1938;1991
38;Santa Cruz de Tenerife;051;Victoria de Acentejo (La);7678;3818;3860
38;Santa Cruz de Tenerife;052;Vilaflor;1616;824;792
38;Santa Cruz de Tenerife;053;Villa de Mazo;4501;2264;2237
39;Cantabria;001;Alfoz de Lloredo;2646;1348;1298
39;Cantabria;002;Ampuero;3337;1664;1673
39;Cantabria;003;Anievas;407;211;196
39;Cantabria;004;Arenas de Iguña;2165;1084;1081
39;Cantabria;005;Argoños;778;398;380
39;Cantabria;006;Arnuero;1811;908;903
39;Cantabria;007;Arredondo;668;364;304
39;Cantabria;008;Astillero (El);13010;6408;6602
39;Cantabria;009;Bárcena de Cicero;2213;1140;1073
39;Cantabria;010;Bárcena de Pie de Concha;955;454;501
39;Cantabria;011;Bareyo;1704;864;840
39;Cantabria;012;Cabezón de la Sal;7076;3491;3585
39;Cantabria;013;Cabezón de Liébana;782;424;358
39;Cantabria;014;Cabuérniga;1152;582;570
39;Cantabria;015;Camaleño;1116;580;536
39;Cantabria;016;Camargo;22311;10934;11377
39;Cantabria;027;Campoo de Enmedio;3858;1961;1897
39;Cantabria;017;Campoo de Yuso;761;372;389
39;Cantabria;018;Cartes;2954;1468;1486
39;Cantabria;019;Castañeda;1566;772;794
39;Cantabria;020;Castro-Urdiales;15167;7544;7623
39;Cantabria;021;Cieza;722;358;364
39;Cantabria;022;Cillorigo de Liébana;1166;620;546
39;Cantabria;023;Colindres;6099;3034;3065
39;Cantabria;024;Comillas;2364;1140;1224
39;Cantabria;025;Corrales de Buelna (Los);10289;5148;5141
39;Cantabria;026;Corvera de Toranzo;2192;1105;1087
39;Cantabria;028;Entrambasaguas;2483;1240;1243
39;Cantabria;029;Escalante;747;383;364
39;Cantabria;030;Guriezo;1705;879;826
39;Cantabria;031;Hazas de Cesto;1274;642;632
39;Cantabria;032;Hermandad de Campoo de Suso;1863;991;872
39;Cantabria;033;Herrerías;754;411;343
39;Cantabria;034;Lamasón;417;229;188
39;Cantabria;035;Laredo;12913;6252;6661
39;Cantabria;036;Liendo;811;413;398
39;Cantabria;037;Liérganes;2263;1107;1156
39;Cantabria;038;Limpias;1271;633;638
39;Cantabria;039;Luena;1022;533;489
39;Cantabria;040;Marina de Cudeyo;4503;2257;2246
39;Cantabria;041;Mazcuerras;1901;1004;897
39;Cantabria;042;Medio Cudeyo;5904;2889;3015
39;Cantabria;043;Meruelo;955;485;470
39;Cantabria;044;Miengo;3437;1703;1734
39;Cantabria;045;Miera;580;288;292
39;Cantabria;046;Molledo;2024;999;1025
39;Cantabria;047;Noja;1876;938;938
39;Cantabria;048;Penagos;1696;852;844
39;Cantabria;049;Peñarrubia;298;151;147
39;Cantabria;050;Pesaguero;421;224;197
39;Cantabria;051;Pesquera;106;49;57
39;Cantabria;052;Piélagos;10741;5339;5402
39;Cantabria;053;Polaciones;302;179;123
39;Cantabria;054;Polanco;3660;1783;1877
39;Cantabria;055;Potes;1622;802;820
39;Cantabria;056;Puente Viesgo;2308;1152;1156
39;Cantabria;057;Ramales de la Victoria;2284;1173;1111
39;Cantabria;058;Rasines;1016;522;494
39;Cantabria;059;Reinosa;11786;5716;6070
39;Cantabria;060;Reocín;6837;3383;3454
39;Cantabria;061;Ribamontán al Mar;3355;1707;1648
39;Cantabria;062;Ribamontán al Monte;2045;1046;999
39;Cantabria;063;Rionansa;1561;848;713
39;Cantabria;064;Riotuerto;1535;750;785
39;Cantabria;065;Rozas de Valdearroyo (Las);298;154;144
39;Cantabria;066;Ruente;949;486;463
39;Cantabria;067;Ruesga;1281;651;630
39;Cantabria;068;Ruiloba;708;357;351
39;Cantabria;069;San Felices de Buelna;2230;1073;1157
39;Cantabria;070;San Miguel de Aguayo;159;83;76
39;Cantabria;071;San Pedro del Romeral;693;352;341
39;Cantabria;072;San Roque de Riomiera;572;313;259
39;Cantabria;080;San Vicente de la Barquera;4395;2234;2161
39;Cantabria;073;Santa Cruz de Bezana;7046;3504;3542
39;Cantabria;074;Santa María de Cayón;6196;3105;3091
39;Cantabria;075;Santander;185410;86979;98431
39;Cantabria;076;Santillana del Mar;3854;1886;1968
39;Cantabria;077;Santiurde de Reinosa;368;199;169
39;Cantabria;078;Santiurde de Toranzo;1695;855;840
39;Cantabria;079;Santoña;11843;5993;5850
39;Cantabria;081;Saro;547;273;274
39;Cantabria;082;Selaya;1987;1006;981
39;Cantabria;083;Soba;1737;910;827
39;Cantabria;084;Solórzano;1014;524;490
39;Cantabria;085;Suances;6117;3009;3108
39;Cantabria;086;Tojos (Los);400;216;184
39;Cantabria;087;Torrelavega;58196;28127;30069
39;Cantabria;088;Tresviso;62;36;26
39;Cantabria;089;Tudanca;275;162;113
39;Cantabria;090;Udías;847;422;425
39;Cantabria;095;Val de San Vicente;2536;1278;1258
39;Cantabria;091;Valdáliga;2652;1361;1291
39;Cantabria;092;Valdeolea;1626;838;788
39;Cantabria;093;Valdeprado del Río;319;172;147
39;Cantabria;094;Valderredible;1165;610;555
39;Cantabria;096;Vega de Liébana;1063;558;505
39;Cantabria;097;Vega de Pas;1011;504;507
39;Cantabria;098;Villacarriedo;1804;941;863
39;Cantabria;099;Villaescusa;3041;1472;1569
39;Cantabria;100;Villafufre;1107;570;537
39;Cantabria;101;Villaverde de Trucíos;379;195;184
39;Cantabria;102;Voto;2310;1210;1100
40;Segovia;001;Abades;876;442;434
40;Segovia;002;Adrada de Pirón;61;33;28
40;Segovia;003;Adrados;236;113;123
40;Segovia;004;Aguilafuente;813;385;428
40;Segovia;005;Alconada de Maderuelo;60;32;28
40;Segovia;012;Aldea Real;409;221;188
40;Segovia;006;Aldealcorvo;35;17;18
40;Segovia;007;Aldealengua de Pedraza;105;56;49
40;Segovia;008;Aldealengua de Santa María;97;52;45
40;Segovia;009;Aldeanueva de la Serrezuela;59;33;26
40;Segovia;010;Aldeanueva del Codonal;223;117;106
40;Segovia;013;Aldeasoña;126;54;72
40;Segovia;014;Aldehorno;84;41;43
40;Segovia;015;Aldehuela del Codonal;60;27;33
40;Segovia;016;Aldeonte;96;48;48
40;Segovia;017;Anaya;131;66;65
40;Segovia;018;Añe;127;69;58
40;Segovia;019;Arahuetes;45;24;21
40;Segovia;020;Arcones;260;138;122
40;Segovia;021;Arevalillo de Cega;38;20;18
40;Segovia;022;Armuña;281;152;129
40;Segovia;024;Ayllón;1237;624;613
40;Segovia;025;Barbolla;238;127;111
40;Segovia;026;Basardilla;91;48;43
40;Segovia;028;Bercial;138;67;71
40;Segovia;029;Bercimuel;76;34;42
40;Segovia;030;Bernardos;776;388;388
40;Segovia;031;Bernuy de Porreros;336;172;164
40;Segovia;032;Boceguillas;614;315;299
40;Segovia;033;Brieva;72;44;28
40;Segovia;034;Caballar;113;52;61
40;Segovia;035;Cabañas de Polendos;119;62;57
40;Segovia;036;Cabezuela;736;391;345
40;Segovia;037;Calabazas de Fuentidueña;82;38;44
40;Segovia;039;Campo de San Pedro;398;226;172
40;Segovia;040;Cantalejo;3521;1786;1735
40;Segovia;041;Cantimpalos;1306;668;638
40;Segovia;043;Carbonero el Mayor;2349;1189;1160
40;Segovia;044;Carrascal del Río;217;114;103
40;Segovia;045;Casla;155;79;76
40;Segovia;046;Castillejo de Mesleón;145;75;70
40;Segovia;047;Castro de Fuentidueña;95;54;41
40;Segovia;048;Castrojimeno;50;30;20
40;Segovia;049;Castroserna de Abajo;63;38;25
40;Segovia;051;Castroserracín;60;35;25
40;Segovia;052;Cedillo de la Torre;139;71;68
40;Segovia;053;Cerezo de Abajo;197;99;98
40;Segovia;054;Cerezo de Arriba;240;129;111
40;Segovia;065;Chañe;743;392;351
40;Segovia;055;Cilleruelo de San Mamés;55;27;28
40;Segovia;056;Cobos de Fuentidueña;73;32;41
40;Segovia;057;Coca;2027;1008;1019
40;Segovia;058;Codorniz;507;248;259
40;Segovia;059;Collado Hermoso;146;68;78
40;Segovia;060;Condado de Castilnovo;162;89;73
40;Segovia;061;Corral de Ayllón;113;62;51
40;Segovia;902;Cozuelos de Fuentidueña;217;108;109
40;Segovia;062;Cubillo;66;39;27
40;Segovia;063;Cuéllar;9118;4639;4479
40;Segovia;905;Cuevas de Provanco;228;125;103
40;Segovia;068;Domingo García;49;22;27
40;Segovia;069;Donhierro;116;65;51
40;Segovia;070;Duruelo;155;79;76
40;Segovia;071;Encinas;72;35;37
40;Segovia;072;Encinillas;82;45;37
40;Segovia;073;Escalona del Prado;599;320;279
40;Segovia;074;Escarabajosa de Cabezas;390;205;185
40;Segovia;075;Escobar de Polendos;228;116;112
40;Segovia;076;Espinar (El);5854;2992;2862
40;Segovia;077;Espirdo;220;121;99
40;Segovia;078;Fresneda de Cuéllar;260;137;123
40;Segovia;079;Fresno de Cantespino;235;122;113
40;Segovia;080;Fresno de la Fuente;78;40;38
40;Segovia;081;Frumales;239;119;120
40;Segovia;082;Fuente de Santa Cruz;198;100;98
40;Segovia;083;Fuente el Olmo de Fuentidueña;163;81;82
40;Segovia;084;Fuente el Olmo de Íscar;119;66;53
40;Segovia;086;Fuentepelayo;1006;503;503
40;Segovia;087;Fuentepiñel;192;95;97
40;Segovia;088;Fuenterrebollo;453;236;217
40;Segovia;089;Fuentesaúco de Fuentidueña;351;182;169
40;Segovia;091;Fuentesoto;172;86;86
40;Segovia;092;Fuentidueña;195;98;97
40;Segovia;093;Gallegos;113;60;53
40;Segovia;094;Garcillán;349;186;163
40;Segovia;095;Gomezserracín;664;345;319
40;Segovia;097;Grajera;96;47;49
40;Segovia;099;Honrubia de la Cuesta;90;41;49
40;Segovia;100;Hontalbilla;471;241;230
40;Segovia;101;Hontanares de Eresma;158;86;72
40;Segovia;103;Huertos (Los);169;83;86
40;Segovia;104;Ituero y Lama;74;43;31
40;Segovia;105;Juarros de Riomoros;75;40;35
40;Segovia;106;Juarros de Voltoya;288;156;132
40;Segovia;107;Labajos;161;91;70
40;Segovia;108;Laguna de Contreras;191;105;86
40;Segovia;109;Languilla;141;79;62
40;Segovia;110;Lastras de Cuéllar;582;303;279
40;Segovia;111;Lastras del Pozo;82;45;37
40;Segovia;112;Lastrilla (La);1375;686;689
40;Segovia;113;Losa (La);362;194;168
40;Segovia;115;Maderuelo;153;79;74
40;Segovia;903;Marazoleja;160;91;69
40;Segovia;118;Marazuela;92;45;47
40;Segovia;119;Martín Miguel;210;101;109
40;Segovia;120;Martín Muñoz de la Dehesa;192;104;88
40;Segovia;121;Martín Muñoz de las Posadas;547;279;268
40;Segovia;122;Marugán;337;181;156
40;Segovia;124;Mata de Cuéllar;331;179;152
40;Segovia;123;Matabuena;216;110;106
40;Segovia;125;Matilla (La);122;66;56
40;Segovia;126;Melque de Cercos;132;66;66
40;Segovia;127;Membibre de la Hoz;82;43;39
40;Segovia;128;Migueláñez;183;92;91
40;Segovia;129;Montejo de Arévalo;308;168;140
40;Segovia;130;Montejo de la Vega de la Serrezuela;209;110;99
40;Segovia;131;Monterrubio;71;35;36
40;Segovia;132;Moral de Hornuez;121;63;58
40;Segovia;134;Mozoncillo;1052;542;510
40;Segovia;135;Muñopedro;422;213;209
40;Segovia;136;Muñoveros;218;117;101
40;Segovia;138;Nava de la Asunción;2692;1377;1315
40;Segovia;139;Navafría;391;208;183
40;Segovia;140;Navalilla;170;84;86
40;Segovia;141;Navalmanzano;1157;598;559
40;Segovia;142;Navares de Ayuso;87;44;43
40;Segovia;143;Navares de Enmedio;187;102;85
40;Segovia;144;Navares de las Cuevas;26;12;14
40;Segovia;145;Navas de Oro;1488;750;738
40;Segovia;904;Navas de Riofrío;262;128;134
40;Segovia;146;Navas de San Antonio;297;156;141
40;Segovia;148;Nieva;380;200;180
40;Segovia;149;Olombrada;845;442;403
40;Segovia;150;Orejana;122;66;56
40;Segovia;151;Ortigosa de Pestaño;87;44;43
40;Segovia;901;Ortigosa del Monte;294;147;147
40;Segovia;152;Otero de Herreros;812;398;414
40;Segovia;154;Pajarejos;47;22;25
40;Segovia;155;Palazuelos de Eresma;2499;1228;1271
40;Segovia;156;Pedraza;467;242;225
40;Segovia;157;Pelayos del Arroyo;55;28;27
40;Segovia;158;Perosillo;35;22;13
40;Segovia;159;Pinarejos;207;116;91
40;Segovia;160;Pinarnegrillo;205;105;100
40;Segovia;161;Pradales;82;41;41
40;Segovia;162;Prádena;581;313;268
40;Segovia;163;Puebla de Pedraza;95;45;50
40;Segovia;164;Rapariegos;289;151;138
40;Segovia;165;Rebollo;140;76;64
40;Segovia;166;Remondo;380;182;198
40;Segovia;168;Riaguas de San Bartolomé;82;42;40
40;Segovia;170;Riaza;1673;884;789
40;Segovia;171;Ribota;41;23;18
40;Segovia;172;Riofrío de Riaza;51;26;25
40;Segovia;173;Roda de Eresma;106;52;54
40;Segovia;174;Sacramenia;556;289;267
40;Segovia;176;Samboal;633;332;301
40;Segovia;177;San Cristóbal de Cuéllar;251;129;122
40;Segovia;178;San Cristóbal de la Vega;161;82;79
40;Segovia;906;San Cristóbal de Segovia;"";"";""
40;Segovia;181;San Ildefonso;5110;2461;2649
40;Segovia;182;San Martín y Mudrián;309;160;149
40;Segovia;183;San Miguel de Bernuy;199;103;96
40;Segovia;184;San Pedro de Gaíllos;381;187;194
40;Segovia;179;Sanchonuño;756;373;383
40;Segovia;180;Sangarcía;473;240;233
40;Segovia;185;Santa María la Real de Nieva;1545;774;771
40;Segovia;186;Santa Marta del Cerro;51;24;27
40;Segovia;188;Santiuste de Pedraza;108;58;50
40;Segovia;189;Santiuste de San Juan Bautista;786;399;387
40;Segovia;190;Santo Domingo de Pirón;56;26;30
40;Segovia;191;Santo Tomé del Puerto;340;178;162
40;Segovia;192;Sauquillo de Cabezas;250;134;116
40;Segovia;193;Sebúlcor;298;157;141
40;Segovia;194;Segovia;54287;26121;28166
40;Segovia;195;Sepúlveda;1343;695;648
40;Segovia;196;Sequera de Fresno;57;31;26
40;Segovia;198;Sotillo;49;22;27
40;Segovia;199;Sotosalbos;114;62;52
40;Segovia;200;Tabanera la Luenga;81;45;36
40;Segovia;201;Tolocirio;64;29;35
40;Segovia;206;Torre Val de San Pedro;204;109;95
40;Segovia;202;Torreadrada;146;76;70
40;Segovia;203;Torrecaballeros;443;233;210
40;Segovia;204;Torrecilla del Pinar;345;170;175
40;Segovia;205;Torreiglesias;393;208;185
40;Segovia;207;Trescasas;234;118;116
40;Segovia;208;Turégano;1111;553;558
40;Segovia;210;Urueñas;130;68;62
40;Segovia;211;Valdeprados;56;28;28
40;Segovia;212;Valdevacas de Montejo;35;20;15
40;Segovia;213;Valdevacas y Guijar;156;83;73
40;Segovia;218;Valle de Tabladillo;178;93;85
40;Segovia;219;Vallelado;860;433;427
40;Segovia;220;Valleruela de Pedraza;78;43;35
40;Segovia;221;Valleruela de Sepúlveda;78;39;39
40;Segovia;214;Valseca;319;166;153
40;Segovia;215;Valtiendas;206;115;91
40;Segovia;216;Valverde del Majano;485;249;236
40;Segovia;222;Veganzones;302;147;155
40;Segovia;223;Vegas de Matute;249;140;109
40;Segovia;224;Ventosilla y Tejadilla;29;17;12
40;Segovia;225;Villacastín;1540;782;758
40;Segovia;228;Villaverde de Íscar;763;397;366
40;Segovia;229;Villaverde de Montejo;83;43;40
40;Segovia;230;Villeguillo;141;80;61
40;Segovia;231;Yanguas de Eresma;197;94;103
40;Segovia;233;Zarzuela del Monte;532;272;260
40;Segovia;234;Zarzuela del Pinar;622;330;292
41;Sevilla;001;Aguadulce;1956;981;975
41;Sevilla;002;Alanís;2108;1056;1052
41;Sevilla;003;Albaida del Aljarafe;1841;930;911
41;Sevilla;004;Alcalá de Guadaira;56313;27845;28468
41;Sevilla;005;Alcalá del Río;9368;4785;4583
41;Sevilla;006;Alcolea del Río;3398;1682;1716
41;Sevilla;007;Algaba (La);12792;6458;6334
41;Sevilla;008;Algámitas;1412;734;678
41;Sevilla;009;Almadén de la Plata;1696;857;839
41;Sevilla;010;Almensilla;2232;1116;1116
41;Sevilla;011;Arahal;18110;8955;9155
41;Sevilla;012;Aznalcázar;3387;1702;1685
41;Sevilla;013;Aznalcóllar;5812;2984;2828
41;Sevilla;014;Badolatosa;3173;1637;1536
41;Sevilla;015;Benacazón;4936;2503;2433
41;Sevilla;016;Bollullos de la Mitación;4950;2486;2464
41;Sevilla;017;Bormujos;6839;3395;3444
41;Sevilla;018;Brenes;10623;5347;5276
41;Sevilla;019;Burguillos;3451;1716;1735
41;Sevilla;020;Cabezas de San Juan (Las);15509;8003;7506
41;Sevilla;021;Camas;25679;12484;13195
41;Sevilla;022;Campana (La);5260;2659;2601
41;Sevilla;023;Cantillana;8930;4480;4450
41;Sevilla;901;Cañada Rosal;2904;1465;1439
41;Sevilla;024;Carmona;25266;12724;12542
41;Sevilla;025;Carrión de los Céspedes;2257;1074;1183
41;Sevilla;026;Casariche;5132;2580;2552
41;Sevilla;027;Castilblanco de los Arroyos;4457;2228;2229
41;Sevilla;028;Castilleja de Guzmán;692;349;343
41;Sevilla;029;Castilleja de la Cuesta;15726;7742;7984
41;Sevilla;030;Castilleja del Campo;653;319;334
41;Sevilla;031;Castillo de las Guardas (El);1600;812;788
41;Sevilla;032;Cazalla de la Sierra;5229;2619;2610
41;Sevilla;033;Constantina;7390;3638;3752
41;Sevilla;034;Coria del Río;23362;11722;11640
41;Sevilla;035;Coripe;1620;828;792
41;Sevilla;036;Coronil (El);5134;2600;2534
41;Sevilla;037;Corrales (Los);4150;2121;2029
41;Sevilla;903;Cuervo de Sevilla (El);7588;3876;3712
41;Sevilla;038;Dos Hermanas;91138;45135;46003
41;Sevilla;039;Écija;37292;18383;18909
41;Sevilla;040;Espartinas;4160;2112;2048
41;Sevilla;041;Estepa;11560;5708;5852
41;Sevilla;042;Fuentes de Andalucía;7470;3701;3769
41;Sevilla;043;Garrobo (El);761;379;382
41;Sevilla;044;Gelves;5084;2496;2588
41;Sevilla;045;Gerena;5405;2713;2692
41;Sevilla;046;Gilena;3840;1948;1892
41;Sevilla;047;Gines;8634;4249;4385
41;Sevilla;048;Guadalcanal;3095;1530;1565
41;Sevilla;049;Guillena;8281;4194;4087
41;Sevilla;050;Herrera;5925;2923;3002
41;Sevilla;051;Huévar del Aljarafe;2308;1185;1123
41;Sevilla;052;Lantejuela (La);3356;1715;1641
41;Sevilla;053;Lebrija;23833;12056;11777
41;Sevilla;054;Lora de Estepa;741;367;374
41;Sevilla;055;Lora del Río;18895;9319;9576
41;Sevilla;056;Luisiana (La);4331;2219;2112
41;Sevilla;057;Madroño (El);402;205;197
41;Sevilla;058;Mairena del Alcor;16071;7999;8072
41;Sevilla;059;Mairena del Aljarafe;30659;15384;15275
41;Sevilla;060;Marchena;17921;8838;9083
41;Sevilla;061;Marinaleda;2622;1301;1321
41;Sevilla;062;Martín de la Jara;2819;1489;1330
41;Sevilla;063;Molares (Los);2659;1343;1316
41;Sevilla;064;Montellano;7064;3558;3506
41;Sevilla;065;Morón de la Frontera;28303;14084;14219
41;Sevilla;066;Navas de la Concepción (Las);1926;960;966
41;Sevilla;067;Olivares;7604;3847;3757
41;Sevilla;068;Osuna;17212;8519;8693
41;Sevilla;069;Palacios y Villafranca (Los);31718;16077;15641
41;Sevilla;070;Palomares del Río;3448;1744;1704
41;Sevilla;071;Paradas;7014;3527;3487
41;Sevilla;072;Pedrera;5025;2520;2505
41;Sevilla;073;Pedroso (El);2403;1177;1226
41;Sevilla;074;Peñaflor;3930;1994;1936
41;Sevilla;075;Pilas;11122;5491;5631
41;Sevilla;076;Pruna;3475;1781;1694
41;Sevilla;077;Puebla de Cazalla (La);10825;5444;5381
41;Sevilla;078;Puebla de los Infantes (La);3591;1816;1775
41;Sevilla;079;Puebla del Río (La);10650;5291;5359
41;Sevilla;080;Real de la Jara (El);1761;861;900
41;Sevilla;081;Rinconada (La);26059;13125;12934
41;Sevilla;082;Roda de Andalucía (La);4175;2071;2104
41;Sevilla;083;Ronquillo (El);1419;712;707
41;Sevilla;084;Rubio (El);3702;1856;1846
41;Sevilla;085;Salteras;2875;1429;1446
41;Sevilla;086;San Juan de Aznalfarache;21484;10422;11062
41;Sevilla;088;San Nicolás del Puerto;726;377;349
41;Sevilla;087;Sanlúcar la Mayor;10412;5167;5245
41;Sevilla;089;Santiponce;6770;3400;3370
41;Sevilla;090;Saucejo (El);4163;2098;2065
41;Sevilla;091;Sevilla;697487;333469;364018
41;Sevilla;092;Tocina;8660;4326;4334
41;Sevilla;093;Tomares;16980;8393;8587
41;Sevilla;094;Umbrete;4709;2362;2347
41;Sevilla;095;Utrera;46173;23099;23074
41;Sevilla;096;Valencina de la Concepción;5922;3001;2921
41;Sevilla;902;Villafranco del Guadalquivir;6022;3015;3007
41;Sevilla;097;Villamanrique de la Condesa;3764;1852;1912
41;Sevilla;100;Villanueva de San Juan;1610;802;808
41;Sevilla;098;Villanueva del Ariscal;4432;2131;2301
41;Sevilla;099;Villanueva del Río y Minas;5953;2873;3080
41;Sevilla;101;Villaverde del Río;6669;3382;3287
41;Sevilla;102;Viso del Alcor (El);15886;8042;7844
42;Soria;001;Abejar;359;183;176
42;Soria;003;Adradas;110;58;52
42;Soria;004;Ágreda;3521;1721;1800
42;Soria;006;Alconaba;175;102;73
42;Soria;007;Alcubilla de Avellaneda;238;123;115
42;Soria;008;Alcubilla de las Peñas;100;51;49
42;Soria;009;Aldealafuente;170;82;88
42;Soria;010;Aldealices;35;17;18
42;Soria;011;Aldealpozo;32;15;17
42;Soria;012;Aldealseñor;49;29;20
42;Soria;013;Aldehuela de Periáñez;47;25;22
42;Soria;014;Aldehuelas (Las);133;74;59
42;Soria;015;Alentisque;51;21;30
42;Soria;016;Aliud;45;19;26
42;Soria;017;Almajano;196;97;99
42;Soria;018;Almaluez;329;166;163
42;Soria;019;Almarza;641;348;293
42;Soria;020;Almazán;5877;2925;2952
42;Soria;021;Almazul;183;99;84
42;Soria;022;Almenar de Soria;423;219;204
42;Soria;023;Alpanseque;119;60;59
42;Soria;024;Arancón;115;63;52
42;Soria;025;Arcos de Jalón;2042;1012;1030
42;Soria;026;Arenillas;55;30;25
42;Soria;027;Arévalo de la Sierra;120;62;58
42;Soria;028;Ausejo de la Sierra;55;28;27
42;Soria;029;Baraona;261;140;121
42;Soria;030;Barca;156;83;73
42;Soria;031;Barcones;55;28;27
42;Soria;032;Bayubas de Abajo;291;150;141
42;Soria;033;Bayubas de Arriba;98;50;48
42;Soria;034;Beratón;40;33;7
42;Soria;035;Berlanga de Duero;1238;637;601
42;Soria;036;Blacos;65;37;28
42;Soria;037;Bliecos;66;33;33
42;Soria;038;Borjabad;70;38;32
42;Soria;039;Borobia;406;197;209
42;Soria;041;Buberos;54;24;30
42;Soria;042;Buitrago;49;24;25
42;Soria;043;Burgo de Osma-Ciudad de Osma;5053;2495;2558
42;Soria;044;Cabrejas del Campo;99;53;46
42;Soria;045;Cabrejas del Pinar;495;260;235
42;Soria;046;Calatañazor;76;39;37
42;Soria;048;Caltojar;144;75;69
42;Soria;049;Candilichera;243;125;118
42;Soria;050;Cañamaque;46;26;20
42;Soria;051;Carabantes;42;23;19
42;Soria;052;Caracena;19;12;7
42;Soria;053;Carrascosa de Abajo;47;25;22
42;Soria;054;Carrascosa de la Sierra;16;8;8
42;Soria;055;Casarejos;284;143;141
42;Soria;056;Castilfrío de la Sierra;39;23;16
42;Soria;058;Castillejo de Robledo;228;119;109
42;Soria;057;Castilruiz;356;181;175
42;Soria;059;Centenera de Andaluz;36;15;21
42;Soria;060;Cerbón;53;29;24
42;Soria;061;Cidones;340;182;158
42;Soria;062;Cigudosa;87;49;38
42;Soria;063;Cihuela;111;66;45
42;Soria;064;Ciria;102;48;54
42;Soria;065;Cirujales del Río;45;24;21
42;Soria;068;Coscurita;163;93;70
42;Soria;069;Covaleda;2053;1058;995
42;Soria;070;Cubilla;89;45;44
42;Soria;071;Cubo de la Solana;280;154;126
42;Soria;073;Cueva de Ágreda;112;59;53
42;Soria;075;Dévanos;152;83;69
42;Soria;076;Deza;393;203;190
42;Soria;078;Duruelo de la Sierra;1493;754;739
42;Soria;079;Escobosa de Almazán;47;28;19
42;Soria;080;Espeja de San Marcelino;279;156;123
42;Soria;081;Espejón;241;124;117
42;Soria;082;Estepa de San Juan;16;8;8
42;Soria;083;Frechilla de Almazán;53;26;27
42;Soria;084;Fresno de Caracena;58;32;26
42;Soria;085;Fuentearmegil;375;200;175
42;Soria;086;Fuentecambrón;82;45;37
42;Soria;087;Fuentecantos;53;27;26
42;Soria;088;Fuentelmonge;150;76;74
42;Soria;089;Fuentelsaz de Soria;62;33;29
42;Soria;090;Fuentepinilla;174;95;79
42;Soria;092;Fuentes de Magaña;107;50;57
42;Soria;093;Fuentestrún;74;43;31
42;Soria;094;Garray;336;174;162
42;Soria;095;Golmayo;595;330;265
42;Soria;096;Gómara;546;269;277
42;Soria;097;Gormaz;24;12;12
42;Soria;098;Herrera de Soria;28;17;11
42;Soria;100;Hinojosa del Campo;57;33;24
42;Soria;103;Langa de Duero;988;523;465
42;Soria;105;Liceras;69;35;34
42;Soria;106;Losilla (La);20;12;8
42;Soria;107;Magaña;110;55;55
42;Soria;108;Maján;20;10;10
42;Soria;110;Matalebreras;135;67;68
42;Soria;111;Matamala de Almazán;434;224;210
42;Soria;113;Medinaceli;733;373;360
42;Soria;115;Miño de Medinaceli;125;61;64
42;Soria;116;Miño de San Esteban;101;56;45
42;Soria;117;Molinos de Duero;200;105;95
42;Soria;118;Momblona;47;25;22
42;Soria;119;Monteagudo de las Vicarías;326;152;174
42;Soria;120;Montejo de Tiermes;254;144;110
42;Soria;121;Montenegro de Cameros;124;67;57
42;Soria;123;Morón de Almazán;293;140;153
42;Soria;124;Muriel de la Fuente;83;43;40
42;Soria;125;Muriel Viejo;92;48;44
42;Soria;127;Nafría de Ucero;92;49;43
42;Soria;128;Narros;61;28;33
42;Soria;129;Navaleno;937;471;466
42;Soria;130;Nepas;94;54;40
42;Soria;131;Nolay;101;55;46
42;Soria;132;Noviercas;258;119;139
42;Soria;134;Ólvega;3293;1702;1591
42;Soria;135;Oncala;117;67;50
42;Soria;139;Pinilla del Campo;26;15;11
42;Soria;140;Portillo de Soria;24;13;11
42;Soria;141;Póveda de Soria (La);126;64;62
42;Soria;142;Pozalmuro;101;50;51
42;Soria;144;Quintana Redonda;613;321;292
42;Soria;145;Quintanas de Gormaz;199;98;101
42;Soria;148;Quiñonería;15;5;10
42;Soria;149;Rábanos (Los);435;259;176
42;Soria;151;Rebollar;47;28;19
42;Soria;152;Recuerda;125;65;60
42;Soria;153;Rello;50;23;27
42;Soria;154;Renieblas;130;69;61
42;Soria;155;Retortillo de Soria;267;141;126
42;Soria;156;Reznos;55;30;25
42;Soria;157;Riba de Escalote (La);34;20;14
42;Soria;158;Rioseco de Soria;161;83;78
42;Soria;159;Rollamienta;51;28;23
42;Soria;160;Royo (El);374;177;197
42;Soria;161;Salduero;193;99;94
42;Soria;162;San Esteban de Gormaz;3426;1760;1666
42;Soria;163;San Felices;78;42;36
42;Soria;164;San Leonardo de Yagüe;2104;1066;1038
42;Soria;165;San Pedro Manrique;501;252;249
42;Soria;166;Santa Cruz de Yanguas;65;40;25
42;Soria;167;Santa María de Huerta;496;252;244
42;Soria;168;Santa María de las Hoyas;208;112;96
42;Soria;171;Serón de Nágima;319;162;157
42;Soria;172;Soliedra;45;27;18
42;Soria;173;Soria;33597;16004;17593
42;Soria;174;Sotillo del Rincón;214;105;109
42;Soria;175;Suellacabras;51;29;22
42;Soria;176;Tajahuerce;51;25;26
42;Soria;177;Tajueco;139;73;66
42;Soria;178;Talveila;222;115;107
42;Soria;181;Tardelcuende;708;351;357
42;Soria;182;Taroda;89;44;45
42;Soria;183;Tejado;262;129;133
42;Soria;184;Torlengua;122;60;62
42;Soria;185;Torreblacos;43;21;22
42;Soria;187;Torrubia de Soria;104;58;46
42;Soria;188;Trévago;85;38;47
42;Soria;189;Ucero;115;59;56
42;Soria;190;Vadillo;161;86;75
42;Soria;191;Valdeavellano de Tera;235;123;112
42;Soria;192;Valdegeña;53;27;26
42;Soria;193;Valdelagua del Cerro;34;16;18
42;Soria;194;Valdemaluque;316;153;163
42;Soria;195;Valdenebro;170;89;81
42;Soria;196;Valdeprado;18;7;11
42;Soria;197;Valderrodilla;139;67;72
42;Soria;198;Valtajeros;31;17;14
42;Soria;200;Velamazán;154;89;65
42;Soria;201;Velilla de la Sierra;24;11;13
42;Soria;202;Velilla de los Ajos;45;28;17
42;Soria;204;Viana de Duero;83;47;36
42;Soria;205;Villaciervos;101;54;47
42;Soria;206;Villanueva de Gormaz;23;13;10
42;Soria;207;Villar del Ala;58;28;30
42;Soria;208;Villar del Campo;41;22;19
42;Soria;209;Villar del Río;208;117;91
42;Soria;211;Villares de Soria (Los);129;65;64
42;Soria;212;Villasayas;112;69;43
42;Soria;213;Villaseca de Arciel;50;27;23
42;Soria;215;Vinuesa;1105;581;524
42;Soria;216;Vizmanos;45;28;17
42;Soria;217;Vozmediano;57;31;26
42;Soria;218;Yanguas;84;41;43
42;Soria;219;Yelo;73;38;35
43;Tarragona;001;Aiguamúrcia;614;310;304
43;Tarragona;002;Albinyana;1077;553;524
43;Tarragona;003;Albiol (L');144;74;70
43;Tarragona;004;Alcanar;7727;3796;3931
43;Tarragona;005;Alcover;3523;1798;1725
43;Tarragona;904;Aldea (L');3563;1802;1761
43;Tarragona;006;Aldover;794;376;418
43;Tarragona;007;Aleixar (L');633;312;321
43;Tarragona;008;Alfara de Carles;383;202;181
43;Tarragona;009;Alforja;1179;597;582
43;Tarragona;010;Alió;339;164;175
43;Tarragona;011;Almoster;679;338;341
43;Tarragona;012;Altafulla;2555;1302;1253
43;Tarragona;013;Ametlla de Mar (L');4341;2155;2186
43;Tarragona;906;Ampolla (L');1667;818;849
43;Tarragona;014;Amposta;15900;7864;8036
43;Tarragona;016;Arboç (L');3362;1718;1644
43;Tarragona;015;Arbolí;131;64;67
43;Tarragona;017;Argentera (L');149;83;66
43;Tarragona;018;Arnes;535;275;260
43;Tarragona;019;Ascó;1714;860;854
43;Tarragona;020;Banyeres del Penedès;1524;783;741
43;Tarragona;021;Barberà de la Conca;401;201;200
43;Tarragona;022;Batea;1985;1004;981
43;Tarragona;023;Bellmunt del Priorat;303;147;156
43;Tarragona;024;Bellvei;1241;659;582
43;Tarragona;025;Benifallet;896;450;446
43;Tarragona;026;Benissanet;1020;510;510
43;Tarragona;027;Bisbal de Falset (La);245;122;123
43;Tarragona;028;Bisbal del Penedès (La);1628;834;794
43;Tarragona;029;Blancafort;395;197;198
43;Tarragona;030;Bonastre;303;157;146
43;Tarragona;031;Borges del Camp (Les);1471;738;733
43;Tarragona;032;Bot;858;437;421
43;Tarragona;033;Botarell;510;258;252
43;Tarragona;034;Bràfim;569;276;293
43;Tarragona;035;Cabacés;340;175;165
43;Tarragona;036;Cabra del Camp;483;263;220
43;Tarragona;037;Calafell;9772;4912;4860
43;Tarragona;903;Camarles;2953;1485;1468
43;Tarragona;038;Cambrils;17536;8709;8827
43;Tarragona;039;Capafonts;105;55;50
43;Tarragona;040;Capçanes;409;184;225
43;Tarragona;041;Caseres;333;164;169
43;Tarragona;042;Castellvell del Camp;1069;541;528
43;Tarragona;043;Catllar (El);1828;952;876
43;Tarragona;045;Colldejou;196;108;88
43;Tarragona;046;Conesa;104;51;53
43;Tarragona;047;Constantí;5154;2685;2469
43;Tarragona;048;Corbera d'Ebre;1064;546;518
43;Tarragona;049;Cornudella de Montsant;881;439;442
43;Tarragona;050;Creixell;1400;711;689
43;Tarragona;051;Cunit;4246;2177;2069
43;Tarragona;901;Deltebre;10157;5102;5055
43;Tarragona;053;Duesaigües;210;128;82
43;Tarragona;054;Espluga de Francolí (L');3671;1792;1879
43;Tarragona;055;Falset;2504;1267;1237
43;Tarragona;056;Fatarella (La);1301;654;647
43;Tarragona;057;Febró (La);55;30;25
43;Tarragona;058;Figuera (La);123;64;59
43;Tarragona;059;Figuerola del Camp;226;113;113
43;Tarragona;060;Flix;4372;2181;2191
43;Tarragona;061;Forès;72;34;38
43;Tarragona;062;Freginals;341;168;173
43;Tarragona;063;Galera (La);748;371;377
43;Tarragona;064;Gandesa;2668;1325;1343
43;Tarragona;065;Garcia;551;273;278
43;Tarragona;066;Garidells (Els);162;82;80
43;Tarragona;067;Ginestar;835;424;411
43;Tarragona;068;Godall;751;382;369
43;Tarragona;069;Gratallops;221;111;110
43;Tarragona;070;Guiamets (Els);302;146;156
43;Tarragona;071;Horta de Sant Joan;1272;658;614
43;Tarragona;072;Lloar (El);133;67;66
43;Tarragona;073;Llorac;122;57;65
43;Tarragona;074;Llorenç del Penedès;1434;696;738
43;Tarragona;076;Marçà;611;292;319
43;Tarragona;075;Margalef;132;69;63
43;Tarragona;077;Mas de Barberans;726;369;357
43;Tarragona;078;Masdenverge;912;460;452
43;Tarragona;079;Masllorenç;419;208;211
43;Tarragona;080;Masó (La);258;127;131
43;Tarragona;081;Maspujols;414;211;203
43;Tarragona;082;Masroig (El);524;251;273
43;Tarragona;083;Milà (El);156;73;83
43;Tarragona;084;Miravet;810;411;399
43;Tarragona;085;Molar (El);280;148;132
43;Tarragona;086;Montblanc;5892;2939;2953
43;Tarragona;088;Montbrió del Camp;1413;697;716
43;Tarragona;089;Montferri;158;79;79
43;Tarragona;090;Montmell (El);419;229;190
43;Tarragona;091;Mont-ral;145;74;71
43;Tarragona;092;Mont-roig del Camp;6064;3077;2987
43;Tarragona;093;Móra d'Ebre;4880;2384;2496
43;Tarragona;094;Móra la Nova;2683;1335;1348
43;Tarragona;095;Morell (El);2338;1166;1172
43;Tarragona;096;Morera de Montsant (La);184;100;84
43;Tarragona;097;Nou de Gaià (La);380;185;195
43;Tarragona;098;Nulles;341;159;182
43;Tarragona;100;Pallaresos (Els);2179;1133;1046
43;Tarragona;099;Palma d'Ebre (La);421;199;222
43;Tarragona;101;Passanant;192;115;77
43;Tarragona;102;Paüls;651;335;316
43;Tarragona;103;Perafort;515;265;250
43;Tarragona;104;Perelló (El);2152;1086;1066
43;Tarragona;105;Piles (Les);162;91;71
43;Tarragona;106;Pinell de Brai (El);1125;575;550
43;Tarragona;107;Pira;364;175;189
43;Tarragona;108;Pla de Santa Maria (El);1627;834;793
43;Tarragona;109;Pobla de Mafumet (La);1018;508;510
43;Tarragona;110;Pobla de Massaluca (La);445;227;218
43;Tarragona;111;Pobla de Montornès (La);1115;592;523
43;Tarragona;112;Poboleda;336;172;164
43;Tarragona;113;Pont d'Armentera (El);582;294;288
43;Tarragona;141;Pontils;136;66;70
43;Tarragona;114;Porrera;444;228;216
43;Tarragona;115;Pradell de la Teixeta;232;124;108
43;Tarragona;116;Prades;510;260;250
43;Tarragona;117;Prat de Comte;202;96;106
43;Tarragona;118;Pratdip;452;223;229
43;Tarragona;119;Puigpelat;486;242;244
43;Tarragona;120;Querol;238;131;107
43;Tarragona;121;Rasquera;865;433;432
43;Tarragona;122;Renau;54;29;25
43;Tarragona;123;Reus;90993;44545;46448
43;Tarragona;124;Riba (La);820;422;398
43;Tarragona;125;Riba-roja d'Ebre;1472;754;718
43;Tarragona;126;Riera de Gaià (La);902;453;449
43;Tarragona;127;Riudecanyes;596;298;298
43;Tarragona;128;Riudecols;992;509;483
43;Tarragona;129;Riudoms;5006;2500;2506
43;Tarragona;130;Rocafort de Queralt;254;136;118
43;Tarragona;131;Roda de Barà;2851;1528;1323
43;Tarragona;132;Rodonyà;384;196;188
43;Tarragona;133;Roquetes;6057;3014;3043
43;Tarragona;134;Rourell (El);255;140;115
43;Tarragona;135;Salomó;384;197;187
43;Tarragona;905;Salou;10708;5421;5287
43;Tarragona;136;Sant Carles de la Ràpita;10828;5351;5477
43;Tarragona;137;Sant Jaume dels Domenys;1287;653;634
43;Tarragona;902;Sant Jaume d'Enveja;3352;1689;1663
43;Tarragona;138;Santa Bàrbara;3283;1634;1649
43;Tarragona;139;Santa Coloma de Queralt;2518;1217;1301
43;Tarragona;140;Santa Oliva;1828;922;906
43;Tarragona;142;Sarral;1413;723;690
43;Tarragona;143;Savallà del Comtat;74;35;39
43;Tarragona;144;Secuita (La);1069;536;533
43;Tarragona;145;Selva del Camp (La);3767;1898;1869
43;Tarragona;146;Senan;36;22;14
43;Tarragona;044;Sénia (La);5045;2549;2496
43;Tarragona;147;Solivella;658;315;343
43;Tarragona;148;Tarragona;112176;54712;57464
43;Tarragona;149;Tivenys;961;478;483
43;Tarragona;150;Tivissa;1726;859;867
43;Tarragona;151;Torre de Fontaubella (La);83;37;46
43;Tarragona;152;Torre de l'Espanyol (La);649;335;314
43;Tarragona;153;Torredembarra;8907;4370;4537
43;Tarragona;154;Torroja del Priorat;129;72;57
43;Tarragona;155;Tortosa;30088;14543;15545
43;Tarragona;156;Ulldecona;5152;2530;2622
43;Tarragona;157;Ulldemolins;494;255;239
43;Tarragona;158;Vallclara;112;55;57
43;Tarragona;159;Vallfogona de Riucorb;130;75;55
43;Tarragona;160;Vallmoll;1012;520;492
43;Tarragona;161;Valls;20206;9883;10323
43;Tarragona;162;Vandellòs i l'Hospitalet de l'Infant;4253;2114;2139
43;Tarragona;163;Vendrell (El);19010;9496;9514
43;Tarragona;164;Vespella de Gaià;148;84;64
43;Tarragona;165;Vilabella;814;402;412
43;Tarragona;175;Vilalba dels Arcs;796;420;376
43;Tarragona;166;Vilallonga del Camp;1211;610;601
43;Tarragona;168;Vilanova de Prades;157;85;72
43;Tarragona;167;Vilanova d'Escornalbou;462;235;227
43;Tarragona;169;Vilaplana;523;270;253
43;Tarragona;170;Vila-rodona;1005;541;464
43;Tarragona;171;Vila-seca;12124;6064;6060
43;Tarragona;172;Vilaverd;361;184;177
43;Tarragona;173;Vilella Alta (La);133;68;65
43;Tarragona;174;Vilella Baixa (La);169;87;82
43;Tarragona;176;Vimbodí i Poblet;1061;547;514
43;Tarragona;177;Vinebre;444;214;230
43;Tarragona;178;Vinyols i els Arcs;1028;545;483
43;Tarragona;052;Xerta;1216;591;625
44;Teruel;001;Ababuj;85;50;35
44;Teruel;002;Abejuela;70;39;31
44;Teruel;003;Aguatón;26;11;15
44;Teruel;004;Aguaviva;641;321;320
44;Teruel;005;Aguilar del Alfambra;88;42;46
44;Teruel;006;Alacón;481;250;231
44;Teruel;007;Alba;294;150;144
44;Teruel;008;Albalate del Arzobispo;2434;1197;1237
44;Teruel;009;Albarracín;1061;534;527
44;Teruel;010;Albentosa;268;134;134
44;Teruel;011;Alcaine;61;33;28
44;Teruel;012;Alcalá de la Selva;442;228;214
44;Teruel;013;Alcañiz;12679;6238;6441
44;Teruel;014;Alcorisa;3316;1681;1635
44;Teruel;016;Alfambra;705;345;360
44;Teruel;017;Aliaga;440;233;207
44;Teruel;021;Allepuz;146;75;71
44;Teruel;022;Alloza;831;405;426
44;Teruel;023;Allueva;19;8;11
44;Teruel;018;Almohaja;35;21;14
44;Teruel;019;Alobras;94;52;42
44;Teruel;020;Alpeñés;32;19;13
44;Teruel;024;Anadón;23;12;11
44;Teruel;025;Andorra;8282;4259;4023
44;Teruel;026;Arcos de las Salinas;178;89;89
44;Teruel;027;Arens de Lledó;243;115;128
44;Teruel;028;Argente;276;137;139
44;Teruel;029;Ariño;930;461;469
44;Teruel;031;Azaila;192;105;87
44;Teruel;032;Bádenas;25;12;13
44;Teruel;033;Báguena;558;286;272
44;Teruel;034;Bañón;188;99;89
44;Teruel;035;Barrachina;176;88;88
44;Teruel;036;Bea;46;25;21
44;Teruel;037;Beceite;693;358;335
44;Teruel;039;Bello;411;191;220
44;Teruel;038;Belmonte de San José;151;80;71
44;Teruel;040;Berge;237;123;114
44;Teruel;041;Bezas;72;37;35
44;Teruel;042;Blancas;203;105;98
44;Teruel;043;Blesa;159;93;66
44;Teruel;044;Bordón;139;78;61
44;Teruel;045;Bronchales;447;240;207
44;Teruel;046;Bueña;110;61;49
44;Teruel;047;Burbáguena;356;157;199
44;Teruel;048;Cabra de Mora;97;54;43
44;Teruel;049;Calaceite;1238;631;607
44;Teruel;050;Calamocha;4019;1997;2022
44;Teruel;051;Calanda;3596;1816;1780
44;Teruel;052;Calomarde;90;42;48
44;Teruel;053;Camañas;144;80;64
44;Teruel;054;Camarena de la Sierra;167;90;77
44;Teruel;055;Camarillas;131;71;60
44;Teruel;056;Caminreal;832;411;421
44;Teruel;059;Cantavieja;739;389;350
44;Teruel;060;Cañada de Benatanduz;69;43;26
44;Teruel;061;Cañada de Verich (La);106;58;48
44;Teruel;062;Cañada Vellida;63;41;22
44;Teruel;063;Cañizar del Olivar;129;69;60
44;Teruel;064;Cascante del Río;126;73;53
44;Teruel;065;Castejón de Tornos;109;57;52
44;Teruel;066;Castel de Cabra;192;100;92
44;Teruel;070;Castellar (El);95;51;44
44;Teruel;071;Castellote;735;371;364
44;Teruel;067;Castelnou;106;55;51
44;Teruel;068;Castelserás;873;463;410
44;Teruel;074;Cedrillas;552;282;270
44;Teruel;075;Celadas;433;232;201
44;Teruel;076;Cella;3030;1538;1492
44;Teruel;077;Cerollera (La);87;47;40
44;Teruel;080;Codoñera (La);358;182;176
44;Teruel;082;Corbalán;75;42;33
44;Teruel;084;Cortes de Aragón;143;70;73
44;Teruel;085;Cosa;106;57;49
44;Teruel;086;Cretas;638;326;312
44;Teruel;087;Crivillén;138;70;68
44;Teruel;088;Cuba (La);70;36;34
44;Teruel;089;Cubla;60;32;28
44;Teruel;090;Cucalón;83;44;39
44;Teruel;092;Cuervo (El);138;70;68
44;Teruel;093;Cuevas de Almudén;111;62;49
44;Teruel;094;Cuevas Labradas;180;95;85
44;Teruel;096;Ejulve;236;117;119
44;Teruel;097;Escorihuela;240;118;122
44;Teruel;099;Escucha;1179;621;558
44;Teruel;100;Estercuel;386;190;196
44;Teruel;101;Ferreruela de Huerva;87;47;40
44;Teruel;102;Fonfría;33;19;14
44;Teruel;103;Formiche Alto;201;109;92
44;Teruel;105;Fórnoles;108;51;57
44;Teruel;106;Fortanete;195;98;97
44;Teruel;107;Foz-Calanda;255;140;115
44;Teruel;108;Fresneda (La);435;227;208
44;Teruel;109;Frías de Albarracín;180;93;87
44;Teruel;110;Fuenferrada;49;26;23
44;Teruel;111;Fuentes Calientes;143;77;66
44;Teruel;112;Fuentes Claras;689;343;346
44;Teruel;113;Fuentes de Rubielos;83;47;36
44;Teruel;114;Fuentespalda;379;188;191
44;Teruel;115;Galve;144;76;68
44;Teruel;116;Gargallo;128;67;61
44;Teruel;117;Gea de Albarracín;503;263;240
44;Teruel;118;Ginebrosa (La);275;153;122
44;Teruel;119;Griegos;155;91;64
44;Teruel;120;Guadalaviar;297;150;147
44;Teruel;121;Gúdar;83;49;34
44;Teruel;122;Híjar;1974;985;989
44;Teruel;123;Hinojosa de Jarque;186;102;84
44;Teruel;124;Hoz de la Vieja (La);139;76;63
44;Teruel;125;Huesa del Común;138;76;62
44;Teruel;126;Iglesuela del Cid (La);502;261;241
44;Teruel;127;Jabaloyas;101;56;45
44;Teruel;128;Jarque de la Val;106;59;47
44;Teruel;129;Jatiel;72;36;36
44;Teruel;130;Jorcas;54;34;20
44;Teruel;131;Josa;47;26;21
44;Teruel;132;Lagueruela;73;37;36
44;Teruel;133;Lanzuela;32;21;11
44;Teruel;135;Libros;182;94;88
44;Teruel;136;Lidón;85;40;45
44;Teruel;137;Linares de Mora;317;174;143
44;Teruel;141;Lledó;217;112;105
44;Teruel;138;Loscos;223;124;99
44;Teruel;142;Maicas;25;15;10
44;Teruel;143;Manzanera;487;262;225
44;Teruel;144;Martín del Río;518;270;248
44;Teruel;145;Mas de las Matas;1483;751;732
44;Teruel;146;Mata de los Olmos (La);281;134;147
44;Teruel;147;Mazaleón;608;312;296
44;Teruel;148;Mezquita de Jarque;144;73;71
44;Teruel;149;Mirambel;144;79;65
44;Teruel;150;Miravete de la Sierra;50;30;20
44;Teruel;151;Molinos;359;184;175
44;Teruel;152;Monforte de Moyuela;85;50;35
44;Teruel;153;Monreal del Campo;2305;1155;1150
44;Teruel;154;Monroyo;393;204;189
44;Teruel;155;Montalbán;1668;842;826
44;Teruel;156;Monteagudo del Castillo;68;39;29
44;Teruel;157;Monterde de Albarracín;76;33;43
44;Teruel;158;Mora de Rubielos;1346;698;648
44;Teruel;159;Moscardón;48;24;24
44;Teruel;160;Mosqueruela;719;367;352
44;Teruel;161;Muniesa;756;392;364
44;Teruel;163;Noguera de Albarracín;183;92;91
44;Teruel;164;Nogueras;23;16;7
44;Teruel;165;Nogueruelas;224;116;108
44;Teruel;167;Obón;60;29;31
44;Teruel;168;Odón;271;128;143
44;Teruel;169;Ojos Negros;611;314;297
44;Teruel;171;Olba;220;113;107
44;Teruel;172;Oliete;499;251;248
44;Teruel;173;Olmos (Los);154;86;68
44;Teruel;174;Orihuela del Tremedal;620;312;308
44;Teruel;175;Orrios;209;111;98
44;Teruel;176;Palomar de Arroyos;274;152;122
44;Teruel;177;Pancrudo;202;112;90
44;Teruel;178;Parras de Castellote (Las);109;59;50
44;Teruel;179;Peñarroya de Tastavins;552;285;267
44;Teruel;180;Peracense;118;61;57
44;Teruel;181;Peralejos;101;53;48
44;Teruel;182;Perales del Alfambra;294;160;134
44;Teruel;183;Pitarque;114;56;58
44;Teruel;184;Plou;54;27;27
44;Teruel;185;Pobo (El);155;87;68
44;Teruel;187;Portellada (La);342;176;166
44;Teruel;189;Pozondón;88;49;39
44;Teruel;190;Pozuel del Campo;116;62;54
44;Teruel;191;Puebla de Híjar (La);1145;558;587
44;Teruel;192;Puebla de Valverde (La);476;253;223
44;Teruel;193;Puertomingalvo;136;73;63
44;Teruel;194;Ráfales;225;118;107
44;Teruel;195;Rillo;151;83;68
44;Teruel;196;Riodeva;245;118;127
44;Teruel;197;Ródenas;98;47;51
44;Teruel;198;Royuela;238;133;105
44;Teruel;199;Rubiales;64;37;27
44;Teruel;200;Rubielos de la Cérida;61;30;31
44;Teruel;201;Rubielos de Mora;620;306;314
44;Teruel;203;Salcedillo;9;5;4
44;Teruel;204;Saldón;47;28;19
44;Teruel;205;Samper de Calanda;1032;490;542
44;Teruel;206;San Agustín;156;77;79
44;Teruel;207;San Martín del Río;312;151;161
44;Teruel;208;Santa Cruz de Nogueras;28;16;12
44;Teruel;209;Santa Eulalia;1283;618;665
44;Teruel;210;Sarrión;1026;544;482
44;Teruel;211;Segura de los Baños;56;30;26
44;Teruel;212;Seno;56;28;28
44;Teruel;213;Singra;98;48;50
44;Teruel;215;Terriente;186;108;78
44;Teruel;216;Teruel;28994;13968;15026
44;Teruel;217;Toril y Masegoso;37;22;15
44;Teruel;218;Tormón;43;21;22
44;Teruel;219;Tornos;271;141;130
44;Teruel;220;Torralba de los Sisones;229;115;114
44;Teruel;223;Torre de Arcas;117;56;61
44;Teruel;224;Torre de las Arcas;40;25;15
44;Teruel;225;Torre del Compte;189;91;98
44;Teruel;227;Torre los Negros;98;47;51
44;Teruel;221;Torrecilla de Alcañiz;453;239;214
44;Teruel;222;Torrecilla del Rebollar;170;91;79
44;Teruel;226;Torrelacárcel;313;160;153
44;Teruel;228;Torremocha de Jiloca;182;88;94
44;Teruel;229;Torres de Albarracín;162;82;80
44;Teruel;230;Torrevelilla;207;102;105
44;Teruel;231;Torrijas;85;45;40
44;Teruel;232;Torrijo del Campo;592;300;292
44;Teruel;234;Tramacastiel;120;58;62
44;Teruel;235;Tramacastilla;143;68;75
44;Teruel;236;Tronchón;92;47;45
44;Teruel;237;Urrea de Gaén;633;310;323
44;Teruel;238;Utrillas;3343;1719;1624
44;Teruel;239;Valacloche;21;13;8
44;Teruel;240;Valbona;195;102;93
44;Teruel;241;Valdealgorfa;780;386;394
44;Teruel;243;Valdecuenca;37;21;16
44;Teruel;244;Valdelinares;126;73;53
44;Teruel;245;Valdeltormo;396;204;192
44;Teruel;246;Valderrobres;1935;990;945
44;Teruel;247;Valjunquera;460;233;227
44;Teruel;249;Vallecillo (El);40;24;16
44;Teruel;250;Veguillas de la Sierra;31;17;14
44;Teruel;251;Villafranca del Campo;404;207;197
44;Teruel;252;Villahermosa del Campo;68;39;29
44;Teruel;256;Villanueva del Rebollar de la Sierra;47;26;21
44;Teruel;257;Villar del Cobo;235;114;121
44;Teruel;258;Villar del Salz;115;58;57
44;Teruel;260;Villarluengo;205;111;94
44;Teruel;261;Villarquemado;1005;504;501
44;Teruel;262;Villarroya de los Pinares;214;106;108
44;Teruel;263;Villastar;345;184;161
44;Teruel;264;Villel;345;170;175
44;Teruel;265;Vinaceite;306;158;148
44;Teruel;266;Visiedo;228;103;125
44;Teruel;267;Vivel del Río Martín;110;57;53
44;Teruel;268;Zoma (La);34;18;16
45;Toledo;001;Ajofrín;2162;1100;1062
45;Toledo;002;Alameda de la Sagra;2797;1468;1329
45;Toledo;003;Albarreal de Tajo;594;293;301
45;Toledo;004;Alcabón;573;295;278
45;Toledo;005;Alcañizo;351;181;170
45;Toledo;006;Alcaudete de la Jara;1684;774;910
45;Toledo;007;Alcolea de Tajo;804;401;403
45;Toledo;008;Aldea en Cabo;193;102;91
45;Toledo;009;Aldeanueva de Barbarroya;872;445;427
45;Toledo;010;Aldeanueva de San Bartolomé;650;320;330
45;Toledo;011;Almendral de la Cañada;399;208;191
45;Toledo;012;Almonacid de Toledo;786;404;382
45;Toledo;013;Almorox;2219;1122;1097
45;Toledo;014;Añover de Tajo;4620;2405;2215
45;Toledo;015;Arcicóllar;575;276;299
45;Toledo;016;Argés;2242;1117;1125
45;Toledo;017;Azután;365;185;180
45;Toledo;018;Barcience;110;57;53
45;Toledo;019;Bargas;6608;3317;3291
45;Toledo;020;Belvís de la Jara;1808;883;925
45;Toledo;021;Borox;2132;1062;1070
45;Toledo;022;Buenaventura;553;268;285
45;Toledo;023;Burguillos de Toledo;788;394;394
45;Toledo;024;Burujón;1285;661;624
45;Toledo;025;Cabañas de la Sagra;1077;551;526
45;Toledo;026;Cabañas de Yepes;264;137;127
45;Toledo;027;Cabezamesada;527;271;256
45;Toledo;028;Calera y Chozas;3750;1892;1858
45;Toledo;029;Caleruela;326;163;163
45;Toledo;030;Calzada de Oropesa;629;310;319
45;Toledo;031;Camarena;2143;1091;1052
45;Toledo;032;Camarenilla;549;272;277
45;Toledo;033;Campillo de la Jara (El);572;308;264
45;Toledo;034;Camuñas;1772;897;875
45;Toledo;035;Cardiel de los Montes;127;70;57
45;Toledo;036;Carmena;805;415;390
45;Toledo;037;Carpio de Tajo (El);2332;1136;1196
45;Toledo;038;Carranque;1469;754;715
45;Toledo;039;Carriches;313;151;162
45;Toledo;040;Casar de Escalona (El);845;417;428
45;Toledo;041;Casarrubios del Monte;2506;1289;1217
45;Toledo;042;Casasbuenas;229;116;113
45;Toledo;043;Castillo de Bayuela;1013;506;507
45;Toledo;045;Cazalegas;1177;581;596
45;Toledo;046;Cebolla;2810;1397;1413
45;Toledo;047;Cedillo del Condado;1382;709;673
45;Toledo;048;Cerralbos (Los);480;234;246
45;Toledo;049;Cervera de los Montes;428;223;205
45;Toledo;056;Chozas de Canales;1006;498;508
45;Toledo;057;Chueca;271;137;134
45;Toledo;050;Ciruelos;329;176;153
45;Toledo;051;Cobeja;1739;865;874
45;Toledo;052;Cobisa;1034;533;501
45;Toledo;053;Consuegra;10113;5005;5108
45;Toledo;054;Corral de Almaguer;5856;2935;2921
45;Toledo;055;Cuerva;1272;629;643
45;Toledo;058;Domingo Pérez;503;239;264
45;Toledo;059;Dosbarrios;2045;1025;1020
45;Toledo;060;Erustes;211;107;104
45;Toledo;061;Escalona;2048;1047;1001
45;Toledo;062;Escalonilla;1451;708;743
45;Toledo;063;Espinoso del Rey;655;336;319
45;Toledo;064;Esquivias;3770;1888;1882
45;Toledo;065;Estrella (La);457;241;216
45;Toledo;066;Fuensalida;7525;3769;3756
45;Toledo;067;Gálvez;3115;1581;1534
45;Toledo;068;Garciotum;160;79;81
45;Toledo;069;Gerindote;1864;946;918
45;Toledo;070;Guadamur;1622;841;781
45;Toledo;071;Guardia (La);2427;1193;1234
45;Toledo;072;Herencias (Las);727;375;352
45;Toledo;073;Herreruela de Oropesa;432;206;226
45;Toledo;074;Hinojosa de San Vicente;490;263;227
45;Toledo;075;Hontanar;116;62;54
45;Toledo;076;Hormigos;434;220;214
45;Toledo;077;Huecas;381;195;186
45;Toledo;078;Huerta de Valdecarábanos;1715;836;879
45;Toledo;079;Iglesuela (La);474;240;234
45;Toledo;080;Illán de Vacas;6;5;1
45;Toledo;081;Illescas;9743;4874;4869
45;Toledo;082;Lagartera;1939;951;988
45;Toledo;083;Layos;273;135;138
45;Toledo;084;Lillo;2892;1437;1455
45;Toledo;085;Lominchar;1105;566;539
45;Toledo;086;Lucillos;515;254;261
45;Toledo;087;Madridejos;10533;5180;5353
45;Toledo;088;Magán;1081;542;539
45;Toledo;089;Malpica de Tajo;1779;894;885
45;Toledo;090;Manzaneque;487;239;248
45;Toledo;091;Maqueda;489;264;225
45;Toledo;092;Marjaliza;326;163;163
45;Toledo;093;Marrupe;122;57;65
45;Toledo;094;Mascaraque;506;237;269
45;Toledo;095;Mata (La);1010;504;506
45;Toledo;096;Mazarambroz;1200;594;606
45;Toledo;097;Mejorada;1092;557;535
45;Toledo;098;Menasalbas;2987;1547;1440
45;Toledo;099;Méntrida;1913;963;950
45;Toledo;100;Mesegar de Tajo;245;118;127
45;Toledo;101;Miguel Esteban;4688;2325;2363
45;Toledo;102;Mocejón;4032;2030;2002
45;Toledo;103;Mohedas de la Jara;651;335;316
45;Toledo;104;Montearagón;479;244;235
45;Toledo;105;Montesclaros;483;236;247
45;Toledo;106;Mora;9312;4566;4746
45;Toledo;107;Nambroca;2342;1154;1188
45;Toledo;108;Nava de Ricomalillo (La);775;391;384
45;Toledo;109;Navahermosa;3938;2019;1919
45;Toledo;110;Navalcán;2403;1250;1153
45;Toledo;111;Navalmoralejo;88;41;47
45;Toledo;112;Navalmorales (Los);2679;1331;1348
45;Toledo;113;Navalucillos (Los);2827;1421;1406
45;Toledo;114;Navamorcuende;765;398;367
45;Toledo;115;Noblejas;3022;1527;1495
45;Toledo;116;Noez;902;449;453
45;Toledo;117;Nombela;951;492;459
45;Toledo;118;Novés;1548;785;763
45;Toledo;119;Numancia de la Sagra;1917;998;919
45;Toledo;120;Nuño Gómez;178;89;89
45;Toledo;121;Ocaña;6102;3009;3093
45;Toledo;122;Olías del Rey;4205;2115;2090
45;Toledo;123;Ontígola;1088;585;503
45;Toledo;124;Orgaz;2670;1347;1323
45;Toledo;125;Oropesa;2834;1410;1424
45;Toledo;126;Otero;230;114;116
45;Toledo;127;Palomeque;465;234;231
45;Toledo;128;Pantoja;2282;1168;1114
45;Toledo;129;Paredes de Escalona;111;54;57
45;Toledo;130;Parrillas;474;232;242
45;Toledo;131;Pelahustán;378;196;182
45;Toledo;132;Pepino;787;402;385
45;Toledo;133;Polán;3246;1640;1606
45;Toledo;134;Portillo de Toledo;1933;994;939
45;Toledo;135;Puebla de Almoradiel (La);5360;2685;2675
45;Toledo;136;Puebla de Montalbán (La);6969;3494;3475
45;Toledo;137;Pueblanueva (La);1986;1003;983
45;Toledo;138;Puente del Arzobispo (El);1562;747;815
45;Toledo;139;Puerto de San Vicente;292;142;150
45;Toledo;140;Pulgar;1235;624;611
45;Toledo;141;Quero;1391;704;687
45;Toledo;142;Quintanar de la Orden;9330;4629;4701
45;Toledo;143;Quismondo;1328;634;694
45;Toledo;144;Real de San Vicente (El);985;501;484
45;Toledo;145;Recas;2469;1291;1178
45;Toledo;146;Retamoso;198;106;92
45;Toledo;147;Rielves;493;247;246
45;Toledo;148;Robledo del Mazo;538;278;260
45;Toledo;149;Romeral (El);943;465;478
45;Toledo;150;San Bartolomé de las Abiertas;492;259;233
45;Toledo;151;San Martín de Montalbán;751;375;376
45;Toledo;152;San Martín de Pusa;798;402;396
45;Toledo;153;San Pablo de los Montes;2131;1075;1056
45;Toledo;154;San Román de los Montes;596;308;288
45;Toledo;155;Santa Ana de Pusa;387;207;180
45;Toledo;156;Santa Cruz de la Zarza;4439;2223;2216
45;Toledo;157;Santa Cruz del Retamar;1607;816;791
45;Toledo;158;Santa Olalla;2418;1228;1190
45;Toledo;901;Santo Domingo-Caudilla;790;391;399
45;Toledo;159;Sartajada;111;69;42
45;Toledo;160;Segurilla;952;478;474
45;Toledo;161;Seseña;3597;1870;1727
45;Toledo;162;Sevilleja de la Jara;1108;585;523
45;Toledo;163;Sonseca;9142;4603;4539
45;Toledo;164;Sotillo de las Palomas;218;112;106
45;Toledo;165;Talavera de la Reina;70922;34671;36251
45;Toledo;166;Tembleque;2121;1071;1050
45;Toledo;167;Toboso (El);2141;1046;1095
45;Toledo;168;Toledo;66006;31734;34272
45;Toledo;169;Torralba de Oropesa;294;142;152
45;Toledo;171;Torre de Esteban Hambrán (La);1442;741;701
45;Toledo;170;Torrecilla de la Jara;313;163;150
45;Toledo;172;Torrico;939;476;463
45;Toledo;173;Torrijos;9822;4820;5002
45;Toledo;174;Totanés;349;182;167
45;Toledo;175;Turleque;1027;514;513
45;Toledo;176;Ugena;981;524;457
45;Toledo;177;Urda;3046;1519;1527
45;Toledo;179;Valdeverdeja;854;393;461
45;Toledo;180;Valmojado;2325;1185;1140
45;Toledo;181;Velada;2373;1223;1150
45;Toledo;182;Ventas con Peña Aguilera (Las);1405;717;688
45;Toledo;183;Ventas de Retamosa (Las);690;357;333
45;Toledo;184;Ventas de San Julián (Las);239;113;126
45;Toledo;186;Villa de Don Fadrique (La);4155;2049;2106
45;Toledo;185;Villacañas;9301;4599;4702
45;Toledo;187;Villafranca de los Caballeros;5349;2653;2696
45;Toledo;188;Villaluenga de la Sagra;2639;1335;1304
45;Toledo;189;Villamiel de Toledo;441;224;217
45;Toledo;190;Villaminaya;655;333;322
45;Toledo;191;Villamuelas;760;377;383
45;Toledo;192;Villanueva de Alcardete;3313;1655;1658
45;Toledo;193;Villanueva de Bogas;843;419;424
45;Toledo;194;Villarejo de Montalbán;104;53;51
45;Toledo;195;Villarrubia de Santiago;2922;1455;1467
45;Toledo;196;Villaseca de la Sagra;1580;803;777
45;Toledo;197;Villasequilla;2381;1238;1143
45;Toledo;198;Villatobas;2280;1149;1131
45;Toledo;199;Viso de San Juan (El);993;522;471
45;Toledo;200;Yébenes (Los);6573;3313;3260
45;Toledo;201;Yeles;1417;740;677
45;Toledo;202;Yepes;4428;2244;2184
45;Toledo;203;Yuncler;1960;996;964
45;Toledo;204;Yunclillos;609;307;302
45;Toledo;205;Yuncos;3307;1721;1586
46;Valencia/València;001;Ademuz;1197;598;599
46;Valencia/València;002;Ador;1117;565;552
46;Valencia/València;004;Agullent;2205;1061;1144
46;Valencia/València;042;Aielo de Malferit;3924;1939;1985
46;Valencia/València;043;Aielo de Rugat;196;103;93
46;Valencia/València;005;Alaquàs;25514;12660;12854
46;Valencia/València;006;Albaida;5793;2843;2950
46;Valencia/València;007;Albal;10523;5228;5295
46;Valencia/València;008;Albalat de la Ribera;3473;1676;1797
46;Valencia/València;009;Albalat dels Sorells;3530;1711;1819
46;Valencia/València;010;Albalat dels Tarongers;651;342;309
46;Valencia/València;011;Alberic;9100;4469;4631
46;Valencia/València;012;Alborache;875;446;429
46;Valencia/València;013;Alboraya;13127;6464;6663
46;Valencia/València;014;Albuixech;3088;1509;1579
46;Valencia/València;016;Alcàntera de Xúquer;1492;745;747
46;Valencia/València;015;Alcàsser;7335;3697;3638
46;Valencia/València;018;Alcublas;837;424;413
46;Valencia/València;020;Alcúdia de Crespins (L');4185;2063;2122
46;Valencia/València;019;Alcúdia (L');10511;5166;5345
46;Valencia/València;021;Aldaia;23425;11724;11701
46;Valencia/València;022;Alfafar;20302;10052;10250
46;Valencia/València;024;Alfara de Algimia;509;250;259
46;Valencia/València;025;Alfara del Patriarca;2733;1343;1390
46;Valencia/València;026;Alfarp;1336;648;688
46;Valencia/València;027;Alfarrasí;1231;605;626
46;Valencia/València;023;Alfauir;343;180;163
46;Valencia/València;028;Algar de Palancia;413;201;212
46;Valencia/València;029;Algemesí;25029;12359;12670
46;Valencia/València;030;Algimia de Alfara;829;413;416
46;Valencia/València;031;Alginet;11632;5798;5834
46;Valencia/València;032;Almàssera;5545;2648;2897
46;Valencia/València;033;Almiserà;255;128;127
46;Valencia/València;034;Almoines;1759;863;896
46;Valencia/València;035;Almussafes;6881;3436;3445
46;Valencia/València;036;Alpuente;985;498;487
46;Valencia/València;037;Alquería de la Condesa/Alqueria de la Comtessa (l');1487;705;782
46;Valencia/València;017;Alzira;40556;19736;20820
46;Valencia/València;038;Andilla;292;162;130
46;Valencia/València;039;Anna;2637;1329;1308
46;Valencia/València;040;Antella;1558;780;778
46;Valencia/València;041;Aras de los Olmos;420;236;184
46;Valencia/València;003;Atzeneta d'Albaida;1243;635;608
46;Valencia/València;044;Ayora;5556;2846;2710
46;Valencia/València;046;Barx;1203;568;635
46;Valencia/València;045;Barxeta;1610;812;798
46;Valencia/València;047;Bèlgida;677;329;348
46;Valencia/València;048;Bellreguard;3764;1876;1888
46;Valencia/València;049;Bellús;383;191;192
46;Valencia/València;050;Benagéber;156;89;67
46;Valencia/València;051;Benaguasil;9155;4601;4554
46;Valencia/València;052;Benavites;651;315;336
46;Valencia/València;053;Beneixida;647;315;332
46;Valencia/València;054;Benetússer;13961;6885;7076
46;Valencia/València;055;Beniarjó;1165;557;608
46;Valencia/València;056;Beniatjar;245;123;122
46;Valencia/València;057;Benicolet;501;258;243
46;Valencia/València;904;Benicull de Xúquer;"";"";""
46;Valencia/València;060;Benifaió;12178;6020;6158
46;Valencia/València;059;Benifairó de la Valldigna;1669;824;845
46;Valencia/València;058;Benifairó de les Valls;1978;976;1002
46;Valencia/València;061;Beniflá;153;67;86
46;Valencia/València;062;Benigánim;5437;2753;2684
46;Valencia/València;063;Benimodo;1757;894;863
46;Valencia/València;064;Benimuslem;552;269;283
46;Valencia/València;065;Beniparrell;1510;767;743
46;Valencia/València;066;Benirredrà;1008;478;530
46;Valencia/València;067;Benisanó;1672;859;813
46;Valencia/València;068;Benissoda;291;164;127
46;Valencia/València;069;Benisuera;196;91;105
46;Valencia/València;070;Bétera;11619;5767;5852
46;Valencia/València;071;Bicorp;697;350;347
46;Valencia/València;072;Bocairent;4627;2285;2342
46;Valencia/València;073;Bolbaite;1439;724;715
46;Valencia/València;074;Bonrepòs i Mirambell;2377;1166;1211
46;Valencia/València;075;Bufali;220;106;114
46;Valencia/València;076;Bugarra;855;432;423
46;Valencia/València;077;Buñol;9410;4657;4753
46;Valencia/València;078;Burjassot;34061;16534;17527
46;Valencia/València;079;Calles;435;232;203
46;Valencia/València;080;Camporrobles;1398;716;682
46;Valencia/València;081;Canals;12886;6386;6500
46;Valencia/València;082;Canet d'En Berenguer;1975;957;1018
46;Valencia/València;083;Carcaixent;20397;9933;10464
46;Valencia/València;084;Càrcer;2022;966;1056
46;Valencia/València;085;Carlet;14366;6999;7367
46;Valencia/València;086;Carrícola;77;34;43
46;Valencia/València;087;Casas Altas;165;88;77
46;Valencia/València;088;Casas Bajas;316;167;149
46;Valencia/València;089;Casinos;2292;1189;1103
46;Valencia/València;090;Castelló de Rugat;2069;1058;1011
46;Valencia/València;091;Castellonet de la Conquesta;144;73;71
46;Valencia/València;092;Castielfabib;561;302;259
46;Valencia/València;093;Catadau;2189;1075;1114
46;Valencia/València;094;Catarroja;20627;10148;10479
46;Valencia/València;095;Caudete de las Fuentes;845;425;420
46;Valencia/València;096;Cerdà;282;136;146
46;Valencia/València;107;Chella;2539;1257;1282
46;Valencia/València;106;Chelva;2211;1115;1096
46;Valencia/València;108;Chera;582;293;289
46;Valencia/València;109;Cheste;6857;3444;3413
46;Valencia/València;111;Chiva;8794;4379;4415
46;Valencia/València;112;Chulilla;744;373;371
46;Valencia/València;097;Cofrentes;1007;502;505
46;Valencia/València;098;Corbera;3148;1520;1628
46;Valencia/València;099;Cortes de Pallás;602;313;289
46;Valencia/València;100;Cotes;375;169;206
46;Valencia/València;105;Cullera;20595;10136;10459
46;Valencia/València;113;Daimús;1389;694;695
46;Valencia/València;114;Domeño;505;261;244
46;Valencia/València;115;Dos Aguas;367;207;160
46;Valencia/València;116;Eliana (L');11526;5791;5735
46;Valencia/València;117;Emperador;188;91;97
46;Valencia/València;118;Enguera;4754;2333;2421
46;Valencia/València;119;Ènova (L');1104;560;544
46;Valencia/València;120;Estivella;1097;516;581
46;Valencia/València;121;Estubeny;141;63;78
46;Valencia/València;122;Faura;2809;1403;1406
46;Valencia/València;123;Favara;1726;834;892
46;Valencia/València;126;Foios;5235;2525;2710
46;Valencia/València;128;Font de la Figuera (La);2129;1067;1062
46;Valencia/València;127;Font d'En Carròs (La);3211;1595;1616
46;Valencia/València;124;Fontanars dels Alforins;970;504;466
46;Valencia/València;125;Fortaleny;997;505;492
46;Valencia/València;129;Fuenterrobles;711;367;344
46;Valencia/València;131;Gandia;56555;27630;28925
46;Valencia/València;902;Gátova;"";"";""
46;Valencia/València;130;Gavarda;1268;610;658
46;Valencia/València;132;Genovés;2314;1150;1164
46;Valencia/València;133;Gestalgar;661;318;343
46;Valencia/València;134;Gilet;1433;709;724
46;Valencia/València;135;Godella;10408;5074;5334
46;Valencia/València;136;Godelleta;2095;1025;1070
46;Valencia/València;137;Granja de la Costera (La);363;172;191
46;Valencia/València;138;Guadasequies;390;207;183
46;Valencia/València;139;Guadassuar;5415;2705;2710
46;Valencia/València;140;Guardamar de la Safor;69;38;31
46;Valencia/València;141;Higueruelas;556;288;268
46;Valencia/València;142;Jalance;1117;569;548
46;Valencia/València;144;Jarafuel;1006;523;483
46;Valencia/València;154;Llanera de Ranes;1056;527;529
46;Valencia/València;155;Llaurí;1336;667;669
46;Valencia/València;147;Llíria;15550;7719;7831
46;Valencia/València;153;Llocnou de Sant Jeroni;555;278;277
46;Valencia/València;151;Llocnou d'En Fenollet;731;356;375
46;Valencia/València;156;Llombai;2220;1115;1105
46;Valencia/València;157;Llosa de Ranes (La);3640;1871;1769
46;Valencia/València;150;Llutxent;2377;1201;1176
46;Valencia/València;148;Loriguilla;1004;507;497
46;Valencia/València;149;Losa del Obispo;469;227;242
46;Valencia/València;152;Lugar Nuevo de la Corona;123;61;62
46;Valencia/València;158;Macastre;997;487;510
46;Valencia/València;159;Manises;25170;12297;12873
46;Valencia/València;160;Manuel;2411;1159;1252
46;Valencia/València;161;Marines;1305;665;640
46;Valencia/València;162;Masalavés;1480;759;721
46;Valencia/València;163;Massalfassar;1364;669;695
46;Valencia/València;164;Massamagrell;12283;6041;6242
46;Valencia/València;165;Massanassa;7645;3721;3924
46;Valencia/València;166;Meliana;9120;4435;4685
46;Valencia/València;167;Millares;693;341;352
46;Valencia/València;168;Miramar;1064;513;551
46;Valencia/València;169;Mislata;40302;19761;20541
46;Valencia/València;170;Mogente/Moixent;4214;2140;2074
46;Valencia/València;171;Moncada;18420;9108;9312
46;Valencia/València;172;Monserrat;2762;1405;1357
46;Valencia/València;173;Montaverner;1711;859;852
46;Valencia/València;174;Montesa;1260;629;631
46;Valencia/València;175;Montichelvo;610;307;303
46;Valencia/València;176;Montroy;1567;803;764
46;Valencia/València;177;Museros;4083;2021;2062
46;Valencia/València;178;Náquera;2075;1047;1028
46;Valencia/València;179;Navarrés;2772;1394;1378
46;Valencia/València;180;Novelé/Novetlè;646;314;332
46;Valencia/València;181;Oliva;20654;10145;10509
46;Valencia/València;183;Olleria (L');7010;3569;3441
46;Valencia/València;182;Olocau;768;388;380
46;Valencia/València;184;Ontinyent;31024;15269;15755
46;Valencia/València;185;Otos;534;266;268
46;Valencia/València;186;Paiporta;17259;8518;8741
46;Valencia/València;187;Palma de Gandía;1534;750;784
46;Valencia/València;188;Palmera;497;241;256
46;Valencia/València;189;Palomar (El);496;248;248
46;Valencia/València;190;Paterna;47414;23455;23959
46;Valencia/València;191;Pedralba;2099;1061;1038
46;Valencia/València;192;Petrés;757;364;393
46;Valencia/València;193;Picanya;8582;4308;4274
46;Valencia/València;194;Picassent;15438;7769;7669
46;Valencia/València;195;Piles;1956;952;1004
46;Valencia/València;196;Pinet;235;120;115
46;Valencia/València;199;Pobla de Farnals (La);4960;2479;2481
46;Valencia/València;202;Pobla de Vallbona (La);9871;5061;4810
46;Valencia/València;200;Pobla del Duc (La);2490;1215;1275
46;Valencia/València;203;Pobla Llarga (La);4390;2140;2250
46;Valencia/València;197;Polinyà de Xúquer;3048;1527;1521
46;Valencia/València;198;Potríes;965;463;502
46;Valencia/València;205;Puçol;13662;6708;6954
46;Valencia/València;201;Puebla de San Miguel;77;43;34
46;Valencia/València;204;Puig;6868;3372;3496
46;Valencia/València;101;Quart de les Valls;1093;520;573
46;Valencia/València;102;Quart de Poblet;27112;13363;13749
46;Valencia/València;103;Quartell;1374;675;699
46;Valencia/València;104;Quatretonda;2570;1315;1255
46;Valencia/València;206;Quesa;780;389;391
46;Valencia/València;207;Rafelbuñol/Rafelbunyol;5260;2582;2678
46;Valencia/València;208;Rafelcofer;1390;650;740
46;Valencia/València;209;Rafelguaraf;2478;1223;1255
46;Valencia/València;210;Ráfol de Salem;377;169;208
46;Valencia/València;211;Real de Gandía;1802;870;932
46;Valencia/València;212;Real ;1843;941;902
46;Valencia/València;213;Requena;18795;9453;9342
46;Valencia/València;214;Riba-roja de Túria;11236;5582;5654
46;Valencia/València;215;Riola;1600;801;799
46;Valencia/València;216;Rocafort;4799;2359;2440
46;Valencia/València;217;Rotglá y Corberá;1018;515;503
46;Valencia/València;218;Rótova;1345;681;664
46;Valencia/València;219;Rugat;199;98;101
46;Valencia/València;220;Sagunto/Sagunt;58135;28342;29793
46;Valencia/València;221;Salem;471;240;231
46;Valencia/València;903;San Antonio de Benagéber;"";"";""
46;Valencia/València;222;San Juan de Énova;360;160;200
46;Valencia/València;223;Sedaví;8198;3994;4204
46;Valencia/València;224;Segart;181;86;95
46;Valencia/València;225;Sellent;496;264;232
46;Valencia/València;226;Sempere;38;19;19
46;Valencia/València;227;Senyera;885;418;467
46;Valencia/València;228;Serra;1794;901;893
46;Valencia/València;229;Siete Aguas;1074;543;531
46;Valencia/València;230;Silla;16165;8149;8016
46;Valencia/València;231;Simat de la Valldigna;3114;1581;1533
46;Valencia/València;232;Sinarcas;1253;657;596
46;Valencia/València;233;Sollana;4425;2132;2293
46;Valencia/València;234;Sot de Chera;283;144;139
46;Valencia/València;235;Sueca;24869;12196;12673
46;Valencia/València;236;Sumacàrcer;1382;702;680
46;Valencia/València;237;Tavernes Blanques;8299;4090;4209
46;Valencia/València;238;Tavernes de la Valldigna;16412;8167;8245
46;Valencia/València;239;Teresa de Cofrentes;751;382;369
46;Valencia/València;240;Terrateig;195;102;93
46;Valencia/València;241;Titaguas;556;303;253
46;Valencia/València;242;Torrebaja;457;233;224
46;Valencia/València;243;Torrella;204;102;102
46;Valencia/València;244;Torrent;60999;30154;30845
46;Valencia/València;245;Torres Torres;417;199;218
46;Valencia/València;246;Tous;1205;593;612
46;Valencia/València;247;Tuéjar;1342;705;637
46;Valencia/València;248;Turís;4471;2302;2169
46;Valencia/València;249;Utiel;11782;5827;5955
46;Valencia/València;250;Valencia;746683;354950;391733
46;Valencia/València;251;Vallada;3089;1561;1528
46;Valencia/València;252;Vallanca;240;112;128
46;Valencia/València;253;Vallés;103;56;47
46;Valencia/València;254;Venta del Moro;1636;833;803
46;Valencia/València;256;Vilamarxant;5592;2818;2774
46;Valencia/València;255;Villalonga;3649;1828;1821
46;Valencia/València;257;Villanueva de Castellón;7089;3486;3603
46;Valencia/València;258;Villar del Arzobispo;3460;1726;1734
46;Valencia/València;259;Villargordo del Cabriel;739;380;359
46;Valencia/València;260;Vinalesa;2265;1074;1191
46;Valencia/València;145;Xàtiva;24760;12012;12748
46;Valencia/València;143;Xeraco;4573;2252;2321
46;Valencia/València;146;Xeresa;1880;952;928
46;Valencia/València;110;Xirivella;26478;13140;13338
46;Valencia/València;261;Yátova;2002;1041;961
46;Valencia/València;262;Yesa (La);303;149;154
46;Valencia/València;263;Zarra;438;227;211
47;Valladolid;001;Adalia;93;48;45
47;Valladolid;002;Aguasal;25;13;12
47;Valladolid;003;Aguilar de Campos;396;207;189
47;Valladolid;004;Alaejos;1717;891;826
47;Valladolid;005;Alcazarén;739;395;344
47;Valladolid;006;Aldea de San Miguel;242;123;119
47;Valladolid;007;Aldeamayor de San Martín;1275;643;632
47;Valladolid;008;Almenara de Adaja;33;19;14
47;Valladolid;009;Amusquillo;190;104;86
47;Valladolid;010;Arroyo de la Encomienda;1930;994;936
47;Valladolid;011;Ataquines;918;474;444
47;Valladolid;012;Bahabón;208;99;109
47;Valladolid;013;Barcial de la Loma;171;88;83
47;Valladolid;014;Barruelo del Valle;78;41;37
47;Valladolid;015;Becilla de Valderaduey;459;241;218
47;Valladolid;016;Benafarces;118;57;61
47;Valladolid;017;Bercero;295;157;138
47;Valladolid;018;Berceruelo;35;19;16
47;Valladolid;019;Berrueces;112;62;50
47;Valladolid;020;Bobadilla del Campo;417;220;197
47;Valladolid;021;Bocigas;180;87;93
47;Valladolid;022;Bocos de Duero;84;35;49
47;Valladolid;023;Boecillo;1242;641;601
47;Valladolid;024;Bolaños de Campos;384;195;189
47;Valladolid;025;Brahojos de Medina;189;107;82
47;Valladolid;026;Bustillo de Chaves;100;49;51
47;Valladolid;027;Cabezón de Pisuerga;1692;868;824
47;Valladolid;028;Cabezón de Valderaduey;54;29;25
47;Valladolid;029;Cabreros del Monte;105;58;47
47;Valladolid;030;Campaspero;1529;787;742
47;Valladolid;031;Campillo (El);248;139;109
47;Valladolid;032;Camporredondo;219;121;98
47;Valladolid;033;Canalejas de Peñafiel;318;156;162
47;Valladolid;034;Canillas de Esgueva;149;81;68
47;Valladolid;035;Carpio;1244;654;590
47;Valladolid;036;Casasola de Arión;390;211;179
47;Valladolid;037;Castrejón de Trabancos;277;151;126
47;Valladolid;038;Castrillo de Duero;236;116;120
47;Valladolid;039;Castrillo-Tejeriego;295;153;142
47;Valladolid;040;Castrobol;90;41;49
47;Valladolid;041;Castrodeza;256;137;119
47;Valladolid;042;Castromembibre;90;48;42
47;Valladolid;043;Castromonte;487;252;235
47;Valladolid;044;Castronuevo de Esgueva;305;161;144
47;Valladolid;045;Castronuño;1111;562;549
47;Valladolid;046;Castroponce;210;106;104
47;Valladolid;047;Castroverde de Cerrato;279;154;125
47;Valladolid;048;Ceinos de Campos;271;145;126
47;Valladolid;049;Cervillego de la Cruz;167;83;84
47;Valladolid;050;Cigales;2620;1254;1366
47;Valladolid;051;Ciguñuela;368;203;165
47;Valladolid;052;Cistérniga;2488;1291;1197
47;Valladolid;053;Cogeces de Íscar;156;82;74
47;Valladolid;054;Cogeces del Monte;972;523;449
47;Valladolid;055;Corcos;276;145;131
47;Valladolid;056;Corrales de Duero;145;82;63
47;Valladolid;057;Cubillas de Santa Marta;265;145;120
47;Valladolid;058;Cuenca de Campos;306;151;155
47;Valladolid;059;Curiel de Duero;135;75;60
47;Valladolid;060;Encinas de Esgueva;409;221;188
47;Valladolid;061;Esguevillas de Esgueva;446;226;220
47;Valladolid;062;Fombellida;301;155;146
47;Valladolid;063;Fompedraza;145;79;66
47;Valladolid;064;Fontihoyuelo;42;26;16
47;Valladolid;065;Fresno el Viejo;1331;680;651
47;Valladolid;066;Fuensaldaña;881;426;455
47;Valladolid;067;Fuente el Sol;314;161;153
47;Valladolid;068;Fuente-Olmedo;66;34;32
47;Valladolid;069;Gallegos de Hornija;156;79;77
47;Valladolid;070;Gatón de Campos;49;29;20
47;Valladolid;071;Geria;477;259;218
47;Valladolid;073;Herrín de Campos;218;105;113
47;Valladolid;074;Hornillos de Eresma;153;78;75
47;Valladolid;075;Íscar;6133;3103;3030
47;Valladolid;076;Laguna de Duero;14234;7221;7013
47;Valladolid;077;Langayo;490;259;231
47;Valladolid;079;Llano de Olmedo;105;56;49
47;Valladolid;078;Lomoviejo;268;134;134
47;Valladolid;080;Manzanillo;86;45;41
47;Valladolid;081;Marzales;77;37;40
47;Valladolid;082;Matapozuelos;1017;513;504
47;Valladolid;083;Matilla de los Caños;98;54;44
47;Valladolid;084;Mayorga;1712;835;877
47;Valladolid;086;Medina de Rioseco;5015;2441;2574
47;Valladolid;085;Medina del Campo;20174;9908;10266
47;Valladolid;087;Megeces;472;236;236
47;Valladolid;088;Melgar de Abajo;202;102;100
47;Valladolid;089;Melgar de Arriba;322;163;159
47;Valladolid;090;Mojados;2423;1216;1207
47;Valladolid;091;Monasterio de Vega;87;43;44
47;Valladolid;092;Montealegre de Campos;175;95;80
47;Valladolid;093;Montemayor de Pililla;1085;568;517
47;Valladolid;094;Moral de la Reina;243;122;121
47;Valladolid;095;Moraleja de las Panaderas;29;17;12
47;Valladolid;096;Morales de Campos;208;103;105
47;Valladolid;097;Mota del Marqués;462;218;244
47;Valladolid;098;Mucientes;613;313;300
47;Valladolid;099;Mudarra (La);265;134;131
47;Valladolid;100;Muriel;232;114;118
47;Valladolid;101;Nava del Rey;2310;1136;1174
47;Valladolid;102;Nueva Villa de las Torres;426;234;192
47;Valladolid;103;Olivares de Duero;350;188;162
47;Valladolid;104;Olmedo;3501;1706;1795
47;Valladolid;105;Olmos de Esgueva;184;103;81
47;Valladolid;106;Olmos de Peñafiel;87;45;42
47;Valladolid;109;Palazuelo de Vedija;235;120;115
47;Valladolid;110;Parrilla (La);666;318;348
47;Valladolid;111;Pedraja de Portillo (La);1102;552;550
47;Valladolid;112;Pedrajas de San Esteban;3215;1629;1586
47;Valladolid;113;Pedrosa del Rey;245;133;112
47;Valladolid;114;Peñafiel;5160;2599;2561
47;Valladolid;115;Peñaflor de Hornija;506;267;239
47;Valladolid;116;Pesquera de Duero;534;286;248
47;Valladolid;117;Piña de Esgueva;411;211;200
47;Valladolid;118;Piñel de Abajo;235;124;111
47;Valladolid;119;Piñel de Arriba;161;80;81
47;Valladolid;121;Pollos;853;440;413
47;Valladolid;122;Portillo;2562;1300;1262
47;Valladolid;123;Pozal de Gallinas;503;264;239
47;Valladolid;124;Pozaldez;536;263;273
47;Valladolid;125;Pozuelo de la Orden;83;46;37
47;Valladolid;126;Puras;63;30;33
47;Valladolid;127;Quintanilla de Arriba;240;126;114
47;Valladolid;129;Quintanilla de Onésimo;1175;623;552
47;Valladolid;130;Quintanilla de Trigueros;103;52;51
47;Valladolid;128;Quintanilla del Molar;89;39;50
47;Valladolid;131;Rábano;256;123;133
47;Valladolid;132;Ramiro;87;46;41
47;Valladolid;133;Renedo de Esgueva;933;489;444
47;Valladolid;134;Roales de Campos;266;129;137
47;Valladolid;135;Robladillo;110;54;56
47;Valladolid;137;Roturas;29;17;12
47;Valladolid;138;Rubí de Bracamonte;348;182;166
47;Valladolid;139;Rueda;1514;785;729
47;Valladolid;140;Saelices de Mayorga;208;109;99
47;Valladolid;141;Salvador de Zapardiel;208;111;97
47;Valladolid;142;San Cebrián de Mazote;247;132;115
47;Valladolid;143;San Llorente;215;114;101
47;Valladolid;144;San Martín de Valvení;117;67;50
47;Valladolid;145;San Miguel del Arroyo;855;444;411
47;Valladolid;146;San Miguel del Pino;247;131;116
47;Valladolid;147;San Pablo de la Moraleja;197;106;91
47;Valladolid;148;San Pedro de Latarce;679;365;314
47;Valladolid;149;San Pelayo;42;23;19
47;Valladolid;150;San Román de Hornija;479;232;247
47;Valladolid;151;San Salvador;50;25;25
47;Valladolid;156;San Vicente del Palacio;266;136;130
47;Valladolid;152;Santa Eufemia del Arroyo;130;63;67
47;Valladolid;153;Santervás de Campos;173;91;82
47;Valladolid;154;Santibáñez de Valcorba;235;122;113
47;Valladolid;155;Santovenia de Pisuerga;1556;786;770
47;Valladolid;157;Sardón de Duero;647;326;321
47;Valladolid;158;Seca (La);1066;566;500
47;Valladolid;159;Serrada;1023;524;499
47;Valladolid;160;Siete Iglesias de Trabancos;667;340;327
47;Valladolid;161;Simancas;2900;1472;1428
47;Valladolid;162;Tamariz de Campos;115;59;56
47;Valladolid;163;Tiedra;429;210;219
47;Valladolid;164;Tordehumos;576;296;280
47;Valladolid;165;Tordesillas;7946;4011;3935
47;Valladolid;169;Torre de Esgueva;117;58;59
47;Valladolid;170;Torre de Peñafiel;50;27;23
47;Valladolid;166;Torrecilla de la Abadesa;384;202;182
47;Valladolid;167;Torrecilla de la Orden;395;193;202
47;Valladolid;168;Torrecilla de la Torre;39;23;16
47;Valladolid;171;Torrelobatón;588;288;300
47;Valladolid;172;Torrescárcela;182;95;87
47;Valladolid;173;Traspinedo;834;427;407
47;Valladolid;174;Trigueros del Valle;282;144;138
47;Valladolid;175;Tudela de Duero;5745;2941;2804
47;Valladolid;176;Unión de Campos (La);333;162;171
47;Valladolid;177;Urones de Castroponce;171;96;75
47;Valladolid;178;Urueña;204;102;102
47;Valladolid;179;Valbuena de Duero;518;264;254
47;Valladolid;180;Valdearcos de la Vega;153;76;77
47;Valladolid;181;Valdenebro de los Valles;259;134;125
47;Valladolid;182;Valdestillas;1556;784;772
47;Valladolid;183;Valdunquillo;240;111;129
47;Valladolid;186;Valladolid;319805;154149;165656
47;Valladolid;184;Valoria la Buena;683;353;330
47;Valladolid;185;Valverde de Campos;123;65;58
47;Valladolid;187;Vega de Ruiponce;151;72;79
47;Valladolid;188;Vega de Valdetronco;199;102;97
47;Valladolid;189;Velascálvaro;201;106;95
47;Valladolid;190;Velilla;161;81;80
47;Valladolid;191;Velliza;161;91;70
47;Valladolid;192;Ventosa de la Cuesta;167;89;78
47;Valladolid;193;Viana de Cega;1337;678;659
47;Valladolid;195;Villabáñez;485;259;226
47;Valladolid;196;Villabaruz de Campos;55;26;29
47;Valladolid;197;Villabrágima;1249;646;603
47;Valladolid;198;Villacarralón;128;68;60
47;Valladolid;199;Villacid de Campos;115;61;54
47;Valladolid;200;Villaco;142;81;61
47;Valladolid;203;Villafrades de Campos;121;55;66
47;Valladolid;204;Villafranca de Duero;402;204;198
47;Valladolid;205;Villafrechós;544;276;268
47;Valladolid;206;Villafuerte;161;76;85
47;Valladolid;207;Villagarcía de Campos;446;238;208
47;Valladolid;208;Villagómez la Nueva;109;50;59
47;Valladolid;209;Villalán de Campos;54;26;28
47;Valladolid;210;Villalar de los Comuneros;510;252;258
47;Valladolid;211;Villalba de la Loma;50;26;24
47;Valladolid;212;Villalba de los Alcores;589;307;282
47;Valladolid;213;Villalbarba;175;86;89
47;Valladolid;214;Villalón de Campos;2166;1047;1119
47;Valladolid;215;Villamuriel de Campos;103;52;51
47;Valladolid;216;Villán de Tordesillas;189;97;92
47;Valladolid;217;Villanubla;928;486;442
47;Valladolid;218;Villanueva de Duero;938;487;451
47;Valladolid;219;Villanueva de la Condesa;44;26;18
47;Valladolid;220;Villanueva de los Caballeros;294;146;148
47;Valladolid;221;Villanueva de los Infantes;158;82;76
47;Valladolid;222;Villanueva de San Mancio;99;53;46
47;Valladolid;223;Villardefrades;248;133;115
47;Valladolid;224;Villarmentero de Esgueva;136;68;68
47;Valladolid;225;Villasexmir;130;68;62
47;Valladolid;226;Villavaquerín;229;121;108
47;Valladolid;227;Villavellid;69;37;32
47;Valladolid;228;Villaverde de Medina;614;333;281
47;Valladolid;229;Villavicencio de los Caballeros;359;166;193
47;Valladolid;194;Viloria;404;218;186
47;Valladolid;230;Wamba;390;208;182
47;Valladolid;231;Zaratán;1221;623;598
47;Valladolid;232;Zarza (La);164;83;81
48;Vizcaya;001;Abadiño;6897;3469;3428
48;Vizcaya;002;Abanto y Ciérvana-Abanto Zierbena;8417;4176;4241
48;Vizcaya;911;Ajangiz;388;200;188
48;Vizcaya;912;Alonsotegi;2894;1414;1480
48;Vizcaya;003;Amorebieta-Etxano;16060;8020;8040
48;Vizcaya;004;Amoroto;374;198;176
48;Vizcaya;005;Arakaldo;110;64;46
48;Vizcaya;006;Arantzazu;285;137;148
48;Vizcaya;093;Areatza;1096;495;601
48;Vizcaya;009;Arrankudiaga;730;349;381
48;Vizcaya;914;Arratzu;399;201;198
48;Vizcaya;010;Arrieta;471;240;231
48;Vizcaya;011;Arrigorriaga;10413;5115;5298
48;Vizcaya;023;Artea;594;283;311
48;Vizcaya;008;Artzentales;637;346;291
48;Vizcaya;091;Atxondo;1490;744;746
48;Vizcaya;070;Aulesti;658;341;317
48;Vizcaya;012;Bakio;1389;707;682
48;Vizcaya;090;Balmaseda;7226;3502;3724
48;Vizcaya;013;Barakaldo;100474;49241;51233
48;Vizcaya;014;Barrika;1047;520;527
48;Vizcaya;015;Basauri;48490;24043;24447
48;Vizcaya;092;Bedia;996;498;498
48;Vizcaya;016;Berango;4645;2313;2332
48;Vizcaya;017;Bermeo;17176;8456;8720
48;Vizcaya;018;Berriatua;978;507;471
48;Vizcaya;019;Berriz;4099;2056;2043
48;Vizcaya;020;Bilbao;358875;170460;188415
48;Vizcaya;021;Busturia;1640;826;814
48;Vizcaya;901;Derio;4677;2320;2357
48;Vizcaya;026;Dima;1048;532;516
48;Vizcaya;027;Durango;23909;11774;12135
48;Vizcaya;028;Ea;808;390;418
48;Vizcaya;031;Elantxobe;510;228;282
48;Vizcaya;032;Elorrio;7338;3678;3660
48;Vizcaya;902;Erandio;23613;11614;11999
48;Vizcaya;033;Ereño;268;133;135
48;Vizcaya;034;Ermua;17346;8846;8500
48;Vizcaya;079;Errigoiti;452;246;206
48;Vizcaya;029;Etxebarri, Anteiglesia de San Esteban-Etxebarri Doneztebeko Elizatea;6374;3210;3164
48;Vizcaya;030;Etxebarria;788;411;377
48;Vizcaya;906;Forua;977;495;482
48;Vizcaya;035;Fruiz;316;159;157
48;Vizcaya;036;Galdakao;29646;14741;14905
48;Vizcaya;037;Galdames;804;419;385
48;Vizcaya;038;Gamiz-Fika;987;510;477
48;Vizcaya;039;Garay;244;126;118
48;Vizcaya;040;Gatika;1090;555;535
48;Vizcaya;041;Gautegiz Arteaga;778;384;394
48;Vizcaya;046;Gernika-Lumo;15439;7502;7937
48;Vizcaya;044;Getxo;82196;39376;42820
48;Vizcaya;047;Gizaburuaga;136;68;68
48;Vizcaya;042;Gordexola;1448;724;724
48;Vizcaya;043;Gorliz;3523;1749;1774
48;Vizcaya;045;Güeñes;5913;2922;2991
48;Vizcaya;048;Ibarrangelu;525;245;280
48;Vizcaya;094;Igorre;4000;2004;1996
48;Vizcaya;049;Ispaster;624;325;299
48;Vizcaya;910;Iurreta;4483;2210;2273
48;Vizcaya;050;Izurtza;277;144;133
48;Vizcaya;022;Karrantza Harana/Valle de Carranza;3147;1663;1484
48;Vizcaya;907;Kortezubi;368;193;175
48;Vizcaya;051;Lanestosa;296;149;147
48;Vizcaya;052;Larrabetzu;1518;762;756
48;Vizcaya;053;Laukiz;937;480;457
48;Vizcaya;054;Leioa;26256;12949;13307
48;Vizcaya;057;Lekeitio;7430;3645;3785
48;Vizcaya;055;Lemoa;2470;1232;1238
48;Vizcaya;056;Lemoiz;829;430;399
48;Vizcaya;081;Lezama;2057;1034;1023
48;Vizcaya;903;Loiu;1686;860;826
48;Vizcaya;058;Mallabia;1100;576;524
48;Vizcaya;059;Mañaria;473;253;220
48;Vizcaya;060;Markina-Xemein;4713;2334;2379
48;Vizcaya;061;Maruri-Jatabe;580;284;296
48;Vizcaya;062;Mendata;332;182;150
48;Vizcaya;063;Mendexa;338;177;161
48;Vizcaya;064;Meñaka;473;243;230
48;Vizcaya;066;Morga;386;207;179
48;Vizcaya;068;Mundaka;1781;830;951
48;Vizcaya;069;Mungia;12807;6272;6535
48;Vizcaya;007;Munitibar-Arbatzegi Gerrikaitz;397;216;181
48;Vizcaya;908;Murueta;202;104;98
48;Vizcaya;071;Muskiz;6367;3136;3231
48;Vizcaya;067;Muxika;1415;733;682
48;Vizcaya;909;Nabarniz;244;116;128
48;Vizcaya;073;Ondarroa;10247;5121;5126
48;Vizcaya;075;Orozko;1888;935;953
48;Vizcaya;083;Ortuella;8601;4200;4401
48;Vizcaya;072;Otxandio;1046;545;501
48;Vizcaya;077;Plentzia;3117;1484;1633
48;Vizcaya;078;Portugalete;54071;26518;27553
48;Vizcaya;082;Santurtzi;49976;24578;25398
48;Vizcaya;084;Sestao;34496;16816;17680
48;Vizcaya;904;Sondika;3582;1720;1862
48;Vizcaya;085;Sopelana;9460;4729;4731
48;Vizcaya;086;Sopuerta;2268;1153;1115
48;Vizcaya;076;Sukarrieta;314;159;155
48;Vizcaya;087;Trucios-Turtzioz;534;262;272
48;Vizcaya;088;Ubide;161;77;84
48;Vizcaya;065;Ugao-Miraballes;4173;2108;2065
48;Vizcaya;089;Urduliz;2787;1372;1415
48;Vizcaya;074;Urduña-Orduña;3963;2019;1944
48;Vizcaya;080;Valle de Trápaga-Trapagaran;12855;6318;6537
48;Vizcaya;095;Zaldibar;3050;1447;1603
48;Vizcaya;096;Zalla;7518;3699;3819
48;Vizcaya;905;Zamudio;3053;1537;1516
48;Vizcaya;097;Zaratamo;1597;801;796
48;Vizcaya;024;Zeanuri;1135;596;539
48;Vizcaya;025;Zeberio;899;461;438
48;Vizcaya;913;Zierbena;1148;598;550
48;Vizcaya;915;Ziortza-Bolibar;"";"";""
49;Zamora;002;Abezames;118;58;60
49;Zamora;003;Alcañices;1229;599;630
49;Zamora;004;Alcubilla de Nogales;216;108;108
49;Zamora;005;Alfaraz de Sayago;232;121;111
49;Zamora;006;Algodre;218;110;108
49;Zamora;007;Almaraz de Duero;488;242;246
49;Zamora;008;Almeida de Sayago;696;360;336
49;Zamora;009;Andavías;524;255;269
49;Zamora;010;Arcenillas;281;139;142
49;Zamora;011;Arcos de la Polvorosa;320;171;149
49;Zamora;012;Argañín;121;56;65
49;Zamora;013;Argujillo;404;215;189
49;Zamora;014;Arquillinos;207;103;104
49;Zamora;015;Arrabalde;426;209;217
49;Zamora;016;Aspariegos;414;204;210
49;Zamora;017;Asturianos;369;180;189
49;Zamora;018;Ayoó de Vidriales;516;251;265
49;Zamora;019;Barcial del Barco;301;166;135
49;Zamora;020;Belver de los Montes;535;278;257
49;Zamora;021;Benavente;16055;7820;8235
49;Zamora;022;Benegiles;446;234;212
49;Zamora;023;Bermillo de Sayago;1549;793;756
49;Zamora;024;Bóveda de Toro (La);1029;527;502
49;Zamora;025;Bretó;267;142;125
49;Zamora;026;Bretocino;334;181;153
49;Zamora;027;Brime de Sog;266;124;142
49;Zamora;028;Brime de Urz;167;93;74
49;Zamora;029;Burganes de Valverde;927;477;450
49;Zamora;030;Bustillo del Oro;175;86;89
49;Zamora;031;Cabañas de Sayago;219;108;111
49;Zamora;032;Calzadilla de Tera;524;250;274
49;Zamora;033;Camarzana de Tera;1099;539;560
49;Zamora;034;Cañizal;656;345;311
49;Zamora;035;Cañizo;358;178;180
49;Zamora;036;Carbajales de Alba;736;355;381
49;Zamora;037;Carbellino;285;147;138
49;Zamora;038;Casaseca de Campeán;165;85;80
49;Zamora;039;Casaseca de las Chanas;384;195;189
49;Zamora;040;Castrillo de la Guareña;178;88;90
49;Zamora;041;Castrogonzalo;537;280;257
49;Zamora;042;Castronuevo;360;185;175
49;Zamora;043;Castroverde de Campos;435;217;218
49;Zamora;044;Cazurra;108;60;48
49;Zamora;046;Cerecinos de Campos;454;236;218
49;Zamora;047;Cerecinos del Carrizal;172;92;80
49;Zamora;048;Cernadilla;159;74;85
49;Zamora;050;Cobreros;874;433;441
49;Zamora;052;Coomonte;364;186;178
49;Zamora;053;Coreses;1250;642;608
49;Zamora;054;Corrales;1218;586;632
49;Zamora;055;Cotanes del Monte;184;96;88
49;Zamora;056;Cubillos;414;207;207
49;Zamora;057;Cubo de Benavente;204;106;98
49;Zamora;058;Cubo de Tierra del Vino (El);507;254;253
49;Zamora;059;Cuelgamures;155;87;68
49;Zamora;061;Entrala;162;73;89
49;Zamora;062;Espadañedo;220;108;112
49;Zamora;063;Faramontanos de Tábara;526;271;255
49;Zamora;064;Fariza;752;383;369
49;Zamora;065;Fermoselle;1782;856;926
49;Zamora;066;Ferreras de Abajo;662;332;330
49;Zamora;067;Ferreras de Arriba;563;286;277
49;Zamora;068;Ferreruela;703;369;334
49;Zamora;069;Figueruela de Arriba;591;287;304
49;Zamora;071;Fonfría;1226;614;612
49;Zamora;075;Fresno de la Polvorosa;231;109;122
49;Zamora;076;Fresno de la Ribera;430;234;196
49;Zamora;077;Fresno de Sayago;299;148;151
49;Zamora;078;Friera de Valverde;304;154;150
49;Zamora;079;Fuente Encalada;167;83;84
49;Zamora;080;Fuentelapeña;1079;549;530
49;Zamora;082;Fuentes de Ropel;643;325;318
49;Zamora;081;Fuentesaúco;1896;933;963
49;Zamora;083;Fuentesecas;92;45;47
49;Zamora;084;Fuentespreadas;422;230;192
49;Zamora;085;Galende;1416;698;718
49;Zamora;086;Gallegos del Pan;174;90;84
49;Zamora;087;Gallegos del Río;933;486;447
49;Zamora;088;Gamones;106;62;44
49;Zamora;090;Gema;292;148;144
49;Zamora;091;Granja de Moreruela;398;190;208
49;Zamora;092;Granucillo;288;142;146
49;Zamora;093;Guarrate;395;216;179
49;Zamora;094;Hermisende;482;246;236
49;Zamora;095;Hiniesta (La);406;197;209
49;Zamora;096;Jambrina;291;145;146
49;Zamora;097;Justel;188;98;90
49;Zamora;098;Losacino;379;205;174
49;Zamora;099;Losacio;184;96;88
49;Zamora;100;Lubián;397;190;207
49;Zamora;101;Luelmo;280;142;138
49;Zamora;102;Maderal (El);307;159;148
49;Zamora;103;Madridanos;582;293;289
49;Zamora;104;Mahide;602;309;293
49;Zamora;105;Maire de Castroponce;270;138;132
49;Zamora;107;Malva;252;124;128
49;Zamora;108;Manganeses de la Lampreana;861;439;422
49;Zamora;109;Manganeses de la Polvorosa;890;435;455
49;Zamora;110;Manzanal de Arriba;511;258;253
49;Zamora;112;Manzanal de los Infantes;192;100;92
49;Zamora;111;Manzanal del Barco;218;115;103
49;Zamora;113;Matilla de Arzón;281;151;130
49;Zamora;114;Matilla la Seca;74;38;36
49;Zamora;115;Mayalde;246;123;123
49;Zamora;116;Melgar de Tera;617;301;316
49;Zamora;117;Micereces de Tera;680;356;324
49;Zamora;118;Milles de la Polvorosa;304;151;153
49;Zamora;119;Molacillos;321;171;150
49;Zamora;120;Molezuelas de la Carballeda;130;63;67
49;Zamora;121;Mombuey;499;246;253
49;Zamora;122;Monfarracinos;570;298;272
49;Zamora;123;Montamarta;738;353;385
49;Zamora;124;Moral de Sayago;412;224;188
49;Zamora;126;Moraleja de Sayago;308;166;142
49;Zamora;125;Moraleja del Vino;1261;652;609
49;Zamora;128;Morales de Rey;797;389;408
49;Zamora;129;Morales de Toro;1156;589;567
49;Zamora;130;Morales de Valverde;324;157;167
49;Zamora;127;Morales del Vino;1440;736;704
49;Zamora;131;Moralina;393;208;185
49;Zamora;132;Moreruela de los Infanzones;510;267;243
49;Zamora;133;Moreruela de Tábara;572;297;275
49;Zamora;134;Muelas de los Caballeros;244;126;118
49;Zamora;135;Muelas del Pan;944;459;485
49;Zamora;136;Muga de Sayago;541;264;277
49;Zamora;137;Navianos de Valverde;274;144;130
49;Zamora;138;Olmillos de Castro;451;233;218
49;Zamora;139;Otero de Bodas;291;157;134
49;Zamora;141;Pajares de la Lampreana;533;266;267
49;Zamora;143;Palacios de Sanabria;376;182;194
49;Zamora;142;Palacios del Pan;265;121;144
49;Zamora;145;Pedralba de la Pradería;332;153;179
49;Zamora;146;Pego (El);491;246;245
49;Zamora;147;Peleagonzalo;469;238;231
49;Zamora;148;Peleas de Abajo;225;114;111
49;Zamora;149;Peñausende;625;321;304
49;Zamora;150;Peque;254;129;125
49;Zamora;151;Perdigón (El);773;384;389
49;Zamora;152;Pereruela;769;392;377
49;Zamora;153;Perilla de Castro;266;134;132
49;Zamora;154;Pías;255;130;125
49;Zamora;155;Piedrahita de Castro;169;90;79
49;Zamora;156;Pinilla de Toro;423;213;210
49;Zamora;157;Pino del Oro;245;129;116
49;Zamora;158;Piñero (El);329;175;154
49;Zamora;160;Pobladura de Valderaduey;84;38;46
49;Zamora;159;Pobladura del Valle;343;166;177
49;Zamora;162;Porto;363;191;172
49;Zamora;163;Pozoantiguo;392;194;198
49;Zamora;164;Pozuelo de Tábara;258;124;134
49;Zamora;165;Prado;114;54;60
49;Zamora;166;Puebla de Sanabria;1739;840;899
49;Zamora;167;Pueblica de Valverde;364;185;179
49;Zamora;170;Quintanilla de Urz;150;79;71
49;Zamora;168;Quintanilla del Monte;156;72;84
49;Zamora;169;Quintanilla del Olmo;67;30;37
49;Zamora;171;Quiruelas de Vidriales;1017;479;538
49;Zamora;172;Rabanales;935;486;449
49;Zamora;173;Rábano de Aliste;521;256;265
49;Zamora;174;Requejo;230;112;118
49;Zamora;175;Revellinos;358;185;173
49;Zamora;176;Riofrío de Aliste;1135;584;551
49;Zamora;177;Rionegro del Puente;427;207;220
49;Zamora;178;Roales;400;204;196
49;Zamora;179;Robleda-Cervantes;473;219;254
49;Zamora;180;Roelos de Sayago;177;91;86
49;Zamora;181;Rosinos de la Requejada;548;251;297
49;Zamora;183;Salce;167;91;76
49;Zamora;184;Samir de los Caños;262;136;126
49;Zamora;185;San Agustín del Pozo;223;116;107
49;Zamora;186;San Cebrián de Castro;425;197;228
49;Zamora;187;San Cristóbal de Entreviñas;1646;836;810
49;Zamora;188;San Esteban del Molar;196;109;87
49;Zamora;189;San Justo;396;188;208
49;Zamora;190;San Martín de Valderaduey;112;49;63
49;Zamora;191;San Miguel de la Ribera;441;222;219
49;Zamora;192;San Miguel del Valle;259;121;138
49;Zamora;193;San Pedro de Ceque;721;355;366
49;Zamora;194;San Pedro de la Nave-Almendra;540;270;270
49;Zamora;208;San Vicente de la Cabeza;675;359;316
49;Zamora;209;San Vitero;798;414;384
49;Zamora;197;Santa Clara de Avedillo;264;127;137
49;Zamora;199;Santa Colomba de las Monjas;359;182;177
49;Zamora;200;Santa Cristina de la Polvorosa;1314;678;636
49;Zamora;201;Santa Croya de Tera;511;259;252
49;Zamora;202;Santa Eufemia del Barco;307;166;141
49;Zamora;203;Santa María de la Vega;533;280;253
49;Zamora;204;Santa María de Valverde;108;55;53
49;Zamora;205;Santibáñez de Tera;627;322;305
49;Zamora;206;Santibáñez de Vidriales;1437;710;727
49;Zamora;207;Santovenia;462;221;241
49;Zamora;210;Sanzoles;729;376;353
49;Zamora;214;Tábara;987;530;457
49;Zamora;216;Tapioles;258;142;116
49;Zamora;219;Toro;9821;4756;5065
49;Zamora;220;Torre del Valle (La);200;105;95
49;Zamora;221;Torregamones;344;168;176
49;Zamora;222;Torres del Carrizal;555;281;274
49;Zamora;223;Trabazos;1003;509;494
49;Zamora;224;Trefacio;258;122;136
49;Zamora;225;Uña de Quintana;238;121;117
49;Zamora;226;Vadillo de la Guareña;371;193;178
49;Zamora;227;Valcabado;351;177;174
49;Zamora;228;Valdefinjas;96;55;41
49;Zamora;229;Valdescorriel;200;98;102
49;Zamora;230;Vallesa de la Guareña;194;104;90
49;Zamora;231;Vega de Tera;549;260;289
49;Zamora;232;Vega de Villalobos;169;79;90
49;Zamora;233;Vegalatrave;173;92;81
49;Zamora;234;Venialbo;573;298;275
49;Zamora;235;Vezdemarbán;742;357;385
49;Zamora;236;Vidayanes;128;59;69
49;Zamora;237;Videmala;226;111;115
49;Zamora;238;Villabrázaro;430;221;209
49;Zamora;239;Villabuena del Puente;1041;538;503
49;Zamora;240;Villadepera;295;143;152
49;Zamora;241;Villaescusa;401;205;196
49;Zamora;242;Villafáfila;688;334;354
49;Zamora;243;Villaferrueña;168;87;81
49;Zamora;244;Villageriz;74;38;36
49;Zamora;245;Villalazán;408;200;208
49;Zamora;246;Villalba de la Lampreana;346;181;165
49;Zamora;247;Villalcampo;755;361;394
49;Zamora;248;Villalobos;352;167;185
49;Zamora;249;Villalonso;146;72;74
49;Zamora;250;Villalpando;1782;863;919
49;Zamora;251;Villalube;349;176;173
49;Zamora;252;Villamayor de Campos;574;288;286
49;Zamora;255;Villamor de los Escuderos;623;320;303
49;Zamora;256;Villanázar;402;190;212
49;Zamora;257;Villanueva de Azoague;405;207;198
49;Zamora;258;Villanueva de Campeán;207;107;100
49;Zamora;259;Villanueva de las Peras;206;103;103
49;Zamora;260;Villanueva del Campo;1126;555;571
49;Zamora;263;Villar de Fallaves;115;62;53
49;Zamora;264;Villar del Buey;929;504;425
49;Zamora;261;Villaralbo;1595;792;803
49;Zamora;262;Villardeciervos;585;268;317
49;Zamora;265;Villardiegua de la Ribera;182;92;90
49;Zamora;266;Villárdiga;124;59;65
49;Zamora;267;Villardondiego;147;76;71
49;Zamora;268;Villarrín de Campos;669;346;323
49;Zamora;269;Villaseco del Pan;351;173;178
49;Zamora;270;Villavendimio;226;124;102
49;Zamora;272;Villaveza de Valverde;152;77;75
49;Zamora;271;Villaveza del Agua;277;138;139
49;Zamora;273;Viñas;313;162;151
49;Zamora;275;Zamora;63783;30303;33480
50;Zaragoza;001;Abanto;191;103;88
50;Zaragoza;002;Acered;297;152;145
50;Zaragoza;003;Agón;201;107;94
50;Zaragoza;004;Aguarón;746;369;377
50;Zaragoza;005;Aguilón;263;134;129
50;Zaragoza;006;Ainzón;1221;608;613
50;Zaragoza;007;Aladrén;64;37;27
50;Zaragoza;008;Alagón;5595;2785;2810
50;Zaragoza;009;Alarba;166;92;74
50;Zaragoza;010;Alberite de San Juan;107;56;51
50;Zaragoza;011;Albeta;130;61;69
50;Zaragoza;012;Alborge;128;62;66
50;Zaragoza;013;Alcalá de Ebro;312;149;163
50;Zaragoza;014;Alcalá de Moncayo;162;87;75
50;Zaragoza;015;Alconchel de Ariza;171;93;78
50;Zaragoza;016;Aldehuela de Liestos;67;35;32
50;Zaragoza;017;Alfajarín;1450;742;708
50;Zaragoza;018;Alfamén;1319;689;630
50;Zaragoza;019;Alforque;89;46;43
50;Zaragoza;020;Alhama de Aragón;1217;594;623
50;Zaragoza;021;Almochuel;45;26;19
50;Zaragoza;022;Almolda (La);717;354;363
50;Zaragoza;023;Almonacid de la Cuba;355;182;173
50;Zaragoza;024;Almonacid de la Sierra;864;447;417
50;Zaragoza;025;Almunia de Doña Godina (La);5373;2746;2627
50;Zaragoza;026;Alpartir;629;334;295
50;Zaragoza;027;Ambel;371;183;188
50;Zaragoza;028;Anento;73;43;30
50;Zaragoza;029;Aniñón;911;485;426
50;Zaragoza;030;Añón de Moncayo;317;189;128
50;Zaragoza;031;Aranda de Moncayo;254;140;114
50;Zaragoza;032;Arándiga;535;272;263
50;Zaragoza;033;Ardisa;85;43;42
50;Zaragoza;034;Ariza;1385;705;680
50;Zaragoza;035;Artieda;105;56;49
50;Zaragoza;036;Asín;108;50;58
50;Zaragoza;037;Atea;251;140;111
50;Zaragoza;038;Ateca;2059;1009;1050
50;Zaragoza;039;Azuara;759;395;364
50;Zaragoza;040;Badules;122;63;59
50;Zaragoza;041;Bagüés;34;19;15
50;Zaragoza;042;Balconchán;34;17;17
50;Zaragoza;043;Bárboles;317;165;152
50;Zaragoza;044;Bardallur;311;156;155
50;Zaragoza;045;Belchite;1628;833;795
50;Zaragoza;046;Belmonte de Gracián;310;171;139
50;Zaragoza;047;Berdejo;53;29;24
50;Zaragoza;048;Berrueco;38;22;16
50;Zaragoza;901;Biel;204;113;91
50;Zaragoza;050;Bijuesca;148;84;64
50;Zaragoza;051;Biota;1255;644;611
50;Zaragoza;052;Bisimbre;141;63;78
50;Zaragoza;053;Boquiñeni;1028;524;504
50;Zaragoza;054;Bordalba;101;58;43
50;Zaragoza;055;Borja;4174;2027;2147
50;Zaragoza;056;Botorrita;467;247;220
50;Zaragoza;057;Brea de Aragón;2019;1006;1013
50;Zaragoza;058;Bubierca;112;54;58
50;Zaragoza;059;Bujaraloz;1035;541;494
50;Zaragoza;060;Bulbuente;265;141;124
50;Zaragoza;061;Bureta;333;166;167
50;Zaragoza;062;Burgo de Ebro (El);1447;730;717
50;Zaragoza;063;Buste (El);121;65;56
50;Zaragoza;064;Cabañas de Ebro;524;272;252
50;Zaragoza;065;Cabolafuente;86;51;35
50;Zaragoza;066;Cadrete;1243;653;590
50;Zaragoza;067;Calatayud;17078;8155;8923
50;Zaragoza;068;Calatorao;2692;1381;1311
50;Zaragoza;069;Calcena;102;53;49
50;Zaragoza;070;Calmarza;94;44;50
50;Zaragoza;071;Campillo de Aragón;214;120;94
50;Zaragoza;072;Carenas;251;123;128
50;Zaragoza;073;Cariñena;2852;1433;1419
50;Zaragoza;074;Caspe;7770;3816;3954
50;Zaragoza;075;Castejón de Alarba;121;67;54
50;Zaragoza;076;Castejón de las Armas;154;74;80
50;Zaragoza;077;Castejón de Valdejasa;351;186;165
50;Zaragoza;078;Castiliscar;437;219;218
50;Zaragoza;079;Cervera de la Cañada;354;173;181
50;Zaragoza;080;Cerveruela;6;3;3
50;Zaragoza;081;Cetina;761;375;386
50;Zaragoza;092;Chiprana;406;200;206
50;Zaragoza;093;Chodes;131;64;67
50;Zaragoza;082;Cimballa;141;72;69
50;Zaragoza;083;Cinco Olivas;134;65;69
50;Zaragoza;084;Clarés de Ribota;101;53;48
50;Zaragoza;085;Codo;299;148;151
50;Zaragoza;086;Codos;306;177;129
50;Zaragoza;087;Contamina;61;32;29
50;Zaragoza;088;Cosuenda;431;219;212
50;Zaragoza;089;Cuarte de Huerva;1720;887;833
50;Zaragoza;090;Cubel;249;122;127
50;Zaragoza;091;Cuerlas (Las);103;53;50
50;Zaragoza;094;Daroca;2335;1152;1183
50;Zaragoza;095;Ejea de los Caballeros;15227;7757;7470
50;Zaragoza;096;Embid de Ariza;64;34;30
50;Zaragoza;098;Encinacorba;347;184;163
50;Zaragoza;099;Épila;3957;2021;1936
50;Zaragoza;100;Erla;484;235;249
50;Zaragoza;101;Escatrón;1371;675;696
50;Zaragoza;102;Fabara;1261;666;595
50;Zaragoza;104;Farlete;468;235;233
50;Zaragoza;105;Fayón;392;206;186
50;Zaragoza;106;Fayos (Los);201;111;90
50;Zaragoza;107;Figueruelas;955;479;476
50;Zaragoza;108;Fombuena;21;16;5
50;Zaragoza;109;Frago (El);106;65;41
50;Zaragoza;110;Frasno (El);573;300;273
50;Zaragoza;111;Fréscano;261;124;137
50;Zaragoza;113;Fuendejalón;935;469;466
50;Zaragoza;114;Fuendetodos;154;88;66
50;Zaragoza;115;Fuentes de Ebro;3763;1950;1813
50;Zaragoza;116;Fuentes de Jiloca;372;192;180
50;Zaragoza;117;Gallocanta;191;97;94
50;Zaragoza;118;Gallur;2992;1491;1501
50;Zaragoza;119;Gelsa;1289;653;636
50;Zaragoza;120;Godojos;77;40;37
50;Zaragoza;121;Gotor;392;207;185
50;Zaragoza;122;Grisel;65;34;31
50;Zaragoza;123;Grisén;480;237;243
50;Zaragoza;124;Herrera de los Navarros;605;317;288
50;Zaragoza;125;Ibdes;620;312;308
50;Zaragoza;126;Illueca;3282;1601;1681
50;Zaragoza;128;Isuerre;67;37;30
50;Zaragoza;129;Jaraba;329;169;160
50;Zaragoza;130;Jarque;591;318;273
50;Zaragoza;131;Jaulín;306;158;148
50;Zaragoza;132;Joyosa (La);363;186;177
50;Zaragoza;133;Lagata;157;83;74
50;Zaragoza;134;Langa del Castillo;190;91;99
50;Zaragoza;135;Layana;159;78;81
50;Zaragoza;136;Lécera;879;425;454
50;Zaragoza;138;Lechón;58;34;24
50;Zaragoza;137;Leciñena;1413;698;715
50;Zaragoza;139;Letux;506;257;249
50;Zaragoza;140;Litago;183;103;80
50;Zaragoza;141;Lituénigo;122;60;62
50;Zaragoza;142;Lobera de Onsella;66;37;29
50;Zaragoza;143;Longares;870;446;424
50;Zaragoza;144;Longás;42;26;16
50;Zaragoza;146;Lucena de Jalón;273;138;135
50;Zaragoza;147;Luceni;1074;534;540
50;Zaragoza;148;Luesia;440;228;212
50;Zaragoza;149;Luesma;22;12;10
50;Zaragoza;150;Lumpiaque;962;497;465
50;Zaragoza;151;Luna;961;505;456
50;Zaragoza;152;Maella;2079;1051;1028
50;Zaragoza;153;Magallón;1243;650;593
50;Zaragoza;154;Mainar;194;101;93
50;Zaragoza;155;Malanquilla;139;72;67
50;Zaragoza;156;Maleján;314;165;149
50;Zaragoza;160;Mallén;2963;1524;1439
50;Zaragoza;157;Malón;491;253;238
50;Zaragoza;159;Maluenda;1031;496;535
50;Zaragoza;161;Manchones;162;79;83
50;Zaragoza;162;Mara;214;111;103
50;Zaragoza;163;María de Huerva;849;407;442
50;Zaragoza;902;Marracos;"";"";""
50;Zaragoza;164;Mediana de Aragón;515;262;253
50;Zaragoza;165;Mequinenza;2582;1285;1297
50;Zaragoza;166;Mesones de Isuela;392;194;198
50;Zaragoza;167;Mezalocha;318;171;147
50;Zaragoza;168;Mianos;37;20;17
50;Zaragoza;169;Miedes de Aragón;532;273;259
50;Zaragoza;170;Monegrillo;553;300;253
50;Zaragoza;171;Moneva;127;62;65
50;Zaragoza;172;Monreal de Ariza;324;166;158
50;Zaragoza;173;Monterde;238;119;119
50;Zaragoza;174;Montón;140;71;69
50;Zaragoza;175;Morata de Jalón;1614;806;808
50;Zaragoza;176;Morata de Jiloca;359;192;167
50;Zaragoza;177;Morés;518;272;246
50;Zaragoza;178;Moros;555;279;276
50;Zaragoza;179;Moyuela;365;180;185
50;Zaragoza;180;Mozota;115;55;60
50;Zaragoza;181;Muel;1128;563;565
50;Zaragoza;182;Muela (La);1098;568;530
50;Zaragoza;183;Munébrega;485;258;227
50;Zaragoza;184;Murero;144;84;60
50;Zaragoza;185;Murillo de Gállego;139;82;57
50;Zaragoza;186;Navardún;64;33;31
50;Zaragoza;187;Nigüella;123;64;59
50;Zaragoza;188;Nombrevilla;33;18;15
50;Zaragoza;189;Nonaspe;1100;557;543
50;Zaragoza;190;Novallas;773;376;397
50;Zaragoza;191;Novillas;713;366;347
50;Zaragoza;192;Nuévalos;297;170;127
50;Zaragoza;193;Nuez de Ebro;550;292;258
50;Zaragoza;194;Olvés;178;96;82
50;Zaragoza;195;Orcajo;47;23;24
50;Zaragoza;196;Orera;143;73;70
50;Zaragoza;197;Orés;108;63;45
50;Zaragoza;198;Oseja;60;32;28
50;Zaragoza;199;Osera de Ebro;361;174;187
50;Zaragoza;200;Paniza;702;343;359
50;Zaragoza;201;Paracuellos de Jiloca;512;231;281
50;Zaragoza;202;Paracuellos de la Ribera;331;158;173
50;Zaragoza;203;Pastriz;893;438;455
50;Zaragoza;204;Pedrola;2582;1331;1251
50;Zaragoza;205;Pedrosas (Las);109;51;58
50;Zaragoza;206;Perdiguera;447;235;212
50;Zaragoza;207;Piedratajada;200;101;99
50;Zaragoza;208;Pina de Ebro;2187;1088;1099
50;Zaragoza;209;Pinseque;1472;733;739
50;Zaragoza;210;Pintanos (Los);88;44;44
50;Zaragoza;211;Plasencia de Jalón;361;193;168
50;Zaragoza;212;Pleitas;74;41;33
50;Zaragoza;213;Plenas;167;84;83
50;Zaragoza;214;Pomer;22;12;10
50;Zaragoza;215;Pozuel de Ariza;29;20;9
50;Zaragoza;216;Pozuelo de Aragón;367;202;165
50;Zaragoza;217;Pradilla de Ebro;652;338;314
50;Zaragoza;218;Puebla de Albortón;158;81;77
50;Zaragoza;219;Puebla de Alfindén (La);1578;819;759
50;Zaragoza;220;Puendeluna;61;35;26
50;Zaragoza;221;Purujosa;34;25;9
50;Zaragoza;222;Quinto;2152;1083;1069
50;Zaragoza;223;Remolinos;1253;637;616
50;Zaragoza;224;Retascón;76;42;34
50;Zaragoza;225;Ricla;2043;1061;982
50;Zaragoza;227;Romanos;154;90;64
50;Zaragoza;228;Rueda de Jalón;358;184;174
50;Zaragoza;229;Ruesca;93;48;45
50;Zaragoza;241;Sabiñán;997;486;511
50;Zaragoza;230;Sádaba;1722;875;847
50;Zaragoza;231;Salillas de Jalón;372;194;178
50;Zaragoza;232;Salvatierra de Esca;291;149;142
50;Zaragoza;233;Samper del Salz;149;75;74
50;Zaragoza;234;San Martín de la Virgen de Moncayo;314;162;152
50;Zaragoza;235;San Mateo de Gállego;2031;1056;975
50;Zaragoza;236;Santa Cruz de Grío;238;130;108
50;Zaragoza;237;Santa Cruz de Moncayo;101;51;50
50;Zaragoza;238;Santa Eulalia de Gállego;138;65;73
50;Zaragoza;239;Santed;83;37;46
50;Zaragoza;240;Sástago;1510;757;753
50;Zaragoza;242;Sediles;111;56;55
50;Zaragoza;243;Sestrica;485;250;235
50;Zaragoza;244;Sierra de Luna;275;136;139
50;Zaragoza;245;Sigüés;185;96;89
50;Zaragoza;246;Sisamón;89;54;35
50;Zaragoza;247;Sobradiel;596;283;313
50;Zaragoza;248;Sos del Rey Católico;850;422;428
50;Zaragoza;249;Tabuenca;497;271;226
50;Zaragoza;250;Talamantes;67;37;30
50;Zaragoza;251;Tarazona;10365;4993;5372
50;Zaragoza;252;Tauste;7017;3484;3533
50;Zaragoza;253;Terrer;708;340;368
50;Zaragoza;254;Tierga;265;143;122
50;Zaragoza;255;Tobed;299;142;157
50;Zaragoza;256;Torralba de los Frailes;112;54;58
50;Zaragoza;257;Torralba de Ribota;237;135;102
50;Zaragoza;258;Torralbilla;77;40;37
50;Zaragoza;259;Torrehermosa;119;65;54
50;Zaragoza;260;Torrelapaja;48;24;24
50;Zaragoza;261;Torrellas;336;174;162
50;Zaragoza;262;Torres de Berrellén;1402;704;698
50;Zaragoza;263;Torrijo de la Cañada;426;223;203
50;Zaragoza;264;Tosos;211;106;105
50;Zaragoza;265;Trasmoz;67;33;34
50;Zaragoza;266;Trasobares;249;136;113
50;Zaragoza;267;Uncastillo;967;474;493
50;Zaragoza;268;Undués de Lerda;59;35;24
50;Zaragoza;269;Urrea de Jalón;354;181;173
50;Zaragoza;270;Urriés;88;53;35
50;Zaragoza;271;Used;404;216;188
50;Zaragoza;272;Utebo;9075;4574;4501
50;Zaragoza;274;Val de San Martín;74;34;40
50;Zaragoza;273;Valdehorna;62;32;30
50;Zaragoza;275;Valmadrid;63;34;29
50;Zaragoza;276;Valpalmas;203;103;100
50;Zaragoza;277;Valtorres;102;48;54
50;Zaragoza;278;Velilla de Ebro;290;146;144
50;Zaragoza;279;Velilla de Jiloca;130;64;66
50;Zaragoza;280;Vera de Moncayo;483;245;238
50;Zaragoza;281;Vierlas;106;50;56
50;Zaragoza;283;Villadoz;87;47;40
50;Zaragoza;284;Villafeliche;241;122;119
50;Zaragoza;285;Villafranca de Ebro;688;335;353
50;Zaragoza;286;Villalba de Perejil;126;68;58
50;Zaragoza;287;Villalengua;453;241;212
50;Zaragoza;903;Villamayor de Gállego;"";"";""
50;Zaragoza;288;Villanueva de Gállego;2734;1373;1361
50;Zaragoza;290;Villanueva de Huerva;617;313;304
50;Zaragoza;289;Villanueva de Jiloca;127;67;60
50;Zaragoza;291;Villar de los Navarros;158;80;78
50;Zaragoza;292;Villarreal de Huerva;181;104;77
50;Zaragoza;293;Villarroya de la Sierra;725;370;355
50;Zaragoza;294;Villarroya del Campo;83;40;43
50;Zaragoza;282;Vilueña (La);103;47;56
50;Zaragoza;295;Vistabella;34;18;16
50;Zaragoza;296;Zaida (La);619;317;302
50;Zaragoza;297;Zaragoza;601674;289654;312020
50;Zaragoza;298;Zuera;5374;2754;2620
51;Ceuta;001;Ceuta;68796;34229;34567
52;Melilla;001;Melilla;59576;29647;29929
