01;Álava;001;Alegría-Dulantzi;1016;514;502
01;Álava;002;Amurrio;9645;4829;4816
01;Álava;049;Añana;196;101;95
01;Álava;003;Aramaio;1369;721;648
01;Álava;006;Armiñón;155;78;77
01;Álava;037;Arraia-Maeztu;827;437;390
01;Álava;008;Arrazua-Ubarrundia;625;334;291
01;Álava;004;Artziniega;1167;573;594
01;Álava;009;Asparrena;1561;776;785
01;Álava;010;Ayala/Aiara;2117;1028;1089
01;Álava;011;Baños de Ebro/Mañueta;352;187;165
01;Álava;013;Barrundia;591;333;258
01;Álava;014;Berantevilla;432;217;215
01;Álava;016;Bernedo;601;334;267
01;Álava;017;Campezo/Kanpezu;1213;637;576
01;Álava;021;Elburgo/Burgelu;206;110;96
01;Álava;022;Elciego;912;456;456
01;Álava;023;Elvillar/Bilar;385;198;187
01;Álava;056;Harana/Valle de Arana;431;232;199
01;Álava;901;Iruña Oka/Iruña de Oca;1563;815;748
01;Álava;027;Iruraiz-Gauna;475;260;215
01;Álava;019;Kripan;200;106;94
01;Álava;020;Kuartango;340;190;150
01;Álava;028;Labastida;987;533;454
01;Álava;030;Lagrán;206;110;96
01;Álava;031;Laguardia;1498;777;721
01;Álava;032;Lanciego/Lantziego;618;332;286
01;Álava;902;Lantarón;856;440;416
01;Álava;033;Lapuebla de Labarca;853;432;421
01;Álava;058;Legutiano;1304;716;588
01;Álava;034;Leza;205;110;95
01;Álava;036;Llodio;21052;10704;10348
01;Álava;039;Moreda de Álava;286;153;133
01;Álava;041;Navaridas;220;118;102
01;Álava;042;Okondo;783;419;364
01;Álava;043;Oyón/Oion;2268;1136;1132
01;Álava;044;Peñacerrada-Urizaharra;237;133;104
01;Álava;046;Ribera Alta;541;317;224
01;Álava;047;Ribera Baja/Erribera Beitia;396;213;183
01;Álava;051;Salvatierra/Agurain;3650;1841;1809
01;Álava;052;Samaniego;303;150;153
01;Álava;053;San Millán/Donemiliaga;777;411;366
01;Álava;054;Urkabustaiz;889;454;435
01;Álava;055;Valdegovía;883;496;387
01;Álava;057;Villabuena de Álava/Eskuernaga;357;183;174
01;Álava;059;Vitoria-Gasteiz;204264;101424;102840
01;Álava;060;Yécora/Lekora;255;129;126
01;Álava;061;Zalduondo;122;65;57
01;Álava;062;Zambrana;343;181;162
01;Álava;018;Zigoitia;763;417;346
01;Álava;063;Zuia;1268;625;643
02;Albacete;001;Abengibre;1125;559;566
02;Albacete;002;Alatoz;803;423;380
02;Albacete;003;Albacete;125997;61940;64057
02;Albacete;004;Albatana;941;475;466
02;Albacete;005;Alborea;914;458;456
02;Albacete;006;Alcadozo;924;471;453
02;Albacete;007;Alcalá del Júcar;1837;933;904
02;Albacete;008;Alcaraz;2104;1038;1066
02;Albacete;009;Almansa;22040;10760;11280
02;Albacete;010;Alpera;2380;1220;1160
02;Albacete;011;Ayna;1479;746;733
02;Albacete;012;Balazote;2226;1116;1110
02;Albacete;014;Ballestero (El);768;380;388
02;Albacete;013;Balsa de Ves;309;154;155
02;Albacete;015;Barrax;2071;1035;1036
02;Albacete;016;Bienservida;1225;638;587
02;Albacete;017;Bogarra;1793;941;852
02;Albacete;018;Bonete;1306;656;650
02;Albacete;019;Bonillo (El);3434;1702;1732
02;Albacete;020;Carcelén;869;428;441
02;Albacete;021;Casas de Juan Núñez;1335;680;655
02;Albacete;022;Casas de Lázaro;560;293;267
02;Albacete;023;Casas de Ves;1342;683;659
02;Albacete;024;Casas-Ibáñez;3936;1976;1960
02;Albacete;025;Caudete;8261;4101;4160
02;Albacete;026;Cenizate;1113;570;543
02;Albacete;029;Chinchilla de Monte-Aragón;3518;1816;1702
02;Albacete;027;Corral-Rubio;559;287;272
02;Albacete;028;Cotillas;311;161;150
02;Albacete;030;Elche de la Sierra;4136;2015;2121
02;Albacete;032;Fuensanta;464;219;245
02;Albacete;033;Fuente-Álamo;2588;1318;1270
02;Albacete;034;Fuentealbilla;1926;982;944
02;Albacete;031;Férez;997;492;505
02;Albacete;035;Gineta (La);2368;1136;1232
02;Albacete;036;Golosalvo;157;75;82
02;Albacete;037;Hellín;24881;12287;12594
02;Albacete;038;Herrera (La);477;257;220
02;Albacete;039;Higueruela;1414;704;710
02;Albacete;040;Hoya-Gonzalo;768;396;372
02;Albacete;041;Jorquera;794;418;376
02;Albacete;042;Letur;1783;912;871
02;Albacete;043;Lezuza;2230;1137;1093
02;Albacete;044;Liétor;2024;1049;975
02;Albacete;045;Madrigueras;4512;2267;2245
02;Albacete;046;Mahora;1490;735;755
02;Albacete;047;Masegoso;333;186;147
02;Albacete;048;Minaya;2103;1062;1041
02;Albacete;049;Molinicos;1988;1020;968
02;Albacete;050;Montalvos;170;89;81
02;Albacete;051;Montealegre del Castillo;2254;1115;1139
02;Albacete;052;Motilleja;553;271;282
02;Albacete;053;Munera;4315;2210;2105
02;Albacete;054;Navas de Jorquera;617;319;298
02;Albacete;055;Nerpio;2406;1259;1147
02;Albacete;056;Ontur;2795;1358;1437
02;Albacete;057;Ossa de Montiel;2872;1472;1400
02;Albacete;058;Paterna del Madera;728;379;349
02;Albacete;060;Peñas de San Pedro;1520;795;725
02;Albacete;059;Peñascosa;574;302;272
02;Albacete;061;Pétrola;1219;613;606
02;Albacete;062;Povedilla;829;429;400
02;Albacete;064;Pozo-Lorente;548;269;279
02;Albacete;063;Pozohondo;2167;1101;1066
02;Albacete;065;Pozuelo;724;362;362
02;Albacete;066;Recueja (La);464;237;227
02;Albacete;067;Riópar;1461;751;710
02;Albacete;068;Robledo;532;282;250
02;Albacete;069;Roda (La);12845;6441;6404
02;Albacete;070;Salobre;759;401;358
02;Albacete;071;San Pedro;1465;745;720
02;Albacete;072;Socovos;2382;1206;1176
02;Albacete;073;Tarazona de la Mancha;5990;3010;2980
02;Albacete;074;Tobarra;7625;3779;3846
02;Albacete;075;Valdeganga;2366;1189;1177
02;Albacete;076;Vianos;566;293;273
02;Albacete;077;Villa de Ves;50;26;24
02;Albacete;078;Villalgordo del Júcar;1336;660;676
02;Albacete;079;Villamalea;3457;1815;1642
02;Albacete;080;Villapalacios;1112;556;556
02;Albacete;081;Villarrobledo;21093;10421;10672
02;Albacete;082;Villatoya;242;134;108
02;Albacete;083;Villavaliente;365;186;179
02;Albacete;084;Villaverde de Guadalimar;747;417;330
02;Albacete;085;Viveros;698;362;336
02;Albacete;086;Yeste;5299;2747;2552
03;Alicante/Alacant;001;Adsubia;555;277;278
03;Alicante/Alacant;002;Agost;3845;1934;1911
03;Alicante/Alacant;003;Agres;713;368;345
03;Alicante/Alacant;004;Aigües;344;164;180
03;Alicante/Alacant;005;Albatera;8860;4452;4408
03;Alicante/Alacant;006;Alcalalí;638;324;314
03;Alicante/Alacant;007;Alcocer de Planes;113;53;60
03;Alicante/Alacant;008;Alcoleja;337;154;183
03;Alicante/Alacant;009;Alcoy/Alcoi;66074;31839;34235
03;Alicante/Alacant;010;Alfafara;406;198;208
03;Alicante/Alacant;011;Alfàs del Pi (L');7223;3550;3673
03;Alicante/Alacant;012;Algorfa;1131;566;565
03;Alicante/Alacant;013;Algueña;1525;744;781
03;Alicante/Alacant;014;Alicante/Alacant;261051;126140;134911
03;Alicante/Alacant;015;Almoradí;14210;7140;7070
03;Alicante/Alacant;016;Almudaina;145;66;79
03;Alicante/Alacant;017;Alquería d'Asnar (L');413;206;207
03;Alicante/Alacant;018;Altea;12329;6089;6240
03;Alicante/Alacant;019;Aspe;15784;7812;7972
03;Alicante/Alacant;020;Balones;173;77;96
03;Alicante/Alacant;021;Banyeres de Mariola;7007;3468;3539
03;Alicante/Alacant;022;Benasau;227;110;117
03;Alicante/Alacant;023;Beneixama;1855;919;936
03;Alicante/Alacant;024;Benejúzar;4548;2269;2279
03;Alicante/Alacant;025;Benferri;956;476;480
03;Alicante/Alacant;026;Beniarbeig;1188;591;597
03;Alicante/Alacant;027;Beniardá;251;119;132
03;Alicante/Alacant;028;Beniarrés;1590;788;802
03;Alicante/Alacant;030;Benidoleig;786;373;413
03;Alicante/Alacant;031;Benidorm;38044;18939;19105
03;Alicante/Alacant;032;Benifallim;198;99;99
03;Alicante/Alacant;033;Benifato;125;61;64
03;Alicante/Alacant;029;Benigembla;388;192;196
03;Alicante/Alacant;034;Benijófar;1388;644;744
03;Alicante/Alacant;035;Benilloba;954;483;471
03;Alicante/Alacant;036;Benillup;75;39;36
03;Alicante/Alacant;037;Benimantell;435;211;224
03;Alicante/Alacant;038;Benimarfull;407;191;216
03;Alicante/Alacant;039;Benimassot;112;55;57
03;Alicante/Alacant;040;Benimeli;348;169;179
03;Alicante/Alacant;041;Benissa;7484;3719;3765
03;Alicante/Alacant;042;Benitachell/Poble Nou de Benitatxell (el);1611;808;803
03;Alicante/Alacant;043;Biar;3424;1668;1756
03;Alicante/Alacant;044;Bigastro;4378;2237;2141
03;Alicante/Alacant;045;Bolulla;268;134;134
03;Alicante/Alacant;046;Busot;757;371;386
03;Alicante/Alacant;048;Callosa d'En Sarrià;7841;3883;3958
03;Alicante/Alacant;049;Callosa de Segura;15383;7684;7699
03;Alicante/Alacant;047;Calpe/Calp;10732;5351;5381
03;Alicante/Alacant;050;Campello (El);10059;4981;5078
03;Alicante/Alacant;051;Campo de Mirra/Camp de Mirra (el);384;188;196
03;Alicante/Alacant;053;Castalla;7151;3541;3610
03;Alicante/Alacant;054;Castell de Castells;598;299;299
03;Alicante/Alacant;055;Catral;4457;2222;2235
03;Alicante/Alacant;052;Cañada;1076;523;553
03;Alicante/Alacant;056;Cocentaina;10408;5101;5307
03;Alicante/Alacant;057;Confrides;330;180;150
03;Alicante/Alacant;058;Cox;5314;2705;2609
03;Alicante/Alacant;059;Crevillent;22122;11192;10930
03;Alicante/Alacant;061;Daya Nueva;1210;604;606
03;Alicante/Alacant;062;Daya Vieja;244;121;123
03;Alicante/Alacant;064;Dolores;5792;2890;2902
03;Alicante/Alacant;063;Dénia;24271;11895;12376
03;Alicante/Alacant;065;Elche/Elx;180256;89389;90867
03;Alicante/Alacant;066;Elda;56756;27818;28938
03;Alicante/Alacant;067;Facheca;146;77;69
03;Alicante/Alacant;068;Famorca;81;34;47
03;Alicante/Alacant;069;Finestrat;1101;550;551
03;Alicante/Alacant;070;Formentera del Segura;1898;940;958
03;Alicante/Alacant;072;Gaianes;332;161;171
03;Alicante/Alacant;071;Gata de Gorgos;5151;2574;2577
03;Alicante/Alacant;073;Gorga;306;153;153
03;Alicante/Alacant;074;Granja de Rocamora;1888;955;933
03;Alicante/Alacant;075;Guadalest;169;87;82
03;Alicante/Alacant;076;Guardamar del Segura;6389;3115;3274
03;Alicante/Alacant;077;Hondón de las Nieves;1516;751;765
03;Alicante/Alacant;078;Hondón de los Frailes;553;274;279
03;Alicante/Alacant;079;Ibi;20645;10233;10412
03;Alicante/Alacant;080;Jacarilla;1414;708;706
03;Alicante/Alacant;081;Jalón/Xaló;1767;864;903
03;Alicante/Alacant;083;Jijona/Xixona;7614;3604;4010
03;Alicante/Alacant;082;Jávea/Xàbia;13431;6626;6805
03;Alicante/Alacant;085;Llíber;424;209;215
03;Alicante/Alacant;084;Lorcha/Orxa (L');914;462;452
03;Alicante/Alacant;086;Millena;132;64;68
03;Alicante/Alacant;088;Monforte del Cid;4874;2503;2371
03;Alicante/Alacant;903;Montesinos (Los);"";"";""
03;Alicante/Alacant;089;Monóvar/Monòver;11916;5788;6128
03;Alicante/Alacant;091;Murla;362;156;206
03;Alicante/Alacant;092;Muro de Alcoy;6459;3245;3214
03;Alicante/Alacant;090;Mutxamel;8826;4438;4388
03;Alicante/Alacant;093;Novelda;21918;10795;11123
03;Alicante/Alacant;094;Nucia (la);5486;2699;2787
03;Alicante/Alacant;095;Ondara;4725;2326;2399
03;Alicante/Alacant;096;Onil;6632;3322;3310
03;Alicante/Alacant;097;Orba;1544;729;815
03;Alicante/Alacant;099;Orihuela;46371;22653;23718
03;Alicante/Alacant;098;Orxeta;464;229;235
03;Alicante/Alacant;100;Parcent;661;336;325
03;Alicante/Alacant;101;Pedreguer;5712;2766;2946
03;Alicante/Alacant;102;Pego;9437;4686;4751
03;Alicante/Alacant;103;Penàguila;372;185;187
03;Alicante/Alacant;104;Petrer;22707;11318;11389
03;Alicante/Alacant;902;Pilar de la Horadada;6650;3371;3279
03;Alicante/Alacant;105;Pinoso;5589;2769;2820
03;Alicante/Alacant;106;Planes;839;417;422
03;Alicante/Alacant;901;Poblets (Els);1066;509;557
03;Alicante/Alacant;107;Polop;1889;925;964
03;Alicante/Alacant;060;Quatretondeta;229;113;116
03;Alicante/Alacant;109;Rafal;2544;1261;1283
03;Alicante/Alacant;111;Redován;4902;2495;2407
03;Alicante/Alacant;112;Relleu;856;433;423
03;Alicante/Alacant;113;Rojales;5094;2555;2539
03;Alicante/Alacant;114;Romana (La);1989;1013;976
03;Alicante/Alacant;110;Ràfol d'Almúnia (El);368;178;190
03;Alicante/Alacant;115;Sagra;392;184;208
03;Alicante/Alacant;116;Salinas;1088;568;520
03;Alicante/Alacant;118;San Fulgencio;1593;798;795
03;Alicante/Alacant;904;San Isidro;"";"";""
03;Alicante/Alacant;120;San Miguel de Salinas;2447;1253;1194
03;Alicante/Alacant;122;San Vicente del Raspeig/Sant Vicent del Raspeig;26315;13056;13259
03;Alicante/Alacant;117;Sanet y Negrals;552;251;301
03;Alicante/Alacant;119;Sant Joan d'Alacant;12496;6167;6329
03;Alicante/Alacant;121;Santa Pola;13867;6918;6949
03;Alicante/Alacant;123;Sax;8081;4040;4041
03;Alicante/Alacant;124;Sella;609;311;298
03;Alicante/Alacant;125;Senija;431;223;208
03;Alicante/Alacant;128;Teulada;4833;2375;2458
03;Alicante/Alacant;129;Tibi;1033;515;518
03;Alicante/Alacant;130;Tollos;46;28;18
03;Alicante/Alacant;131;Tormos;253;132;121
03;Alicante/Alacant;132;Torremanzanas/Torre de les Maçanes (la);749;356;393
03;Alicante/Alacant;133;Torrevieja;18908;9239;9669
03;Alicante/Alacant;127;Tárbena;705;362;343
03;Alicante/Alacant;134;Vall d'Alcalà (La);160;78;82
03;Alicante/Alacant;135;Vall de Ebo;381;190;191
03;Alicante/Alacant;136;Vall de Gallinera;798;401;397
03;Alicante/Alacant;137;Vall de Laguar (La);1008;501;507
03;Alicante/Alacant;138;Verger (El);3659;1776;1883
03;Alicante/Alacant;139;Villajoyosa/Vila Joiosa (La);22609;11107;11502
03;Alicante/Alacant;140;Villena;30674;15185;15489
04;Almería;001;Abla;1712;831;881
04;Almería;002;Abrucena;1560;778;782
04;Almería;003;Adra;19811;9892;9919
04;Almería;004;Albánchez;847;412;435
04;Almería;005;Alboloduy;996;462;534
04;Almería;006;Albox;10354;5246;5108
04;Almería;007;Alcolea;862;430;432
04;Almería;008;Alcóntar;686;343;343
04;Almería;009;Alcudia de Monteagud;208;91;117
04;Almería;010;Alhabia;876;437;439
04;Almería;011;Alhama de Almería;3105;1549;1556
04;Almería;012;Alicún;245;111;134
04;Almería;013;Almería;157644;76556;81088
04;Almería;014;Almócita;226;112;114
04;Almería;015;Alsodux;130;54;76
04;Almería;016;Antas;2558;1282;1276
04;Almería;017;Arboleas;1534;750;784
04;Almería;018;Armuña de Almanzora;350;165;185
04;Almería;019;Bacares;337;180;157
04;Almería;020;Bayárcal;446;235;211
04;Almería;021;Bayarque;255;124;131
04;Almería;022;Bédar;571;297;274
04;Almería;023;Beires;176;81;95
04;Almería;024;Benahadux;2094;1012;1082
04;Almería;026;Benitagla;121;59;62
04;Almería;027;Benizalón;432;223;209
04;Almería;028;Bentarique;345;175;170
04;Almería;029;Berja;11790;5809;5981
04;Almería;030;Canjáyar;2142;1062;1080
04;Almería;031;Cantoria;3375;1693;1682
04;Almería;032;Carboneras;5782;3016;2766
04;Almería;033;Castro de Filabres;160;78;82
04;Almería;036;Chercos;362;177;185
04;Almería;037;Chirivel;2059;1042;1017
04;Almería;034;Cóbdar;307;160;147
04;Almería;035;Cuevas del Almanzora;9056;4518;4538
04;Almería;038;Dalías;3616;1793;1823
04;Almería;039;Darrical;428;216;212
04;Almería;902;Ejido (El);38646;19592;19054
04;Almería;041;Enix;239;112;127
04;Almería;043;Felix;665;301;364
04;Almería;044;Fines;1546;778;768
04;Almería;045;Fiñana;2769;1334;1435
04;Almería;046;Fondón;1013;516;497
04;Almería;047;Gádor;2533;1231;1302
04;Almería;048;Gallardos (Los);1681;857;824
04;Almería;049;Garrucha;3915;2008;1907
04;Almería;050;Gérgal;1227;603;624
04;Almería;051;Huécija;587;291;296
04;Almería;052;Huércal de Almería;3832;1887;1945
04;Almería;053;Huércal-Overa;13002;6415;6587
04;Almería;054;Illar;545;249;296
04;Almería;055;Instinción;663;325;338
04;Almería;056;Laroya;166;87;79
04;Almería;057;Láujar de Andarax;1896;933;963
04;Almería;058;Líjar;568;286;282
04;Almería;059;Lubrín;2198;1068;1130
04;Almería;060;Lucainena de las Torres;668;327;341
04;Almería;061;Lúcar;817;408;409
04;Almería;062;Macael;5687;2863;2824
04;Almería;063;María;1874;974;900
04;Almería;064;Mojácar;3217;1613;1604
04;Almería;903;Mojonera (La);5338;2715;2623
04;Almería;065;Nacimiento;580;295;285
04;Almería;066;Níjar;12464;6349;6115
04;Almería;067;Ohanes;946;471;475
04;Almería;068;Olula de Castro;245;132;113
04;Almería;069;Olula del Río;5198;2600;2598
04;Almería;070;Oria;2637;1317;1320
04;Almería;071;Padules;590;308;282
04;Almería;072;Partaloa;482;242;240
04;Almería;073;Paterna del Río;451;224;227
04;Almería;074;Pechina;2106;1030;1076
04;Almería;075;Pulpí;4370;2195;2175
04;Almería;076;Purchena;1837;920;917
04;Almería;077;Rágol;483;238;245
04;Almería;078;Rioja;1182;576;606
04;Almería;079;Roquetas de Mar;24609;12364;12245
04;Almería;080;Santa Cruz de Marchena;270;121;149
04;Almería;081;Santa Fe de Mondújar;441;219;222
04;Almería;082;Senés;513;265;248
04;Almería;083;Serón;3223;1600;1623
04;Almería;084;Sierro;725;377;348
04;Almería;085;Somontín;562;287;275
04;Almería;086;Sorbas;3009;1509;1500
04;Almería;087;Suflí;259;136;123
04;Almería;088;Tabernas;3240;1609;1631
04;Almería;089;Taberno;1036;510;526
04;Almería;090;Tahal;589;292;297
04;Almería;091;Terque;518;255;263
04;Almería;092;Tíjola;3567;1809;1758
04;Almería;901;Tres Villas (Las);716;387;329
04;Almería;093;Turre;2082;1012;1070
04;Almería;094;Turrillas;291;154;137
04;Almería;095;Uleila del Campo;1046;530;516
04;Almería;096;Urrácal;396;191;205
04;Almería;097;Velefique;440;220;220
04;Almería;098;Vélez-Blanco;2587;1309;1278
04;Almería;099;Vélez-Rubio;6693;3252;3441
04;Almería;100;Vera;5654;2754;2900
04;Almería;101;Viator;2680;1317;1363
04;Almería;102;Vícar;10556;5428;5128
04;Almería;103;Zurgena;2181;1070;1111
05;Ávila;001;Adanero;412;223;189
05;Ávila;002;Adrada (La);1857;956;901
05;Ávila;005;Albornos;318;171;147
05;Ávila;007;Aldeanueva de Santa Cruz;252;134;118
05;Ávila;008;Aldeaseca;450;226;224
05;Ávila;010;Aldehuela (La);327;170;157
05;Ávila;012;Amavida;232;116;116
05;Ávila;013;Arenal (El);1173;595;578
05;Ávila;014;Arenas de San Pedro;6901;3471;3430
05;Ávila;015;Arevalillo;216;104;112
05;Ávila;016;Arévalo;7062;3432;3630
05;Ávila;017;Aveinte;175;87;88
05;Ávila;018;Avellaneda;83;38;45
05;Ávila;019;Ávila;45092;21827;23265
05;Ávila;021;Barco de Ávila (El);2718;1350;1368
05;Ávila;022;Barraco (El);2187;1121;1066
05;Ávila;023;Barromán;352;183;169
05;Ávila;024;Becedas;685;340;345
05;Ávila;025;Becedillas;233;126;107
05;Ávila;026;Bercial de Zapardiel;402;198;204
05;Ávila;027;Berlanas (Las);406;200;206
05;Ávila;029;Bernuy-Zapardiel;327;171;156
05;Ávila;030;Berrocalejo de Aragona;40;19;21
05;Ávila;033;Blascomillán;412;200;212
05;Ávila;034;Blasconuño de Matacabras;37;19;18
05;Ávila;035;Blascosancho;200;104;96
05;Ávila;036;Bohodón (El);248;132;116
05;Ávila;037;Bohoyo;632;347;285
05;Ávila;038;Bonilla de la Sierra;292;156;136
05;Ávila;039;Brabos;92;48;44
05;Ávila;040;Bularros;158;85;73
05;Ávila;041;Burgohondo;1515;766;749
05;Ávila;042;Cabezas de Alambre;319;164;155
05;Ávila;043;Cabezas del Pozo;266;131;135
05;Ávila;044;Cabezas del Villar;684;369;315
05;Ávila;045;Cabizuela;164;86;78
05;Ávila;046;Canales;99;48;51
05;Ávila;047;Candeleda;5468;2787;2681
05;Ávila;048;Cantiveros;272;139;133
05;Ávila;049;Cardeñosa;640;334;306
05;Ávila;051;Carrera (La);381;196;185
05;Ávila;052;Casas del Puerto de Villatoro;143;80;63
05;Ávila;053;Casasola;255;132;123
05;Ávila;054;Casavieja;1731;887;844
05;Ávila;055;Casillas;1046;530;516
05;Ávila;056;Castellanos de Zapardiel;189;109;80
05;Ávila;057;Cebreros;3428;1723;1705
05;Ávila;058;Cepeda la Mora;204;108;96
05;Ávila;067;Chamartín;141;75;66
05;Ávila;059;Cillán;184;89;95
05;Ávila;060;Cisla;263;129;134
05;Ávila;061;Colilla (La);248;124;124
05;Ávila;062;Collado de Contreras;353;190;163
05;Ávila;063;Collado del Mirón;138;69;69
05;Ávila;064;Constanzana;241;135;106
05;Ávila;065;Crespos;853;444;409
05;Ávila;066;Cuevas del Valle;724;387;337
05;Ávila;903;Diego del Carpio;462;244;218
05;Ávila;069;Donjimeno;170;89;81
05;Ávila;070;Donvidas;101;49;52
05;Ávila;072;Espinosa de los Caballeros;142;78;64
05;Ávila;073;Flores de Ávila;579;303;276
05;Ávila;074;Fontíveros;1186;598;588
05;Ávila;075;Fresnedilla;163;76;87
05;Ávila;076;Fresno (El);451;228;223
05;Ávila;077;Fuente el Saúz;405;196;209
05;Ávila;078;Fuentes de Año;289;146;143
05;Ávila;079;Gallegos de Altamiros;144;81;63
05;Ávila;080;Gallegos de Sobrinos;141;69;72
05;Ávila;081;Garganta del Villar;116;64;52
05;Ávila;082;Gavilanes;858;448;410
05;Ávila;083;Gemuño;301;151;150
05;Ávila;085;Gil García;106;52;54
05;Ávila;084;Gilbuena;226;123;103
05;Ávila;086;Gimialcón;169;88;81
05;Ávila;087;Gotarrendura;229;80;149
05;Ávila;088;Grandes y San Martín;91;44;47
05;Ávila;089;Guisando;807;414;393
05;Ávila;090;Gutierre-Muñoz;156;75;81
05;Ávila;092;Hernansancho;280;137;143
05;Ávila;093;Herradón de Pinares;517;263;254
05;Ávila;094;Herreros de Suso;404;201;203
05;Ávila;095;Higuera de las Dueñas;329;173;156
05;Ávila;096;Hija de Dios (La);177;96;81
05;Ávila;097;Horcajada (La);1094;549;545
05;Ávila;099;Horcajo de las Torres;1034;562;472
05;Ávila;100;Hornillo (El);583;291;292
05;Ávila;102;Hoyo de Pinares (El);2715;1387;1328
05;Ávila;101;Hoyocasero;539;283;256
05;Ávila;103;Hoyorredondo;197;91;106
05;Ávila;106;Hoyos de Miguel Muñoz;83;46;37
05;Ávila;104;Hoyos del Collado;65;40;25
05;Ávila;105;Hoyos del Espino;415;212;203
05;Ávila;107;Hurtumpascual;197;99;98
05;Ávila;108;Junciana;120;59;61
05;Ávila;109;Langa;654;347;307
05;Ávila;110;Lanzahíta;946;496;450
05;Ávila;113;Llanos de Tormes (Los);199;102;97
05;Ávila;112;Losar del Barco (El);229;126;103
05;Ávila;114;Madrigal de las Altas Torres;2343;1210;1133
05;Ávila;115;Maello;721;364;357
05;Ávila;116;Malpartida de Corneja;322;158;164
05;Ávila;117;Mamblas;343;181;162
05;Ávila;118;Mancera de Arriba;236;123;113
05;Ávila;119;Manjabálago;124;66;58
05;Ávila;120;Marlín;54;28;26
05;Ávila;121;Martiherrero;240;121;119
05;Ávila;122;Martínez;312;164;148
05;Ávila;123;Mediana de Voltoya;123;68;55
05;Ávila;124;Medinilla;361;180;181
05;Ávila;125;Mengamuñoz;91;45;46
05;Ávila;126;Mesegar de Corneja;165;79;86
05;Ávila;127;Mijares;1178;604;574
05;Ávila;128;Mingorría;603;308;295
05;Ávila;129;Mirón (El);397;213;184
05;Ávila;130;Mironcillo;152;88;64
05;Ávila;131;Mirueña de los Infanzones;303;148;155
05;Ávila;132;Mombeltrán;1385;732;653
05;Ávila;133;Monsalupe;148;75;73
05;Ávila;134;Moraleja de Matacabras;92;43;49
05;Ávila;135;Muñana;654;344;310
05;Ávila;136;Muñico;219;119;100
05;Ávila;138;Muñogalindo;498;267;231
05;Ávila;139;Muñogrande;126;68;58
05;Ávila;140;Muñomer del Peco;132;79;53
05;Ávila;141;Muñopepe;124;62;62
05;Ávila;142;Muñosancho;224;101;123
05;Ávila;143;Muñotello;179;101;78
05;Ávila;144;Narrillos del Álamo;218;116;102
05;Ávila;145;Narrillos del Rebollar;117;60;57
05;Ávila;149;Narros de Saldueña;273;137;136
05;Ávila;147;Narros del Castillo;352;187;165
05;Ávila;148;Narros del Puerto;69;39;30
05;Ávila;152;Nava de Arévalo;1237;650;587
05;Ávila;153;Nava del Barco;267;125;142
05;Ávila;151;Navacepedilla de Corneja;189;96;93
05;Ávila;154;Navadijos;100;51;49
05;Ávila;155;Navaescurial;136;77;59
05;Ávila;156;Navahondilla;158;67;91
05;Ávila;157;Navalacruz;416;208;208
05;Ávila;158;Navalmoral;760;379;381
05;Ávila;159;Navalonguilla;604;304;300
05;Ávila;160;Navalosa;612;307;305
05;Ávila;161;Navalperal de Pinares;1006;490;516
05;Ávila;162;Navalperal de Tormes;203;97;106
05;Ávila;163;Navaluenga;2166;1104;1062
05;Ávila;164;Navaquesera;128;66;62
05;Ávila;165;Navarredonda de Gredos;554;283;271
05;Ávila;166;Navarredondilla;358;175;183
05;Ávila;167;Navarrevisca;442;238;204
05;Ávila;168;Navas del Marqués (Las);4187;2106;2081
05;Ávila;169;Navatalgordo;1208;623;585
05;Ávila;170;Navatejares;206;97;109
05;Ávila;171;Neila de San Miguel;176;93;83
05;Ávila;172;Niharra;237;123;114
05;Ávila;173;Ojos-Albos;42;21;21
05;Ávila;174;Orbita;127;71;56
05;Ávila;175;Oso (El);279;149;130
05;Ávila;176;Padiernos;339;184;155
05;Ávila;177;Pajares de Adaja;237;122;115
05;Ávila;178;Palacios de Goda;640;308;332
05;Ávila;179;Papatrigo;420;202;218
05;Ávila;180;Parral (El);204;101;103
05;Ávila;181;Pascualcobo;83;43;40
05;Ávila;182;Pedro Bernardo;1991;1032;959
05;Ávila;183;Pedro-Rodríguez;261;126;135
05;Ávila;184;Peguerinos;452;230;222
05;Ávila;185;Peñalba de Ávila;184;102;82
05;Ávila;186;Piedrahíta;2451;1190;1261
05;Ávila;187;Piedralaves;2201;1101;1100
05;Ávila;188;Poveda;119;60;59
05;Ávila;189;Poyales del Hoyo;887;443;444
05;Ávila;190;Pozanco;80;44;36
05;Ávila;191;Pradosegar;221;115;106
05;Ávila;192;Puerto Castilla;210;101;109
05;Ávila;193;Rasueros;503;268;235
05;Ávila;194;Riocabado;262;149;113
05;Ávila;195;Riofrío;413;223;190
05;Ávila;196;Rivilla de Barajas;126;66;60
05;Ávila;197;Salobral;142;70;72
05;Ávila;198;Salvadiós;159;85;74
05;Ávila;199;San Bartolomé de Béjar;136;60;76
05;Ávila;200;San Bartolomé de Corneja;185;97;88
05;Ávila;201;San Bartolomé de Pinares;896;476;420
05;Ávila;206;San Esteban de los Patos;66;36;30
05;Ávila;208;San Esteban de Zapardiel;132;65;67
05;Ávila;207;San Esteban del Valle;1139;583;556
05;Ávila;209;San García de Ingelmos;246;127;119
05;Ávila;901;San Juan de Gredos;560;281;279
05;Ávila;210;San Juan de la Encinilla;194;87;107
05;Ávila;211;San Juan de la Nava;774;401;373
05;Ávila;212;San Juan del Molinillo;643;340;303
05;Ávila;213;San Juan del Olmo;260;138;122
05;Ávila;214;San Lorenzo de Tormes;97;45;52
05;Ávila;215;San Martín de la Vega del Alberche;385;213;172
05;Ávila;216;San Martín del Pimpollar;321;170;151
05;Ávila;217;San Miguel de Corneja;143;75;68
05;Ávila;218;San Miguel de Serrezuela;302;157;145
05;Ávila;219;San Pascual;83;42;41
05;Ávila;220;San Pedro del Arroyo;565;291;274
05;Ávila;231;San Vicente de Arévalo;264;135;129
05;Ávila;204;Sanchidrián;912;458;454
05;Ávila;205;Sanchorreja;167;87;80
05;Ávila;222;Santa Cruz de Pinares;279;158;121
05;Ávila;221;Santa Cruz del Valle;733;361;372
05;Ávila;226;Santa María de los Caballeros;246;124;122
05;Ávila;224;Santa María del Arroyo;175;85;90
05;Ávila;225;Santa María del Berrocal;789;387;402
05;Ávila;902;Santa María del Cubillo;486;271;215
05;Ávila;227;Santa María del Tiétar;383;188;195
05;Ávila;228;Santiago del Collado;378;223;155
05;Ávila;904;Santiago del Tormes;459;237;222
05;Ávila;229;Santo Domingo de las Posadas;118;61;57
05;Ávila;230;Santo Tomé de Zabarcos;151;79;72
05;Ávila;232;Serrada (La);173;90;83
05;Ávila;233;Serranillos;605;313;292
05;Ávila;234;Sigeres;94;42;52
05;Ávila;235;Sinlabajos;311;163;148
05;Ávila;236;Solana de Ávila;351;183;168
05;Ávila;237;Solana de Rioalmar;385;202;183
05;Ávila;238;Solosancho;1422;741;681
05;Ávila;239;Sotalbo;307;164;143
05;Ávila;240;Sotillo de la Adrada;3384;1704;1680
05;Ávila;241;Tiemblo (El);3837;1908;1929
05;Ávila;242;Tiñosillos;791;420;371
05;Ávila;243;Tolbaños;204;99;105
05;Ávila;244;Tormellas;158;79;79
05;Ávila;245;Tornadizos de Ávila;350;172;178
05;Ávila;247;Torre (La);586;314;272
05;Ávila;246;Tórtoles;191;101;90
05;Ávila;249;Umbrías;246;126;120
05;Ávila;251;Vadillo de la Sierra;223;130;93
05;Ávila;252;Valdecasa;156;83;73
05;Ávila;253;Vega de Santa María;165;88;77
05;Ávila;254;Velayos;349;173;176
05;Ávila;256;Villaflor;224;110;114
05;Ávila;257;Villafranca de la Sierra;311;168;143
05;Ávila;905;Villanueva de Ávila;"";"";""
05;Ávila;258;Villanueva de Gómez;215;105;110
05;Ávila;259;Villanueva del Aceral;258;122;136
05;Ávila;260;Villanueva del Campillo;275;141;134
05;Ávila;261;Villar de Corneja;128;61;67
05;Ávila;262;Villarejo del Valle;519;267;252
05;Ávila;263;Villatoro;288;155;133
05;Ávila;264;Viñegra de Moraña;106;59;47
05;Ávila;265;Vita;144;78;66
05;Ávila;266;Zapardiel de la Cañada;284;140;144
05;Ávila;267;Zapardiel de la Ribera;168;87;81
06;Badajoz;001;Acedera;1097;581;516
06;Badajoz;002;Aceuchal;5163;2584;2579
06;Badajoz;003;Ahillones;1411;695;716
06;Badajoz;004;Alange;2009;1048;961
06;Badajoz;005;Albuera (La);1788;893;895
06;Badajoz;006;Alburquerque;5529;2814;2715
06;Badajoz;007;Alconchel;2787;1383;1404
06;Badajoz;008;Alconera;865;442;423
06;Badajoz;009;Aljucén;228;126;102
06;Badajoz;010;Almendral;1569;779;790
06;Badajoz;011;Almendralejo;25352;12331;13021
06;Badajoz;012;Arroyo de San Serván;3742;1908;1834
06;Badajoz;013;Atalaya;389;194;195
06;Badajoz;014;Azuaga;10408;5118;5290
06;Badajoz;015;Badajoz;122407;59208;63199
06;Badajoz;016;Barcarrota;4391;2195;2196
06;Badajoz;017;Baterno;491;251;240
06;Badajoz;018;Benquerencia de la Serena;1410;701;709
06;Badajoz;019;Berlanga;2979;1490;1489
06;Badajoz;020;Bienvenida;2732;1371;1361
06;Badajoz;021;Bodonal de la Sierra;1567;788;779
06;Badajoz;022;Burguillos del Cerro;3401;1693;1708
06;Badajoz;023;Cabeza del Buey;6778;3344;3434
06;Badajoz;024;Cabeza la Vaca;1919;944;975
06;Badajoz;025;Calamonte;5443;2709;2734
06;Badajoz;026;Calera de León;1243;642;601
06;Badajoz;027;Calzadilla de los Barros;876;436;440
06;Badajoz;028;Campanario;6069;2907;3162
06;Badajoz;029;Campillo de Llerena;1926;957;969
06;Badajoz;030;Capilla;278;134;144
06;Badajoz;031;Carmonita;774;413;361
06;Badajoz;032;Carrascalejo (El);26;13;13
06;Badajoz;033;Casas de Don Pedro;2007;978;1029
06;Badajoz;034;Casas de Reina;342;152;190
06;Badajoz;035;Castilblanco;1922;967;955
06;Badajoz;036;Castuera;8354;4147;4207
06;Badajoz;042;Cheles;1439;727;712
06;Badajoz;037;Codosera (La);2719;1407;1312
06;Badajoz;038;Cordobilla de Lácara;1122;582;540
06;Badajoz;039;Coronada (La);2661;1337;1324
06;Badajoz;040;Corte de Peleas;1330;680;650
06;Badajoz;041;Cristina;550;293;257
06;Badajoz;043;Don Álvaro;603;305;298
06;Badajoz;044;Don Benito;29324;14731;14593
06;Badajoz;045;Entrín Bajo;704;344;360
06;Badajoz;046;Esparragalejo;1372;704;668
06;Badajoz;047;Esparragosa de la Serena;1217;604;613
06;Badajoz;048;Esparragosa de Lares;1420;692;728
06;Badajoz;049;Feria;1736;856;880
06;Badajoz;050;Fregenal de la Sierra;6000;2896;3104
06;Badajoz;051;Fuenlabrada de los Montes;2458;1228;1230
06;Badajoz;052;Fuente de Cantos;5185;2603;2582
06;Badajoz;053;Fuente del Arco;997;509;488
06;Badajoz;054;Fuente del Maestre;7033;3517;3516
06;Badajoz;055;Fuentes de León;3048;1445;1603
06;Badajoz;056;Garbayuela;650;342;308
06;Badajoz;057;Garlitos;952;474;478
06;Badajoz;058;Garrovilla (La);2712;1407;1305
06;Badajoz;059;Granja de Torrehermosa;3020;1479;1541
06;Badajoz;060;Guareña;7863;3944;3919
06;Badajoz;061;Haba (La);1883;913;970
06;Badajoz;062;Helechosa de los Montes;950;492;458
06;Badajoz;063;Herrera del Duque;4261;2138;2123
06;Badajoz;064;Higuera de la Serena;1439;724;715
06;Badajoz;065;Higuera de Llerena;647;307;340
06;Badajoz;066;Higuera de Vargas;3107;1552;1555
06;Badajoz;067;Higuera la Real;2931;1482;1449
06;Badajoz;068;Hinojosa del Valle;755;408;347
06;Badajoz;069;Hornachos;4127;2095;2032
06;Badajoz;070;Jerez de los Caballeros;9288;4638;4650
06;Badajoz;071;Lapa (La);378;190;188
06;Badajoz;073;Llera;1168;590;578
06;Badajoz;074;Llerena;5810;2799;3011
06;Badajoz;072;Lobón;2759;1437;1322
06;Badajoz;075;Magacela;1005;517;488
06;Badajoz;076;Maguilla;1415;708;707
06;Badajoz;077;Malcocinado;733;384;349
06;Badajoz;078;Malpartida de la Serena;1065;531;534
06;Badajoz;079;Manchita;777;409;368
06;Badajoz;080;Medellín;2625;1334;1291
06;Badajoz;081;Medina de las Torres;2002;996;1006
06;Badajoz;082;Mengabril;536;277;259
06;Badajoz;083;Mérida;52368;25515;26853
06;Badajoz;084;Mirandilla;1343;670;673
06;Badajoz;085;Monesterio;5221;2603;2618
06;Badajoz;086;Montemolín;2024;1008;1016
06;Badajoz;087;Monterrubio de la Serena;3668;1810;1858
06;Badajoz;088;Montijo;14788;7268;7520
06;Badajoz;089;Morera (La);805;407;398
06;Badajoz;090;Nava de Santiago (La);1259;632;627
06;Badajoz;091;Navalvillar de Pela;5375;2707;2668
06;Badajoz;092;Nogales;790;407;383
06;Badajoz;093;Oliva de la Frontera;7052;3455;3597
06;Badajoz;094;Oliva de Mérida;2344;1170;1174
06;Badajoz;095;Olivenza;10599;5214;5385
06;Badajoz;096;Orellana de la Sierra;538;262;276
06;Badajoz;097;Orellana la Vieja;4487;2250;2237
06;Badajoz;098;Palomas;721;368;353
06;Badajoz;099;Parra (La);1461;747;714
06;Badajoz;100;Peñalsordo;2011;967;1044
06;Badajoz;101;Peraleda del Zaucejo;869;420;449
06;Badajoz;102;Puebla de Alcocer;1884;947;937
06;Badajoz;103;Puebla de la Calzada;5713;2861;2852
06;Badajoz;104;Puebla de la Reina;950;487;463
06;Badajoz;107;Puebla de Obando;2211;1125;1086
06;Badajoz;108;Puebla de Sancho Pérez;3085;1511;1574
06;Badajoz;105;Puebla del Maestre;1239;598;641
06;Badajoz;106;Puebla del Prior;647;341;306
06;Badajoz;109;Quintana de la Serena;5083;2520;2563
06;Badajoz;110;Reina;292;148;144
06;Badajoz;111;Rena;683;358;325
06;Badajoz;112;Retamal de Llerena;749;377;372
06;Badajoz;113;Ribera del Fresno;3667;1766;1901
06;Badajoz;114;Risco;281;141;140
06;Badajoz;115;Roca de la Sierra (La);1782;896;886
06;Badajoz;116;Salvaleón;2563;1327;1236
06;Badajoz;117;Salvatierra de los Barros;2067;1037;1030
06;Badajoz;119;San Pedro de Mérida;783;409;374
06;Badajoz;123;San Vicente de Alcántara;6271;3091;3180
06;Badajoz;118;Sancti-Spíritus;425;208;217
06;Badajoz;120;Santa Amalia;4237;2142;2095
06;Badajoz;121;Santa Marta;4106;2073;2033
06;Badajoz;122;Santos de Maimona (Los);7604;3804;3800
06;Badajoz;124;Segura de León;2595;1302;1293
06;Badajoz;125;Siruela;2803;1366;1437
06;Badajoz;126;Solana de los Barros;2856;1466;1390
06;Badajoz;127;Talarrubias;4140;2020;2120
06;Badajoz;128;Talavera la Real;5316;2698;2618
06;Badajoz;129;Táliga;832;438;394
06;Badajoz;130;Tamurejo;341;162;179
06;Badajoz;131;Torre de Miguel Sesmero;1358;666;692
06;Badajoz;132;Torremayor;1148;572;576
06;Badajoz;133;Torremejía;1948;984;964
06;Badajoz;134;Trasierra;745;395;350
06;Badajoz;135;Trujillanos;971;500;471
06;Badajoz;136;Usagre;2274;1157;1117
06;Badajoz;137;Valdecaballeros;1830;916;914
06;Badajoz;901;Valdelacalzada;"";"";""
06;Badajoz;138;Valdetorres;1494;755;739
06;Badajoz;139;Valencia de las Torres;1026;517;509
06;Badajoz;140;Valencia del Mombuey;1044;511;533
06;Badajoz;141;Valencia del Ventoso;2668;1341;1327
06;Badajoz;146;Valle de la Serena;2055;1005;1050
06;Badajoz;147;Valle de Matamoros;701;343;358
06;Badajoz;148;Valle de Santa Ana;1409;718;691
06;Badajoz;142;Valverde de Burguillos;429;215;214
06;Badajoz;143;Valverde de Leganés;3623;1832;1791
06;Badajoz;144;Valverde de Llerena;1001;490;511
06;Badajoz;145;Valverde de Mérida;1170;601;569
06;Badajoz;149;Villafranca de los Barros;12714;6246;6468
06;Badajoz;150;Villagarcía de la Torre;1192;609;583
06;Badajoz;151;Villagonzalo;1637;778;859
06;Badajoz;152;Villalba de los Barros;1764;866;898
06;Badajoz;153;Villanueva de la Serena;24356;12003;12353
06;Badajoz;154;Villanueva del Fresno;4055;1999;2056
06;Badajoz;156;Villar de Rena;2038;1073;965
06;Badajoz;155;Villar del Rey;2489;1282;1207
06;Badajoz;157;Villarta de los Montes;960;467;493
06;Badajoz;158;Zafra;13996;6709;7287
06;Badajoz;159;Zahínos;3210;1592;1618
06;Badajoz;160;Zalamea de la Serena;5963;2929;3034
06;Badajoz;162;Zarza (La);3653;1855;1798
06;Badajoz;161;Zarza-Capilla;749;366;383
07;Balears (Illes);002;Alaior;6184;3054;3130
07;Balears (Illes);001;Alaró;3565;1698;1867
07;Balears (Illes);003;Alcúdia;7497;3726;3771
07;Balears (Illes);004;Algaida;3110;1552;1558
07;Balears (Illes);005;Andratx;6622;3261;3361
07;Balears (Illes);901;Ariany;944;461;483
07;Balears (Illes);006;Artà;5810;2851;2959
07;Balears (Illes);007;Banyalbufar;443;219;224
07;Balears (Illes);008;Binissalem;4692;2277;2415
07;Balears (Illes);009;Búger;1014;496;518
07;Balears (Illes);010;Bunyola;3718;1836;1882
07;Balears (Illes);011;Calvià;18667;9667;9000
07;Balears (Illes);012;Campanet;2232;1117;1115
07;Balears (Illes);013;Campos;6600;3303;3297
07;Balears (Illes);014;Capdepera;6381;3240;3141
07;Balears (Illes);064;Castell (Es);5016;2438;2578
07;Balears (Illes);015;Ciutadella de Menorca;20141;10065;10076
07;Balears (Illes);016;Consell;2007;989;1018
07;Balears (Illes);017;Costitx;739;351;388
07;Balears (Illes);018;Deyá;534;263;271
07;Balears (Illes);026;Eivissa;30050;15251;14799
07;Balears (Illes);019;Escorca;247;148;99
07;Balears (Illes);020;Esporles;2946;1451;1495
07;Balears (Illes);021;Estellencs;331;165;166
07;Balears (Illes);022;Felanitx;14023;6969;7054
07;Balears (Illes);023;Ferreries;3505;1886;1619
07;Balears (Illes);024;Formentera;4713;2425;2288
07;Balears (Illes);025;Fornalutx;532;264;268
07;Balears (Illes);027;Inca;22061;10794;11267
07;Balears (Illes);028;Lloret de Vistalegre;811;394;417
07;Balears (Illes);029;Lloseta;4487;2235;2252
07;Balears (Illes);030;Llubí;1955;964;991
07;Balears (Illes);031;Llucmajor;16584;8225;8359
07;Balears (Illes);032;Mahón;23318;11486;11832
07;Balears (Illes);033;Manacor;26577;13092;13485
07;Balears (Illes);034;Mancor de la Vall;923;449;474
07;Balears (Illes);035;Maria de la Salut;1886;929;957
07;Balears (Illes);036;Marratxí;10774;5401;5373
07;Balears (Illes);037;Mercadal (Es);3236;1643;1593
07;Balears (Illes);902;Migjorn Gran (Es);"";"";""
07;Balears (Illes);038;Montuïri;2163;1037;1126
07;Balears (Illes);039;Muro;5887;2906;2981
07;Balears (Illes);040;Palma de Mallorca;314608;153861;160747
07;Balears (Illes);041;Petra;2617;1258;1359
07;Balears (Illes);044;Pobla (Sa);10323;5116;5207
07;Balears (Illes);042;Pollença;12160;6046;6114
07;Balears (Illes);043;Porreres;4483;2222;2261
07;Balears (Illes);045;Puigpunyent;1134;570;564
07;Balears (Illes);059;Salines (Ses);3024;1538;1486
07;Balears (Illes);046;Sant Antoni de Portmany;13721;6897;6824
07;Balears (Illes);049;Sant Joan;1788;875;913
07;Balears (Illes);050;Sant Joan de Labritja;3584;1762;1822
07;Balears (Illes);048;Sant Josep de sa Talaia;9659;4958;4701
07;Balears (Illes);051;Sant Llorenç des Cardassar;4377;2196;2181
07;Balears (Illes);052;Sant Lluís;3060;1537;1523
07;Balears (Illes);053;Santa Eugènia;931;455;476
07;Balears (Illes);054;Santa Eulalia del Río;15984;8099;7885
07;Balears (Illes);055;Santa Margalida;5516;2778;2738
07;Balears (Illes);056;Santa María del Camí;4069;2021;2048
07;Balears (Illes);057;Santanyí;6823;3460;3363
07;Balears (Illes);058;Selva;3013;1489;1524
07;Balears (Illes);047;Sencelles;1559;749;810
07;Balears (Illes);060;Sineu;2630;1300;1330
07;Balears (Illes);061;Sóller;10238;4977;5261
07;Balears (Illes);062;Son Servera;6392;3269;3123
07;Balears (Illes);063;Valldemossa;1370;656;714
07;Balears (Illes);065;Vilafranca de Bonany;2185;1069;1116
08;Barcelona;001;Abrera;4769;2427;2342
08;Barcelona;002;Aguilar de Segarra;212;106;106
08;Barcelona;014;Aiguafreda;2022;993;1029
08;Barcelona;003;Alella;5893;2870;3023
08;Barcelona;004;Alpens;248;129;119
08;Barcelona;005;Ametlla del Vallès (L');2861;1390;1471
08;Barcelona;006;Arenys de Mar;10694;5156;5538
08;Barcelona;007;Arenys de Munt;4753;2289;2464
08;Barcelona;008;Argençola;193;102;91
08;Barcelona;009;Argentona;7606;3791;3815
08;Barcelona;010;Artés;4099;1987;2112
08;Barcelona;011;Avià;1806;925;881
08;Barcelona;012;Avinyó;2010;982;1028
08;Barcelona;013;Avinyonet del Penedès;1200;607;593
08;Barcelona;015;Badalona;225229;112325;112904
08;Barcelona;904;Badia del Vallès;"";"";""
08;Barcelona;016;Bagà;2154;1086;1068
08;Barcelona;017;Balenyà;3186;1633;1553
08;Barcelona;018;Balsareny;3482;1697;1785
08;Barcelona;252;Barberà del Vallès;30647;15933;14714
08;Barcelona;019;Barcelona;1714355;812907;901448
08;Barcelona;020;Begues;1648;784;864
08;Barcelona;021;Bellprat;93;49;44
08;Barcelona;022;Berga;13933;6788;7145
08;Barcelona;023;Bigues i Riells;2201;1121;1080
08;Barcelona;024;Borredà;447;210;237
08;Barcelona;025;Bruc (El);711;368;343
08;Barcelona;026;Brull (El);180;94;86
08;Barcelona;027;Cabanyes (Les);371;194;177
08;Barcelona;029;Cabrera de Mar;2369;1179;1190
08;Barcelona;028;Cabrera d'Igualada;259;138;121
08;Barcelona;030;Cabrils;2399;1155;1244
08;Barcelona;031;Calaf;3219;1582;1637
08;Barcelona;034;Calders;502;270;232
08;Barcelona;033;Caldes de Montbui;10692;5280;5412
08;Barcelona;032;Caldes d'Estrac;1399;690;709
08;Barcelona;035;Calella;11654;5465;6189
08;Barcelona;037;Calldetenes;1455;734;721
08;Barcelona;038;Callús;1527;736;791
08;Barcelona;036;Calonge de Segarra;201;107;94
08;Barcelona;039;Campins;193;93;100
08;Barcelona;040;Canet de Mar;8707;4266;4441
08;Barcelona;041;Canovelles;12832;6463;6369
08;Barcelona;042;Cànoves i Samalús;782;388;394
08;Barcelona;043;Canyelles;619;336;283
08;Barcelona;044;Capellades;4893;2393;2500
08;Barcelona;045;Capolat;110;59;51
08;Barcelona;046;Cardedeu;8342;4150;4192
08;Barcelona;047;Cardona;6642;3244;3398
08;Barcelona;048;Carme;696;363;333
08;Barcelona;049;Casserres;1769;863;906
08;Barcelona;057;Castell de l'Areny;54;29;25
08;Barcelona;052;Castellar de n'Hug;186;100;86
08;Barcelona;050;Castellar del Riu;58;33;25
08;Barcelona;051;Castellar del Vallès;12113;6036;6077
08;Barcelona;053;Castellbell i el Vilar;3322;1625;1697
08;Barcelona;054;Castellbisbal;4249;2182;2067
08;Barcelona;055;Castellcir;235;127;108
08;Barcelona;056;Castelldefels;29725;14858;14867
08;Barcelona;058;Castellet i la Gornal;1074;548;526
08;Barcelona;060;Castellfollit de Riubregós;273;134;139
08;Barcelona;059;Castellfollit del Boix;318;153;165
08;Barcelona;061;Castellgalí;694;348;346
08;Barcelona;062;Castellnou de Bages;131;70;61
08;Barcelona;063;Castellolí;441;214;227
08;Barcelona;064;Castellterçol;1985;956;1029
08;Barcelona;065;Castellví de la Marca;1380;693;687
08;Barcelona;066;Castellví de Rosanes;488;248;240
08;Barcelona;067;Centelles;5665;2791;2874
08;Barcelona;268;Cercs;1790;894;896
08;Barcelona;266;Cerdanyola del Vallès;54990;27556;27434
08;Barcelona;068;Cervelló;4585;2304;2281
08;Barcelona;069;Collbató;813;402;411
08;Barcelona;070;Collsuspina;211;110;101
08;Barcelona;071;Copons;309;153;156
08;Barcelona;072;Corbera de Llobregat;4192;2123;2069
08;Barcelona;073;Cornellà de Llobregat;86866;43010;43856
08;Barcelona;074;Cubelles;2709;1386;1323
08;Barcelona;075;Dosrius;994;528;466
08;Barcelona;076;Esparreguera;11741;5899;5842
08;Barcelona;077;Esplugues de Llobregat;47749;23755;23994
08;Barcelona;078;Espunyola (L');299;159;140
08;Barcelona;079;Estany (L');386;179;207
08;Barcelona;134;Figaró-Montmany;616;321;295
08;Barcelona;080;Fígols;31;16;15
08;Barcelona;082;Fogars de la Selva;327;166;161
08;Barcelona;081;Fogars de Montclús;262;135;127
08;Barcelona;083;Folgueroles;1082;532;550
08;Barcelona;084;Fonollosa;649;330;319
08;Barcelona;085;Font-rubí;1131;588;543
08;Barcelona;086;Franqueses del Vallès (Les);9739;4903;4836
08;Barcelona;090;Gaià;146;75;71
08;Barcelona;087;Gallifa;82;41;41
08;Barcelona;088;Garriga (La);8933;4323;4610
08;Barcelona;089;Gavà;34613;17339;17274
08;Barcelona;091;Gelida;3815;1898;1917
08;Barcelona;092;Gironella;5311;2546;2765
08;Barcelona;093;Gisclareny;32;16;16
08;Barcelona;094;Granada (La);1203;593;610
08;Barcelona;095;Granera;61;35;26
08;Barcelona;096;Granollers;49045;24141;24904
08;Barcelona;097;Gualba;582;292;290
08;Barcelona;099;Guardiola de Berguedà;1261;605;656
08;Barcelona;100;Gurb;1660;863;797
08;Barcelona;101;Hospitalet de Llobregat (L');278449;137714;140735
08;Barcelona;162;Hostalets de Pierola (Els);834;422;412
08;Barcelona;102;Igualada;31391;15303;16088
08;Barcelona;103;Jorba;511;256;255
08;Barcelona;104;Llacuna (La);741;386;355
08;Barcelona;105;Llagosta (La);12164;6043;6121
08;Barcelona;107;Lliçà d'Amunt;4266;2152;2114
08;Barcelona;108;Lliçà de Vall;2436;1266;1170
08;Barcelona;106;Llinars del Vallès;5171;2620;2551
08;Barcelona;109;Lluçà;297;162;135
08;Barcelona;110;Malgrat de Mar;11112;5492;5620
08;Barcelona;111;Malla;258;120;138
08;Barcelona;112;Manlleu;16331;8080;8251
08;Barcelona;113;Manresa;65607;31659;33948
08;Barcelona;242;Marganell;214;82;132
08;Barcelona;114;Martorell;16326;8153;8173
08;Barcelona;115;Martorelles;4661;2322;2339
08;Barcelona;116;Masies de Roda (Les);631;308;323
08;Barcelona;117;Masies de Voltregà (Les);2483;1212;1271
08;Barcelona;118;Masnou (El);16515;7971;8544
08;Barcelona;119;Masquefa;2507;1243;1264
08;Barcelona;120;Matadepera;3780;1919;1861
08;Barcelona;121;Mataró;100817;49501;51316
08;Barcelona;122;Mediona;981;505;476
08;Barcelona;138;Moià;3216;1550;1666
08;Barcelona;123;Molins de Rei;18355;9047;9308
08;Barcelona;124;Mollet del Vallès;38622;19295;19327
08;Barcelona;128;Monistrol de Calders;626;316;310
08;Barcelona;127;Monistrol de Montserrat;2583;1266;1317
08;Barcelona;125;Montcada i Reixac;26671;13245;13426
08;Barcelona;130;Montclar;258;112;146
08;Barcelona;131;Montesquiu;890;429;461
08;Barcelona;126;Montgat;7382;3645;3737
08;Barcelona;132;Montmajor;695;348;347
08;Barcelona;133;Montmaneu;274;158;116
08;Barcelona;135;Montmeló;7169;3572;3597
08;Barcelona;136;Montornès del Vallès;10585;5291;5294
08;Barcelona;137;Montseny;281;144;137
08;Barcelona;129;Muntanyola;162;94;68
08;Barcelona;139;Mura;173;95;78
08;Barcelona;140;Navarcles;5077;2520;2557
08;Barcelona;141;Navàs;5293;2592;2701
08;Barcelona;142;Nou de Berguedà (La);138;76;62
08;Barcelona;143;Òdena;2560;1309;1251
08;Barcelona;145;Olèrdola;1557;815;742
08;Barcelona;146;Olesa de Bonesvalls;344;176;168
08;Barcelona;147;Olesa de Montserrat;14589;7276;7313
08;Barcelona;148;Olivella;213;107;106
08;Barcelona;149;Olost;954;467;487
08;Barcelona;144;Olvan;1084;517;567
08;Barcelona;150;Orís;221;114;107
08;Barcelona;151;Oristà;908;455;453
08;Barcelona;152;Orpí;153;78;75
08;Barcelona;153;Òrrius;338;180;158
08;Barcelona;154;Pacs del Penedès;394;211;183
08;Barcelona;155;Palafolls;3021;1497;1524
08;Barcelona;156;Palau-solità i Plegamans;5681;2915;2766
08;Barcelona;157;Pallejà;6073;2997;3076
08;Barcelona;905;Palma de Cervelló (La);"";"";""
08;Barcelona;158;Papiol (El);3071;1506;1565
08;Barcelona;159;Parets del Vallès;10177;5121;5056
08;Barcelona;160;Perafita;354;172;182
08;Barcelona;161;Piera;5411;2726;2685
08;Barcelona;163;Pineda de Mar;14860;7446;7414
08;Barcelona;164;Pla del Penedès (El);1009;511;498
08;Barcelona;165;Pobla de Claramunt (La);1692;848;844
08;Barcelona;166;Pobla de Lillet (La);1868;924;944
08;Barcelona;167;Polinyà;2975;1501;1474
08;Barcelona;182;Pont de Vilomara i Rocafort (El);2203;1089;1114
08;Barcelona;168;Pontons;235;125;110
08;Barcelona;169;Prat de Llobregat (El);64193;32319;31874
08;Barcelona;171;Prats de Lluçanès;2508;1254;1254
08;Barcelona;170;Prats de Rei (Els);579;281;298
08;Barcelona;230;Premià de Dalt;5523;2768;2755
08;Barcelona;172;Premià de Mar;21478;10797;10681
08;Barcelona;174;Puigdàlber;301;148;153
08;Barcelona;175;Puig-reig;5094;2512;2582
08;Barcelona;176;Pujalt;181;92;89
08;Barcelona;177;Quar (La);39;19;20
08;Barcelona;178;Rajadell;276;144;132
08;Barcelona;179;Rellinars;201;98;103
08;Barcelona;180;Ripollet;25963;12969;12994
08;Barcelona;181;Roca del Vallès (La);5400;2706;2694
08;Barcelona;183;Roda de Ter;4734;2275;2459
08;Barcelona;184;Rubí;48807;24525;24282
08;Barcelona;185;Rubió;137;73;64
08;Barcelona;901;Rupit i Pruit;367;185;182
08;Barcelona;187;Sabadell;189489;92799;96690
08;Barcelona;188;Sagàs;255;132;123
08;Barcelona;190;Saldes;348;198;150
08;Barcelona;191;Sallent;7854;3799;4055
08;Barcelona;194;Sant Adrià de Besòs;34813;17322;17491
08;Barcelona;195;Sant Agustí de Lluçanès;124;68;56
08;Barcelona;196;Sant Andreu de la Barca;14711;7408;7303
08;Barcelona;197;Sant Andreu de Llavaneres;3816;1902;1914
08;Barcelona;198;Sant Antoni de Vilamajor;1885;934;951
08;Barcelona;199;Sant Bartomeu del Grau;1093;572;521
08;Barcelona;200;Sant Boi de Llobregat;77502;38892;38610
08;Barcelona;201;Sant Boi de Lluçanès;521;263;258
08;Barcelona;203;Sant Cebrià de Vallalta;731;385;346
08;Barcelona;202;Sant Celoni;12382;6147;6235
08;Barcelona;204;Sant Climent de Llobregat;2170;1082;1088
08;Barcelona;205;Sant Cugat del Vallès;37243;18388;18855
08;Barcelona;206;Sant Cugat Sesgarrigues;726;366;360
08;Barcelona;207;Sant Esteve de Palautordera;1075;553;522
08;Barcelona;208;Sant Esteve Sesrovires;1991;1029;962
08;Barcelona;210;Sant Feliu de Codines;3400;1644;1756
08;Barcelona;211;Sant Feliu de Llobregat;37681;18761;18920
08;Barcelona;212;Sant Feliu Sasserra;652;320;332
08;Barcelona;209;Sant Fost de Campsentelles;4216;2132;2084
08;Barcelona;213;Sant Fruitós de Bages;4688;2341;2347
08;Barcelona;215;Sant Hipòlit de Voltregà;2974;1425;1549
08;Barcelona;193;Sant Iscle de Vallalta;498;258;240
08;Barcelona;216;Sant Jaume de Frontanyà;28;17;11
08;Barcelona;218;Sant Joan de Vilatorrada;7789;3904;3885
08;Barcelona;217;Sant Joan Despí;24228;12133;12095
08;Barcelona;903;Sant Julià de Cerdanyola;"";"";""
08;Barcelona;220;Sant Julià de Vilatorta;1722;840;882
08;Barcelona;221;Sant Just Desvern;11831;5688;6143
08;Barcelona;222;Sant Llorenç d'Hortons;972;495;477
08;Barcelona;223;Sant Llorenç Savall;1864;863;1001
08;Barcelona;225;Sant Martí d'Albars;144;79;65
08;Barcelona;224;Sant Martí de Centelles;672;338;334
08;Barcelona;226;Sant Martí de Tous;1011;505;506
08;Barcelona;227;Sant Martí Sarroca;2362;1185;1177
08;Barcelona;228;Sant Martí Sesgueioles;385;194;191
08;Barcelona;229;Sant Mateu de Bages;595;302;293
08;Barcelona;231;Sant Pere de Ribes;12589;6354;6235
08;Barcelona;232;Sant Pere de Riudebitlles;2189;1072;1117
08;Barcelona;233;Sant Pere de Torelló;2033;945;1088
08;Barcelona;234;Sant Pere de Vilamajor;936;493;443
08;Barcelona;189;Sant Pere Sallavinera;182;91;91
08;Barcelona;235;Sant Pol de Mar;2466;1213;1253
08;Barcelona;236;Sant Quintí de Mediona;1576;787;789
08;Barcelona;237;Sant Quirze de Besora;2046;978;1068
08;Barcelona;238;Sant Quirze del Vallès;7494;3689;3805
08;Barcelona;239;Sant Quirze Safaja;242;116;126
08;Barcelona;240;Sant Sadurní d'Anoia;8998;4518;4480
08;Barcelona;241;Sant Sadurní d'Osormort;78;39;39
08;Barcelona;098;Sant Salvador de Guardiola;939;481;458
08;Barcelona;262;Sant Vicenç de Castellet;7617;3665;3952
08;Barcelona;264;Sant Vicenç de Montalt;1625;816;809
08;Barcelona;265;Sant Vicenç de Torelló;1751;830;921
08;Barcelona;263;Sant Vicenç dels Horts;20652;10330;10322
08;Barcelona;243;Santa Cecilia de Voltregà;192;109;83
08;Barcelona;244;Santa Coloma de Cervelló;2780;1380;1400
08;Barcelona;245;Santa Coloma de Gramenet;136042;68035;68007
08;Barcelona;246;Santa Eugènia de Berga;1428;730;698
08;Barcelona;247;Santa Eulàlia de Riuprimer;832;421;411
08;Barcelona;248;Santa Eulàlia de Ronçana;2647;1357;1290
08;Barcelona;249;Santa Fe del Penedès;186;86;100
08;Barcelona;250;Santa Margarida de Montbui;9291;4657;4634
08;Barcelona;251;Santa Margarida i els Monjos;3623;1882;1741
08;Barcelona;253;Santa Maria de Besora;200;99;101
08;Barcelona;254;Santa Maria de Corcó;1961;951;1010
08;Barcelona;256;Santa Maria de Martorelles;387;195;192
08;Barcelona;255;Santa Maria de Merlès;265;134;131
08;Barcelona;257;Santa Maria de Miralles;98;50;48
08;Barcelona;259;Santa Maria de Palautordera;4552;2307;2245
08;Barcelona;258;Santa Maria d'Oló;1055;534;521
08;Barcelona;260;Santa Perpètua de Mogoda;15990;8064;7926
08;Barcelona;261;Santa Susanna;710;351;359
08;Barcelona;192;Santpedor;4111;1984;2127
08;Barcelona;267;Sentmenat;4032;2012;2020
08;Barcelona;269;Seva;1662;832;830
08;Barcelona;270;Sitges;12932;6312;6620
08;Barcelona;271;Sobremunt;81;41;40
08;Barcelona;272;Sora;230;123;107
08;Barcelona;273;Subirats;2158;1101;1057
08;Barcelona;274;Súria;6650;3289;3361
08;Barcelona;276;Tagamanent;135;69;66
08;Barcelona;277;Talamanca;72;39;33
08;Barcelona;278;Taradell;4391;2189;2202
08;Barcelona;275;Tavèrnoles;215;109;106
08;Barcelona;280;Tavertet;114;60;54
08;Barcelona;281;Teià;3196;1607;1589
08;Barcelona;279;Terrassa;161410;79035;82375
08;Barcelona;282;Tiana;4287;2153;2134
08;Barcelona;283;Tona;5421;2695;2726
08;Barcelona;284;Tordera;7859;3942;3917
08;Barcelona;285;Torelló;11378;5591;5787
08;Barcelona;286;Torre de Claramunt (La);1476;761;715
08;Barcelona;287;Torrelavit;1184;601;583
08;Barcelona;288;Torrelles de Foix;1160;619;541
08;Barcelona;289;Torrelles de Llobregat;1943;995;948
08;Barcelona;290;Ullastrell;886;442;444
08;Barcelona;291;Vacarisses;710;360;350
08;Barcelona;292;Vallbona d'Anoia;1051;529;522
08;Barcelona;293;Vallcebre;350;185;165
08;Barcelona;294;Vallgorguina;675;336;339
08;Barcelona;295;Vallirana;5440;2715;2725
08;Barcelona;296;Vallromanes;463;234;229
08;Barcelona;297;Veciana;197;105;92
08;Barcelona;298;Vic;28873;13804;15069
08;Barcelona;299;Vilada;600;303;297
08;Barcelona;301;Viladecans;46271;23389;22882
08;Barcelona;300;Viladecavalls;2680;1350;1330
08;Barcelona;305;Vilafranca del Penedès;27402;13359;14043
08;Barcelona;306;Vilalba Sasserra;297;160;137
08;Barcelona;303;Vilanova de Sau;344;162;182
08;Barcelona;302;Vilanova del Camí;8831;4418;4413
08;Barcelona;902;Vilanova del Vallès;1256;618;638
08;Barcelona;307;Vilanova i la Geltrú;46364;22954;23410
08;Barcelona;214;Vilassar de Dalt;6461;3155;3306
08;Barcelona;219;Vilassar de Mar;11294;5591;5703
08;Barcelona;304;Vilobí del Penedès;773;386;387
08;Barcelona;308;Viver i Serrateix;233;125;108
09;Burgos;001;Abajas;58;30;28
09;Burgos;003;Adrada de Haza;337;182;155
09;Burgos;006;Aguas Cándidas;132;74;58
09;Burgos;007;Aguilar de Bureba;131;74;57
09;Burgos;009;Albillos;169;98;71
09;Burgos;010;Alcocero de Mola;70;41;29
09;Burgos;011;Alfoz de Bricia;169;80;89
09;Burgos;907;Alfoz de Quintanadueñas;466;236;230
09;Burgos;012;Alfoz de Santa Gadea;168;89;79
09;Burgos;013;Altable;76;43;33
09;Burgos;014;Altos (Los);342;198;144
09;Burgos;016;Ameyugo;71;46;25
09;Burgos;017;Anguix;199;103;96
09;Burgos;018;Aranda de Duero;29069;14643;14426
09;Burgos;019;Arandilla;235;143;92
09;Burgos;020;Arauzo de Miel;486;268;218
09;Burgos;021;Arauzo de Salce;100;59;41
09;Burgos;022;Arauzo de Torre;143;79;64
09;Burgos;023;Arcos;280;155;125
09;Burgos;024;Arenillas de Riopisuerga;247;139;108
09;Burgos;025;Arija;335;151;184
09;Burgos;026;Arlanzón;442;227;215
09;Burgos;027;Arraya de Oca;50;26;24
09;Burgos;029;Atapuerca;181;83;98
09;Burgos;030;Ausines (Los);148;80;68
09;Burgos;032;Avellanosa de Muñó;236;126;110
09;Burgos;033;Bahabón de Esgueva;199;114;85
09;Burgos;034;Balbases (Los);447;237;210
09;Burgos;035;Baños de Valdearados;624;350;274
09;Burgos;036;Bañuelos de Bureba;60;40;20
09;Burgos;037;Barbadillo de Herreros;163;78;85
09;Burgos;038;Barbadillo del Mercado;233;117;116
09;Burgos;039;Barbadillo del Pez;130;72;58
09;Burgos;041;Barrio de Muñó;44;23;21
09;Burgos;043;Barrios de Bureba (Los);381;192;189
09;Burgos;044;Barrios de Colina;80;46;34
09;Burgos;045;Basconcillos del Tozo;519;269;250
09;Burgos;046;Bascuñana;101;55;46
09;Burgos;047;Belbimbre;89;44;45
09;Burgos;048;Belorado;2140;1084;1056
09;Burgos;050;Berberana;112;58;54
09;Burgos;051;Berlangas de Roa;371;184;187
09;Burgos;052;Berzosa de Bureba;61;34;27
09;Burgos;054;Bozoó;101;52;49
09;Burgos;055;Brazacorta;111;57;54
09;Burgos;056;Briviesca;5375;2678;2697
09;Burgos;057;Bugedo;118;85;33
09;Burgos;058;Buniel;167;88;79
09;Burgos;059;Burgos;160561;78327;82234
09;Burgos;060;Busto de Bureba;390;202;188
09;Burgos;061;Cabañes de Esgueva;347;172;175
09;Burgos;062;Cabezón de la Sierra;62;28;34
09;Burgos;063;Cabia;234;136;98
09;Burgos;064;Caleruega;484;265;219
09;Burgos;065;Campillo de Aranda;216;115;101
09;Burgos;066;Campolara;112;63;49
09;Burgos;067;Canicosa de la Sierra;770;395;375
09;Burgos;068;Cantabrana;79;43;36
09;Burgos;070;Carazo;52;27;25
09;Burgos;071;Carcedo de Bureba;51;28;23
09;Burgos;072;Carcedo de Burgos;109;63;46
09;Burgos;073;Cardeñadijo;355;196;159
09;Burgos;074;Cardeñajimeno;309;166;143
09;Burgos;075;Cardeñuela Riopico;71;37;34
09;Burgos;076;Carrias;70;44;26
09;Burgos;077;Cascajares de Bureba;78;44;34
09;Burgos;078;Cascajares de la Sierra;34;17;17
09;Burgos;079;Castellanos de Castro;81;47;34
09;Burgos;083;Castil de Peones;63;33;30
09;Burgos;082;Castildelgado;102;52;50
09;Burgos;084;Castrillo de la Reina;387;225;162
09;Burgos;085;Castrillo de la Vega;702;361;341
09;Burgos;088;Castrillo de Riopisuerga;122;69;53
09;Burgos;086;Castrillo del Val;138;85;53
09;Burgos;090;Castrillo Matajudíos;87;48;39
09;Burgos;091;Castrojeriz;1180;589;591
09;Burgos;093;Cayuela;131;78;53
09;Burgos;094;Cebrecos;89;47;42
09;Burgos;095;Celada del Camino;103;48;55
09;Burgos;098;Cerezo de Río Tirón;961;506;455
09;Burgos;100;Cerratón de Juarros;76;41;35
09;Burgos;101;Ciadoncha;152;80;72
09;Burgos;102;Cillaperlata;104;56;48
09;Burgos;103;Cilleruelo de Abajo;429;234;195
09;Burgos;104;Cilleruelo de Arriba;105;59;46
09;Burgos;105;Ciruelos de Cervera;211;110;101
09;Burgos;108;Cogollos;213;117;96
09;Burgos;109;Condado de Treviño;1069;586;483
09;Burgos;110;Contreras;108;65;43
09;Burgos;112;Coruña del Conde;211;118;93
09;Burgos;113;Covarrubias;742;385;357
09;Burgos;114;Cubillo del Campo;79;44;35
09;Burgos;115;Cubo de Bureba;177;88;89
09;Burgos;117;Cueva de Roa (La);158;92;66
09;Burgos;119;Cuevas de San Clemente;97;43;54
09;Burgos;120;Encío;58;33;25
09;Burgos;122;Espinosa de Cervera;127;78;49
09;Burgos;124;Espinosa de los Monteros;2456;1265;1191
09;Burgos;123;Espinosa del Camino;62;32;30
09;Burgos;125;Estépar;1024;539;485
09;Burgos;127;Fontioso;119;64;55
09;Burgos;128;Frandovínez;97;53;44
09;Burgos;129;Fresneda de la Sierra Tirón;136;67;69
09;Burgos;130;Fresneña;168;92;76
09;Burgos;131;Fresnillo de las Dueñas;352;184;168
09;Burgos;132;Fresno de Río Tirón;321;183;138
09;Burgos;133;Fresno de Rodilla;37;20;17
09;Burgos;134;Frías;333;173;160
09;Burgos;135;Fuentebureba;141;67;74
09;Burgos;136;Fuentecén;373;209;164
09;Burgos;137;Fuentelcésped;285;137;148
09;Burgos;138;Fuentelisendo;160;89;71
09;Burgos;139;Fuentemolinos;165;91;74
09;Burgos;140;Fuentenebro;239;133;106
09;Burgos;141;Fuentespina;597;318;279
09;Burgos;143;Galbarros;31;21;10
09;Burgos;144;Gallega (La);108;59;49
09;Burgos;148;Grijalba;186;90;96
09;Burgos;149;Grisaleña;81;48;33
09;Burgos;151;Gumiel de Izán;755;404;351
09;Burgos;152;Gumiel de Mercado;551;287;264
09;Burgos;154;Hacinas;236;126;110
09;Burgos;155;Haza;47;26;21
09;Burgos;159;Hontanas;100;57;43
09;Burgos;160;Hontangas;195;106;89
09;Burgos;162;Hontoria de la Cantera;171;81;90
09;Burgos;164;Hontoria de Valdearados;311;181;130
09;Burgos;163;Hontoria del Pinar;1098;592;506
09;Burgos;166;Hormazas (Las);191;97;94
09;Burgos;167;Hornillos del Camino;108;54;54
09;Burgos;168;Horra (La);567;297;270
09;Burgos;169;Hortigüela;128;75;53
09;Burgos;170;Hoyales de Roa;405;196;209
09;Burgos;172;Huérmeces;175;99;76
09;Burgos;173;Huerta de Arriba;241;125;116
09;Burgos;174;Huerta de Rey;1314;691;623
09;Burgos;175;Humada;358;206;152
09;Burgos;176;Hurones;72;43;29
09;Burgos;177;Ibeas de Juarros;846;444;402
09;Burgos;178;Ibrillos;133;73;60
09;Burgos;179;Iglesiarrubia;77;42;35
09;Burgos;180;Iglesias;237;121;116
09;Burgos;181;Isar;500;240;260
09;Burgos;182;Itero del Castillo;154;75;79
09;Burgos;183;Jaramillo de la Fuente;41;19;22
09;Burgos;184;Jaramillo Quemado;24;13;11
09;Burgos;189;Junta de Traslaloma;261;143;118
09;Burgos;190;Junta de Villalba de Losa;109;61;48
09;Burgos;191;Jurisdicción de Lara;70;38;32
09;Burgos;192;Jurisdicción de San Zadornil;91;50;41
09;Burgos;194;Lerma;2633;1320;1313
09;Burgos;195;Llano de Bureba;78;42;36
09;Burgos;196;Madrigal del Monte;205;98;107
09;Burgos;197;Madrigalejo del Monte;177;98;79
09;Burgos;198;Mahamud;205;101;104
09;Burgos;199;Mambrilla de Castrejón;188;97;91
09;Burgos;200;Mambrillas de Lara;90;47;43
09;Burgos;201;Mamolar;113;62;51
09;Burgos;202;Manciles;52;27;25
09;Burgos;206;Mazuela;99;50;49
09;Burgos;208;Mecerreyes;384;182;202
09;Burgos;209;Medina de Pomar;5347;2642;2705
09;Burgos;211;Melgar de Fernamental;2306;1162;1144
09;Burgos;213;Merindad de Cuesta-Urria;650;359;291
09;Burgos;214;Merindad de Montija;1110;588;522
09;Burgos;431;Villafranca Montes de Oca;244;128;116
09;Burgos;432;Villafruela;377;196;181
09;Burgos;433;Villagalijo;86;47;39
09;Burgos;434;Villagonzalo Pedernales;484;245;239
09;Burgos;437;Villahoz;503;243;260
09;Burgos;438;Villalba de Duero;557;298;259
09;Burgos;439;Villalbilla de Burgos;509;286;223
09;Burgos;440;Villalbilla de Gumiel;169;92;77
09;Burgos;441;Villaldemiro;98;46;52
09;Burgos;442;Villalmanzo;482;262;220
09;Burgos;443;Villamayor de los Montes;329;166;163
09;Burgos;444;Villamayor de Treviño;132;77;55
09;Burgos;445;Villambistia;106;57;49
09;Burgos;446;Villamedianilla;40;18;22
09;Burgos;447;Villamiel de la Sierra;42;25;17
09;Burgos;448;Villangómez;431;221;210
09;Burgos;449;Villanueva de Argaño;124;71;53
09;Burgos;450;Villanueva de Carazo;29;19;10
09;Burgos;451;Villanueva de Gumiel;344;185;159
09;Burgos;454;Villanueva de Teba;98;54;44
09;Burgos;455;Villaquirán de la Puebla;76;42;34
09;Burgos;456;Villaquirán de los Infantes;245;126;119
09;Burgos;903;Villarcayo de Merindad de Castilla la Vieja;4430;2186;2244
09;Burgos;458;Villariezo;144;77;67
09;Burgos;460;Villasandino;355;184;171
09;Burgos;463;Villasur de Herreros;306;158;148
09;Burgos;464;Villatuelda;95;54;41
09;Burgos;466;Villaverde del Monte;257;141;116
09;Burgos;467;Villaverde-Mogina;155;88;67
09;Burgos;471;Villayerno Morquillas;127;59;68
09;Burgos;472;Villazopeque;106;58;48
09;Burgos;473;Villegas;154;78;76
09;Burgos;476;Villoruebo;38;26;12
09;Burgos;424;Viloria de Rioja;87;45;42
09;Burgos;425;Vilviestre del Pinar;923;464;459
09;Burgos;478;Vizcaínos;64;34;30
09;Burgos;480;Zael;180;87;93
09;Burgos;482;Zarzosa de Río Pisuerga;81;41;40
09;Burgos;483;Zazuar;366;195;171
09;Burgos;485;Zuñeda;128;69;59
09;Burgos;906;Merindad de Río Ubierna;1053;564;489
09;Burgos;215;Merindad de Sotoscueva;782;395;387
09;Burgos;216;Merindad de Valdeporres;610;318;292
09;Burgos;217;Merindad de Valdivielso;715;357;358
09;Burgos;218;Milagros;463;231;232
09;Burgos;219;Miranda de Ebro;36201;18106;18095
09;Burgos;220;Miraveche;157;82;75
09;Burgos;221;Modúbar de la Emparedada;208;115;93
09;Burgos;223;Monasterio de la Sierra;30;16;14
09;Burgos;224;Monasterio de Rodilla;234;123;111
09;Burgos;225;Moncalvillo;171;95;76
09;Burgos;226;Monterrubio de la Demanda;109;64;45
09;Burgos;227;Montorio;192;91;101
09;Burgos;228;Moradillo de Roa;251;130;121
09;Burgos;229;Nava de Roa;368;183;185
09;Burgos;230;Navas de Bureba;59;31;28
09;Burgos;231;Nebreda;158;98;60
09;Burgos;232;Neila;259;130;129
09;Burgos;235;Olmedillo de Roa;342;174;168
09;Burgos;236;Olmillos de Muñó;60;31;29
09;Burgos;238;Oña;1788;923;865
09;Burgos;239;Oquillas;76;42;34
09;Burgos;241;Orbaneja Riopico;115;63;52
09;Burgos;242;Padilla de Abajo;144;79;65
09;Burgos;243;Padilla de Arriba;160;85;75
09;Burgos;244;Padrones de Bureba;111;60;51
09;Burgos;246;Palacios de la Sierra;1013;517;496
09;Burgos;247;Palacios de Riopisuerga;57;27;30
09;Burgos;248;Palazuelos de la Sierra;76;42;34
09;Burgos;249;Palazuelos de Muñó;86;47;39
09;Burgos;250;Pampliega;464;244;220
09;Burgos;251;Pancorbo;625;315;310
09;Burgos;253;Pardilla;125;61;64
09;Burgos;255;Partido de la Sierra en Tobalina;91;55;36
09;Burgos;256;Pedrosa de Duero;695;370;325
09;Burgos;259;Pedrosa de Río Úrbel;332;172;160
09;Burgos;257;Pedrosa del Páramo;123;68;55
09;Burgos;258;Pedrosa del Príncipe;343;184;159
09;Burgos;261;Peñaranda de Duero;729;378;351
09;Burgos;262;Peral de Arlanza;295;156;139
09;Burgos;265;Piérnigas;50;30;20
09;Burgos;266;Pineda de la Sierra;119;66;53
09;Burgos;267;Pineda Trasmonte;246;126;120
09;Burgos;268;Pinilla de los Barruecos;213;111;102
09;Burgos;269;Pinilla de los Moros;59;37;22
09;Burgos;270;Pinilla Trasmonte;320;161;159
09;Burgos;272;Poza de la Sal;543;250;293
09;Burgos;273;Prádanos de Bureba;101;60;41
09;Burgos;274;Pradoluengo;1764;862;902
09;Burgos;275;Presencio;348;192;156
09;Burgos;276;Puebla de Arganzón (La);324;169;155
09;Burgos;277;Puentedura;169;91;78
09;Burgos;279;Quemada;297;163;134
09;Burgos;281;Quintana del Pidio;232;126;106
09;Burgos;280;Quintanabureba;71;44;27
09;Burgos;283;Quintanaélez;153;82;71
09;Burgos;287;Quintanaortuño;132;65;67
09;Burgos;288;Quintanapalla;165;88;77
09;Burgos;289;Quintanar de la Sierra;2928;1498;1430
09;Burgos;292;Quintanavides;92;43;49
09;Burgos;294;Quintanilla de la Mata;193;108;85
09;Burgos;901;Quintanilla del Agua y Tordueles;733;372;361
09;Burgos;295;Quintanilla del Coco;148;81;67
09;Burgos;298;Quintanilla San García;173;91;82
09;Burgos;301;Quintanilla Vivar;282;132;150
09;Burgos;297;Quintanillas (Las);369;192;177
09;Burgos;302;Rabanera del Pinar;241;105;136
09;Burgos;303;Rábanos;65;36;29
09;Burgos;304;Rabé de las Calzadas;160;90;70
09;Burgos;306;Rebolledo de la Torre;220;109;111
09;Burgos;307;Redecilla del Camino;156;89;67
09;Burgos;308;Redecilla del Campo;118;63;55
09;Burgos;309;Regumiel de la Sierra;601;303;298
09;Burgos;310;Reinoso;35;22;13
09;Burgos;311;Retuerta;83;43;40
09;Burgos;314;Revilla del Campo;162;83;79
09;Burgos;316;Revilla Vallejera;189;109;80
09;Burgos;312;Revilla y Ahedo (La);143;73;70
09;Burgos;315;Revillarruz;183;93;90
09;Burgos;317;Rezmondo;28;15;13
09;Burgos;318;Riocavado de la Sierra;74;40;34
09;Burgos;321;Roa;2511;1285;1226
09;Burgos;323;Rojas;107;56;51
09;Burgos;325;Royuela de Río Franco;466;254;212
09;Burgos;326;Rubena;177;91;86
09;Burgos;327;Rublacedo de Abajo;44;22;22
09;Burgos;328;Rucandio;127;64;63
09;Burgos;329;Salas de Bureba;217;119;98
09;Burgos;330;Salas de los Infantes;2203;1135;1068
09;Burgos;332;Saldaña de Burgos;81;41;40
09;Burgos;334;Salinillas de Bureba;75;47;28
09;Burgos;335;San Adrián de Juarros;42;20;22
09;Burgos;337;San Juan del Monte;248;128;120
09;Burgos;338;San Mamés de Burgos;141;77;64
09;Burgos;339;San Martín de Rubiales;417;225;192
09;Burgos;340;San Millán de Lara;122;68;54
09;Burgos;360;San Vicente del Valle;37;19;18
09;Burgos;343;Santa Cecilia;139;74;65
09;Burgos;345;Santa Cruz de la Salceda;226;114;112
09;Burgos;346;Santa Cruz del Valle Urbión;162;98;64
09;Burgos;347;Santa Gadea del Cid;211;109;102
09;Burgos;348;Santa Inés;253;135;118
09;Burgos;350;Santa María del Campo;827;437;390
09;Burgos;351;Santa María del Invierno;73;43;30
09;Burgos;352;Santa María del Mercadillo;243;137;106
09;Burgos;353;Santa María Rivarredonda;180;95;85
09;Burgos;354;Santa Olalla de Bureba;49;21;28
09;Burgos;355;Santibáñez de Esgueva;218;111;107
09;Burgos;356;Santibáñez del Val;91;52;39
09;Burgos;358;Santo Domingo de Silos;363;235;128
09;Burgos;361;Sargentes de la Lora;223;117;106
09;Burgos;362;Sarracín;158;79;79
09;Burgos;363;Sasamón;1796;951;845
09;Burgos;365;Sequera de Haza (La);84;49;35
09;Burgos;366;Solarana;151;77;74
09;Burgos;368;Sordillos;47;27;20
09;Burgos;369;Sotillo de la Ribera;602;331;271
09;Burgos;372;Sotragero;137;78;59
09;Burgos;373;Sotresgudo;942;504;438
09;Burgos;374;Susinos del Páramo;83;39;44
09;Burgos;375;Tamarón;59;30;29
09;Burgos;377;Tardajos;698;367;331
09;Burgos;378;Tejada;62;32;30
09;Burgos;380;Terradillos de Esgueva;142;73;69
09;Burgos;381;Tinieblas de la Sierra;28;16;12
09;Burgos;382;Tobar;65;35;30
09;Burgos;384;Tordómar;454;250;204
09;Burgos;386;Torrecilla del Monte;93;47;46
09;Burgos;387;Torregalindo;203;112;91
09;Burgos;388;Torrelara;17;9;8
09;Burgos;389;Torrepadre;235;125;110
09;Burgos;390;Torresandino;917;485;432
09;Burgos;391;Tórtoles de Esgueva;697;372;325
09;Burgos;392;Tosantos;92;45;47
09;Burgos;394;Trespaderne;1255;664;591
09;Burgos;395;Tubilla del Agua;174;95;79
09;Burgos;396;Tubilla del Lago;252;125;127
09;Burgos;398;Úrbel del Castillo;155;80;75
09;Burgos;400;Vadocondes;574;292;282
09;Burgos;403;Valdeande;231;117;114
09;Burgos;405;Valdezate;270;144;126
09;Burgos;406;Valdorros;112;59;53
09;Burgos;408;Vallarta de Bureba;112;63;49
09;Burgos;904;Valle de las Navas;674;370;304
09;Burgos;908;Valle de Losa;799;436;363
09;Burgos;409;Valle de Manzanedo;148;76;72
09;Burgos;410;Valle de Mena;5011;2541;2470
09;Burgos;411;Valle de Oca;225;115;110
09;Burgos;902;Valle de Santibáñez;746;395;351
09;Burgos;905;Valle de Sedano;490;256;234
09;Burgos;412;Valle de Tobalina;1129;607;522
09;Burgos;413;Valle de Valdebezana;997;523;474
09;Burgos;414;Valle de Valdelaguna;319;159;160
09;Burgos;415;Valle de Valdelucio;472;250;222
09;Burgos;416;Valle de Zamanzas;56;30;26
09;Burgos;417;Vallejera;70;38;32
09;Burgos;418;Valles de Palenzuela;118;62;56
09;Burgos;419;Valluércanes;174;104;70
09;Burgos;407;Valmala;41;19;22
09;Burgos;422;Vid de Bureba (La);56;30;26
09;Burgos;421;Vid y Barrios (La);429;244;185
09;Burgos;423;Vileña;47;26;21
09;Burgos;427;Villadiego;2641;1376;1265
09;Burgos;428;Villaescusa de Roa;223;121;102
09;Burgos;429;Villaescusa la Sombría;81;44;37
09;Burgos;430;Villaespasa;43;25;18
10;Cáceres;001;Abadía;345;195;150
10;Cáceres;002;Abertura;541;273;268
10;Cáceres;003;Acebo;922;464;458
10;Cáceres;004;Acehúche;1081;535;546
10;Cáceres;005;Aceituna;827;427;400
10;Cáceres;006;Ahigal;2029;1044;985
10;Cáceres;007;Albalá del Caudillo;1133;555;578
10;Cáceres;008;Alcántara;2264;1132;1132
10;Cáceres;009;Alcollarín;410;201;209
10;Cáceres;010;Alcuéscar;3484;1872;1612
10;Cáceres;012;Aldea del Cano;858;408;450
10;Cáceres;013;Aldea del Obispo (La);533;267;266
10;Cáceres;011;Aldeacentenera;1102;540;562
10;Cáceres;014;Aldeanueva de la Vera;2872;1445;1427
10;Cáceres;015;Aldeanueva del Camino;1081;519;562
10;Cáceres;016;Aldehuela de Jerte;456;255;201
10;Cáceres;017;Alía;2024;986;1038
10;Cáceres;018;Aliseda;2596;1296;1300
10;Cáceres;019;Almaraz;1389;708;681
10;Cáceres;020;Almoharín;2258;1128;1130
10;Cáceres;021;Arroyo de la Luz;6697;3328;3369
10;Cáceres;023;Arroyomolinos;1228;620;608
10;Cáceres;022;Arroyomolinos de la Vera;757;386;371
10;Cáceres;024;Baños de Montemayor;844;396;448
10;Cáceres;025;Barrado;637;306;331
10;Cáceres;026;Belvís de Monroy;515;260;255
10;Cáceres;027;Benquerencia;129;72;57
10;Cáceres;028;Berrocalejo;150;67;83
10;Cáceres;029;Berzocana;805;420;385
10;Cáceres;030;Bohonal de Ibor;794;434;360
10;Cáceres;031;Botija;235;112;123
10;Cáceres;032;Brozas;2651;1306;1345
10;Cáceres;033;Cabañas del Castillo;758;398;360
10;Cáceres;034;Cabezabellosa;683;343;340
10;Cáceres;035;Cabezuela del Valle;2588;1315;1273
10;Cáceres;036;Cabrero;555;308;247
10;Cáceres;037;Cáceres;71598;34282;37316
10;Cáceres;038;Cachorrilla;143;61;82
10;Cáceres;039;Cadalso;727;375;352
10;Cáceres;040;Calzadilla;702;325;377
10;Cáceres;041;Caminomorisco;1552;813;739
10;Cáceres;042;Campillo de Deleitosa;190;96;94
10;Cáceres;043;Campo Lugar;1446;732;714
10;Cáceres;044;Cañamero;2219;1141;1078
10;Cáceres;045;Cañaveral;1930;911;1019
10;Cáceres;046;Carbajo;294;153;141
10;Cáceres;047;Carcaboso;1387;733;654
10;Cáceres;048;Carrascalejo;537;265;272
10;Cáceres;049;Casar de Cáceres;4049;2058;1991
10;Cáceres;050;Casar de Palomero;1739;877;862
10;Cáceres;051;Casares de las Hurdes;1116;589;527
10;Cáceres;052;Casas de Don Antonio;264;124;140
10;Cáceres;053;Casas de Don Gómez;499;249;250
10;Cáceres;056;Casas de Millán;931;475;456
10;Cáceres;057;Casas de Miravete;201;105;96
10;Cáceres;054;Casas del Castañar;788;384;404
10;Cáceres;055;Casas del Monte;1018;528;490
10;Cáceres;058;Casatejada;1471;718;753
10;Cáceres;059;Casillas de Coria;789;380;409
10;Cáceres;060;Castañar de Ibor;1614;813;801
10;Cáceres;061;Ceclavín;2570;1305;1265
10;Cáceres;062;Cedillo;645;323;322
10;Cáceres;063;Cerezo;284;133;151
10;Cáceres;064;Cilleros;2548;1274;1274
10;Cáceres;065;Collado;535;287;248
10;Cáceres;066;Conquista de la Sierra;208;103;105
10;Cáceres;067;Coria;11284;5656;5628
10;Cáceres;068;Cuacos de Yuste;1080;567;513
10;Cáceres;069;Cumbre (La);1364;677;687
10;Cáceres;070;Deleitosa;1153;561;592
10;Cáceres;071;Descargamaría;331;177;154
10;Cáceres;072;Eljas;1631;820;811
10;Cáceres;073;Escurial;1051;524;527
10;Cáceres;075;Fresnedoso de Ibor;561;293;268
10;Cáceres;076;Galisteo;2388;1216;1172
10;Cáceres;077;Garciaz;1227;622;605
10;Cáceres;078;Garganta (La);711;368;343
10;Cáceres;079;Garganta la Olla;1324;678;646
10;Cáceres;080;Gargantilla;614;317;297
10;Cáceres;081;Gargüera;288;147;141
10;Cáceres;082;Garrovillas de Alconétar;2719;1289;1430
10;Cáceres;083;Garvín;157;88;69
10;Cáceres;084;Gata;2333;1158;1175
10;Cáceres;085;Gordo (El);380;182;198
10;Cáceres;086;Granja (La);505;261;244
10;Cáceres;087;Guadalupe;2776;1364;1412
10;Cáceres;088;Guijo de Coria;406;206;200
10;Cáceres;089;Guijo de Galisteo;1967;1018;949
10;Cáceres;090;Guijo de Granadilla;899;436;463
10;Cáceres;091;Guijo de Santa Bárbara;689;349;340
10;Cáceres;092;Herguijuela;575;282;293
10;Cáceres;093;Hernán-Pérez;538;282;256
10;Cáceres;094;Herrera de Alcántara;450;221;229
10;Cáceres;095;Herreruela;598;299;299
10;Cáceres;096;Hervás;3809;1858;1951
10;Cáceres;097;Higuera;144;71;73
10;Cáceres;098;Hinojal;494;242;252
10;Cáceres;099;Holguera;971;482;489
10;Cáceres;100;Hoyos;1090;539;551
10;Cáceres;101;Huélaga;228;117;111
10;Cáceres;102;Ibahernando;938;470;468
10;Cáceres;103;Jaraicejo;853;418;435
10;Cáceres;104;Jaraíz de la Vera;7653;3790;3863
10;Cáceres;105;Jarandilla de la Vera;3260;1659;1601
10;Cáceres;106;Jarilla;236;110;126
10;Cáceres;107;Jerte;1473;770;703
10;Cáceres;108;Ladrillar;674;344;330
10;Cáceres;109;Logrosán;3221;1576;1645
10;Cáceres;110;Losar de la Vera;3222;1616;1606
10;Cáceres;111;Madrigal de la Vera;1882;983;899
10;Cáceres;112;Madrigalejo;2800;1396;1404
10;Cáceres;113;Madroñera;3473;1719;1754
10;Cáceres;114;Majadas;1164;581;583
10;Cáceres;115;Malpartida de Cáceres;3634;1790;1844
10;Cáceres;116;Malpartida de Plasencia;4443;2200;2243
10;Cáceres;117;Marchagaz;463;223;240
10;Cáceres;118;Mata de Alcántara;442;220;222
10;Cáceres;119;Membrío;1026;490;536
10;Cáceres;120;Mesas de Ibor;233;128;105
10;Cáceres;121;Miajadas;9390;4675;4715
10;Cáceres;122;Millanes;267;145;122
10;Cáceres;123;Mirabel;986;515;471
10;Cáceres;124;Mohedas de Granadilla;1364;712;652
10;Cáceres;125;Monroy;1384;697;687
10;Cáceres;126;Montánchez;2734;1361;1373
10;Cáceres;127;Montehermoso;5382;2710;2672
10;Cáceres;128;Moraleja;8534;4331;4203
10;Cáceres;129;Morcillo;560;259;301
10;Cáceres;130;Navaconcejo;2240;1141;1099
10;Cáceres;131;Navalmoral de la Mata;14271;7041;7230
10;Cáceres;132;Navalvillar de Ibor;669;343;326
10;Cáceres;133;Navas del Madroño;1785;897;888
10;Cáceres;134;Navezuelas;877;478;399
10;Cáceres;135;Nuñomoral;2379;1279;1100
10;Cáceres;136;Oliva de Plasencia;416;209;207
10;Cáceres;137;Palomero;652;339;313
10;Cáceres;138;Pasarón de la Vera;789;392;397
10;Cáceres;139;Pedroso de Acim;206;110;96
10;Cáceres;140;Peraleda de la Mata;1577;785;792
10;Cáceres;141;Peraleda de San Román;521;267;254
10;Cáceres;142;Perales del Puerto;1053;518;535
10;Cáceres;143;Pescueza;287;141;146
10;Cáceres;144;Pesga (La);1573;808;765
10;Cáceres;145;Piedras Albas;302;138;164
10;Cáceres;146;Pinofranqueado;2054;1066;988
10;Cáceres;147;Piornal;1712;863;849
10;Cáceres;148;Plasencia;33613;16499;17114
10;Cáceres;149;Plasenzuela;532;261;271
10;Cáceres;150;Portaje;526;262;264
10;Cáceres;151;Portezuelo;366;177;189
10;Cáceres;152;Pozuelo de Zarzón;740;353;387
10;Cáceres;153;Puerto de Santa Cruz;476;229;247
10;Cáceres;154;Rebollar;296;158;138
10;Cáceres;155;Riolobos;1878;990;888
10;Cáceres;156;Robledillo de Gata;242;128;114
10;Cáceres;157;Robledillo de la Vera;517;266;251
10;Cáceres;158;Robledillo de Trujillo;619;314;305
10;Cáceres;159;Robledollano;560;297;263
10;Cáceres;160;Romangordo;217;107;110
10;Cáceres;901;Rosalejo;"";"";""
10;Cáceres;161;Ruanes;107;55;52
10;Cáceres;162;Salorino;1078;514;564
10;Cáceres;163;Salvatierra de Santiago;547;282;265
10;Cáceres;164;San Martín de Trevejo;975;495;480
10;Cáceres;165;Santa Ana;453;227;226
10;Cáceres;166;Santa Cruz de la Sierra;416;210;206
10;Cáceres;167;Santa Cruz de Paniagua;602;313;289
10;Cáceres;168;Santa Marta de Magasca;443;224;219
10;Cáceres;169;Santiago de Alcántara;1095;560;535
10;Cáceres;170;Santiago del Campo;391;206;185
10;Cáceres;171;Santibáñez el Alto;718;377;341
10;Cáceres;172;Santibáñez el Bajo;1142;612;530
10;Cáceres;173;Saucedilla;509;262;247
10;Cáceres;174;Segura de Toro;234;125;109
10;Cáceres;175;Serradilla;2422;1211;1211
10;Cáceres;176;Serrejón;535;272;263
10;Cáceres;177;Sierra de Fuentes;1584;780;804
10;Cáceres;178;Talaván;1053;511;542
10;Cáceres;179;Talaveruela de la Vera;586;273;313
10;Cáceres;180;Talayuela;7771;3994;3777
10;Cáceres;181;Tejeda de Tiétar;1190;630;560
10;Cáceres;182;Toril;338;172;166
10;Cáceres;183;Tornavacas;1572;809;763
10;Cáceres;184;Torno (El);1253;647;606
10;Cáceres;187;Torre de Don Miguel;845;423;422
10;Cáceres;188;Torre de Santa María;866;437;429
10;Cáceres;185;Torrecilla de los Ángeles;770;403;367
10;Cáceres;186;Torrecillas de la Tiesa;1389;689;700
10;Cáceres;190;Torrejón el Rubio;869;449;420
10;Cáceres;189;Torrejoncillo;4004;1934;2070
10;Cáceres;191;Torremenga;564;289;275
10;Cáceres;192;Torremocha;1500;729;771
10;Cáceres;193;Torreorgaz;1475;742;733
10;Cáceres;194;Torrequemada;665;315;350
10;Cáceres;195;Trujillo;9234;4414;4820
10;Cáceres;196;Valdastillas;484;236;248
10;Cáceres;197;Valdecañas de Tajo;199;110;89
10;Cáceres;198;Valdefuentes;1704;843;861
10;Cáceres;199;Valdehúncar;179;89;90
10;Cáceres;200;Valdelacasa de Tajo;1054;501;553
10;Cáceres;201;Valdemorales;295;155;140
10;Cáceres;202;Valdeobispo;952;479;473
10;Cáceres;203;Valencia de Alcántara;7448;3714;3734
10;Cáceres;204;Valverde de la Vera;811;400;411
10;Cáceres;205;Valverde del Fresno;2892;1463;1429
10;Cáceres;206;Viandar de la Vera;486;243;243
10;Cáceres;207;Villa del Campo;799;397;402
10;Cáceres;208;Villa del Rey;219;110;109
10;Cáceres;209;Villamesías;516;248;268
10;Cáceres;210;Villamiel;906;451;455
10;Cáceres;211;Villanueva de la Sierra;878;435;443
10;Cáceres;212;Villanueva de la Vera;2147;1084;1063
10;Cáceres;214;Villar de Plasencia;399;195;204
10;Cáceres;213;Villar del Pedroso;1080;543;537
10;Cáceres;215;Villasbuenas de Gata;617;310;307
10;Cáceres;216;Zarza de Granadilla;1952;1005;947
10;Cáceres;217;Zarza de Montánchez;863;440;423
10;Cáceres;218;Zarza la Mayor;1928;939;989
10;Cáceres;219;Zorita;2671;1307;1364
11;Cádiz;001;Alcalá de los Gazules;5885;3079;2806
11;Cádiz;002;Alcalá del Valle;5309;2702;2607
11;Cádiz;003;Algar;2200;1161;1039
11;Cádiz;004;Algeciras;99528;49137;50391
11;Cádiz;005;Algodonales;6038;3159;2879
11;Cádiz;006;Arcos de la Frontera;27311;13720;13591
11;Cádiz;007;Barbate;22608;11371;11237
11;Cádiz;008;Barrios (Los);13014;6667;6347
11;Cádiz;901;Benalup-Casas Viejas;"";"";""
11;Cádiz;009;Benaocaz;500;244;256
11;Cádiz;010;Bornos;8138;4101;4037
11;Cádiz;011;Bosque (El);1787;905;882
11;Cádiz;013;Castellar de la Frontera;2238;1163;1075
11;Cádiz;015;Chiclana de la Frontera;43157;22006;21151
11;Cádiz;016;Chipiona;14069;7227;6842
11;Cádiz;014;Conil de la Frontera;14874;7668;7206
11;Cádiz;012;Cádiz;156591;75660;80931
11;Cádiz;017;Espera;4186;2190;1996
11;Cádiz;018;Gastor (El);2308;1221;1087
11;Cádiz;019;Grazalema;2328;1204;1124
11;Cádiz;020;Jerez de la Frontera;183007;90128;92879
11;Cádiz;021;Jimena de la Frontera;8717;4539;4178
11;Cádiz;022;Línea de la Concepción (La);60956;29709;31247
11;Cádiz;023;Medina-Sidonia;16116;8342;7774
11;Cádiz;024;Olvera;9289;4720;4569
11;Cádiz;025;Paterna de Rivera;4828;2515;2313
11;Cádiz;026;Prado del Rey;5478;2764;2714
11;Cádiz;028;Puerto Real;29884;14981;14903
11;Cádiz;029;Puerto Serrano;6246;3168;3078
11;Cádiz;027;Puerto de Santa María (El);62285;31101;31184
11;Cádiz;030;Rota;22047;11169;10878
11;Cádiz;031;San Fernando;81975;40574;41401
11;Cádiz;902;San José del Valle;"";"";""
11;Cádiz;033;San Roque;21715;10902;10813
11;Cádiz;032;Sanlúcar de Barrameda;54690;27462;27228
11;Cádiz;034;Setenil de las Bodegas;3326;1692;1634
11;Cádiz;035;Tarifa;14627;7391;7236
11;Cádiz;036;Torre Alháquime;1064;534;530
11;Cádiz;037;Trebujena;6950;3545;3405
11;Cádiz;038;Ubrique;18007;8940;9067
11;Cádiz;039;Vejer de la Frontera;13202;6749;6453
11;Cádiz;040;Villaluenga del Rosario;491;256;235
11;Cádiz;041;Villamartín;12292;6106;6186
11;Cádiz;042;Zahara;1702;880;822
12;Castellón/Castelló;002;Aín;140;70;70
12;Castellón/Castelló;003;Albocàsser;1553;755;798
12;Castellón/Castelló;004;Alcalà de Xivert;4738;2365;2373
12;Castellón/Castelló;005;Alcora (L');8322;4194;4128
12;Castellón/Castelló;006;Alcudia de Veo;196;92;104
12;Castellón/Castelló;007;Alfondeguilla;931;470;461
12;Castellón/Castelló;008;Algimia de Almonacid;386;208;178
12;Castellón/Castelló;009;Almazora/Almassora;15750;7816;7934
12;Castellón/Castelló;010;Almedíjar;306;149;157
12;Castellón/Castelló;011;Almenara;5084;2541;2543
12;Castellón/Castelló;901;Alquerías del Niño Perdido;3650;1792;1858
12;Castellón/Castelló;012;Altura;3099;1530;1569
12;Castellón/Castelló;013;Arañuel;132;62;70
12;Castellón/Castelló;014;Ares del Maestre;376;193;183
12;Castellón/Castelló;015;Argelita;109;55;54
12;Castellón/Castelló;016;Artana;2022;1014;1008
12;Castellón/Castelló;001;Atzeneta del Maestrat;1701;862;839
12;Castellón/Castelló;017;Ayódar;228;114;114
12;Castellón/Castelló;018;Azuébar;412;198;214
12;Castellón/Castelló;020;Barracas;198;106;92
12;Castellón/Castelló;022;Bejís;497;252;245
12;Castellón/Castelló;024;Benafer;131;73;58
12;Castellón/Castelló;025;Benafigos;292;159;133
12;Castellón/Castelló;026;Benasal;1512;735;777
12;Castellón/Castelló;027;Benicarló;17540;8556;8984
12;Castellón/Castelló;028;Benicasim/Benicàssim;5757;2888;2869
12;Castellón/Castelló;029;Benlloch;1020;524;496
12;Castellón/Castelló;021;Betxí;5166;2628;2538
12;Castellón/Castelló;031;Borriol;2468;1245;1223
12;Castellón/Castelló;032;Burriana;25725;12601;13124
12;Castellón/Castelló;033;Cabanes;2648;1278;1370
12;Castellón/Castelló;034;Càlig;1778;873;905
12;Castellón/Castelló;036;Canet lo Roig;1106;549;557
12;Castellón/Castelló;037;Castell de Cabres;31;14;17
12;Castellón/Castelló;038;Castellfort;309;158;151
12;Castellón/Castelló;039;Castellnovo;1110;563;547
12;Castellón/Castelló;040;Castellón de la Plana/Castelló de la Plana;131809;64656;67153
12;Castellón/Castelló;041;Castillo de Villamalefa;172;86;86
12;Castellón/Castelló;042;Catí;991;509;482
12;Castellón/Castelló;043;Caudiel;719;362;357
12;Castellón/Castelló;044;Cervera del Maestre;839;412;427
12;Castellón/Castelló;052;Chert/Xert;1123;547;576
12;Castellón/Castelló;053;Chilches/Xilxes;2172;1088;1084
12;Castellón/Castelló;055;Chodos/Xodos;161;87;74
12;Castellón/Castelló;056;Chóvar;424;220;204
12;Castellón/Castelló;045;Cinctorres;643;295;348
12;Castellón/Castelló;046;Cirat;395;197;198
12;Castellón/Castelló;048;Cortes de Arenoso;421;230;191
12;Castellón/Castelló;049;Costur;484;246;238
12;Castellón/Castelló;050;Coves de Vinromà (les);2075;1037;1038
12;Castellón/Castelló;051;Culla;1074;534;540
12;Castellón/Castelló;057;Eslida;861;427;434
12;Castellón/Castelló;058;Espadilla;53;22;31
12;Castellón/Castelló;059;Fanzara;294;142;152
12;Castellón/Castelló;060;Figueroles;589;295;294
12;Castellón/Castelló;061;Forcall;676;324;352
12;Castellón/Castelló;063;Fuente la Reina;34;18;16
12;Castellón/Castelló;064;Fuentes de Ayódar;90;49;41
12;Castellón/Castelló;065;Gaibiel;272;135;137
12;Castellón/Castelló;066;Gatova;570;276;294
12;Castellón/Castelló;067;Geldo;760;385;375
12;Castellón/Castelló;068;Herbés;138;74;64
12;Castellón/Castelló;069;Higueras;49;27;22
12;Castellón/Castelló;070;Jana (La);979;494;485
12;Castellón/Castelló;071;Jérica;1754;889;865
12;Castellón/Castelló;074;Llosa (La);949;476;473
12;Castellón/Castelló;072;Lucena del Cid;1758;855;903
12;Castellón/Castelló;073;Ludiente;282;140;142
12;Castellón/Castelló;075;Mata de Morella (La);209;102;107
12;Castellón/Castelló;076;Matet;161;84;77
12;Castellón/Castelló;077;Moncofa;3558;1756;1802
12;Castellón/Castelló;078;Montán;398;207;191
12;Castellón/Castelló;079;Montanejos;465;241;224
12;Castellón/Castelló;080;Morella;3061;1478;1583
12;Castellón/Castelló;081;Navajas;510;247;263
12;Castellón/Castelló;082;Nules;11371;5598;5773
12;Castellón/Castelló;083;Olocau del Rey;166;91;75
12;Castellón/Castelló;084;Onda;18147;9034;9113
12;Castellón/Castelló;085;Oropesa del Mar/Orpesa;2085;1071;1014
12;Castellón/Castelló;087;Palanques;27;16;11
12;Castellón/Castelló;088;Pavías;74;39;35
12;Castellón/Castelló;089;Peñíscola;3402;1701;1701
12;Castellón/Castelló;090;Pina de Montalgrao;216;120;96
12;Castellón/Castelló;093;Pobla de Benifassà (La);248;120;128
12;Castellón/Castelló;094;Pobla Tornesa (La);501;247;254
12;Castellón/Castelló;091;Portell de Morella;329;173;156
12;Castellón/Castelló;092;Puebla de Arenoso;222;109;113
12;Castellón/Castelló;095;Ribesalbes;1378;677;701
12;Castellón/Castelló;096;Rossell;1292;656;636
12;Castellón/Castelló;097;Sacañet;69;30;39
12;Castellón/Castelló;098;Salzadella (La);916;451;465
12;Castellón/Castelló;101;San Rafael del Río;524;261;263
12;Castellón/Castelló;902;Sant Joan de Moró;"";"";""
12;Castellón/Castelló;099;Sant Jordi/San Jorge;593;290;303
12;Castellón/Castelló;100;Sant Mateu;1906;916;990
12;Castellón/Castelló;102;Santa Magdalena de Pulpis;754;387;367
12;Castellón/Castelló;103;Sarratella;130;66;64
12;Castellón/Castelló;104;Segorbe;7762;3780;3982
12;Castellón/Castelló;105;Sierra Engarcerán;1175;609;566
12;Castellón/Castelló;106;Soneja;1507;761;746
12;Castellón/Castelló;107;Sot de Ferrer;427;216;211
12;Castellón/Castelló;108;Sueras/Suera;611;306;305
12;Castellón/Castelló;109;Tales;777;362;415
12;Castellón/Castelló;110;Teresa;471;243;228
12;Castellón/Castelló;111;Tírig;706;344;362
12;Castellón/Castelló;112;Todolella;160;80;80
12;Castellón/Castelló;113;Toga;114;49;65
12;Castellón/Castelló;114;Torás;321;168;153
12;Castellón/Castelló;115;Toro (El);324;171;153
12;Castellón/Castelló;116;Torralba del Pinar;70;36;34
12;Castellón/Castelló;119;Torre d'En Besora (La);268;139;129
12;Castellón/Castelló;120;Torre Endoménech;319;160;159
12;Castellón/Castelló;117;Torreblanca;4618;2332;2286
12;Castellón/Castelló;118;Torrechiva;61;35;26
12;Castellón/Castelló;121;Traiguera;1713;873;840
12;Castellón/Castelló;122;Useras/Useres (Les);1246;633;613
12;Castellón/Castelló;124;Vall d'Alba;2031;1024;1007
12;Castellón/Castelló;125;Vall de Almonacid;279;138;141
12;Castellón/Castelló;126;Vall d'Uixó (La);27853;13924;13929
12;Castellón/Castelló;123;Vallat;32;15;17
12;Castellón/Castelló;127;Vallibona;126;58;68
12;Castellón/Castelló;128;Vilafamés;3064;1586;1478
12;Castellón/Castelló;132;Vilanova d'Alcolea;843;419;424
12;Castellón/Castelló;134;Vilar de Canes;227;117;110
12;Castellón/Castelló;129;Villafranca del Cid;2877;1356;1521
12;Castellón/Castelló;130;Villahermosa del Río;549;286;263
12;Castellón/Castelló;131;Villamalur;172;93;79
12;Castellón/Castelló;133;Villanueva de Viver;138;72;66
12;Castellón/Castelló;135;Villarreal/Vila-real;37659;18619;19040
12;Castellón/Castelló;136;Villavieja;3463;1721;1742
12;Castellón/Castelló;137;Villores;104;54;50
12;Castellón/Castelló;138;Vinaròs;18560;9039;9521
12;Castellón/Castelló;139;Vistabella del Maestrazgo;625;308;317
12;Castellón/Castelló;140;Viver;1276;639;637
12;Castellón/Castelló;141;Zorita del Maestrazgo;155;71;84
12;Castellón/Castelló;142;Zucaina;259;141;118
13;Ciudad Real;001;Abenójar;2137;1089;1048
13;Ciudad Real;002;Agudo;2409;1211;1198
13;Ciudad Real;003;Alamillo;805;409;396
13;Ciudad Real;004;Albaladejo;2026;990;1036
13;Ciudad Real;005;Alcázar de San Juan;26258;12808;13450
13;Ciudad Real;006;Alcoba;927;462;465
13;Ciudad Real;007;Alcolea de Calatrava;1635;812;823
13;Ciudad Real;008;Alcubillas;883;430;453
13;Ciudad Real;009;Aldea del Rey;2530;1215;1315
13;Ciudad Real;010;Alhambra;1481;743;738
13;Ciudad Real;011;Almadén;9168;4429;4739
13;Ciudad Real;012;Almadenejos;797;421;376
13;Ciudad Real;013;Almagro;8397;4047;4350
13;Ciudad Real;014;Almedina;1006;487;519
13;Ciudad Real;015;Almodóvar del Campo;8542;4288;4254
13;Ciudad Real;016;Almuradiel;862;423;439
13;Ciudad Real;017;Anchuras;518;272;246
13;Ciudad Real;903;Arenales de San Gregorio;"";"";""
13;Ciudad Real;018;Arenas de San Juan;1088;561;527
13;Ciudad Real;019;Argamasilla de Alba;7239;3591;3648
13;Ciudad Real;020;Argamasilla de Calatrava;5750;2850;2900
13;Ciudad Real;021;Arroba de los Montes;725;373;352
13;Ciudad Real;022;Ballesteros de Calatrava;725;360;365
13;Ciudad Real;023;Bolaños de Calatrava;10235;5068;5167
13;Ciudad Real;024;Brazatortas;1509;753;756
13;Ciudad Real;025;Cabezarados;432;219;213
13;Ciudad Real;026;Cabezarrubias del Puerto;821;425;396
13;Ciudad Real;027;Calzada de Calatrava;5287;2604;2683
13;Ciudad Real;028;Campo de Criptana;13889;6800;7089
13;Ciudad Real;029;Cañada de Calatrava;97;56;41
13;Ciudad Real;030;Caracuel de Calatrava;209;106;103
13;Ciudad Real;031;Carrión de Calatrava;2501;1199;1302
13;Ciudad Real;032;Carrizosa;1821;913;908
13;Ciudad Real;033;Castellar de Santiago;2572;1248;1324
13;Ciudad Real;038;Chillón;2778;1343;1435
13;Ciudad Real;034;Ciudad Real;56300;26785;29515
13;Ciudad Real;035;Corral de Calatrava;1418;694;724
13;Ciudad Real;036;Cortijos (Los);1277;640;637
13;Ciudad Real;037;Cózar;1618;788;830
13;Ciudad Real;039;Daimiel;17223;8369;8854
13;Ciudad Real;040;Fernán Caballero;1129;540;589
13;Ciudad Real;041;Fontanarejo;517;268;249
13;Ciudad Real;042;Fuencaliente;1470;782;688
13;Ciudad Real;043;Fuenllana;377;163;214
13;Ciudad Real;044;Fuente el Fresno;3727;1825;1902
13;Ciudad Real;045;Granátula de Calatrava;1223;587;636
13;Ciudad Real;046;Guadalmez;1193;614;579
13;Ciudad Real;047;Herencia;7195;3550;3645
13;Ciudad Real;048;Hinojosas de Calatrava;1056;510;546
13;Ciudad Real;049;Horcajo de los Montes;1244;629;615
13;Ciudad Real;050;Labores (Las);702;347;355
13;Ciudad Real;904;Llanos del Caudillo;"";"";""
13;Ciudad Real;051;Luciana;548;287;261
13;Ciudad Real;052;Malagón;8172;4030;4142
13;Ciudad Real;053;Manzanares;18032;8779;9253
13;Ciudad Real;054;Membrilla;6790;3386;3404
13;Ciudad Real;055;Mestanza;1253;613;640
13;Ciudad Real;056;Miguelturra;7301;3595;3706
13;Ciudad Real;057;Montiel;1786;884;902
13;Ciudad Real;058;Moral de Calatrava;5335;2579;2756
13;Ciudad Real;059;Navalpino;393;199;194
13;Ciudad Real;060;Navas de Estena;509;276;233
13;Ciudad Real;061;Pedro Muñoz;7251;3617;3634
13;Ciudad Real;062;Picón;620;329;291
13;Ciudad Real;063;Piedrabuena;5179;2594;2585
13;Ciudad Real;064;Poblete;675;345;330
13;Ciudad Real;065;Porzuna;4120;2093;2027
13;Ciudad Real;066;Pozuelo de Calatrava;2363;1153;1210
13;Ciudad Real;067;Pozuelos de Calatrava (Los);683;362;321
13;Ciudad Real;068;Puebla de Don Rodrigo;1400;738;662
13;Ciudad Real;069;Puebla del Príncipe;1160;592;568
13;Ciudad Real;070;Puerto Lápice;1062;530;532
13;Ciudad Real;071;Puertollano;52284;25619;26665
13;Ciudad Real;072;Retuerta del Bullaque;1119;581;538
13;Ciudad Real;901;Robledo (El);1308;682;626
13;Ciudad Real;902;Ruidera;"";"";""
13;Ciudad Real;073;Saceruela;867;452;415
13;Ciudad Real;074;San Carlos del Valle;1315;659;656
13;Ciudad Real;075;San Lorenzo de Calatrava;425;224;201
13;Ciudad Real;076;Santa Cruz de los Cáñamos;729;367;362
13;Ciudad Real;077;Santa Cruz de Mudela;5056;2433;2623
13;Ciudad Real;078;Socuéllamos;11935;5846;6089
13;Ciudad Real;080;Solana del Pino;803;399;404
13;Ciudad Real;079;Solana (La);14458;7189;7269
13;Ciudad Real;081;Terrinches;1203;594;609
13;Ciudad Real;082;Tomelloso;28386;13894;14492
13;Ciudad Real;083;Torralba de Calatrava;3151;1523;1628
13;Ciudad Real;084;Torre de Juan Abad;1989;963;1026
13;Ciudad Real;085;Torrenueva;3383;1664;1719
13;Ciudad Real;086;Valdemanco del Esteras;363;186;177
13;Ciudad Real;087;Valdepeñas;25568;12363;13205
13;Ciudad Real;088;Valenzuela de Calatrava;858;409;449
13;Ciudad Real;089;Villahermosa;3345;1574;1771
13;Ciudad Real;090;Villamanrique;2001;991;1010
13;Ciudad Real;091;Villamayor de Calatrava;849;425;424
13;Ciudad Real;092;Villanueva de la Fuente;3236;1611;1625
13;Ciudad Real;093;Villanueva de los Infantes;6319;3025;3294
13;Ciudad Real;094;Villanueva de San Carlos;591;292;299
13;Ciudad Real;095;Villar del Pozo;106;52;54
13;Ciudad Real;096;Villarrubia de los Ojos;9509;4763;4746
13;Ciudad Real;097;Villarta de San Juan;3018;1489;1529
13;Ciudad Real;098;Viso del Marqués;3456;1692;1764
14;Córdoba;001;Adamuz;4644;2332;2312
14;Córdoba;002;Aguilar de la Frontera;13166;6475;6691
14;Córdoba;003;Alcaracejos;1507;759;748
14;Córdoba;004;Almedinilla;2786;1386;1400
14;Córdoba;005;Almodóvar del Río;6970;3489;3481
14;Córdoba;006;Añora;1843;881;962
14;Córdoba;007;Baena;18985;9398;9587
14;Córdoba;008;Belalcázar;4201;2037;2164
14;Córdoba;009;Belmez;4695;2259;2436
14;Córdoba;010;Benamejí;4712;2326;2386
14;Córdoba;011;Blázquez (Los);808;410;398
14;Córdoba;012;Bujalance;8956;4421;4535
14;Córdoba;013;Cabra;20368;9955;10413
14;Córdoba;015;Carcabuey;3075;1512;1563
14;Córdoba;016;Cardeña;2195;1109;1086
14;Córdoba;017;Carlota (La);9012;4542;4470
14;Córdoba;018;Carpio (El);4830;2367;2463
14;Córdoba;019;Castro del Río;7890;3845;4045
14;Córdoba;014;Cañete de las Torres;3492;1754;1738
14;Córdoba;020;Conquista;588;288;300
14;Córdoba;021;Córdoba;302301;145933;156368
14;Córdoba;023;Dos Torres;2501;1223;1278
14;Córdoba;022;Doña Mencía;5205;2562;2643
14;Córdoba;024;Encinas Reales;2242;1100;1142
14;Córdoba;025;Espejo;5165;2539;2626
14;Córdoba;026;Espiel;2836;1395;1441
14;Córdoba;027;Fernán-Núñez;9362;4656;4706
14;Córdoba;029;Fuente Obejuna;6985;3551;3434
14;Córdoba;030;Fuente Palmera;9311;4720;4591
14;Córdoba;028;Fuente la Lancha;521;258;263
14;Córdoba;031;Fuente-Tójar;939;454;485
14;Córdoba;032;Granjuela (La);565;293;272
14;Córdoba;033;Guadalcázar;1270;649;621
14;Córdoba;034;Guijo (El);527;268;259
14;Córdoba;035;Hinojosa del Duque;8308;3970;4338
14;Córdoba;036;Hornachuelos;5404;2765;2639
14;Córdoba;037;Iznájar;6252;3148;3104
14;Córdoba;038;Lucena;31987;15965;16022
14;Córdoba;039;Luque;3490;1719;1771
14;Córdoba;040;Montalbán de Córdoba;4458;2231;2227
14;Córdoba;041;Montemayor;3734;1897;1837
14;Córdoba;042;Montilla;22434;11112;11322
14;Córdoba;043;Montoro;9972;4896;5076
14;Córdoba;044;Monturque;2001;1020;981
14;Córdoba;045;Moriles;3669;1820;1849
14;Córdoba;046;Nueva Carteya;5856;2950;2906
14;Córdoba;047;Obejo;1503;741;762
14;Córdoba;048;Palenciana;1781;889;892
14;Córdoba;049;Palma del Río;18854;9391;9463
14;Córdoba;050;Pedro Abad;3060;1508;1552
14;Córdoba;051;Pedroche;1918;951;967
14;Córdoba;052;Peñarroya-Pueblonuevo;14051;6701;7350
14;Córdoba;053;Posadas;7042;3533;3509
14;Córdoba;054;Pozoblanco;14779;7072;7707
14;Córdoba;055;Priego de Córdoba;21186;10400;10786
14;Córdoba;056;Puente Genil;27243;13287;13956
14;Córdoba;057;Rambla (La);7117;3548;3569
14;Córdoba;058;Rute;10097;4915;5182
14;Córdoba;059;San Sebastián de los Ballesteros;835;427;408
14;Córdoba;061;Santa Eufemia;1389;694;695
14;Córdoba;060;Santaella;5864;2936;2928
14;Córdoba;062;Torrecampo;1685;817;868
14;Córdoba;063;Valenzuela;1703;807;896
14;Córdoba;064;Valsequillo;639;319;320
14;Córdoba;065;Victoria (La);1743;863;880
14;Córdoba;066;Villa del Río;7142;3606;3536
14;Córdoba;067;Villafranca de Córdoba;3591;1820;1771
14;Córdoba;068;Villaharta;666;320;346
14;Córdoba;069;Villanueva de Córdoba;10576;5133;5443
14;Córdoba;070;Villanueva del Duque;2149;995;1154
14;Córdoba;071;Villanueva del Rey;1404;724;680
14;Córdoba;072;Villaralto;1885;892;993
14;Córdoba;073;Villaviciosa de Córdoba;4292;2182;2110
14;Córdoba;074;Viso (El);3654;1791;1863
14;Córdoba;075;Zuheros;1056;515;541
15;Coruña (A);001;Abegondo;6175;3054;3121
15;Coruña (A);002;Ames;9816;4702;5114
15;Coruña (A);003;Aranga;2650;1308;1342
15;Coruña (A);004;Ares;4826;2348;2478
15;Coruña (A);005;Arteixo;17247;8665;8582
15;Coruña (A);006;Arzúa;7378;3692;3686
15;Coruña (A);007;Baña (A);7490;3668;3822
15;Coruña (A);008;Bergondo;5577;2693;2884
15;Coruña (A);009;Betanzos;11786;5509;6277
15;Coruña (A);010;Boimorto;3300;1668;1632
15;Coruña (A);011;Boiro;17891;8648;9243
15;Coruña (A);012;Boqueixón;5002;2497;2505
15;Coruña (A);013;Brión;7031;3403;3628
15;Coruña (A);014;Cabana de Bergantiños;7225;3651;3574
15;Coruña (A);015;Cabanas;3273;1585;1688
15;Coruña (A);016;Camariñas;7519;3768;3751
15;Coruña (A);017;Cambre;11184;5438;5746
15;Coruña (A);018;Capela (A);1854;924;930
15;Coruña (A);019;Carballo;27390;13625;13765
15;Coruña (A);901;Cariño;"";"";""
15;Coruña (A);020;Carnota;7208;3487;3721
15;Coruña (A);021;Carral;5631;2803;2828
15;Coruña (A);022;Cedeira;8026;3929;4097
15;Coruña (A);023;Cee;7864;3858;4006
15;Coruña (A);024;Cerceda;7409;3641;3768
15;Coruña (A);025;Cerdido;2113;1034;1079
15;Coruña (A);026;Cesuras;3258;1618;1640
15;Coruña (A);027;Coirós;1636;819;817
15;Coruña (A);028;Corcubión;2111;1018;1093
15;Coruña (A);029;Coristanco;10267;5221;5046
15;Coruña (A);030;A Coruña;248862;117263;131599
15;Coruña (A);031;Culleredo;13474;6576;6898
15;Coruña (A);032;Curtis;5175;2570;2605
15;Coruña (A);033;Dodro;3690;1773;1917
15;Coruña (A);034;Dumbría;5061;2509;2552
15;Coruña (A);035;Fene;15813;7789;8024
15;Coruña (A);036;Ferrol;86503;40895;45608
15;Coruña (A);037;Fisterra;5552;2787;2765
15;Coruña (A);038;Frades;3627;1842;1785
15;Coruña (A);039;Irixoa;2030;980;1050
15;Coruña (A);041;Laracha (A);12012;5997;6015
15;Coruña (A);040;Laxe;3824;1915;1909
15;Coruña (A);042;Lousame;5017;2445;2572
15;Coruña (A);043;Malpica de Bergantiños;8513;4197;4316
15;Coruña (A);045;Mazaricos;7258;3513;3745
15;Coruña (A);044;Mañón;2502;1209;1293
15;Coruña (A);046;Melide;8380;4185;4195
15;Coruña (A);047;Mesía;4240;2121;2119
15;Coruña (A);048;Miño;5310;2527;2783
15;Coruña (A);049;Moeche;1903;912;991
15;Coruña (A);050;Monfero;3276;1670;1606
15;Coruña (A);051;Mugardos;6968;3401;3567
15;Coruña (A);053;Muros;12129;5862;6267
15;Coruña (A);052;Muxía;7132;3507;3625
15;Coruña (A);054;Narón;30925;15093;15832
15;Coruña (A);055;Neda;6765;3226;3539
15;Coruña (A);056;Negreira;7255;3459;3796
15;Coruña (A);057;Noia;14599;7111;7488
15;Coruña (A);058;Oleiros;17092;8332;8760
15;Coruña (A);059;Ordes;12069;5923;6146
15;Coruña (A);060;Oroso;4110;2034;2076
15;Coruña (A);061;Ortigueira;16279;7849;8430
15;Coruña (A);062;Outes;10091;4798;5293
15;Coruña (A);063;Oza dos Ríos;3459;1703;1756
15;Coruña (A);064;Paderne;3071;1470;1601
15;Coruña (A);065;Padrón;10304;5015;5289
15;Coruña (A);066;Pino (O);5724;2864;2860
15;Coruña (A);067;Pobra do Caramiñal (A);10457;5013;5444
15;Coruña (A);068;Ponteceso;8592;4339;4253
15;Coruña (A);069;Pontedeume;8715;4217;4498
15;Coruña (A);070;Pontes de García Rodríguez (As);13714;6982;6732
15;Coruña (A);071;Porto do Son;11226;5510;5716
15;Coruña (A);072;Rianxo;13297;6539;6758
15;Coruña (A);073;Ribeira;25719;12650;13069
15;Coruña (A);074;Rois;6086;2976;3110
15;Coruña (A);075;Sada;8399;4017;4382
15;Coruña (A);076;San Sadurniño;4053;1961;2092
15;Coruña (A);077;Santa Comba;12126;5956;6170
15;Coruña (A);078;Santiago de Compostela;88110;41921;46189
15;Coruña (A);079;Santiso;2795;1464;1331
15;Coruña (A);080;Sobrado;3119;1609;1510
15;Coruña (A);081;Somozas (As);1813;897;916
15;Coruña (A);082;Teo;11496;5620;5876
15;Coruña (A);083;Toques;2173;1123;1050
15;Coruña (A);084;Tordoia;6073;2936;3137
15;Coruña (A);085;Touro;5548;2743;2805
15;Coruña (A);086;Trazo;5007;2536;2471
15;Coruña (A);088;Val do Dubra;6196;3061;3135
15;Coruña (A);087;Valdoviño;7123;3528;3595
15;Coruña (A);089;Vedra;5740;2768;2972
15;Coruña (A);091;Vilarmaior;1558;754;804
15;Coruña (A);090;Vilasantar;2357;1195;1162
15;Coruña (A);092;Vimianzo;9712;4813;4899
15;Coruña (A);093;Zas;7049;3432;3617
16;Cuenca;001;Abia de la Obispalía;118;65;53
16;Cuenca;002;Acebrón (El);337;165;172
16;Cuenca;003;Alarcón;265;138;127
16;Cuenca;004;Albaladejo del Cuende;521;276;245
16;Cuenca;005;Albalate de las Nogueras;465;249;216
16;Cuenca;006;Albendea;237;122;115
16;Cuenca;007;Alberca de Záncara (La);2023;1000;1023
16;Cuenca;008;Alcalá de la Vega;240;126;114
16;Cuenca;009;Alcantud;181;98;83
16;Cuenca;011;Alcohujate;80;41;39
16;Cuenca;012;Alconchel de la Estrella;251;121;130
16;Cuenca;010;Alcázar del Rey;311;158;153
16;Cuenca;013;Algarra;40;20;20
16;Cuenca;014;Aliaguilla;988;493;495
16;Cuenca;015;Almarcha (La);754;373;381
16;Cuenca;016;Almendros;475;238;237
16;Cuenca;017;Almodóvar del Pinar;600;312;288
16;Cuenca;018;Almonacid del Marquesado;620;317;303
16;Cuenca;019;Altarejos;512;259;253
16;Cuenca;020;Arandilla del Arroyo;66;35;31
16;Cuenca;905;Arcas del Villar;383;186;197
16;Cuenca;022;Arcos de la Sierra;152;84;68
16;Cuenca;024;Arguisuelas;252;127;125
16;Cuenca;025;Arrancacepas;51;25;26
16;Cuenca;026;Atalaya del Cañavate;162;79;83
16;Cuenca;027;Barajas de Melo;787;390;397
16;Cuenca;029;Barchín del Hoyo;192;105;87
16;Cuenca;030;Bascuñana de San Pedro;39;19;20
16;Cuenca;031;Beamud;105;58;47
16;Cuenca;032;Belinchón;357;177;180
16;Cuenca;033;Belmonte;2766;1284;1482
16;Cuenca;034;Belmontejo;336;175;161
16;Cuenca;035;Beteta;478;236;242
16;Cuenca;036;Boniches;268;130;138
16;Cuenca;038;Buciegas;122;64;58
16;Cuenca;039;Buenache de Alarcón;727;373;354
16;Cuenca;040;Buenache de la Sierra;112;68;44
16;Cuenca;041;Buendía;468;233;235
16;Cuenca;042;Campillo de Altobuey;1833;912;921
16;Cuenca;043;Campillos-Paravientos;180;96;84
16;Cuenca;044;Campillos-Sierra;109;57;52
16;Cuenca;901;Campos del Paraíso;1546;715;831
16;Cuenca;045;Canalejas del Arroyo;461;239;222
16;Cuenca;055;Carboneras de Guadazaón;1125;598;527
16;Cuenca;056;Cardenete;812;419;393
16;Cuenca;057;Carrascosa;169;91;78
16;Cuenca;058;Carrascosa de Haro;208;102;106
16;Cuenca;060;Casas de Benítez;1259;620;639
16;Cuenca;061;Casas de Fernando Alonso;1508;739;769
16;Cuenca;062;Casas de Garcimolina;42;18;24
16;Cuenca;063;Casas de Guijarro;212;107;105
16;Cuenca;064;Casas de Haro;961;472;489
16;Cuenca;065;Casas de los Pinos;638;322;316
16;Cuenca;066;Casasimarro;3137;1567;1570
16;Cuenca;067;Castejón;307;163;144
16;Cuenca;068;Castillejo de Iniesta;208;117;91
16;Cuenca;070;Castillejo-Sierra;64;30;34
16;Cuenca;072;Castillo de Garcimuñoz;338;173;165
16;Cuenca;071;Castillo-Albaráñez;40;19;21
16;Cuenca;047;Cañada Juncosa;438;228;210
16;Cuenca;046;Cañada del Hoyo;435;224;211
16;Cuenca;048;Cañamares;637;339;298
16;Cuenca;049;Cañavate (El);340;175;165
16;Cuenca;050;Cañaveras;504;255;249
16;Cuenca;051;Cañaveruelas;282;143;139
16;Cuenca;052;Cañete;974;485;489
16;Cuenca;053;Cañizares;726;396;330
16;Cuenca;073;Cervera del Llano;399;206;193
16;Cuenca;023;Chillarón de Cuenca;311;153;158
16;Cuenca;081;Chumillas;71;40;31
16;Cuenca;074;Cierva (La);68;39;29
16;Cuenca;078;Cuenca;42222;20443;21779
16;Cuenca;079;Cueva del Hierro;63;37;26
16;Cuenca;082;Enguídanos;744;384;360
16;Cuenca;083;Fresneda de Altarejos;112;63;49
16;Cuenca;084;Fresneda de la Sierra;106;48;58
16;Cuenca;085;Frontera (La);282;148;134
16;Cuenca;086;Fuente de Pedro Naharro;1347;668;679
16;Cuenca;087;Fuentelespino de Haro;438;240;198
16;Cuenca;088;Fuentelespino de Moya;189;90;99
16;Cuenca;904;Fuentenava de Jábaga;292;152;140
16;Cuenca;089;Fuentes;616;317;299
16;Cuenca;091;Fuertescusa;130;62;68
16;Cuenca;092;Gabaldón;216;124;92
16;Cuenca;093;Garaballa;243;126;117
16;Cuenca;094;Gascueña;222;109;113
16;Cuenca;095;Graja de Campalbo;167;95;72
16;Cuenca;096;Graja de Iniesta;394;206;188
16;Cuenca;097;Henarejos;416;204;212
16;Cuenca;098;Herrumblar (El);799;410;389
16;Cuenca;099;Hinojosa (La);428;206;222
16;Cuenca;100;Hinojosos (Los);1407;702;705
16;Cuenca;101;Hito (El);301;148;153
16;Cuenca;102;Honrubia;1736;868;868
16;Cuenca;103;Hontanaya;656;330;326
16;Cuenca;104;Hontecillas;120;57;63
16;Cuenca;106;Horcajo de Santiago;3686;1831;1855
16;Cuenca;108;Huelves;95;44;51
16;Cuenca;110;Huerta de la Obispalía;199;114;85
16;Cuenca;111;Huerta del Marquesado;201;102;99
16;Cuenca;112;Huete;2604;1309;1295
16;Cuenca;107;Huélamo;149;79;70
16;Cuenca;109;Huérguina;105;54;51
16;Cuenca;113;Iniesta;3692;1822;1870
16;Cuenca;115;Laguna del Marquesado;85;48;37
16;Cuenca;116;Lagunaseca;116;56;60
16;Cuenca;117;Landete;1704;847;857
16;Cuenca;118;Ledaña;2239;1132;1107
16;Cuenca;119;Leganiel;347;171;176
16;Cuenca;121;Majadas (Las);442;233;209
16;Cuenca;122;Mariana;323;155;168
16;Cuenca;123;Masegosa;167;81;86
16;Cuenca;124;Mesas (Las);2722;1393;1329
16;Cuenca;125;Minglanilla;2386;1201;1185
16;Cuenca;126;Mira;1291;641;650
16;Cuenca;128;Monreal del Llano;105;54;51
16;Cuenca;129;Montalbanejo;254;125;129
16;Cuenca;130;Montalbo;925;490;435
16;Cuenca;131;Monteagudo de las Salinas;143;78;65
16;Cuenca;132;Mota de Altarejos;87;46;41
16;Cuenca;133;Mota del Cuervo;5670;2797;2873
16;Cuenca;134;Motilla del Palancar;4786;2397;2389
16;Cuenca;135;Moya;404;212;192
16;Cuenca;137;Narboneta;124;64;60
16;Cuenca;139;Olivares de Júcar;785;382;403
16;Cuenca;140;Olmeda de la Cuesta;73;38;35
16;Cuenca;141;Olmeda del Rey;292;139;153
16;Cuenca;142;Olmedilla de Alarcón;283;145;138
16;Cuenca;143;Olmedilla de Eliz;39;23;16
16;Cuenca;145;Osa de la Vega;780;392;388
16;Cuenca;147;Pajaroncillo;124;65;59
16;Cuenca;146;Pajarón;171;91;80
16;Cuenca;148;Palomares del Campo;1053;528;525
16;Cuenca;149;Palomera;146;69;77
16;Cuenca;150;Paracuellos;243;123;120
16;Cuenca;151;Paredes;86;45;41
16;Cuenca;152;Parra de las Vegas (La);81;39;42
16;Cuenca;153;Pedernoso (El);1460;713;747
16;Cuenca;154;Pedroñeras (Las);6660;3364;3296
16;Cuenca;155;Peral (El);791;404;387
16;Cuenca;156;Peraleja (La);263;138;125
16;Cuenca;157;Pesquera (La);352;186;166
16;Cuenca;158;Picazo (El);784;381;403
16;Cuenca;159;Pinarejo;638;326;312
16;Cuenca;160;Pineda de Gigüela;232;117;115
16;Cuenca;161;Piqueras del Castillo;115;65;50
16;Cuenca;162;Portalrubio de Guadamejud;148;74;74
16;Cuenca;163;Portilla;125;61;64
16;Cuenca;165;Poyatos;138;75;63
16;Cuenca;166;Pozoamargo;429;212;217
16;Cuenca;908;Pozorrubielos de la Mancha;334;168;166
16;Cuenca;167;Pozorrubio;564;275;289
16;Cuenca;169;Pozuelo (El);114;59;55
16;Cuenca;170;Priego;1218;625;593
16;Cuenca;171;Provencio (El);2984;1476;1508
16;Cuenca;172;Puebla de Almenara;762;387;375
16;Cuenca;173;Puebla de Don Francisco;531;278;253
16;Cuenca;174;Puebla del Salvador;379;209;170
16;Cuenca;175;Quintanar del Rey;5701;2913;2788
16;Cuenca;176;Rada de Haro;76;37;39
16;Cuenca;177;Reíllo;172;81;91
16;Cuenca;181;Rozalén del Monte;188;88;100
16;Cuenca;185;Saceda-Trasierra;70;35;35
16;Cuenca;186;Saelices;902;460;442
16;Cuenca;187;Salinas del Manzano;169;91;78
16;Cuenca;188;Salmeroncillos;219;115;104
16;Cuenca;189;Salvacañete;378;205;173
16;Cuenca;190;San Clemente;6417;3172;3245
16;Cuenca;191;San Lorenzo de la Parrilla;1832;923;909
16;Cuenca;192;San Martín de Boniches;108;54;54
16;Cuenca;193;San Pedro Palmiches;134;79;55
16;Cuenca;194;Santa Cruz de Moya;515;263;252
16;Cuenca;196;Santa María de los Llanos;935;469;466
16;Cuenca;195;Santa María del Campo Rus;1139;571;568
16;Cuenca;197;Santa María del Val;156;79;77
16;Cuenca;198;Sisante;2016;1031;985
16;Cuenca;199;Solera de Gabaldón;62;36;26
16;Cuenca;909;Sotorribas;1104;570;534
16;Cuenca;202;Talayuelas;1314;680;634
16;Cuenca;203;Tarancón;10490;5200;5290
16;Cuenca;205;Tejadillos;213;105;108
16;Cuenca;206;Tinajas;484;253;231
16;Cuenca;209;Torralba;266;134;132
16;Cuenca;211;Torrejoncillo del Rey;981;483;498
16;Cuenca;212;Torrubia del Campo;413;201;212
16;Cuenca;213;Torrubia del Castillo;63;31;32
16;Cuenca;215;Tragacete;441;237;204
16;Cuenca;216;Tresjuncos;666;338;328
16;Cuenca;217;Tribaldos;195;100;95
16;Cuenca;204;Tébar;534;282;252
16;Cuenca;218;Uclés;367;171;196
16;Cuenca;219;Uña;161;79;82
16;Cuenca;906;Valdecolmenas (Los);184;89;95
16;Cuenca;224;Valdemeca;104;60;44
16;Cuenca;225;Valdemorillo de la Sierra;108;53;55
16;Cuenca;227;Valdemoro-Sierra;211;117;94
16;Cuenca;228;Valdeolivas;355;182;173
16;Cuenca;902;Valdetórtola;219;120;99
16;Cuenca;903;Valeras (Las);1579;788;791
16;Cuenca;231;Valhermoso de la Fuente;84;37;47
16;Cuenca;234;Valsalobre;72;36;36
16;Cuenca;236;Valverde de Júcar;1556;771;785
16;Cuenca;237;Valverdejo;178;92;86
16;Cuenca;238;Vara de Rey;1008;507;501
16;Cuenca;239;Vega del Codorno;304;148;156
16;Cuenca;240;Vellisca;271;127;144
16;Cuenca;242;Villaconejos de Trabaque;585;299;286
16;Cuenca;243;Villaescusa de Haro;647;328;319
16;Cuenca;244;Villagarcía del Llano;1013;510;503
16;Cuenca;245;Villalba de la Sierra;545;285;260
16;Cuenca;246;Villalba del Rey;941;491;450
16;Cuenca;247;Villalgordo del Marquesado;208;102;106
16;Cuenca;248;Villalpardo;1159;597;562
16;Cuenca;249;Villamayor de Santiago;3008;1492;1516
16;Cuenca;250;Villanueva de Guadamejud;179;81;98
16;Cuenca;251;Villanueva de la Jara;2576;1288;1288
16;Cuenca;253;Villar de Cañas;575;289;286
16;Cuenca;254;Villar de Domingo García;306;153;153
16;Cuenca;263;Villar de Olalla;828;421;407
16;Cuenca;255;Villar de la Encina;283;138;145
16;Cuenca;258;Villar del Humo;522;267;255
16;Cuenca;259;Villar del Infantado;65;39;26
16;Cuenca;910;Villar y Velasco;190;103;87
16;Cuenca;264;Villarejo de Fuentes;977;479;498
16;Cuenca;265;Villarejo de la Peñuela;50;27;23
16;Cuenca;266;Villarejo-Periesteban;598;305;293
16;Cuenca;269;Villares del Saz;1013;500;513
16;Cuenca;270;Villarrubio;305;143;162
16;Cuenca;271;Villarta;828;439;389
16;Cuenca;272;Villas de la Ventosa;559;297;262
16;Cuenca;273;Villaverde y Pasaconsol;496;240;256
16;Cuenca;275;Vindel;34;17;17
16;Cuenca;274;Víllora;339;162;177
16;Cuenca;276;Yémeda;60;30;30
16;Cuenca;277;Zafra de Záncara;314;162;152
16;Cuenca;278;Zafrilla;178;89;89
16;Cuenca;279;Zarza de Tajo;359;169;190
16;Cuenca;280;Zarzuela;374;184;190
17;Girona;001;Agullana;677;351;326
17;Girona;002;Aiguaviva;390;192;198
17;Girona;003;Albanyà;110;62;48
17;Girona;004;Albons;489;251;238
17;Girona;006;Alp;914;475;439
17;Girona;007;Amer;2417;1186;1231
17;Girona;008;Anglès;5157;2591;2566
17;Girona;009;Arbúcies;4326;2157;2169
17;Girona;010;Argelaguer;345;172;173
17;Girona;011;Armentera (L');819;385;434
17;Girona;012;Avinyonet de Puigventós;360;181;179
17;Girona;015;Banyoles;13196;6428;6768
17;Girona;016;Bàscara;760;396;364
17;Girona;013;Begur;2621;1324;1297
17;Girona;018;Bellcaire d'Empordà;481;236;245
17;Girona;019;Besalú;2142;1037;1105
17;Girona;020;Bescanó;2821;1407;1414
17;Girona;021;Beuda;99;55;44
17;Girona;022;Bisbal d'Empordà (La);7850;3885;3965
17;Girona;234;Biure;297;149;148
17;Girona;023;Blanes;23898;11954;11944
17;Girona;029;Boadella d'Empordà;230;121;109
17;Girona;024;Bolvir;220;102;118
17;Girona;025;Bordils;1258;612;646
17;Girona;026;Borrassà;497;248;249
17;Girona;027;Breda;3164;1623;1541
17;Girona;028;Brunyola;393;200;193
17;Girona;031;Cabanelles;258;131;127
17;Girona;030;Cabanes;855;448;407
17;Girona;032;Cadaqués;1733;861;872
17;Girona;033;Caldes de Malavella;2940;1432;1508
17;Girona;034;Calonge;4610;2287;2323
17;Girona;035;Camós;617;324;293
17;Girona;036;Campdevànol;3539;1747;1792
17;Girona;037;Campelles;156;83;73
17;Girona;038;Campllong;267;144;123
17;Girona;039;Camprodon;2302;1138;1164
17;Girona;040;Canet d'Adri;458;245;213
17;Girona;041;Cantallops;255;119;136
17;Girona;042;Capmany;438;232;206
17;Girona;044;Cassà de la Selva;7196;3519;3677
17;Girona;046;Castellfollit de la Roca;1077;511;566
17;Girona;047;Castelló d'Empúries;3678;1839;1839
17;Girona;048;Castell-Platja d'Aro;4676;2348;2328
17;Girona;189;Cellera de Ter (La);2017;971;1046
17;Girona;049;Celrà;2332;1156;1176
17;Girona;050;Cervià de Ter;633;307;326
17;Girona;051;Cistella;206;100;106
17;Girona;054;Colera;429;220;209
17;Girona;055;Colomers;210;106;104
17;Girona;057;Corçà;1129;572;557
17;Girona;056;Cornellà del Terri;1797;914;883
17;Girona;058;Crespià;218;114;104
17;Girona;901;Cruïlles, Monells i Sant Sadurní de l'Heura;1026;515;511
17;Girona;060;Darnius;476;255;221
17;Girona;061;Das;145;78;67
17;Girona;062;Escala (L');4994;2565;2429
17;Girona;063;Espinelves;240;128;112
17;Girona;064;Espolla;399;209;190
17;Girona;065;Esponellà;372;168;204
17;Girona;005;Far d'Empordà (El);430;223;207
17;Girona;066;Figueres;33092;16236;16856
17;Girona;067;Flaçà;966;472;494
17;Girona;068;Foixà;313;155;158
17;Girona;069;Fontanals de Cerdanya;345;182;163
17;Girona;070;Fontanilles;129;71;58
17;Girona;071;Fontcoberta;793;415;378
17;Girona;902;Forallac;1519;768;751
17;Girona;073;Fornells de la Selva;1034;496;538
17;Girona;074;Fortià;500;242;258
17;Girona;075;Garrigàs;319;166;153
17;Girona;076;Garrigoles;162;89;73
17;Girona;077;Garriguella;630;332;298
17;Girona;078;Ger;253;128;125
17;Girona;079;Girona;68902;33362;35540
17;Girona;080;Gombrèn;252;127;125
17;Girona;081;Gualta;294;147;147
17;Girona;082;Guils de Cerdanya;268;139;129
17;Girona;083;Hostalric;2757;1367;1390
17;Girona;084;Isòvol;198;93;105
17;Girona;085;Jafre;335;169;166
17;Girona;086;Jonquera (La);2635;1381;1254
17;Girona;087;Juià;271;134;137
17;Girona;088;Lladó;481;245;236
17;Girona;089;Llagostera;5181;2606;2575
17;Girona;090;Llambilles;449;221;228
17;Girona;091;Llanars;400;210;190
17;Girona;092;Llançà;3324;1686;1638
17;Girona;093;Llers;699;358;341
17;Girona;094;Llívia;923;470;453
17;Girona;095;Lloret de Mar;15862;7990;7872
17;Girona;096;Llosses (Les);396;204;192
17;Girona;102;Maçanet de Cabrenys;753;365;388
17;Girona;103;Maçanet de la Selva;2630;1327;1303
17;Girona;097;Madremanya;206;96;110
17;Girona;098;Maià de Montcal;361;180;181
17;Girona;100;Masarac;262;130;132
17;Girona;101;Massanes;460;244;216
17;Girona;099;Meranges;68;38;30
17;Girona;105;Mieres;382;190;192
17;Girona;106;Mollet de Peralada;174;96;78
17;Girona;107;Molló;378;196;182
17;Girona;109;Montagut i Oix;810;412;398
17;Girona;110;Mont-ras;1201;626;575
17;Girona;111;Navata;632;303;329
17;Girona;112;Ogassa;288;159;129
17;Girona;114;Olot;26284;12685;13599
17;Girona;115;Ordis;302;163;139
17;Girona;116;Osor;515;270;245
17;Girona;117;Palafrugell;16314;8095;8219
17;Girona;118;Palamós;12738;6298;6440
17;Girona;119;Palau de Santa Eulàlia;81;40;41
17;Girona;121;Palau-sator;314;165;149
17;Girona;120;Palau-saverdera;700;349;351
17;Girona;122;Palmerola;20;12;8
17;Girona;123;Palol de Revardit;380;201;179
17;Girona;124;Pals;1710;862;848
17;Girona;125;Pardines;119;63;56
17;Girona;126;Parlavà;341;182;159
17;Girona;128;Pau;318;149;169
17;Girona;129;Pedret i Marzà;139;61;78
17;Girona;130;Pera (La);368;182;186
17;Girona;132;Peralada;1247;642;605
17;Girona;133;Planes d'Hostoles (Les);1835;884;951
17;Girona;134;Planoles;305;159;146
17;Girona;135;Pont de Molins;368;190;178
17;Girona;136;Pontós;196;112;84
17;Girona;137;Porqueres;2927;1455;1472
17;Girona;140;Port de la Selva (El);785;384;401
17;Girona;138;Portbou;2019;1007;1012
17;Girona;139;Preses (Les);1327;651;676
17;Girona;141;Puigcerdà;6173;3120;3053
17;Girona;142;Quart;1748;883;865
17;Girona;043;Queralbs;213;114;99
17;Girona;143;Rabós;157;76;81
17;Girona;144;Regencós;256;143;113
17;Girona;145;Ribes de Freser;2622;1254;1368
17;Girona;146;Riells i Viabrea;809;407;402
17;Girona;147;Ripoll;11627;5676;5951
17;Girona;148;Riudarenes;1110;560;550
17;Girona;149;Riudaura;385;188;197
17;Girona;150;Riudellots de la Selva;1219;623;596
17;Girona;151;Riumors;198;91;107
17;Girona;152;Roses;10109;5209;4900
17;Girona;153;Rupià;210;105;105
17;Girona;154;Sales de Llierca;58;36;22
17;Girona;155;Salt;21538;10712;10826
17;Girona;157;Sant Andreu Salou;147;79;68
17;Girona;183;Sant Aniol de Finestres;263;134;129
17;Girona;158;Sant Climent Sescebes;465;248;217
17;Girona;159;Sant Feliu de Buixalleu;613;327;286
17;Girona;160;Sant Feliu de Guíxols;16451;7978;8473
17;Girona;161;Sant Feliu de Pallerols;1064;510;554
17;Girona;162;Sant Ferriol;170;96;74
17;Girona;163;Sant Gregori;1803;930;873
17;Girona;164;Sant Hilari Sacalm;4606;2344;2262
17;Girona;165;Sant Jaume de Llierca;768;387;381
17;Girona;167;Sant Joan de les Abadesses;4057;1956;2101
17;Girona;168;Sant Joan de Mollet;316;156;160
17;Girona;185;Sant Joan les Fonts;2961;1482;1479
17;Girona;166;Sant Jordi Desvalls;579;287;292
17;Girona;169;Sant Julià de Ramis;1693;851;842
17;Girona;903;Sant Julià del Llor i Bonmatí;859;410;449
17;Girona;171;Sant Llorenç de la Muga;154;73;81
17;Girona;172;Sant Martí de Llémena;329;181;148
17;Girona;173;Sant Martí Vell;207;101;106
17;Girona;174;Sant Miquel de Campmajor;219;124;95
17;Girona;175;Sant Miquel de Fluvià;550;283;267
17;Girona;176;Sant Mori;141;69;72
17;Girona;177;Sant Pau de Segúries;611;306;305
17;Girona;178;Sant Pere Pescador;1183;606;577
17;Girona;180;Santa Coloma de Farners;7816;3964;3852
17;Girona;181;Santa Cristina d'Aro;1605;853;752
17;Girona;182;Santa Llogaia d'Àlguema;313;160;153
17;Girona;184;Santa Pau;1347;683;664
17;Girona;186;Sarrià de Ter;3463;1736;1727
17;Girona;187;Saus;723;367;356
17;Girona;188;Selva de Mar (La);149;80;69
17;Girona;190;Serinyà;710;345;365
17;Girona;191;Serra de Daró;187;97;90
17;Girona;192;Setcases;164;85;79
17;Girona;193;Sils;2160;1090;1070
17;Girona;052;Siurana;175;78;97
17;Girona;194;Susqueda;118;62;56
17;Girona;195;Tallada d'Empordà (La);357;183;174
17;Girona;196;Terrades;186;88;98
17;Girona;197;Torrent;209;108;101
17;Girona;198;Torroella de Fluvià;272;141;131
17;Girona;199;Torroella de Montgrí;6515;3275;3240
17;Girona;200;Tortellà;728;354;374
17;Girona;201;Toses;147;84;63
17;Girona;202;Tossa de Mar;3564;1801;1763
17;Girona;204;Ullà;749;371;378
17;Girona;205;Ullastret;277;135;142
17;Girona;203;Ultramort;213;109;104
17;Girona;206;Urús;101;46;55
17;Girona;014;Vajol (La);65;35;30
17;Girona;208;Vall de Bianya (La);1043;520;523
17;Girona;207;Vall d'en Bas (La);2588;1328;1260
17;Girona;170;Vallfogona de Ripollès;256;128;128
17;Girona;209;Vall-llobrega;233;119;114
17;Girona;210;Ventalló;536;281;255
17;Girona;211;Verges;1147;563;584
17;Girona;212;Vidrà;179;88;91
17;Girona;213;Vidreres;3660;1838;1822
17;Girona;214;Vilabertran;797;399;398
17;Girona;215;Vilablareix;948;478;470
17;Girona;217;Viladamat;357;189;168
17;Girona;216;Viladasens;185;95;90
17;Girona;218;Vilademuls;779;403;376
17;Girona;220;Viladrau;820;417;403
17;Girona;221;Vilafant;2371;1170;1201
17;Girona;223;Vilajuïga;684;335;349
17;Girona;224;Vilallonga de Ter;439;222;217
17;Girona;225;Vilamacolum;257;119;138
17;Girona;226;Vilamalla;543;269;274
17;Girona;227;Vilamaniscle;121;54;67
17;Girona;228;Vilanant;291;149;142
17;Girona;230;Vila-sacra;430;217;213
17;Girona;222;Vilaür;98;45;53
17;Girona;233;Vilobí d'Onyar;1947;1008;939
17;Girona;232;Vilopriu;185;88;97
18;Granada;001;Agrón;476;237;239
18;Granada;002;Alamedilla;1135;567;568
18;Granada;003;Albolote;8443;4195;4248
18;Granada;004;Albondón;1447;738;709
18;Granada;005;Albuñán;558;283;275
18;Granada;006;Albuñol;5719;2846;2873
18;Granada;007;Albuñuelas;1438;734;704
18;Granada;010;Aldeire;935;461;474
18;Granada;011;Alfacar;3333;1702;1631
18;Granada;012;Algarinejo;5111;2621;2490
18;Granada;013;Alhama de Granada;6121;3129;2992
18;Granada;014;Alhendín;3402;1711;1691
18;Granada;015;Alicún de Ortega;804;418;386
18;Granada;016;Almegíjar;554;279;275
18;Granada;017;Almuñécar;17779;8863;8916
18;Granada;904;Alpujarra de la Sierra;1493;758;735
18;Granada;018;Alquife;1353;668;685
18;Granada;020;Arenas del Rey;2184;1134;1050
18;Granada;021;Armilla;10388;5229;5159
18;Granada;022;Atarfe;9918;4872;5046
18;Granada;023;Baza;20910;10177;10733
18;Granada;024;Beas de Granada;871;437;434
18;Granada;025;Beas de Guadix;469;246;223
18;Granada;027;Benalúa;3621;1842;1779
18;Granada;028;Benalúa de las Villas;1391;683;708
18;Granada;029;Benamaurel;2764;1434;1330
18;Granada;030;Bérchules;1032;525;507
18;Granada;032;Bubión;335;175;160
18;Granada;033;Busquístar;430;222;208
18;Granada;034;Cacín;956;493;463
18;Granada;035;Cádiar;2112;1071;1041
18;Granada;036;Cájar;1723;782;941
18;Granada;114;Calahorra (La);1110;539;571
18;Granada;037;Calicasas;604;288;316
18;Granada;038;Campotéjar;1517;734;783
18;Granada;039;Caniles;6087;2979;3108
18;Granada;040;Cáñar;379;181;198
18;Granada;042;Capileira;605;301;304
18;Granada;043;Carataunas;176;90;86
18;Granada;044;Cástaras;384;198;186
18;Granada;045;Castilléjar;2417;1203;1214
18;Granada;046;Castril;3595;1863;1732
18;Granada;047;Cenes de la Vega;1618;823;795
18;Granada;059;Chauchina;4020;1986;2034
18;Granada;061;Chimeneas;1635;821;814
18;Granada;062;Churriana de la Vega;4971;2459;2512
18;Granada;048;Cijuela;1192;567;625
18;Granada;049;Cogollos de Guadix;832;446;386
18;Granada;050;Cogollos de la Vega;1916;966;950
18;Granada;051;Colomera;2031;1035;996
18;Granada;053;Cortes de Baza;3277;1678;1599
18;Granada;054;Cortes y Graena;1053;548;505
18;Granada;912;Cuevas del Campo;2605;1306;1299
18;Granada;056;Cúllar;5835;2863;2972
18;Granada;057;Cúllar Vega;1482;746;736
18;Granada;063;Darro;1631;800;831
18;Granada;064;Dehesas de Guadix;994;504;490
18;Granada;066;Deifontes;2468;1271;1197
18;Granada;067;Diezma;1135;595;540
18;Granada;068;Dílar;1325;654;671
18;Granada;069;Dólar;741;371;370
18;Granada;070;Dúdar;270;140;130
18;Granada;071;Dúrcal;5632;2805;2827
18;Granada;072;Escúzar;1149;578;571
18;Granada;074;Ferreira;450;210;240
18;Granada;076;Fonelas;1602;816;786
18;Granada;078;Freila;1394;702;692
18;Granada;079;Fuente Vaqueros;3767;1883;1884
18;Granada;905;Gabias (Las);5530;2760;2770
18;Granada;082;Galera;1895;931;964
18;Granada;083;Gobernador;444;216;228
18;Granada;084;Gójar;2049;1026;1023
18;Granada;085;Gor;1562;775;787
18;Granada;086;Gorafe;739;383;356
18;Granada;087;Granada;263334;124579;138755
18;Granada;088;Guadahortuna;2600;1331;1269
18;Granada;089;Guadix;20656;10146;10510
18;Granada;906;Guajares (Los);1639;841;798
18;Granada;093;Gualchos;3015;1501;1514
18;Granada;094;Güejar Sierra;2586;1315;1271
18;Granada;095;Güevéjar;1175;568;607
18;Granada;096;Huélago;753;394;359
18;Granada;097;Huéneja;1608;794;814
18;Granada;098;Huéscar;10411;5194;5217
18;Granada;099;Huétor de Santillán;1408;733;675
18;Granada;100;Huétor Tájar;7757;3903;3854
18;Granada;101;Huétor Vega;6027;3013;3014
18;Granada;102;Illora;10573;5344;5229
18;Granada;103;Itrabo;1190;607;583
18;Granada;105;Iznalloz;6972;3567;3405
18;Granada;107;Jayena;1550;821;729
18;Granada;108;Jerez del Marquesado;1346;679;667
18;Granada;109;Jete;737;365;372
18;Granada;111;Jun;848;421;427
18;Granada;112;Juviles;181;85;96
18;Granada;115;Láchar;2252;1153;1099
18;Granada;116;Lanjarón;4193;2078;2115
18;Granada;117;Lanteira;785;402;383
18;Granada;119;Lecrín;2644;1303;1341
18;Granada;120;Lentegí;379;186;193
18;Granada;121;Lobras;251;121;130
18;Granada;122;Loja;20835;10448;10387
18;Granada;123;Lugros;603;320;283
18;Granada;124;Lújar;701;365;336
18;Granada;126;Malahá (La);1686;862;824
18;Granada;127;Maracena;11566;5772;5794
18;Granada;128;Marchal;542;260;282
18;Granada;132;Moclín;5109;2583;2526
18;Granada;133;Molvízar;2488;1247;1241
18;Granada;134;Monachil;3863;1953;1910
18;Granada;135;Montefrío;8425;4310;4115
18;Granada;136;Montejícar;3013;1530;1483
18;Granada;137;Montillana;1443;743;700
18;Granada;138;Moraleda de Zafayona;2616;1313;1303
18;Granada;909;Morelábor;1130;552;578
18;Granada;140;Motril;45901;22806;23095
18;Granada;141;Murtas;1219;608;611
18;Granada;903;Nevada;1600;830;770
18;Granada;143;Nigüelas;1213;614;599
18;Granada;144;Nívar;479;244;235
18;Granada;145;Ogíjares;3317;1683;1634
18;Granada;146;Orce;1631;818;813
18;Granada;147;Órgiva;5273;2639;2634
18;Granada;148;Otívar;1208;611;597
18;Granada;149;Otura;2256;1115;1141
18;Granada;150;Padul;6293;3118;3175
18;Granada;151;Pampaneira;364;188;176
18;Granada;152;Pedro Martínez;1993;994;999
18;Granada;153;Peligros;5514;2760;2754
18;Granada;154;Peza (La);1723;896;827
18;Granada;910;Pinar (El);1463;722;741
18;Granada;157;Pinos Genil;957;488;469
18;Granada;158;Pinos Puente;14015;6939;7076
18;Granada;159;Píñar;1605;837;768
18;Granada;161;Polícar;277;147;130
18;Granada;162;Polopos;1357;716;641
18;Granada;163;Pórtugos;452;231;221
18;Granada;164;Puebla de Don Fadrique;2972;1477;1495
18;Granada;165;Pulianas;2362;1168;1194
18;Granada;167;Purullena;2815;1410;1405
18;Granada;168;Quéntar;1276;646;630
18;Granada;170;Rubite;536;278;258
18;Granada;171;Salar;2895;1432;1463
18;Granada;173;Salobreña;9174;4535;4639
18;Granada;174;Santa Cruz del Comercio;626;334;292
18;Granada;175;Santa Fe;11834;5759;6075
18;Granada;176;Soportújar;269;143;126
18;Granada;177;Sorvilán;989;505;484
18;Granada;901;Taha (La);926;473;453
18;Granada;178;Torre-Cardela;1500;750;750
18;Granada;179;Torvizcón;1285;628;657
18;Granada;180;Trevélez;881;459;422
18;Granada;181;Turón;498;278;220
18;Granada;182;Ugíjar;3130;1523;1607
18;Granada;907;Valle del Zalabí;2681;1342;1339
18;Granada;902;Valle (El);1627;819;808
18;Granada;183;Válor;1172;590;582
18;Granada;911;Vegas del Genil;2676;1343;1333
18;Granada;184;Vélez de Benaudalla;2661;1321;1340
18;Granada;185;Ventas de Huelma;769;386;383
18;Granada;908;Villamena;1159;548;611
18;Granada;187;Villanueva de las Torres;1119;601;518
18;Granada;188;Villanueva Mesía;1847;923;924
18;Granada;189;Víznar;681;340;341
18;Granada;192;Zafarraya;2264;1144;1120
18;Granada;913;Zagra;1480;749;731
18;Granada;193;Zubia (La);7531;3752;3779
18;Granada;194;Zújar;3467;1782;1685
19;Guadalajara;001;Abánades;129;74;55
19;Guadalajara;002;Ablanque;166;89;77
19;Guadalajara;003;Adobes;36;17;19
19;Guadalajara;004;Alaminos;122;56;66
19;Guadalajara;005;Alarilla;109;58;51
19;Guadalajara;006;Albalate de Zorita;1073;560;513
19;Guadalajara;007;Albares;538;274;264
19;Guadalajara;008;Albendiego;73;39;34
19;Guadalajara;009;Alcocer;362;176;186
19;Guadalajara;010;Alcolea de las Peñas;45;28;17
19;Guadalajara;011;Alcolea del Pinar;548;278;270
19;Guadalajara;013;Alcoroches;191;104;87
19;Guadalajara;015;Aldeanueva de Guadalajara;125;62;63
19;Guadalajara;016;Algar de Mesa;104;53;51
19;Guadalajara;017;Algora;124;74;50
19;Guadalajara;018;Alhóndiga;300;164;136
19;Guadalajara;019;Alique;14;7;7
19;Guadalajara;020;Almadrones;129;81;48
19;Guadalajara;021;Almoguera;783;392;391
19;Guadalajara;022;Almonacid de Zorita;989;518;471
19;Guadalajara;023;Alocén;128;64;64
19;Guadalajara;024;Alovera;1355;674;681
19;Guadalajara;027;Alustante;321;168;153
19;Guadalajara;031;Angón;35;20;15
19;Guadalajara;032;Anguita;425;217;208
19;Guadalajara;033;Anquela del Ducado;94;49;45
19;Guadalajara;034;Anquela del Pedregal;40;21;19
19;Guadalajara;036;Aranzueque;369;185;184
19;Guadalajara;037;Arbancón;228;129;99
19;Guadalajara;038;Arbeteta;52;30;22
19;Guadalajara;039;Argecilla;138;83;55
19;Guadalajara;040;Armallones;99;55;44
19;Guadalajara;041;Armuña de Tajuña;106;58;48
19;Guadalajara;042;Arroyo de las Fraguas;19;11;8
19;Guadalajara;043;Atanzón;128;70;58
19;Guadalajara;044;Atienza;544;287;257
19;Guadalajara;045;Auñón;294;160;134
19;Guadalajara;046;Azuqueca de Henares;10959;5552;5407
19;Guadalajara;047;Baides;90;47;43
19;Guadalajara;048;Baños de Tajo;38;25;13
19;Guadalajara;049;Bañuelos;43;21;22
19;Guadalajara;050;Barriopedro;27;11;16
19;Guadalajara;051;Berninches;135;81;54
19;Guadalajara;052;Bodera (La);57;32;25
19;Guadalajara;053;Brihuega;3382;1787;1595
19;Guadalajara;054;Budia;378;200;178
19;Guadalajara;055;Bujalaro;151;85;66
19;Guadalajara;057;Bustares;161;88;73
19;Guadalajara;058;Cabanillas del Campo;951;503;448
19;Guadalajara;059;Campillo de Dueñas;198;111;87
19;Guadalajara;060;Campillo de Ranas;101;45;56
19;Guadalajara;061;Campisábalos;79;36;43
19;Guadalajara;064;Canredondo;138;74;64
19;Guadalajara;065;Cantalojas;183;103;80
19;Guadalajara;066;Cañizar;123;65;58
19;Guadalajara;067;Cardoso de la Sierra (El);122;74;48
19;Guadalajara;070;Casa de Uceda;154;77;77
19;Guadalajara;071;Casar (El);1319;677;642
19;Guadalajara;073;Casas de San Galindo;38;21;17
19;Guadalajara;074;Caspueñas;57;28;29
19;Guadalajara;075;Castejón de Henares;138;73;65
19;Guadalajara;076;Castellar de la Muela;73;41;32
19;Guadalajara;078;Castilforte;47;24;23
19;Guadalajara;079;Castilnuevo;14;3;11
19;Guadalajara;080;Cendejas de Enmedio;175;86;89
19;Guadalajara;081;Cendejas de la Torre;162;94;68
19;Guadalajara;082;Centenera;98;52;46
19;Guadalajara;103;Checa;500;251;249
19;Guadalajara;104;Chequilla;32;16;16
19;Guadalajara;106;Chillarón del Rey;139;74;65
19;Guadalajara;105;Chiloeches;1072;558;514
19;Guadalajara;086;Cifuentes;2579;1356;1223
19;Guadalajara;087;Cincovillas;46;23;23
19;Guadalajara;088;Ciruelas;73;38;35
19;Guadalajara;089;Ciruelos del Pinar;97;47;50
19;Guadalajara;090;Cobeta;152;77;75
19;Guadalajara;091;Cogollor;76;41;35
19;Guadalajara;092;Cogolludo;691;372;319
19;Guadalajara;095;Condemios de Abajo;35;20;15
19;Guadalajara;096;Condemios de Arriba;226;120;106
19;Guadalajara;097;Congostrina;48;22;26
19;Guadalajara;098;Copernal;33;18;15
19;Guadalajara;099;Corduente;555;296;259
19;Guadalajara;102;Cubillo de Uceda (El);161;81;80
19;Guadalajara;107;Driebes;411;233;178
19;Guadalajara;108;Durón;100;56;44
19;Guadalajara;109;Embid;83;48;35
19;Guadalajara;110;Escamilla;172;92;80
19;Guadalajara;111;Escariche;250;123;127
19;Guadalajara;112;Escopete;60;27;33
19;Guadalajara;113;Espinosa de Henares;527;254;273
19;Guadalajara;114;Esplegares;82;47;35
19;Guadalajara;115;Establés;73;36;37
19;Guadalajara;116;Estriégana;37;18;19
19;Guadalajara;117;Fontanar;711;356;355
19;Guadalajara;118;Fuembellida;26;14;12
19;Guadalajara;119;Fuencemillán;141;75;66
19;Guadalajara;120;Fuentelahiguera de Albatages;255;127;128
19;Guadalajara;121;Fuentelencina;235;124;111
19;Guadalajara;122;Fuentelsaz;170;82;88
19;Guadalajara;123;Fuentelviejo;102;52;50
19;Guadalajara;124;Fuentenovilla;258;148;110
19;Guadalajara;125;Gajanejos;116;68;48
19;Guadalajara;126;Galápagos;203;112;91
19;Guadalajara;127;Galve de Sorbe;200;102;98
19;Guadalajara;129;Gascueña de Bornova;40;22;18
19;Guadalajara;130;Guadalajara;61309;30483;30826
19;Guadalajara;132;Henche;25;16;9
19;Guadalajara;133;Heras de Ayuso;137;73;64
19;Guadalajara;134;Herrería;47;23;24
19;Guadalajara;135;Hiendelaencina;196;111;85
19;Guadalajara;136;Hijes;29;17;12
19;Guadalajara;138;Hita;270;154;116
19;Guadalajara;139;Hombrados;75;39;36
19;Guadalajara;142;Hontoba;144;70;74
19;Guadalajara;143;Horche;1135;598;537
19;Guadalajara;145;Hortezuela de Océn;115;64;51
19;Guadalajara;146;Huerce (La);34;19;15
19;Guadalajara;147;Huérmeces del Cerro;65;38;27
19;Guadalajara;148;Huertahernando;81;47;34
19;Guadalajara;150;Hueva;152;83;69
19;Guadalajara;151;Humanes;1245;641;604
19;Guadalajara;152;Illana;735;374;361
19;Guadalajara;153;Iniéstola;28;16;12
19;Guadalajara;154;Inviernas (Las);120;67;53
19;Guadalajara;155;Irueste;88;43;45
19;Guadalajara;156;Jadraque;1264;626;638
19;Guadalajara;157;Jirueque;70;41;29
19;Guadalajara;159;Ledanca;213;109;104
19;Guadalajara;160;Loranca de Tajuña;297;158;139
19;Guadalajara;161;Lupiana;274;141;133
19;Guadalajara;162;Luzaga;153;68;85
19;Guadalajara;163;Luzón;114;59;55
19;Guadalajara;165;Majaelrayo;67;33;34
19;Guadalajara;166;Málaga del Fresno;256;138;118
19;Guadalajara;167;Malaguilla;213;117;96
19;Guadalajara;168;Mandayona;553;258;295
19;Guadalajara;169;Mantiel;25;12;13
19;Guadalajara;170;Maranchón;277;136;141
19;Guadalajara;171;Marchamalo;"";"";""
19;Guadalajara;172;Masegoso de Tajuña;125;62;63
19;Guadalajara;173;Matarrubia;48;29;19
19;Guadalajara;174;Matillas;309;159;150
19;Guadalajara;175;Mazarete;113;56;57
19;Guadalajara;176;Mazuecos;480;250;230
19;Guadalajara;177;Medranda;170;92;78
19;Guadalajara;178;Megina;91;42;49
19;Guadalajara;179;Membrillera;94;54;40
19;Guadalajara;181;Miedes de Atienza;174;87;87
19;Guadalajara;182;Mierla (La);37;22;15
19;Guadalajara;184;Millana;120;59;61
19;Guadalajara;183;Milmarcos;129;68;61
19;Guadalajara;185;Miñosa (La);74;39;35
19;Guadalajara;186;Mirabueno;135;77;58
19;Guadalajara;187;Miralrío;129;69;60
19;Guadalajara;188;Mochales;180;89;91
19;Guadalajara;189;Mohernando;141;83;58
19;Guadalajara;190;Molina de Aragón;3961;2025;1936
19;Guadalajara;191;Monasterio;18;9;9
19;Guadalajara;192;Mondéjar;2215;1089;1126
19;Guadalajara;193;Montarrón;90;49;41
19;Guadalajara;194;Moratilla de los Meleros;127;71;56
19;Guadalajara;195;Morenilla;72;45;27
19;Guadalajara;196;Muduex;135;73;62
19;Guadalajara;197;Navas de Jadraque (Las);31;17;14
19;Guadalajara;198;Negredo;26;11;15
19;Guadalajara;199;Ocentejo;55;24;31
19;Guadalajara;200;Olivar (El);54;31;23
19;Guadalajara;201;Olmeda de Cobeta;93;35;58
19;Guadalajara;202;Olmeda de Jadraque (La);10;6;4
19;Guadalajara;203;Ordial (El);57;21;36
19;Guadalajara;204;Orea;364;192;172
19;Guadalajara;208;Pálmaces de Jadraque;110;59;51
19;Guadalajara;209;Pardos;70;35;35
19;Guadalajara;210;Paredes de Sigüenza;89;45;44
19;Guadalajara;211;Pareja;515;257;258
19;Guadalajara;212;Pastrana;1251;627;624
19;Guadalajara;213;Pedregal (El);126;66;60
19;Guadalajara;214;Peñalén;199;96;103
19;Guadalajara;215;Peñalver;336;189;147
19;Guadalajara;216;Peralejos de las Truchas;199;108;91
19;Guadalajara;217;Peralveche;74;39;35
19;Guadalajara;218;Pinilla de Jadraque;100;52;48
19;Guadalajara;219;Pinilla de Molina;36;18;18
19;Guadalajara;220;Pioz;186;102;84
19;Guadalajara;221;Piqueras;47;27;20
19;Guadalajara;222;Pobo de Dueñas (El);211;114;97
19;Guadalajara;223;Poveda de la Sierra;197;97;100
19;Guadalajara;224;Pozo de Almoguera;243;125;118
19;Guadalajara;225;Pozo de Guadalajara;343;190;153
19;Guadalajara;226;Prádena de Atienza;55;32;23
19;Guadalajara;227;Prados Redondos;127;72;55
19;Guadalajara;228;Puebla de Beleña;40;23;17
19;Guadalajara;229;Puebla de Valles;85;45;40
19;Guadalajara;230;Quer;109;56;53
19;Guadalajara;231;Rebollosa de Jadraque;43;23;20
19;Guadalajara;232;Recuenco (El);157;79;78
19;Guadalajara;233;Renera;50;25;25
19;Guadalajara;234;Retiendas;40;22;18
19;Guadalajara;235;Riba de Saelices;192;107;85
19;Guadalajara;237;Rillo de Gallo;99;48;51
19;Guadalajara;238;Riofrío del Llano;108;58;50
19;Guadalajara;239;Robledillo de Mohernando;186;96;90
19;Guadalajara;240;Robledo de Corpes;103;48;55
19;Guadalajara;241;Romanillos de Atienza;91;53;38
19;Guadalajara;242;Romanones;191;108;83
19;Guadalajara;243;Rueda de la Sierra;97;50;47
19;Guadalajara;244;Sacecorbo;162;84;78
19;Guadalajara;245;Sacedón;1798;912;886
19;Guadalajara;246;Saelices de la Sal;84;43;41
19;Guadalajara;247;Salmerón;318;166;152
19;Guadalajara;248;San Andrés del Congosto;81;45;36
19;Guadalajara;249;San Andrés del Rey;52;25;27
19;Guadalajara;250;Santiuste;20;9;11
19;Guadalajara;251;Saúca;66;35;31
19;Guadalajara;252;Sayatón;215;108;107
19;Guadalajara;254;Selas;79;37;42
19;Guadalajara;901;Semillas;34;20;14
19;Guadalajara;255;Setiles;275;141;134
19;Guadalajara;256;Sienes;111;65;46
19;Guadalajara;257;Sigüenza;5139;2556;2583
19;Guadalajara;258;Solanillos del Extremo;124;62;62
19;Guadalajara;259;Somolinos;57;26;31
19;Guadalajara;260;Sotillo (El);57;37;20
19;Guadalajara;261;Sotodosos;89;44;45
19;Guadalajara;262;Tamajón;213;113;100
19;Guadalajara;263;Taragudo;32;16;16
19;Guadalajara;264;Taravilla;84;41;43
19;Guadalajara;265;Tartanedo;276;139;137
19;Guadalajara;266;Tendilla;421;225;196
19;Guadalajara;267;Terzaga;54;31;23
19;Guadalajara;268;Tierzo;53;27;26
19;Guadalajara;269;Toba (La);142;75;67
19;Guadalajara;271;Tordellego;114;56;58
19;Guadalajara;270;Tordelrábano;23;9;14
19;Guadalajara;272;Tordesilos;180;91;89
19;Guadalajara;274;Torija;377;191;186
19;Guadalajara;279;Torre del Burgo;55;30;25
19;Guadalajara;276;Torrecilla del Ducado;11;6;5
19;Guadalajara;277;Torrecuadrada de Molina;27;16;11
19;Guadalajara;278;Torrecuadradilla;96;53;43
19;Guadalajara;280;Torrejón del Rey;414;226;188
19;Guadalajara;281;Torremocha de Jadraque;19;13;6
19;Guadalajara;282;Torremocha del Campo;421;229;192
19;Guadalajara;283;Torremocha del Pinar;112;54;58
19;Guadalajara;284;Torremochuela;11;6;5
19;Guadalajara;285;Torrubia;55;28;27
19;Guadalajara;286;Tórtola de Henares;424;216;208
19;Guadalajara;287;Tortuera;310;155;155
19;Guadalajara;288;Tortuero;30;17;13
19;Guadalajara;289;Traíd;61;33;28
19;Guadalajara;290;Trijueque;304;158;146
19;Guadalajara;291;Trillo;1416;752;664
19;Guadalajara;293;Uceda;425;218;207
19;Guadalajara;294;Ujados;53;30;23
19;Guadalajara;296;Utande;86;48;38
19;Guadalajara;297;Valdarachas;30;14;16
19;Guadalajara;298;Valdearenas;72;36;36
19;Guadalajara;299;Valdeavellano;98;49;49
19;Guadalajara;300;Valdeaveruelo;130;70;60
19;Guadalajara;301;Valdeconcha;49;20;29
19;Guadalajara;302;Valdegrudas;76;40;36
19;Guadalajara;303;Valdelcubo;81;45;36
19;Guadalajara;304;Valdenuño Fernández;151;79;72
19;Guadalajara;305;Valdepeñas de la Sierra;314;170;144
19;Guadalajara;306;Valderrebollo;46;29;17
19;Guadalajara;307;Valdesotos;59;27;32
19;Guadalajara;308;Valfermoso de Tajuña;88;53;35
19;Guadalajara;309;Valhermoso;55;29;26
19;Guadalajara;310;Valtablado del Río;19;12;7
19;Guadalajara;311;Valverde de los Arroyos;84;43;41
19;Guadalajara;314;Viana de Jadraque;79;42;37
19;Guadalajara;317;Villanueva de Alcorón;381;203;178
19;Guadalajara;318;Villanueva de Argecilla;56;32;24
19;Guadalajara;319;Villanueva de la Torre;107;47;60
19;Guadalajara;321;Villares de Jadraque;50;25;25
19;Guadalajara;322;Villaseca de Henares;101;51;50
19;Guadalajara;323;Villaseca de Uceda;70;35;35
19;Guadalajara;324;Villel de Mesa;311;148;163
19;Guadalajara;325;Viñuelas;165;87;78
19;Guadalajara;326;Yebes;63;33;30
19;Guadalajara;327;Yebra;647;328;319
19;Guadalajara;329;Yélamos de Abajo;116;58;58
19;Guadalajara;330;Yélamos de Arriba;162;88;74
19;Guadalajara;331;Yunquera de Henares;1888;967;921
19;Guadalajara;332;Yunta (La);209;101;108
19;Guadalajara;333;Zaorejas;261;137;124
19;Guadalajara;334;Zarzuela de Jadraque;39;24;15
19;Guadalajara;335;Zorita de los Canes;102;52;50
20;Guipúzcoa;001;Abaltzisketa;284;153;131
20;Guipúzcoa;002;Aduna;340;181;159
20;Guipúzcoa;016;Aia;1761;1007;754
20;Guipúzcoa;003;Aizarnazabal;550;298;252
20;Guipúzcoa;004;Albiztur;313;169;144
20;Guipúzcoa;005;Alegia;1670;886;784
20;Guipúzcoa;006;Alkiza;268;152;116
20;Guipúzcoa;906;Altzaga;"";"";""
20;Guipúzcoa;007;Altzo;338;192;146
20;Guipúzcoa;008;Amezketa;1098;601;497
20;Guipúzcoa;009;Andoain;15943;7967;7976
20;Guipúzcoa;010;Anoeta;1889;936;953
20;Guipúzcoa;011;Antzuola;2108;1101;1007
20;Guipúzcoa;012;Arama;161;81;80
20;Guipúzcoa;013;Aretxabaleta;6041;3083;2958
20;Guipúzcoa;055;Arrasate/Mondragón;26231;13162;13069
20;Guipúzcoa;014;Asteasu;1267;679;588
20;Guipúzcoa;903;Astigarraga;3261;1629;1632
20;Guipúzcoa;015;Ataun;1825;939;886
20;Guipúzcoa;017;Azkoitia;10631;5304;5327
20;Guipúzcoa;018;Azpeitia;13327;6738;6589
20;Guipúzcoa;904;Baliarrain;"";"";""
20;Guipúzcoa;019;Beasain;12446;6313;6133
20;Guipúzcoa;020;Beizama;168;91;77
20;Guipúzcoa;021;Belauntza;309;166;143
20;Guipúzcoa;022;Berastegi;962;538;424
20;Guipúzcoa;074;Bergara;15802;7881;7921
20;Guipúzcoa;023;Berrobi;597;327;270
20;Guipúzcoa;024;Bidegoyan;491;278;213
20;Guipúzcoa;029;Deba;4902;2526;2376
20;Guipúzcoa;069;Donostia/San Sebastián;177622;83443;94179
20;Guipúzcoa;030;Eibar;34355;16953;17402
20;Guipúzcoa;031;Elduain;256;144;112
20;Guipúzcoa;033;Elgeta;1036;523;513
20;Guipúzcoa;032;Elgoibar;12274;6242;6032
20;Guipúzcoa;067;Errenteria;43288;21561;21727
20;Guipúzcoa;066;Errezil;729;406;323
20;Guipúzcoa;034;Eskoriatza;3990;2080;1910
20;Guipúzcoa;035;Ezkio-Itsaso;602;309;293
20;Guipúzcoa;038;Gabiria;457;254;203
20;Guipúzcoa;037;Gaintza;126;74;52
20;Guipúzcoa;907;Gaztelu;"";"";""
20;Guipúzcoa;039;Getaria;2347;1178;1169
20;Guipúzcoa;040;Hernani;19085;9505;9580
20;Guipúzcoa;041;Hernialde;289;157;132
20;Guipúzcoa;036;Hondarribia;13337;6661;6676
20;Guipúzcoa;042;Ibarra;4540;2341;2199
20;Guipúzcoa;043;Idiazabal;2074;1048;1026
20;Guipúzcoa;044;Ikaztegieta;666;351;315
20;Guipúzcoa;045;Irún;54886;26933;27953
20;Guipúzcoa;046;Irura;634;311;323
20;Guipúzcoa;047;Itsasondo;769;394;375
20;Guipúzcoa;048;Larraul;159;97;62
20;Guipúzcoa;902;Lasarte-Oria;18536;9279;9257
20;Guipúzcoa;049;Lazkao;5276;2703;2573
20;Guipúzcoa;050;Leaburu;590;323;267
20;Guipúzcoa;051;Legazpi;10275;5306;4969
20;Guipúzcoa;052;Legorreta;1569;787;782
20;Guipúzcoa;068;Leintz-Gatzaga;219;122;97
20;Guipúzcoa;053;Lezo;5651;2792;2859
20;Guipúzcoa;054;Lizartza;724;387;337
20;Guipúzcoa;901;Mendaro;1558;794;764
20;Guipúzcoa;057;Mutiloa;196;97;99
20;Guipúzcoa;056;Mutriku;4679;2341;2338
20;Guipúzcoa;063;Oiartzun;8314;4148;4166
20;Guipúzcoa;058;Olaberria;1242;637;605
20;Guipúzcoa;076;Ordizia;9458;4643;4815
20;Guipúzcoa;905;Orendain;"";"";""
20;Guipúzcoa;060;Orexa;83;43;40
20;Guipúzcoa;061;Orio;4310;2194;2116
20;Guipúzcoa;062;Ormaiztegi;1284;635;649
20;Guipúzcoa;059;Oñati;10864;5458;5406
20;Guipúzcoa;064;Pasaia;19387;9502;9885
20;Guipúzcoa;070;Segura;1365;697;668
20;Guipúzcoa;065;Soraluze/Placencia de las Armas;5120;2567;2553
20;Guipúzcoa;071;Tolosa;18378;8872;9506
20;Guipúzcoa;072;Urnieta;4443;2279;2164
20;Guipúzcoa;077;Urretxu;6379;3286;3093
20;Guipúzcoa;073;Usurbil;5565;2846;2719
20;Guipúzcoa;075;Villabona;5361;2716;2645
20;Guipúzcoa;078;Zaldibia;1652;875;777
20;Guipúzcoa;079;Zarautz;16858;8391;8467
20;Guipúzcoa;025;Zegama;1473;755;718
20;Guipúzcoa;026;Zerain;231;112;119
20;Guipúzcoa;027;Zestoa;3587;1888;1699
20;Guipúzcoa;028;Zizurkil;2780;1414;1366
20;Guipúzcoa;081;Zumaia;8151;4088;4063
20;Guipúzcoa;080;Zumarraga;11545;5832;5713
21;Huelva;001;Alájar;900;451;449
21;Huelva;002;Aljaraque;5611;2791;2820
21;Huelva;003;Almendro (El);886;461;425
21;Huelva;004;Almonaster la Real;2378;1171;1207
21;Huelva;005;Almonte;15415;7777;7638
21;Huelva;006;Alosno;5001;2416;2585
21;Huelva;007;Aracena;6508;3149;3359
21;Huelva;008;Aroche;3860;1885;1975
21;Huelva;009;Arroyomolinos de León;1329;659;670
21;Huelva;010;Ayamonte;17278;8594;8684
21;Huelva;011;Beas;4037;2015;2022
21;Huelva;012;Berrocal;430;223;207
21;Huelva;013;Bollullos Par del Condado;12465;6201;6264
21;Huelva;014;Bonares;4886;2460;2426
21;Huelva;015;Cabezas Rubias;973;501;472
21;Huelva;016;Cala;1560;784;776
21;Huelva;017;Calañas;5360;2640;2720
21;Huelva;018;Campillo (El);2864;1397;1467
21;Huelva;019;Campofrío;902;457;445
21;Huelva;020;Cañaveral de León;608;290;318
21;Huelva;021;Cartaya;10234;5141;5093
21;Huelva;022;Castaño del Robledo;209;107;102
21;Huelva;023;Cerro de Andévalo (El);3102;1530;1572
21;Huelva;030;Chucena;1944;994;950
21;Huelva;024;Corteconcepción;718;368;350
21;Huelva;025;Cortegana;5498;2683;2815
21;Huelva;026;Cortelazor;371;182;189
21;Huelva;027;Cumbres de Enmedio;62;30;32
21;Huelva;028;Cumbres de San Bartolomé;743;377;366
21;Huelva;029;Cumbres Mayores;2530;1208;1322
21;Huelva;031;Encinasola;2423;1174;1249
21;Huelva;032;Escacena del Campo;2226;1104;1122
21;Huelva;033;Fuenteheridos;656;325;331
21;Huelva;034;Galaroza;1693;811;882
21;Huelva;035;Gibraleón;9780;4912;4868
21;Huelva;036;Granada de Río-Tinto (La);231;125;106
21;Huelva;037;Granado (El);724;374;350
21;Huelva;038;Higuera de la Sierra;1418;699;719
21;Huelva;039;Hinojales;495;249;246
21;Huelva;040;Hinojos;3519;1794;1725
21;Huelva;041;Huelva;137826;66738;71088
21;Huelva;042;Isla Cristina;17054;8460;8594
21;Huelva;043;Jabugo;2598;1263;1335
21;Huelva;044;Lepe;15916;8102;7814
21;Huelva;045;Linares de la Sierra;286;138;148
21;Huelva;046;Lucena del Puerto;2050;1029;1021
21;Huelva;047;Manzanilla;2487;1237;1250
21;Huelva;048;Marines (Los);370;184;186
21;Huelva;049;Minas de Riotinto;6108;2898;3210
21;Huelva;050;Moguer;11407;5773;5634
21;Huelva;051;Nava (La);389;188;201
21;Huelva;052;Nerva;7240;3533;3707
21;Huelva;053;Niebla;4002;2038;1964
21;Huelva;054;Palma del Condado (La);9330;4651;4679
21;Huelva;055;Palos de la Frontera;6484;3266;3218
21;Huelva;056;Paterna del Campo;3861;2037;1824
21;Huelva;057;Paymogo;1500;717;783
21;Huelva;058;Puebla de Guzmán;3376;1705;1671
21;Huelva;059;Puerto Moral;240;112;128
21;Huelva;060;Punta Umbría;9950;5008;4942
21;Huelva;061;Rociana del Condado;6224;3167;3057
21;Huelva;062;Rosal de la Frontera;2102;1006;1096
21;Huelva;063;San Bartolomé de la Torre;2759;1409;1350
21;Huelva;064;San Juan del Puerto;5551;2780;2771
21;Huelva;066;San Silvestre de Guzmán;764;373;391
21;Huelva;065;Sanlúcar de Guadiana;424;202;222
21;Huelva;067;Santa Ana la Real;587;279;308
21;Huelva;068;Santa Bárbara de Casa;1566;775;791
21;Huelva;069;Santa Olalla del Cala;2425;1207;1218
21;Huelva;070;Trigueros;7060;3528;3532
21;Huelva;071;Valdelarco;328;155;173
21;Huelva;072;Valverde del Camino;12020;5773;6247
21;Huelva;073;Villablanca;1977;1025;952
21;Huelva;074;Villalba del Alcor;3784;1876;1908
21;Huelva;075;Villanueva de las Cruces;474;234;240
21;Huelva;076;Villanueva de los Castillejos;2690;1339;1351
21;Huelva;077;Villarrasa;2264;1164;1100
21;Huelva;078;Zalamea la Real;3954;1928;2026
21;Huelva;079;Zufre;1506;787;719
22;Huesca;001;Abiego;342;177;165
22;Huesca;002;Abizanda;112;64;48
22;Huesca;003;Adahuesca;187;95;92
22;Huesca;004;Agüero;187;99;88
22;Huesca;907;Aínsa-Sobrarbe;1358;714;644
22;Huesca;006;Aisa;296;152;144
22;Huesca;007;Albalate de Cinca;1231;627;604
22;Huesca;008;Albalatillo;292;146;146
22;Huesca;009;Albelda;1104;564;540
22;Huesca;011;Albero Alto;119;58;61
22;Huesca;012;Albero Bajo;141;73;68
22;Huesca;013;Alberuela de Tubo;466;243;223
22;Huesca;014;Alcalá de Gurrea;458;230;228
22;Huesca;015;Alcalá del Obispo;448;221;227
22;Huesca;016;Alcampell;1191;611;580
22;Huesca;017;Alcolea de Cinca;1206;610;596
22;Huesca;018;Alcubierre;549;281;268
22;Huesca;019;Alerre;139;69;70
22;Huesca;020;Alfántega;138;74;64
22;Huesca;021;Almudévar;2532;1334;1198
22;Huesca;022;Almunia de San Juan;811;398;413
22;Huesca;023;Almuniente;709;355;354
22;Huesca;024;Alquézar;276;136;140
22;Huesca;025;Altorricón;1575;843;732
22;Huesca;027;Angüés;558;298;260
22;Huesca;028;Ansó;546;286;260
22;Huesca;029;Antillón;184;90;94
22;Huesca;032;Aragüés del Puerto;129;86;43
22;Huesca;035;Arén;449;243;206
22;Huesca;036;Argavieso;125;71;54
22;Huesca;037;Arguis;54;28;26
22;Huesca;039;Ayerbe;1312;663;649
22;Huesca;040;Azanuy-Alins;282;136;146
22;Huesca;041;Azara;229;115;114
22;Huesca;042;Azlor;209;110;99
22;Huesca;043;Baélls;200;106;94
22;Huesca;044;Bailo;382;216;166
22;Huesca;045;Baldellou;207;107;100
22;Huesca;046;Ballobar;1229;610;619
22;Huesca;047;Banastás;106;47;59
22;Huesca;048;Barbastro;15106;7409;7697
22;Huesca;049;Barbués;131;62;69
22;Huesca;050;Barbuñales;124;66;58
22;Huesca;051;Bárcabo;115;67;48
22;Huesca;052;Belver de Cinca;1607;839;768
22;Huesca;053;Benabarre;1287;687;600
22;Huesca;054;Benasque;948;510;438
22;Huesca;055;Berbegal;533;259;274
22;Huesca;057;Bielsa;464;238;226
22;Huesca;058;Bierge;214;117;97
22;Huesca;059;Biescas;1242;644;598
22;Huesca;060;Binaced;1702;861;841
22;Huesca;061;Binéfar;8017;4046;3971
22;Huesca;062;Bisaurri;281;167;114
22;Huesca;063;Biscarrués;266;138;128
22;Huesca;064;Blecua y Torres;226;114;112
22;Huesca;066;Boltaña;887;437;450
22;Huesca;067;Bonansa;71;41;30
22;Huesca;068;Borau;76;42;34
22;Huesca;069;Broto;488;248;240
22;Huesca;072;Caldearenas;330;168;162
22;Huesca;074;Campo;417;195;222
22;Huesca;075;Camporrélls;337;154;183
22;Huesca;076;Canal de Berdún;505;259;246
22;Huesca;077;Candasnos;683;352;331
22;Huesca;078;Canfranc;553;295;258
22;Huesca;079;Capdesaso;220;110;110
22;Huesca;080;Capella;474;245;229
22;Huesca;081;Casbas de Huesca;357;188;169
22;Huesca;083;Castejón de Monegros;856;427;429
22;Huesca;084;Castejón de Sos;434;222;212
22;Huesca;082;Castejón del Puente;442;218;224
22;Huesca;085;Castelflorite;179;91;88
22;Huesca;086;Castiello de Jaca;177;81;96
22;Huesca;087;Castigaleu;95;52;43
22;Huesca;088;Castillazuelo;273;144;129
22;Huesca;089;Castillonroy;450;225;225
22;Huesca;094;Chalamera;180;100;80
22;Huesca;095;Chía;138;79;59
22;Huesca;096;Chimillas;149;81;68
22;Huesca;090;Colungo;164;81;83
22;Huesca;099;Esplús;1488;736;752
22;Huesca;102;Estada;231;118;113
22;Huesca;103;Estadilla;1055;542;513
22;Huesca;105;Estopiñán del Castillo;212;108;104
22;Huesca;106;Fago;52;31;21
22;Huesca;107;Fanlo;43;29;14
22;Huesca;109;Fiscal;304;164;140
22;Huesca;110;Fonz;1336;671;665
22;Huesca;111;Foradada del Toscar;287;146;141
22;Huesca;112;Fraga;11490;5772;5718
22;Huesca;113;Fueva (La);709;398;311
22;Huesca;114;Gistaín;230;130;100
22;Huesca;115;Grado (El);607;315;292
22;Huesca;116;Grañén;2375;1205;1170
22;Huesca;117;Graus;3484;1773;1711
22;Huesca;119;Gurrea de Gállego;2115;1063;1052
22;Huesca;122;Hoz de Jaca;85;35;50
22;Huesca;908;Hoz y Costean;298;162;136
22;Huesca;124;Huerto;353;189;164
22;Huesca;125;Huesca;41841;20313;21528
22;Huesca;126;Ibieca;126;66;60
22;Huesca;127;Igriés;163;92;71
22;Huesca;128;Ilche;318;164;154
22;Huesca;129;Isábena;306;166;140
22;Huesca;130;Jaca;10821;5357;5464
22;Huesca;131;Jasa;113;62;51
22;Huesca;133;Labuerda;177;91;86
22;Huesca;135;Laluenga;334;174;160
22;Huesca;136;Lalueza;1443;784;659
22;Huesca;137;Lanaja;1936;1001;935
22;Huesca;139;Laperdiguera;110;58;52
22;Huesca;141;Lascellas-Ponzano;206;99;107
22;Huesca;142;Lascuarre;177;87;90
22;Huesca;143;Laspaúles;324;192;132
22;Huesca;144;Laspuña;292;159;133
22;Huesca;149;Loarre;429;230;199
22;Huesca;150;Loporzano;478;238;240
22;Huesca;151;Loscorrales;139;76;63
22;Huesca;905;Lupiñén-Ortilla;409;216;193
22;Huesca;155;Monesma y Cajigar;109;50;59
22;Huesca;156;Monflorite-Lascasas;187;99;88
22;Huesca;157;Montanuy;366;210;156
22;Huesca;158;Monzón;14717;7382;7335
22;Huesca;160;Naval;293;143;150
22;Huesca;162;Novales;215;99;116
22;Huesca;163;Nueno;216;115;101
22;Huesca;164;Olvena;61;31;30
22;Huesca;165;Ontiñena;741;374;367
22;Huesca;167;Osso de Cinca;753;393;360
22;Huesca;168;Palo;41;24;17
22;Huesca;170;Panticosa;580;305;275
22;Huesca;172;Peñalba;829;407;422
22;Huesca;173;Peñas de Riglos (Las);328;179;149
22;Huesca;174;Peralta de Alcofea;819;397;422
22;Huesca;175;Peralta de Calasanz;430;226;204
22;Huesca;176;Peraltilla;181;95;86
22;Huesca;177;Perarrúa;166;83;83
22;Huesca;178;Pertusa;159;77;82
22;Huesca;181;Piracés;113;67;46
22;Huesca;182;Plan;313;171;142
22;Huesca;184;Poleñino;288;145;143
22;Huesca;186;Pozán de Vero;295;150;145
22;Huesca;187;Puebla de Castro (La);284;134;150
22;Huesca;188;Puente de Montañana;170;88;82
22;Huesca;902;Puente la Reina de Jaca;298;150;148
22;Huesca;189;Puértolas;205;114;91
22;Huesca;190;Pueyo de Araguás (El);169;101;68
22;Huesca;193;Pueyo de Santa Cruz;414;217;197
22;Huesca;195;Quicena;128;60;68
22;Huesca;197;Robres;796;401;395
22;Huesca;199;Sabiñánigo;9035;4665;4370
22;Huesca;200;Sahún;323;172;151
22;Huesca;201;Salas Altas;449;230;219
22;Huesca;202;Salas Bajas;238;115;123
22;Huesca;203;Salillas;144;73;71
22;Huesca;204;Sallent de Gállego;912;470;442
22;Huesca;205;San Esteban de Litera;805;395;410
22;Huesca;207;San Juan de Plan;179;104;75
22;Huesca;903;San Miguel del Cinca;978;508;470
22;Huesca;206;Sangarrén;316;157;159
22;Huesca;208;Santa Cilia;220;117;103
22;Huesca;209;Santa Cruz de la Serós;144;83;61
22;Huesca;906;Santa María de Dulcis;252;119;133
22;Huesca;212;Santaliestra y San Quílez;115;59;56
22;Huesca;213;Sariñena;4320;2168;2152
22;Huesca;214;Secastilla;211;92;119
22;Huesca;215;Seira;208;101;107
22;Huesca;217;Sena;729;373;356
22;Huesca;218;Senés de Alcubierre;70;31;39
22;Huesca;220;Sesa;327;165;162
22;Huesca;221;Sesué;74;41;33
22;Huesca;222;Siétamo;374;199;175
22;Huesca;223;Sopeira;157;85;72
22;Huesca;904;Sotonera (La);1403;720;683
22;Huesca;225;Tamarite de Litera;4180;2093;2087
22;Huesca;226;Tardienta;1296;661;635
22;Huesca;227;Tella-Sin;368;193;175
22;Huesca;228;Tierz;211;110;101
22;Huesca;229;Tolva;281;148;133
22;Huesca;230;Torla;350;194;156
22;Huesca;232;Torralba de Aragón;168;78;90
22;Huesca;233;Torre la Ribera;124;73;51
22;Huesca;234;Torrente de Cinca;1216;616;600
22;Huesca;235;Torres de Alcanadre;153;89;64
22;Huesca;236;Torres de Barbués;467;249;218
22;Huesca;239;Tramaced;143;83;60
22;Huesca;242;Valfarta;117;59;58
22;Huesca;243;Valle de Bardají;72;37;35
22;Huesca;901;Valle de Hecho;1054;562;492
22;Huesca;244;Valle de Lierp;69;37;32
22;Huesca;245;Velilla de Cinca;548;269;279
22;Huesca;909;Vencillón;164;81;83
22;Huesca;246;Veracruz;126;70;56
22;Huesca;247;Viacamp y Litera;52;31;21
22;Huesca;248;Vicién;136;78;58
22;Huesca;249;Villanova;102;53;49
22;Huesca;250;Villanúa;240;111;129
22;Huesca;251;Villanueva de Sigena;535;277;258
22;Huesca;252;Yebra de Basa;187;104;83
22;Huesca;253;Yésero;58;27;31
22;Huesca;254;Zaidín;1860;926;934
23;Jaén;001;Albanchez de Mágina;1839;898;941
23;Jaén;002;Alcalá la Real;20857;10411;10446
23;Jaén;003;Alcaudete;12080;6010;6070
23;Jaén;004;Aldeaquemada;663;336;327
23;Jaén;005;Andújar;37020;18335;18685
23;Jaén;006;Arjona;6096;3076;3020
23;Jaén;007;Arjonilla;3944;1968;1976
23;Jaén;008;Arquillos;1878;967;911
23;Jaén;009;Baeza;14957;7276;7681
23;Jaén;010;Bailén;16429;8275;8154
23;Jaén;011;Baños de la Encina;2826;1436;1390
23;Jaén;012;Beas de Segura;8750;4385;4365
23;Jaén;902;Bedmar y Garcíez;4053;2024;2029
23;Jaén;014;Begíjar;3160;1573;1587
23;Jaén;015;Bélmez de la Moraleda;2122;1060;1062
23;Jaén;016;Benatae;755;374;381
23;Jaén;017;Cabra del Santo Cristo;2611;1356;1255
23;Jaén;018;Cambil;4029;2076;1953
23;Jaén;019;Campillo de Arenas;2466;1252;1214
23;Jaén;020;Canena;2118;1020;1098
23;Jaén;021;Carboneros;763;373;390
23;Jaén;901;Cárcheles;1684;810;874
23;Jaén;024;Carolina (La);15345;7494;7851
23;Jaén;025;Castellar;3706;1852;1854
23;Jaén;026;Castillo de Locubín;6054;3001;3053
23;Jaén;027;Cazalilla;963;505;458
23;Jaén;028;Cazorla;9285;4581;4704
23;Jaén;029;Chiclana de Segura;2188;1092;1096
23;Jaén;030;Chilluévar;2123;1067;1056
23;Jaén;031;Escañuela;1068;552;516
23;Jaén;032;Espelúy;842;415;427
23;Jaén;033;Frailes;2000;1007;993
23;Jaén;034;Fuensanta de Martos;3689;1814;1875
23;Jaén;035;Fuerte del Rey;1183;586;597
23;Jaén;037;Génave;857;428;429
23;Jaén;038;Guardia de Jaén (La);1829;946;883
23;Jaén;039;Guarromán;3140;1551;1589
23;Jaén;041;Higuera de Calatrava;828;441;387
23;Jaén;042;Hinojares;772;392;380
23;Jaén;043;Hornos;879;456;423
23;Jaén;044;Huelma;6056;3004;3052
23;Jaén;045;Huesa;2936;1459;1477
23;Jaén;046;Ibros;3279;1618;1661
23;Jaén;047;Iruela (La);2333;1166;1167
23;Jaén;048;Iznatoraf;1420;684;736
23;Jaén;049;Jabalquinto;2750;1359;1391
23;Jaén;050;Jaén;106435;51356;55079
23;Jaén;051;Jamilena;3107;1581;1526
23;Jaén;052;Jimena;1885;936;949
23;Jaén;053;Jódar;12264;6142;6122
23;Jaén;040;Lahiguera;1969;971;998
23;Jaén;054;Larva;764;397;367
23;Jaén;055;Linares;58622;28744;29878
23;Jaén;056;Lopera;3973;1964;2009
23;Jaén;057;Lupión;1256;597;659
23;Jaén;058;Mancha Real;8271;4100;4171
23;Jaén;059;Marmolejo;7410;3731;3679
23;Jaén;060;Martos;22427;10972;11455
23;Jaén;061;Mengíbar;8213;4083;4130
23;Jaén;062;Montizón;2124;1063;1061
23;Jaén;063;Navas de San Juan;5478;2694;2784
23;Jaén;064;Noalejo;2422;1238;1184
23;Jaén;065;Orcera;2510;1292;1218
23;Jaén;066;Peal de Becerro;5577;2796;2781
23;Jaén;067;Pegalajar;3320;1624;1696
23;Jaén;069;Porcuna;7304;3647;3657
23;Jaén;070;Pozo Alcón;6061;3048;3013
23;Jaén;071;Puente de Génave;2163;1103;1060
23;Jaén;072;Puerta de Segura (La);3106;1556;1550
23;Jaén;073;Quesada;7329;3660;3669
23;Jaén;074;Rus;3726;1864;1862
23;Jaén;075;Sabiote;4541;2216;2325
23;Jaén;076;Santa Elena;1080;552;528
23;Jaén;077;Santiago de Calatrava;1117;566;551
23;Jaén;904;Santiago-Pontones;5514;2818;2696
23;Jaén;079;Santisteban del Puerto;5158;2596;2562
23;Jaén;080;Santo Tomé;2911;1469;1442
23;Jaén;081;Segura de la Sierra;2678;1400;1278
23;Jaén;082;Siles;2898;1453;1445
23;Jaén;084;Sorihuela del Guadalimar;1446;727;719
23;Jaén;086;Torre del Campo;11293;5556;5737
23;Jaén;085;Torreblascopedro;3343;1690;1653
23;Jaén;087;Torredonjimeno;13467;6611;6856
23;Jaén;088;Torreperogil;7888;3866;4022
23;Jaén;090;Torres;2163;1094;1069
23;Jaén;091;Torres de Albánchez;1235;619;616
23;Jaén;092;Úbeda;31179;15287;15892
23;Jaén;093;Valdepeñas de Jaén;5039;2550;2489
23;Jaén;094;Vilches;5426;2724;2702
23;Jaén;095;Villacarrillo;12323;6148;6175
23;Jaén;096;Villanueva de la Reina;3661;1833;1828
23;Jaén;097;Villanueva del Arzobispo;9112;4467;4645
23;Jaén;098;Villardompardo;1311;634;677
23;Jaén;099;Villares (Los);4407;2174;2233
23;Jaén;101;Villarrodrigo;901;458;443
23;Jaén;903;Villatorres;3979;2011;1968
24;León;001;Acebedo;420;214;206
24;León;002;Algadefe;455;234;221
24;León;003;Alija del Infantado;1290;651;639
24;León;004;Almanza;973;481;492
24;León;005;Antigua (La);900;463;437
24;León;006;Ardón;844;445;399
24;León;007;Arganza;1224;591;633
24;León;008;Astorga;12494;5982;6512
24;León;009;Balboa;798;392;406
24;León;010;Bañeza (La);9333;4508;4825
24;León;011;Barjas;769;416;353
24;León;012;Barrios de Luna (Los);446;226;220
24;León;014;Bembibre;10886;5519;5367
24;León;015;Benavides;3393;1781;1612
24;León;016;Benuza;1019;531;488
24;León;017;Bercianos del Páramo;1090;545;545
24;León;018;Bercianos del Real Camino;320;167;153
24;León;019;Berlanga del Bierzo;530;260;270
24;León;020;Boca de Huérgano;824;435;389
24;León;021;Boñar;3096;1525;1571
24;León;022;Borrenes;718;366;352
24;León;023;Brazuelo;380;196;184
24;León;024;Burgo Ranero (El);1274;650;624
24;León;025;Burón;631;334;297
24;León;026;Bustillo del Páramo;2414;1228;1186
24;León;027;Cabañas Raras;1235;648;587
24;León;028;Cabreros del Río;752;385;367
24;León;029;Cabrillanes;1498;748;750
24;León;030;Cacabelos;4680;2381;2299
24;León;031;Calzada del Coto;386;216;170
24;León;032;Campazas;234;111;123
24;León;033;Campo de Villavidel;485;250;235
24;León;034;Camponaraya;3110;1522;1588
24;León;036;Candín;612;331;281
24;León;037;Cármenes;614;280;334
24;León;038;Carracedelo;3598;1822;1776
24;León;039;Carrizo;2840;1461;1379
24;León;040;Carrocera;790;390;400
24;León;041;Carucedo;820;384;436
24;León;042;Castilfalé;144;76;68
24;León;043;Castrillo de Cabrera;458;237;221
24;León;044;Castrillo de la Valduerna;344;162;182
24;León;046;Castrocalbón;1577;781;796
24;León;047;Castrocontrigo;1538;774;764
24;León;049;Castropodame;2013;1010;1003
24;León;050;Castrotierra de Valmadrigal;195;102;93
24;León;051;Cea;972;505;467
24;León;052;Cebanico;369;201;168
24;León;053;Cebrones del Río;937;474;463
24;León;065;Chozas de Abajo;2378;1230;1148
24;León;054;Cimanes de la Vega;813;398;415
24;León;055;Cimanes del Tejar;1337;673;664
24;León;056;Cistierna;5511;2768;2743
24;León;057;Congosto;2165;1063;1102
24;León;058;Corbillos de los Oteros;444;216;228
24;León;059;Corullón;1770;880;890
24;León;060;Crémenes;1696;831;865
24;León;061;Cuadros;1885;891;994
24;León;062;Cubillas de los Oteros;281;132;149
24;León;063;Cubillas de Rueda;850;423;427
24;León;064;Cubillos del Sil;1557;794;763
24;León;066;Destriana;1186;564;622
24;León;067;Encinedo;1227;657;570
24;León;068;Ercina (La);1051;515;536
24;León;069;Escobar de Campos;110;63;47
24;León;070;Fabero;7067;3552;3515
24;León;071;Folgoso de la Ribera;1757;889;868
24;León;072;Fresnedo;"";"";""
24;León;073;Fresno de la Vega;841;409;432
24;León;074;Fuentes de Carbajal;190;104;86
24;León;076;Garrafe de Torío;1173;579;594
24;León;077;Gordaliza del Pino;487;240;247
24;León;078;Gordoncillo;767;373;394
24;León;079;Gradefes;1687;822;865
24;León;080;Grajal de Campos;445;192;253
24;León;081;Gusendos de los Oteros;316;156;160
24;León;082;Hospital de Órbigo;1208;609;599
24;León;083;Igüeña;2757;1487;1270
24;León;084;Izagre;466;220;246
24;León;086;Joarilla de las Matas;549;294;255
24;León;087;Laguna Dalga;1169;586;583
24;León;088;Laguna de Negrillos;2014;1027;987
24;León;089;León;136558;64825;71733
24;León;092;Llamas de la Ribera;1598;819;779
24;León;090;Lucillo;637;331;306
24;León;091;Luyego;1158;555;603
24;León;093;Magaz de Cepeda;759;362;397
24;León;094;Mansilla de las Mulas;1824;909;915
24;León;095;Mansilla Mayor;523;256;267
24;León;096;Maraña;252;128;124
24;León;097;Matadeón de los Oteros;386;207;179
24;León;098;Matallana de Torío;2138;1059;1079
24;León;099;Matanza;457;225;232
24;León;100;Molinaseca;762;386;376
24;León;101;Murias de Paredes;1000;474;526
24;León;102;Noceda del Bierzo;1173;574;599
24;León;103;Oencia;618;325;293
24;León;104;Omañas (Las);550;270;280
24;León;105;Onzonilla;1365;674;691
24;León;106;Oseja de Sajambre;437;226;211
24;León;107;Pajares de los Oteros;525;275;250
24;León;108;Palacios de la Valduerna;702;356;346
24;León;109;Palacios del Sil;2049;1057;992
24;León;110;Páramo del Sil;2570;1302;1268
24;León;111;Pedrosa del Rey;162;86;76
24;León;112;Peranzanes;504;258;246
24;León;113;Pobladura de Pelayo García;856;427;429
24;León;114;Pola de Gordón (La);6659;3251;3408
24;León;115;Ponferrada;59868;29520;30348
24;León;116;Posada de Valdeón;622;324;298
24;León;117;Pozuelo del Páramo;841;442;399
24;León;118;Prado de la Guzpeña;233;120;113
24;León;119;Priaranza del Bierzo;1155;599;556
24;León;120;Prioro;641;334;307
24;León;121;Puebla de Lillo;830;434;396
24;León;122;Puente de Domingo Flórez;2138;1134;1004
24;León;123;Quintana del Castillo;1490;765;725
24;León;124;Quintana del Marco;772;399;373
24;León;125;Quintana y Congosto;1073;553;520
24;León;127;Regueras de Arriba;514;281;233
24;León;129;Reyero;242;130;112
24;León;130;Riaño;897;465;432
24;León;131;Riego de la Vega;1408;698;710
24;León;132;Riello;1421;694;727
24;León;133;Rioseco de Tapia;695;369;326
24;León;134;Robla (La);5660;2857;2803
24;León;136;Roperuelos del Páramo;1066;541;525
24;León;137;Sabero;2895;1469;1426
24;León;139;Sahagún;3530;1765;1765
24;León;141;San Adrián del Valle;248;116;132
24;León;142;San Andrés del Rabanedo;16700;8118;8582
24;León;144;San Cristóbal de la Polantera;1511;764;747
24;León;145;San Emiliano;1213;599;614
24;León;146;San Esteban de Nogales;562;263;299
24;León;148;San Justo de la Vega;2597;1316;1281
24;León;149;San Millán de los Caballeros;237;117;120
24;León;150;San Pedro Bercianos;465;237;228
24;León;143;Sancedo;697;354;343
24;León;151;Santa Colomba de Curueño;839;413;426
24;León;152;Santa Colomba de Somoza;648;322;326
24;León;153;Santa Cristina de Valmadrigal;498;265;233
24;León;154;Santa Elena de Jamuz;1622;827;795
24;León;155;Santa María de la Isla;879;464;415
24;León;158;Santa María de Ordás;601;299;302
24;León;156;Santa María del Monte de Cea;567;281;286
24;León;157;Santa María del Páramo;3068;1491;1577
24;León;159;Santa Marina del Rey;3056;1525;1531
24;León;160;Santas Martas;1359;687;672
24;León;161;Santiago Millas;430;211;219
24;León;162;Santovenia de la Valdoncina;1299;624;675
24;León;163;Sariegos;1617;804;813
24;León;164;Sena de Luna;695;338;357
24;León;165;Sobrado;716;360;356
24;León;166;Soto de la Vega;2281;1163;1118
24;León;167;Soto y Amío;1330;633;697
24;León;168;Toral de los Guzmanes;859;439;420
24;León;169;Toreno;5680;2965;2715
24;León;170;Torre del Bierzo;4074;2057;2017
24;León;171;Trabadelo;840;441;399
24;León;172;Truchas;1446;712;734
24;León;173;Turcia;1784;916;868
24;León;174;Urdiales del Páramo;1096;547;549
24;León;185;Val de San Lorenzo;900;439;461
24;León;175;Valdefresno;1625;817;808
24;León;176;Valdefuentes del Páramo;570;299;271
24;León;177;Valdelugueros;527;268;259
24;León;178;Valdemora;165;85;80
24;León;179;Valdepiélago;514;255;259
24;León;180;Valdepolo;1989;1057;932
24;León;181;Valderas;2577;1287;1290
24;León;182;Valderrey;871;425;446
24;León;183;Valderrueda;1792;885;907
24;León;184;Valdesamario;393;195;198
24;León;187;Valdevimbre;1530;781;749
24;León;188;Valencia de Don Juan;3828;1906;1922
24;León;191;Vallecillo;244;128;116
24;León;189;Valverde de la Virgen;3582;1832;1750
24;León;190;Valverde-Enrique;325;158;167
24;León;193;Vecilla (La);555;279;276
24;León;196;Vega de Espinareda;3668;1868;1800
24;León;197;Vega de Infanzones;989;501;488
24;León;198;Vega de Valcarce;1391;704;687
24;León;194;Vegacervera;370;192;178
24;León;199;Vegaquemada;735;356;379
24;León;201;Vegas del Condado;1810;908;902
24;León;202;Villablino;15886;8060;7826
24;León;203;Villabraz;235;124;111
24;León;205;Villadangos del Páramo;1075;522;553
24;León;206;Villadecanes;2630;1308;1322
24;León;207;Villademor de la Vega;597;310;287
24;León;209;Villafranca del Bierzo;5253;2633;2620
24;León;210;Villagatón;1329;688;641
24;León;211;Villamandos;615;296;319
24;León;901;Villamanín;1879;959;920
24;León;212;Villamañán;1661;816;845
24;León;213;Villamartín de Don Sancho;276;139;137
24;León;214;Villamejil;1249;646;603
24;León;215;Villamol;349;168;181
24;León;216;Villamontán de la Valduerna;1529;784;745
24;León;217;Villamoratiel de las Matas;288;153;135
24;León;218;Villanueva de las Manzanas;781;359;422
24;León;219;Villaobispo de Otero;863;446;417
24;León;902;Villaornate y Castro;675;338;337
24;León;221;Villaquejida;1270;645;625
24;León;222;Villaquilambre;4591;2264;2327
24;León;223;Villarejo de Órbigo;3823;1879;1944
24;León;224;Villares de Órbigo;1201;605;596
24;León;225;Villasabariego;1408;700;708
24;León;226;Villaselán;464;250;214
24;León;227;Villaturiel;1850;942;908
24;León;228;Villazala;1399;712;687
24;León;229;Villazanzo de Valderaduey;941;495;446
24;León;230;Zotes del Páramo;998;519;479
25;Lleida;001;Abella de la Conca;169;87;82
25;Lleida;002;Àger;635;331;304
25;Lleida;003;Agramunt;4747;2389;2358
25;Lleida;038;Aitona;2344;1169;1175
25;Lleida;004;Alamús (Els);677;339;338
25;Lleida;005;Alàs i Cerc;414;221;193
25;Lleida;006;Albagés (L');587;289;298
25;Lleida;007;Albatàrrec;1024;505;519
25;Lleida;008;Albesa;1450;727;723
25;Lleida;009;Albi (L');816;421;395
25;Lleida;010;Alcanó;289;142;147
25;Lleida;011;Alcarràs;4450;2239;2211
25;Lleida;012;Alcoletge;1450;730;720
25;Lleida;013;Alfarràs;3153;1553;1600
25;Lleida;014;Alfés;355;188;167
25;Lleida;015;Algerri;588;283;305
25;Lleida;016;Alguaire;2864;1432;1432
25;Lleida;017;Alins;296;153;143
25;Lleida;019;Almacelles;5485;2790;2695
25;Lleida;020;Almatret;588;302;286
25;Lleida;021;Almenar;3609;1842;1767
25;Lleida;022;Alòs de Balaguer;184;101;83
25;Lleida;023;Alpicat;3522;1827;1695
25;Lleida;024;Alt Àneu;349;188;161
25;Lleida;027;Anglesola;1313;653;660
25;Lleida;029;Arbeca;2399;1186;1213
25;Lleida;031;Arres;52;31;21
25;Lleida;032;Arsèguel;83;44;39
25;Lleida;033;Artesa de Lleida;1176;574;602
25;Lleida;034;Artesa de Segre;3238;1662;1576
25;Lleida;036;Aspa;263;133;130
25;Lleida;037;Avellanes i Santa Linya (Les);524;277;247
25;Lleida;039;Baix Pallars;422;233;189
25;Lleida;040;Balaguer;13133;6504;6629
25;Lleida;041;Barbens;800;410;390
25;Lleida;042;Baronia de Rialb (La);266;146;120
25;Lleida;044;Bassella;390;202;188
25;Lleida;045;Bausen;63;41;22
25;Lleida;046;Belianes;590;284;306
25;Lleida;170;Bellaguarda;389;199;190
25;Lleida;047;Bellcaire d'Urgell;1453;718;735
25;Lleida;048;Bell-lloc d'Urgell;2238;1118;1120
25;Lleida;049;Bellmunt d'Urgell;239;120;119
25;Lleida;050;Bellpuig;3818;1890;1928
25;Lleida;051;Bellver de Cerdanya;1582;811;771
25;Lleida;052;Bellvís;2323;1154;1169
25;Lleida;053;Benavent de Segrià;727;376;351
25;Lleida;055;Biosca;273;132;141
25;Lleida;057;Bòrdes (Es);189;92;97
25;Lleida;058;Borges Blanques (Les);5231;2556;2675
25;Lleida;059;Bossòst;795;394;401
25;Lleida;056;Bovera;491;249;242
25;Lleida;060;Cabanabona;120;57;63
25;Lleida;061;Cabó;161;92;69
25;Lleida;062;Camarasa;1002;505;497
25;Lleida;063;Canejan;118;66;52
25;Lleida;904;Castell de Mur;143;69;74
25;Lleida;064;Castellar de la Ribera;165;81;84
25;Lleida;067;Castelldans;1002;509;493
25;Lleida;068;Castellnou de Seana;784;386;398
25;Lleida;069;Castelló de Farfanya;637;324;313
25;Lleida;070;Castellserà;1235;604;631
25;Lleida;071;Cava;52;32;20
25;Lleida;072;Cervera;6724;3291;3433
25;Lleida;073;Cervià de les Garrigues;922;460;462
25;Lleida;074;Ciutadilla;253;129;124
25;Lleida;075;Clariana de Cardener;156;79;77
25;Lleida;076;Cogul (El);242;119;123
25;Lleida;077;Coll de Nargó;658;342;316
25;Lleida;163;Coma i la Pedra (La);257;146;111
25;Lleida;161;Conca de Dalt;484;258;226
25;Lleida;078;Corbins;1045;539;506
25;Lleida;079;Cubells;417;224;193
25;Lleida;081;Espluga Calba (L');443;235;208
25;Lleida;082;Espot;231;118;113
25;Lleida;088;Estamariu;139;74;65
25;Lleida;085;Estaràs;195;98;97
25;Lleida;086;Esterri d'Àneu;563;284;279
25;Lleida;087;Esterri de Cardós;64;32;32
25;Lleida;089;Farrera;95;52;43
25;Lleida;908;Fígols i Alinyà;374;209;165
25;Lleida;092;Floresta (La);195;96;99
25;Lleida;093;Fondarella;563;278;285
25;Lleida;094;Foradada;156;86;70
25;Lleida;096;Fuliola (La);1330;685;645
25;Lleida;097;Fulleda;118;56;62
25;Lleida;098;Gavet de la Conca;383;190;193
25;Lleida;912;Gimenells i el Pla de la Font;"";"";""
25;Lleida;099;Golmés;1275;628;647
25;Lleida;100;Gósol;201;107;94
25;Lleida;101;Granadella (La);922;469;453
25;Lleida;102;Granja d'Escarp (La);1168;587;581
25;Lleida;103;Granyanella;118;59;59
25;Lleida;105;Granyena de les Garrigues;196;97;99
25;Lleida;104;Granyena de Segarra;203;107;96
25;Lleida;109;Guimerà;459;222;237
25;Lleida;903;Guingueta d'Àneu (La);260;133;127
25;Lleida;110;Guissona;2695;1361;1334
25;Lleida;111;Guixers;167;99;68
25;Lleida;115;Isona i Conca Dellà;1468;746;722
25;Lleida;112;Ivars de Noguera;364;181;183
25;Lleida;113;Ivars d'Urgell;1767;871;896
25;Lleida;114;Ivorra;192;94;98
25;Lleida;910;Josa i Tuixén;134;68;66
25;Lleida;118;Juncosa;606;311;295
25;Lleida;119;Juneda;2997;1511;1486
25;Lleida;121;Les;612;307;305
25;Lleida;122;Linyola;2408;1228;1180
25;Lleida;123;Lladorre;212;118;94
25;Lleida;124;Lladurs;255;135;120
25;Lleida;125;Llardecans;696;351;345
25;Lleida;126;Llavorsí;279;145;134
25;Lleida;120;Lleida;109795;53820;55975
25;Lleida;127;Lles de Cerdanya;303;163;140
25;Lleida;128;Llimiana;139;78;61
25;Lleida;129;Llobera;244;127;117
25;Lleida;133;Maials;1181;590;591
25;Lleida;130;Maldà;342;176;166
25;Lleida;131;Massalcoreig;694;341;353
25;Lleida;132;Massoteres;156;84;72
25;Lleida;134;Menàrguens;917;452;465
25;Lleida;135;Miralcamp;1205;587;618
25;Lleida;137;Mollerussa;8601;4274;4327
25;Lleida;136;Molsosa (La);133;65;68
25;Lleida;139;Montellà i Martinet;550;293;257
25;Lleida;140;Montferrer i Castellbò;632;338;294
25;Lleida;138;Montgai;878;444;434
25;Lleida;142;Montoliu de Lleida;453;220;233
25;Lleida;141;Montoliu de Segarra;216;112;104
25;Lleida;143;Montornès de Segarra;134;56;78
25;Lleida;145;Nalec;105;49;56
25;Lleida;025;Naut Aran;1214;661;553
25;Lleida;146;Navès;302;156;146
25;Lleida;148;Odèn;335;183;152
25;Lleida;149;Oliana;2047;1053;994
25;Lleida;150;Oliola;257;145;112
25;Lleida;151;Olius;487;252;235
25;Lleida;152;Oluges (Les);229;118;111
25;Lleida;153;Omellons (Els);280;142;138
25;Lleida;154;Omells de na Gaia (Els);166;88;78
25;Lleida;155;Organyà;1051;539;512
25;Lleida;156;Os de Balaguer;849;489;360
25;Lleida;157;Ossó de Sió;263;126;137
25;Lleida;158;Palau d'Anglesola (El);1621;833;788
25;Lleida;164;Penelles;598;299;299
25;Lleida;165;Peramola;400;211;189
25;Lleida;166;Pinell de Solsonès;273;143;130
25;Lleida;167;Pinós;380;207;173
25;Lleida;911;Plans de Sió (Els);722;365;357
25;Lleida;168;Poal (El);692;355;337
25;Lleida;169;Pobla de Cérvoles (La);196;102;94
25;Lleida;171;Pobla de Segur (La);3266;1581;1685
25;Lleida;030;Pont de Bar (El);162;89;73
25;Lleida;173;Pont de Suert (El);2369;1190;1179
25;Lleida;172;Ponts;2279;1135;1144
25;Lleida;174;Portella (La);639;340;299
25;Lleida;175;Prats i Sansor;107;58;49
25;Lleida;176;Preixana;481;241;240
25;Lleida;177;Preixens;614;265;349
25;Lleida;179;Prullans;190;94;96
25;Lleida;180;Puiggròs;280;135;145
25;Lleida;181;Puigverd d'Agramunt;256;133;123
25;Lleida;182;Puigverd de Lleida;958;446;512
25;Lleida;183;Rialp;448;247;201
25;Lleida;905;Ribera d'Ondara;504;258;246
25;Lleida;185;Ribera d'Urgellet;803;437;366
25;Lleida;186;Riner;292;160;132
25;Lleida;913;Riu de Cerdanya;"";"";""
25;Lleida;189;Rosselló;1592;791;801
25;Lleida;190;Salàs de Pallars;395;194;201
25;Lleida;191;Sanaüja;472;232;240
25;Lleida;196;Sant Esteve de la Sarga;142;85;57
25;Lleida;192;Sant Guim de Freixenet;1088;541;547
25;Lleida;197;Sant Guim de la Plana;207;107;100
25;Lleida;193;Sant Llorenç de Morunys;882;462;420
25;Lleida;902;Sant Martí de Riucorb;811;417;394
25;Lleida;194;Sant Ramon;603;296;307
25;Lleida;201;Sarroca de Bellera;134;77;57
25;Lleida;200;Sarroca de Lleida;521;270;251
25;Lleida;202;Senterada;129;77;52
25;Lleida;035;Sentiu de Sió (La);503;248;255
25;Lleida;204;Seròs;1941;1032;909
25;Lleida;203;Seu d'Urgell (La);10071;5023;5048
25;Lleida;205;Sidamon;448;226;222
25;Lleida;206;Soleràs (El);495;250;245
25;Lleida;207;Solsona;6598;3300;3298
25;Lleida;208;Soriguera;284;151;133
25;Lleida;209;Sort;1542;783;759
25;Lleida;210;Soses;1526;776;750
25;Lleida;211;Sudanell;811;426;385
25;Lleida;212;Sunyer;322;162;160
25;Lleida;215;Talarn;375;195;180
25;Lleida;216;Talavera;308;148;160
25;Lleida;217;Tàrrega;11278;5477;5801
25;Lleida;218;Tarrés;98;48;50
25;Lleida;219;Tarroja de Segarra;208;109;99
25;Lleida;220;Térmens;1426;707;719
25;Lleida;221;Tírvia;106;56;50
25;Lleida;222;Tiurana;210;114;96
25;Lleida;223;Torà;1221;627;594
25;Lleida;224;Torms (Els);217;119;98
25;Lleida;225;Tornabous;937;467;470
25;Lleida;227;Torre de Cabdella (La);715;353;362
25;Lleida;226;Torrebesses;364;187;177
25;Lleida;228;Torrefarrera;1468;758;710
25;Lleida;907;Torrefeta i Florejacs;738;357;381
25;Lleida;230;Torregrossa;2242;1111;1131
25;Lleida;231;Torrelameu;603;321;282
25;Lleida;232;Torres de Segre;1891;967;924
25;Lleida;233;Torre-serona;311;155;156
25;Lleida;234;Tremp;5558;2763;2795
25;Lleida;043;Vall de Boí (La);557;310;247
25;Lleida;901;Vall de Cardós;333;178;155
25;Lleida;238;Vallbona de les Monges;290;132;158
25;Lleida;240;Vallfogona de Balaguer;1387;706;681
25;Lleida;906;Valls d'Aguilar (Les);238;128;110
25;Lleida;239;Valls de Valira (Les);733;388;345
25;Lleida;909;Vansa i Fórnols (La);162;87;75
25;Lleida;242;Verdú;950;467;483
25;Lleida;243;Vielha e Mijaran;3099;1577;1522
25;Lleida;244;Vilagrassa;434;217;217
25;Lleida;245;Vilaller;631;339;292
25;Lleida;247;Vilamòs;87;48;39
25;Lleida;248;Vilanova de Bellpuig;1237;606;631
25;Lleida;254;Vilanova de la Barca;878;448;430
25;Lleida;249;Vilanova de l'Aguda;279;147;132
25;Lleida;250;Vilanova de Meià;518;262;256
25;Lleida;251;Vilanova de Segrià;675;333;342
25;Lleida;252;Vila-sana;548;273;275
25;Lleida;253;Vilosell (El);212;99;113
25;Lleida;255;Vinaixa;714;353;361
26;Rioja (La);001;Ábalos;304;170;134
26;Rioja (La);002;Agoncillo;869;457;412
26;Rioja (La);003;Aguilar del Río Alhama;929;474;455
26;Rioja (La);004;Ajamil;76;46;30
26;Rioja (La);005;Albelda de Iregua;2301;1184;1117
26;Rioja (La);006;Alberite;1964;986;978
26;Rioja (La);007;Alcanadre;981;495;486
26;Rioja (La);008;Aldeanueva de Ebro;2675;1381;1294
26;Rioja (La);009;Alesanco;575;299;276
26;Rioja (La);010;Alesón;172;90;82
26;Rioja (La);011;Alfaro;9188;4580;4608
26;Rioja (La);012;Almarza de Cameros;37;21;16
26;Rioja (La);013;Anguciana;376;189;187
26;Rioja (La);014;Anguiano;770;422;348
26;Rioja (La);015;Arenzana de Abajo;413;218;195
26;Rioja (La);016;Arenzana de Arriba;48;25;23
26;Rioja (La);017;Arnedillo;414;209;205
26;Rioja (La);018;Arnedo;12380;6168;6212
26;Rioja (La);019;Arrúbal;407;216;191
26;Rioja (La);020;Ausejo;741;384;357
26;Rioja (La);021;Autol;3455;1738;1717
26;Rioja (La);022;Azofra;439;231;208
26;Rioja (La);023;Badarán;896;480;416
26;Rioja (La);024;Bañares;552;281;271
26;Rioja (La);026;Baños de Río Tobía;1853;934;919
26;Rioja (La);025;Baños de Rioja;146;84;62
26;Rioja (La);027;Berceo;255;141;114
26;Rioja (La);028;Bergasa;228;122;106
26;Rioja (La);029;Bergasillas Bajera;29;16;13
26;Rioja (La);030;Bezares;26;15;11
26;Rioja (La);031;Bobadilla;206;97;109
26;Rioja (La);032;Brieva de Cameros;79;42;37
26;Rioja (La);033;Briñas;213;107;106
26;Rioja (La);034;Briones;981;532;449
26;Rioja (La);035;Cabezón de Cameros;45;25;20
26;Rioja (La);036;Calahorra;18569;8959;9610
26;Rioja (La);037;Camprovín;283;145;138
26;Rioja (La);038;Canales de la Sierra;89;47;42
26;Rioja (La);039;Canillas de Río Tuerto;96;50;46
26;Rioja (La);040;Cañas;127;61;66
26;Rioja (La);041;Cárdenas;291;138;153
26;Rioja (La);042;Casalarreina;921;470;451
26;Rioja (La);043;Castañares de Rioja;596;308;288
26;Rioja (La);044;Castroviejo;49;24;25
26;Rioja (La);045;Cellorigo;24;13;11
26;Rioja (La);046;Cenicero;2246;1137;1109
26;Rioja (La);047;Cervera del Río Alhama;3775;1865;1910
26;Rioja (La);048;Cidamón;102;59;43
26;Rioja (La);049;Cihuri;209;108;101
26;Rioja (La);050;Cirueña;146;84;62
26;Rioja (La);051;Clavijo;179;92;87
26;Rioja (La);052;Cordovín;279;133;146
26;Rioja (La);053;Corera;274;138;136
26;Rioja (La);054;Cornago;819;439;380
26;Rioja (La);055;Corporales;79;42;37
26;Rioja (La);056;Cuzcurrita de Río Tirón;572;309;263
26;Rioja (La);057;Daroca de Rioja;59;35;24
26;Rioja (La);058;Enciso;168;92;76
26;Rioja (La);059;Entrena;1108;591;517
26;Rioja (La);060;Estollo;145;76;69
26;Rioja (La);061;Ezcaray;1784;930;854
26;Rioja (La);062;Foncea;166;92;74
26;Rioja (La);063;Fonzaleche;239;123;116
26;Rioja (La);064;Fuenmayor;2110;1043;1067
26;Rioja (La);065;Galbárruli;62;34;28
26;Rioja (La);066;Galilea;271;151;120
26;Rioja (La);067;Gallinero de Cameros;21;13;8
26;Rioja (La);068;Gimileo;93;48;45
26;Rioja (La);069;Grañón;557;300;257
26;Rioja (La);070;Grávalos;362;184;178
26;Rioja (La);071;Haro;9150;4470;4680
26;Rioja (La);072;Herce;386;190;196
26;Rioja (La);073;Herramélluri;203;105;98
26;Rioja (La);074;Hervías;256;133;123
26;Rioja (La);075;Hormilla;538;275;263
26;Rioja (La);076;Hormilleja;215;109;106
26;Rioja (La);077;Hornillos de Cameros;30;15;15
26;Rioja (La);078;Hornos de Moncalvillo;95;48;47
26;Rioja (La);079;Huércanos;964;497;467
26;Rioja (La);080;Igea;1037;559;478
26;Rioja (La);081;Jalón de Cameros;43;25;18
26;Rioja (La);082;Laguna de Cameros;203;109;94
26;Rioja (La);083;Lagunilla del Jubera;412;205;207
26;Rioja (La);084;Lardero;2797;1386;1411
26;Rioja (La);086;Ledesma de la Cogolla;27;17;10
26;Rioja (La);087;Leiva;384;188;196
26;Rioja (La);088;Leza de Río Leza;26;19;7
26;Rioja (La);089;Logroño;119038;57626;61412
26;Rioja (La);091;Lumbreras;178;105;73
26;Rioja (La);092;Manjarrés;149;79;70
26;Rioja (La);093;Mansilla de la Sierra;57;36;21
26;Rioja (La);094;Manzanares de Rioja;171;91;80
26;Rioja (La);095;Matute;222;111;111
26;Rioja (La);096;Medrano;285;148;137
26;Rioja (La);098;Munilla;123;62;61
26;Rioja (La);099;Murillo de Río Leza;1715;849;866
26;Rioja (La);100;Muro de Aguas;61;35;26
26;Rioja (La);101;Muro en Cameros;45;30;15
26;Rioja (La);102;Nájera;6699;3357;3342
26;Rioja (La);103;Nalda;970;513;457
26;Rioja (La);104;Navajún;22;14;8
26;Rioja (La);105;Navarrete;2068;1087;981
26;Rioja (La);106;Nestares;58;30;28
26;Rioja (La);107;Nieva de Cameros;139;74;65
26;Rioja (La);109;Ochánduri;120;59;61
26;Rioja (La);108;Ocón;358;197;161
26;Rioja (La);110;Ojacastro;281;165;116
26;Rioja (La);111;Ollauri;323;171;152
26;Rioja (La);112;Ortigosa de Cameros;363;179;184
26;Rioja (La);113;Pazuengos;44;25;19
26;Rioja (La);114;Pedroso;117;61;56
26;Rioja (La);115;Pinillos;28;16;12
26;Rioja (La);117;Pradejón;2823;1430;1393
26;Rioja (La);118;Pradillo;116;59;57
26;Rioja (La);119;Préjano;257;127;130
26;Rioja (La);120;Quel;2060;1070;990
26;Rioja (La);121;Rabanera;49;24;25
26;Rioja (La);122;Rasillo de Cameros (El);129;62;67
26;Rioja (La);123;Redal (El);254;127;127
26;Rioja (La);124;Ribafrecha;1136;604;532
26;Rioja (La);125;Rincón de Soto;3425;1735;1690
26;Rioja (La);126;Robres del Castillo;30;17;13
26;Rioja (La);127;Rodezno;400;200;200
26;Rioja (La);128;Sajazarra;200;101;99
26;Rioja (La);129;San Asensio;1506;779;727
26;Rioja (La);130;San Millán de la Cogolla;313;185;128
26;Rioja (La);131;San Millán de Yécora;94;55;39
26;Rioja (La);132;San Román de Cameros;177;95;82
26;Rioja (La);139;San Torcuato;156;81;75
26;Rioja (La);142;San Vicente de la Sonsierra;1211;624;587
26;Rioja (La);134;Santa Coloma;187;106;81
26;Rioja (La);135;Santa Engracia del Jubera;226;132;94
26;Rioja (La);136;Santa Eulalia Bajera;122;66;56
26;Rioja (La);138;Santo Domingo de la Calzada;5749;2884;2865
26;Rioja (La);140;Santurde de Rioja;346;171;175
26;Rioja (La);141;Santurdejo;244;136;108
26;Rioja (La);143;Sojuela;105;58;47
26;Rioja (La);144;Sorzano;277;149;128
26;Rioja (La);145;Sotés;302;157;145
26;Rioja (La);146;Soto en Cameros;117;67;50
26;Rioja (La);147;Terroba;38;20;18
26;Rioja (La);148;Tirgo;305;156;149
26;Rioja (La);149;Tobía;73;42;31
26;Rioja (La);150;Tormantos;245;135;110
26;Rioja (La);153;Torre en Cameros;15;11;4
26;Rioja (La);151;Torrecilla en Cameros;547;286;261
26;Rioja (La);152;Torrecilla sobre Alesanco;114;56;58
26;Rioja (La);154;Torremontalbo;13;8;5
26;Rioja (La);155;Treviana;355;191;164
26;Rioja (La);157;Tricio;432;212;220
26;Rioja (La);158;Tudelilla;551;283;268
26;Rioja (La);160;Uruñuela;738;381;357
26;Rioja (La);161;Valdemadera;22;13;9
26;Rioja (La);162;Valgañón;187;96;91
26;Rioja (La);163;Ventosa;159;84;75
26;Rioja (La);164;Ventrosa;100;43;57
26;Rioja (La);165;Viguera;426;230;196
26;Rioja (La);166;Villalba de Rioja;194;106;88
26;Rioja (La);167;Villalobar de Rioja;149;87;62
26;Rioja (La);168;Villamediana de Iregua;1937;988;949
26;Rioja (La);169;Villanueva de Cameros;128;65;63
26;Rioja (La);170;Villar de Arnedo (El);810;396;414
26;Rioja (La);171;Villar de Torre;386;201;185
26;Rioja (La);172;Villarejo;49;27;22
26;Rioja (La);173;Villarroya;13;7;6
26;Rioja (La);174;Villarta-Quintana;252;129;123
26;Rioja (La);175;Villavelayo;82;48;34
26;Rioja (La);176;Villaverde de Rioja;105;61;44
26;Rioja (La);177;Villoslada de Cameros;406;219;187
26;Rioja (La);178;Viniegra de Abajo;143;70;73
26;Rioja (La);179;Viniegra de Arriba;47;27;20
26;Rioja (La);180;Zarratón;313;157;156
26;Rioja (La);181;Zarzosa;23;14;9
26;Rioja (La);183;Zorraquín;44;27;17
27;Lugo;001;Abadín;4784;2331;2453
27;Lugo;002;Alfoz;2811;1378;1433
27;Lugo;003;Antas de Ulla;4175;2069;2106
27;Lugo;004;Baleira;2495;1301;1194
27;Lugo;901;Baralla;4308;2223;2085
27;Lugo;005;Barreiros;4071;1990;2081
27;Lugo;006;Becerreá;4728;2430;2298
27;Lugo;007;Begonte;4722;2340;2382
27;Lugo;008;Bóveda;2564;1269;1295
27;Lugo;902;Burela;"";"";""
27;Lugo;009;Carballedo;5063;2523;2540
27;Lugo;010;Castro de Rei;6226;3143;3083
27;Lugo;011;Castroverde;4310;2205;2105
27;Lugo;012;Cervantes;3177;1731;1446
27;Lugo;013;Cervo;11630;5775;5855
27;Lugo;016;Chantada;11299;5496;5803
27;Lugo;014;Corgo (O);5237;2649;2588
27;Lugo;015;Cospeito;7006;3459;3547
27;Lugo;017;Folgoso do Courel;2635;1365;1270
27;Lugo;018;Fonsagrada (A);8303;4371;3932
27;Lugo;019;Foz;9743;4683;5060
27;Lugo;020;Friol;5522;2784;2738
27;Lugo;022;Guitiriz;7465;3702;3763
27;Lugo;023;Guntín;4461;2183;2278
27;Lugo;024;Incio (O);3612;1862;1750
27;Lugo;026;Láncara;4124;2119;2005
27;Lugo;027;Lourenzá;3270;1597;1673
27;Lugo;028;Lugo;78795;37489;41306
27;Lugo;029;Meira;2024;989;1035
27;Lugo;030;Mondoñedo;6459;3052;3407
27;Lugo;031;Monforte de Lemos;20472;9866;10606
27;Lugo;032;Monterroso;5150;2711;2439
27;Lugo;033;Muras;2000;995;1005
27;Lugo;034;Navia de Suarna;3321;1741;1580
27;Lugo;035;Negueira de Muñiz;379;204;175
27;Lugo;037;Nogais (As);2163;1156;1007
27;Lugo;038;Ourol;2280;1053;1227
27;Lugo;039;Outeiro de Rei;4487;2215;2272
27;Lugo;040;Palas de Rei;6187;3076;3111
27;Lugo;041;Pantón;5729;2767;2962
27;Lugo;042;Paradela;3355;1664;1691
27;Lugo;043;Páramo (O);2227;1145;1082
27;Lugo;044;Pastoriza (A);4907;2473;2434
27;Lugo;045;Pedrafita do Cebreiro;2415;1290;1125
27;Lugo;047;Pobra do Brollón (A);3487;1707;1780
27;Lugo;046;Pol;2675;1338;1337
27;Lugo;048;Pontenova (A);4100;2003;2097
27;Lugo;049;Portomarín;2474;1257;1217
27;Lugo;050;Quiroga;5675;2830;2845
27;Lugo;056;Rábade;1953;994;959
27;Lugo;051;Ribadeo;9161;4327;4834
27;Lugo;052;Ribas de Sil;2020;1010;1010
27;Lugo;053;Ribeira de Piquín;1233;622;611
27;Lugo;054;Riotorto;2480;1234;1246
27;Lugo;055;Samos;3094;1658;1436
27;Lugo;057;Sarria;13049;6486;6563
27;Lugo;058;Saviñao (O);7197;3556;3641
27;Lugo;059;Sober;4980;2451;2529
27;Lugo;060;Taboada;6073;3008;3065
27;Lugo;061;Trabada;2198;1066;1132
27;Lugo;062;Triacastela;1163;608;555
27;Lugo;063;Valadouro (O);3070;1510;1560
27;Lugo;064;Vicedo (O);2979;1454;1525
27;Lugo;065;Vilalba;16465;8024;8441
27;Lugo;066;Viveiro;15083;7251;7832
27;Lugo;021;Xermade;3376;1637;1739
27;Lugo;025;Xove;3805;1927;1878
28;Madrid;001;Acebeda (La);62;34;28
28;Madrid;002;Ajalvir;1112;603;509
28;Madrid;003;Alameda del Valle;144;79;65
28;Madrid;004;Álamo (El);2103;1085;1018
28;Madrid;005;Alcalá de Henares;150021;75299;74722
28;Madrid;006;Alcobendas;73455;36490;36965
28;Madrid;007;Alcorcón;139796;69494;70302
28;Madrid;008;Aldea del Fresno;1029;529;500
28;Madrid;009;Algete;8284;4275;4009
28;Madrid;010;Alpedrete;2940;1474;1466
28;Madrid;011;Ambite;313;154;159
28;Madrid;012;Anchuelo;503;270;233
28;Madrid;013;Aranjuez;37694;18369;19325
28;Madrid;014;Arganda del Rey;24862;12383;12479
28;Madrid;015;Arroyomolinos;322;161;161
28;Madrid;016;Atazar (El);90;49;41
28;Madrid;017;Batres;275;137;138
28;Madrid;018;Becerril de la Sierra;1669;827;842
28;Madrid;019;Belmonte de Tajo;1085;549;536
28;Madrid;021;Berrueco (El);237;129;108
28;Madrid;020;Berzosa del Lozoya;70;40;30
28;Madrid;022;Boadilla del Monte;10302;5205;5097
28;Madrid;023;Boalo (El);1578;805;773
28;Madrid;024;Braojos;131;72;59
28;Madrid;025;Brea de Tajo;493;260;233
28;Madrid;026;Brunete;1882;944;938
28;Madrid;027;Buitrago del Lozoya;1223;654;569
28;Madrid;028;Bustarviejo;1148;584;564
28;Madrid;029;Cabanillas de la Sierra;359;182;177
28;Madrid;030;Cabrera (La);805;403;402
28;Madrid;031;Cadalso de los Vidrios;2048;1060;988
28;Madrid;032;Camarma de Esteruelas;1361;690;671
28;Madrid;033;Campo Real;2071;1064;1007
28;Madrid;034;Canencia;465;241;224
28;Madrid;035;Carabaña;1056;535;521
28;Madrid;036;Casarrubuelos;515;286;229
28;Madrid;037;Cenicientos;2132;1065;1067
28;Madrid;038;Cercedilla;3877;1901;1976
28;Madrid;039;Cervera de Buitrago;94;48;46
28;Madrid;051;Chapinería;768;407;361
28;Madrid;052;Chinchón;4024;2019;2005
28;Madrid;040;Ciempozuelos;10390;5282;5108
28;Madrid;041;Cobeña;887;456;431
28;Madrid;046;Collado Mediano;1762;859;903
28;Madrid;047;Collado Villalba;22555;11227;11328
28;Madrid;043;Colmenar de Oreja;5251;2544;2707
28;Madrid;042;Colmenar del Arroyo;410;206;204
28;Madrid;045;Colmenar Viejo;32976;16363;16613
28;Madrid;044;Colmenarejo;1741;904;837
28;Madrid;048;Corpa;357;185;172
28;Madrid;049;Coslada;68765;34584;34181
28;Madrid;050;Cubas de la Sagra;844;405;439
28;Madrid;053;Daganzo de Arriba;1304;664;640
28;Madrid;054;Escorial (El);6615;3288;3327
28;Madrid;055;Estremera;1091;569;522
28;Madrid;056;Fresnedillas de la Oliva;415;208;207
28;Madrid;057;Fresno de Torote;182;90;92
28;Madrid;058;Fuenlabrada;128872;65283;63589
28;Madrid;059;Fuente el Saz de Jarama;2011;1034;977
28;Madrid;060;Fuentidueña de Tajo;1247;622;625
28;Madrid;061;Galapagar;8116;4149;3967
28;Madrid;062;Garganta de los Montes;305;153;152
28;Madrid;063;Gargantilla del Lozoya y Pinilla de Buitrago;219;122;97
28;Madrid;064;Gascones;89;45;44
28;Madrid;065;Getafe;135367;67472;67895
28;Madrid;066;Griñón;1721;904;817
28;Madrid;067;Guadalix de la Sierra;1569;802;767
28;Madrid;068;Guadarrama;6261;3104;3157
28;Madrid;069;Hiruela (La);40;24;16
28;Madrid;070;Horcajo de la Sierra;130;66;64
28;Madrid;071;Horcajuelo de la Sierra;71;36;35
28;Madrid;072;Hoyo de Manzanares;2680;1377;1303
28;Madrid;073;Humanes de Madrid;6785;3441;3344
28;Madrid;074;Leganés;168403;84617;83786
28;Madrid;075;Loeches;2064;1044;1020
28;Madrid;076;Lozoya;446;231;215
28;Madrid;901;Lozoyuela-Navas-Sieteiglesias;639;352;287
28;Madrid;078;Madarcos;34;16;18
28;Madrid;079;Madrid;3102846;1462470;1640376
28;Madrid;080;Majadahonda;31624;15592;16032
28;Madrid;082;Manzanares el Real;1815;941;874
28;Madrid;083;Meco;1890;964;926
28;Madrid;084;Mejorada del Campo;12058;6083;5975
28;Madrid;085;Miraflores de la Sierra;2509;1246;1263
28;Madrid;086;Molar (El);2678;1397;1281
28;Madrid;087;Molinos (Los);2370;1108;1262
28;Madrid;088;Montejo de la Sierra;234;123;111
28;Madrid;089;Moraleja de Enmedio;1437;717;720
28;Madrid;090;Moralzarzal;1749;876;873
28;Madrid;091;Morata de Tajuña;4728;2341;2387
28;Madrid;092;Móstoles;181648;90642;91006
28;Madrid;093;Navacerrada;1551;858;693
28;Madrid;094;Navalafuente;280;153;127
28;Madrid;095;Navalagamella;535;264;271
28;Madrid;096;Navalcarnero;9245;4673;4572
28;Madrid;097;Navarredonda y San Mamés;119;64;55
28;Madrid;099;Navas del Rey;986;502;484
28;Madrid;100;Nuevo Baztán;614;349;265
28;Madrid;101;Olmeda de las Fuentes;137;72;65
28;Madrid;102;Orusco de Tajuña;575;284;291
28;Madrid;104;Paracuellos de Jarama;4088;2096;1992
28;Madrid;106;Parla;66253;33416;32837
28;Madrid;107;Patones;352;174;178
28;Madrid;108;Pedrezuela;760;391;369
28;Madrid;109;Pelayos de la Presa;774;394;380
28;Madrid;110;Perales de Tajuña;1900;908;992
28;Madrid;111;Pezuela de las Torres;509;273;236
28;Madrid;112;Pinilla del Valle;137;74;63
28;Madrid;113;Pinto;21266;10649;10617
28;Madrid;114;Piñuécar-Gandullas;159;76;83
28;Madrid;115;Pozuelo de Alarcón;38889;19138;19751
28;Madrid;116;Pozuelo del Rey;222;114;108
28;Madrid;117;Prádena del Rincón;111;62;49
28;Madrid;118;Puebla de la Sierra;87;48;39
28;Madrid;902;Puentes Viejas;410;214;196
28;Madrid;119;Quijorna;558;300;258
28;Madrid;120;Rascafría;1266;656;610
28;Madrid;121;Redueña;122;60;62
28;Madrid;122;Ribatejada;240;124;116
28;Madrid;123;Rivas-Vaciamadrid;7599;3821;3778
28;Madrid;124;Robledillo de la Jara;63;28;35
28;Madrid;125;Robledo de Chavela;1680;848;832
28;Madrid;126;Robregordo;101;54;47
28;Madrid;127;Rozas de Madrid (Las);26214;12978;13236
28;Madrid;128;Rozas de Puerto Real;404;206;198
28;Madrid;129;San Agustín del Guadalix;2748;1407;1341
28;Madrid;130;San Fernando de Henares;23844;11982;11862
28;Madrid;131;San Lorenzo de El Escorial;9193;4470;4723
28;Madrid;132;San Martín de la Vega;5819;2990;2829
28;Madrid;133;San Martín de Valdeiglesias;5122;2595;2527
28;Madrid;134;San Sebastián de los Reyes;51653;25961;25692
28;Madrid;135;Santa María de la Alameda;737;399;338
28;Madrid;136;Santorcaz;520;268;252
28;Madrid;137;Santos de la Humosa (Los);889;456;433
28;Madrid;138;Serna del Monte (La);85;45;40
28;Madrid;140;Serranillos del Valle;456;243;213
28;Madrid;141;Sevilla la Nueva;718;368;350
28;Madrid;143;Somosierra;107;64;43
28;Madrid;144;Soto del Real;1854;928;926
28;Madrid;145;Talamanca de Jarama;976;497;479
28;Madrid;146;Tielmes;1872;984;888
28;Madrid;147;Titulcia;866;428;438
28;Madrid;148;Torrejón de Ardoz;83267;41936;41331
28;Madrid;149;Torrejón de la Calzada;1026;535;491
28;Madrid;150;Torrejón de Velasco;1268;651;617
28;Madrid;151;Torrelaguna;2513;1228;1285
28;Madrid;152;Torrelodones;5853;2879;2974
28;Madrid;153;Torremocha de Jarama;202;106;96
28;Madrid;154;Torres de la Alameda;2647;1333;1314
28;Madrid;903;Tres Cantos;"";"";""
28;Madrid;155;Valdaracete;720;343;377
28;Madrid;156;Valdeavero;492;254;238
28;Madrid;157;Valdelaguna;565;293;272
28;Madrid;158;Valdemanco;457;242;215
28;Madrid;159;Valdemaqueda;458;230;228
28;Madrid;160;Valdemorillo;2494;1276;1218
28;Madrid;161;Valdemoro;17925;9651;8274
28;Madrid;162;Valdeolmos-Alalpardo;773;427;346
28;Madrid;163;Valdepiélagos;313;158;155
28;Madrid;164;Valdetorres de Jarama;1100;558;542
28;Madrid;165;Valdilecha;1551;777;774
28;Madrid;166;Valverde de Alcalá;210;113;97
28;Madrid;167;Velilla de San Antonio;1940;976;964
28;Madrid;168;Vellón (El);880;451;429
28;Madrid;169;Venturada;261;132;129
28;Madrid;171;Villa del Prado;3252;1630;1622
28;Madrid;170;Villaconejos;2912;1490;1422
28;Madrid;172;Villalbilla;1583;822;761
28;Madrid;173;Villamanrique de Tajo;564;284;280
28;Madrid;174;Villamanta;1065;548;517
28;Madrid;175;Villamantilla;296;153;143
28;Madrid;176;Villanueva de la Cañada;3262;1664;1598
28;Madrid;178;Villanueva de Perales;362;198;164
28;Madrid;177;Villanueva del Pardillo;1605;807;798
28;Madrid;179;Villar del Olmo;418;216;202
28;Madrid;180;Villarejo de Salvanés;4611;2317;2294
28;Madrid;181;Villaviciosa de Odón;10313;4988;5325
28;Madrid;182;Villavieja del Lozoya;157;71;86
28;Madrid;183;Zarzalejo;800;419;381
29;Málaga;001;Alameda;4816;2410;2406
29;Málaga;002;Alcaucín;1486;745;741
29;Málaga;003;Alfarnate;1583;813;770
29;Málaga;004;Alfarnatejo;435;234;201
29;Málaga;005;Algarrobo;4772;2420;2352
29;Málaga;006;Algatocín;1098;575;523
29;Málaga;007;Alhaurín de la Torre;11209;5582;5627
29;Málaga;008;Alhaurín el Grande;16422;8177;8245
29;Málaga;009;Almáchar;2063;1067;996
29;Málaga;010;Almargen;2428;1203;1225
29;Málaga;011;Almogía;4177;2111;2066
29;Málaga;012;Álora;13911;6965;6946
29;Málaga;013;Alozaina;2987;1559;1428
29;Málaga;014;Alpandeire;393;208;185
29;Málaga;015;Antequera;41284;20279;21005
29;Málaga;016;Árchez;388;213;175
29;Málaga;017;Archidona;10305;5209;5096
29;Málaga;018;Ardales;3134;1595;1539
29;Málaga;019;Arenas;1330;719;611
29;Málaga;020;Arriate;3307;1668;1639
29;Málaga;021;Atajate;151;86;65
29;Málaga;022;Benadalid;275;147;128
29;Málaga;023;Benahavís;2083;1044;1039
29;Málaga;024;Benalauría;598;307;291
29;Málaga;025;Benalmádena;21866;10993;10873
29;Málaga;026;Benamargosa;1688;863;825
29;Málaga;027;Benamocarra;2733;1371;1362
29;Málaga;028;Benaoján;1815;899;916
29;Málaga;029;Benarrabá;786;402;384
29;Málaga;030;Borge (El);1119;573;546
29;Málaga;031;Burgo (El);2198;1157;1041
29;Málaga;032;Campillos;7563;3850;3713
29;Málaga;033;Canillas de Aceituno;2756;1408;1348
29;Málaga;034;Canillas de Albaida;647;339;308
29;Málaga;035;Cañete la Real;2394;1250;1144
29;Málaga;036;Carratraca;1020;508;512
29;Málaga;037;Cartajima;419;215;204
29;Málaga;038;Cártama;11776;5915;5861
29;Málaga;039;Casabermeja;3035;1598;1437
29;Málaga;040;Casarabonela;2848;1483;1365
29;Málaga;041;Casares;3069;1566;1503
29;Málaga;042;Coín;20294;10349;9945
29;Málaga;043;Colmenar;3322;1636;1686
29;Málaga;044;Comares;1727;883;844
29;Málaga;045;Cómpeta;2315;1148;1167
29;Málaga;046;Cortes de la Frontera;4123;2077;2046
29;Málaga;047;Cuevas Bajas;1683;809;874
29;Málaga;049;Cuevas de San Marcos;4250;2115;2135
29;Málaga;048;Cuevas del Becerro;2133;1088;1045
29;Málaga;050;Cútar;652;324;328
29;Málaga;051;Estepona;29304;14723;14581
29;Málaga;052;Faraján;365;191;174
29;Málaga;053;Frigiliana;2130;1050;1080
29;Málaga;054;Fuengirola;38323;18993;19330
29;Málaga;055;Fuente de Piedra;2151;1094;1057
29;Málaga;056;Gaucín;2002;1044;958
29;Málaga;057;Genalguacil;771;397;374
29;Málaga;058;Guaro;2086;1051;1035
29;Málaga;059;Humilladero;2347;1195;1152
29;Málaga;060;Igualeja;1136;582;554
29;Málaga;061;Istán;1610;811;799
29;Málaga;062;Iznate;742;377;365
29;Málaga;063;Jimera de Líbar;539;274;265
29;Málaga;064;Jubrique;1054;535;519
29;Málaga;065;Júzcar;300;173;127
29;Málaga;066;Macharaviaya;358;182;176
29;Málaga;067;Málaga;574456;278500;295956
29;Málaga;068;Manilva;4554;2343;2211
29;Málaga;069;Marbella;77035;38329;38706
29;Málaga;070;Mijas;27101;13644;13457
29;Málaga;071;Moclinejo;1162;599;563
29;Málaga;072;Mollina;3220;1594;1626
29;Málaga;073;Monda;1734;883;851
29;Málaga;074;Montejaque;1370;682;688
29;Málaga;075;Nerja;12743;6354;6389
29;Málaga;076;Ojén;2098;1101;997
29;Málaga;077;Parauta;400;200;200
29;Málaga;079;Periana;3706;1941;1765
29;Málaga;080;Pizarra;6351;3232;3119
29;Málaga;081;Pujerra;339;194;145
29;Málaga;082;Rincón de la Victoria;10167;5045;5122
29;Málaga;083;Riogordo;2859;1448;1411
29;Málaga;084;Ronda;33567;16611;16956
29;Málaga;085;Salares;307;156;151
29;Málaga;086;Sayalonga;1131;579;552
29;Málaga;087;Sedella;577;306;271
29;Málaga;088;Sierra de Yeguas;3260;1616;1644
29;Málaga;089;Teba;4532;2345;2187
29;Málaga;090;Tolox;3130;1634;1496
29;Málaga;901;Torremolinos;"";"";""
29;Málaga;091;Torrox;10336;5276;5060
29;Málaga;092;Totalán;616;318;298
29;Málaga;093;Valle de Abdalajís;3162;1607;1555
29;Málaga;094;Vélez-Málaga;52176;26168;26008
29;Málaga;095;Villanueva de Algaidas;4459;2219;2240
29;Málaga;098;Villanueva de Tapia;1548;788;760
29;Málaga;096;Villanueva del Rosario;3181;1566;1615
29;Málaga;097;Villanueva del Trabuco;4524;2289;2235
29;Málaga;099;Viñuela;1211;617;594
29;Málaga;100;Yunquera;3166;1636;1530
30;Murcia;001;Abanilla;6989;3432;3557
30;Murcia;002;Abarán;11809;5828;5981
30;Murcia;003;Águilas;23853;11902;11951
30;Murcia;004;Albudeite;1529;753;776
30;Murcia;005;Alcantarilla;28279;13767;14512
30;Murcia;902;Alcázares (Los);3450;1686;1764
30;Murcia;006;Aledo;1046;531;515
30;Murcia;007;Alguazas;6670;3296;3374
30;Murcia;008;Alhama de Murcia;14117;6932;7185
30;Murcia;009;Archena;13299;6576;6723
30;Murcia;010;Beniel;6718;3354;3364
30;Murcia;011;Blanca;6073;2927;3146
30;Murcia;012;Bullas;10209;5124;5085
30;Murcia;013;Calasparra;8913;4473;4440
30;Murcia;014;Campos del Río;2054;1016;1038
30;Murcia;015;Caravaca de la Cruz;23078;11429;11649
30;Murcia;016;Cartagena;172710;85179;87531
30;Murcia;017;Cehegín;15181;7552;7629
30;Murcia;018;Ceutí;6143;3097;3046
30;Murcia;019;Cieza;30904;15109;15795
30;Murcia;020;Fortuna;6225;3132;3093
30;Murcia;021;Fuente Álamo de Murcia;8938;4486;4452
30;Murcia;022;Jumilla;20961;10416;10545
30;Murcia;023;Librilla;3742;1843;1899
30;Murcia;024;Lorca;66437;32748;33689
30;Murcia;025;Lorquí;5400;2717;2683
30;Murcia;026;Mazarrón;13797;6955;6842
30;Murcia;027;Molina de Segura;36429;18021;18408
30;Murcia;028;Moratalla;10146;5147;4999
30;Murcia;029;Mula;13249;6579;6670
30;Murcia;030;Murcia;314124;152891;161233
30;Murcia;031;Ojós;654;319;335
30;Murcia;032;Pliego;3459;1734;1725
30;Murcia;033;Puerto Lumbreras;9513;4643;4870
30;Murcia;034;Ricote;1792;863;929
30;Murcia;035;San Javier;14496;7265;7231
30;Murcia;036;San Pedro del Pinatar;11623;5773;5850
30;Murcia;901;Santomera;7943;3985;3958
30;Murcia;037;Torre-Pacheco;16009;8115;7894
30;Murcia;038;Torres de Cotillas (Las);13266;6670;6596
30;Murcia;039;Totana;19959;9929;10030
30;Murcia;040;Ulea;1115;563;552
30;Murcia;041;Unión (La);14869;7375;7494
30;Murcia;042;Villanueva del Río Segura;1719;867;852
30;Murcia;043;Yecla;26847;13292;13555
31;Navarra;001;Abáigar;100;58;42
31;Navarra;002;Abárzuza;508;243;265
31;Navarra;003;Abaurregaina/Abaurrea Alta;230;129;101
31;Navarra;004;Abaurrepea/Abaurrea Baja;52;33;19
31;Navarra;005;Aberin;381;186;195
31;Navarra;006;Ablitas;2345;1193;1152
31;Navarra;007;Adiós;130;66;64
31;Navarra;008;Aguilar de Codés;162;83;79
31;Navarra;009;Aibar/Oibar;979;492;487
31;Navarra;011;Allín;834;438;396
31;Navarra;012;Allo;1224;604;620
31;Navarra;010;Altsasu/Alsasua;7066;3603;3463
31;Navarra;013;Améscoa Baja;947;487;460
31;Navarra;014;Ancín;294;154;140
31;Navarra;015;Andosilla;2509;1257;1252
31;Navarra;016;Ansoáin;10967;5554;5413
31;Navarra;017;Anue;437;249;188
31;Navarra;018;Añorbe;401;221;180
31;Navarra;019;Aoiz/Agoitz;1887;944;943
31;Navarra;020;Araitz;683;398;285
31;Navarra;025;Arakil;2859;1486;1373
31;Navarra;021;Aranarache;109;54;55
31;Navarra;023;Aranguren;1342;741;601
31;Navarra;024;Arano;189;102;87
31;Navarra;022;Arantza;738;406;332
31;Navarra;026;Aras;256;129;127
31;Navarra;027;Arbizu;901;486;415
31;Navarra;028;Arce/Artzi;282;154;128
31;Navarra;029;Arcos (Los);1409;698;711
31;Navarra;030;Arellano;218;118;100
31;Navarra;031;Areso;312;163;149
31;Navarra;032;Arguedas;2433;1213;1220
31;Navarra;033;Aria;70;45;25
31;Navarra;034;Aribe;80;39;41
31;Navarra;035;Armañanzas;123;57;66
31;Navarra;036;Arróniz;1297;676;621
31;Navarra;037;Arruazu;115;61;54
31;Navarra;038;Artajona;1770;931;839
31;Navarra;039;Artazu;112;60;52
31;Navarra;040;Atez;189;108;81
31;Navarra;058;Auritz/Burguete;337;155;182
31;Navarra;041;Ayegui;660;344;316
31;Navarra;042;Azagra;3238;1588;1650
31;Navarra;043;Azuelo;89;45;44
31;Navarra;044;Bakaiku;372;207;165
31;Navarra;901;Barañain;15048;7435;7613
31;Navarra;045;Barásoain;435;225;210
31;Navarra;046;Barbarin;128;57;71
31;Navarra;047;Bargota;424;220;204
31;Navarra;048;Barillas;211;101;110
31;Navarra;049;Basaburua;837;455;382
31;Navarra;050;Baztan;8208;4192;4016
31;Navarra;137;Beintza-Labaien;336;193;143
31;Navarra;051;Beire;356;167;189
31;Navarra;052;Belascoáin;79;43;36
31;Navarra;250;Bera/Vera de Bidasoa;3570;1836;1734
31;Navarra;053;Berbinzana;789;388;401
31;Navarra;905;Beriáin;"";"";""
31;Navarra;902;Berrioplano;"";"";""
31;Navarra;903;Berriozar;"";"";""
31;Navarra;054;Bertizarana;666;336;330
31;Navarra;055;Betelu;348;191;157
31;Navarra;253;Bidaurreta;119;65;54
31;Navarra;056;Biurrun-Olcoz;195;109;86
31;Navarra;057;Buñuel;2510;1236;1274
31;Navarra;059;Burgui/Burgi;281;152;129
31;Navarra;060;Burlada/Burlata;14208;7026;7182
31;Navarra;061;Busto (El);134;68;66
31;Navarra;062;Cabanillas;1453;737;716
31;Navarra;063;Cabredo;144;71;73
31;Navarra;064;Cadreita;1901;915;986
31;Navarra;065;Caparroso;2429;1172;1257
31;Navarra;066;Cárcar;1252;610;642
31;Navarra;067;Carcastillo;2688;1360;1328
31;Navarra;068;Cascante;3587;1750;1837
31;Navarra;069;Cáseda;1190;587;603
31;Navarra;070;Castejón;3285;1630;1655
31;Navarra;071;Castillonuevo;19;13;6
31;Navarra;072;Cintruénigo;5417;2706;2711
31;Navarra;074;Cirauqui;498;272;226
31;Navarra;075;Ciriza;52;26;26
31;Navarra;076;Cizur;5073;2530;2543
31;Navarra;077;Corella;6411;3183;3228
31;Navarra;078;Cortes;3302;1695;1607
31;Navarra;079;Desojo;171;94;77
31;Navarra;080;Dicastillo;798;415;383
31;Navarra;081;Donamaria;396;203;193
31;Navarra;221;Doneztebe/Santesteban;1169;590;579
31;Navarra;083;Echarri;50;27;23
31;Navarra;086;Egüés;985;463;522
31;Navarra;087;Elgorriaga;189;95;94
31;Navarra;089;Enériz;189;99;90
31;Navarra;090;Eratsun;233;139;94
31;Navarra;091;Ergoiena;568;313;255
31;Navarra;092;Erro;842;445;397
31;Navarra;094;Eslava;250;126;124
31;Navarra;095;Esparza de Salazar;154;83;71
31;Navarra;096;Espronceda;219;124;95
31;Navarra;097;Estella/Lizarra;12732;6206;6526
31;Navarra;098;Esteribar;1463;770;693
31;Navarra;099;Etayo;115;59;56
31;Navarra;082;Etxalar;841;436;405
31;Navarra;084;Etxarri-Aranatz;2326;1213;1113
31;Navarra;085;Etxauri;385;202;183
31;Navarra;100;Eulate;432;221;211
31;Navarra;101;Ezcabarte;983;519;464
31;Navarra;093;Ezcároz/Ezkaroze;399;209;190
31;Navarra;102;Ezkurra;302;176;126
31;Navarra;103;Ezprogui;80;41;39
31;Navarra;104;Falces;2841;1398;1443
31;Navarra;105;Fitero;2216;1110;1106
31;Navarra;106;Fontellas;494;246;248
31;Navarra;107;Funes;2168;1083;1085
31;Navarra;108;Fustiñana;2359;1209;1150
31;Navarra;109;Galar;3269;1643;1626
31;Navarra;110;Gallipienzo;206;108;98
31;Navarra;111;Gallués/Galoze;145;87;58
31;Navarra;112;Garaioa;160;86;74
31;Navarra;113;Garde;227;120;107
31;Navarra;114;Garínoain;291;152;139
31;Navarra;115;Garralda;273;141;132
31;Navarra;116;Genevilla;167;90;77
31;Navarra;117;Goizueta;1084;586;498
31;Navarra;118;Goñi;219;122;97
31;Navarra;119;Güesa/Gorza;106;58;48
31;Navarra;120;Guesálaz;454;260;194
31;Navarra;121;Guirguillano;92;51;41
31;Navarra;256;Hiriberri/Villanueva de Aezkoa;186;99;87
31;Navarra;122;Huarte/Uharte;2760;1381;1379
31;Navarra;124;Ibargoiti;197;115;82
31;Navarra;259;Igantzi;586;314;272
31;Navarra;125;Igúzquiza;377;186;191
31;Navarra;126;Imotz;460;247;213
31;Navarra;127;Irañeta;172;99;73
31;Navarra;904;Irurtzun;"";"";""
31;Navarra;128;Isaba/Izaba;604;291;313
31;Navarra;129;Ituren;490;245;245
31;Navarra;130;Iturmendi;384;197;187
31;Navarra;131;Iza;563;308;255
31;Navarra;132;Izagaondoa;153;90;63
31;Navarra;133;Izalzu/Itzaltzu;54;26;28
31;Navarra;134;Jaurrieta;351;185;166
31;Navarra;135;Javier;172;80;92
31;Navarra;136;Juslapeña;401;222;179
31;Navarra;138;Lakuntza;1019;522;497
31;Navarra;139;Lana;248;141;107
31;Navarra;140;Lantz;144;88;56
31;Navarra;141;Lapoblación;208;115;93
31;Navarra;142;Larraga;1898;973;925
31;Navarra;143;Larraona;206;109;97
31;Navarra;144;Larraun;2068;1124;944
31;Navarra;145;Lazagurría;258;138;120
31;Navarra;146;Leache;71;40;31
31;Navarra;147;Legarda;78;39;39
31;Navarra;148;Legaria;179;87;92
31;Navarra;149;Leitza;3206;1653;1553
31;Navarra;908;Lekunberri;"";"";""
31;Navarra;150;Leoz;151;94;57
31;Navarra;151;Lerga;129;68;61
31;Navarra;152;Lerín;2171;1095;1076
31;Navarra;153;Lesaka;2907;1513;1394
31;Navarra;154;Lezáun;298;161;137
31;Navarra;155;Liédena;360;175;185
31;Navarra;156;Lizoáin;232;127;105
31;Navarra;157;Lodosa;4613;2332;2281
31;Navarra;158;Lónguida/Longida;349;184;165
31;Navarra;159;Lumbier;1476;766;710
31;Navarra;160;Luquin;161;86;75
31;Navarra;248;Luzaide/Valcarlos;567;288;279
31;Navarra;161;Mañeru;397;201;196
31;Navarra;162;Marañón;106;58;48
31;Navarra;163;Marcilla;2430;1250;1180
31;Navarra;164;Mélida;947;487;460
31;Navarra;165;Mendavia;3597;1808;1789
31;Navarra;166;Mendaza;494;229;265
31;Navarra;167;Mendigorría;995;511;484
31;Navarra;168;Metauten;365;191;174
31;Navarra;169;Milagro;2499;1251;1248
31;Navarra;170;Mirafuentes;58;27;31
31;Navarra;171;Miranda de Arga;1044;517;527
31;Navarra;172;Monreal;286;150;136
31;Navarra;173;Monteagudo;1167;575;592
31;Navarra;174;Morentin;128;59;69
31;Navarra;175;Mues;157;73;84
31;Navarra;176;Murchante;2937;1449;1488
31;Navarra;177;Murieta;274;155;119
31;Navarra;178;Murillo el Cuende;583;312;271
31;Navarra;179;Murillo el Fruto;883;446;437
31;Navarra;180;Muruzábal;203;106;97
31;Navarra;181;Navascués;291;180;111
31;Navarra;182;Nazar;52;31;21
31;Navarra;088;Noáin (Valle de Elorz)/Noain (Elortzibar);3412;1679;1733
31;Navarra;183;Obanos;699;335;364
31;Navarra;185;Ochagavía;717;378;339
31;Navarra;184;Oco;99;58;41
31;Navarra;186;Odieta;343;187;156
31;Navarra;187;Oitz;171;107;64
31;Navarra;188;Olaibar;194;106;88
31;Navarra;189;Olazti/Olazagutía;1789;934;855
31;Navarra;190;Olejua;70;33;37
31;Navarra;191;Olite;3028;1493;1535
31;Navarra;194;Ollo;371;207;164
31;Navarra;192;Olóriz;181;99;82
31;Navarra;193;Olza;2304;1175;1129
31;Navarra;195;Orbaitzeta;265;146;119
31;Navarra;196;Orbara;67;34;33
31;Navarra;906;Orcoyen;"";"";""
31;Navarra;197;Orísoain;105;56;49
31;Navarra;198;Oronz;69;39;30
31;Navarra;199;Oroz-Betelu;278;146;132
31;Navarra;211;Orreaga/Roncesvalles;31;17;14
31;Navarra;200;Oteiza;967;492;475
31;Navarra;201;Pamplona/Iruña;180598;87233;93365
31;Navarra;202;Peralta;4551;2231;2320
31;Navarra;203;Petilla de Aragón;68;34;34
31;Navarra;204;Piedramillera;110;57;53
31;Navarra;205;Pitillas;676;336;340
31;Navarra;206;Puente la Reina/Gares;2129;1068;1061
31;Navarra;207;Pueyo;328;168;160
31;Navarra;208;Ribaforada;3116;1590;1526
31;Navarra;209;Romanzado;159;93;66
31;Navarra;210;Roncal/Erronkari;416;213;203
31;Navarra;212;Sada;299;158;141
31;Navarra;213;Saldías;182;95;87
31;Navarra;214;Salinas de Oro;111;59;52
31;Navarra;215;San Adrián;4855;2384;2471
31;Navarra;217;San Martín de Unx;619;323;296
31;Navarra;216;Sangüesa/Zangoza;4603;2342;2261
31;Navarra;219;Sansol;168;84;84
31;Navarra;220;Santacara;1150;577;573
31;Navarra;222;Sarriés/Sartze;106;60;46
31;Navarra;223;Sartaguda;1441;724;717
31;Navarra;224;Sesma;1625;817;808
31;Navarra;225;Sorlada;80;41;39
31;Navarra;226;Sunbilla;753;396;357
31;Navarra;227;Tafalla;10266;5054;5212
31;Navarra;228;Tiebas-Muruarte de Reta;609;317;292
31;Navarra;229;Tirapu;68;37;31
31;Navarra;230;Torralba del Río;187;102;85
31;Navarra;231;Torres del Río;243;117;126
31;Navarra;232;Tudela;26618;12969;13649
31;Navarra;233;Tulebras;102;30;72
31;Navarra;234;Ucar;116;61;55
31;Navarra;123;Uharte-Arakil;879;462;417
31;Navarra;235;Ujué;329;172;157
31;Navarra;236;Ultzama;1621;847;774
31;Navarra;237;Unciti;219;122;97
31;Navarra;238;Unzué;129;65;64
31;Navarra;239;Urdazubi/Urdax;499;254;245
31;Navarra;240;Urdiain;718;378;340
31;Navarra;241;Urraul Alto;155;87;68
31;Navarra;242;Urraul Bajo;289;129;160
31;Navarra;244;Urrotz;238;139;99
31;Navarra;243;Urroz;371;189;182
31;Navarra;245;Urzainqui;124;65;59
31;Navarra;246;Uterga;137;67;70
31;Navarra;247;Uztárroz/Uztarroze;332;165;167
31;Navarra;249;Valtierra;2542;1266;1276
31;Navarra;251;Viana;3452;1768;1684
31;Navarra;252;Vidángoz/Bidankoze;115;56;59
31;Navarra;254;Villafranca;2647;1279;1368
31;Navarra;255;Villamayor de Monjardín;111;66;45
31;Navarra;257;Villatuerta;799;410;389
31;Navarra;258;Villava/Atarrabia;7209;3630;3579
31;Navarra;260;Yerri;1603;840;763
31;Navarra;261;Yesa;312;180;132
31;Navarra;262;Zabalza;148;66;82
31;Navarra;073;Ziordia;392;186;206
31;Navarra;907;Zizur Mayor/Zizur Nagusia;"";"";""
31;Navarra;263;Zubieta;350;205;145
31;Navarra;264;Zugarramurdi;283;151;132
31;Navarra;265;Zúñiga;139;79;60
32;Ourense;001;Allariz;6153;2979;3174
32;Ourense;002;Amoeiro;2674;1288;1386
32;Ourense;003;Arnoia (A);1296;620;676
32;Ourense;004;Avión;4549;2164;2385
32;Ourense;005;Baltar;3060;1525;1535
32;Ourense;006;Bande;4225;2042;2183
32;Ourense;007;Baños de Molgas;4404;2222;2182
32;Ourense;008;Barbadás;4211;2011;2200
32;Ourense;009;Barco de Valdeorras (O);10602;5235;5367
32;Ourense;010;Beade;1226;604;622
32;Ourense;011;Beariz;1986;875;1111
32;Ourense;012;Blancos (Os);2210;1133;1077
32;Ourense;013;Boborás;5164;2444;2720
32;Ourense;014;Bola (A);2296;1115;1181
32;Ourense;015;Bolo (O);3038;1515;1523
32;Ourense;016;Calvos de Randín;2202;1099;1103
32;Ourense;018;Carballeda de Avia;2467;1198;1269
32;Ourense;017;Carballeda de Valdeorras;3354;1729;1625
32;Ourense;019;Carballiño (O);12034;5770;6264
32;Ourense;020;Cartelle;5680;2805;2875
32;Ourense;022;Castrelo de Miño;5298;2662;2636
32;Ourense;021;Castrelo do Val;2036;1028;1008
32;Ourense;023;Castro Caldelas;3177;1585;1592
32;Ourense;024;Celanova;7366;3544;3822
32;Ourense;025;Cenlle;2283;1065;1218
32;Ourense;029;Chandrexa de Queixa;1280;682;598
32;Ourense;026;Coles;3516;1738;1778
32;Ourense;027;Cortegada;2167;1050;1117
32;Ourense;028;Cualedro;5857;2998;2859
32;Ourense;030;Entrimo;2618;1231;1387
32;Ourense;031;Esgos;2656;1302;1354
32;Ourense;033;Gomesende;2230;1070;1160
32;Ourense;034;Gudiña (A);2594;1319;1275
32;Ourense;035;Irixo (O);3876;1904;1972
32;Ourense;038;Larouco;882;420;462
32;Ourense;039;Laza;2813;1390;1423
32;Ourense;040;Leiro;2539;1211;1328
32;Ourense;041;Lobeira;3055;1467;1588
32;Ourense;042;Lobios;5006;2424;2582
32;Ourense;043;Maceda;4898;2372;2526
32;Ourense;044;Manzaneda;1893;954;939
32;Ourense;045;Maside;5025;2422;2603
32;Ourense;046;Melón;2203;991;1212
32;Ourense;047;Merca (A);4200;2064;2136
32;Ourense;048;Mezquita (A);2011;1022;989
32;Ourense;049;Montederramo;1793;911;882
32;Ourense;050;Monterrei;4948;2484;2464
32;Ourense;051;Muíños;4156;2031;2125
32;Ourense;052;Nogueira de Ramuín;3491;1671;1820
32;Ourense;053;Oímbra;2131;1085;1046
32;Ourense;054;Ourense;106042;50060;55982
32;Ourense;055;Paderne de Allariz;2243;1057;1186
32;Ourense;056;Padrenda;4976;2440;2536
32;Ourense;057;Parada de Sil;2064;995;1069
32;Ourense;058;Pereiro de Aguiar (O);6356;3091;3265
32;Ourense;059;Peroxa (A);3509;1673;1836
32;Ourense;060;Petín;1511;754;757
32;Ourense;061;Piñor;2199;1094;1105
32;Ourense;063;Pobra de Trives (A);4089;2035;2054
32;Ourense;064;Pontedeva;929;441;488
32;Ourense;062;Porqueira;1966;980;986
32;Ourense;065;Punxín;1252;592;660
32;Ourense;066;Quintela de Leirado;1439;697;742
32;Ourense;067;Rairiz de Veiga;4315;2147;2168
32;Ourense;068;Ramirás;3418;1668;1750
32;Ourense;069;Ribadavia;6883;3326;3557
32;Ourense;071;Riós;5048;2524;2524
32;Ourense;072;Rúa (A);5299;2632;2667
32;Ourense;073;Rubiá;2994;1500;1494
32;Ourense;074;San Amaro;2607;1289;1318
32;Ourense;075;San Cibrao das Viñas;3657;1755;1902
32;Ourense;076;San Cristovo de Cea;5130;2504;2626
32;Ourense;070;San Xoán de Río;1700;845;855
32;Ourense;077;Sandiás;2604;1260;1344
32;Ourense;078;Sarreaus;4061;2033;2028
32;Ourense;079;Taboadela;3160;1531;1629
32;Ourense;080;Teixeira (A);1981;996;985
32;Ourense;081;Toén;3422;1695;1727
32;Ourense;082;Trasmiras;4082;2085;1997
32;Ourense;083;Veiga (A);3205;1582;1623
32;Ourense;084;Verea;2873;1405;1468
32;Ourense;085;Verín;11369;5525;5844
32;Ourense;086;Viana do Bolo;6140;3109;3031
32;Ourense;087;Vilamarín;2373;1149;1224
32;Ourense;088;Vilamartín de Valdeorras;3086;1579;1507
32;Ourense;089;Vilar de Barrio;4314;2203;2111
32;Ourense;090;Vilar de Santos;1890;958;932
32;Ourense;091;Vilardevós;4103;2140;1963
32;Ourense;092;Vilariño de Conso;1235;671;564
32;Ourense;032;Xinzo de Limia;10621;5250;5371
32;Ourense;036;Xunqueira de Ambía;3379;1674;1705
32;Ourense;037;Xunqueira de Espadanedo;1470;719;751
33;Asturias;001;Allande;3241;1681;1560
33;Asturias;002;Aller;20007;9970;10037
33;Asturias;003;Amieva;1120;581;539
33;Asturias;004;Avilés;87811;42958;44853
33;Asturias;005;Belmonte de Miranda;3442;1783;1659
33;Asturias;006;Bimenes;2725;1279;1446
33;Asturias;007;Boal;3356;1687;1669
33;Asturias;008;Cabrales;2615;1315;1300
33;Asturias;009;Cabranes;1616;766;850
33;Asturias;010;Candamo;3201;1557;1644
33;Asturias;012;Cangas de Onís;6412;3235;3177
33;Asturias;011;Cangas del Narcea;20338;10533;9805
33;Asturias;013;Caravia;645;328;317
33;Asturias;014;Carreño;11497;5640;5857
33;Asturias;015;Caso;2288;1166;1122
33;Asturias;016;Castrillón;22356;10943;11413
33;Asturias;017;Castropol;5106;2464;2642
33;Asturias;018;Coaña;4225;2040;2185
33;Asturias;019;Colunga;5176;2511;2665
33;Asturias;020;Corvera de Asturias;18161;9117;9044
33;Asturias;021;Cudillero;7155;3574;3581
33;Asturias;022;Degaña;1848;990;858
33;Asturias;023;Franco (El);4361;2125;2236
33;Asturias;024;Gijón;262156;125369;136787
33;Asturias;025;Gozón;12313;6030;6283
33;Asturias;026;Grado;12658;6186;6472
33;Asturias;027;Grandas de Salime;1634;859;775
33;Asturias;028;Ibias;2868;1525;1343
33;Asturias;029;Illano;894;463;431
33;Asturias;030;Illas;1437;749;688
33;Asturias;031;Langreo;53939;26056;27883
33;Asturias;032;Laviana;15613;7736;7877
33;Asturias;033;Lena;14905;7354;7551
33;Asturias;035;Llanera;10439;5158;5281
33;Asturias;036;Llanes;13788;6573;7215
33;Asturias;037;Mieres;57758;28129;29629
33;Asturias;038;Morcín;3320;1648;1672
33;Asturias;039;Muros de Nalón;2839;1334;1505
33;Asturias;040;Nava;5811;2840;2971
33;Asturias;041;Navia;9089;4408;4681
33;Asturias;042;Noreña;4178;1971;2207
33;Asturias;043;Onís;1355;699;656
33;Asturias;044;Oviedo;190073;89814;100259
33;Asturias;045;Parres;6008;2942;3066
33;Asturias;046;Peñamellera Alta;994;499;495
33;Asturias;047;Peñamellera Baja;1941;958;983
33;Asturias;048;Pesoz;366;182;184
33;Asturias;049;Piloña;10225;4957;5268
33;Asturias;050;Ponga;989;548;441
33;Asturias;051;Pravia;10261;4944;5317
33;Asturias;052;Proaza;1108;539;569
33;Asturias;053;Quirós;1872;951;921
33;Asturias;054;Regueras (Las);2588;1291;1297
33;Asturias;055;Ribadedeva;2364;1126;1238
33;Asturias;056;Ribadesella;6505;3108;3397
33;Asturias;057;Ribera de Arriba;2275;1132;1143
33;Asturias;058;Riosa;2986;1557;1429
33;Asturias;059;Salas;8767;4348;4419
33;Asturias;061;San Martín de Oscos;701;365;336
33;Asturias;060;San Martín del Rey Aurelio;25319;12384;12935
33;Asturias;063;San Tirso de Abres;792;401;391
33;Asturias;062;Santa Eulalia de Oscos;759;402;357
33;Asturias;064;Santo Adriano;411;198;213
33;Asturias;065;Sariego;1689;825;864
33;Asturias;066;Siero;42578;20614;21964
33;Asturias;067;Sobrescobio;860;431;429
33;Asturias;068;Somiedo;1997;1020;977
33;Asturias;069;Soto del Barco;5002;2391;2611
33;Asturias;070;Tapia de Casariego;4632;2237;2395
33;Asturias;071;Taramundi;1142;559;583
33;Asturias;072;Teverga;3024;1527;1497
33;Asturias;073;Tineo;17381;8797;8584
33;Asturias;034;Valdés;18155;8923;9232
33;Asturias;074;Vegadeo;5178;2485;2693
33;Asturias;075;Villanueva de Oscos;541;278;263
33;Asturias;076;Villaviciosa;15498;7618;7880
33;Asturias;077;Villayón;2395;1228;1167
33;Asturias;078;Yernes y Tameza;229;111;118
34;Palencia;001;Abarca de Campos;54;29;25
34;Palencia;003;Abia de las Torres;252;128;124
34;Palencia;004;Aguilar de Campoo;7430;3654;3776
34;Palencia;005;Alar del Rey;1685;818;867
34;Palencia;006;Alba de Cerrato;155;79;76
34;Palencia;009;Amayuelas de Arriba;78;43;35
34;Palencia;010;Ampudia;876;441;435
34;Palencia;011;Amusco;737;395;342
34;Palencia;012;Antigüedad;492;265;227
34;Palencia;015;Arconada;113;59;54
34;Palencia;017;Astudillo;1559;814;745
34;Palencia;018;Autilla del Pino;352;181;171
34;Palencia;019;Autillo de Campos;232;108;124
34;Palencia;020;Ayuela;132;74;58
34;Palencia;022;Baltanás;1714;892;822
34;Palencia;024;Baquerín de Campos;44;28;16
34;Palencia;025;Bárcena de Campos;78;33;45
34;Palencia;027;Barruelo de Santullán;2440;1171;1269
34;Palencia;028;Báscones de Ojeda;262;132;130
34;Palencia;029;Becerril de Campos;1319;646;673
34;Palencia;031;Belmonte de Campos;65;29;36
34;Palencia;032;Berzosilla;103;51;52
34;Palencia;033;Boada de Campos;31;16;15
34;Palencia;035;Boadilla de Rioseco;237;116;121
34;Palencia;034;Boadilla del Camino;256;130;126
34;Palencia;036;Brañosera;358;184;174
34;Palencia;037;Buenavista de Valdavia;551;267;284
34;Palencia;038;Bustillo de la Vega;451;243;208
34;Palencia;039;Bustillo del Páramo de Carrión;129;66;63
34;Palencia;041;Calahorra de Boedo;178;86;92
34;Palencia;042;Calzada de los Molinos;448;242;206
34;Palencia;045;Capillas;164;79;85
34;Palencia;046;Cardeñosa de Volpejera;74;34;40
34;Palencia;047;Carrión de los Condes;2627;1253;1374
34;Palencia;048;Castil de Vela;141;68;73
34;Palencia;049;Castrejón de la Peña;844;452;392
34;Palencia;050;Castrillo de Don Juan;487;262;225
34;Palencia;051;Castrillo de Onielo;225;112;113
34;Palencia;052;Castrillo de Villavega;390;195;195
34;Palencia;053;Castromocho;325;167;158
34;Palencia;055;Cervatos de la Cueza;454;225;229
34;Palencia;056;Cervera de Pisuerga;3123;1580;1543
34;Palencia;057;Cevico de la Torre;808;404;404
34;Palencia;058;Cevico Navero;387;200;187
34;Palencia;059;Cisneros;705;355;350
34;Palencia;060;Cobos de Cerrato;284;144;140
34;Palencia;061;Collazos de Boedo;191;107;84
34;Palencia;062;Congosto de Valdavia;354;183;171
34;Palencia;063;Cordovilla la Real;192;106;86
34;Palencia;066;Cubillas de Cerrato;156;79;77
34;Palencia;067;Dehesa de Montejo;391;217;174
34;Palencia;068;Dehesa de Romanos;83;44;39
34;Palencia;069;Dueñas;3140;1617;1523
34;Palencia;070;Espinosa de Cerrato;371;189;182
34;Palencia;071;Espinosa de Villagonzalo;353;172;181
34;Palencia;072;Frechilla;330;156;174
34;Palencia;073;Fresno del Río;239;120;119
34;Palencia;074;Frómista;1139;584;555
34;Palencia;076;Fuentes de Nava;1010;487;523
34;Palencia;077;Fuentes de Valdepero;253;133;120
34;Palencia;079;Grijota;811;406;405
34;Palencia;080;Guardo;9763;5000;4763
34;Palencia;081;Guaza de Campos;114;58;56
34;Palencia;082;Hérmedes de Cerrato;196;97;99
34;Palencia;083;Herrera de Pisuerga;2987;1517;1470
34;Palencia;084;Herrera de Valdecañas;219;111;108
34;Palencia;086;Hontoria de Cerrato;133;67;66
34;Palencia;087;Hornillos de Cerrato;200;94;106
34;Palencia;088;Husillos;222;120;102
34;Palencia;089;Itero de la Vega;307;170;137
34;Palencia;091;Lagartos;235;129;106
34;Palencia;092;Lantadilla;656;325;331
34;Palencia;094;Ledigos;144;74;70
34;Palencia;903;Loma de Ucieza;470;248;222
34;Palencia;096;Lomas;87;43;44
34;Palencia;098;Magaz de Pisuerga;582;305;277
34;Palencia;099;Manquillos;104;56;48
34;Palencia;100;Mantinos;260;138;122
34;Palencia;101;Marcilla de Campos;120;53;67
34;Palencia;102;Mazariegos;294;156;138
34;Palencia;103;Mazuecos de Valdeginate;169;79;90
34;Palencia;104;Melgar de Yuso;510;266;244
34;Palencia;106;Meneses de Campos;207;112;95
34;Palencia;107;Micieces de Ojeda;152;77;75
34;Palencia;108;Monzón de Campos;989;509;480
34;Palencia;109;Moratinos;121;60;61
34;Palencia;110;Mudá;213;105;108
34;Palencia;112;Nogal de las Huertas;116;61;55
34;Palencia;113;Olea de Boedo;55;25;30
34;Palencia;114;Olmos de Ojeda;513;278;235
34;Palencia;116;Osornillo;129;65;64
34;Palencia;901;Osorno la Mayor;2014;1032;982
34;Palencia;120;Palencia;76692;36983;39709
34;Palencia;121;Palenzuela;422;230;192
34;Palencia;122;Páramo de Boedo;139;71;68
34;Palencia;123;Paredes de Nava;2783;1385;1398
34;Palencia;124;Payo de Ojeda;117;65;52
34;Palencia;125;Pedraza de Campos;188;98;90
34;Palencia;126;Pedrosa de la Vega;433;229;204
34;Palencia;127;Perales;185;96;89
34;Palencia;904;Pernía (La);602;317;285
34;Palencia;129;Pino del Río;325;182;143
34;Palencia;130;Piña de Campos;417;227;190
34;Palencia;131;Población de Arroyo;119;65;54
34;Palencia;132;Población de Campos;268;142;126
34;Palencia;133;Población de Cerrato;161;84;77
34;Palencia;134;Polentinos;163;76;87
34;Palencia;135;Pomar de Valdivia;741;369;372
34;Palencia;136;Poza de la Vega;328;184;144
34;Palencia;137;Pozo de Urama;57;30;27
34;Palencia;139;Prádanos de Ojeda;278;140;138
34;Palencia;140;Puebla de Valdavia (La);240;115;125
34;Palencia;141;Quintana del Puente;422;205;217
34;Palencia;143;Quintanilla de Onsoña;327;181;146
34;Palencia;146;Reinoso de Cerrato;101;49;52
34;Palencia;147;Renedo de la Vega;341;176;165
34;Palencia;149;Requena de Campos;70;36;34
34;Palencia;151;Respenda de la Peña;402;217;185
34;Palencia;152;Revenga de Campos;232;110;122
34;Palencia;154;Revilla de Collazos;121;66;55
34;Palencia;155;Ribas de Campos;279;146;133
34;Palencia;156;Riberos de la Cueza;116;61;55
34;Palencia;157;Saldaña;3042;1583;1459
34;Palencia;158;Salinas de Pisuerga;310;167;143
34;Palencia;159;San Cebrián de Campos;607;347;260
34;Palencia;160;San Cebrián de Mudá;295;149;146
34;Palencia;161;San Cristóbal de Boedo;69;36;33
34;Palencia;163;San Mamés de Campos;162;76;86
34;Palencia;165;San Román de la Cuba;160;84;76
34;Palencia;167;Santa Cecilia del Alcor;190;104;86
34;Palencia;168;Santa Cruz de Boedo;96;48;48
34;Palencia;169;Santervás de la Vega;680;375;305
34;Palencia;170;Santibáñez de Ecla;136;52;84
34;Palencia;171;Santibáñez de la Peña;2180;1079;1101
34;Palencia;174;Santoyo;359;173;186
34;Palencia;175;Serna (La);146;80;66
34;Palencia;177;Soto de Cerrato;286;139;147
34;Palencia;176;Sotobañado y Priorato;244;126;118
34;Palencia;178;Tabanera de Cerrato;227;108;119
34;Palencia;179;Tabanera de Valdavia;75;41;34
34;Palencia;180;Támara de Campos;113;59;54
34;Palencia;181;Tariego de Cerrato;577;296;281
34;Palencia;182;Torquemada;1382;703;679
34;Palencia;184;Torremormojón;102;46;56
34;Palencia;185;Triollo;148;80;68
34;Palencia;186;Valbuena de Pisuerga;92;54;38
34;Palencia;189;Valdeolmillos;111;53;58
34;Palencia;190;Valderrábano;133;70;63
34;Palencia;192;Valde-Ucieza;185;109;76
34;Palencia;196;Valle de Cerrato;176;94;82
34;Palencia;902;Valle del Retortillo;338;164;174
34;Palencia;199;Velilla del Río Carrión;2246;1148;1098
34;Palencia;023;Venta de Baños;7016;3471;3545
34;Palencia;201;Vertavillo;344;182;162
34;Palencia;093;Vid de Ojeda (La);194;105;89
34;Palencia;202;Villabasta de Valdavia;51;23;28
34;Palencia;204;Villacidaler;122;59;63
34;Palencia;205;Villaconancio;117;60;57
34;Palencia;206;Villada;1507;732;775
34;Palencia;208;Villaeles de Valdavia;127;68;59
34;Palencia;210;Villahán;195;110;85
34;Palencia;211;Villaherreros;367;176;191
34;Palencia;213;Villalaco;94;43;51
34;Palencia;214;Villalba de Guardo;261;139;122
34;Palencia;215;Villalcázar de Sirga;278;127;151
34;Palencia;216;Villalcón;126;59;67
34;Palencia;217;Villalobón;255;134;121
34;Palencia;218;Villaluenga de la Vega;897;497;400
34;Palencia;220;Villamartín de Campos;188;91;97
34;Palencia;221;Villamediana;316;166;150
34;Palencia;222;Villameriel;212;105;107
34;Palencia;223;Villamoronta;368;189;179
34;Palencia;224;Villamuera de la Cueza;109;61;48
34;Palencia;225;Villamuriel de Cerrato;3683;1885;1798
34;Palencia;227;Villanueva del Rebollar;117;61;56
34;Palencia;228;Villanuño de Valdavia;163;92;71
34;Palencia;229;Villaprovedo;133;77;56
34;Palencia;230;Villarmentero de Campos;24;11;13
34;Palencia;231;Villarrabé;319;166;153
34;Palencia;232;Villarramiel;1269;640;629
34;Palencia;233;Villasarracino;412;204;208
34;Palencia;234;Villasila de Valdavia;141;79;62
34;Palencia;236;Villaturde;369;184;185
34;Palencia;237;Villaumbrales;995;517;478
34;Palencia;238;Villaviudas;555;283;272
34;Palencia;240;Villerías de Campos;153;85;68
34;Palencia;241;Villodre;61;34;27
34;Palencia;242;Villodrigo;158;82;76
34;Palencia;243;Villoldo;610;313;297
34;Palencia;245;Villota del Páramo;616;345;271
34;Palencia;246;Villovieco;166;87;79
35;Palmas (Las);001;Agaete;5320;2686;2634
35;Palmas (Las);002;Agüimes;15545;7902;7643
35;Palmas (Las);003;Antigua;2381;1286;1095
35;Palmas (Las);004;Arrecife;36297;18647;17650
35;Palmas (Las);005;Artenara;1123;592;531
35;Palmas (Las);006;Arucas;27631;14044;13587
35;Palmas (Las);007;Betancuria;588;308;280
35;Palmas (Las);008;Firgas;5712;2872;2840
35;Palmas (Las);009;Gáldar;21087;10677;10410
35;Palmas (Las);010;Haría;2936;1523;1413
35;Palmas (Las);011;Ingenio;21707;11006;10701
35;Palmas (Las);016;Las Palmas de Gran Canaria;366347;181320;185027
35;Palmas (Las);012;Mogán;9141;4832;4309
35;Palmas (Las);013;Moya;7941;4039;3902
35;Palmas (Las);014;Oliva (La);4908;2627;2281
35;Palmas (Las);015;Pájara;4611;2471;2140
35;Palmas (Las);017;Puerto del Rosario;15551;8504;7047
35;Palmas (Las);018;San Bartolomé;5776;3010;2766
35;Palmas (Las);019;San Bartolomé de Tirajana;29343;15389;13954
35;Palmas (Las);020;San Nicolás de Tolentino;7891;3963;3928
35;Palmas (Las);021;Santa Brígida;13499;6755;6744
35;Palmas (Las);022;Santa Lucía de Tirajana;32015;16345;15670
35;Palmas (Las);023;Santa María de Guía de Gran Canaria;12914;6536;6378
35;Palmas (Las);024;Teguise;7552;3946;3606
35;Palmas (Las);025;Tejeda;2189;1059;1130
35;Palmas (Las);026;Telde;76332;38436;37896
35;Palmas (Las);027;Teror;10870;5432;5438
35;Palmas (Las);028;Tías;7262;3943;3319
35;Palmas (Las);029;Tinajo;3317;1684;1633
35;Palmas (Las);030;Tuineje;6578;3463;3115
35;Palmas (Las);032;Valleseco;4213;2162;2051
35;Palmas (Las);031;Valsequillo de Gran Canaria;6127;3143;2984
35;Palmas (Las);033;Vega de San Mateo;7315;3754;3561
35;Palmas (Las);034;Yaiza;2363;1276;1087
36;Pontevedra;020;Agolada;5003;2448;2555
36;Pontevedra;001;Arbo;5182;2500;2682
36;Pontevedra;003;Baiona;10405;5095;5310
36;Pontevedra;002;Barro;3960;1882;2078
36;Pontevedra;004;Bueu;12468;6152;6316
36;Pontevedra;005;Caldas de Reis;9328;4479;4849
36;Pontevedra;006;Cambados;13274;6546;6728
36;Pontevedra;007;Campo Lameiro;2789;1306;1483
36;Pontevedra;008;Cangas;22737;11207;11530
36;Pontevedra;009;Cañiza (A);8565;4097;4468
36;Pontevedra;010;Catoira;3704;1829;1875
36;Pontevedra;011;Cerdedo;4490;2038;2452
36;Pontevedra;012;Cotobade;5993;2749;3244
36;Pontevedra;013;Covelo;5579;2572;3007
36;Pontevedra;014;Crecente;4236;2001;2235
36;Pontevedra;015;Cuntis;6675;3120;3555
36;Pontevedra;016;Dozón;2816;1417;1399
36;Pontevedra;017;Estrada (A);25785;12085;13700
36;Pontevedra;018;Forcarei;8037;3902;4135
36;Pontevedra;019;Fornelos de Montes;2623;1223;1400
36;Pontevedra;021;Gondomar;10421;5132;5289
36;Pontevedra;022;Grove (O);10810;5375;5435
36;Pontevedra;023;Guarda (A);10211;4939;5272
36;Pontevedra;901;Illa de Arousa (A);"";"";""
36;Pontevedra;024;Lalín;20420;10048;10372
36;Pontevedra;025;Lama (A);4393;1985;2408
36;Pontevedra;026;Marín;23962;11684;12278
36;Pontevedra;027;Meaño;5969;2912;3057
36;Pontevedra;028;Meis;5392;2569;2823
36;Pontevedra;029;Moaña;18215;8837;9378
36;Pontevedra;030;Mondariz;7232;3464;3768
36;Pontevedra;031;Mondariz-Balneario;625;293;332
36;Pontevedra;032;Moraña;5186;2469;2717
36;Pontevedra;033;Mos;13712;6697;7015
36;Pontevedra;034;Neves (As);6555;3115;3440
36;Pontevedra;035;Nigrán;14222;6987;7235
36;Pontevedra;036;Oia;3276;1622;1654
36;Pontevedra;037;Pazos de Borbén;3743;1737;2006
36;Pontevedra;041;Poio;12971;6354;6617
36;Pontevedra;043;Ponte Caldelas;8476;4008;4468
36;Pontevedra;042;Ponteareas;16958;8150;8808
36;Pontevedra;044;Pontecesures;2818;1363;1455
36;Pontevedra;038;Pontevedra;68233;32279;35954
36;Pontevedra;039;Porriño (O);15002;7285;7717
36;Pontevedra;040;Portas;3763;1792;1971
36;Pontevedra;045;Redondela;27710;13502;14208
36;Pontevedra;046;Ribadumia;4237;2041;2196
36;Pontevedra;047;Rodeiro;4831;2506;2325
36;Pontevedra;048;Rosal (O);6017;2966;3051
36;Pontevedra;049;Salceda de Caselas;5923;2891;3032
36;Pontevedra;050;Salvaterra de Miño;9566;4558;5008
36;Pontevedra;051;Sanxenxo;15491;7586;7905
36;Pontevedra;052;Silleda;10489;5007;5482
36;Pontevedra;053;Soutomaior;5314;2528;2786
36;Pontevedra;054;Tomiño;11080;5445;5635
36;Pontevedra;055;Tui;16319;7823;8496
36;Pontevedra;056;Valga;6580;3254;3326
36;Pontevedra;057;Vigo;271128;130026;141102
36;Pontevedra;059;Vila de Cruces;8467;4128;4339
36;Pontevedra;058;Vilaboa;6178;3010;3168
36;Pontevedra;060;Vilagarcía de Arousa;32495;15821;16674
36;Pontevedra;061;Vilanova de Arousa;15885;7791;8094
37;Salamanca;001;Abusejo;370;194;176
37;Salamanca;002;Agallas;330;175;155
37;Salamanca;003;Ahigal de los Aceiteros;255;128;127
37;Salamanca;004;Ahigal de Villarino;59;34;25
37;Salamanca;005;Alameda de Gardón (La);258;124;134
37;Salamanca;006;Alamedilla (La);306;150;156
37;Salamanca;007;Alaraz;768;405;363
37;Salamanca;008;Alba de Tormes;4207;2116;2091
37;Salamanca;009;Alba de Yeltes;401;204;197
37;Salamanca;010;Alberca (La);1128;582;546
37;Salamanca;011;Alberguería de Argañán (La);333;167;166
37;Salamanca;012;Alconada;281;148;133
37;Salamanca;015;Aldea del Obispo;509;259;250
37;Salamanca;013;Aldeacipreste;400;216;184
37;Salamanca;014;Aldeadávila de la Ribera;1897;996;901
37;Salamanca;016;Aldealengua;404;201;203
37;Salamanca;017;Aldeanueva de Figueroa;460;233;227
37;Salamanca;018;Aldeanueva de la Sierra;122;70;52
37;Salamanca;019;Aldearrodrigo;246;129;117
37;Salamanca;020;Aldearrubia;535;273;262
37;Salamanca;021;Aldeaseca de Alba;195;98;97
37;Salamanca;022;Aldeaseca de la Frontera;444;229;215
37;Salamanca;023;Aldeatejada;583;285;298
37;Salamanca;024;Aldeavieja de Tormes;168;89;79
37;Salamanca;025;Aldehuela de la Bóveda;448;225;223
37;Salamanca;026;Aldehuela de Yeltes;429;212;217
37;Salamanca;027;Almenara de Tormes;260;126;134
37;Salamanca;028;Almendra;262;136;126
37;Salamanca;029;Anaya de Alba;432;221;211
37;Salamanca;030;Añover de Tormes;134;64;70
37;Salamanca;031;Arabayona de Mógica;655;347;308
37;Salamanca;032;Arapiles;477;244;233
37;Salamanca;033;Arcediano;137;69;68
37;Salamanca;034;Arco (El);109;60;49
37;Salamanca;035;Armenteros;420;194;226
37;Salamanca;037;Atalaya (La);230;124;106
37;Salamanca;038;Babilafuente;1036;535;501
37;Salamanca;039;Bañobárez;615;323;292
37;Salamanca;040;Barbadillo;652;313;339
37;Salamanca;041;Barbalos;170;81;89
37;Salamanca;042;Barceo;117;62;55
37;Salamanca;044;Barruecopardo;758;382;376
37;Salamanca;045;Bastida (La);55;26;29
37;Salamanca;046;Béjar;17597;8437;9160
37;Salamanca;047;Beleña;118;53;65
37;Salamanca;049;Bermellar;260;131;129
37;Salamanca;050;Berrocal de Huebra;182;91;91
37;Salamanca;051;Berrocal de Salvatierra;188;94;94
37;Salamanca;052;Boada;492;244;248
37;Salamanca;054;Bodón (El);454;231;223
37;Salamanca;055;Bogajo;275;138;137
37;Salamanca;056;Bouza (La);72;38;34
37;Salamanca;057;Bóveda del Río Almar;364;185;179
37;Salamanca;058;Brincones;159;76;83
37;Salamanca;059;Buenamadre;233;114;119
37;Salamanca;060;Buenavista;130;68;62
37;Salamanca;061;Cabaco (El);356;182;174
37;Salamanca;063;Cabeza de Béjar (La);161;78;83
37;Salamanca;065;Cabeza del Caballo;621;325;296
37;Salamanca;062;Cabezabellosa de la Calzada;176;100;76
37;Salamanca;067;Cabrerizos;720;354;366
37;Salamanca;068;Cabrillas;687;322;365
37;Salamanca;069;Calvarrasa de Abajo;1094;545;549
37;Salamanca;070;Calvarrasa de Arriba;629;334;295
37;Salamanca;071;Calzada de Béjar (La);140;72;68
37;Salamanca;072;Calzada de Don Diego;334;166;168
37;Salamanca;073;Calzada de Valdunciel;741;360;381
37;Salamanca;074;Campillo de Azaba;407;198;209
37;Salamanca;077;Campo de Peñaranda (El);493;254;239
37;Salamanca;078;Candelario;1278;608;670
37;Salamanca;079;Canillas de Abajo;183;99;84
37;Salamanca;080;Cantagallo;323;160;163
37;Salamanca;081;Cantalapiedra;1714;856;858
37;Salamanca;082;Cantalpino;1410;735;675
37;Salamanca;083;Cantaracillo;322;159;163
37;Salamanca;085;Carbajosa de la Sagrada;546;271;275
37;Salamanca;086;Carpio de Azaba;125;67;58
37;Salamanca;087;Carrascal de Barregas;329;174;155
37;Salamanca;088;Carrascal del Obispo;327;158;169
37;Salamanca;089;Casafranca;100;45;55
37;Salamanca;090;Casas del Conde (Las);159;71;88
37;Salamanca;091;Casillas de Flores;356;170;186
37;Salamanca;092;Castellanos de Moriscos;343;154;189
37;Salamanca;185;Castellanos de Villiquera;488;244;244
37;Salamanca;096;Castillejo de Martín Viejo;427;221;206
37;Salamanca;097;Castraz;120;63;57
37;Salamanca;098;Cepeda;641;313;328
37;Salamanca;099;Cereceda de la Sierra;142;78;64
37;Salamanca;100;Cerezal de Peñahorcada;195;97;98
37;Salamanca;101;Cerralbo;352;194;158
37;Salamanca;102;Cerro (El);688;341;347
37;Salamanca;103;Cespedosa de Tormes;787;427;360
37;Salamanca;114;Chagarcía Medianero;205;107;98
37;Salamanca;104;Cilleros de la Bastida;70;30;40
37;Salamanca;106;Cipérez;627;318;309
37;Salamanca;107;Ciudad Rodrigo;15895;7651;8244
37;Salamanca;108;Coca de Alba;221;107;114
37;Salamanca;109;Colmenar de Montemayor;403;202;201
37;Salamanca;110;Cordovilla;164;86;78
37;Salamanca;112;Cristóbal;276;144;132
37;Salamanca;113;Cubo de Don Sancho (El);727;380;347
37;Salamanca;115;Dios le Guarde;207;107;100
37;Salamanca;116;Doñinos de Ledesma;128;61;67
37;Salamanca;117;Doñinos de Salamanca;647;326;321
37;Salamanca;118;Ejeme;289;156;133
37;Salamanca;120;Encina de San Silvestre;138;66;72
37;Salamanca;119;Encina (La);336;178;158
37;Salamanca;121;Encinas de Abajo;780;415;365
37;Salamanca;122;Encinas de Arriba;302;157;145
37;Salamanca;123;Encinasola de los Comendadores;406;209;197
37;Salamanca;124;Endrinal;371;197;174
37;Salamanca;125;Escurial de la Sierra;361;170;191
37;Salamanca;126;Espadaña;73;37;36
37;Salamanca;127;Espeja;406;205;201
37;Salamanca;128;Espino de la Orbada;458;236;222
37;Salamanca;129;Florida de Liébana;256;142;114
37;Salamanca;130;Forfoleda;279;130;149
37;Salamanca;131;Frades de la Sierra;348;182;166
37;Salamanca;132;Fregeneda (La);709;341;368
37;Salamanca;133;Fresnedoso;202;102;100
37;Salamanca;134;Fresno Alhándiga;421;221;200
37;Salamanca;135;Fuente de San Esteban (La);1897;953;944
37;Salamanca;136;Fuenteguinaldo;1221;606;615
37;Salamanca;137;Fuenteliante;171;88;83
37;Salamanca;138;Fuenterroble de Salvatierra;313;160;153
37;Salamanca;139;Fuentes de Béjar;327;135;192
37;Salamanca;140;Fuentes de Oñoro;1584;785;799
37;Salamanca;141;Gajates;309;160;149
37;Salamanca;142;Galindo y Perahuy;176;89;87
37;Salamanca;143;Galinduste;724;377;347
37;Salamanca;144;Galisancho;819;422;397
37;Salamanca;145;Gallegos de Argañán;640;327;313
37;Salamanca;146;Gallegos de Solmirón;374;180;194
37;Salamanca;147;Garcibuey;372;205;167
37;Salamanca;148;Garcihernández;718;381;337
37;Salamanca;149;Garcirrey;134;67;67
37;Salamanca;150;Gejuelo del Barro;59;31;28
37;Salamanca;151;Golpejas;262;139;123
37;Salamanca;152;Gomecello;684;335;349
37;Salamanca;154;Guadramiro;291;164;127
37;Salamanca;155;Guijo de Ávila;122;68;54
37;Salamanca;156;Guijuelo;4630;2310;2320
37;Salamanca;157;Herguijuela de Ciudad Rodrigo;221;108;113
37;Salamanca;158;Herguijuela de la Sierra;485;236;249
37;Salamanca;159;Herguijuela del Campo;189;100;89
37;Salamanca;160;Hinojosa de Duero;1010;486;524
37;Salamanca;161;Horcajo de Montemayor;232;120;112
37;Salamanca;162;Horcajo Medianero;555;287;268
37;Salamanca;163;Hoya (La);38;23;15
37;Salamanca;164;Huerta;308;165;143
37;Salamanca;165;Iruelos;86;43;43
37;Salamanca;166;Ituero de Azaba;438;222;216
37;Salamanca;167;Juzbado;267;137;130
37;Salamanca;168;Lagunilla;894;475;419
37;Salamanca;169;Larrodrigo;376;189;187
37;Salamanca;170;Ledesma;2100;1031;1069
37;Salamanca;171;Ledrada;663;322;341
37;Salamanca;172;Linares de Riofrío;1228;612;616
37;Salamanca;173;Lumbrales;2630;1292;1338
37;Salamanca;175;Machacón;608;317;291
37;Salamanca;174;Macotera;2075;1040;1035
37;Salamanca;176;Madroñal;174;90;84
37;Salamanca;177;Maíllo (El);509;254;255
37;Salamanca;178;Malpartida;248;131;117
37;Salamanca;179;Mancera de Abajo;467;238;229
37;Salamanca;180;Manzano (El);131;76;55
37;Salamanca;181;Martiago;568;285;283
37;Salamanca;183;Martín de Yeltes;785;405;380
37;Salamanca;182;Martinamor;115;60;55
37;Salamanca;184;Masueco;599;302;297
37;Salamanca;186;Mata de Ledesma (La);207;95;112
37;Salamanca;187;Matilla de los Caños del Río;786;401;385
37;Salamanca;188;Maya (La);332;179;153
37;Salamanca;189;Membribe de la Sierra;128;69;59
37;Salamanca;190;Mieza;478;248;230
37;Salamanca;191;Milano (El);230;124;106
37;Salamanca;192;Miranda de Azán;129;62;67
37;Salamanca;193;Miranda del Castañar;836;429;407
37;Salamanca;194;Mogarraz;479;230;249
37;Salamanca;195;Molinillo;94;48;46
37;Salamanca;196;Monforte de la Sierra;166;85;81
37;Salamanca;197;Monleón;180;100;80
37;Salamanca;198;Monleras;323;168;155
37;Salamanca;199;Monsagro;295;166;129
37;Salamanca;200;Montejo;257;134;123
37;Salamanca;201;Montemayor del Río;499;255;244
37;Salamanca;202;Monterrubio de Armuña;107;56;51
37;Salamanca;203;Monterrubio de la Sierra;199;104;95
37;Salamanca;204;Morasverdes;532;278;254
37;Salamanca;205;Morille;212;109;103
37;Salamanca;206;Moríñigo;180;98;82
37;Salamanca;207;Moriscos;145;79;66
37;Salamanca;208;Moronta;184;90;94
37;Salamanca;209;Mozárbez;390;199;191
37;Salamanca;211;Narros de Matalayegua;414;220;194
37;Salamanca;213;Nava de Béjar;150;72;78
37;Salamanca;214;Nava de Francia;186;100;86
37;Salamanca;215;Nava de Sotrobal;291;151;140
37;Salamanca;212;Navacarros;100;52;48
37;Salamanca;216;Navales;434;242;192
37;Salamanca;217;Navalmoral de Béjar;104;53;51
37;Salamanca;218;Navamorales;264;139;125
37;Salamanca;219;Navarredonda de la Rinconada;422;211;211
37;Salamanca;221;Navasfrías;966;475;491
37;Salamanca;222;Negrilla de Palencia;139;69;70
37;Salamanca;223;Olmedo de Camaces;212;106;106
37;Salamanca;224;Orbada (La);343;169;174
37;Salamanca;225;Pajares de la Laguna;160;80;80
37;Salamanca;226;Palacios del Arzobispo;307;160;147
37;Salamanca;228;Palaciosrubios;715;377;338
37;Salamanca;229;Palencia de Negrilla;263;129;134
37;Salamanca;230;Parada de Arriba;262;136;126
37;Salamanca;231;Parada de Rubiales;431;218;213
37;Salamanca;232;Paradinas de San Juan;715;391;324
37;Salamanca;233;Pastores;106;56;50
37;Salamanca;234;Payo (El);727;355;372
37;Salamanca;235;Pedraza de Alba;316;174;142
37;Salamanca;236;Pedrosillo de Alba;366;186;180
37;Salamanca;237;Pedrosillo de los Aires;583;316;267
37;Salamanca;238;Pedrosillo el Ralo;164;82;82
37;Salamanca;239;Pedroso de la Armuña (El);424;200;224
37;Salamanca;240;Pelabravo;593;301;292
37;Salamanca;241;Pelarrodríguez;253;137;116
37;Salamanca;242;Pelayos;104;53;51
37;Salamanca;243;Peña (La);248;125;123
37;Salamanca;244;Peñacaballera;271;136;135
37;Salamanca;245;Peñaparda;608;284;324
37;Salamanca;246;Peñaranda de Bracamonte;6412;3160;3252
37;Salamanca;247;Peñarandilla;345;175;170
37;Salamanca;248;Peralejos de Abajo;280;128;152
37;Salamanca;249;Peralejos de Arriba;102;54;48
37;Salamanca;250;Pereña de la Ribera;580;302;278
37;Salamanca;251;Peromingo;153;72;81
37;Salamanca;252;Pinedas;304;154;150
37;Salamanca;253;Pino de Tormes (El);195;106;89
37;Salamanca;254;Pitiegua;341;178;163
37;Salamanca;255;Pizarral;120;56;64
37;Salamanca;256;Poveda de las Cintas;447;242;205
37;Salamanca;257;Pozos de Hinojo;139;71;68
37;Salamanca;258;Puebla de Azaba;476;246;230
37;Salamanca;259;Puebla de San Medel;77;40;37
37;Salamanca;260;Puebla de Yeltes;309;170;139
37;Salamanca;261;Puente del Congosto;474;235;239
37;Salamanca;262;Puertas;158;84;74
37;Salamanca;263;Puerto de Béjar;605;296;309
37;Salamanca;264;Puerto Seguro;140;75;65
37;Salamanca;265;Rágama;406;216;190
37;Salamanca;266;Redonda (La);134;64;70
37;Salamanca;267;Retortillo;348;176;172
37;Salamanca;268;Rinconada de la Sierra (La);227;108;119
37;Salamanca;269;Robleda;717;364;353
37;Salamanca;270;Robliza de Cojos;274;122;152
37;Salamanca;271;Rollán;635;331;304
37;Salamanca;272;Saelices el Chico;236;130;106
37;Salamanca;273;Sagrada (La);240;121;119
37;Salamanca;303;Sahugo (El);393;200;193
37;Salamanca;274;Salamanca;159342;75917;83425
37;Salamanca;275;Saldeana;275;145;130
37;Salamanca;276;Salmoral;521;265;256
37;Salamanca;277;Salvatierra de Tormes;95;44;51
37;Salamanca;278;San Cristóbal de la Cuesta;248;125;123
37;Salamanca;284;San Esteban de la Sierra;547;285;262
37;Salamanca;285;San Felices de los Gallegos;816;416;400
37;Salamanca;286;San Martín del Castañar;443;225;218
37;Salamanca;287;San Miguel de Valero;539;255;284
37;Salamanca;036;San Miguel del Robledo;141;72;69
37;Salamanca;288;San Morales;186;97;89
37;Salamanca;289;San Muñoz;440;230;210
37;Salamanca;291;San Pedro de Rozados;509;252;257
37;Salamanca;290;San Pedro del Valle;319;163;156
37;Salamanca;292;San Pelayo de Guareña;149;76;73
37;Salamanca;280;Sanchón de la Ribera;196;99;97
37;Salamanca;281;Sanchón de la Sagrada;70;34;36
37;Salamanca;282;Sanchotello;425;222;203
37;Salamanca;279;Sancti-Spíritus;1553;776;777
37;Salamanca;283;Sando;283;159;124
37;Salamanca;293;Santa María de Sando;259;145;114
37;Salamanca;294;Santa Marta de Tormes;4976;2479;2497
37;Salamanca;296;Santiago de la Puebla;885;467;418
37;Salamanca;297;Santibáñez de Béjar;835;397;438
37;Salamanca;298;Santibáñez de la Sierra;323;175;148
37;Salamanca;299;Santiz;337;178;159
37;Salamanca;300;Santos (Los);901;479;422
37;Salamanca;301;Sardón de los Frailes;113;65;48
37;Salamanca;302;Saucelle;645;342;303
37;Salamanca;304;Sepulcro-Hilario;360;179;181
37;Salamanca;305;Sequeros;310;146;164
37;Salamanca;306;Serradilla del Arroyo;591;294;297
37;Salamanca;307;Serradilla del Llano;422;222;200
37;Salamanca;309;Sierpe (La);64;31;33
37;Salamanca;310;Sieteiglesias de Tormes;226;123;103
37;Salamanca;311;Sobradillo;466;224;242
37;Salamanca;312;Sorihuela;541;267;274
37;Salamanca;313;Sotoserrano;866;459;407
37;Salamanca;314;Tabera de Abajo;164;84;80
37;Salamanca;315;Tala (La);228;119;109
37;Salamanca;316;Tamames;1208;606;602
37;Salamanca;317;Tarazona de Guareña;508;278;230
37;Salamanca;318;Tardáguila;314;172;142
37;Salamanca;319;Tejado (El);239;114;125
37;Salamanca;320;Tejeda y Segoyuela;190;92;98
37;Salamanca;321;Tenebrón;283;137;146
37;Salamanca;322;Terradillos;1160;579;581
37;Salamanca;323;Topas;839;444;395
37;Salamanca;324;Tordillos;729;363;366
37;Salamanca;325;Tornadizo (El);188;94;94
37;Salamanca;327;Torresmenudas;293;145;148
37;Salamanca;328;Trabanca;301;162;139
37;Salamanca;329;Tremedal de Tormes;81;42;39
37;Salamanca;330;Valdecarros;546;274;272
37;Salamanca;331;Valdefuentes de Sangusín;378;194;184
37;Salamanca;332;Valdehijaderos;157;89;68
37;Salamanca;333;Valdelacasa;372;193;179
37;Salamanca;334;Valdelageve;170;95;75
37;Salamanca;335;Valdelosa;573;284;289
37;Salamanca;336;Valdemierque;76;40;36
37;Salamanca;337;Valderrodrigo;241;120;121
37;Salamanca;338;Valdunciel;141;65;76
37;Salamanca;339;Valero;585;294;291
37;Salamanca;343;Vallejera de Riofrío;65;23;42
37;Salamanca;340;Valsalabroso;302;150;152
37;Salamanca;341;Valverde de Valdelacasa;97;49;48
37;Salamanca;342;Valverdón;277;151;126
37;Salamanca;344;Vecinos;338;170;168
37;Salamanca;345;Vega de Tirados;259;133;126
37;Salamanca;346;Veguillas (Las);382;181;201
37;Salamanca;347;Vellés (La);512;259;253
37;Salamanca;348;Ventosa del Río Almar;194;96;98
37;Salamanca;349;Vídola (La);270;138;132
37;Salamanca;351;Villaflores;604;303;301
37;Salamanca;352;Villagonzalo de Tormes;270;146;124
37;Salamanca;353;Villalba de los Llanos;238;124;114
37;Salamanca;354;Villamayor;1044;536;508
37;Salamanca;355;Villanueva del Conde;367;185;182
37;Salamanca;356;Villar de Argañán;175;92;83
37;Salamanca;357;Villar de Ciervo;538;280;258
37;Salamanca;358;Villar de Gallimazo;353;184;169
37;Salamanca;359;Villar de la Yegua;482;247;235
37;Salamanca;360;Villar de Peralonso;477;233;244
37;Salamanca;361;Villar de Samaniego;190;102;88
37;Salamanca;362;Villares de la Reina;985;492;493
37;Salamanca;363;Villares de Yeltes;214;112;102
37;Salamanca;364;Villarino de los Aires;1448;724;724
37;Salamanca;365;Villarmayor;263;134;129
37;Salamanca;366;Villarmuerto;105;54;51
37;Salamanca;367;Villasbuenas;421;207;214
37;Salamanca;368;Villasdardo;44;21;23
37;Salamanca;369;Villaseco de los Gamitos;246;126;120
37;Salamanca;370;Villaseco de los Reyes;517;263;254
37;Salamanca;371;Villasrubias;465;240;225
37;Salamanca;372;Villaverde de Guareña;246;126;120
37;Salamanca;373;Villavieja de Yeltes;1652;814;838
37;Salamanca;374;Villoria;1490;742;748
37;Salamanca;375;Villoruela;1100;536;564
37;Salamanca;350;Vilvestre;738;367;371
37;Salamanca;376;Vitigudino;3063;1497;1566
37;Salamanca;377;Yecla de Yeltes;482;241;241
37;Salamanca;378;Zamarra;230;114;116
37;Salamanca;379;Zamayón;219;124;95
37;Salamanca;380;Zarapicos;70;31;39
37;Salamanca;381;Zarza de Pumareda (La);272;149;123
37;Salamanca;382;Zorita de la Frontera;388;207;181
38;Santa Cruz de Tenerife;001;Adeje;8430;4288;4142
38;Santa Cruz de Tenerife;002;Agulo;1424;720;704
38;Santa Cruz de Tenerife;003;Alajeró;1148;603;545
38;Santa Cruz de Tenerife;004;Arafo;3921;1907;2014
38;Santa Cruz de Tenerife;005;Arico;4335;2265;2070
38;Santa Cruz de Tenerife;006;Arona;21663;11034;10629
38;Santa Cruz de Tenerife;007;Barlovento;2625;1316;1309
38;Santa Cruz de Tenerife;008;Breña Alta;5312;2658;2654
38;Santa Cruz de Tenerife;009;Breña Baja;3383;1678;1705
38;Santa Cruz de Tenerife;010;Buenavista del Norte;5436;2762;2674
38;Santa Cruz de Tenerife;011;Candelaria;8854;4423;4431
38;Santa Cruz de Tenerife;012;Fasnia;2265;1129;1136
38;Santa Cruz de Tenerife;013;Frontera;3752;1865;1887
38;Santa Cruz de Tenerife;014;Fuencaliente de la Palma;1812;907;905
38;Santa Cruz de Tenerife;015;Garachico;6207;3077;3130
38;Santa Cruz de Tenerife;016;Garafía;2057;1029;1028
38;Santa Cruz de Tenerife;017;Granadilla de Abona;15937;8087;7850
38;Santa Cruz de Tenerife;018;Guancha (La);5135;2563;2572
38;Santa Cruz de Tenerife;019;Guía de Isora;12079;5948;6131
38;Santa Cruz de Tenerife;020;Güímar;14621;7260;7361
38;Santa Cruz de Tenerife;021;Hermigua;2732;1355;1377
38;Santa Cruz de Tenerife;022;Icod de los Vinos;22011;10901;11110
38;Santa Cruz de Tenerife;024;Llanos de Aridane (Los);16429;8148;8281
38;Santa Cruz de Tenerife;025;Matanza de Acentejo (La);5801;2998;2803
38;Santa Cruz de Tenerife;026;Orotava (La);36015;17842;18173
38;Santa Cruz de Tenerife;027;Paso (El);6998;3442;3556
38;Santa Cruz de Tenerife;028;Puerto de la Cruz;26834;13183;13651
38;Santa Cruz de Tenerife;029;Puntagorda;1692;867;825
38;Santa Cruz de Tenerife;030;Puntallana;2282;1160;1122
38;Santa Cruz de Tenerife;031;Realejos (Los);28854;14218;14636
38;Santa Cruz de Tenerife;032;Rosario (El);6592;3312;3280
38;Santa Cruz de Tenerife;033;San Andrés y Sauces;5492;2729;2763
38;Santa Cruz de Tenerife;023;San Cristóbal de La Laguna;111533;55107;56426
38;Santa Cruz de Tenerife;034;San Juan de la Rambla;4729;2362;2367
38;Santa Cruz de Tenerife;035;San Miguel de Abona;4728;2407;2321
38;Santa Cruz de Tenerife;036;San Sebastián de la Gomera;5586;2812;2774
38;Santa Cruz de Tenerife;037;Santa Cruz de la Palma;17915;8627;9288
38;Santa Cruz de Tenerife;038;Santa Cruz de Tenerife;215228;104822;110406
38;Santa Cruz de Tenerife;039;Santa Úrsula;8479;4248;4231
38;Santa Cruz de Tenerife;040;Santiago del Teide;4496;2251;2245
38;Santa Cruz de Tenerife;041;Sauzal (El);6065;3037;3028
38;Santa Cruz de Tenerife;042;Silos (Los);5503;2692;2811
38;Santa Cruz de Tenerife;043;Tacoronte;17583;8786;8797
38;Santa Cruz de Tenerife;044;Tanque (El);2765;1378;1387
38;Santa Cruz de Tenerife;045;Tazacorte;7078;3571;3507
38;Santa Cruz de Tenerife;046;Tegueste;7324;3660;3664
38;Santa Cruz de Tenerife;047;Tijarafe;2734;1393;1341
38;Santa Cruz de Tenerife;049;Valle Gran Rey;3029;1563;1466
38;Santa Cruz de Tenerife;050;Vallehermoso;3390;1665;1725
38;Santa Cruz de Tenerife;048;Valverde;3646;1817;1829
38;Santa Cruz de Tenerife;051;Victoria de Acentejo (La);7462;3786;3676
38;Santa Cruz de Tenerife;052;Vilaflor;1521;772;749
38;Santa Cruz de Tenerife;053;Villa de Mazo;5076;2546;2530
39;Cantabria;001;Alfoz de Lloredo;2918;1505;1413
39;Cantabria;002;Ampuero;3355;1676;1679
39;Cantabria;003;Anievas;486;245;241
39;Cantabria;004;Arenas de Iguña;2450;1254;1196
39;Cantabria;005;Argoños;644;322;322
39;Cantabria;006;Arnuero;1828;919;909
39;Cantabria;007;Arredondo;805;419;386
39;Cantabria;008;Astillero (El);12479;6207;6272
39;Cantabria;009;Bárcena de Cicero;2347;1190;1157
39;Cantabria;010;Bárcena de Pie de Concha;954;457;497
39;Cantabria;011;Bareyo;1617;836;781
39;Cantabria;012;Cabezón de la Sal;6558;3246;3312
39;Cantabria;013;Cabezón de Liébana;929;484;445
39;Cantabria;014;Cabuérniga;1190;595;595
39;Cantabria;015;Camaleño;1352;697;655
39;Cantabria;016;Camargo;19587;9671;9916
39;Cantabria;027;Campoo de Enmedio;4194;2144;2050
39;Cantabria;017;Campoo de Yuso;928;468;460
39;Cantabria;018;Cartes;2161;1062;1099
39;Cantabria;019;Castañeda;1624;803;821
39;Cantabria;020;Castro-Urdiales;13330;6626;6704
39;Cantabria;021;Cieza;828;410;418
39;Cantabria;022;Cillorigo de Liébana;1286;684;602
39;Cantabria;023;Colindres;5409;2710;2699
39;Cantabria;024;Comillas;2511;1201;1310
39;Cantabria;025;Corrales de Buelna (Los);9743;4859;4884
39;Cantabria;026;Corvera de Toranzo;2282;1139;1143
39;Cantabria;028;Entrambasaguas;2656;1308;1348
39;Cantabria;029;Escalante;761;371;390
39;Cantabria;030;Guriezo;1875;948;927
39;Cantabria;031;Hazas de Cesto;1367;694;673
39;Cantabria;032;Hermandad de Campoo de Suso;1962;1028;934
39;Cantabria;033;Herrerías;933;494;439
39;Cantabria;034;Lamasón;496;266;230
39;Cantabria;035;Laredo;13200;6512;6688
39;Cantabria;036;Liendo;814;416;398
39;Cantabria;037;Liérganes;2404;1182;1222
39;Cantabria;038;Limpias;1203;604;599
39;Cantabria;039;Luena;1283;672;611
39;Cantabria;040;Marina de Cudeyo;4645;2309;2336
39;Cantabria;041;Mazcuerras;1845;949;896
39;Cantabria;042;Medio Cudeyo;5589;2735;2854
39;Cantabria;043;Meruelo;893;451;442
39;Cantabria;044;Miengo;3028;1510;1518
39;Cantabria;045;Miera;783;386;397
39;Cantabria;046;Molledo;2297;1126;1171
39;Cantabria;047;Noja;1543;784;759
39;Cantabria;048;Penagos;1861;927;934
39;Cantabria;049;Peñarrubia;393;192;201
39;Cantabria;050;Pesaguero;519;277;242
39;Cantabria;051;Pesquera;121;52;69
39;Cantabria;052;Piélagos;9192;4590;4602
39;Cantabria;053;Polaciones;403;227;176
39;Cantabria;054;Polanco;3758;1811;1947
39;Cantabria;055;Potes;1478;733;745
39;Cantabria;056;Puente Viesgo;2502;1255;1247
39;Cantabria;057;Ramales de la Victoria;2515;1261;1254
39;Cantabria;058;Rasines;1109;566;543
39;Cantabria;059;Reinosa;13063;6405;6658
39;Cantabria;060;Reocín;6456;3212;3244
39;Cantabria;061;Ribamontán al Mar;2758;1416;1342
39;Cantabria;062;Ribamontán al Monte;2181;1129;1052
39;Cantabria;063;Rionansa;1813;947;866
39;Cantabria;064;Riotuerto;1693;825;868
39;Cantabria;065;Rozas de Valdearroyo (Las);294;155;139
39;Cantabria;066;Ruente;1015;520;495
39;Cantabria;067;Ruesga;1443;724;719
39;Cantabria;068;Ruiloba;795;400;395
39;Cantabria;069;San Felices de Buelna;2408;1208;1200
39;Cantabria;070;San Miguel de Aguayo;195;107;88
39;Cantabria;071;San Pedro del Romeral;988;517;471
39;Cantabria;072;San Roque de Riomiera;656;346;310
39;Cantabria;080;San Vicente de la Barquera;4511;2322;2189
39;Cantabria;073;Santa Cruz de Bezana;4157;2084;2073
39;Cantabria;074;Santa María de Cayón;5915;2975;2940
39;Cantabria;075;Santander;190795;90629;100166
39;Cantabria;076;Santillana del Mar;3840;1889;1951
39;Cantabria;077;Santiurde de Reinosa;454;240;214
39;Cantabria;078;Santiurde de Toranzo;1874;954;920
39;Cantabria;079;Santoña;11180;5486;5694
39;Cantabria;081;Saro;603;317;286
39;Cantabria;082;Selaya;2063;1051;1012
39;Cantabria;083;Soba;2013;1073;940
39;Cantabria;084;Solórzano;1092;555;537
39;Cantabria;085;Suances;5770;2852;2918
39;Cantabria;086;Tojos (Los);439;225;214
39;Cantabria;087;Torrelavega;59601;29087;30514
39;Cantabria;088;Tresviso;95;53;42
39;Cantabria;089;Tudanca;389;217;172
39;Cantabria;090;Udías;888;442;446
39;Cantabria;095;Val de San Vicente;2618;1349;1269
39;Cantabria;091;Valdáliga;2880;1482;1398
39;Cantabria;092;Valdeolea;2119;1101;1018
39;Cantabria;093;Valdeprado del Río;458;237;221
39;Cantabria;094;Valderredible;1407;725;682
39;Cantabria;096;Vega de Liébana;1192;614;578
39;Cantabria;097;Vega de Pas;1293;664;629
39;Cantabria;098;Villacarriedo;2160;1084;1076
39;Cantabria;099;Villaescusa;2905;1434;1471
39;Cantabria;100;Villafufre;1212;608;604
39;Cantabria;101;Villaverde de Trucíos;475;251;224
39;Cantabria;102;Voto;2688;1396;1292
40;Segovia;001;Abades;936;477;459
40;Segovia;002;Adrada de Pirón;51;27;24
40;Segovia;003;Adrados;325;147;178
40;Segovia;004;Aguilafuente;824;408;416
40;Segovia;005;Alconada de Maderuelo;68;34;34
40;Segovia;012;Aldea Real;450;239;211
40;Segovia;006;Aldealcorvo;46;22;24
40;Segovia;007;Aldealengua de Pedraza;109;59;50
40;Segovia;008;Aldealengua de Santa María;114;67;47
40;Segovia;009;Aldeanueva de la Serrezuela;52;31;21
40;Segovia;010;Aldeanueva del Codonal;289;142;147
40;Segovia;013;Aldeasoña;182;86;96
40;Segovia;014;Aldehorno;107;60;47
40;Segovia;015;Aldehuela del Codonal;67;25;42
40;Segovia;016;Aldeonte;130;67;63
40;Segovia;017;Anaya;143;78;65
40;Segovia;018;Añe;147;76;71
40;Segovia;019;Arahuetes;55;29;26
40;Segovia;020;Arcones;314;165;149
40;Segovia;021;Arevalillo de Cega;37;19;18
40;Segovia;022;Armuña;362;177;185
40;Segovia;024;Ayllón;1336;667;669
40;Segovia;025;Barbolla;264;137;127
40;Segovia;026;Basardilla;103;52;51
40;Segovia;028;Bercial;185;94;91
40;Segovia;029;Bercimuel;102;42;60
40;Segovia;030;Bernardos;858;413;445
40;Segovia;031;Bernuy de Porreros;359;186;173
40;Segovia;032;Boceguillas;580;281;299
40;Segovia;033;Brieva;56;35;21
40;Segovia;034;Caballar;124;61;63
40;Segovia;035;Cabañas de Polendos;125;61;64
40;Segovia;036;Cabezuela;785;411;374
40;Segovia;037;Calabazas de Fuentidueña;130;62;68
40;Segovia;039;Campo de San Pedro;435;247;188
40;Segovia;040;Cantalejo;3588;1787;1801
40;Segovia;041;Cantimpalos;1380;690;690
40;Segovia;043;Carbonero el Mayor;2481;1241;1240
40;Segovia;044;Carrascal del Río;251;131;120
40;Segovia;045;Casla;141;68;73
40;Segovia;046;Castillejo de Mesleón;146;75;71
40;Segovia;047;Castro de Fuentidueña;127;73;54
40;Segovia;048;Castrojimeno;68;37;31
40;Segovia;049;Castroserna de Abajo;91;51;40
40;Segovia;051;Castroserracín;54;32;22
40;Segovia;052;Cedillo de la Torre;170;87;83
40;Segovia;053;Cerezo de Abajo;185;92;93
40;Segovia;054;Cerezo de Arriba;214;113;101
40;Segovia;065;Chañe;805;419;386
40;Segovia;055;Cilleruelo de San Mamés;75;41;34
40;Segovia;056;Cobos de Fuentidueña;109;50;59
40;Segovia;057;Coca;2169;1073;1096
40;Segovia;058;Codorniz;575;282;293
40;Segovia;059;Collado Hermoso;113;53;60
40;Segovia;060;Condado de Castilnovo;185;102;83
40;Segovia;061;Corral de Ayllón;146;86;60
40;Segovia;902;Cozuelos de Fuentidueña;278;140;138
40;Segovia;062;Cubillo;74;41;33
40;Segovia;063;Cuéllar;9300;4711;4589
40;Segovia;905;Cuevas de Provanco;"";"";""
40;Segovia;068;Domingo García;43;19;24
40;Segovia;069;Donhierro;126;77;49
40;Segovia;070;Duruelo;111;56;55
40;Segovia;071;Encinas;90;44;46
40;Segovia;072;Encinillas;87;42;45
40;Segovia;073;Escalona del Prado;673;334;339
40;Segovia;074;Escarabajosa de Cabezas;429;227;202
40;Segovia;075;Escobar de Polendos;260;127;133
40;Segovia;076;Espinar (El);5155;2600;2555
40;Segovia;077;Espirdo;209;122;87
40;Segovia;078;Fresneda de Cuéllar;297;159;138
40;Segovia;079;Fresno de Cantespino;257;131;126
40;Segovia;080;Fresno de la Fuente;103;54;49
40;Segovia;081;Frumales;297;146;151
40;Segovia;082;Fuente de Santa Cruz;235;121;114
40;Segovia;083;Fuente el Olmo de Fuentidueña;230;113;117
40;Segovia;084;Fuente el Olmo de Íscar;134;74;60
40;Segovia;086;Fuentepelayo;1072;548;524
40;Segovia;087;Fuentepiñel;211;104;107
40;Segovia;088;Fuenterrebollo;552;275;277
40;Segovia;089;Fuentesaúco de Fuentidueña;424;218;206
40;Segovia;091;Fuentesoto;219;109;110
40;Segovia;092;Fuentidueña;254;122;132
40;Segovia;093;Gallegos;114;59;55
40;Segovia;094;Garcillán;366;197;169
40;Segovia;095;Gomezserracín;671;342;329
40;Segovia;097;Grajera;79;40;39
40;Segovia;099;Honrubia de la Cuesta;112;59;53
40;Segovia;100;Hontalbilla;603;316;287
40;Segovia;101;Hontanares de Eresma;147;78;69
40;Segovia;103;Huertos (Los);169;85;84
40;Segovia;104;Ituero y Lama;55;30;25
40;Segovia;105;Juarros de Riomoros;102;50;52
40;Segovia;106;Juarros de Voltoya;338;185;153
40;Segovia;107;Labajos;190;99;91
40;Segovia;108;Laguna de Contreras;251;131;120
40;Segovia;109;Languilla;183;92;91
40;Segovia;110;Lastras de Cuéllar;698;362;336
40;Segovia;111;Lastras del Pozo;121;61;60
40;Segovia;112;Lastrilla (La);466;228;238
40;Segovia;113;Losa (La);272;138;134
40;Segovia;115;Maderuelo;189;92;97
40;Segovia;903;Marazoleja;194;107;87
40;Segovia;118;Marazuela;104;53;51
40;Segovia;119;Martín Miguel;225;109;116
40;Segovia;120;Martín Muñoz de la Dehesa;177;95;82
40;Segovia;121;Martín Muñoz de las Posadas;680;343;337
40;Segovia;122;Marugán;238;124;114
40;Segovia;124;Mata de Cuéllar;347;184;163
40;Segovia;123;Matabuena;240;116;124
40;Segovia;125;Matilla (La);136;72;64
40;Segovia;126;Melque de Cercos;194;95;99
40;Segovia;127;Membibre de la Hoz;113;58;55
40;Segovia;128;Migueláñez;214;108;106
40;Segovia;129;Montejo de Arévalo;360;201;159
40;Segovia;130;Montejo de la Vega de la Serrezuela;237;122;115
40;Segovia;131;Monterrubio;85;38;47
40;Segovia;132;Moral de Hornuez;167;85;82
40;Segovia;134;Mozoncillo;1100;559;541
40;Segovia;135;Muñopedro;502;260;242
40;Segovia;136;Muñoveros;257;133;124
40;Segovia;138;Nava de la Asunción;2640;1356;1284
40;Segovia;139;Navafría;449;237;212
40;Segovia;140;Navalilla;234;118;116
40;Segovia;141;Navalmanzano;1246;638;608
40;Segovia;142;Navares de Ayuso;91;48;43
40;Segovia;143;Navares de Enmedio;217;108;109
40;Segovia;144;Navares de las Cuevas;36;18;18
40;Segovia;145;Navas de Oro;1610;807;803
40;Segovia;904;Navas de Riofrío;210;95;115
40;Segovia;146;Navas de San Antonio;362;190;172
40;Segovia;148;Nieva;400;198;202
40;Segovia;149;Olombrada;980;520;460
40;Segovia;150;Orejana;133;67;66
40;Segovia;151;Ortigosa de Pestaño;111;59;52
40;Segovia;901;Ortigosa del Monte;289;146;143
40;Segovia;152;Otero de Herreros;859;435;424
40;Segovia;154;Pajarejos;50;23;27
40;Segovia;155;Palazuelos de Eresma;1078;556;522
40;Segovia;156;Pedraza;460;223;237
40;Segovia;157;Pelayos del Arroyo;64;34;30
40;Segovia;158;Perosillo;35;21;14
40;Segovia;159;Pinarejos;268;149;119
40;Segovia;160;Pinarnegrillo;229;116;113
40;Segovia;161;Pradales;68;37;31
40;Segovia;162;Prádena;598;299;299
40;Segovia;163;Puebla de Pedraza;111;55;56
40;Segovia;164;Rapariegos;316;166;150
40;Segovia;165;Rebollo;166;93;73
40;Segovia;166;Remondo;408;202;206
40;Segovia;168;Riaguas de San Bartolomé;98;53;45
40;Segovia;170;Riaza;1506;793;713
40;Segovia;171;Ribota;48;26;22
40;Segovia;172;Riofrío de Riaza;61;33;28
40;Segovia;173;Roda de Eresma;107;51;56
40;Segovia;174;Sacramenia;983;514;469
40;Segovia;176;Samboal;801;411;390
40;Segovia;177;San Cristóbal de Cuéllar;315;156;159
40;Segovia;178;San Cristóbal de la Vega;201;99;102
40;Segovia;906;San Cristóbal de Segovia;"";"";""
40;Segovia;181;San Ildefonso;4936;2414;2522
40;Segovia;182;San Martín y Mudrián;386;195;191
40;Segovia;183;San Miguel de Bernuy;244;124;120
40;Segovia;184;San Pedro de Gaíllos;326;172;154
40;Segovia;179;Sanchonuño;765;378;387
40;Segovia;180;Sangarcía;597;310;287
40;Segovia;185;Santa María la Real de Nieva;1766;877;889
40;Segovia;186;Santa Marta del Cerro;67;33;34
40;Segovia;188;Santiuste de Pedraza;146;77;69
40;Segovia;189;Santiuste de San Juan Bautista;936;471;465
40;Segovia;190;Santo Domingo de Pirón;58;28;30
40;Segovia;191;Santo Tomé del Puerto;416;211;205
40;Segovia;192;Sauquillo de Cabezas;290;153;137
40;Segovia;193;Sebúlcor;267;144;123
40;Segovia;194;Segovia;54402;26231;28171
40;Segovia;195;Sepúlveda;1497;760;737
40;Segovia;196;Sequera de Fresno;86;48;38
40;Segovia;198;Sotillo;77;35;42
40;Segovia;199;Sotosalbos;109;53;56
40;Segovia;200;Tabanera la Luenga;96;52;44
40;Segovia;201;Tolocirio;87;42;45
40;Segovia;206;Torre Val de San Pedro;183;94;89
40;Segovia;202;Torreadrada;189;93;96
40;Segovia;203;Torrecaballeros;245;118;127
40;Segovia;204;Torrecilla del Pinar;437;208;229
40;Segovia;205;Torreiglesias;453;243;210
40;Segovia;207;Trescasas;172;93;79
40;Segovia;208;Turégano;1220;602;618
40;Segovia;210;Urueñas;183;100;83
40;Segovia;211;Valdeprados;52;23;29
40;Segovia;212;Valdevacas de Montejo;51;29;22
40;Segovia;213;Valdevacas y Guijar;181;100;81
40;Segovia;218;Valle de Tabladillo;242;124;118
40;Segovia;219;Vallelado;903;454;449
40;Segovia;220;Valleruela de Pedraza;77;45;32
40;Segovia;221;Valleruela de Sepúlveda;97;50;47
40;Segovia;214;Valseca;350;178;172
40;Segovia;215;Valtiendas;291;157;134
40;Segovia;216;Valverde del Majano;531;274;257
40;Segovia;222;Veganzones;365;181;184
40;Segovia;223;Vegas de Matute;303;161;142
40;Segovia;224;Ventosilla y Tejadilla;33;18;15
40;Segovia;225;Villacastín;1635;843;792
40;Segovia;228;Villaverde de Íscar;808;409;399
40;Segovia;229;Villaverde de Montejo;108;55;53
40;Segovia;230;Villeguillo;158;88;70
40;Segovia;231;Yanguas de Eresma;226;102;124
40;Segovia;233;Zarzuela del Monte;565;289;276
40;Segovia;234;Zarzuela del Pinar;697;368;329
41;Sevilla;001;Aguadulce;1945;970;975
41;Sevilla;002;Alanís;2270;1141;1129
41;Sevilla;003;Albaida del Aljarafe;1700;866;834
41;Sevilla;004;Alcalá de Guadaira;50935;25383;25552
41;Sevilla;005;Alcalá del Río;9095;4648;4447
41;Sevilla;006;Alcolea del Río;3477;1698;1779
41;Sevilla;007;Algaba (La);12352;6209;6143
41;Sevilla;008;Algámitas;1575;810;765
41;Sevilla;009;Almadén de la Plata;1917;982;935
41;Sevilla;010;Almensilla;1671;829;842
41;Sevilla;011;Arahal;17474;8661;8813
41;Sevilla;012;Aznalcázar;3131;1584;1547
41;Sevilla;013;Aznalcóllar;5466;2774;2692
41;Sevilla;014;Badolatosa;3187;1614;1573
41;Sevilla;015;Benacazón;4654;2345;2309
41;Sevilla;016;Bollullos de la Mitación;4329;2149;2180
41;Sevilla;017;Bormujos;4974;2444;2530
41;Sevilla;018;Brenes;10007;5037;4970
41;Sevilla;019;Burguillos;3166;1594;1572
41;Sevilla;020;Cabezas de San Juan (Las);15242;7831;7411
41;Sevilla;021;Camas;25553;12572;12981
41;Sevilla;022;Campana (La);5439;2786;2653
41;Sevilla;023;Cantillana;8928;4473;4455
41;Sevilla;901;Cañada Rosal;2730;1373;1357
41;Sevilla;024;Carmona;24244;12169;12075
41;Sevilla;025;Carrión de los Céspedes;2462;1190;1272
41;Sevilla;026;Casariche;4917;2518;2399
41;Sevilla;027;Castilblanco de los Arroyos;3859;1956;1903
41;Sevilla;028;Castilleja de Guzmán;220;109;111
41;Sevilla;029;Castilleja de la Cuesta;14006;6912;7094
41;Sevilla;030;Castilleja del Campo;621;309;312
41;Sevilla;031;Castillo de las Guardas (El);1818;933;885
41;Sevilla;032;Cazalla de la Sierra;5426;2715;2711
41;Sevilla;033;Constantina;7941;3936;4005
41;Sevilla;034;Coria del Río;21844;10923;10921
41;Sevilla;035;Coripe;1843;953;890
41;Sevilla;036;Coronil (El);5238;2687;2551
41;Sevilla;037;Corrales (Los);3914;2024;1890
41;Sevilla;903;Cuervo de Sevilla (El);"";"";""
41;Sevilla;038;Dos Hermanas;68456;33771;34685
41;Sevilla;039;Écija;35836;17679;18157
41;Sevilla;040;Espartinas;2440;1266;1174
41;Sevilla;041;Estepa;10652;5235;5417
41;Sevilla;042;Fuentes de Andalucía;7702;3850;3852
41;Sevilla;043;Garrobo (El);742;367;375
41;Sevilla;044;Gelves;3773;1818;1955
41;Sevilla;045;Gerena;5100;2556;2544
41;Sevilla;046;Gilena;3746;1872;1874
41;Sevilla;047;Gines;5109;2516;2593
41;Sevilla;048;Guadalcanal;3326;1644;1682
41;Sevilla;049;Guillena;7737;3917;3820
41;Sevilla;050;Herrera;5575;2747;2828
41;Sevilla;051;Huévar del Aljarafe;2100;1095;1005
41;Sevilla;052;Lantejuela (La);3264;1689;1575
41;Sevilla;053;Lebrija;28935;14702;14233
41;Sevilla;054;Lora de Estepa;669;341;328
41;Sevilla;055;Lora del Río;19348;9567;9781
41;Sevilla;056;Luisiana (La);4104;2095;2009
41;Sevilla;057;Madroño (El);451;237;214
41;Sevilla;058;Mairena del Alcor;14027;6992;7035
41;Sevilla;059;Mairena del Aljarafe;18004;9086;8918
41;Sevilla;060;Marchena;17651;8667;8984
41;Sevilla;061;Marinaleda;2448;1208;1240
41;Sevilla;062;Martín de la Jara;2740;1446;1294
41;Sevilla;063;Molares (Los);2728;1394;1334
41;Sevilla;064;Montellano;7091;3591;3500
41;Sevilla;065;Morón de la Frontera;29048;14522;14526
41;Sevilla;066;Navas de la Concepción (Las);2148;1066;1082
41;Sevilla;067;Olivares;6357;3269;3088
41;Sevilla;068;Osuna;16866;8342;8524
41;Sevilla;069;Palacios y Villafranca (Los);28798;14623;14175
41;Sevilla;070;Palomares del Río;1935;990;945
41;Sevilla;071;Paradas;7235;3634;3601
41;Sevilla;072;Pedrera;4737;2398;2339
41;Sevilla;073;Pedroso (El);2486;1231;1255
41;Sevilla;074;Peñaflor;4083;2078;2005
41;Sevilla;075;Pilas;10319;5008;5311
41;Sevilla;076;Pruna;3903;2019;1884
41;Sevilla;077;Puebla de Cazalla (La);10706;5413;5293
41;Sevilla;078;Puebla de los Infantes (La);3884;1972;1912
41;Sevilla;079;Puebla del Río (La);15772;7987;7785
41;Sevilla;080;Real de la Jara (El);1857;938;919
41;Sevilla;081;Rinconada (La);20490;10385;10105
41;Sevilla;082;Roda de Andalucía (La);4095;2025;2070
41;Sevilla;083;Ronquillo (El);1416;711;705
41;Sevilla;084;Rubio (El);3854;1951;1903
41;Sevilla;085;Salteras;2355;1179;1176
41;Sevilla;086;San Juan de Aznalfarache;21620;10628;10992
41;Sevilla;088;San Nicolás del Puerto;755;393;362
41;Sevilla;087;Sanlúcar la Mayor;8806;4409;4397
41;Sevilla;089;Santiponce;6256;3129;3127
41;Sevilla;090;Saucejo (El);4110;2087;2023
41;Sevilla;091;Sevilla;663132;317116;346016
41;Sevilla;092;Tocina;8443;4195;4248
41;Sevilla;093;Tomares;10612;5238;5374
41;Sevilla;094;Umbrete;4121;2076;2045
41;Sevilla;095;Utrera;41902;20986;20916
41;Sevilla;096;Valencina de la Concepción;3993;2038;1955
41;Sevilla;902;Villafranco del Guadalquivir;"";"";""
41;Sevilla;097;Villamanrique de la Condesa;3531;1759;1772
41;Sevilla;100;Villanueva de San Juan;1825;922;903
41;Sevilla;098;Villanueva del Ariscal;3776;1788;1988
41;Sevilla;099;Villanueva del Río y Minas;5843;2823;3020
41;Sevilla;101;Villaverde del Río;6298;3228;3070
41;Sevilla;102;Viso del Alcor (El);14843;7562;7281
42;Soria;001;Abejar;369;189;180
42;Soria;003;Adradas;136;72;64
42;Soria;004;Ágreda;3698;1795;1903
42;Soria;006;Alconaba;157;87;70
42;Soria;007;Alcubilla de Avellaneda;306;159;147
42;Soria;008;Alcubilla de las Peñas;131;65;66
42;Soria;009;Aldealafuente;185;90;95
42;Soria;010;Aldealices;40;19;21
42;Soria;011;Aldealpozo;29;13;16
42;Soria;012;Aldealseñor;57;31;26
42;Soria;013;Aldehuela de Periáñez;53;27;26
42;Soria;014;Aldehuelas (Las);182;93;89
42;Soria;015;Alentisque;65;37;28
42;Soria;016;Aliud;64;29;35
42;Soria;017;Almajano;203;99;104
42;Soria;018;Almaluez;444;219;225
42;Soria;019;Almarza;674;357;317
42;Soria;020;Almazán;5840;2932;2908
42;Soria;021;Almazul;246;118;128
42;Soria;022;Almenar de Soria;498;257;241
42;Soria;023;Alpanseque;168;91;77
42;Soria;024;Arancón;119;65;54
42;Soria;025;Arcos de Jalón;2402;1208;1194
42;Soria;026;Arenillas;53;28;25
42;Soria;027;Arévalo de la Sierra;158;87;71
42;Soria;028;Ausejo de la Sierra;72;38;34
42;Soria;029;Baraona;350;180;170
42;Soria;030;Barca;204;109;95
42;Soria;031;Barcones;70;39;31
42;Soria;032;Bayubas de Abajo;344;185;159
42;Soria;033;Bayubas de Arriba;106;55;51
42;Soria;034;Beratón;51;31;20
42;Soria;035;Berlanga de Duero;1510;754;756
42;Soria;036;Blacos;93;53;40
42;Soria;037;Bliecos;73;37;36
42;Soria;038;Borjabad;81;42;39
42;Soria;039;Borobia;500;252;248
42;Soria;041;Buberos;65;31;34
42;Soria;042;Buitrago;53;30;23
42;Soria;043;Burgo de Osma-Ciudad de Osma;5063;2478;2585
42;Soria;044;Cabrejas del Campo;100;56;44
42;Soria;045;Cabrejas del Pinar;552;295;257
42;Soria;046;Calatañazor;88;45;43
42;Soria;048;Caltojar;200;101;99
42;Soria;049;Candilichera;271;141;130
42;Soria;050;Cañamaque;79;41;38
42;Soria;051;Carabantes;53;28;25
42;Soria;052;Caracena;9;5;4
42;Soria;053;Carrascosa de Abajo;55;29;26
42;Soria;054;Carrascosa de la Sierra;26;12;14
42;Soria;055;Casarejos;334;170;164
42;Soria;056;Castilfrío de la Sierra;40;20;20
42;Soria;058;Castillejo de Robledo;277;153;124
42;Soria;057;Castilruiz;451;231;220
42;Soria;059;Centenera de Andaluz;46;20;26
42;Soria;060;Cerbón;91;51;40
42;Soria;061;Cidones;351;181;170
42;Soria;062;Cigudosa;113;62;51
42;Soria;063;Cihuela;133;67;66
42;Soria;064;Ciria;118;60;58
42;Soria;065;Cirujales del Río;45;24;21
42;Soria;068;Coscurita;206;118;88
42;Soria;069;Covaleda;2226;1154;1072
42;Soria;070;Cubilla;118;66;52
42;Soria;071;Cubo de la Solana;410;209;201
42;Soria;073;Cueva de Ágreda;152;79;73
42;Soria;075;Dévanos;195;100;95
42;Soria;076;Deza;540;277;263
42;Soria;078;Duruelo de la Sierra;1563;801;762
42;Soria;079;Escobosa de Almazán;58;30;28
42;Soria;080;Espeja de San Marcelino;344;185;159
42;Soria;081;Espejón;262;136;126
42;Soria;082;Estepa de San Juan;19;9;10
42;Soria;083;Frechilla de Almazán;69;36;33
42;Soria;084;Fresno de Caracena;72;40;32
42;Soria;085;Fuentearmegil;494;255;239
42;Soria;086;Fuentecambrón;97;55;42
42;Soria;087;Fuentecantos;49;22;27
42;Soria;088;Fuentelmonge;196;96;100
42;Soria;089;Fuentelsaz de Soria;77;39;38
42;Soria;090;Fuentepinilla;219;110;109
42;Soria;092;Fuentes de Magaña;162;78;84
42;Soria;093;Fuentestrún;104;60;44
42;Soria;094;Garray;320;162;158
42;Soria;095;Golmayo;541;291;250
42;Soria;096;Gómara;674;329;345
42;Soria;097;Gormaz;41;19;22
42;Soria;098;Herrera de Soria;50;27;23
42;Soria;100;Hinojosa del Campo;71;42;29
42;Soria;103;Langa de Duero;1175;608;567
42;Soria;105;Liceras;83;41;42
42;Soria;106;Losilla (La);27;16;11
42;Soria;107;Magaña;136;74;62
42;Soria;108;Maján;34;17;17
42;Soria;110;Matalebreras;170;91;79
42;Soria;111;Matamala de Almazán;549;284;265
42;Soria;113;Medinaceli;901;459;442
42;Soria;115;Miño de Medinaceli;190;89;101
42;Soria;116;Miño de San Esteban;148;80;68
42;Soria;117;Molinos de Duero;218;105;113
42;Soria;118;Momblona;62;35;27
42;Soria;119;Monteagudo de las Vicarías;401;197;204
42;Soria;120;Montejo de Tiermes;327;174;153
42;Soria;121;Montenegro de Cameros;141;74;67
42;Soria;123;Morón de Almazán;394;190;204
42;Soria;124;Muriel de la Fuente;107;58;49
42;Soria;125;Muriel Viejo;118;62;56
42;Soria;127;Nafría de Ucero;117;56;61
42;Soria;128;Narros;68;36;32
42;Soria;129;Navaleno;929;462;467
42;Soria;130;Nepas;117;67;50
42;Soria;131;Nolay;119;65;54
42;Soria;132;Noviercas;302;144;158
42;Soria;134;Ólvega;3259;1676;1583
42;Soria;135;Oncala;153;89;64
42;Soria;139;Pinilla del Campo;32;17;15
42;Soria;140;Portillo de Soria;25;15;10
42;Soria;141;Póveda de Soria (La);179;89;90
42;Soria;142;Pozalmuro;147;71;76
42;Soria;144;Quintana Redonda;771;397;374
42;Soria;145;Quintanas de Gormaz;245;118;127
42;Soria;148;Quiñonería;27;11;16
42;Soria;149;Rábanos (Los);500;283;217
42;Soria;151;Rebollar;53;31;22
42;Soria;152;Recuerda;214;108;106
42;Soria;153;Rello;65;26;39
42;Soria;154;Renieblas;142;75;67
42;Soria;155;Retortillo de Soria;329;181;148
42;Soria;156;Reznos;60;31;29
42;Soria;157;Riba de Escalote (La);45;27;18
42;Soria;158;Rioseco de Soria;178;93;85
42;Soria;159;Rollamienta;49;26;23
42;Soria;160;Royo (El);411;196;215
42;Soria;161;Salduero;241;129;112
42;Soria;162;San Esteban de Gormaz;3736;1913;1823
42;Soria;163;San Felices;111;62;49
42;Soria;164;San Leonardo de Yagüe;2144;1074;1070
42;Soria;165;San Pedro Manrique;549;272;277
42;Soria;166;Santa Cruz de Yanguas;74;45;29
42;Soria;167;Santa María de Huerta;581;281;300
42;Soria;168;Santa María de las Hoyas;259;134;125
42;Soria;171;Serón de Nágima;366;183;183
42;Soria;172;Soliedra;46;27;19
42;Soria;173;Soria;31926;15268;16658
42;Soria;174;Sotillo del Rincón;194;96;98
42;Soria;175;Suellacabras;58;26;32
42;Soria;176;Tajahuerce;55;29;26
42;Soria;177;Tajueco;164;89;75
42;Soria;178;Talveila;261;137;124
42;Soria;181;Tardelcuende;751;357;394
42;Soria;182;Taroda;116;61;55
42;Soria;183;Tejado;284;145;139
42;Soria;184;Torlengua;161;76;85
42;Soria;185;Torreblacos;66;28;38
42;Soria;187;Torrubia de Soria;121;67;54
42;Soria;188;Trévago;99;50;49
42;Soria;189;Ucero;108;56;52
42;Soria;190;Vadillo;192;98;94
42;Soria;191;Valdeavellano de Tera;246;123;123
42;Soria;192;Valdegeña;66;35;31
42;Soria;193;Valdelagua del Cerro;58;28;30
42;Soria;194;Valdemaluque;396;198;198
42;Soria;195;Valdenebro;216;114;102
42;Soria;196;Valdeprado;34;15;19
42;Soria;197;Valderrodilla;161;77;84
42;Soria;198;Valtajeros;47;25;22
42;Soria;200;Velamazán;203;111;92
42;Soria;201;Velilla de la Sierra;12;6;6
42;Soria;202;Velilla de los Ajos;72;38;34
42;Soria;204;Viana de Duero;112;58;54
42;Soria;205;Villaciervos;114;58;56
42;Soria;206;Villanueva de Gormaz;25;14;11
42;Soria;207;Villar del Ala;45;19;26
42;Soria;208;Villar del Campo;57;29;28
42;Soria;209;Villar del Río;221;113;108
42;Soria;211;Villares de Soria (Los);123;59;64
42;Soria;212;Villasayas;138;78;60
42;Soria;213;Villaseca de Arciel;62;33;29
42;Soria;215;Vinuesa;1195;627;568
42;Soria;216;Vizmanos;50;31;19
42;Soria;217;Vozmediano;70;35;35
42;Soria;218;Yanguas;99;50;49
42;Soria;219;Yelo;109;53;56
43;Tarragona;001;Aiguamúrcia;599;318;281
43;Tarragona;002;Albinyana;639;333;306
43;Tarragona;003;Albiol (L');88;46;42
43;Tarragona;004;Alcanar;8070;3958;4112
43;Tarragona;005;Alcover;3527;1770;1757
43;Tarragona;904;Aldea (L');3471;1858;1613
43;Tarragona;006;Aldover;858;409;449
43;Tarragona;007;Aleixar (L');633;314;319
43;Tarragona;008;Alfara de Carles;425;217;208
43;Tarragona;009;Alforja;1097;542;555
43;Tarragona;010;Alió;346;177;169
43;Tarragona;011;Almoster;379;189;190
43;Tarragona;012;Altafulla;1612;819;793
43;Tarragona;013;Ametlla de Mar (L');4218;2122;2096
43;Tarragona;906;Ampolla (L');"";"";""
43;Tarragona;014;Amposta;15481;7722;7759
43;Tarragona;016;Arboç (L');3745;1883;1862
43;Tarragona;015;Arbolí;136;67;69
43;Tarragona;017;Argentera (L');151;71;80
43;Tarragona;018;Arnes;551;280;271
43;Tarragona;019;Ascó;1816;921;895
43;Tarragona;020;Banyeres del Penedès;1601;841;760
43;Tarragona;021;Barberà de la Conca;445;224;221
43;Tarragona;022;Batea;2048;1036;1012
43;Tarragona;023;Bellmunt del Priorat;331;165;166
43;Tarragona;024;Bellvei;910;475;435
43;Tarragona;025;Benifallet;1014;502;512
43;Tarragona;026;Benissanet;1081;523;558
43;Tarragona;027;Bisbal de Falset (La);313;160;153
43;Tarragona;028;Bisbal del Penedès (La);1313;668;645
43;Tarragona;029;Blancafort;432;210;222
43;Tarragona;030;Bonastre;285;144;141
43;Tarragona;031;Borges del Camp (Les);1382;691;691
43;Tarragona;032;Bot;972;487;485
43;Tarragona;033;Botarell;443;218;225
43;Tarragona;034;Bràfim;593;279;314
43;Tarragona;035;Cabacés;360;182;178
43;Tarragona;036;Cabra del Camp;422;222;200
43;Tarragona;037;Calafell;6654;3315;3339
43;Tarragona;903;Camarles;2920;1473;1447
43;Tarragona;038;Cambrils;14336;7192;7144
43;Tarragona;039;Capafonts;107;54;53
43;Tarragona;040;Capçanes;430;196;234
43;Tarragona;041;Caseres;339;169;170
43;Tarragona;042;Castellvell del Camp;738;362;376
43;Tarragona;043;Catllar (El);931;481;450
43;Tarragona;045;Colldejou;194;100;94
43;Tarragona;046;Conesa;137;63;74
43;Tarragona;047;Constantí;5691;2939;2752
43;Tarragona;048;Corbera d'Ebre;1137;585;552
43;Tarragona;049;Cornudella de Montsant;943;478;465
43;Tarragona;050;Creixell;736;367;369
43;Tarragona;051;Cunit;2085;1037;1048
43;Tarragona;901;Deltebre;10267;5194;5073
43;Tarragona;053;Duesaigües;210;113;97
43;Tarragona;054;Espluga de Francolí (L');3689;1794;1895
43;Tarragona;055;Falset;2610;1259;1351
43;Tarragona;056;Fatarella (La);1417;718;699
43;Tarragona;057;Febró (La);47;24;23
43;Tarragona;058;Figuera (La);141;68;73
43;Tarragona;059;Figuerola del Camp;225;114;111
43;Tarragona;060;Flix;5006;2525;2481
43;Tarragona;061;Forès;65;30;35
43;Tarragona;062;Freginals;393;192;201
43;Tarragona;063;Galera (La);790;380;410
43;Tarragona;064;Gandesa;2727;1363;1364
43;Tarragona;065;Garcia;591;290;301
43;Tarragona;066;Garidells (Els);185;91;94
43;Tarragona;067;Ginestar;925;465;460
43;Tarragona;068;Godall;794;378;416
43;Tarragona;069;Gratallops;258;125;133
43;Tarragona;070;Guiamets (Els);299;153;146
43;Tarragona;071;Horta de Sant Joan;1379;693;686
43;Tarragona;072;Lloar (El);159;80;79
43;Tarragona;073;Llorac;101;46;55
43;Tarragona;074;Llorenç del Penedès;1235;599;636
43;Tarragona;076;Marçà;614;288;326
43;Tarragona;075;Margalef;165;85;80
43;Tarragona;077;Mas de Barberans;773;380;393
43;Tarragona;078;Masdenverge;941;484;457
43;Tarragona;079;Masllorenç;388;191;197
43;Tarragona;080;Masó (La);280;134;146
43;Tarragona;081;Maspujols;384;198;186
43;Tarragona;082;Masroig (El);574;281;293
43;Tarragona;083;Milà (El);158;68;90
43;Tarragona;084;Miravet;840;437;403
43;Tarragona;085;Molar (El);350;174;176
43;Tarragona;086;Montblanc;5778;2868;2910
43;Tarragona;088;Montbrió del Camp;1440;722;718
43;Tarragona;089;Montferri;158;78;80
43;Tarragona;090;Montmell (El);241;118;123
43;Tarragona;091;Mont-ral;178;93;85
43;Tarragona;092;Mont-roig del Camp;4950;2519;2431
43;Tarragona;093;Móra d'Ebre;4263;2101;2162
43;Tarragona;094;Móra la Nova;2848;1435;1413
43;Tarragona;095;Morell (El);2242;1127;1115
43;Tarragona;096;Morera de Montsant (La);193;92;101
43;Tarragona;097;Nou de Gaià (La);363;196;167
43;Tarragona;098;Nulles;365;172;193
43;Tarragona;100;Pallaresos (Els);511;276;235
43;Tarragona;099;Palma d'Ebre (La);479;224;255
43;Tarragona;101;Passanant;208;114;94
43;Tarragona;102;Paüls;754;378;376
43;Tarragona;103;Perafort;494;257;237
43;Tarragona;104;Perelló (El);3763;1901;1862
43;Tarragona;105;Piles (Les);132;74;58
43;Tarragona;106;Pinell de Brai (El);1243;632;611
43;Tarragona;107;Pira;350;172;178
43;Tarragona;108;Pla de Santa Maria (El);1516;765;751
43;Tarragona;109;Pobla de Mafumet (La);829;409;420
43;Tarragona;110;Pobla de Massaluca (La);503;264;239
43;Tarragona;111;Pobla de Montornès (La);801;414;387
43;Tarragona;112;Poboleda;383;190;193
43;Tarragona;113;Pont d'Armentera (El);593;283;310
43;Tarragona;141;Pontils;123;59;64
43;Tarragona;114;Porrera;465;236;229
43;Tarragona;115;Pradell de la Teixeta;277;141;136
43;Tarragona;116;Prades;539;280;259
43;Tarragona;117;Prat de Comte;228;106;122
43;Tarragona;118;Pratdip;478;226;252
43;Tarragona;119;Puigpelat;443;218;225
43;Tarragona;120;Querol;211;109;102
43;Tarragona;121;Rasquera;906;470;436
43;Tarragona;122;Renau;47;27;20
43;Tarragona;123;Reus;83800;41008;42792
43;Tarragona;124;Riba (La);960;475;485
43;Tarragona;125;Riba-roja d'Ebre;1780;926;854
43;Tarragona;126;Riera de Gaià (La);949;447;502
43;Tarragona;127;Riudecanyes;578;293;285
43;Tarragona;128;Riudecols;936;491;445
43;Tarragona;129;Riudoms;4813;2395;2418
43;Tarragona;130;Rocafort de Queralt;277;148;129
43;Tarragona;131;Roda de Barà;1889;961;928
43;Tarragona;132;Rodonyà;366;189;177
43;Tarragona;133;Roquetes;5832;2877;2955
43;Tarragona;134;Rourell (El);269;147;122
43;Tarragona;135;Salomó;454;230;224
43;Tarragona;905;Salou;"";"";""
43;Tarragona;136;Sant Carles de la Ràpita;10436;5218;5218
43;Tarragona;137;Sant Jaume dels Domenys;1153;595;558
43;Tarragona;902;Sant Jaume d'Enveja;3487;1764;1723
43;Tarragona;138;Santa Bàrbara;3337;1642;1695
43;Tarragona;139;Santa Coloma de Queralt;2598;1258;1340
43;Tarragona;140;Santa Oliva;1356;702;654
43;Tarragona;142;Sarral;1389;693;696
43;Tarragona;143;Savallà del Comtat;60;28;32
43;Tarragona;144;Secuita (La);982;486;496
43;Tarragona;145;Selva del Camp (La);3384;1664;1720
43;Tarragona;146;Senan;28;20;8
43;Tarragona;044;Sénia (La);4738;2391;2347
43;Tarragona;147;Solivella;740;341;399
43;Tarragona;148;Tarragona;109586;53865;55721
43;Tarragona;149;Tivenys;1078;535;543
43;Tarragona;150;Tivissa;1827;893;934
43;Tarragona;151;Torre de Fontaubella (La);63;29;34
43;Tarragona;152;Torre de l'Espanyol (La);753;369;384
43;Tarragona;153;Torredembarra;6235;3085;3150
43;Tarragona;154;Torroja del Priorat;145;74;71
43;Tarragona;155;Tortosa;29333;14140;15193
43;Tarragona;156;Ulldecona;5226;2542;2684
43;Tarragona;157;Ulldemolins;562;299;263
43;Tarragona;158;Vallclara;108;55;53
43;Tarragona;159;Vallfogona de Riucorb;119;61;58
43;Tarragona;160;Vallmoll;1015;517;498
43;Tarragona;161;Valls;20003;9889;10114
43;Tarragona;162;Vandellòs i l'Hospitalet de l'Infant;4401;2240;2161
43;Tarragona;163;Vendrell (El);14308;7078;7230
43;Tarragona;164;Vespella de Gaià;73;37;36
43;Tarragona;165;Vilabella;819;388;431
43;Tarragona;175;Vilalba dels Arcs;818;434;384
43;Tarragona;166;Vilallonga del Camp;1181;579;602
43;Tarragona;168;Vilanova de Prades;163;79;84
43;Tarragona;167;Vilanova d'Escornalbou;441;215;226
43;Tarragona;169;Vilaplana;508;262;246
43;Tarragona;170;Vila-rodona;1027;537;490
43;Tarragona;171;Vila-seca;18455;9298;9157
43;Tarragona;172;Vilaverd;386;191;195
43;Tarragona;173;Vilella Alta (La);146;73;73
43;Tarragona;174;Vilella Baixa (La);187;95;92
43;Tarragona;176;Vimbodí;1161;593;568
43;Tarragona;177;Vinebre;465;224;241
43;Tarragona;178;Vinyols i els Arcs;813;430;383
43;Tarragona;052;Xerta;1277;612;665
44;Teruel;001;Ababuj;95;56;39
44;Teruel;002;Abejuela;83;45;38
44;Teruel;003;Aguatón;40;20;20
44;Teruel;004;Aguaviva;652;327;325
44;Teruel;005;Aguilar del Alfambra;109;53;56
44;Teruel;006;Alacón;521;269;252
44;Teruel;007;Alba;360;185;175
44;Teruel;008;Albalate del Arzobispo;2663;1287;1376
44;Teruel;009;Albarracín;1101;546;555
44;Teruel;010;Albentosa;310;151;159
44;Teruel;011;Alcaine;39;22;17
44;Teruel;012;Alcalá de la Selva;510;268;242
44;Teruel;013;Alcañiz;12421;6093;6328
44;Teruel;014;Alcorisa;3221;1617;1604
44;Teruel;016;Alfambra;843;420;423
44;Teruel;017;Aliaga;525;268;257
44;Teruel;021;Allepuz;192;102;90
44;Teruel;022;Alloza;980;483;497
44;Teruel;023;Allueva;10;6;4
44;Teruel;018;Almohaja;40;21;19
44;Teruel;019;Alobras;124;64;60
44;Teruel;020;Alpeñés;33;20;13
44;Teruel;024;Anadón;32;15;17
44;Teruel;025;Andorra;8898;4608;4290
44;Teruel;026;Arcos de las Salinas;183;99;84
44;Teruel;027;Arens de Lledó;280;129;151
44;Teruel;028;Argente;333;159;174
44;Teruel;029;Ariño;969;496;473
44;Teruel;031;Azaila;288;159;129
44;Teruel;032;Bádenas;34;17;17
44;Teruel;033;Báguena;679;329;350
44;Teruel;034;Bañón;251;129;122
44;Teruel;035;Barrachina;216;109;107
44;Teruel;036;Bea;30;19;11
44;Teruel;037;Beceite;709;369;340
44;Teruel;039;Bello;522;244;278
44;Teruel;038;Belmonte de San José;194;99;95
44;Teruel;040;Berge;290;146;144
44;Teruel;041;Bezas;74;38;36
44;Teruel;042;Blancas;268;132;136
44;Teruel;043;Blesa;185;98;87
44;Teruel;044;Bordón;161;85;76
44;Teruel;045;Bronchales;475;240;235
44;Teruel;046;Bueña;163;85;78
44;Teruel;047;Burbáguena;397;180;217
44;Teruel;048;Cabra de Mora;108;58;50
44;Teruel;049;Calaceite;1351;688;663
44;Teruel;050;Calamocha;4435;2215;2220
44;Teruel;051;Calanda;3606;1829;1777
44;Teruel;052;Calomarde;100;52;48
44;Teruel;053;Camañas;181;100;81
44;Teruel;054;Camarena de la Sierra;141;74;67
44;Teruel;055;Camarillas;147;83;64
44;Teruel;056;Caminreal;992;494;498
44;Teruel;059;Cantavieja;789;428;361
44;Teruel;060;Cañada de Benatanduz;82;47;35
44;Teruel;061;Cañada de Verich (La);119;63;56
44;Teruel;062;Cañada Vellida;80;47;33
44;Teruel;063;Cañizar del Olivar;165;84;81
44;Teruel;064;Cascante del Río;166;95;71
44;Teruel;065;Castejón de Tornos;136;67;69
44;Teruel;066;Castel de Cabra;280;141;139
44;Teruel;070;Castellar (El);120;65;55
44;Teruel;071;Castellote;979;498;481
44;Teruel;067;Castelnou;138;76;62
44;Teruel;068;Castelserás;967;511;456
44;Teruel;074;Cedrillas;584;304;280
44;Teruel;075;Celadas;512;266;246
44;Teruel;076;Cella;3133;1586;1547
44;Teruel;077;Cerollera (La);107;56;51
44;Teruel;080;Codoñera (La);389;200;189
44;Teruel;082;Corbalán;94;52;42
44;Teruel;084;Cortes de Aragón;161;78;83
44;Teruel;085;Cosa;147;81;66
44;Teruel;086;Cretas;776;386;390
44;Teruel;087;Crivillén;166;88;78
44;Teruel;088;Cuba (La);95;47;48
44;Teruel;089;Cubla;80;40;40
44;Teruel;090;Cucalón;120;64;56
44;Teruel;092;Cuervo (El);165;79;86
44;Teruel;093;Cuevas de Almudén;132;71;61
44;Teruel;094;Cuevas Labradas;235;115;120
44;Teruel;096;Ejulve;259;146;113
44;Teruel;097;Escorihuela;297;151;146
44;Teruel;099;Escucha;1305;713;592
44;Teruel;100;Estercuel;446;238;208
44;Teruel;101;Ferreruela de Huerva;121;59;62
44;Teruel;102;Fonfría;41;19;22
44;Teruel;103;Formiche Alto;231;119;112
44;Teruel;105;Fórnoles;140;62;78
44;Teruel;106;Fortanete;254;128;126
44;Teruel;107;Foz-Calanda;269;143;126
44;Teruel;108;Fresneda (La);535;272;263
44;Teruel;109;Frías de Albarracín;215;114;101
44;Teruel;110;Fuenferrada;59;30;29
44;Teruel;111;Fuentes Calientes;178;98;80
44;Teruel;112;Fuentes Claras;791;398;393
44;Teruel;113;Fuentes de Rubielos;92;51;41
44;Teruel;114;Fuentespalda;451;234;217
44;Teruel;115;Galve;165;88;77
44;Teruel;116;Gargallo;146;79;67
44;Teruel;117;Gea de Albarracín;520;258;262
44;Teruel;118;Ginebrosa (La);310;168;142
44;Teruel;119;Griegos;178;104;74
44;Teruel;120;Guadalaviar;319;162;157
44;Teruel;121;Gúdar;101;59;42
44;Teruel;122;Híjar;2121;1062;1059
44;Teruel;123;Hinojosa de Jarque;239;127;112
44;Teruel;124;Hoz de la Vieja (La);200;108;92
44;Teruel;125;Huesa del Común;202;104;98
44;Teruel;126;Iglesuela del Cid (La);540;279;261
44;Teruel;127;Jabaloyas;139;67;72
44;Teruel;128;Jarque de la Val;128;70;58
44;Teruel;129;Jatiel;67;29;38
44;Teruel;130;Jorcas;84;49;35
44;Teruel;131;Josa;57;30;27
44;Teruel;132;Lagueruela;90;48;42
44;Teruel;133;Lanzuela;50;28;22
44;Teruel;135;Libros;234;117;117
44;Teruel;136;Lidón;117;59;58
44;Teruel;137;Linares de Mora;380;210;170
44;Teruel;141;Lledó;259;131;128
44;Teruel;138;Loscos;271;141;130
44;Teruel;142;Maicas;21;8;13
44;Teruel;143;Manzanera;559;303;256
44;Teruel;144;Martín del Río;600;307;293
44;Teruel;145;Mas de las Matas;1540;770;770
44;Teruel;146;Mata de los Olmos (La);301;149;152
44;Teruel;147;Mazaleón;688;349;339
44;Teruel;148;Mezquita de Jarque;185;98;87
44;Teruel;149;Mirambel;159;78;81
44;Teruel;150;Miravete de la Sierra;55;30;25
44;Teruel;151;Molinos;408;197;211
44;Teruel;152;Monforte de Moyuela;120;65;55
44;Teruel;153;Monreal del Campo;2378;1191;1187
44;Teruel;154;Monroyo;405;200;205
44;Teruel;155;Montalbán;2014;1025;989
44;Teruel;156;Monteagudo del Castillo;99;56;43
44;Teruel;157;Monterde de Albarracín;91;40;51
44;Teruel;158;Mora de Rubielos;1368;708;660
44;Teruel;159;Moscardón;86;42;44
44;Teruel;160;Mosqueruela;774;398;376
44;Teruel;161;Muniesa;923;470;453
44;Teruel;163;Noguera de Albarracín;189;96;93
44;Teruel;164;Nogueras;37;23;14
44;Teruel;165;Nogueruelas;252;125;127
44;Teruel;167;Obón;80;38;42
44;Teruel;168;Odón;329;160;169
44;Teruel;169;Ojos Negros;885;453;432
44;Teruel;171;Olba;262;133;129
44;Teruel;172;Oliete;618;313;305
44;Teruel;173;Olmos (Los);193;106;87
44;Teruel;174;Orihuela del Tremedal;702;331;371
44;Teruel;175;Orrios;220;116;104
44;Teruel;176;Palomar de Arroyos;351;185;166
44;Teruel;177;Pancrudo;270;149;121
44;Teruel;178;Parras de Castellote (Las);129;68;61
44;Teruel;179;Peñarroya de Tastavins;614;305;309
44;Teruel;180;Peracense;106;50;56
44;Teruel;181;Peralejos;127;61;66
44;Teruel;182;Perales del Alfambra;333;187;146
44;Teruel;183;Pitarque;117;57;60
44;Teruel;184;Plou;63;29;34
44;Teruel;185;Pobo (El);199;109;90
44;Teruel;187;Portellada (La);386;205;181
44;Teruel;189;Pozondón;115;59;56
44;Teruel;190;Pozuel del Campo;159;85;74
44;Teruel;191;Puebla de Híjar (La);1332;639;693
44;Teruel;192;Puebla de Valverde (La);523;265;258
44;Teruel;193;Puertomingalvo;200;99;101
44;Teruel;194;Ráfales;286;143;143
44;Teruel;195;Rillo;211;115;96
44;Teruel;196;Riodeva;300;154;146
44;Teruel;197;Ródenas;113;60;53
44;Teruel;198;Royuela;242;139;103
44;Teruel;199;Rubiales;52;26;26
44;Teruel;200;Rubielos de la Cérida;82;42;40
44;Teruel;201;Rubielos de Mora;634;312;322
44;Teruel;203;Salcedillo;10;5;5
44;Teruel;204;Saldón;58;37;21
44;Teruel;205;Samper de Calanda;1245;605;640
44;Teruel;206;San Agustín;213;110;103
44;Teruel;207;San Martín del Río;412;201;211
44;Teruel;208;Santa Cruz de Nogueras;34;19;15
44;Teruel;209;Santa Eulalia;1552;749;803
44;Teruel;210;Sarrión;1126;586;540
44;Teruel;211;Segura de los Baños;84;46;38
44;Teruel;212;Seno;69;35;34
44;Teruel;213;Singra;136;71;65
44;Teruel;215;Terriente;215;114;101
44;Teruel;216;Teruel;28029;13617;14412
44;Teruel;217;Toril y Masegoso;52;29;23
44;Teruel;218;Tormón;60;31;29
44;Teruel;219;Tornos;325;166;159
44;Teruel;220;Torralba de los Sisones;266;135;131
44;Teruel;223;Torre de Arcas;138;65;73
44;Teruel;224;Torre de las Arcas;45;27;18
44;Teruel;225;Torre del Compte;230;104;126
44;Teruel;227;Torre los Negros;114;54;60
44;Teruel;221;Torrecilla de Alcañiz;511;264;247
44;Teruel;222;Torrecilla del Rebollar;224;119;105
44;Teruel;226;Torrelacárcel;382;192;190
44;Teruel;228;Torremocha de Jiloca;222;105;117
44;Teruel;229;Torres de Albarracín;213;111;102
44;Teruel;230;Torrevelilla;226;113;113
44;Teruel;231;Torrijas;88;46;42
44;Teruel;232;Torrijo del Campo;703;361;342
44;Teruel;234;Tramacastiel;157;73;84
44;Teruel;235;Tramacastilla;164;82;82
44;Teruel;236;Tronchón;138;71;67
44;Teruel;237;Urrea de Gaén;738;347;391
44;Teruel;238;Utrillas;4252;2187;2065
44;Teruel;239;Valacloche;37;20;17
44;Teruel;240;Valbona;217;116;101
44;Teruel;241;Valdealgorfa;869;437;432
44;Teruel;243;Valdecuenca;40;21;19
44;Teruel;244;Valdelinares;148;79;69
44;Teruel;245;Valdeltormo;486;252;234
44;Teruel;246;Valderrobres;1843;919;924
44;Teruel;247;Valjunquera;509;253;256
44;Teruel;249;Vallecillo (El);20;11;9
44;Teruel;250;Veguillas de la Sierra;34;17;17
44;Teruel;251;Villafranca del Campo;489;251;238
44;Teruel;252;Villahermosa del Campo;106;55;51
44;Teruel;256;Villanueva del Rebollar de la Sierra;62;30;32
44;Teruel;257;Villar del Cobo;262;133;129
44;Teruel;258;Villar del Salz;160;84;76
44;Teruel;260;Villarluengo;252;127;125
44;Teruel;261;Villarquemado;1104;551;553
44;Teruel;262;Villarroya de los Pinares;231;117;114
44;Teruel;263;Villastar;391;201;190
44;Teruel;264;Villel;417;205;212
44;Teruel;265;Vinaceite;393;209;184
44;Teruel;266;Visiedo;299;155;144
44;Teruel;267;Vivel del Río Martín;170;88;82
44;Teruel;268;Zoma (La);42;22;20
45;Toledo;001;Ajofrín;2136;1094;1042
45;Toledo;002;Alameda de la Sagra;2655;1382;1273
45;Toledo;003;Albarreal de Tajo;583;286;297
45;Toledo;004;Alcabón;510;248;262
45;Toledo;005;Alcañizo;425;219;206
45;Toledo;006;Alcaudete de la Jara;1596;771;825
45;Toledo;007;Alcolea de Tajo;881;428;453
45;Toledo;008;Aldea en Cabo;231;118;113
45;Toledo;009;Aldeanueva de Barbarroya;1048;525;523
45;Toledo;010;Aldeanueva de San Bartolomé;904;444;460
45;Toledo;011;Almendral de la Cañada;483;250;233
45;Toledo;012;Almonacid de Toledo;908;443;465
45;Toledo;013;Almorox;2217;1145;1072
45;Toledo;014;Añover de Tajo;4320;2202;2118
45;Toledo;015;Arcicóllar;463;235;228
45;Toledo;016;Argés;1652;836;816
45;Toledo;017;Azután;387;205;182
45;Toledo;018;Barcience;133;67;66
45;Toledo;019;Bargas;5592;2820;2772
45;Toledo;020;Belvís de la Jara;2134;1045;1089
45;Toledo;021;Borox;1926;957;969
45;Toledo;022;Buenaventura;531;267;264
45;Toledo;023;Burguillos de Toledo;622;320;302
45;Toledo;024;Burujón;1255;664;591
45;Toledo;025;Cabañas de la Sagra;914;473;441
45;Toledo;026;Cabañas de Yepes;280;144;136
45;Toledo;027;Cabezamesada;649;328;321
45;Toledo;028;Calera y Chozas;3697;1876;1821
45;Toledo;029;Caleruela;408;201;207
45;Toledo;030;Calzada de Oropesa;760;374;386
45;Toledo;031;Camarena;1894;966;928
45;Toledo;032;Camarenilla;568;283;285
45;Toledo;033;Campillo de la Jara (El);727;369;358
45;Toledo;034;Camuñas;1818;899;919
45;Toledo;035;Cardiel de los Montes;146;67;79
45;Toledo;036;Carmena;841;417;424
45;Toledo;037;Carpio de Tajo (El);2483;1182;1301
45;Toledo;038;Carranque;926;460;466
45;Toledo;039;Carriches;327;160;167
45;Toledo;040;Casar de Escalona (El);928;475;453
45;Toledo;041;Casarrubios del Monte;1636;820;816
45;Toledo;042;Casasbuenas;275;137;138
45;Toledo;043;Castillo de Bayuela;1109;576;533
45;Toledo;045;Cazalegas;1169;590;579
45;Toledo;046;Cebolla;2544;1277;1267
45;Toledo;047;Cedillo del Condado;1003;521;482
45;Toledo;048;Cerralbos (Los);526;264;262
45;Toledo;049;Cervera de los Montes;485;252;233
45;Toledo;056;Chozas de Canales;896;449;447
45;Toledo;057;Chueca;259;130;129
45;Toledo;050;Ciruelos;348;170;178
45;Toledo;051;Cobeja;1608;805;803
45;Toledo;052;Cobisa;203;99;104
45;Toledo;053;Consuegra;10070;4931;5139
45;Toledo;054;Corral de Almaguer;6259;3091;3168
45;Toledo;055;Cuerva;1267;629;638
45;Toledo;058;Domingo Pérez;608;304;304
45;Toledo;059;Dosbarrios;2078;1079;999
45;Toledo;060;Erustes;224;111;113
45;Toledo;061;Escalona;1714;846;868
45;Toledo;062;Escalonilla;1518;752;766
45;Toledo;063;Espinoso del Rey;708;357;351
45;Toledo;064;Esquivias;3258;1639;1619
45;Toledo;065;Estrella (La);682;355;327
45;Toledo;066;Fuensalida;6463;3244;3219
45;Toledo;067;Gálvez;3266;1649;1617
45;Toledo;068;Garciotum;179;84;95
45;Toledo;069;Gerindote;1636;830;806
45;Toledo;070;Guadamur;1565;799;766
45;Toledo;071;Guardia (La);2542;1248;1294
45;Toledo;072;Herencias (Las);894;458;436
45;Toledo;073;Herreruela de Oropesa;525;264;261
45;Toledo;074;Hinojosa de San Vicente;587;317;270
45;Toledo;075;Hontanar;115;62;53
45;Toledo;076;Hormigos;410;216;194
45;Toledo;077;Huecas;360;188;172
45;Toledo;078;Huerta de Valdecarábanos;1739;848;891
45;Toledo;079;Iglesuela (La);545;276;269
45;Toledo;080;Illán de Vacas;11;7;4
45;Toledo;081;Illescas;7394;3752;3642
45;Toledo;082;Lagartera;2042;989;1053
45;Toledo;083;Layos;259;129;130
45;Toledo;084;Lillo;3057;1493;1564
45;Toledo;085;Lominchar;1030;537;493
45;Toledo;086;Lucillos;555;267;288
45;Toledo;087;Madridejos;10325;4997;5328
45;Toledo;088;Magán;751;380;371
45;Toledo;089;Malpica de Tajo;1833;931;902
45;Toledo;090;Manzaneque;519;255;264
45;Toledo;091;Maqueda;482;248;234
45;Toledo;092;Marjaliza;365;179;186
45;Toledo;093;Marrupe;152;78;74
45;Toledo;094;Mascaraque;533;252;281
45;Toledo;095;Mata (La);1080;530;550
45;Toledo;096;Mazarambroz;1234;611;623
45;Toledo;097;Mejorada;1218;622;596
45;Toledo;098;Menasalbas;3025;1565;1460
45;Toledo;099;Méntrida;1527;782;745
45;Toledo;100;Mesegar de Tajo;293;150;143
45;Toledo;101;Miguel Esteban;4663;2293;2370
45;Toledo;102;Mocejón;3769;1903;1866
45;Toledo;103;Mohedas de la Jara;835;422;413
45;Toledo;104;Montearagón;511;260;251
45;Toledo;105;Montesclaros;535;253;282
45;Toledo;106;Mora;9395;4554;4841
45;Toledo;107;Nambroca;1723;857;866
45;Toledo;108;Nava de Ricomalillo (La);809;421;388
45;Toledo;109;Navahermosa;3781;1940;1841
45;Toledo;110;Navalcán;2656;1364;1292
45;Toledo;111;Navalmoralejo;144;68;76
45;Toledo;112;Navalmorales (Los);2956;1456;1500
45;Toledo;113;Navalucillos (Los);3307;1673;1634
45;Toledo;114;Navamorcuende;858;454;404
45;Toledo;115;Noblejas;2891;1464;1427
45;Toledo;116;Noez;944;478;466
45;Toledo;117;Nombela;922;481;441
45;Toledo;118;Novés;1449;729;720
45;Toledo;119;Numancia de la Sagra;963;487;476
45;Toledo;120;Nuño Gómez;192;95;97
45;Toledo;121;Ocaña;5603;2768;2835
45;Toledo;122;Olías del Rey;2703;1371;1332
45;Toledo;123;Ontígola;656;324;332
45;Toledo;124;Orgaz;2759;1390;1369
45;Toledo;125;Oropesa;3244;1607;1637
45;Toledo;126;Otero;217;97;120
45;Toledo;127;Palomeque;382;195;187
45;Toledo;128;Pantoja;1973;1015;958
45;Toledo;129;Paredes de Escalona;94;44;50
45;Toledo;130;Parrillas;586;293;293
45;Toledo;131;Pelahustán;484;247;237
45;Toledo;132;Pepino;585;306;279
45;Toledo;133;Polán;2986;1500;1486
45;Toledo;134;Portillo de Toledo;1858;953;905
45;Toledo;135;Puebla de Almoradiel (La);5538;2774;2764
45;Toledo;136;Puebla de Montalbán (La);6466;3236;3230
45;Toledo;137;Pueblanueva (La);2030;1030;1000
45;Toledo;138;Puente del Arzobispo (El);1600;768;832
45;Toledo;139;Puerto de San Vicente;395;195;200
45;Toledo;140;Pulgar;1189;583;606
45;Toledo;141;Quero;1563;777;786
45;Toledo;142;Quintanar de la Orden;8972;4445;4527
45;Toledo;143;Quismondo;1312;644;668
45;Toledo;144;Real de San Vicente (El);1000;517;483
45;Toledo;145;Recas;2152;1111;1041
45;Toledo;146;Retamoso;205;111;94
45;Toledo;147;Rielves;439;220;219
45;Toledo;148;Robledo del Mazo;691;355;336
45;Toledo;149;Romeral (El);1128;546;582
45;Toledo;150;San Bartolomé de las Abiertas;567;284;283
45;Toledo;151;San Martín de Montalbán;840;418;422
45;Toledo;152;San Martín de Pusa;834;441;393
45;Toledo;153;San Pablo de los Montes;1995;1011;984
45;Toledo;154;San Román de los Montes;417;204;213
45;Toledo;155;Santa Ana de Pusa;458;240;218
45;Toledo;156;Santa Cruz de la Zarza;4311;2171;2140
45;Toledo;157;Santa Cruz del Retamar;1432;718;714
45;Toledo;158;Santa Olalla;2256;1120;1136
45;Toledo;901;Santo Domingo-Caudilla;858;415;443
45;Toledo;159;Sartajada;154;83;71
45;Toledo;160;Segurilla;1049;515;534
45;Toledo;161;Seseña;2649;1353;1296
45;Toledo;162;Sevilleja de la Jara;1372;701;671
45;Toledo;163;Sonseca;8282;4121;4161
45;Toledo;164;Sotillo de las Palomas;225;121;104
45;Toledo;165;Talavera de la Reina;68158;33536;34622
45;Toledo;166;Tembleque;2259;1118;1141
45;Toledo;167;Toboso (El);2346;1148;1198
45;Toledo;168;Toledo;59551;28995;30556
45;Toledo;169;Torralba de Oropesa;327;152;175
45;Toledo;171;Torre de Esteban Hambrán (La);1321;687;634
45;Toledo;170;Torrecilla de la Jara;343;186;157
45;Toledo;172;Torrico;1032;527;505
45;Toledo;173;Torrijos;8975;4427;4548
45;Toledo;174;Totanés;373;189;184
45;Toledo;175;Turleque;1215;601;614
45;Toledo;176;Ugena;385;202;183
45;Toledo;177;Urda;3251;1597;1654
45;Toledo;179;Valdeverdeja;1061;497;564
45;Toledo;180;Valmojado;2187;1112;1075
45;Toledo;181;Velada;2301;1177;1124
45;Toledo;182;Ventas con Peña Aguilera (Las);1469;734;735
45;Toledo;183;Ventas de Retamosa (Las);525;270;255
45;Toledo;184;Ventas de San Julián (Las);234;111;123
45;Toledo;186;Villa de Don Fadrique (La);4268;2061;2207
45;Toledo;185;Villacañas;8651;4308;4343
45;Toledo;187;Villafranca de los Caballeros;5523;2706;2817
45;Toledo;188;Villaluenga de la Sagra;2576;1277;1299
45;Toledo;189;Villamiel de Toledo;272;136;136
45;Toledo;190;Villaminaya;739;367;372
45;Toledo;191;Villamuelas;769;397;372
45;Toledo;192;Villanueva de Alcardete;3342;1673;1669
45;Toledo;193;Villanueva de Bogas;906;463;443
45;Toledo;194;Villarejo de Montalbán;115;53;62
45;Toledo;195;Villarrubia de Santiago;3065;1510;1555
45;Toledo;196;Villaseca de la Sagra;1577;789;788
45;Toledo;197;Villasequilla;2352;1200;1152
45;Toledo;198;Villatobas;2514;1256;1258
45;Toledo;199;Viso de San Juan (El);451;226;225
45;Toledo;200;Yébenes (Los);6452;3263;3189
45;Toledo;201;Yeles;957;479;478
45;Toledo;202;Yepes;4444;2217;2227
45;Toledo;203;Yuncler;1755;889;866
45;Toledo;204;Yunclillos;556;286;270
45;Toledo;205;Yuncos;2613;1338;1275
46;Valencia/València;001;Ademuz;1440;720;720
46;Valencia/València;002;Ador;1167;589;578
46;Valencia/València;004;Agullent;2039;989;1050
46;Valencia/València;042;Aielo de Malferit;3852;1897;1955
46;Valencia/València;043;Aielo de Rugat;203;103;100
46;Valencia/València;005;Alaquàs;24474;12142;12332
46;Valencia/València;006;Albaida;5940;2953;2987
46;Valencia/València;007;Albal;8839;4451;4388
46;Valencia/València;008;Albalat de la Ribera;3615;1770;1845
46;Valencia/València;009;Albalat dels Sorells;3597;1768;1829
46;Valencia/València;010;Albalat dels Tarongers;560;275;285
46;Valencia/València;011;Alberic;8910;4397;4513
46;Valencia/València;012;Alborache;875;440;435
46;Valencia/València;013;Alboraya;11555;5640;5915
46;Valencia/València;014;Albuixech;2919;1449;1470
46;Valencia/València;016;Alcàntera de Xúquer;1523;752;771
46;Valencia/València;015;Alcàsser;7262;3640;3622
46;Valencia/València;018;Alcublas;920;477;443
46;Valencia/València;020;Alcúdia de Crespins (L');4322;2145;2177
46;Valencia/València;019;Alcúdia (L');10234;5005;5229
46;Valencia/València;021;Aldaia;22096;11063;11033
46;Valencia/València;022;Alfafar;20153;10033;10120
46;Valencia/València;024;Alfara de Algimia;555;277;278
46;Valencia/València;025;Alfara del Patriarca;2814;1392;1422
46;Valencia/València;026;Alfarp;1329;642;687
46;Valencia/València;027;Alfarrasí;1284;638;646
46;Valencia/València;023;Alfauir;311;155;156
46;Valencia/València;028;Algar de Palancia;407;190;217
46;Valencia/València;029;Algemesí;25202;12376;12826
46;Valencia/València;030;Algimia de Alfara;897;443;454
46;Valencia/València;031;Alginet;11856;5915;5941
46;Valencia/València;032;Almàssera;5650;2742;2908
46;Valencia/València;033;Almiserà;222;106;116
46;Valencia/València;034;Almoines;1900;949;951
46;Valencia/València;035;Almussafes;6005;2997;3008
46;Valencia/València;036;Alpuente;1253;662;591
46;Valencia/València;037;Alquería de la Condesa/Alqueria de la Comtessa (l');1636;777;859
46;Valencia/València;017;Alzira;40575;19819;20756
46;Valencia/València;038;Andilla;166;88;78
46;Valencia/València;039;Anna;2587;1287;1300
46;Valencia/València;040;Antella;1647;814;833
46;Valencia/València;041;Aras de los Olmos;511;274;237
46;Valencia/València;003;Atzeneta d'Albaida;1258;642;616
46;Valencia/València;044;Ayora;5733;2981;2752
46;Valencia/València;046;Barx;942;462;480
46;Valencia/València;045;Barxeta;1628;818;810
46;Valencia/València;047;Bèlgida;702;337;365
46;Valencia/València;048;Bellreguard;3861;1897;1964
46;Valencia/València;049;Bellús;415;207;208
46;Valencia/València;050;Benagéber;155;84;71
46;Valencia/València;051;Benaguasil;9129;4586;4543
46;Valencia/València;052;Benavites;673;325;348
46;Valencia/València;053;Beneixida;594;285;309
46;Valencia/València;054;Benetússer;14082;6954;7128
46;Valencia/València;055;Beniarjó;1256;611;645
46;Valencia/València;056;Beniatjar;269;136;133
46;Valencia/València;057;Benicolet;483;248;235
46;Valencia/València;060;Benifaió;12206;6042;6164
46;Valencia/València;059;Benifairó de la Valldigna;1646;816;830
46;Valencia/València;058;Benifairó de les Valls;2009;1013;996
46;Valencia/València;061;Beniflá;164;74;90
46;Valencia/València;062;Benigánim;5301;2678;2623
46;Valencia/València;063;Benimodo;1699;868;831
46;Valencia/València;064;Benimuslem;569;275;294
46;Valencia/València;065;Beniparrell;1434;708;726
46;Valencia/València;066;Benirredrà;877;418;459
46;Valencia/València;067;Benisanó;1688;855;833
46;Valencia/València;068;Benissoda;301;163;138
46;Valencia/València;069;Benisuera;219;105;114
46;Valencia/València;070;Bétera;9112;4551;4561
46;Valencia/València;071;Bicorp;754;377;377
46;Valencia/València;072;Bocairent;4952;2412;2540
46;Valencia/València;073;Bolbaite;1400;714;686
46;Valencia/València;074;Bonrepòs i Mirambell;2291;1126;1165
46;Valencia/València;075;Bufali;222;116;106
46;Valencia/València;076;Bugarra;887;446;441
46;Valencia/València;077;Buñol;9665;4815;4850
46;Valencia/València;078;Burjassot;35011;17082;17929
46;Valencia/València;079;Calles;473;250;223
46;Valencia/València;080;Camporrobles;1580;779;801
46;Valencia/València;081;Canals;12127;5980;6147
46;Valencia/València;082;Canet d'En Berenguer;1475;718;757
46;Valencia/València;083;Carcaixent;20792;10085;10707
46;Valencia/València;084;Càrcer;2089;1018;1071
46;Valencia/València;085;Carlet;14156;6972;7184
46;Valencia/València;086;Carrícola;69;31;38
46;Valencia/València;087;Casas Altas;208;100;108
46;Valencia/València;088;Casas Bajas;404;201;203
46;Valencia/València;089;Casinos;2227;1132;1095
46;Valencia/València;090;Castelló de Rugat;2117;1086;1031
46;Valencia/València;091;Castellonet de la Conquesta;90;47;43
46;Valencia/València;092;Castielfabib;741;389;352
46;Valencia/València;093;Catadau;2196;1121;1075
46;Valencia/València;094;Catarroja;20876;10263;10613
46;Valencia/València;095;Caudete de las Fuentes;1021;516;505
46;Valencia/València;096;Cerdà;244;124;120
46;Valencia/València;107;Chella;2631;1315;1316
46;Valencia/València;106;Chelva;2270;1164;1106
46;Valencia/València;108;Chera;620;316;304
46;Valencia/València;109;Cheste;6936;3500;3436
46;Valencia/València;111;Chiva;7527;3747;3780
46;Valencia/València;112;Chulilla;693;347;346
46;Valencia/València;097;Cofrentes;944;487;457
46;Valencia/València;098;Corbera;3247;1597;1650
46;Valencia/València;099;Cortes de Pallás;942;499;443
46;Valencia/València;100;Cotes;378;178;200
46;Valencia/València;105;Cullera;20444;10072;10372
46;Valencia/València;113;Daimús;1216;601;615
46;Valencia/València;114;Domeño;384;198;186
46;Valencia/València;115;Dos Aguas;481;268;213
46;Valencia/València;116;Eliana (L');6847;3415;3432
46;Valencia/València;117;Emperador;173;81;92
46;Valencia/València;118;Enguera;5128;2537;2591
46;Valencia/València;119;Ènova (L');1210;591;619
46;Valencia/València;120;Estivella;1113;515;598
46;Valencia/València;121;Estubeny;171;80;91
46;Valencia/València;122;Faura;2782;1392;1390
46;Valencia/València;123;Favara;1758;861;897
46;Valencia/València;126;Foios;5364;2596;2768
46;Valencia/València;128;Font de la Figuera (La);2226;1095;1131
46;Valencia/València;127;Font d'En Carròs (La);3325;1656;1669
46;Valencia/València;124;Fontanars dels Alforins;1011;545;466
46;Valencia/València;125;Fortaleny;1057;529;528
46;Valencia/València;129;Fuenterrobles;814;411;403
46;Valencia/València;131;Gandia;52646;25805;26841
46;Valencia/València;130;Gavarda;1286;650;636
46;Valencia/València;132;Genovés;2154;1074;1080
46;Valencia/València;133;Gestalgar;618;304;314
46;Valencia/València;134;Gilet;1132;553;579
46;Valencia/València;135;Godella;8961;4392;4569
46;Valencia/València;136;Godelleta;1954;961;993
46;Valencia/València;137;Granja de la Costera (La);406;198;208
46;Valencia/València;138;Guadasequies;357;182;175
46;Valencia/València;139;Guadassuar;5496;2771;2725
46;Valencia/València;140;Guardamar de la Safor;66;35;31
46;Valencia/València;141;Higueruelas;596;312;284
46;Valencia/València;142;Jalance;1359;691;668
46;Valencia/València;144;Jarafuel;1140;596;544
46;Valencia/València;154;Llanera de Ranes;959;480;479
46;Valencia/València;155;Llaurí;1512;742;770
46;Valencia/València;147;Llíria;13643;6700;6943
46;Valencia/València;153;Llocnou de Sant Jeroni;590;280;310
46;Valencia/València;151;Llocnou d'En Fenollet;658;315;343
46;Valencia/València;156;Llombai;2172;1094;1078
46;Valencia/València;157;Llosa de Ranes (La);3566;1827;1739
46;Valencia/València;150;Llutxent;2445;1258;1187
46;Valencia/València;148;Loriguilla;1167;597;570
46;Valencia/València;149;Losa del Obispo;504;240;264
46;Valencia/València;152;Lugar Nuevo de la Corona;112;56;56
46;Valencia/València;158;Macastre;929;461;468
46;Valencia/València;159;Manises;25481;12524;12957
46;Valencia/València;160;Manuel;2480;1205;1275
46;Valencia/València;161;Marines;1195;598;597
46;Valencia/València;162;Masalavés;1553;776;777
46;Valencia/València;163;Massalfassar;1479;727;752
46;Valencia/València;164;Massamagrell;12221;6107;6114
46;Valencia/València;165;Massanassa;7892;3898;3994
46;Valencia/València;166;Meliana;9144;4527;4617
46;Valencia/València;167;Millares;816;402;414
46;Valencia/València;168;Miramar;929;454;475
46;Valencia/València;169;Mislata;36735;18060;18675
46;Valencia/València;170;Mogente/Moixent;4162;2153;2009
46;Valencia/València;171;Moncada;18044;8951;9093
46;Valencia/València;172;Monserrat;2495;1270;1225
46;Valencia/València;173;Montaverner;1716;874;842
46;Valencia/València;174;Montesa;1249;634;615
46;Valencia/València;175;Montichelvo;676;341;335
46;Valencia/València;176;Montroy;1482;750;732
46;Valencia/València;177;Museros;4048;2004;2044
46;Valencia/València;178;Náquera;1630;810;820
46;Valencia/València;179;Navarrés;2785;1395;1390
46;Valencia/València;180;Novelé/Novetlè;575;282;293
46;Valencia/València;181;Oliva;20497;10176;10321
46;Valencia/València;183;Olleria (L');6878;3480;3398
46;Valencia/València;182;Olocau;608;311;297
46;Valencia/València;184;Ontinyent;29591;14607;14984
46;Valencia/València;185;Otos;544;273;271
46;Valencia/València;186;Paiporta;15332;7592;7740
46;Valencia/València;187;Palma de Gandía;1515;748;767
46;Valencia/València;188;Palmera;488;230;258
46;Valencia/València;189;Palomar (El);498;242;256
46;Valencia/València;190;Paterna;38554;19123;19431
46;Valencia/València;191;Pedralba;2093;1062;1031
46;Valencia/València;192;Petrés;622;296;326
46;Valencia/València;193;Picanya;7431;3724;3707
46;Valencia/València;194;Picassent;14597;7354;7243
46;Valencia/València;195;Piles;2034;970;1064
46;Valencia/València;196;Pinet;270;152;118
46;Valencia/València;199;Pobla de Farnals (La);4360;2149;2211
46;Valencia/València;202;Pobla de Vallbona (La);7686;3972;3714
46;Valencia/València;200;Pobla del Duc (La);2644;1315;1329
46;Valencia/València;203;Pobla Llarga (La);4512;2204;2308
46;Valencia/València;197;Polinyà de Xúquer;3056;1504;1552
46;Valencia/València;198;Potríes;958;469;489
46;Valencia/València;205;Puçol;12334;6078;6256
46;Valencia/València;201;Puebla de San Miguel;45;23;22
46;Valencia/València;204;Puig;5983;2969;3014
46;Valencia/València;101;Quart de les Valls;1127;531;596
46;Valencia/València;102;Quart de Poblet;27444;13591;13853
46;Valencia/València;103;Quartell;1359;678;681
46;Valencia/València;104;Quatretonda;2624;1332;1292
46;Valencia/València;206;Quesa;861;432;429
46;Valencia/València;207;Rafelbuñol/Rafelbunyol;4833;2402;2431
46;Valencia/València;208;Rafelcofer;1450;684;766
46;Valencia/València;209;Rafelguaraf;2412;1197;1215
46;Valencia/València;210;Ráfol de Salem;406;186;220
46;Valencia/València;211;Real de Gandía;1949;894;1055
46;Valencia/València;212;Real de Montroi;1830;942;888
46;Valencia/València;213;Requena;18543;9296;9247
46;Valencia/València;214;Riba-roja de Túria;9539;4712;4827
46;Valencia/València;215;Riola;1703;862;841
46;Valencia/València;216;Rocafort;3467;1708;1759
46;Valencia/València;217;Rotglá y Corberá;1054;525;529
46;Valencia/València;218;Rótova;1399;708;691
46;Valencia/València;219;Rugat;199;100;99
46;Valencia/València;220;Sagunto/Sagunt;56551;27852;28699
46;Valencia/València;221;Salem;498;245;253
46;Valencia/València;222;San Juan de Énova;390;186;204
46;Valencia/València;223;Sedaví;8510;4190;4320
46;Valencia/València;224;Segart;158;71;87
46;Valencia/València;225;Sellent;517;265;252
46;Valencia/València;226;Sempere;49;21;28
46;Valencia/València;227;Senyera;831;402;429
46;Valencia/València;228;Serra;1386;680;706
46;Valencia/València;229;Siete Aguas;1218;581;637
46;Valencia/València;230;Silla;16209;8224;7985
46;Valencia/València;231;Simat de la Valldigna;3255;1649;1606
46;Valencia/València;232;Sinarcas;1380;713;667
46;Valencia/València;233;Sollana;4477;2238;2239
46;Valencia/València;234;Sot de Chera;335;173;162
46;Valencia/València;235;Sueca;24667;12124;12543
46;Valencia/València;236;Sumacàrcer;1422;718;704
46;Valencia/València;237;Tavernes Blanques;8043;3962;4081
46;Valencia/València;238;Tavernes de la Valldigna;16230;8064;8166
46;Valencia/València;239;Teresa de Cofrentes;841;444;397
46;Valencia/València;240;Terrateig;236;120;116
46;Valencia/València;241;Titaguas;660;347;313
46;Valencia/València;242;Torrebaja;457;243;214
46;Valencia/València;243;Torrella;189;92;97
46;Valencia/València;244;Torrent;55751;27734;28017
46;Valencia/València;245;Torres Torres;396;190;206
46;Valencia/València;246;Tous;1231;617;614
46;Valencia/València;247;Tuéjar;1485;783;702
46;Valencia/València;248;Turís;4045;2086;1959
46;Valencia/València;249;Utiel;12218;6174;6044
46;Valencia/València;250;Valencia;743933;354808;389125
46;Valencia/València;251;Vallada;2904;1457;1447
46;Valencia/València;252;Vallanca;287;135;152
46;Valencia/València;253;Vallés;126;71;55
46;Valencia/València;254;Venta del Moro;1994;1019;975
46;Valencia/València;256;Vilamarxant;4868;2477;2391
46;Valencia/València;255;Villalonga;3678;1844;1834
46;Valencia/València;257;Villanueva de Castellón;7056;3436;3620
46;Valencia/València;258;Villar del Arzobispo;3421;1709;1712
46;Valencia/València;259;Villargordo del Cabriel;910;469;441
46;Valencia/València;260;Vinalesa;2326;1096;1230
46;Valencia/València;145;Xàtiva;24773;12026;12747
46;Valencia/València;143;Xeraco;4563;2283;2280
46;Valencia/València;146;Xeresa;2014;1007;1007
46;Valencia/València;110;Xirivella;24963;12447;12516
46;Valencia/València;261;Yátova;2161;1125;1036
46;Valencia/València;262;Yesa (La);331;167;164
46;Valencia/València;263;Zarra;557;279;278
47;Valladolid;001;Adalia;105;57;48
47;Valladolid;002;Aguasal;31;18;13
47;Valladolid;003;Aguilar de Campos;468;238;230
47;Valladolid;004;Alaejos;2003;1017;986
47;Valladolid;005;Alcazarén;815;434;381
47;Valladolid;006;Aldea de San Miguel;270;135;135
47;Valladolid;007;Aldeamayor de San Martín;1057;528;529
47;Valladolid;008;Almenara de Adaja;46;26;20
47;Valladolid;009;Amusquillo;219;116;103
47;Valladolid;010;Arroyo de la Encomienda;1277;639;638
47;Valladolid;011;Ataquines;1032;529;503
47;Valladolid;012;Bahabón;284;142;142
47;Valladolid;013;Barcial de la Loma;201;102;99
47;Valladolid;014;Barruelo del Valle;91;43;48
47;Valladolid;015;Becilla de Valderaduey;534;263;271
47;Valladolid;016;Benafarces;109;52;57
47;Valladolid;017;Bercero;307;158;149
47;Valladolid;018;Berceruelo;38;21;17
47;Valladolid;019;Berrueces;149;82;67
47;Valladolid;020;Bobadilla del Campo;488;250;238
47;Valladolid;021;Bocigas;121;64;57
47;Valladolid;022;Bocos de Duero;97;41;56
47;Valladolid;023;Boecillo;749;368;381
47;Valladolid;024;Bolaños de Campos;465;232;233
47;Valladolid;025;Brahojos de Medina;233;135;98
47;Valladolid;026;Bustillo de Chaves;137;67;70
47;Valladolid;027;Cabezón de Pisuerga;1532;770;762
47;Valladolid;028;Cabezón de Valderaduey;63;32;31
47;Valladolid;029;Cabreros del Monte;145;68;77
47;Valladolid;030;Campaspero;1833;944;889
47;Valladolid;031;Campillo (El);270;153;117
47;Valladolid;032;Camporredondo;255;135;120
47;Valladolid;033;Canalejas de Peñafiel;376;196;180
47;Valladolid;034;Canillas de Esgueva;173;92;81
47;Valladolid;035;Carpio;1366;712;654
47;Valladolid;036;Casasola de Arión;451;235;216
47;Valladolid;037;Castrejón de Trabancos;315;175;140
47;Valladolid;038;Castrillo de Duero;281;145;136
47;Valladolid;039;Castrillo-Tejeriego;350;183;167
47;Valladolid;040;Castrobol;127;53;74
47;Valladolid;041;Castrodeza;288;144;144
47;Valladolid;042;Castromembibre;112;56;56
47;Valladolid;043;Castromonte;560;291;269
47;Valladolid;044;Castronuevo de Esgueva;299;157;142
47;Valladolid;045;Castronuño;1324;681;643
47;Valladolid;046;Castroponce;252;129;123
47;Valladolid;047;Castroverde de Cerrato;361;190;171
47;Valladolid;048;Ceinos de Campos;326;175;151
47;Valladolid;049;Cervillego de la Cruz;217;103;114
47;Valladolid;050;Cigales;1681;811;870
47;Valladolid;051;Ciguñuela;353;174;179
47;Valladolid;052;Cistérniga;1184;595;589
47;Valladolid;053;Cogeces de Íscar;168;86;82
47;Valladolid;054;Cogeces del Monte;1087;571;516
47;Valladolid;055;Corcos;268;142;126
47;Valladolid;056;Corrales de Duero;178;98;80
47;Valladolid;057;Cubillas de Santa Marta;308;147;161
47;Valladolid;058;Cuenca de Campos;361;177;184
47;Valladolid;059;Curiel de Duero;201;111;90
47;Valladolid;060;Encinas de Esgueva;471;241;230
47;Valladolid;061;Esguevillas de Esgueva;498;260;238
47;Valladolid;062;Fombellida;349;189;160
47;Valladolid;063;Fompedraza;155;88;67
47;Valladolid;064;Fontihoyuelo;65;32;33
47;Valladolid;065;Fresno el Viejo;1509;762;747
47;Valladolid;066;Fuensaldaña;633;321;312
47;Valladolid;067;Fuente el Sol;397;207;190
47;Valladolid;068;Fuente-Olmedo;93;45;48
47;Valladolid;069;Gallegos de Hornija;158;80;78
47;Valladolid;070;Gatón de Campos;72;38;34
47;Valladolid;071;Geria;423;231;192
47;Valladolid;073;Herrín de Campos;264;132;132
47;Valladolid;074;Hornillos de Eresma;176;95;81
47;Valladolid;075;Íscar;5854;2957;2897
47;Valladolid;076;Laguna de Duero;9667;4855;4812
47;Valladolid;077;Langayo;559;288;271
47;Valladolid;079;Llano de Olmedo;115;57;58
47;Valladolid;078;Lomoviejo;313;162;151
47;Valladolid;080;Manzanillo;69;38;31
47;Valladolid;081;Marzales;83;41;42
47;Valladolid;082;Matapozuelos;965;500;465
47;Valladolid;083;Matilla de los Caños;96;50;46
47;Valladolid;084;Mayorga;1690;780;910
47;Valladolid;086;Medina de Rioseco;5009;2482;2527
47;Valladolid;085;Medina del Campo;19696;9724;9972
47;Valladolid;087;Megeces;494;247;247
47;Valladolid;088;Melgar de Abajo;277;128;149
47;Valladolid;089;Melgar de Arriba;364;178;186
47;Valladolid;090;Mojados;2058;1046;1012
47;Valladolid;091;Monasterio de Vega;139;63;76
47;Valladolid;092;Montealegre de Campos;195;103;92
47;Valladolid;093;Montemayor de Pililla;1180;618;562
47;Valladolid;094;Moral de la Reina;296;156;140
47;Valladolid;095;Moraleja de las Panaderas;29;18;11
47;Valladolid;096;Morales de Campos;240;119;121
47;Valladolid;097;Mota del Marqués;526;259;267
47;Valladolid;098;Mucientes;667;331;336
47;Valladolid;099;Mudarra (La);317;166;151
47;Valladolid;100;Muriel;320;155;165
47;Valladolid;101;Nava del Rey;2462;1191;1271
47;Valladolid;102;Nueva Villa de las Torres;459;243;216
47;Valladolid;103;Olivares de Duero;359;192;167
47;Valladolid;104;Olmedo;3750;1840;1910
47;Valladolid;105;Olmos de Esgueva;210;112;98
47;Valladolid;106;Olmos de Peñafiel;111;61;50
47;Valladolid;109;Palazuelo de Vedija;301;149;152
47;Valladolid;110;Parrilla (La);632;312;320
47;Valladolid;111;Pedraja de Portillo (La);987;485;502
47;Valladolid;112;Pedrajas de San Esteban;3133;1605;1528
47;Valladolid;113;Pedrosa del Rey;311;149;162
47;Valladolid;114;Peñafiel;5285;2688;2597
47;Valladolid;115;Peñaflor de Hornija;544;290;254
47;Valladolid;116;Pesquera de Duero;649;337;312
47;Valladolid;117;Piña de Esgueva;463;245;218
47;Valladolid;118;Piñel de Abajo;331;179;152
47;Valladolid;119;Piñel de Arriba;204;101;103
47;Valladolid;121;Pollos;960;503;457
47;Valladolid;122;Portillo;2604;1326;1278
47;Valladolid;123;Pozal de Gallinas;505;256;249
47;Valladolid;124;Pozaldez;622;295;327
47;Valladolid;125;Pozuelo de la Orden;121;61;60
47;Valladolid;126;Puras;74;38;36
47;Valladolid;127;Quintanilla de Arriba;291;155;136
47;Valladolid;129;Quintanilla de Onésimo;1168;629;539
47;Valladolid;130;Quintanilla de Trigueros;108;57;51
47;Valladolid;128;Quintanilla del Molar;104;51;53
47;Valladolid;131;Rábano;306;164;142
47;Valladolid;132;Ramiro;120;62;58
47;Valladolid;133;Renedo de Esgueva;777;417;360
47;Valladolid;134;Roales de Campos;337;177;160
47;Valladolid;135;Robladillo;112;57;55
47;Valladolid;137;Roturas;43;25;18
47;Valladolid;138;Rubí de Bracamonte;419;217;202
47;Valladolid;139;Rueda;1663;845;818
47;Valladolid;140;Saelices de Mayorga;283;146;137
47;Valladolid;141;Salvador de Zapardiel;254;129;125
47;Valladolid;142;San Cebrián de Mazote;287;153;134
47;Valladolid;143;San Llorente;246;123;123
47;Valladolid;144;San Martín de Valvení;124;70;54
47;Valladolid;145;San Miguel del Arroyo;957;491;466
47;Valladolid;146;San Miguel del Pino;259;138;121
47;Valladolid;147;San Pablo de la Moraleja;210;111;99
47;Valladolid;148;San Pedro de Latarce;764;412;352
47;Valladolid;149;San Pelayo;47;20;27
47;Valladolid;150;San Román de Hornija;588;294;294
47;Valladolid;151;San Salvador;54;29;25
47;Valladolid;156;San Vicente del Palacio;333;172;161
47;Valladolid;152;Santa Eufemia del Arroyo;158;80;78
47;Valladolid;153;Santervás de Campos;220;117;103
47;Valladolid;154;Santibáñez de Valcorba;224;114;110
47;Valladolid;155;Santovenia de Pisuerga;1016;524;492
47;Valladolid;157;Sardón de Duero;646;325;321
47;Valladolid;158;Seca (La);1076;566;510
47;Valladolid;159;Serrada;1044;545;499
47;Valladolid;160;Siete Iglesias de Trabancos;744;377;367
47;Valladolid;161;Simancas;1799;930;869
47;Valladolid;162;Tamariz de Campos;106;52;54
47;Valladolid;163;Tiedra;449;217;232
47;Valladolid;164;Tordehumos;637;329;308
47;Valladolid;165;Tordesillas;7384;3722;3662
47;Valladolid;169;Torre de Esgueva;142;73;69
47;Valladolid;170;Torre de Peñafiel;78;40;38
47;Valladolid;166;Torrecilla de la Abadesa;406;217;189
47;Valladolid;167;Torrecilla de la Orden;472;234;238
47;Valladolid;168;Torrecilla de la Torre;50;29;21
47;Valladolid;171;Torrelobatón;684;334;350
47;Valladolid;172;Torrescárcela;214;109;105
47;Valladolid;173;Traspinedo;805;415;390
47;Valladolid;174;Trigueros del Valle;285;144;141
47;Valladolid;175;Tudela de Duero;4772;2422;2350
47;Valladolid;176;Unión de Campos (La);423;205;218
47;Valladolid;177;Urones de Castroponce;241;132;109
47;Valladolid;178;Urueña;265;136;129
47;Valladolid;179;Valbuena de Duero;584;312;272
47;Valladolid;180;Valdearcos de la Vega;173;88;85
47;Valladolid;181;Valdenebro de los Valles;269;145;124
47;Valladolid;182;Valdestillas;1404;721;683
47;Valladolid;183;Valdunquillo;317;156;161
47;Valladolid;186;Valladolid;331461;160799;170662
47;Valladolid;184;Valoria la Buena;664;354;310
47;Valladolid;185;Valverde de Campos;137;76;61
47;Valladolid;187;Vega de Ruiponce;227;109;118
47;Valladolid;188;Vega de Valdetronco;223;121;102
47;Valladolid;189;Velascálvaro;213;110;103
47;Valladolid;190;Velilla;163;87;76
47;Valladolid;191;Velliza;202;104;98
47;Valladolid;192;Ventosa de la Cuesta;196;104;92
47;Valladolid;193;Viana de Cega;975;499;476
47;Valladolid;195;Villabáñez;438;224;214
47;Valladolid;196;Villabaruz de Campos;60;26;34
47;Valladolid;197;Villabrágima;1342;693;649
47;Valladolid;198;Villacarralón;167;87;80
47;Valladolid;199;Villacid de Campos;146;79;67
47;Valladolid;200;Villaco;179;103;76
47;Valladolid;203;Villafrades de Campos;181;82;99
47;Valladolid;204;Villafranca de Duero;481;247;234
47;Valladolid;205;Villafrechós;605;310;295
47;Valladolid;206;Villafuerte;193;93;100
47;Valladolid;207;Villagarcía de Campos;494;258;236
47;Valladolid;208;Villagómez la Nueva;119;56;63
47;Valladolid;209;Villalán de Campos;66;34;32
47;Valladolid;210;Villalar de los Comuneros;507;254;253
47;Valladolid;211;Villalba de la Loma;57;30;27
47;Valladolid;212;Villalba de los Alcores;689;360;329
47;Valladolid;213;Villalbarba;200;98;102
47;Valladolid;214;Villalón de Campos;2226;1094;1132
47;Valladolid;215;Villamuriel de Campos;113;53;60
47;Valladolid;216;Villán de Tordesillas;178;90;88
47;Valladolid;217;Villanubla;980;509;471
47;Valladolid;218;Villanueva de Duero;842;439;403
47;Valladolid;219;Villanueva de la Condesa;59;33;26
47;Valladolid;220;Villanueva de los Caballeros;350;178;172
47;Valladolid;221;Villanueva de los Infantes;160;82;78
47;Valladolid;222;Villanueva de San Mancio;108;51;57
47;Valladolid;223;Villardefrades;353;184;169
47;Valladolid;224;Villarmentero de Esgueva;137;64;73
47;Valladolid;225;Villasexmir;151;81;70
47;Valladolid;226;Villavaquerín;250;138;112
47;Valladolid;227;Villavellid;109;52;57
47;Valladolid;228;Villaverde de Medina;688;365;323
47;Valladolid;229;Villavicencio de los Caballeros;421;195;226
47;Valladolid;194;Viloria;439;236;203
47;Valladolid;230;Wamba;422;220;202
47;Valladolid;231;Zaratán;1153;585;568
47;Valladolid;232;Zarza (La);206;105;101
48;Vizcaya;001;Abadiño;7180;3653;3527
48;Vizcaya;002;Abanto y Ciérvana-Abanto Zierbena;9642;4825;4817
48;Vizcaya;911;Ajangiz;"";782;746
48;Vizcaya;912;Alonsotegi;"";"";""
48;Vizcaya;003;Amorebieta-Etxano;15932;8065;7867
48;Vizcaya;004;Amoroto;409;218;191
48;Vizcaya;005;Arakaldo;90;55;35
48;Vizcaya;006;Arantzazu;321;159;162
48;Vizcaya;093;Areatza;1186;564;622
48;Vizcaya;009;Arrankudiaga;756;384;372
48;Vizcaya;914;Arratzu;"";"";""
48;Vizcaya;010;Arrieta;429;226;203
48;Vizcaya;011;Arrigorriaga;9517;4651;4866
48;Vizcaya;023;Artea;631;309;322
48;Vizcaya;008;Artzentales;685;378;307
48;Vizcaya;091;Atxondo;1528;782;746
48;Vizcaya;070;Aulesti;707;393;314
48;Vizcaya;012;Bakio;1232;616;616
48;Vizcaya;090;Balmaseda;7625;3745;3880
48;Vizcaya;013;Barakaldo;113502;56281;57221
48;Vizcaya;014;Barrika;773;373;400
48;Vizcaya;015;Basauri;51730;25867;25863
48;Vizcaya;092;Bedia;1121;550;571
48;Vizcaya;016;Berango;4038;2002;2036
48;Vizcaya;017;Bermeo;18411;9175;9236
48;Vizcaya;018;Berriatua;1077;574;503
48;Vizcaya;019;Berriz;4212;2134;2078
48;Vizcaya;020;Bilbao;384733;184848;199885
48;Vizcaya;021;Busturia;1807;902;905
48;Vizcaya;901;Derio;5076;2552;2524
48;Vizcaya;026;Dima;1025;536;489
48;Vizcaya;027;Durango;27425;13650;13775
48;Vizcaya;028;Ea;830;408;422
48;Vizcaya;031;Elantxobe;576;268;308
48;Vizcaya;032;Elorrio;7703;3889;3814
48;Vizcaya;902;Erandio;25244;12482;12762
48;Vizcaya;033;Ereño;299;150;149
48;Vizcaya;034;Ermua;18771;9633;9138
48;Vizcaya;079;Errigoiti;478;257;221
48;Vizcaya;029;Etxebarri, Anteiglesia de San Esteban-Etxebarri Doneztebeko Elizatea;6545;3308;3237
48;Vizcaya;030;Etxebarria;798;421;377
48;Vizcaya;906;Forua;1006;528;478
48;Vizcaya;035;Fruiz;347;178;169
48;Vizcaya;036;Galdakao;27769;13904;13865
48;Vizcaya;037;Galdames;818;429;389
48;Vizcaya;038;Gamiz-Fika;905;480;425
48;Vizcaya;039;Garay;251;130;121
48;Vizcaya;040;Gatika;861;433;428
48;Vizcaya;041;Gautegiz Arteaga;807;397;410
48;Vizcaya;046;Gernika-Lumo;16406;8057;8349
48;Vizcaya;044;Getxo;80108;38833;41275
48;Vizcaya;047;Gizaburuaga;135;68;67
48;Vizcaya;042;Gordexola;1600;811;789
48;Vizcaya;043;Gorliz;2758;1343;1415
48;Vizcaya;045;Güeñes;6210;3079;3131
48;Vizcaya;048;Ibarrangelu;547;246;301
48;Vizcaya;094;Igorre;3865;1945;1920
48;Vizcaya;049;Ispaster;619;333;286
48;Vizcaya;910;Iurreta;"";"";""
48;Vizcaya;050;Izurtza;281;139;142
48;Vizcaya;022;Karrantza Harana/Valle de Carranza;3450;1822;1628
48;Vizcaya;907;Kortezubi;394;209;185
48;Vizcaya;051;Lanestosa;324;168;156
48;Vizcaya;052;Larrabetzu;1531;759;772
48;Vizcaya;053;Laukiz;1040;531;509
48;Vizcaya;054;Leioa;24395;12056;12339
48;Vizcaya;057;Lekeitio;7640;3748;3892
48;Vizcaya;055;Lemoa;3004;1524;1480
48;Vizcaya;056;Lemoiz;798;402;396
48;Vizcaya;081;Lezama;1932;982;950
48;Vizcaya;903;Loiu;1676;865;811
48;Vizcaya;058;Mallabia;1142;595;547
48;Vizcaya;059;Mañaria;522;273;249
48;Vizcaya;060;Markina-Xemein;5073;2585;2488
48;Vizcaya;061;Maruri-Jatabe;514;255;259
48;Vizcaya;062;Mendata;377;214;163
48;Vizcaya;063;Mendexa;348;177;171
48;Vizcaya;064;Meñaka;415;221;194
48;Vizcaya;066;Morga;355;189;166
48;Vizcaya;068;Mundaka;1711;797;914
48;Vizcaya;069;Mungia;11341;5605;5736
48;Vizcaya;007;Munitibar-Arbatzegi Gerrikaitz;488;259;229
48;Vizcaya;908;Murueta;217;106;111
48;Vizcaya;071;Muskiz;6330;3190;3140
48;Vizcaya;067;Muxika;1546;809;737
48;Vizcaya;909;Nabarniz;247;120;127
48;Vizcaya;073;Ondarroa;11145;5622;5523
48;Vizcaya;075;Orozko;1994;980;1014
48;Vizcaya;083;Ortuella;9194;4538;4656
48;Vizcaya;072;Otxandio;1198;630;568
48;Vizcaya;077;Plentzia;2772;1340;1432
48;Vizcaya;078;Portugalete;57813;28660;29153
48;Vizcaya;082;Santurtzi;52334;25935;26399
48;Vizcaya;084;Sestao;37916;18644;19272
48;Vizcaya;904;Sondika;3577;1754;1823
48;Vizcaya;085;Sopelana;7442;3761;3681
48;Vizcaya;086;Sopuerta;2193;1147;1046
48;Vizcaya;076;Sukarrieta;293;143;150
48;Vizcaya;087;Trucios-Turtzioz;529;258;271
48;Vizcaya;088;Ubide;161;76;85
48;Vizcaya;065;Ugao-Miraballes;4203;2131;2072
48;Vizcaya;089;Urduliz;2510;1263;1247
48;Vizcaya;074;Urduña-Orduña;4222;2130;2092
48;Vizcaya;080;Valle de Trápaga-Trapagaran;13381;6612;6769
48;Vizcaya;095;Zaldibar;3241;1515;1726
48;Vizcaya;096;Zalla;7347;3699;3648
48;Vizcaya;905;Zamudio;3231;1639;1592
48;Vizcaya;097;Zaratamo;1600;811;789
48;Vizcaya;024;Zeanuri;1239;642;597
48;Vizcaya;025;Zeberio;976;506;470
48;Vizcaya;913;Zierbena;"";"";""
49;Zamora;002;Abezames;149;72;77
49;Zamora;003;Alcañices;1298;666;632
49;Zamora;004;Alcubilla de Nogales;280;134;146
49;Zamora;005;Alfaraz de Sayago;308;157;151
49;Zamora;006;Algodre;280;147;133
49;Zamora;007;Almaraz de Duero;538;269;269
49;Zamora;008;Almeida de Sayago;807;416;391
49;Zamora;009;Andavías;577;281;296
49;Zamora;010;Arcenillas;265;134;131
49;Zamora;011;Arcos de la Polvorosa;336;178;158
49;Zamora;012;Argañín;145;69;76
49;Zamora;013;Argujillo;476;246;230
49;Zamora;014;Arquillinos;231;117;114
49;Zamora;015;Arrabalde;500;242;258
49;Zamora;016;Aspariegos;493;233;260
49;Zamora;017;Asturianos;460;225;235
49;Zamora;018;Ayoó de Vidriales;661;329;332
49;Zamora;019;Barcial del Barco;376;202;174
49;Zamora;020;Belver de los Montes;618;322;296
49;Zamora;021;Benavente;13980;6743;7237
49;Zamora;022;Benegiles;517;273;244
49;Zamora;023;Bermillo de Sayago;1841;941;900
49;Zamora;024;Bóveda de Toro (La);1168;595;573
49;Zamora;025;Bretó;318;153;165
49;Zamora;026;Bretocino;381;204;177
49;Zamora;027;Brime de Sog;336;147;189
49;Zamora;028;Brime de Urz;203;102;101
49;Zamora;029;Burganes de Valverde;984;502;482
49;Zamora;030;Bustillo del Oro;225;101;124
49;Zamora;031;Cabañas de Sayago;276;144;132
49;Zamora;032;Calzadilla de Tera;670;323;347
49;Zamora;033;Camarzana de Tera;1308;656;652
49;Zamora;034;Cañizal;745;383;362
49;Zamora;035;Cañizo;416;198;218
49;Zamora;036;Carbajales de Alba;788;382;406
49;Zamora;037;Carbellino;308;162;146
49;Zamora;038;Casaseca de Campeán;235;125;110
49;Zamora;039;Casaseca de las Chanas;446;225;221
49;Zamora;040;Castrillo de la Guareña;195;96;99
49;Zamora;041;Castrogonzalo;629;309;320
49;Zamora;042;Castronuevo;472;246;226
49;Zamora;043;Castroverde de Campos;560;274;286
49;Zamora;044;Cazurra;132;71;61
49;Zamora;046;Cerecinos de Campos;574;294;280
49;Zamora;047;Cerecinos del Carrizal;235;122;113
49;Zamora;048;Cernadilla;243;112;131
49;Zamora;050;Cobreros;1014;486;528
49;Zamora;052;Coomonte;412;202;210
49;Zamora;053;Coreses;1365;711;654
49;Zamora;054;Corrales;1553;767;786
49;Zamora;055;Cotanes del Monte;234;122;112
49;Zamora;056;Cubillos;494;262;232
49;Zamora;057;Cubo de Benavente;278;146;132
49;Zamora;058;Cubo de Tierra del Vino (El);497;269;228
49;Zamora;059;Cuelgamures;172;97;75
49;Zamora;061;Entrala;174;85;89
49;Zamora;062;Espadañedo;275;133;142
49;Zamora;063;Faramontanos de Tábara;644;327;317
49;Zamora;064;Fariza;885;437;448
49;Zamora;065;Fermoselle;2202;1086;1116
49;Zamora;066;Ferreras de Abajo;734;382;352
49;Zamora;067;Ferreras de Arriba;724;365;359
49;Zamora;068;Ferreruela;850;446;404
49;Zamora;069;Figueruela de Arriba;732;357;375
49;Zamora;071;Fonfría;1474;745;729
49;Zamora;075;Fresno de la Polvorosa;294;145;149
49;Zamora;076;Fresno de la Ribera;489;274;215
49;Zamora;077;Fresno de Sayago;416;208;208
49;Zamora;078;Friera de Valverde;375;187;188
49;Zamora;079;Fuente Encalada;226;118;108
49;Zamora;080;Fuentelapeña;1161;577;584
49;Zamora;082;Fuentes de Ropel;781;400;381
49;Zamora;081;Fuentesaúco;2080;1017;1063
49;Zamora;083;Fuentesecas;126;59;67
49;Zamora;084;Fuentespreadas;491;265;226
49;Zamora;085;Galende;1609;781;828
49;Zamora;086;Gallegos del Pan;237;120;117
49;Zamora;087;Gallegos del Río;1146;589;557
49;Zamora;088;Gamones;140;79;61
49;Zamora;090;Gema;373;184;189
49;Zamora;091;Granja de Moreruela;475;223;252
49;Zamora;092;Granucillo;378;194;184
49;Zamora;093;Guarrate;482;264;218
49;Zamora;094;Hermisende;621;300;321
49;Zamora;095;Hiniesta (La);447;224;223
49;Zamora;096;Jambrina;335;169;166
49;Zamora;097;Justel;275;143;132
49;Zamora;098;Losacino;448;237;211
49;Zamora;099;Losacio;198;105;93
49;Zamora;100;Lubián;537;256;281
49;Zamora;101;Luelmo;339;173;166
49;Zamora;102;Maderal (El);354;180;174
49;Zamora;103;Madridanos;647;352;295
49;Zamora;104;Mahide;713;358;355
49;Zamora;105;Maire de Castroponce;329;168;161
49;Zamora;107;Malva;327;154;173
49;Zamora;108;Manganeses de la Lampreana;1110;550;560
49;Zamora;109;Manganeses de la Polvorosa;1023;501;522
49;Zamora;110;Manzanal de Arriba;671;326;345
49;Zamora;112;Manzanal de los Infantes;260;127;133
49;Zamora;111;Manzanal del Barco;269;139;130
49;Zamora;113;Matilla de Arzón;390;203;187
49;Zamora;114;Matilla la Seca;107;54;53
49;Zamora;115;Mayalde;334;173;161
49;Zamora;116;Melgar de Tera;719;357;362
49;Zamora;117;Micereces de Tera;784;402;382
49;Zamora;118;Milles de la Polvorosa;331;166;165
49;Zamora;119;Molacillos;380;195;185
49;Zamora;120;Molezuelas de la Carballeda;210;105;105
49;Zamora;121;Mombuey;531;272;259
49;Zamora;122;Monfarracinos;608;322;286
49;Zamora;123;Montamarta;864;409;455
49;Zamora;124;Moral de Sayago;449;237;212
49;Zamora;126;Moraleja de Sayago;333;179;154
49;Zamora;125;Moraleja del Vino;1261;672;589
49;Zamora;128;Morales de Rey;861;433;428
49;Zamora;129;Morales de Toro;1237;608;629
49;Zamora;130;Morales de Valverde;424;207;217
49;Zamora;127;Morales del Vino;1092;575;517
49;Zamora;131;Moralina;412;212;200
49;Zamora;132;Moreruela de los Infanzones;562;299;263
49;Zamora;133;Moreruela de Tábara;664;337;327
49;Zamora;134;Muelas de los Caballeros;310;160;150
49;Zamora;135;Muelas del Pan;1016;509;507
49;Zamora;136;Muga de Sayago;547;265;282
49;Zamora;137;Navianos de Valverde;327;176;151
49;Zamora;138;Olmillos de Castro;659;342;317
49;Zamora;139;Otero de Bodas;355;182;173
49;Zamora;141;Pajares de la Lampreana;622;311;311
49;Zamora;143;Palacios de Sanabria;443;208;235
49;Zamora;142;Palacios del Pan;307;146;161
49;Zamora;145;Pedralba de la Pradería;545;278;267
49;Zamora;146;Pego (El);578;302;276
49;Zamora;147;Peleagonzalo;572;289;283
49;Zamora;148;Peleas de Abajo;230;120;110
49;Zamora;149;Peñausende;698;358;340
49;Zamora;150;Peque;309;143;166
49;Zamora;151;Perdigón (El);919;471;448
49;Zamora;152;Pereruela;958;473;485
49;Zamora;153;Perilla de Castro;416;208;208
49;Zamora;154;Pías;365;189;176
49;Zamora;155;Piedrahita de Castro;195;100;95
49;Zamora;156;Pinilla de Toro;503;240;263
49;Zamora;157;Pino del Oro;297;159;138
49;Zamora;158;Piñero (El);352;175;177
49;Zamora;160;Pobladura de Valderaduey;102;45;57
49;Zamora;159;Pobladura del Valle;436;202;234
49;Zamora;162;Porto;467;231;236
49;Zamora;163;Pozoantiguo;465;244;221
49;Zamora;164;Pozuelo de Tábara;317;160;157
49;Zamora;165;Prado;134;61;73
49;Zamora;166;Puebla de Sanabria;1785;862;923
49;Zamora;167;Pueblica de Valverde;442;224;218
49;Zamora;170;Quintanilla de Urz;174;94;80
49;Zamora;168;Quintanilla del Monte;194;99;95
49;Zamora;169;Quintanilla del Olmo;77;36;41
49;Zamora;171;Quiruelas de Vidriales;1159;576;583
49;Zamora;172;Rabanales;1114;571;543
49;Zamora;173;Rábano de Aliste;687;340;347
49;Zamora;174;Requejo;314;165;149
49;Zamora;175;Revellinos;431;226;205
49;Zamora;176;Riofrío de Aliste;1348;695;653
49;Zamora;177;Rionegro del Puente;528;245;283
49;Zamora;178;Roales;337;166;171
49;Zamora;179;Robleda-Cervantes;531;263;268
49;Zamora;180;Roelos de Sayago;216;108;108
49;Zamora;181;Rosinos de la Requejada;708;348;360
49;Zamora;183;Salce;189;95;94
49;Zamora;184;Samir de los Caños;304;156;148
49;Zamora;185;San Agustín del Pozo;252;135;117
49;Zamora;186;San Cebrián de Castro;501;246;255
49;Zamora;187;San Cristóbal de Entreviñas;1715;883;832
49;Zamora;188;San Esteban del Molar;267;137;130
49;Zamora;189;San Justo;479;229;250
49;Zamora;190;San Martín de Valderaduey;128;62;66
49;Zamora;191;San Miguel de la Ribera;520;262;258
49;Zamora;192;San Miguel del Valle;342;160;182
49;Zamora;193;San Pedro de Ceque;775;391;384
49;Zamora;194;San Pedro de la Nave-Almendra;611;310;301
49;Zamora;208;San Vicente de la Cabeza;842;432;410
49;Zamora;209;San Vitero;877;444;433
49;Zamora;197;Santa Clara de Avedillo;356;172;184
49;Zamora;199;Santa Colomba de las Monjas;389;197;192
49;Zamora;200;Santa Cristina de la Polvorosa;1353;684;669
49;Zamora;201;Santa Croya de Tera;607;301;306
49;Zamora;202;Santa Eufemia del Barco;411;213;198
49;Zamora;203;Santa María de la Vega;611;311;300
49;Zamora;204;Santa María de Valverde;146;84;62
49;Zamora;205;Santibáñez de Tera;744;384;360
49;Zamora;206;Santibáñez de Vidriales;1758;853;905
49;Zamora;207;Santovenia;591;299;292
49;Zamora;210;Sanzoles;848;422;426
49;Zamora;214;Tábara;1062;544;518
49;Zamora;216;Tapioles;283;155;128
49;Zamora;219;Toro;9723;4727;4996
49;Zamora;220;Torre del Valle (La);257;133;124
49;Zamora;221;Torregamones;433;211;222
49;Zamora;222;Torres del Carrizal;613;314;299
49;Zamora;223;Trabazos;1183;602;581
49;Zamora;224;Trefacio;262;125;137
49;Zamora;225;Uña de Quintana;328;165;163
49;Zamora;226;Vadillo de la Guareña;405;201;204
49;Zamora;227;Valcabado;329;171;158
49;Zamora;228;Valdefinjas;126;66;60
49;Zamora;229;Valdescorriel;232;111;121
49;Zamora;230;Vallesa de la Guareña;261;143;118
49;Zamora;231;Vega de Tera;704;336;368
49;Zamora;232;Vega de Villalobos;235;120;115
49;Zamora;233;Vegalatrave;205;108;97
49;Zamora;234;Venialbo;622;326;296
49;Zamora;235;Vezdemarbán;923;441;482
49;Zamora;236;Vidayanes;159;74;85
49;Zamora;237;Videmala;328;158;170
49;Zamora;238;Villabrázaro;543;275;268
49;Zamora;239;Villabuena del Puente;1220;625;595
49;Zamora;240;Villadepera;317;150;167
49;Zamora;241;Villaescusa;489;254;235
49;Zamora;242;Villafáfila;761;382;379
49;Zamora;243;Villaferrueña;226;114;112
49;Zamora;244;Villageriz;88;45;43
49;Zamora;245;Villalazán;433;224;209
49;Zamora;246;Villalba de la Lampreana;391;205;186
49;Zamora;247;Villalcampo;891;436;455
49;Zamora;248;Villalobos;420;196;224
49;Zamora;249;Villalonso;180;80;100
49;Zamora;250;Villalpando;1925;939;986
49;Zamora;251;Villalube;420;218;202
49;Zamora;252;Villamayor de Campos;811;394;417
49;Zamora;255;Villamor de los Escuderos;682;337;345
49;Zamora;256;Villanázar;467;225;242
49;Zamora;257;Villanueva de Azoague;458;233;225
49;Zamora;258;Villanueva de Campeán;224;110;114
49;Zamora;259;Villanueva de las Peras;262;129;133
49;Zamora;260;Villanueva del Campo;1320;648;672
49;Zamora;263;Villar de Fallaves;152;78;74
49;Zamora;264;Villar del Buey;1078;569;509
49;Zamora;261;Villaralbo;1465;731;734
49;Zamora;262;Villardeciervos;627;293;334
49;Zamora;265;Villardiegua de la Ribera;213;99;114
49;Zamora;266;Villárdiga;150;78;72
49;Zamora;267;Villardondiego;185;97;88
49;Zamora;268;Villarrín de Campos;773;374;399
49;Zamora;269;Villaseco del Pan;432;207;225
49;Zamora;270;Villavendimio;288;151;137
49;Zamora;272;Villaveza de Valverde;193;95;98
49;Zamora;271;Villaveza del Agua;330;176;154
49;Zamora;273;Viñas;359;181;178
49;Zamora;275;Zamora;62047;29647;32400
50;Zaragoza;001;Abanto;308;164;144
50;Zaragoza;002;Acered;371;191;180
50;Zaragoza;003;Agón;252;133;119
50;Zaragoza;004;Aguarón;793;389;404
50;Zaragoza;005;Aguilón;312;153;159
50;Zaragoza;006;Ainzón;1275;644;631
50;Zaragoza;007;Aladrén;52;23;29
50;Zaragoza;008;Alagón;5444;2706;2738
50;Zaragoza;009;Alarba;174;100;74
50;Zaragoza;010;Alberite de San Juan;116;60;56
50;Zaragoza;011;Albeta;155;74;81
50;Zaragoza;012;Alborge;129;58;71
50;Zaragoza;013;Alcalá de Ebro;368;184;184
50;Zaragoza;014;Alcalá de Moncayo;184;104;80
50;Zaragoza;015;Alconchel de Ariza;249;126;123
50;Zaragoza;016;Aldehuela de Liestos;86;45;41
50;Zaragoza;017;Alfajarín;1372;713;659
50;Zaragoza;018;Alfamén;1340;697;643
50;Zaragoza;019;Alforque;93;48;45
50;Zaragoza;020;Alhama de Aragón;1315;646;669
50;Zaragoza;021;Almochuel;67;35;32
50;Zaragoza;022;Almolda (La);776;378;398
50;Zaragoza;023;Almonacid de la Cuba;396;205;191
50;Zaragoza;024;Almonacid de la Sierra;893;461;432
50;Zaragoza;025;Almunia de Doña Godina (La);5035;2554;2481
50;Zaragoza;026;Alpartir;641;349;292
50;Zaragoza;027;Ambel;445;210;235
50;Zaragoza;028;Anento;30;19;11
50;Zaragoza;029;Aniñón;997;529;468
50;Zaragoza;030;Añón de Moncayo;362;209;153
50;Zaragoza;031;Aranda de Moncayo;284;153;131
50;Zaragoza;032;Arándiga;619;308;311
50;Zaragoza;033;Ardisa;90;42;48
50;Zaragoza;034;Ariza;1559;740;819
50;Zaragoza;035;Artieda;112;57;55
50;Zaragoza;036;Asín;114;58;56
50;Zaragoza;037;Atea;305;167;138
50;Zaragoza;038;Ateca;2202;1069;1133
50;Zaragoza;039;Azuara;866;455;411
50;Zaragoza;040;Badules;128;67;61
50;Zaragoza;041;Bagüés;13;5;8
50;Zaragoza;042;Balconchán;40;22;18
50;Zaragoza;043;Bárboles;395;207;188
50;Zaragoza;044;Bardallur;362;180;182
50;Zaragoza;045;Belchite;1754;889;865
50;Zaragoza;046;Belmonte de Gracián;393;216;177
50;Zaragoza;047;Berdejo;37;18;19
50;Zaragoza;048;Berrueco;39;23;16
50;Zaragoza;901;Biel;243;131;112
50;Zaragoza;050;Bijuesca;136;70;66
50;Zaragoza;051;Biota;1434;741;693
50;Zaragoza;052;Bisimbre;159;75;84
50;Zaragoza;053;Boquiñeni;1128;587;541
50;Zaragoza;054;Bordalba;122;66;56
50;Zaragoza;055;Borja;4120;2022;2098
50;Zaragoza;056;Botorrita;416;224;192
50;Zaragoza;057;Brea de Aragón;2095;1030;1065
50;Zaragoza;058;Bubierca;141;66;75
50;Zaragoza;059;Bujaraloz;1130;588;542
50;Zaragoza;060;Bulbuente;306;157;149
50;Zaragoza;061;Bureta;370;193;177
50;Zaragoza;062;Burgo de Ebro (El);1116;549;567
50;Zaragoza;063;Buste (El);158;80;78
50;Zaragoza;064;Cabañas de Ebro;583;294;289
50;Zaragoza;065;Cabolafuente;128;72;56
50;Zaragoza;066;Cadrete;859;438;421
50;Zaragoza;067;Calatayud;17745;8469;9276
50;Zaragoza;068;Calatorao;2834;1439;1395
50;Zaragoza;069;Calcena;100;51;49
50;Zaragoza;070;Calmarza;153;76;77
50;Zaragoza;071;Campillo de Aragón;242;131;111
50;Zaragoza;072;Carenas;279;140;139
50;Zaragoza;073;Cariñena;2948;1488;1460
50;Zaragoza;074;Caspe;8309;4109;4200
50;Zaragoza;075;Castejón de Alarba;154;88;66
50;Zaragoza;076;Castejón de las Armas;183;93;90
50;Zaragoza;077;Castejón de Valdejasa;436;236;200
50;Zaragoza;078;Castiliscar;493;247;246
50;Zaragoza;079;Cervera de la Cañada;401;200;201
50;Zaragoza;080;Cerveruela;4;2;2
50;Zaragoza;081;Cetina;876;448;428
50;Zaragoza;092;Chiprana;488;243;245
50;Zaragoza;093;Chodes;186;89;97
50;Zaragoza;082;Cimballa;151;78;73
50;Zaragoza;083;Cinco Olivas;156;80;76
50;Zaragoza;084;Clarés de Ribota;135;69;66
50;Zaragoza;085;Codo;392;197;195
50;Zaragoza;086;Codos;356;206;150
50;Zaragoza;087;Contamina;85;40;45
50;Zaragoza;088;Cosuenda;484;242;242
50;Zaragoza;089;Cuarte de Huerva;1261;655;606
50;Zaragoza;090;Cubel;298;153;145
50;Zaragoza;091;Cuerlas (Las);105;56;49
50;Zaragoza;094;Daroca;2540;1265;1275
50;Zaragoza;095;Ejea de los Caballeros;15630;7961;7669
50;Zaragoza;096;Embid de Ariza;103;55;48
50;Zaragoza;098;Encinacorba;344;183;161
50;Zaragoza;099;Épila;3793;1924;1869
50;Zaragoza;100;Erla;597;291;306
50;Zaragoza;101;Escatrón;1449;726;723
50;Zaragoza;102;Fabara;1419;748;671
50;Zaragoza;104;Farlete;495;247;248
50;Zaragoza;105;Fayón;448;222;226
50;Zaragoza;106;Fayos (Los);205;107;98
50;Zaragoza;107;Figueruelas;799;402;397
50;Zaragoza;108;Fombuena;10;7;3
50;Zaragoza;109;Frago (El);130;75;55
50;Zaragoza;110;Frasno (El);716;375;341
50;Zaragoza;111;Fréscano;309;150;159
50;Zaragoza;113;Fuendejalón;995;499;496
50;Zaragoza;114;Fuendetodos;171;94;77
50;Zaragoza;115;Fuentes de Ebro;3781;1963;1818
50;Zaragoza;116;Fuentes de Jiloca;449;234;215
50;Zaragoza;117;Gallocanta;210;110;100
50;Zaragoza;118;Gallur;3281;1654;1627
50;Zaragoza;119;Gelsa;1427;712;715
50;Zaragoza;120;Godojos;97;50;47
50;Zaragoza;121;Gotor;417;218;199
50;Zaragoza;122;Grisel;50;24;26
50;Zaragoza;123;Grisén;500;248;252
50;Zaragoza;124;Herrera de los Navarros;782;402;380
50;Zaragoza;125;Ibdes;665;348;317
50;Zaragoza;126;Illueca;3208;1582;1626
50;Zaragoza;128;Isuerre;62;35;27
50;Zaragoza;129;Jaraba;338;162;176
50;Zaragoza;130;Jarque;639;337;302
50;Zaragoza;131;Jaulín;310;154;156
50;Zaragoza;132;Joyosa (La);350;178;172
50;Zaragoza;133;Lagata;163;84;79
50;Zaragoza;134;Langa del Castillo;238;108;130
50;Zaragoza;135;Layana;204;102;102
50;Zaragoza;136;Lécera;1036;504;532
50;Zaragoza;138;Lechón;69;39;30
50;Zaragoza;137;Leciñena;1528;765;763
50;Zaragoza;139;Letux;506;263;243
50;Zaragoza;140;Litago;214;124;90
50;Zaragoza;141;Lituénigo;138;72;66
50;Zaragoza;142;Lobera de Onsella;76;48;28
50;Zaragoza;143;Longares;927;452;475
50;Zaragoza;144;Longás;24;18;6
50;Zaragoza;146;Lucena de Jalón;311;153;158
50;Zaragoza;147;Luceni;1159;576;583
50;Zaragoza;148;Luesia;510;275;235
50;Zaragoza;149;Luesma;28;14;14
50;Zaragoza;150;Lumpiaque;1075;549;526
50;Zaragoza;151;Luna;1070;555;515
50;Zaragoza;152;Maella;2276;1145;1131
50;Zaragoza;153;Magallón;1394;706;688
50;Zaragoza;154;Mainar;206;106;100
50;Zaragoza;155;Malanquilla;129;64;65
50;Zaragoza;156;Maleján;329;167;162
50;Zaragoza;160;Mallén;3019;1524;1495
50;Zaragoza;157;Malón;542;273;269
50;Zaragoza;159;Maluenda;1159;583;576
50;Zaragoza;161;Manchones;182;92;90
50;Zaragoza;162;Mara;279;143;136
50;Zaragoza;163;María de Huerva;719;359;360
50;Zaragoza;902;Marracos;"";"";""
50;Zaragoza;164;Mediana de Aragón;563;280;283
50;Zaragoza;165;Mequinenza;2799;1405;1394
50;Zaragoza;166;Mesones de Isuela;489;243;246
50;Zaragoza;167;Mezalocha;340;184;156
50;Zaragoza;168;Mianos;50;24;26
50;Zaragoza;169;Miedes de Aragón;629;318;311
50;Zaragoza;170;Monegrillo;593;325;268
50;Zaragoza;171;Moneva;94;42;52
50;Zaragoza;172;Monreal de Ariza;390;202;188
50;Zaragoza;173;Monterde;243;122;121
50;Zaragoza;174;Montón;183;90;93
50;Zaragoza;175;Morata de Jalón;1834;906;928
50;Zaragoza;176;Morata de Jiloca;432;221;211
50;Zaragoza;177;Morés;610;308;302
50;Zaragoza;178;Moros;694;354;340
50;Zaragoza;179;Moyuela;469;243;226
50;Zaragoza;180;Mozota;143;65;78
50;Zaragoza;181;Muel;1273;634;639
50;Zaragoza;182;Muela (La);964;503;461
50;Zaragoza;183;Munébrega;596;306;290
50;Zaragoza;184;Murero;181;99;82
50;Zaragoza;185;Murillo de Gállego;156;87;69
50;Zaragoza;186;Navardún;96;52;44
50;Zaragoza;187;Nigüella;146;72;74
50;Zaragoza;188;Nombrevilla;40;20;20
50;Zaragoza;189;Nonaspe;1172;592;580
50;Zaragoza;190;Novallas;855;416;439
50;Zaragoza;191;Novillas;782;404;378
50;Zaragoza;192;Nuévalos;321;174;147
50;Zaragoza;193;Nuez de Ebro;477;250;227
50;Zaragoza;194;Olvés;222;114;108
50;Zaragoza;195;Orcajo;50;23;27
50;Zaragoza;196;Orera;172;93;79
50;Zaragoza;197;Orés;145;81;64
50;Zaragoza;198;Oseja;19;10;9
50;Zaragoza;199;Osera de Ebro;346;156;190
50;Zaragoza;200;Paniza;800;392;408
50;Zaragoza;201;Paracuellos de Jiloca;558;260;298
50;Zaragoza;202;Paracuellos de la Ribera;402;191;211
50;Zaragoza;203;Pastriz;730;354;376
50;Zaragoza;204;Pedrola;2390;1216;1174
50;Zaragoza;205;Pedrosas (Las);105;52;53
50;Zaragoza;206;Perdiguera;528;272;256
50;Zaragoza;207;Piedratajada;270;132;138
50;Zaragoza;208;Pina de Ebro;2212;1100;1112
50;Zaragoza;209;Pinseque;1353;676;677
50;Zaragoza;210;Pintanos (Los);75;44;31
50;Zaragoza;211;Plasencia de Jalón;415;213;202
50;Zaragoza;212;Pleitas;89;44;45
50;Zaragoza;213;Plenas;182;88;94
50;Zaragoza;214;Pomer;30;13;17
50;Zaragoza;215;Pozuel de Ariza;37;22;15
50;Zaragoza;216;Pozuelo de Aragón;420;223;197
50;Zaragoza;217;Pradilla de Ebro;748;397;351
50;Zaragoza;218;Puebla de Albortón;182;92;90
50;Zaragoza;219;Puebla de Alfindén (La);1441;731;710
50;Zaragoza;220;Puendeluna;65;33;32
50;Zaragoza;221;Purujosa;8;6;2
50;Zaragoza;222;Quinto;2290;1144;1146
50;Zaragoza;223;Remolinos;1366;690;676
50;Zaragoza;224;Retascón;83;45;38
50;Zaragoza;225;Ricla;2259;1179;1080
50;Zaragoza;227;Romanos;175;95;80
50;Zaragoza;228;Rueda de Jalón;402;213;189
50;Zaragoza;229;Ruesca;99;52;47
50;Zaragoza;241;Sabiñán;1161;567;594
50;Zaragoza;230;Sádaba;1989;995;994
50;Zaragoza;231;Salillas de Jalón;445;221;224
50;Zaragoza;232;Salvatierra de Esca;367;199;168
50;Zaragoza;233;Samper del Salz;86;39;47
50;Zaragoza;234;San Martín de la Virgen de Moncayo;328;175;153
50;Zaragoza;235;San Mateo de Gállego;1839;953;886
50;Zaragoza;236;Santa Cruz de Grío;273;157;116
50;Zaragoza;237;Santa Cruz de Moncayo;103;55;48
50;Zaragoza;238;Santa Eulalia de Gállego;137;73;64
50;Zaragoza;239;Santed;93;44;49
50;Zaragoza;240;Sástago;1718;866;852
50;Zaragoza;242;Sediles;116;63;53
50;Zaragoza;243;Sestrica;594;303;291
50;Zaragoza;244;Sierra de Luna;332;170;162
50;Zaragoza;245;Sigüés;188;101;87
50;Zaragoza;246;Sisamón;130;74;56
50;Zaragoza;247;Sobradiel;574;269;305
50;Zaragoza;248;Sos del Rey Católico;988;501;487
50;Zaragoza;249;Tabuenca;557;289;268
50;Zaragoza;250;Talamantes;58;30;28
50;Zaragoza;251;Tarazona;10998;5292;5706
50;Zaragoza;252;Tauste;7226;3621;3605
50;Zaragoza;253;Terrer;811;377;434
50;Zaragoza;254;Tierga;320;171;149
50;Zaragoza;255;Tobed;348;174;174
50;Zaragoza;256;Torralba de los Frailes;137;69;68
50;Zaragoza;257;Torralba de Ribota;281;152;129
50;Zaragoza;258;Torralbilla;86;47;39
50;Zaragoza;259;Torrehermosa;145;73;72
50;Zaragoza;260;Torrelapaja;82;42;40
50;Zaragoza;261;Torrellas;382;189;193
50;Zaragoza;262;Torres de Berrellén;1456;742;714
50;Zaragoza;263;Torrijo de la Cañada;551;296;255
50;Zaragoza;264;Tosos;291;155;136
50;Zaragoza;265;Trasmoz;86;43;43
50;Zaragoza;266;Trasobares;323;169;154
50;Zaragoza;267;Uncastillo;934;470;464
50;Zaragoza;268;Undués de Lerda;48;24;24
50;Zaragoza;269;Urrea de Jalón;421;201;220
50;Zaragoza;270;Urriés;88;49;39
50;Zaragoza;271;Used;503;252;251
50;Zaragoza;272;Utebo;7182;3595;3587
50;Zaragoza;274;Val de San Martín;88;39;49
50;Zaragoza;273;Valdehorna;90;49;41
50;Zaragoza;275;Valmadrid;82;43;39
50;Zaragoza;276;Valpalmas;257;134;123
50;Zaragoza;277;Valtorres;148;71;77
50;Zaragoza;278;Velilla de Ebro;327;162;165
50;Zaragoza;279;Velilla de Jiloca;165;84;81
50;Zaragoza;280;Vera de Moncayo;560;280;280
50;Zaragoza;281;Vierlas;119;59;60
50;Zaragoza;283;Villadoz;116;62;54
50;Zaragoza;284;Villafeliche;283;143;140
50;Zaragoza;285;Villafranca de Ebro;690;337;353
50;Zaragoza;286;Villalba de Perejil;109;53;56
50;Zaragoza;287;Villalengua;537;286;251
50;Zaragoza;288;Villanueva de Gállego;2485;1250;1235
50;Zaragoza;290;Villanueva de Huerva;734;363;371
50;Zaragoza;289;Villanueva de Jiloca;155;85;70
50;Zaragoza;291;Villar de los Navarros;237;117;120
50;Zaragoza;292;Villarreal de Huerva;201;120;81
50;Zaragoza;293;Villarroya de la Sierra;889;441;448
50;Zaragoza;294;Villarroya del Campo;82;46;36
50;Zaragoza;282;Vilueña (La);138;66;72
50;Zaragoza;295;Vistabella;42;19;23
50;Zaragoza;296;Zaida (La);710;354;356
50;Zaragoza;297;Zaragoza;582239;281621;300618
50;Zaragoza;298;Zuera;5268;2676;2592
51;Ceuta;001;Ceuta;67188;33132;34056
52;Melilla;001;Melilla;55717;27788;27929
