01;Álava;001;Alegría-Dulantzi;1037;538;499
01;Álava;002;Amurrio;9890;4929;4961
01;Álava;049;Añana;192;101;91
01;Álava;003;Aramaio;1314;677;637
01;Álava;006;Armiñón;131;70;61
01;Álava;037;Arraia-Maeztu;709;367;342
01;Álava;008;Arrazua-Ubarrundia;688;365;323
01;Álava;004;Artziniega;1302;639;663
01;Álava;009;Asparrena;1528;765;763
01;Álava;010;Ayala/Aiara;2082;1033;1049
01;Álava;011;Baños de Ebro/Mañueta;336;182;154
01;Álava;013;Barrundia;569;319;250
01;Álava;014;Berantevilla;416;210;206
01;Álava;016;Bernedo;542;312;230
01;Álava;017;Campezo/Kanpezu;1142;603;539
01;Álava;021;Elburgo/Burgelu;210;116;94
01;Álava;022;Elciego;941;466;475
01;Álava;023;Elvillar/Bilar;359;189;170
01;Álava;056;Harana/Valle de Arana;387;211;176
01;Álava;901;Iruña Oka/Iruña de Oca;1588;826;762
01;Álava;027;Iruraiz-Gauna;422;229;193
01;Álava;019;Kripan;198;102;96
01;Álava;020;Kuartango;358;198;160
01;Álava;028;Labastida;1026;557;469
01;Álava;030;Lagrán;193;104;89
01;Álava;031;Laguardia;1455;757;698
01;Álava;032;Lanciego/Lantziego;635;341;294
01;Álava;902;Lantarón;832;443;389
01;Álava;033;Lapuebla de Labarca;833;415;418
01;Álava;058;Legutiano;1261;688;573
01;Álava;034;Leza;200;110;90
01;Álava;036;Llodio;20303;10213;10090
01;Álava;039;Moreda de Álava;289;157;132
01;Álava;041;Navaridas;217;115;102
01;Álava;042;Okondo;744;381;363
01;Álava;043;Oyón/Oion;2167;1090;1077
01;Álava;044;Peñacerrada-Urizaharra;246;137;109
01;Álava;046;Ribera Alta;526;304;222
01;Álava;047;Ribera Baja/Erribera Beitia;431;238;193
01;Álava;051;Salvatierra/Agurain;3818;1912;1906
01;Álava;052;Samaniego;281;140;141
01;Álava;053;San Millán/Donemiliaga;700;379;321
01;Álava;054;Urkabustaiz;866;460;406
01;Álava;055;Valdegovía;862;489;373
01;Álava;057;Villabuena de Álava/Eskuernaga;360;181;179
01;Álava;059;Vitoria-Gasteiz;214148;105609;108539
01;Álava;060;Yécora/Lekora;242;119;123
01;Álava;061;Zalduondo;130;71;59
01;Álava;062;Zambrana;338;182;156
01;Álava;018;Zigoitia;915;499;416
01;Álava;063;Zuia;1344;684;660
02;Albacete;001;Abengibre;1020;513;507
02;Albacete;002;Alatoz;746;385;361
02;Albacete;003;Albacete;141179;69066;72113
02;Albacete;004;Albatana;923;473;450
02;Albacete;005;Alborea;792;416;376
02;Albacete;006;Alcadozo;809;409;400
02;Albacete;007;Alcalá del Júcar;1642;827;815
02;Albacete;008;Alcaraz;1937;932;1005
02;Albacete;009;Almansa;23389;11510;11879
02;Albacete;010;Alpera;2364;1211;1153
02;Albacete;011;Ayna;1111;573;538
02;Albacete;012;Balazote;2260;1131;1129
02;Albacete;014;Ballestero (El);645;323;322
02;Albacete;013;Balsa de Ves;268;144;124
02;Albacete;015;Barrax;2009;1009;1000
02;Albacete;016;Bienservida;926;473;453
02;Albacete;017;Bogarra;1539;810;729
02;Albacete;018;Bonete;1282;659;623
02;Albacete;019;Bonillo (El);3330;1698;1632
02;Albacete;020;Carcelén;759;394;365
02;Albacete;021;Casas de Juan Núñez;1311;673;638
02;Albacete;022;Casas de Lázaro;498;255;243
02;Albacete;023;Casas de Ves;1001;515;486
02;Albacete;024;Casas-Ibáñez;4041;2036;2005
02;Albacete;025;Caudete;8567;4262;4305
02;Albacete;026;Cenizate;1079;559;520
02;Albacete;029;Chinchilla de Monte-Aragón;3278;1704;1574
02;Albacete;027;Corral-Rubio;495;257;238
02;Albacete;028;Cotillas;261;130;131
02;Albacete;030;Elche de la Sierra;3990;1988;2002
02;Albacete;032;Fuensanta;431;210;221
02;Albacete;033;Fuente-Álamo;2491;1259;1232
02;Albacete;034;Fuentealbilla;1890;956;934
02;Albacete;031;Férez;865;428;437
02;Albacete;035;Gineta (La);2128;1046;1082
02;Albacete;036;Golosalvo;130;66;64
02;Albacete;037;Hellín;26173;12930;13243
02;Albacete;038;Herrera (La);451;235;216
02;Albacete;039;Higueruela;1302;642;660
02;Albacete;040;Hoya-Gonzalo;763;384;379
02;Albacete;041;Jorquera;662;356;306
02;Albacete;042;Letur;1411;707;704
02;Albacete;043;Lezuza;1969;1022;947
02;Albacete;044;Liétor;1861;955;906
02;Albacete;045;Madrigueras;4508;2261;2247
02;Albacete;046;Mahora;1383;680;703
02;Albacete;047;Masegoso;231;129;102
02;Albacete;048;Minaya;1965;1002;963
02;Albacete;049;Molinicos;1625;847;778
02;Albacete;050;Montalvos;151;71;80
02;Albacete;051;Montealegre del Castillo;2134;1074;1060
02;Albacete;052;Motilleja;554;281;273
02;Albacete;053;Munera;4095;2069;2026
02;Albacete;054;Navas de Jorquera;604;316;288
02;Albacete;055;Nerpio;2006;1057;949
02;Albacete;056;Ontur;2525;1263;1262
02;Albacete;057;Ossa de Montiel;2907;1450;1457
02;Albacete;058;Paterna del Madera;662;349;313
02;Albacete;060;Peñas de San Pedro;1323;687;636
02;Albacete;059;Peñascosa;467;247;220
02;Albacete;061;Pétrola;1027;519;508
02;Albacete;062;Povedilla;773;401;372
02;Albacete;064;Pozo-Lorente;533;257;276
02;Albacete;063;Pozohondo;2000;1032;968
02;Albacete;065;Pozuelo;706;357;349
02;Albacete;066;Recueja (La);381;194;187
02;Albacete;067;Riópar;1382;717;665
02;Albacete;068;Robledo;501;256;245
02;Albacete;069;Roda (La);13479;6760;6719
02;Albacete;070;Salobre;672;349;323
02;Albacete;071;San Pedro;1333;681;652
02;Albacete;072;Socovos;2161;1117;1044
02;Albacete;073;Tarazona de la Mancha;5912;2962;2950
02;Albacete;074;Tobarra;7454;3710;3744
02;Albacete;075;Valdeganga;2139;1082;1057
02;Albacete;076;Vianos;541;272;269
02;Albacete;077;Villa de Ves;61;31;30
02;Albacete;078;Villalgordo del Júcar;1308;649;659
02;Albacete;079;Villamalea;3380;1744;1636
02;Albacete;080;Villapalacios;995;502;493
02;Albacete;081;Villarrobledo;22214;10909;11305
02;Albacete;082;Villatoya;214;117;97
02;Albacete;083;Villavaliente;314;165;149
02;Albacete;084;Villaverde de Guadalimar;615;330;285
02;Albacete;085;Viveros;640;335;305
02;Albacete;086;Yeste;4773;2457;2316
03;Alicante/Alacant;001;Adsubia;537;265;272
03;Alicante/Alacant;002;Agost;4022;2029;1993
03;Alicante/Alacant;003;Agres;657;342;315
03;Alicante/Alacant;004;Aigües;469;239;230
03;Alicante/Alacant;005;Albatera;8338;4165;4173
03;Alicante/Alacant;006;Alcalalí;824;410;414
03;Alicante/Alacant;007;Alcocer de Planes;131;60;71
03;Alicante/Alacant;008;Alcoleja;290;136;154
03;Alicante/Alacant;009;Alcoy/Alcoi;64291;30907;33384
03;Alicante/Alacant;010;Alfafara;390;182;208
03;Alicante/Alacant;011;Alfàs del Pi (L');10289;5043;5246
03;Alicante/Alacant;012;Algorfa;1072;540;532
03;Alicante/Alacant;013;Algueña;1467;719;748
03;Alicante/Alacant;014;Alicante/Alacant;274964;132559;142405
03;Alicante/Alacant;015;Almoradí;13124;6511;6613
03;Alicante/Alacant;016;Almudaina;132;64;68
03;Alicante/Alacant;017;Alquería d'Asnar (L');412;200;212
03;Alicante/Alacant;018;Altea;13361;6615;6746
03;Alicante/Alacant;019;Aspe;16359;8141;8218
03;Alicante/Alacant;020;Balones;158;69;89
03;Alicante/Alacant;021;Banyeres de Mariola;7064;3499;3565
03;Alicante/Alacant;022;Benasau;214;103;111
03;Alicante/Alacant;023;Beneixama;1829;902;927
03;Alicante/Alacant;024;Benejúzar;4786;2402;2384
03;Alicante/Alacant;025;Benferri;998;506;492
03;Alicante/Alacant;026;Beniarbeig;1188;588;600
03;Alicante/Alacant;027;Beniardá;231;110;121
03;Alicante/Alacant;028;Beniarrés;1482;749;733
03;Alicante/Alacant;030;Benidoleig;769;382;387
03;Alicante/Alacant;031;Benidorm;46493;22935;23558
03;Alicante/Alacant;032;Benifallim;162;84;78
03;Alicante/Alacant;033;Benifato;122;63;59
03;Alicante/Alacant;029;Benigembla;349;174;175
03;Alicante/Alacant;034;Benijófar;1563;757;806
03;Alicante/Alacant;035;Benilloba;949;478;471
03;Alicante/Alacant;036;Benillup;87;47;40
03;Alicante/Alacant;037;Benimantell;445;207;238
03;Alicante/Alacant;038;Benimarfull;412;185;227
03;Alicante/Alacant;039;Benimassot;113;57;56
03;Alicante/Alacant;040;Benimeli;329;162;167
03;Alicante/Alacant;041;Benissa;8039;3993;4046
03;Alicante/Alacant;042;Benitachell/Poble Nou de Benitatxell (el);1662;839;823
03;Alicante/Alacant;043;Biar;3571;1724;1847
03;Alicante/Alacant;044;Bigastro;4611;2369;2242
03;Alicante/Alacant;045;Bolulla;275;137;138
03;Alicante/Alacant;046;Busot;1158;583;575
03;Alicante/Alacant;048;Callosa d'En Sarrià;7645;3798;3847
03;Alicante/Alacant;049;Callosa de Segura;15823;7886;7937
03;Alicante/Alacant;047;Calpe/Calp;11251;5673;5578
03;Alicante/Alacant;050;Campello (El);13036;6463;6573
03;Alicante/Alacant;051;Campo de Mirra/Camp de Mirra (el);380;184;196
03;Alicante/Alacant;053;Castalla;7542;3724;3818
03;Alicante/Alacant;054;Castell de Castells;523;261;262
03;Alicante/Alacant;055;Catral;4637;2315;2322
03;Alicante/Alacant;052;Cañada;1104;532;572
03;Alicante/Alacant;056;Cocentaina;10664;5219;5445
03;Alicante/Alacant;057;Confrides;296;164;132
03;Alicante/Alacant;058;Cox;5969;3002;2967
03;Alicante/Alacant;059;Crevillent;23626;11879;11747
03;Alicante/Alacant;061;Daya Nueva;1174;595;579
03;Alicante/Alacant;062;Daya Vieja;202;101;101
03;Alicante/Alacant;064;Dolores;6135;3088;3047
03;Alicante/Alacant;063;Dénia;27121;13210;13911
03;Alicante/Alacant;065;Elche/Elx;191305;94860;96445
03;Alicante/Alacant;066;Elda;55563;27164;28399
03;Alicante/Alacant;067;Facheca;132;71;61
03;Alicante/Alacant;068;Famorca;67;32;35
03;Alicante/Alacant;069;Finestrat;1424;703;721
03;Alicante/Alacant;070;Formentera del Segura;1988;982;1006
03;Alicante/Alacant;072;Gaianes;332;160;172
03;Alicante/Alacant;071;Gata de Gorgos;5058;2513;2545
03;Alicante/Alacant;073;Gorga;289;143;146
03;Alicante/Alacant;074;Granja de Rocamora;1998;1021;977
03;Alicante/Alacant;075;Guadalest;161;83;78
03;Alicante/Alacant;076;Guardamar del Segura;7452;3689;3763
03;Alicante/Alacant;077;Hondón de las Nieves;1479;734;745
03;Alicante/Alacant;078;Hondón de los Frailes;546;266;280
03;Alicante/Alacant;079;Ibi;21060;10479;10581
03;Alicante/Alacant;080;Jacarilla;1476;748;728
03;Alicante/Alacant;081;Jalón/Xaló;1970;972;998
03;Alicante/Alacant;083;Jijona/Xixona;7872;3712;4160
03;Alicante/Alacant;082;Jávea/Xàbia;16792;8393;8399
03;Alicante/Alacant;085;Llíber;500;243;257
03;Alicante/Alacant;084;Lorcha/Orxa (L');819;416;403
03;Alicante/Alacant;086;Millena;130;62;68
03;Alicante/Alacant;088;Monforte del Cid;5164;2669;2495
03;Alicante/Alacant;903;Montesinos (Los);2365;1209;1156
03;Alicante/Alacant;089;Monóvar/Monòver;12076;5874;6202
03;Alicante/Alacant;091;Murla;333;143;190
03;Alicante/Alacant;092;Muro de Alcoy;6803;3372;3431
03;Alicante/Alacant;090;Mutxamel;11329;5689;5640
03;Alicante/Alacant;093;Novelda;23011;11254;11757
03;Alicante/Alacant;094;Nucia (la);6522;3232;3290
03;Alicante/Alacant;095;Ondara;5105;2537;2568
03;Alicante/Alacant;096;Onil;6749;3367;3382
03;Alicante/Alacant;097;Orba;1591;763;828
03;Alicante/Alacant;099;Orihuela;51765;25546;26219
03;Alicante/Alacant;098;Orxeta;513;260;253
03;Alicante/Alacant;100;Parcent;732;353;379
03;Alicante/Alacant;101;Pedreguer;5700;2774;2926
03;Alicante/Alacant;102;Pego;9403;4654;4749
03;Alicante/Alacant;103;Penàguila;351;173;178
03;Alicante/Alacant;104;Petrer;25740;12834;12906
03;Alicante/Alacant;902;Pilar de la Horadada;8549;4342;4207
03;Alicante/Alacant;105;Pinoso;5866;2918;2948
03;Alicante/Alacant;106;Planes;805;406;399
03;Alicante/Alacant;901;Poblets (Els);1089;523;566
03;Alicante/Alacant;107;Polop;1857;922;935
03;Alicante/Alacant;060;Quatretondeta;192;96;96
03;Alicante/Alacant;109;Rafal;2829;1405;1424
03;Alicante/Alacant;111;Redován;5143;2629;2514
03;Alicante/Alacant;112;Relleu;823;412;411
03;Alicante/Alacant;113;Rojales;5687;2841;2846
03;Alicante/Alacant;114;Romana (La);1943;984;959
03;Alicante/Alacant;110;Ràfol d'Almúnia (El);369;178;191
03;Alicante/Alacant;115;Sagra;372;187;185
03;Alicante/Alacant;116;Salinas;1172;603;569
03;Alicante/Alacant;118;San Fulgencio;2298;1166;1132
03;Alicante/Alacant;904;San Isidro;"";"";""
03;Alicante/Alacant;120;San Miguel de Salinas;3112;1597;1515
03;Alicante/Alacant;122;San Vicente del Raspeig/Sant Vicent del Raspeig;33250;16500;16750
03;Alicante/Alacant;117;Sanet y Negrals;542;243;299
03;Alicante/Alacant;119;Sant Joan d'Alacant;15269;7597;7672
03;Alicante/Alacant;121;Santa Pola;16508;8213;8295
03;Alicante/Alacant;123;Sax;8614;4314;4300
03;Alicante/Alacant;124;Sella;592;311;281
03;Alicante/Alacant;125;Senija;474;243;231
03;Alicante/Alacant;128;Teulada;5681;2783;2898
03;Alicante/Alacant;129;Tibi;1076;542;534
03;Alicante/Alacant;130;Tollos;36;22;14
03;Alicante/Alacant;131;Tormos;288;143;145
03;Alicante/Alacant;132;Torremanzanas/Torre de les Maçanes (la);756;361;395
03;Alicante/Alacant;133;Torrevieja;29955;14716;15239
03;Alicante/Alacant;127;Tárbena;701;354;347
03;Alicante/Alacant;134;Vall d'Alcalà (La);193;94;99
03;Alicante/Alacant;135;Vall de Ebo;342;172;170
03;Alicante/Alacant;136;Vall de Gallinera;732;377;355
03;Alicante/Alacant;137;Vall de Laguar (La);950;461;489
03;Alicante/Alacant;138;Verger (El);3676;1784;1892
03;Alicante/Alacant;139;Villajoyosa/Vila Joiosa (La);23372;11574;11798
03;Alicante/Alacant;140;Villena;31371;15497;15874
04;Almería;001;Abla;1597;769;828
04;Almería;002;Abrucena;1476;706;770
04;Almería;003;Adra;20979;10509;10470
04;Almería;004;Albánchez;686;343;343
04;Almería;005;Alboloduy;857;393;464
04;Almería;006;Albox;10236;5094;5142
04;Almería;007;Alcolea;842;420;422
04;Almería;008;Alcóntar;646;327;319
04;Almería;009;Alcudia de Monteagud;206;96;110
04;Almería;010;Alhabia;744;371;373
04;Almería;011;Alhama de Almería;3124;1552;1572
04;Almería;012;Alicún;242;113;129
04;Almería;013;Almería;167361;81158;86203
04;Almería;014;Almócita;179;95;84
04;Almería;015;Alsodux;123;55;68
04;Almería;016;Antas;2595;1273;1322
04;Almería;017;Arboleas;1537;783;754
04;Almería;018;Armuña de Almanzora;365;172;193
04;Almería;019;Bacares;300;166;134
04;Almería;020;Bayárcal;388;210;178
04;Almería;021;Bayarque;233;109;124
04;Almería;022;Bédar;515;280;235
04;Almería;023;Beires;133;62;71
04;Almería;024;Benahadux;2514;1220;1294
04;Almería;026;Benitagla;105;55;50
04;Almería;027;Benizalón;308;160;148
04;Almería;028;Bentarique;347;177;170
04;Almería;029;Berja;12731;6330;6401
04;Almería;030;Canjáyar;1770;893;877
04;Almería;031;Cantoria;3342;1693;1649
04;Almería;032;Carboneras;6075;3138;2937
04;Almería;033;Castro de Filabres;150;71;79
04;Almería;036;Chercos;304;150;154
04;Almería;037;Chirivel;2005;995;1010
04;Almería;034;Cóbdar;269;134;135
04;Almería;035;Cuevas del Almanzora;9341;4675;4666
04;Almería;038;Dalías;3626;1792;1834
04;Almería;039;Darrical;306;155;151
04;Almería;902;Ejido (El);44373;22542;21831
04;Almería;041;Enix;247;119;128
04;Almería;043;Felix;591;292;299
04;Almería;044;Fines;1682;870;812
04;Almería;045;Fiñana;2700;1325;1375
04;Almería;046;Fondón;937;481;456
04;Almería;047;Gádor;2592;1271;1321
04;Almería;048;Gallardos (Los);1670;844;826
04;Almería;049;Garrucha;4591;2354;2237
04;Almería;050;Gérgal;1085;530;555
04;Almería;051;Huécija;557;283;274
04;Almería;052;Huércal de Almería;4157;2081;2076
04;Almería;053;Huércal-Overa;13814;6827;6987
04;Almería;054;Illar;477;229;248
04;Almería;055;Instinción;595;280;315
04;Almería;056;Laroya;124;65;59
04;Almería;057;Láujar de Andarax;1864;928;936
04;Almería;058;Líjar;528;265;263
04;Almería;059;Lubrín;1938;924;1014
04;Almería;060;Lucainena de las Torres;552;271;281
04;Almería;061;Lúcar;754;374;380
04;Almería;062;Macael;6086;3085;3001
04;Almería;063;María;1737;887;850
04;Almería;064;Mojácar;3731;1831;1900
04;Almería;903;Mojonera (La);5852;2988;2864
04;Almería;065;Nacimiento;483;240;243
04;Almería;066;Níjar;14053;7202;6851
04;Almería;067;Ohanes;860;432;428
04;Almería;068;Olula de Castro;233;116;117
04;Almería;069;Olula del Río;5841;2919;2922
04;Almería;070;Oria;2367;1196;1171
04;Almería;071;Padules;506;259;247
04;Almería;072;Partaloa;388;191;197
04;Almería;073;Paterna del Río;344;177;167
04;Almería;074;Pechina;2422;1195;1227
04;Almería;075;Pulpí;4887;2478;2409
04;Almería;076;Purchena;1735;853;882
04;Almería;077;Rágol;420;200;220
04;Almería;078;Rioja;1174;583;591
04;Almería;079;Roquetas de Mar;33306;16878;16428
04;Almería;080;Santa Cruz de Marchena;199;95;104
04;Almería;081;Santa Fe de Mondújar;420;204;216
04;Almería;082;Senés;368;190;178
04;Almería;083;Serón;2992;1509;1483
04;Almería;084;Sierro;561;291;270
04;Almería;085;Somontín;505;257;248
04;Almería;086;Sorbas;2752;1377;1375
04;Almería;087;Suflí;246;122;124
04;Almería;088;Tabernas;3155;1592;1563
04;Almería;089;Taberno;1040;514;526
04;Almería;090;Tahal;499;245;254
04;Almería;091;Terque;449;222;227
04;Almería;092;Tíjola;3716;1877;1839
04;Almería;901;Tres Villas (Las);799;414;385
04;Almería;093;Turre;2188;1074;1114
04;Almería;094;Turrillas;278;147;131
04;Almería;095;Uleila del Campo;1026;516;510
04;Almería;096;Urrácal;337;165;172
04;Almería;097;Velefique;343;182;161
04;Almería;098;Vélez-Blanco;2303;1162;1141
04;Almería;099;Vélez-Rubio;6544;3173;3371
04;Almería;100;Vera;6431;3206;3225
04;Almería;101;Viator;2922;1417;1505
04;Almería;102;Vícar;12932;6631;6301
04;Almería;103;Zurgena;2190;1083;1107
05;Ávila;001;Adanero;352;182;170
05;Ávila;002;Adrada (La);2015;1040;975
05;Ávila;005;Albornos;300;160;140
05;Ávila;007;Aldeanueva de Santa Cruz;208;112;96
05;Ávila;008;Aldeaseca;401;195;206
05;Ávila;010;Aldehuela (La);307;157;150
05;Ávila;012;Amavida;211;104;107
05;Ávila;013;Arenal (El);1121;553;568
05;Ávila;014;Arenas de San Pedro;6683;3342;3341
05;Ávila;015;Arevalillo;169;85;84
05;Ávila;016;Arévalo;7438;3599;3839
05;Ávila;017;Aveinte;154;80;74
05;Ávila;018;Avellaneda;54;24;30
05;Ávila;019;Ávila;49639;24062;25577
05;Ávila;021;Barco de Ávila (El);2639;1314;1325
05;Ávila;022;Barraco (El);2039;1022;1017
05;Ávila;023;Barromán;279;155;124
05;Ávila;024;Becedas;529;282;247
05;Ávila;025;Becedillas;180;99;81
05;Ávila;026;Bercial de Zapardiel;366;173;193
05;Ávila;027;Berlanas (Las);391;194;197
05;Ávila;029;Bernuy-Zapardiel;290;159;131
05;Ávila;030;Berrocalejo de Aragona;42;21;21
05;Ávila;033;Blascomillán;342;163;179
05;Ávila;034;Blasconuño de Matacabras;33;20;13
05;Ávila;035;Blascosancho;168;87;81
05;Ávila;036;Bohodón (El);215;108;107
05;Ávila;037;Bohoyo;533;277;256
05;Ávila;038;Bonilla de la Sierra;209;115;94
05;Ávila;039;Brabos;78;44;34
05;Ávila;040;Bularros;140;76;64
05;Ávila;041;Burgohondo;1362;695;667
05;Ávila;042;Cabezas de Alambre;286;148;138
05;Ávila;043;Cabezas del Pozo;208;105;103
05;Ávila;044;Cabezas del Villar;547;297;250
05;Ávila;045;Cabizuela;162;81;81
05;Ávila;046;Canales;88;43;45
05;Ávila;047;Candeleda;5382;2723;2659
05;Ávila;048;Cantiveros;210;108;102
05;Ávila;049;Cardeñosa;574;295;279
05;Ávila;051;Carrera (La);342;167;175
05;Ávila;052;Casas del Puerto de Villatoro;124;66;58
05;Ávila;053;Casasola;185;97;88
05;Ávila;054;Casavieja;1629;860;769
05;Ávila;055;Casillas;999;518;481
05;Ávila;056;Castellanos de Zapardiel;161;88;73
05;Ávila;057;Cebreros;3656;1832;1824
05;Ávila;058;Cepeda la Mora;169;92;77
05;Ávila;067;Chamartín;124;66;58
05;Ávila;059;Cillán;165;84;81
05;Ávila;060;Cisla;234;112;122
05;Ávila;061;Colilla (La);210;107;103
05;Ávila;062;Collado de Contreras;286;151;135
05;Ávila;063;Collado del Mirón;115;61;54
05;Ávila;064;Constanzana;217;113;104
05;Ávila;065;Crespos;806;430;376
05;Ávila;066;Cuevas del Valle;664;357;307
05;Ávila;903;Diego del Carpio;386;209;177
05;Ávila;069;Donjimeno;153;78;75
05;Ávila;070;Donvidas;79;37;42
05;Ávila;072;Espinosa de los Caballeros;118;65;53
05;Ávila;073;Flores de Ávila;488;257;231
05;Ávila;074;Fontíveros;1136;574;562
05;Ávila;075;Fresnedilla;132;63;69
05;Ávila;076;Fresno (El);452;236;216
05;Ávila;077;Fuente el Saúz;369;182;187
05;Ávila;078;Fuentes de Año;247;129;118
05;Ávila;079;Gallegos de Altamiros;120;65;55
05;Ávila;080;Gallegos de Sobrinos;119;53;66
05;Ávila;081;Garganta del Villar;89;50;39
05;Ávila;082;Gavilanes;785;425;360
05;Ávila;083;Gemuño;264;126;138
05;Ávila;085;Gil García;82;39;43
05;Ávila;084;Gilbuena;177;100;77
05;Ávila;086;Gimialcón;146;77;69
05;Ávila;087;Gotarrendura;199;68;131
05;Ávila;088;Grandes y San Martín;64;31;33
05;Ávila;089;Guisando;741;384;357
05;Ávila;090;Gutierre-Muñoz;147;69;78
05;Ávila;092;Hernansancho;248;127;121
05;Ávila;093;Herradón de Pinares;507;263;244
05;Ávila;094;Herreros de Suso;256;127;129
05;Ávila;095;Higuera de las Dueñas;325;172;153
05;Ávila;096;Hija de Dios (La);147;82;65
05;Ávila;097;Horcajada (La);943;463;480
05;Ávila;099;Horcajo de las Torres;909;486;423
05;Ávila;100;Hornillo (El);529;265;264
05;Ávila;102;Hoyo de Pinares (El);2591;1314;1277
05;Ávila;101;Hoyocasero;462;247;215
05;Ávila;103;Hoyorredondo;148;76;72
05;Ávila;106;Hoyos de Miguel Muñoz;72;38;34
05;Ávila;104;Hoyos del Collado;52;35;17
05;Ávila;105;Hoyos del Espino;414;222;192
05;Ávila;107;Hurtumpascual;151;79;72
05;Ávila;108;Junciana;107;52;55
05;Ávila;109;Langa;623;320;303
05;Ávila;110;Lanzahíta;958;482;476
05;Ávila;113;Llanos de Tormes (Los);164;88;76
05;Ávila;112;Losar del Barco (El);174;94;80
05;Ávila;114;Madrigal de las Altas Torres;2092;1072;1020
05;Ávila;115;Maello;660;327;333
05;Ávila;116;Malpartida de Corneja;269;132;137
05;Ávila;117;Mamblas;322;168;154
05;Ávila;118;Mancera de Arriba;177;90;87
05;Ávila;119;Manjabálago;86;48;38
05;Ávila;120;Marlín;39;20;19
05;Ávila;121;Martiherrero;225;112;113
05;Ávila;122;Martínez;287;151;136
05;Ávila;123;Mediana de Voltoya;120;65;55
05;Ávila;124;Medinilla;273;144;129
05;Ávila;125;Mengamuñoz;75;33;42
05;Ávila;126;Mesegar de Corneja;140;69;71
05;Ávila;127;Mijares;1058;540;518
05;Ávila;128;Mingorría;577;291;286
05;Ávila;129;Mirón (El);315;175;140
05;Ávila;130;Mironcillo;140;80;60
05;Ávila;131;Mirueña de los Infanzones;259;128;131
05;Ávila;132;Mombeltrán;1231;655;576
05;Ávila;133;Monsalupe;107;54;53
05;Ávila;134;Moraleja de Matacabras;72;35;37
05;Ávila;135;Muñana;607;312;295
05;Ávila;136;Muñico;167;87;80
05;Ávila;138;Muñogalindo;470;261;209
05;Ávila;139;Muñogrande;125;63;62
05;Ávila;140;Muñomer del Peco;139;75;64
05;Ávila;141;Muñopepe;113;61;52
05;Ávila;142;Muñosancho;185;84;101
05;Ávila;143;Muñotello;146;79;67
05;Ávila;144;Narrillos del Álamo;182;96;86
05;Ávila;145;Narrillos del Rebollar;91;49;42
05;Ávila;149;Narros de Saldueña;239;126;113
05;Ávila;147;Narros del Castillo;292;160;132
05;Ávila;148;Narros del Puerto;55;32;23
05;Ávila;152;Nava de Arévalo;1102;566;536
05;Ávila;153;Nava del Barco;236;110;126
05;Ávila;151;Navacepedilla de Corneja;154;82;72
05;Ávila;154;Navadijos;82;46;36
05;Ávila;155;Navaescurial;121;70;51
05;Ávila;156;Navahondilla;152;67;85
05;Ávila;157;Navalacruz;346;170;176
05;Ávila;158;Navalmoral;665;343;322
05;Ávila;159;Navalonguilla;548;273;275
05;Ávila;160;Navalosa;592;312;280
05;Ávila;161;Navalperal de Pinares;943;453;490
05;Ávila;162;Navalperal de Tormes;165;86;79
05;Ávila;163;Navaluenga;2084;1045;1039
05;Ávila;164;Navaquesera;113;58;55
05;Ávila;165;Navarredonda de Gredos;519;267;252
05;Ávila;166;Navarredondilla;300;146;154
05;Ávila;167;Navarrevisca;408;215;193
05;Ávila;168;Navas del Marqués (Las);4270;2139;2131
05;Ávila;169;Navatalgordo;525;266;259
05;Ávila;170;Navatejares;117;56;61
05;Ávila;171;Neila de San Miguel;150;76;74
05;Ávila;172;Niharra;217;108;109
05;Ávila;173;Ojos-Albos;42;18;24
05;Ávila;174;Orbita;104;55;49
05;Ávila;175;Oso (El);253;134;119
05;Ávila;176;Padiernos;271;141;130
05;Ávila;177;Pajares de Adaja;209;108;101
05;Ávila;178;Palacios de Goda;577;283;294
05;Ávila;179;Papatrigo;362;188;174
05;Ávila;180;Parral (El);131;69;62
05;Ávila;181;Pascualcobo;48;28;20
05;Ávila;182;Pedro Bernardo;1531;781;750
05;Ávila;183;Pedro-Rodríguez;248;116;132
05;Ávila;184;Peguerinos;386;210;176
05;Ávila;185;Peñalba de Ávila;138;77;61
05;Ávila;186;Piedrahíta;2292;1118;1174
05;Ávila;187;Piedralaves;2174;1094;1080
05;Ávila;188;Poveda;99;56;43
05;Ávila;189;Poyales del Hoyo;840;425;415
05;Ávila;190;Pozanco;66;36;30
05;Ávila;191;Pradosegar;209;109;100
05;Ávila;192;Puerto Castilla;159;73;86
05;Ávila;193;Rasueros;418;223;195
05;Ávila;194;Riocabado;220;118;102
05;Ávila;195;Riofrío;357;198;159
05;Ávila;196;Rivilla de Barajas;113;63;50
05;Ávila;197;Salobral;136;67;69
05;Ávila;198;Salvadiós;143;75;68
05;Ávila;199;San Bartolomé de Béjar;102;49;53
05;Ávila;200;San Bartolomé de Corneja;138;72;66
05;Ávila;201;San Bartolomé de Pinares;810;437;373
05;Ávila;206;San Esteban de los Patos;38;21;17
05;Ávila;208;San Esteban de Zapardiel;84;39;45
05;Ávila;207;San Esteban del Valle;1003;515;488
05;Ávila;209;San García de Ingelmos;201;104;97
05;Ávila;901;San Juan de Gredos;472;237;235
05;Ávila;210;San Juan de la Encinilla;162;73;89
05;Ávila;211;San Juan de la Nava;737;379;358
05;Ávila;212;San Juan del Molinillo;369;207;162
05;Ávila;213;San Juan del Olmo;207;112;95
05;Ávila;214;San Lorenzo de Tormes;87;40;47
05;Ávila;215;San Martín de la Vega del Alberche;330;191;139
05;Ávila;216;San Martín del Pimpollar;349;190;159
05;Ávila;217;San Miguel de Corneja;126;61;65
05;Ávila;218;San Miguel de Serrezuela;252;131;121
05;Ávila;219;San Pascual;73;40;33
05;Ávila;220;San Pedro del Arroyo;503;262;241
05;Ávila;231;San Vicente de Arévalo;249;123;126
05;Ávila;204;Sanchidrián;784;385;399
05;Ávila;205;Sanchorreja;146;79;67
05;Ávila;222;Santa Cruz de Pinares;247;137;110
05;Ávila;221;Santa Cruz del Valle;661;331;330
05;Ávila;226;Santa María de los Caballeros;189;96;93
05;Ávila;224;Santa María del Arroyo;155;80;75
05;Ávila;225;Santa María del Berrocal;681;328;353
05;Ávila;902;Santa María del Cubillo;426;234;192
05;Ávila;227;Santa María del Tiétar;384;200;184
05;Ávila;228;Santiago del Collado;329;201;128
05;Ávila;904;Santiago del Tormes;378;190;188
05;Ávila;229;Santo Domingo de las Posadas;100;50;50
05;Ávila;230;Santo Tomé de Zabarcos;132;73;59
05;Ávila;232;Serrada (La);147;73;74
05;Ávila;233;Serranillos;516;264;252
05;Ávila;234;Sigeres;91;43;48
05;Ávila;235;Sinlabajos;276;140;136
05;Ávila;236;Solana de Ávila;264;140;124
05;Ávila;237;Solana de Rioalmar;342;178;164
05;Ávila;238;Solosancho;1171;620;551
05;Ávila;239;Sotalbo;280;141;139
05;Ávila;240;Sotillo de la Adrada;3470;1726;1744
05;Ávila;241;Tiemblo (El);3813;1926;1887
05;Ávila;242;Tiñosillos;765;413;352
05;Ávila;243;Tolbaños;165;82;83
05;Ávila;244;Tormellas;143;73;70
05;Ávila;245;Tornadizos de Ávila;347;170;177
05;Ávila;247;Torre (La);499;268;231
05;Ávila;246;Tórtoles;137;73;64
05;Ávila;249;Umbrías;184;95;89
05;Ávila;251;Vadillo de la Sierra;199;114;85
05;Ávila;252;Valdecasa;133;71;62
05;Ávila;253;Vega de Santa María;152;84;68
05;Ávila;254;Velayos;306;153;153
05;Ávila;256;Villaflor;184;97;87
05;Ávila;257;Villafranca de la Sierra;277;142;135
05;Ávila;905;Villanueva de Ávila;658;341;317
05;Ávila;258;Villanueva de Gómez;170;79;91
05;Ávila;259;Villanueva del Aceral;239;112;127
05;Ávila;260;Villanueva del Campillo;252;129;123
05;Ávila;261;Villar de Corneja;107;53;54
05;Ávila;262;Villarejo del Valle;490;259;231
05;Ávila;263;Villatoro;263;143;120
05;Ávila;264;Viñegra de Moraña;87;46;41
05;Ávila;265;Vita;125;74;51
05;Ávila;266;Zapardiel de la Cañada;222;109;113
05;Ávila;267;Zapardiel de la Ribera;159;81;78
06;Badajoz;001;Acedera;1038;552;486
06;Badajoz;002;Aceuchal;5098;2503;2595
06;Badajoz;003;Ahillones;1263;627;636
06;Badajoz;004;Alange;2040;1059;981
06;Badajoz;005;Albuera (La);1824;932;892
06;Badajoz;006;Alburquerque;5824;2954;2870
06;Badajoz;007;Alconchel;2301;1140;1161
06;Badajoz;008;Alconera;782;396;386
06;Badajoz;009;Aljucén;226;125;101
06;Badajoz;010;Almendral;1534;760;774
06;Badajoz;011;Almendralejo;25596;12472;13124
06;Badajoz;012;Arroyo de San Serván;4041;2051;1990
06;Badajoz;013;Atalaya;393;194;199
06;Badajoz;014;Azuaga;10021;4907;5114
06;Badajoz;015;Badajoz;130153;63050;67103
06;Badajoz;016;Barcarrota;4230;2124;2106
06;Badajoz;017;Baterno;415;208;207
06;Badajoz;018;Benquerencia de la Serena;1160;583;577
06;Badajoz;019;Berlanga;2776;1373;1403
06;Badajoz;020;Bienvenida;2474;1248;1226
06;Badajoz;021;Bodonal de la Sierra;1428;727;701
06;Badajoz;022;Burguillos del Cerro;3393;1667;1726
06;Badajoz;023;Cabeza del Buey;6364;3116;3248
06;Badajoz;024;Cabeza la Vaca;1677;844;833
06;Badajoz;025;Calamonte;5808;2896;2912
06;Badajoz;026;Calera de León;1193;603;590
06;Badajoz;027;Calzadilla de los Barros;838;418;420
06;Badajoz;028;Campanario;6066;2938;3128
06;Badajoz;029;Campillo de Llerena;1820;902;918
06;Badajoz;030;Capilla;240;112;128
06;Badajoz;031;Carmonita;727;380;347
06;Badajoz;032;Carrascalejo (El);31;15;16
06;Badajoz;033;Casas de Don Pedro;1906;929;977
06;Badajoz;034;Casas de Reina;319;139;180
06;Badajoz;035;Castilblanco;1463;727;736
06;Badajoz;036;Castuera;7554;3796;3758
06;Badajoz;042;Cheles;1361;679;682
06;Badajoz;037;Codosera (La);2620;1345;1275
06;Badajoz;038;Cordobilla de Lácara;1014;516;498
06;Badajoz;039;Coronada (La);2569;1278;1291
06;Badajoz;040;Corte de Peleas;1319;668;651
06;Badajoz;041;Cristina;562;301;261
06;Badajoz;043;Don Álvaro;644;320;324
06;Badajoz;044;Don Benito;30885;15321;15564
06;Badajoz;045;Entrín Bajo;693;344;349
06;Badajoz;046;Esparragalejo;1477;725;752
06;Badajoz;047;Esparragosa de la Serena;1158;575;583
06;Badajoz;048;Esparragosa de Lares;1280;630;650
06;Badajoz;049;Feria;1606;794;812
06;Badajoz;050;Fregenal de la Sierra;5560;2681;2879
06;Badajoz;051;Fuenlabrada de los Montes;2133;1046;1087
06;Badajoz;052;Fuente de Cantos;5207;2625;2582
06;Badajoz;053;Fuente del Arco;887;452;435
06;Badajoz;054;Fuente del Maestre;6870;3409;3461
06;Badajoz;055;Fuentes de León;2905;1399;1506
06;Badajoz;056;Garbayuela;617;327;290
06;Badajoz;057;Garlitos;868;439;429
06;Badajoz;058;Garrovilla (La);2687;1392;1295
06;Badajoz;059;Granja de Torrehermosa;2753;1388;1365
06;Badajoz;060;Guareña;7417;3768;3649
06;Badajoz;061;Haba (La);1557;788;769
06;Badajoz;062;Helechosa de los Montes;812;431;381
06;Badajoz;063;Herrera del Duque;4137;2111;2026
06;Badajoz;064;Higuera de la Serena;1300;653;647
06;Badajoz;065;Higuera de Llerena;545;261;284
06;Badajoz;066;Higuera de Vargas;3005;1500;1505
06;Badajoz;067;Higuera la Real;2787;1402;1385
06;Badajoz;068;Hinojosa del Valle;637;329;308
06;Badajoz;069;Hornachos;3921;1979;1942
06;Badajoz;070;Jerez de los Caballeros;10564;5279;5285
06;Badajoz;071;Lapa (La);358;177;181
06;Badajoz;073;Llera;1054;544;510
06;Badajoz;074;Llerena;5807;2803;3004
06;Badajoz;072;Lobón;2772;1426;1346
06;Badajoz;075;Magacela;881;448;433
06;Badajoz;076;Maguilla;1172;595;577
06;Badajoz;077;Malcocinado;612;324;288
06;Badajoz;078;Malpartida de la Serena;1065;539;526
06;Badajoz;079;Manchita;779;397;382
06;Badajoz;080;Medellín;2547;1288;1259
06;Badajoz;081;Medina de las Torres;1674;828;846
06;Badajoz;082;Mengabril;482;237;245
06;Badajoz;083;Mérida;51968;25433;26535
06;Badajoz;084;Mirandilla;1320;671;649
06;Badajoz;085;Monesterio;5153;2570;2583
06;Badajoz;086;Montemolín;1853;901;952
06;Badajoz;087;Monterrubio de la Serena;3231;1570;1661
06;Badajoz;088;Montijo;15233;7416;7817
06;Badajoz;089;Morera (La);789;404;385
06;Badajoz;090;Nava de Santiago (La);1171;598;573
06;Badajoz;091;Navalvillar de Pela;5136;2581;2555
06;Badajoz;092;Nogales;829;415;414
06;Badajoz;093;Oliva de la Frontera;6531;3258;3273
06;Badajoz;094;Oliva de Mérida;2169;1090;1079
06;Badajoz;095;Olivenza;10621;5239;5382
06;Badajoz;096;Orellana de la Sierra;463;236;227
06;Badajoz;097;Orellana la Vieja;4021;2014;2007
06;Badajoz;098;Palomas;709;373;336
06;Badajoz;099;Parra (La);1449;740;709
06;Badajoz;100;Peñalsordo;1755;840;915
06;Badajoz;101;Peraleda del Zaucejo;761;393;368
06;Badajoz;102;Puebla de Alcocer;1620;810;810
06;Badajoz;103;Puebla de la Calzada;5573;2773;2800
06;Badajoz;104;Puebla de la Reina;923;483;440
06;Badajoz;107;Puebla de Obando;2133;1055;1078
06;Badajoz;108;Puebla de Sancho Pérez;3051;1521;1530
06;Badajoz;105;Puebla del Maestre;1018;505;513
06;Badajoz;106;Puebla del Prior;636;330;306
06;Badajoz;109;Quintana de la Serena;5132;2568;2564
06;Badajoz;110;Reina;248;127;121
06;Badajoz;111;Rena;674;344;330
06;Badajoz;112;Retamal de Llerena;622;325;297
06;Badajoz;113;Ribera del Fresno;3500;1678;1822
06;Badajoz;114;Risco;261;132;129
06;Badajoz;115;Roca de la Sierra (La);1620;802;818
06;Badajoz;116;Salvaleón;2507;1281;1226
06;Badajoz;117;Salvatierra de los Barros;2038;999;1039
06;Badajoz;119;San Pedro de Mérida;799;417;382
06;Badajoz;123;San Vicente de Alcántara;6085;3016;3069
06;Badajoz;118;Sancti-Spíritus;379;183;196
06;Badajoz;120;Santa Amalia;4395;2196;2199
06;Badajoz;121;Santa Marta;4131;2053;2078
06;Badajoz;122;Santos de Maimona (Los);7829;3923;3906
06;Badajoz;124;Segura de León;2367;1179;1188
06;Badajoz;125;Siruela;2543;1249;1294
06;Badajoz;126;Solana de los Barros;2841;1455;1386
06;Badajoz;127;Talarrubias;3811;1888;1923
06;Badajoz;128;Talavera la Real;5327;2691;2636
06;Badajoz;129;Táliga;752;378;374
06;Badajoz;130;Tamurejo;290;142;148
06;Badajoz;131;Torre de Miguel Sesmero;1319;645;674
06;Badajoz;132;Torremayor;1166;575;591
06;Badajoz;133;Torremejía;1990;1004;986
06;Badajoz;134;Trasierra;722;387;335
06;Badajoz;135;Trujillanos;993;517;476
06;Badajoz;136;Usagre;2206;1119;1087
06;Badajoz;137;Valdecaballeros;1529;759;770
06;Badajoz;901;Valdelacalzada;"";"";""
06;Badajoz;138;Valdetorres;1405;707;698
06;Badajoz;139;Valencia de las Torres;920;451;469
06;Badajoz;140;Valencia del Mombuey;929;453;476
06;Badajoz;141;Valencia del Ventoso;2495;1229;1266
06;Badajoz;146;Valle de la Serena;1805;873;932
06;Badajoz;147;Valle de Matamoros;560;274;286
06;Badajoz;148;Valle de Santa Ana;1318;665;653
06;Badajoz;142;Valverde de Burguillos;431;214;217
06;Badajoz;143;Valverde de Leganés;3694;1894;1800
06;Badajoz;144;Valverde de Llerena;912;446;466
06;Badajoz;145;Valverde de Mérida;1169;602;567
06;Badajoz;149;Villafranca de los Barros;12658;6244;6414
06;Badajoz;150;Villagarcía de la Torre;1054;545;509
06;Badajoz;151;Villagonzalo;1559;762;797
06;Badajoz;152;Villalba de los Barros;1753;889;864
06;Badajoz;153;Villanueva de la Serena;23752;11680;12072
06;Badajoz;154;Villanueva del Fresno;3611;1819;1792
06;Badajoz;156;Villar de Rena;1782;946;836
06;Badajoz;155;Villar del Rey;2354;1217;1137
06;Badajoz;157;Villarta de los Montes;803;394;409
06;Badajoz;158;Zafra;14841;7186;7655
06;Badajoz;159;Zahínos;3250;1634;1616
06;Badajoz;160;Zalamea de la Serena;5114;2557;2557
06;Badajoz;162;Zarza (La);3749;1882;1867
06;Badajoz;161;Zarza-Capilla;604;300;304
07;Balears (Illes);002;Alaior;6939;3485;3454
07;Balears (Illes);001;Alaró;3987;1912;2075
07;Balears (Illes);003;Alcúdia;9617;4856;4761
07;Balears (Illes);004;Algaida;3437;1724;1713
07;Balears (Illes);005;Andratx;7300;3636;3664
07;Balears (Illes);901;Ariany;846;405;441
07;Balears (Illes);006;Artà;5831;2883;2948
07;Balears (Illes);007;Banyalbufar;461;226;235
07;Balears (Illes);008;Binissalem;4855;2352;2503
07;Balears (Illes);009;Búger;917;452;465
07;Balears (Illes);010;Bunyola;4721;2368;2353
07;Balears (Illes);011;Calvià;27956;14163;13793
07;Balears (Illes);012;Campanet;2254;1110;1144
07;Balears (Illes);013;Campos;6738;3371;3367
07;Balears (Illes);014;Capdepera;7037;3527;3510
07;Balears (Illes);064;Castell (Es);5900;2933;2967
07;Balears (Illes);015;Ciutadella de Menorca;21026;10494;10532
07;Balears (Illes);016;Consell;2072;1007;1065
07;Balears (Illes);017;Costitx;801;389;412
07;Balears (Illes);018;Deyá;570;279;291
07;Balears (Illes);026;Eivissa;34336;17315;17021
07;Balears (Illes);019;Escorca;279;152;127
07;Balears (Illes);020;Esporles;3479;1724;1755
07;Balears (Illes);021;Estellencs;344;181;163
07;Balears (Illes);022;Felanitx;14244;7092;7152
07;Balears (Illes);023;Ferreries;3807;1998;1809
07;Balears (Illes);024;Formentera;5323;2719;2604
07;Balears (Illes);025;Fornalutx;593;304;289
07;Balears (Illes);027;Inca;21407;10456;10951
07;Balears (Illes);028;Lloret de Vistalegre;813;399;414
07;Balears (Illes);029;Lloseta;4519;2271;2248
07;Balears (Illes);030;Llubí;1927;944;983
07;Balears (Illes);031;Llucmajor;19606;9746;9860
07;Balears (Illes);032;Mahón;23090;11271;11819
07;Balears (Illes);033;Manacor;28653;14173;14480
07;Balears (Illes);034;Mancor de la Vall;880;420;460
07;Balears (Illes);035;Maria de la Salut;1796;870;926
07;Balears (Illes);036;Marratxí;14650;7382;7268
07;Balears (Illes);037;Mercadal (Es);2532;1272;1260
07;Balears (Illes);902;Migjorn Gran (Es);1071;555;516
07;Balears (Illes);038;Montuïri;2165;1056;1109
07;Balears (Illes);039;Muro;5916;2895;3021
07;Balears (Illes);040;Palma de Mallorca;322008;156925;165083
07;Balears (Illes);041;Petra;2626;1269;1357
07;Balears (Illes);044;Pobla (Sa);10348;5276;5072
07;Balears (Illes);042;Pollença;13077;6570;6507
07;Balears (Illes);043;Porreres;4305;2130;2175
07;Balears (Illes);045;Puigpunyent;1171;576;595
07;Balears (Illes);059;Salines (Ses);3185;1585;1600
07;Balears (Illes);046;Sant Antoni de Portmany;14593;7409;7184
07;Balears (Illes);049;Sant Joan;1656;811;845
07;Balears (Illes);050;Sant Joan de Labritja;3720;1848;1872
07;Balears (Illes);048;Sant Josep de sa Talaia;11785;6087;5698
07;Balears (Illes);051;Sant Llorenç des Cardassar;4964;2466;2498
07;Balears (Illes);052;Sant Lluís;3662;1838;1824
07;Balears (Illes);053;Santa Eugènia;1012;513;499
07;Balears (Illes);054;Santa Eulalia del Río;18386;9321;9065
07;Balears (Illes);055;Santa Margalida;6375;3179;3196
07;Balears (Illes);056;Santa María del Camí;4309;2127;2182
07;Balears (Illes);057;Santanyí;7575;3783;3792
07;Balears (Illes);058;Selva;2899;1432;1467
07;Balears (Illes);047;Sencelles;1747;865;882
07;Balears (Illes);060;Sineu;2619;1300;1319
07;Balears (Illes);061;Sóller;10514;5168;5346
07;Balears (Illes);062;Son Servera;7781;3899;3882
07;Balears (Illes);063;Valldemossa;1445;692;753
07;Balears (Illes);065;Vilafranca de Bonany;2160;1057;1103
08;Barcelona;001;Abrera;6384;3299;3085
08;Barcelona;002;Aguilar de Segarra;204;104;100
08;Barcelona;014;Aiguafreda;2082;1018;1064
08;Barcelona;003;Alella;7319;3621;3698
08;Barcelona;004;Alpens;257;139;118
08;Barcelona;005;Ametlla del Vallès (L');4209;2083;2126
08;Barcelona;006;Arenys de Mar;11833;5724;6109
08;Barcelona;007;Arenys de Munt;5232;2547;2685
08;Barcelona;008;Argençola;196;102;94
08;Barcelona;009;Argentona;8458;4196;4262
08;Barcelona;010;Artés;4293;2110;2183
08;Barcelona;011;Avià;1792;916;876
08;Barcelona;012;Avinyó;2054;1021;1033
08;Barcelona;013;Avinyonet del Penedès;1226;627;599
08;Barcelona;015;Badalona;219340;108475;110865
08;Barcelona;904;Badia del Vallès;"";"";""
08;Barcelona;016;Bagà;2109;1035;1074
08;Barcelona;017;Balenyà;3293;1681;1612
08;Barcelona;018;Balsareny;3396;1660;1736
08;Barcelona;252;Barberà del Vallès;32680;16543;16137
08;Barcelona;019;Barcelona;1630867;769535;861332
08;Barcelona;020;Begues;2570;1289;1281
08;Barcelona;021;Bellprat;91;47;44
08;Barcelona;022;Berga;14460;7007;7453
08;Barcelona;023;Bigues i Riells;3481;1803;1678
08;Barcelona;024;Borredà;477;230;247
08;Barcelona;025;Bruc (El);827;433;394
08;Barcelona;026;Brull (El);199;98;101
08;Barcelona;027;Cabanyes (Les);430;236;194
08;Barcelona;029;Cabrera de Mar;3156;1599;1557
08;Barcelona;028;Cabrera d'Igualada;324;180;144
08;Barcelona;030;Cabrils;3512;1741;1771
08;Barcelona;031;Calaf;3157;1544;1613
08;Barcelona;034;Calders;594;311;283
08;Barcelona;033;Caldes de Montbui;12126;5993;6133
08;Barcelona;032;Caldes d'Estrac;1551;742;809
08;Barcelona;035;Calella;11943;5626;6317
08;Barcelona;037;Calldetenes;1585;821;764
08;Barcelona;038;Callús;1357;654;703
08;Barcelona;036;Calonge de Segarra;196;105;91
08;Barcelona;039;Campins;218;101;117
08;Barcelona;040;Canet de Mar;9214;4480;4734
08;Barcelona;041;Canovelles;13603;6858;6745
08;Barcelona;042;Cànoves i Samalús;1314;660;654
08;Barcelona;043;Canyelles;1011;524;487
08;Barcelona;044;Capellades;5048;2463;2585
08;Barcelona;045;Capolat;70;40;30
08;Barcelona;046;Cardedeu;10167;5060;5107
08;Barcelona;047;Cardona;6227;3042;3185
08;Barcelona;048;Carme;688;360;328
08;Barcelona;049;Casserres;1621;776;845
08;Barcelona;057;Castell de l'Areny;46;27;19
08;Barcelona;052;Castellar de n'Hug;160;83;77
08;Barcelona;050;Castellar del Riu;72;44;28
08;Barcelona;051;Castellar del Vallès;14942;7467;7475
08;Barcelona;053;Castellbell i el Vilar;2844;1414;1430
08;Barcelona;054;Castellbisbal;5636;2904;2732
08;Barcelona;055;Castellcir;264;145;119
08;Barcelona;056;Castelldefels;35649;17781;17868
08;Barcelona;058;Castellet i la Gornal;1166;581;585
08;Barcelona;060;Castellfollit de Riubregós;232;114;118
08;Barcelona;059;Castellfollit del Boix;339;164;175
08;Barcelona;061;Castellgalí;739;365;374
08;Barcelona;062;Castellnou de Bages;279;148;131
08;Barcelona;063;Castellolí;419;210;209
08;Barcelona;064;Castellterçol;1959;934;1025
08;Barcelona;065;Castellví de la Marca;1449;732;717
08;Barcelona;066;Castellví de Rosanes;778;401;377
08;Barcelona;067;Centelles;5764;2823;2941
08;Barcelona;268;Cercs;1608;778;830
08;Barcelona;266;Cerdanyola del Vallès;59263;29761;29502
08;Barcelona;068;Cervelló;6694;3385;3309
08;Barcelona;069;Collbató;1340;678;662
08;Barcelona;070;Collsuspina;233;123;110
08;Barcelona;071;Copons;271;135;136
08;Barcelona;072;Corbera de Llobregat;6528;3316;3212
08;Barcelona;073;Cornellà de Llobregat;84142;41574;42568
08;Barcelona;074;Cubelles;4151;2106;2045
08;Barcelona;075;Dosrius;2023;1029;994
08;Barcelona;076;Esparreguera;13675;6873;6802
08;Barcelona;077;Esplugues de Llobregat;48437;24017;24420
08;Barcelona;078;Espunyola (L');283;145;138
08;Barcelona;079;Estany (L');384;183;201
08;Barcelona;134;Figaró-Montmany;668;356;312
08;Barcelona;080;Fígols;48;27;21
08;Barcelona;082;Fogars de la Selva;498;255;243
08;Barcelona;081;Fogars de Montclús;271;143;128
08;Barcelona;083;Folgueroles;1204;593;611
08;Barcelona;084;Fonollosa;734;371;363
08;Barcelona;085;Font-rubí;1188;623;565
08;Barcelona;086;Franqueses del Vallès (Les);10649;5372;5277
08;Barcelona;090;Gaià;153;82;71
08;Barcelona;087;Gallifa;114;60;54
08;Barcelona;088;Garriga (La);10060;4867;5193
08;Barcelona;089;Gavà;37532;18745;18787
08;Barcelona;091;Gelida;4141;2075;2066
08;Barcelona;092;Gironella;5167;2494;2673
08;Barcelona;093;Gisclareny;32;16;16
08;Barcelona;094;Granada (La);1276;625;651
08;Barcelona;095;Granera;57;35;22
08;Barcelona;096;Granollers;53012;26064;26948
08;Barcelona;097;Gualba;637;329;308
08;Barcelona;099;Guardiola de Berguedà;1025;503;522
08;Barcelona;100;Gurb;1779;911;868
08;Barcelona;101;Hospitalet de Llobregat (L');266242;131068;135174
08;Barcelona;162;Hostalets de Pierola (Els);1050;531;519
08;Barcelona;102;Igualada;32262;15620;16642
08;Barcelona;103;Jorba;552;267;285
08;Barcelona;104;Llacuna (La);827;420;407
08;Barcelona;105;Llagosta (La);11826;5909;5917
08;Barcelona;107;Lliçà d'Amunt;7001;3645;3356
08;Barcelona;108;Lliçà de Vall;4134;2104;2030
08;Barcelona;106;Llinars del Vallès;6035;3060;2975
08;Barcelona;109;Lluçà;263;148;115
08;Barcelona;110;Malgrat de Mar;12185;6051;6134
08;Barcelona;111;Malla;253;119;134
08;Barcelona;112;Manlleu;16897;8391;8506
08;Barcelona;113;Manresa;66055;31852;34203
08;Barcelona;242;Marganell;221;96;125
08;Barcelona;114;Martorell;17267;8634;8633
08;Barcelona;115;Martorelles;5038;2514;2524
08;Barcelona;116;Masies de Roda (Les);636;315;321
08;Barcelona;117;Masies de Voltregà (Les);2560;1264;1296
08;Barcelona;118;Masnou (El);20022;9717;10305
08;Barcelona;119;Masquefa;3037;1522;1515
08;Barcelona;120;Matadepera;5478;2748;2730
08;Barcelona;121;Mataró;102117;50226;51891
08;Barcelona;122;Mediona;1124;571;553
08;Barcelona;138;Moià;3482;1700;1782
08;Barcelona;123;Molins de Rei;19080;9406;9674
08;Barcelona;124;Mollet del Vallès;42760;21352;21408
08;Barcelona;128;Monistrol de Calders;608;293;315
08;Barcelona;127;Monistrol de Montserrat;2502;1246;1256
08;Barcelona;125;Montcada i Reixac;27393;13565;13828
08;Barcelona;130;Montclar;252;109;143
08;Barcelona;131;Montesquiu;854;412;442
08;Barcelona;126;Montgat;7793;3816;3977
08;Barcelona;132;Montmajor;484;254;230
08;Barcelona;133;Montmaneu;235;132;103
08;Barcelona;135;Montmeló;7700;3832;3868
08;Barcelona;136;Montornès del Vallès;11363;5664;5699
08;Barcelona;137;Montseny;303;158;145
08;Barcelona;129;Muntanyola;201;112;89
08;Barcelona;139;Mura;297;156;141
08;Barcelona;140;Navarcles;5235;2618;2617
08;Barcelona;141;Navàs;5708;2819;2889
08;Barcelona;142;Nou de Berguedà (La);147;79;68
08;Barcelona;143;Òdena;2599;1323;1276
08;Barcelona;145;Olèrdola;1808;933;875
08;Barcelona;146;Olesa de Bonesvalls;560;300;260
08;Barcelona;147;Olesa de Montserrat;15659;7863;7796
08;Barcelona;148;Olivella;586;299;287
08;Barcelona;149;Olost;1193;594;599
08;Barcelona;144;Olvan;956;452;504
08;Barcelona;150;Orís;220;119;101
08;Barcelona;151;Oristà;720;359;361
08;Barcelona;152;Orpí;152;81;71
08;Barcelona;153;Òrrius;368;190;178
08;Barcelona;154;Pacs del Penedès;516;272;244
08;Barcelona;155;Palafolls;3806;1887;1919
08;Barcelona;156;Palau-solità i Plegamans;9112;4671;4441
08;Barcelona;157;Pallejà;6927;3456;3471
08;Barcelona;905;Palma de Cervelló (La);"";"";""
08;Barcelona;158;Papiol (El);3427;1704;1723
08;Barcelona;159;Parets del Vallès;11889;6013;5876
08;Barcelona;160;Perafita;334;160;174
08;Barcelona;161;Piera;6670;3358;3312
08;Barcelona;163;Pineda de Mar;17475;8735;8740
08;Barcelona;164;Pla del Penedès (El);971;479;492
08;Barcelona;165;Pobla de Claramunt (La);1683;838;845
08;Barcelona;166;Pobla de Lillet (La);1702;827;875
08;Barcelona;167;Polinyà;3827;1969;1858
08;Barcelona;182;Pont de Vilomara i Rocafort (El);2275;1143;1132
08;Barcelona;168;Pontons;303;162;141
08;Barcelona;169;Prat de Llobregat (El);65274;32768;32506
08;Barcelona;171;Prats de Lluçanès;2692;1332;1360
08;Barcelona;170;Prats de Rei (Els);555;266;289
08;Barcelona;230;Premià de Dalt;7268;3647;3621
08;Barcelona;172;Premià de Mar;24691;12365;12326
08;Barcelona;174;Puigdàlber;297;136;161
08;Barcelona;175;Puig-reig;4707;2298;2409
08;Barcelona;176;Pujalt;176;90;86
08;Barcelona;177;Quar (La);52;25;27
08;Barcelona;178;Rajadell;299;156;143
08;Barcelona;179;Rellinars;300;149;151
08;Barcelona;180;Ripollet;28249;14139;14110
08;Barcelona;181;Roca del Vallès (La);6370;3188;3182
08;Barcelona;183;Roda de Ter;4875;2356;2519
08;Barcelona;184;Rubí;52629;26469;26160
08;Barcelona;185;Rubió;119;63;56
08;Barcelona;901;Rupit i Pruit;366;185;181
08;Barcelona;187;Sabadell;189006;92223;96783
08;Barcelona;188;Sagàs;184;100;84
08;Barcelona;190;Saldes;331;184;147
08;Barcelona;191;Sallent;7580;3677;3903
08;Barcelona;194;Sant Adrià de Besòs;34542;17132;17410
08;Barcelona;195;Sant Agustí de Lluçanès;108;53;55
08;Barcelona;196;Sant Andreu de la Barca;16658;8549;8109
08;Barcelona;197;Sant Andreu de Llavaneres;5301;2623;2678
08;Barcelona;198;Sant Antoni de Vilamajor;2475;1231;1244
08;Barcelona;199;Sant Bartomeu del Grau;1173;629;544
08;Barcelona;200;Sant Boi de Llobregat;79594;39816;39778
08;Barcelona;201;Sant Boi de Lluçanès;532;265;267
08;Barcelona;203;Sant Cebrià de Vallalta;1070;593;477
08;Barcelona;202;Sant Celoni;12697;6346;6351
08;Barcelona;204;Sant Climent de Llobregat;2374;1162;1212
08;Barcelona;205;Sant Cugat del Vallès;43373;21424;21949
08;Barcelona;206;Sant Cugat Sesgarrigues;753;402;351
08;Barcelona;207;Sant Esteve de Palautordera;1262;648;614
08;Barcelona;208;Sant Esteve Sesrovires;3220;1644;1576
08;Barcelona;210;Sant Feliu de Codines;3897;1901;1996
08;Barcelona;211;Sant Feliu de Llobregat;36933;18327;18606
08;Barcelona;212;Sant Feliu Sasserra;639;327;312
08;Barcelona;209;Sant Fost de Campsentelles;5434;2791;2643
08;Barcelona;213;Sant Fruitós de Bages;4987;2511;2476
08;Barcelona;215;Sant Hipòlit de Voltregà;2986;1465;1521
08;Barcelona;193;Sant Iscle de Vallalta;620;316;304
08;Barcelona;216;Sant Jaume de Frontanyà;30;16;14
08;Barcelona;218;Sant Joan de Vilatorrada;8331;4173;4158
08;Barcelona;217;Sant Joan Despí;26479;13216;13263
08;Barcelona;903;Sant Julià de Cerdanyola;"";"";""
08;Barcelona;220;Sant Julià de Vilatorta;1982;958;1024
08;Barcelona;221;Sant Just Desvern;13413;6426;6987
08;Barcelona;222;Sant Llorenç d'Hortons;1202;608;594
08;Barcelona;223;Sant Llorenç Savall;2017;966;1051
08;Barcelona;225;Sant Martí d'Albars;129;70;59
08;Barcelona;224;Sant Martí de Centelles;656;334;322
08;Barcelona;226;Sant Martí de Tous;953;478;475
08;Barcelona;227;Sant Martí Sarroca;2457;1229;1228
08;Barcelona;228;Sant Martí Sesgueioles;358;176;182
08;Barcelona;229;Sant Mateu de Bages;526;267;259
08;Barcelona;231;Sant Pere de Ribes;16518;8310;8208
08;Barcelona;232;Sant Pere de Riudebitlles;2130;1049;1081
08;Barcelona;233;Sant Pere de Torelló;2035;978;1057
08;Barcelona;234;Sant Pere de Vilamajor;1504;760;744
08;Barcelona;189;Sant Pere Sallavinera;172;88;84
08;Barcelona;235;Sant Pol de Mar;2688;1337;1351
08;Barcelona;236;Sant Quintí de Mediona;1596;795;801
08;Barcelona;237;Sant Quirze de Besora;2011;976;1035
08;Barcelona;238;Sant Quirze del Vallès;9910;4900;5010
08;Barcelona;239;Sant Quirze Safaja;257;127;130
08;Barcelona;240;Sant Sadurní d'Anoia;9475;4749;4726
08;Barcelona;241;Sant Sadurní d'Osormort;76;38;38
08;Barcelona;098;Sant Salvador de Guardiola;1515;770;745
08;Barcelona;262;Sant Vicenç de Castellet;7505;3604;3901
08;Barcelona;264;Sant Vicenç de Montalt;1902;954;948
08;Barcelona;265;Sant Vicenç de Torelló;1729;822;907
08;Barcelona;263;Sant Vicenç dels Horts;22215;11204;11011
08;Barcelona;243;Santa Cecilia de Voltregà;192;108;84
08;Barcelona;244;Santa Coloma de Cervelló;3230;1586;1644
08;Barcelona;245;Santa Coloma de Gramenet;131764;65894;65870
08;Barcelona;246;Santa Eugènia de Berga;2025;1028;997
08;Barcelona;247;Santa Eulàlia de Riuprimer;845;435;410
08;Barcelona;248;Santa Eulàlia de Ronçana;3588;1808;1780
08;Barcelona;249;Santa Fe del Penedès;221;103;118
08;Barcelona;250;Santa Margarida de Montbui;9521;4768;4753
08;Barcelona;251;Santa Margarida i els Monjos;4102;2123;1979
08;Barcelona;253;Santa Maria de Besora;197;98;99
08;Barcelona;254;Santa Maria de Corcó;2002;1011;991
08;Barcelona;256;Santa Maria de Martorelles;629;307;322
08;Barcelona;255;Santa Maria de Merlès;191;96;95
08;Barcelona;257;Santa Maria de Miralles;111;58;53
08;Barcelona;259;Santa Maria de Palautordera;5251;2674;2577
08;Barcelona;258;Santa Maria d'Oló;997;508;489
08;Barcelona;260;Santa Perpètua de Mogoda;17483;8906;8577
08;Barcelona;261;Santa Susanna;1323;658;665
08;Barcelona;192;Santpedor;4812;2354;2458
08;Barcelona;267;Sentmenat;4975;2492;2483
08;Barcelona;269;Seva;1894;961;933
08;Barcelona;270;Sitges;15371;7522;7849
08;Barcelona;271;Sobremunt;100;48;52
08;Barcelona;272;Sora;202;106;96
08;Barcelona;273;Subirats;2174;1083;1091
08;Barcelona;274;Súria;6409;3132;3277
08;Barcelona;276;Tagamanent;167;91;76
08;Barcelona;277;Talamanca;93;47;46
08;Barcelona;278;Taradell;4489;2223;2266
08;Barcelona;275;Tavèrnoles;228;106;122
08;Barcelona;280;Tavertet;134;68;66
08;Barcelona;281;Teià;4237;2144;2093
08;Barcelona;279;Terrassa;161428;78835;82593
08;Barcelona;282;Tiana;5086;2549;2537
08;Barcelona;283;Tona;5688;2821;2867
08;Barcelona;284;Tordera;8771;4381;4390
08;Barcelona;285;Torelló;11783;5758;6025
08;Barcelona;286;Torre de Claramunt (La);1878;968;910
08;Barcelona;287;Torrelavit;1223;625;598
08;Barcelona;288;Torrelles de Foix;1541;821;720
08;Barcelona;289;Torrelles de Llobregat;2890;1485;1405
08;Barcelona;290;Ullastrell;964;492;472
08;Barcelona;291;Vacarisses;1378;718;660
08;Barcelona;292;Vallbona d'Anoia;1029;512;517
08;Barcelona;293;Vallcebre;288;155;133
08;Barcelona;294;Vallgorguina;857;427;430
08;Barcelona;295;Vallirana;7383;3711;3672
08;Barcelona;296;Vallromanes;857;437;420
08;Barcelona;297;Veciana;167;87;80
08;Barcelona;298;Vic;30037;14475;15562
08;Barcelona;299;Vilada;536;273;263
08;Barcelona;301;Viladecans;51646;26076;25570
08;Barcelona;300;Viladecavalls;4188;2064;2124
08;Barcelona;305;Vilafranca del Penedès;28116;13753;14363
08;Barcelona;306;Vilalba Sasserra;316;165;151
08;Barcelona;303;Vilanova de Sau;297;144;153
08;Barcelona;302;Vilanova del Camí;9853;4969;4884
08;Barcelona;902;Vilanova del Vallès;1743;885;858
08;Barcelona;307;Vilanova i la Geltrú;48268;23685;24583
08;Barcelona;214;Vilassar de Dalt;7119;3473;3646
08;Barcelona;219;Vilassar de Mar;14080;6908;7172
08;Barcelona;304;Vilobí del Penedès;816;414;402
08;Barcelona;308;Viver i Serrateix;207;113;94
09;Burgos;001;Abajas;51;24;27
09;Burgos;003;Adrada de Haza;317;166;151
09;Burgos;006;Aguas Cándidas;104;57;47
09;Burgos;007;Aguilar de Bureba;110;58;52
09;Burgos;009;Albillos;144;75;69
09;Burgos;010;Alcocero de Mola;63;38;25
09;Burgos;011;Alfoz de Bricia;143;68;75
09;Burgos;907;Alfoz de Quintanadueñas;516;275;241
09;Burgos;012;Alfoz de Santa Gadea;164;86;78
09;Burgos;013;Altable;74;45;29
09;Burgos;014;Altos (Los);288;165;123
09;Burgos;016;Ameyugo;62;31;31
09;Burgos;017;Anguix;185;94;91
09;Burgos;018;Aranda de Duero;30475;15211;15264
09;Burgos;019;Arandilla;221;132;89
09;Burgos;020;Arauzo de Miel;438;243;195
09;Burgos;021;Arauzo de Salce;82;48;34
09;Burgos;022;Arauzo de Torre;119;65;54
09;Burgos;023;Arcos;247;147;100
09;Burgos;024;Arenillas de Riopisuerga;238;125;113
09;Burgos;025;Arija;278;131;147
09;Burgos;026;Arlanzón;412;216;196
09;Burgos;027;Arraya de Oca;56;30;26
09;Burgos;029;Atapuerca;148;74;74
09;Burgos;030;Ausines (Los);124;70;54
09;Burgos;032;Avellanosa de Muñó;200;104;96
09;Burgos;033;Bahabón de Esgueva;166;95;71
09;Burgos;034;Balbases (Los);394;207;187
09;Burgos;035;Baños de Valdearados;541;296;245
09;Burgos;036;Bañuelos de Bureba;57;37;20
09;Burgos;037;Barbadillo de Herreros;154;82;72
09;Burgos;038;Barbadillo del Mercado;200;99;101
09;Burgos;039;Barbadillo del Pez;115;64;51
09;Burgos;041;Barrio de Muñó;35;20;15
09;Burgos;043;Barrios de Bureba (Los);329;176;153
09;Burgos;044;Barrios de Colina;89;50;39
09;Burgos;045;Basconcillos del Tozo;433;228;205
09;Burgos;046;Bascuñana;83;45;38
09;Burgos;047;Belbimbre;87;45;42
09;Burgos;048;Belorado;2194;1119;1075
09;Burgos;050;Berberana;100;50;50
09;Burgos;051;Berlangas de Roa;301;157;144
09;Burgos;052;Berzosa de Bureba;51;29;22
09;Burgos;054;Bozoó;107;56;51
09;Burgos;055;Brazacorta;99;54;45
09;Burgos;056;Briviesca;5937;2949;2988
09;Burgos;057;Bugedo;111;81;30
09;Burgos;058;Buniel;145;83;62
09;Burgos;059;Burgos;166251;80811;85440
09;Burgos;060;Busto de Bureba;304;159;145
09;Burgos;061;Cabañes de Esgueva;294;152;142
09;Burgos;062;Cabezón de la Sierra;87;40;47
09;Burgos;063;Cabia;223;117;106
09;Burgos;064;Caleruega;440;220;220
09;Burgos;065;Campillo de Aranda;187;104;83
09;Burgos;066;Campolara;109;61;48
09;Burgos;067;Canicosa de la Sierra;669;341;328
09;Burgos;068;Cantabrana;67;36;31
09;Burgos;070;Carazo;49;29;20
09;Burgos;071;Carcedo de Bureba;42;23;19
09;Burgos;072;Carcedo de Burgos;131;76;55
09;Burgos;073;Cardeñadijo;333;179;154
09;Burgos;074;Cardeñajimeno;328;188;140
09;Burgos;075;Cardeñuela Riopico;80;38;42
09;Burgos;076;Carrias;53;36;17
09;Burgos;077;Cascajares de Bureba;69;39;30
09;Burgos;078;Cascajares de la Sierra;17;10;7
09;Burgos;079;Castellanos de Castro;73;41;32
09;Burgos;083;Castil de Peones;47;24;23
09;Burgos;082;Castildelgado;90;45;45
09;Burgos;084;Castrillo de la Reina;330;198;132
09;Burgos;085;Castrillo de la Vega;622;324;298
09;Burgos;088;Castrillo de Riopisuerga;101;60;41
09;Burgos;086;Castrillo del Val;245;142;103
09;Burgos;090;Castrillo Matajudíos;83;43;40
09;Burgos;091;Castrojeriz;1131;567;564
09;Burgos;093;Cayuela;113;67;46
09;Burgos;094;Cebrecos;78;45;33
09;Burgos;095;Celada del Camino;99;43;56
09;Burgos;098;Cerezo de Río Tirón;844;444;400
09;Burgos;100;Cerratón de Juarros;69;37;32
09;Burgos;101;Ciadoncha;144;84;60
09;Burgos;102;Cillaperlata;84;44;40
09;Burgos;103;Cilleruelo de Abajo;385;208;177
09;Burgos;104;Cilleruelo de Arriba;93;49;44
09;Burgos;105;Ciruelos de Cervera;182;93;89
09;Burgos;108;Cogollos;216;121;95
09;Burgos;109;Condado de Treviño;910;495;415
09;Burgos;110;Contreras;89;54;35
09;Burgos;112;Coruña del Conde;171;90;81
09;Burgos;113;Covarrubias;650;335;315
09;Burgos;114;Cubillo del Campo;76;40;36
09;Burgos;115;Cubo de Bureba;145;69;76
09;Burgos;117;Cueva de Roa (La);145;82;63
09;Burgos;119;Cuevas de San Clemente;64;31;33
09;Burgos;120;Encío;66;36;30
09;Burgos;122;Espinosa de Cervera;120;71;49
09;Burgos;124;Espinosa de los Monteros;2460;1272;1188
09;Burgos;123;Espinosa del Camino;58;29;29
09;Burgos;125;Estépar;875;467;408
09;Burgos;127;Fontioso;101;54;47
09;Burgos;128;Frandovínez;100;53;47
09;Burgos;129;Fresneda de la Sierra Tirón;112;59;53
09;Burgos;130;Fresneña;139;74;65
09;Burgos;131;Fresnillo de las Dueñas;317;166;151
09;Burgos;132;Fresno de Río Tirón;272;153;119
09;Burgos;133;Fresno de Rodilla;34;19;15
09;Burgos;134;Frías;341;180;161
09;Burgos;135;Fuentebureba;101;49;52
09;Burgos;136;Fuentecén;325;177;148
09;Burgos;137;Fuentelcésped;234;117;117
09;Burgos;138;Fuentelisendo;136;69;67
09;Burgos;139;Fuentemolinos;134;72;62
09;Burgos;140;Fuentenebro;217;112;105
09;Burgos;141;Fuentespina;566;291;275
09;Burgos;143;Galbarros;27;19;8
09;Burgos;144;Gallega (La);93;55;38
09;Burgos;148;Grijalba;156;75;81
09;Burgos;149;Grisaleña;60;36;24
09;Burgos;151;Gumiel de Izán;692;366;326
09;Burgos;152;Gumiel de Mercado;463;254;209
09;Burgos;154;Hacinas;214;113;101
09;Burgos;155;Haza;46;22;24
09;Burgos;159;Hontanas;89;51;38
09;Burgos;160;Hontangas;162;88;74
09;Burgos;162;Hontoria de la Cantera;106;53;53
09;Burgos;164;Hontoria de Valdearados;254;147;107
09;Burgos;163;Hontoria del Pinar;979;523;456
09;Burgos;166;Hormazas (Las);161;78;83
09;Burgos;167;Hornillos del Camino;80;43;37
09;Burgos;168;Horra (La);510;264;246
09;Burgos;169;Hortigüela;120;67;53
09;Burgos;170;Hoyales de Roa;344;169;175
09;Burgos;172;Huérmeces;163;93;70
09;Burgos;173;Huerta de Arriba;214;108;106
09;Burgos;174;Huerta de Rey;1248;650;598
09;Burgos;175;Humada;275;156;119
09;Burgos;176;Hurones;59;37;22
09;Burgos;177;Ibeas de Juarros;859;464;395
09;Burgos;178;Ibrillos;111;64;47
09;Burgos;179;Iglesiarrubia;74;38;36
09;Burgos;180;Iglesias;214;111;103
09;Burgos;181;Isar;455;212;243
09;Burgos;182;Itero del Castillo;135;65;70
09;Burgos;183;Jaramillo de la Fuente;33;17;16
09;Burgos;184;Jaramillo Quemado;16;10;6
09;Burgos;189;Junta de Traslaloma;246;125;121
09;Burgos;190;Junta de Villalba de Losa;105;58;47
09;Burgos;191;Jurisdicción de Lara;75;44;31
09;Burgos;192;Jurisdicción de San Zadornil;84;43;41
09;Burgos;194;Lerma;2594;1315;1279
09;Burgos;195;Llano de Bureba;65;42;23
09;Burgos;196;Madrigal del Monte;180;89;91
09;Burgos;197;Madrigalejo del Monte;181;101;80
09;Burgos;198;Mahamud;176;90;86
09;Burgos;199;Mambrilla de Castrejón;178;94;84
09;Burgos;200;Mambrillas de Lara;77;38;39
09;Burgos;201;Mamolar;89;46;43
09;Burgos;202;Manciles;48;27;21
09;Burgos;206;Mazuela;91;47;44
09;Burgos;208;Mecerreyes;305;151;154
09;Burgos;209;Medina de Pomar;5665;2827;2838
09;Burgos;211;Melgar de Fernamental;2215;1128;1087
09;Burgos;213;Merindad de Cuesta-Urria;577;338;239
09;Burgos;214;Merindad de Montija;1062;568;494
09;Burgos;431;Villafranca Montes de Oca;221;117;104
09;Burgos;432;Villafruela;337;181;156
09;Burgos;433;Villagalijo;68;37;31
09;Burgos;434;Villagonzalo Pedernales;569;281;288
09;Burgos;437;Villahoz;450;221;229
09;Burgos;438;Villalba de Duero;545;303;242
09;Burgos;439;Villalbilla de Burgos;628;345;283
09;Burgos;440;Villalbilla de Gumiel;147;82;65
09;Burgos;441;Villaldemiro;99;44;55
09;Burgos;442;Villalmanzo;446;237;209
09;Burgos;443;Villamayor de los Montes;299;148;151
09;Burgos;444;Villamayor de Treviño;124;68;56
09;Burgos;445;Villambistia;86;48;38
09;Burgos;446;Villamedianilla;27;14;13
09;Burgos;447;Villamiel de la Sierra;36;23;13
09;Burgos;448;Villangómez;385;197;188
09;Burgos;449;Villanueva de Argaño;117;63;54
09;Burgos;450;Villanueva de Carazo;25;14;11
09;Burgos;451;Villanueva de Gumiel;335;177;158
09;Burgos;454;Villanueva de Teba;76;41;35
09;Burgos;455;Villaquirán de la Puebla;78;43;35
09;Burgos;456;Villaquirán de los Infantes;225;116;109
09;Burgos;903;Villarcayo de Merindad de Castilla la Vieja;4162;2074;2088
09;Burgos;458;Villariezo;155;84;71
09;Burgos;460;Villasandino;308;154;154
09;Burgos;463;Villasur de Herreros;337;175;162
09;Burgos;464;Villatuelda;83;45;38
09;Burgos;466;Villaverde del Monte;202;110;92
09;Burgos;467;Villaverde-Mogina;145;85;60
09;Burgos;471;Villayerno Morquillas;134;60;74
09;Burgos;472;Villazopeque;96;52;44
09;Burgos;473;Villegas;151;79;72
09;Burgos;476;Villoruebo;43;29;14
09;Burgos;424;Viloria de Rioja;81;44;37
09;Burgos;425;Vilviestre del Pinar;843;428;415
09;Burgos;478;Vizcaínos;48;26;22
09;Burgos;480;Zael;165;81;84
09;Burgos;482;Zarzosa de Río Pisuerga;84;43;41
09;Burgos;483;Zazuar;294;155;139
09;Burgos;485;Zuñeda;100;49;51
09;Burgos;906;Merindad de Río Ubierna;1200;633;567
09;Burgos;215;Merindad de Sotoscueva;692;360;332
09;Burgos;216;Merindad de Valdeporres;582;299;283
09;Burgos;217;Merindad de Valdivielso;621;318;303
09;Burgos;218;Milagros;464;244;220
09;Burgos;219;Miranda de Ebro;36874;18346;18528
09;Burgos;220;Miraveche;124;69;55
09;Burgos;221;Modúbar de la Emparedada;221;120;101
09;Burgos;223;Monasterio de la Sierra;36;20;16
09;Burgos;224;Monasterio de Rodilla;215;115;100
09;Burgos;225;Moncalvillo;146;82;64
09;Burgos;226;Monterrubio de la Demanda;95;51;44
09;Burgos;227;Montorio;165;79;86
09;Burgos;228;Moradillo de Roa;247;132;115
09;Burgos;229;Nava de Roa;318;163;155
09;Burgos;230;Navas de Bureba;49;25;24
09;Burgos;231;Nebreda;120;74;46
09;Burgos;232;Neila;243;121;122
09;Burgos;235;Olmedillo de Roa;258;131;127
09;Burgos;236;Olmillos de Muñó;50;28;22
09;Burgos;238;Oña;1860;924;936
09;Burgos;239;Oquillas;80;39;41
09;Burgos;241;Orbaneja Riopico;175;97;78
09;Burgos;242;Padilla de Abajo;120;65;55
09;Burgos;243;Padilla de Arriba;149;78;71
09;Burgos;244;Padrones de Bureba;92;49;43
09;Burgos;246;Palacios de la Sierra;998;508;490
09;Burgos;247;Palacios de Riopisuerga;42;21;21
09;Burgos;248;Palazuelos de la Sierra;70;35;35
09;Burgos;249;Palazuelos de Muñó;85;46;39
09;Burgos;250;Pampliega;454;230;224
09;Burgos;251;Pancorbo;562;296;266
09;Burgos;253;Pardilla;111;53;58
09;Burgos;255;Partido de la Sierra en Tobalina;80;44;36
09;Burgos;256;Pedrosa de Duero;628;335;293
09;Burgos;259;Pedrosa de Río Úrbel;313;179;134
09;Burgos;257;Pedrosa del Páramo;123;69;54
09;Burgos;258;Pedrosa del Príncipe;318;161;157
09;Burgos;261;Peñaranda de Duero;667;357;310
09;Burgos;262;Peral de Arlanza;261;138;123
09;Burgos;265;Piérnigas;43;29;14
09;Burgos;266;Pineda de la Sierra;122;67;55
09;Burgos;267;Pineda Trasmonte;205;104;101
09;Burgos;268;Pinilla de los Barruecos;136;72;64
09;Burgos;269;Pinilla de los Moros;54;35;19
09;Burgos;270;Pinilla Trasmonte;264;139;125
09;Burgos;272;Poza de la Sal;470;234;236
09;Burgos;273;Prádanos de Bureba;83;47;36
09;Burgos;274;Pradoluengo;1732;838;894
09;Burgos;275;Presencio;358;188;170
09;Burgos;276;Puebla de Arganzón (La);235;130;105
09;Burgos;277;Puentedura;140;73;67
09;Burgos;279;Quemada;261;145;116
09;Burgos;281;Quintana del Pidio;216;117;99
09;Burgos;280;Quintanabureba;48;30;18
09;Burgos;283;Quintanaélez;120;62;58
09;Burgos;287;Quintanaortuño;115;58;57
09;Burgos;288;Quintanapalla;130;69;61
09;Burgos;289;Quintanar de la Sierra;2427;1246;1181
09;Burgos;292;Quintanavides;82;36;46
09;Burgos;294;Quintanilla de la Mata;175;98;77
09;Burgos;901;Quintanilla del Agua y Tordueles;652;336;316
09;Burgos;295;Quintanilla del Coco;129;68;61
09;Burgos;298;Quintanilla San García;135;70;65
09;Burgos;301;Quintanilla Vivar;372;186;186
09;Burgos;297;Quintanillas (Las);356;192;164
09;Burgos;302;Rabanera del Pinar;171;90;81
09;Burgos;303;Rábanos;66;35;31
09;Burgos;304;Rabé de las Calzadas;161;85;76
09;Burgos;306;Rebolledo de la Torre;190;94;96
09;Burgos;307;Redecilla del Camino;160;94;66
09;Burgos;308;Redecilla del Campo;103;51;52
09;Burgos;309;Regumiel de la Sierra;549;278;271
09;Burgos;310;Reinoso;29;19;10
09;Burgos;311;Retuerta;79;44;35
09;Burgos;314;Revilla del Campo;135;69;66
09;Burgos;316;Revilla Vallejera;186;103;83
09;Burgos;312;Revilla y Ahedo (La);131;66;65
09;Burgos;315;Revillarruz;156;80;76
09;Burgos;317;Rezmondo;26;13;13
09;Burgos;318;Riocavado de la Sierra;77;44;33
09;Burgos;321;Roa;2398;1210;1188
09;Burgos;323;Rojas;113;61;52
09;Burgos;325;Royuela de Río Franco;388;210;178
09;Burgos;326;Rubena;151;74;77
09;Burgos;327;Rublacedo de Abajo;41;19;22
09;Burgos;328;Rucandio;139;68;71
09;Burgos;329;Salas de Bureba;186;103;83
09;Burgos;330;Salas de los Infantes;2073;1043;1030
09;Burgos;332;Saldaña de Burgos;106;56;50
09;Burgos;334;Salinillas de Bureba;67;39;28
09;Burgos;335;San Adrián de Juarros;37;16;21
09;Burgos;337;San Juan del Monte;190;100;90
09;Burgos;338;San Mamés de Burgos;169;88;81
09;Burgos;339;San Martín de Rubiales;335;179;156
09;Burgos;340;San Millán de Lara;93;54;39
09;Burgos;360;San Vicente del Valle;29;19;10
09;Burgos;343;Santa Cecilia;143;76;67
09;Burgos;345;Santa Cruz de la Salceda;195;104;91
09;Burgos;346;Santa Cruz del Valle Urbión;135;78;57
09;Burgos;347;Santa Gadea del Cid;225;118;107
09;Burgos;348;Santa Inés;218;117;101
09;Burgos;350;Santa María del Campo;752;389;363
09;Burgos;351;Santa María del Invierno;58;33;25
09;Burgos;352;Santa María del Mercadillo;205;115;90
09;Burgos;353;Santa María Rivarredonda;140;79;61
09;Burgos;354;Santa Olalla de Bureba;48;21;27
09;Burgos;355;Santibáñez de Esgueva;182;91;91
09;Burgos;356;Santibáñez del Val;71;39;32
09;Burgos;358;Santo Domingo de Silos;332;207;125
09;Burgos;361;Sargentes de la Lora;197;99;98
09;Burgos;362;Sarracín;148;82;66
09;Burgos;363;Sasamón;1514;808;706
09;Burgos;365;Sequera de Haza (La);74;42;32
09;Burgos;366;Solarana;130;69;61
09;Burgos;368;Sordillos;42;24;18
09;Burgos;369;Sotillo de la Ribera;621;341;280
09;Burgos;372;Sotragero;126;73;53
09;Burgos;373;Sotresgudo;834;442;392
09;Burgos;374;Susinos del Páramo;61;34;27
09;Burgos;375;Tamarón;53;29;24
09;Burgos;377;Tardajos;755;427;328
09;Burgos;378;Tejada;56;32;24
09;Burgos;380;Terradillos de Esgueva;141;72;69
09;Burgos;381;Tinieblas de la Sierra;35;18;17
09;Burgos;382;Tobar;55;27;28
09;Burgos;384;Tordómar;415;230;185
09;Burgos;386;Torrecilla del Monte;84;48;36
09;Burgos;387;Torregalindo;161;90;71
09;Burgos;388;Torrelara;27;13;14
09;Burgos;389;Torrepadre;182;101;81
09;Burgos;390;Torresandino;814;433;381
09;Burgos;391;Tórtoles de Esgueva;592;322;270
09;Burgos;392;Tosantos;81;39;42
09;Burgos;394;Trespaderne;1200;627;573
09;Burgos;395;Tubilla del Agua;167;99;68
09;Burgos;396;Tubilla del Lago;223;117;106
09;Burgos;398;Úrbel del Castillo;112;59;53
09;Burgos;400;Vadocondes;482;244;238
09;Burgos;403;Valdeande;175;101;74
09;Burgos;405;Valdezate;236;125;111
09;Burgos;406;Valdorros;106;61;45
09;Burgos;408;Vallarta de Bureba;84;48;36
09;Burgos;904;Valle de las Navas;693;374;319
09;Burgos;908;Valle de Losa;712;402;310
09;Burgos;409;Valle de Manzanedo;133;74;59
09;Burgos;410;Valle de Mena;4659;2371;2288
09;Burgos;411;Valle de Oca;219;107;112
09;Burgos;902;Valle de Santibáñez;692;358;334
09;Burgos;905;Valle de Sedano;535;292;243
09;Burgos;412;Valle de Tobalina;1086;591;495
09;Burgos;413;Valle de Valdebezana;870;470;400
09;Burgos;414;Valle de Valdelaguna;287;153;134
09;Burgos;415;Valle de Valdelucio;415;225;190
09;Burgos;416;Valle de Zamanzas;47;25;22
09;Burgos;417;Vallejera;58;31;27
09;Burgos;418;Valles de Palenzuela;111;57;54
09;Burgos;419;Valluércanes;137;79;58
09;Burgos;407;Valmala;33;17;16
09;Burgos;422;Vid de Bureba (La);64;31;33
09;Burgos;421;Vid y Barrios (La);382;220;162
09;Burgos;423;Vileña;51;31;20
09;Burgos;427;Villadiego;2316;1240;1076
09;Burgos;428;Villaescusa de Roa;188;101;87
09;Burgos;429;Villaescusa la Sombría;69;42;27
09;Burgos;430;Villaespasa;39;22;17
10;Cáceres;001;Abadía;306;175;131
10;Cáceres;002;Abertura;518;276;242
10;Cáceres;003;Acebo;868;447;421
10;Cáceres;004;Acehúche;1005;504;501
10;Cáceres;005;Aceituna;763;383;380
10;Cáceres;006;Ahigal;1777;929;848
10;Cáceres;007;Albalá del Caudillo;920;459;461
10;Cáceres;008;Alcántara;1991;1004;987
10;Cáceres;009;Alcollarín;373;172;201
10;Cáceres;010;Alcuéscar;3347;1740;1607
10;Cáceres;012;Aldea del Cano;783;386;397
10;Cáceres;013;Aldea del Obispo (La);423;218;205
10;Cáceres;011;Aldeacentenera;1013;497;516
10;Cáceres;014;Aldeanueva de la Vera;2641;1317;1324
10;Cáceres;015;Aldeanueva del Camino;991;472;519
10;Cáceres;016;Aldehuela de Jerte;396;224;172
10;Cáceres;017;Alía;1622;811;811
10;Cáceres;018;Aliseda;2488;1246;1242
10;Cáceres;019;Almaraz;1470;746;724
10;Cáceres;020;Almoharín;2140;1050;1090
10;Cáceres;021;Arroyo de la Luz;6694;3332;3362
10;Cáceres;023;Arroyomolinos;1157;596;561
10;Cáceres;022;Arroyomolinos de la Vera;638;316;322
10;Cáceres;024;Baños de Montemayor;740;342;398
10;Cáceres;025;Barrado;579;289;290
10;Cáceres;026;Belvís de Monroy;574;294;280
10;Cáceres;027;Benquerencia;119;67;52
10;Cáceres;028;Berrocalejo;143;67;76
10;Cáceres;029;Berzocana;708;355;353
10;Cáceres;030;Bohonal de Ibor;635;325;310
10;Cáceres;031;Botija;198;91;107
10;Cáceres;032;Brozas;2477;1227;1250
10;Cáceres;033;Cabañas del Castillo;679;347;332
10;Cáceres;034;Cabezabellosa;619;301;318
10;Cáceres;035;Cabezuela del Valle;2410;1232;1178
10;Cáceres;036;Cabrero;478;248;230
10;Cáceres;037;Cáceres;80235;38571;41664
10;Cáceres;038;Cachorrilla;108;51;57
10;Cáceres;039;Cadalso;604;308;296
10;Cáceres;040;Calzadilla;622;301;321
10;Cáceres;041;Caminomorisco;1327;696;631
10;Cáceres;042;Campillo de Deleitosa;162;79;83
10;Cáceres;043;Campo Lugar;1278;634;644
10;Cáceres;044;Cañamero;2057;1043;1014
10;Cáceres;045;Cañaveral;1695;813;882
10;Cáceres;046;Carbajo;301;159;142
10;Cáceres;047;Carcaboso;1293;681;612
10;Cáceres;048;Carrascalejo;476;229;247
10;Cáceres;049;Casar de Cáceres;4348;2207;2141
10;Cáceres;050;Casar de Palomero;1452;743;709
10;Cáceres;051;Casares de las Hurdes;961;493;468
10;Cáceres;052;Casas de Don Antonio;268;125;143
10;Cáceres;053;Casas de Don Gómez;414;210;204
10;Cáceres;056;Casas de Millán;869;445;424
10;Cáceres;057;Casas de Miravete;159;85;74
10;Cáceres;054;Casas del Castañar;740;363;377
10;Cáceres;055;Casas del Monte;946;492;454
10;Cáceres;058;Casatejada;1446;720;726
10;Cáceres;059;Casillas de Coria;626;294;332
10;Cáceres;060;Castañar de Ibor;1404;707;697
10;Cáceres;061;Ceclavín;2405;1221;1184
10;Cáceres;062;Cedillo;596;304;292
10;Cáceres;063;Cerezo;260;121;139
10;Cáceres;064;Cilleros;2381;1197;1184
10;Cáceres;065;Collado;362;191;171
10;Cáceres;066;Conquista de la Sierra;204;103;101
10;Cáceres;067;Coria;11916;5945;5971
10;Cáceres;068;Cuacos de Yuste;965;500;465
10;Cáceres;069;Cumbre (La);1255;621;634
10;Cáceres;070;Deleitosa;1051;522;529
10;Cáceres;071;Descargamaría;270;133;137
10;Cáceres;072;Eljas;1360;692;668
10;Cáceres;073;Escurial;1021;508;513
10;Cáceres;075;Fresnedoso de Ibor;502;260;242
10;Cáceres;076;Galisteo;2078;1047;1031
10;Cáceres;077;Garciaz;1102;557;545
10;Cáceres;078;Garganta (La);647;338;309
10;Cáceres;079;Garganta la Olla;1247;652;595
10;Cáceres;080;Gargantilla;556;287;269
10;Cáceres;081;Gargüera;265;126;139
10;Cáceres;082;Garrovillas de Alconétar;2641;1262;1379
10;Cáceres;083;Garvín;126;69;57
10;Cáceres;084;Gata;2066;1033;1033
10;Cáceres;085;Gordo (El);333;171;162
10;Cáceres;086;Granja (La);478;250;228
10;Cáceres;087;Guadalupe;2461;1221;1240
10;Cáceres;088;Guijo de Coria;339;178;161
10;Cáceres;089;Guijo de Galisteo;1778;915;863
10;Cáceres;090;Guijo de Granadilla;816;393;423
10;Cáceres;091;Guijo de Santa Bárbara;545;268;277
10;Cáceres;092;Herguijuela;451;219;232
10;Cáceres;093;Hernán-Pérez;499;261;238
10;Cáceres;094;Herrera de Alcántara;372;190;182
10;Cáceres;095;Herreruela;516;264;252
10;Cáceres;096;Hervás;3935;1896;2039
10;Cáceres;097;Higuera;126;69;57
10;Cáceres;098;Hinojal;473;229;244
10;Cáceres;099;Holguera;873;440;433
10;Cáceres;100;Hoyos;971;472;499
10;Cáceres;101;Huélaga;200;98;102
10;Cáceres;102;Ibahernando;851;426;425
10;Cáceres;103;Jaraicejo;735;366;369
10;Cáceres;104;Jaraíz de la Vera;7681;3902;3779
10;Cáceres;105;Jarandilla de la Vera;3150;1560;1590
10;Cáceres;106;Jarilla;198;102;96
10;Cáceres;107;Jerte;1391;721;670
10;Cáceres;108;Ladrillar;428;226;202
10;Cáceres;109;Logrosán;2764;1361;1403
10;Cáceres;110;Losar de la Vera;3115;1556;1559
10;Cáceres;111;Madrigal de la Vera;1827;942;885
10;Cáceres;112;Madrigalejo;2462;1216;1246
10;Cáceres;113;Madroñera;3245;1622;1623
10;Cáceres;114;Majadas;1308;747;561
10;Cáceres;115;Malpartida de Cáceres;4114;2054;2060
10;Cáceres;116;Malpartida de Plasencia;4233;2072;2161
10;Cáceres;117;Marchagaz;422;201;221
10;Cáceres;118;Mata de Alcántara;398;201;197
10;Cáceres;119;Membrío;978;463;515
10;Cáceres;120;Mesas de Ibor;224;116;108
10;Cáceres;121;Miajadas;10025;5014;5011
10;Cáceres;122;Millanes;266;143;123
10;Cáceres;123;Mirabel;902;443;459
10;Cáceres;124;Mohedas de Granadilla;1184;607;577
10;Cáceres;125;Monroy;1338;651;687
10;Cáceres;126;Montánchez;2424;1203;1221
10;Cáceres;127;Montehermoso;5353;2694;2659
10;Cáceres;128;Moraleja;8258;4113;4145
10;Cáceres;129;Morcillo;588;278;310
10;Cáceres;130;Navaconcejo;2216;1124;1092
10;Cáceres;131;Navalmoral de la Mata;16122;8046;8076
10;Cáceres;132;Navalvillar de Ibor;608;310;298
10;Cáceres;133;Navas del Madroño;1718;862;856
10;Cáceres;134;Navezuelas;787;418;369
10;Cáceres;135;Nuñomoral;2121;1116;1005
10;Cáceres;136;Oliva de Plasencia;367;173;194
10;Cáceres;137;Palomero;611;319;292
10;Cáceres;138;Pasarón de la Vera;729;368;361
10;Cáceres;139;Pedroso de Acim;181;88;93
10;Cáceres;140;Peraleda de la Mata;1496;751;745
10;Cáceres;141;Peraleda de San Román;421;205;216
10;Cáceres;142;Perales del Puerto;1062;528;534
10;Cáceres;143;Pescueza;263;131;132
10;Cáceres;144;Pesga (La);1387;722;665
10;Cáceres;145;Piedras Albas;262;121;141
10;Cáceres;146;Pinofranqueado;1830;967;863
10;Cáceres;147;Piornal;1619;793;826
10;Cáceres;148;Plasencia;37554;18433;19121
10;Cáceres;149;Plasenzuela;529;260;269
10;Cáceres;150;Portaje;463;227;236
10;Cáceres;151;Portezuelo;353;160;193
10;Cáceres;152;Pozuelo de Zarzón;683;339;344
10;Cáceres;153;Puerto de Santa Cruz;451;213;238
10;Cáceres;154;Rebollar;282;149;133
10;Cáceres;155;Riolobos;1800;952;848
10;Cáceres;156;Robledillo de Gata;208;108;100
10;Cáceres;157;Robledillo de la Vera;455;223;232
10;Cáceres;158;Robledillo de Trujillo;538;271;267
10;Cáceres;159;Robledollano;431;228;203
10;Cáceres;160;Romangordo;220;107;113
10;Cáceres;901;Rosalejo;"";"";""
10;Cáceres;161;Ruanes;106;52;54
10;Cáceres;162;Salorino;960;467;493
10;Cáceres;163;Salvatierra de Santiago;454;235;219
10;Cáceres;164;San Martín de Trevejo;947;468;479
10;Cáceres;165;Santa Ana;402;204;198
10;Cáceres;166;Santa Cruz de la Sierra;397;207;190
10;Cáceres;167;Santa Cruz de Paniagua;489;260;229
10;Cáceres;168;Santa Marta de Magasca;393;201;192
10;Cáceres;169;Santiago de Alcántara;869;429;440
10;Cáceres;170;Santiago del Campo;358;181;177
10;Cáceres;171;Santibáñez el Alto;531;269;262
10;Cáceres;172;Santibáñez el Bajo;1059;561;498
10;Cáceres;173;Saucedilla;620;309;311
10;Cáceres;174;Segura de Toro;213;115;98
10;Cáceres;175;Serradilla;2219;1119;1100
10;Cáceres;176;Serrejón;515;260;255
10;Cáceres;177;Sierra de Fuentes;1635;802;833
10;Cáceres;178;Talaván;1092;538;554
10;Cáceres;179;Talaveruela de la Vera;523;245;278
10;Cáceres;180;Talayuela;9450;5323;4127
10;Cáceres;181;Tejeda de Tiétar;1043;565;478
10;Cáceres;182;Toril;190;106;84
10;Cáceres;183;Tornavacas;1458;760;698
10;Cáceres;184;Torno (El);1090;562;528
10;Cáceres;187;Torre de Don Miguel;687;342;345
10;Cáceres;188;Torre de Santa María;816;399;417
10;Cáceres;185;Torrecilla de los Ángeles;709;362;347
10;Cáceres;186;Torrecillas de la Tiesa;1292;654;638
10;Cáceres;190;Torrejón el Rubio;827;422;405
10;Cáceres;189;Torrejoncillo;3751;1802;1949
10;Cáceres;191;Torremenga;607;313;294
10;Cáceres;192;Torremocha;1340;644;696
10;Cáceres;193;Torreorgaz;1490;761;729
10;Cáceres;194;Torrequemada;640;289;351
10;Cáceres;195;Trujillo;9332;4442;4890
10;Cáceres;196;Valdastillas;462;226;236
10;Cáceres;197;Valdecañas de Tajo;141;72;69
10;Cáceres;198;Valdefuentes;1695;834;861
10;Cáceres;199;Valdehúncar;168;76;92
10;Cáceres;200;Valdelacasa de Tajo;700;324;376
10;Cáceres;201;Valdemorales;274;133;141
10;Cáceres;202;Valdeobispo;886;444;442
10;Cáceres;203;Valencia de Alcántara;6434;3158;3276
10;Cáceres;204;Valverde de la Vera;700;351;349
10;Cáceres;205;Valverde del Fresno;2810;1419;1391
10;Cáceres;206;Viandar de la Vera;357;164;193
10;Cáceres;207;Villa del Campo;701;346;355
10;Cáceres;208;Villa del Rey;188;92;96
10;Cáceres;209;Villamesías;484;233;251
10;Cáceres;210;Villamiel;811;402;409
10;Cáceres;211;Villanueva de la Sierra;687;332;355
10;Cáceres;212;Villanueva de la Vera;2250;1138;1112
10;Cáceres;214;Villar de Plasencia;322;159;163
10;Cáceres;213;Villar del Pedroso;928;468;460
10;Cáceres;215;Villasbuenas de Gata;553;285;268
10;Cáceres;216;Zarza de Granadilla;1905;980;925
10;Cáceres;217;Zarza de Montánchez;719;358;361
10;Cáceres;218;Zarza la Mayor;1711;856;855
10;Cáceres;219;Zorita;2224;1081;1143
11;Cádiz;001;Alcalá de los Gazules;5688;2958;2730
11;Cádiz;002;Alcalá del Valle;5421;2756;2665
11;Cádiz;003;Algar;1891;1021;870
11;Cádiz;004;Algeciras;103787;51144;52643
11;Cádiz;005;Algodonales;5833;3014;2819
11;Cádiz;006;Arcos de la Frontera;27901;13982;13919
11;Cádiz;007;Barbate;22664;11348;11316
11;Cádiz;008;Barrios (Los);14920;7574;7346
11;Cádiz;901;Benalup-Casas Viejas;6067;3130;2937
11;Cádiz;009;Benaocaz;578;294;284
11;Cádiz;010;Bornos;8051;4023;4028
11;Cádiz;011;Bosque (El);1802;923;879
11;Cádiz;013;Castellar de la Frontera;2418;1224;1194
11;Cádiz;015;Chiclana de la Frontera;50697;25895;24802
11;Cádiz;016;Chipiona;15399;7815;7584
11;Cádiz;014;Conil de la Frontera;16359;8312;8047
11;Cádiz;012;Cádiz;155438;75203;80235
11;Cádiz;017;Espera;4197;2159;2038
11;Cádiz;018;Gastor (El);2121;1134;987
11;Cádiz;019;Grazalema;2296;1184;1112
11;Cádiz;020;Jerez de la Frontera;190390;93510;96880
11;Cádiz;021;Jimena de la Frontera;9025;4621;4404
11;Cádiz;022;Línea de la Concepción (La);61280;29945;31335
11;Cádiz;023;Medina-Sidonia;10850;5598;5252
11;Cádiz;024;Olvera;9144;4592;4552
11;Cádiz;025;Paterna de Rivera;5063;2604;2459
11;Cádiz;026;Prado del Rey;5665;2837;2828
11;Cádiz;028;Puerto Real;31086;15646;15440
11;Cádiz;029;Puerto Serrano;6648;3386;3262
11;Cádiz;027;Puerto de Santa María (El);69656;34875;34781
11;Cádiz;030;Rota;24287;12198;12089
11;Cádiz;031;San Fernando;87588;43305;44283
11;Cádiz;902;San José del Valle;"";"";""
11;Cádiz;033;San Roque;22079;11087;10992
11;Cádiz;032;Sanlúcar de Barrameda;59780;29956;29824
11;Cádiz;034;Setenil de las Bodegas;3301;1653;1648
11;Cádiz;035;Tarifa;14934;7551;7383
11;Cádiz;036;Torre Alháquime;1004;515;489
11;Cádiz;037;Trebujena;6999;3575;3424
11;Cádiz;038;Ubrique;18320;9134;9186
11;Cádiz;039;Vejer de la Frontera;12957;6613;6344
11;Cádiz;040;Villaluenga del Rosario;495;259;236
11;Cádiz;041;Villamartín;12473;6256;6217
11;Cádiz;042;Zahara;1585;800;785
12;Castellón/Castelló;002;Aín;131;65;66
12;Castellón/Castelló;003;Albocàsser;1449;697;752
12;Castellón/Castelló;004;Alcalà de Xivert;4925;2482;2443
12;Castellón/Castelló;005;Alcora (L');8384;4255;4129
12;Castellón/Castelló;006;Alcudia de Veo;180;83;97
12;Castellón/Castelló;007;Alfondeguilla;904;439;465
12;Castellón/Castelló;008;Algimia de Almonacid;319;179;140
12;Castellón/Castelló;009;Almazora/Almassora;16318;8033;8285
12;Castellón/Castelló;010;Almedíjar;295;144;151
12;Castellón/Castelló;011;Almenara;5081;2507;2574
12;Castellón/Castelló;901;Alquerías del Niño Perdido;3566;1730;1836
12;Castellón/Castelló;012;Altura;3068;1521;1547
12;Castellón/Castelló;013;Arañuel;122;52;70
12;Castellón/Castelló;014;Ares del Maestre;315;153;162
12;Castellón/Castelló;015;Argelita;105;51;54
12;Castellón/Castelló;016;Artana;1943;964;979
12;Castellón/Castelló;001;Atzeneta del Maestrat;1538;773;765
12;Castellón/Castelló;017;Ayódar;220;121;99
12;Castellón/Castelló;018;Azuébar;409;207;202
12;Castellón/Castelló;020;Barracas;180;102;78
12;Castellón/Castelló;022;Bejís;416;217;199
12;Castellón/Castelló;024;Benafer;131;70;61
12;Castellón/Castelló;025;Benafigos;251;135;116
12;Castellón/Castelló;026;Benasal;1428;699;729
12;Castellón/Castelló;027;Benicarló;19005;9389;9616
12;Castellón/Castelló;028;Benicasim/Benicàssim;8405;4253;4152
12;Castellón/Castelló;029;Benlloch;912;474;438
12;Castellón/Castelló;021;Betxí;5395;2736;2659
12;Castellón/Castelló;031;Borriol;2906;1475;1431
12;Castellón/Castelló;032;Burriana;26404;12955;13449
12;Castellón/Castelló;033;Cabanes;2489;1236;1253
12;Castellón/Castelló;034;Càlig;1786;865;921
12;Castellón/Castelló;036;Canet lo Roig;991;485;506
12;Castellón/Castelló;037;Castell de Cabres;22;11;11
12;Castellón/Castelló;038;Castellfort;261;136;125
12;Castellón/Castelló;039;Castellnovo;1077;535;542
12;Castellón/Castelló;040;Castellón de la Plana/Castelló de la Plana;139094;67923;71171
12;Castellón/Castelló;041;Castillo de Villamalefa;132;65;67
12;Castellón/Castelló;042;Catí;923;478;445
12;Castellón/Castelló;043;Caudiel;710;354;356
12;Castellón/Castelló;044;Cervera del Maestre;767;371;396
12;Castellón/Castelló;052;Chert/Xert;997;485;512
12;Castellón/Castelló;053;Chilches/Xilxes;2188;1113;1075
12;Castellón/Castelló;055;Chodos/Xodos;167;93;74
12;Castellón/Castelló;056;Chóvar;421;217;204
12;Castellón/Castelló;045;Cinctorres;598;279;319
12;Castellón/Castelló;046;Cirat;272;134;138
12;Castellón/Castelló;048;Cortes de Arenoso;424;228;196
12;Castellón/Castelló;049;Costur;477;237;240
12;Castellón/Castelló;050;Coves de Vinromà (les);1854;917;937
12;Castellón/Castelló;051;Culla;918;451;467
12;Castellón/Castelló;057;Eslida;823;394;429
12;Castellón/Castelló;058;Espadilla;81;35;46
12;Castellón/Castelló;059;Fanzara;326;154;172
12;Castellón/Castelló;060;Figueroles;580;284;296
12;Castellón/Castelló;061;Forcall;577;275;302
12;Castellón/Castelló;063;Fuente la Reina;29;15;14
12;Castellón/Castelló;064;Fuentes de Ayódar;86;45;41
12;Castellón/Castelló;065;Gaibiel;225;119;106
12;Castellón/Castelló;066;Gatova;493;242;251
12;Castellón/Castelló;067;Geldo;708;358;350
12;Castellón/Castelló;068;Herbés;134;65;69
12;Castellón/Castelló;069;Higueras;31;17;14
12;Castellón/Castelló;070;Jana (La);908;450;458
12;Castellón/Castelló;071;Jérica;1619;831;788
12;Castellón/Castelló;074;Llosa (La);938;466;472
12;Castellón/Castelló;072;Lucena del Cid;1616;792;824
12;Castellón/Castelló;073;Ludiente;250;125;125
12;Castellón/Castelló;075;Mata de Morella (La);220;102;118
12;Castellón/Castelló;076;Matet;146;77;69
12;Castellón/Castelló;077;Moncofa;3688;1861;1827
12;Castellón/Castelló;078;Montán;352;176;176
12;Castellón/Castelló;079;Montanejos;400;197;203
12;Castellón/Castelló;080;Morella;2859;1403;1456
12;Castellón/Castelló;081;Navajas;466;223;243
12;Castellón/Castelló;082;Nules;11680;5807;5873
12;Castellón/Castelló;083;Olocau del Rey;162;91;71
12;Castellón/Castelló;084;Onda;18633;9368;9265
12;Castellón/Castelló;085;Oropesa del Mar/Orpesa;2671;1388;1283
12;Castellón/Castelló;087;Palanques;25;16;9
12;Castellón/Castelló;088;Pavías;62;36;26
12;Castellón/Castelló;089;Peñíscola;4023;2035;1988
12;Castellón/Castelló;090;Pina de Montalgrao;189;102;87
12;Castellón/Castelló;093;Pobla de Benifassà (La);211;103;108
12;Castellón/Castelló;094;Pobla Tornesa (La);526;259;267
12;Castellón/Castelló;091;Portell de Morella;283;143;140
12;Castellón/Castelló;092;Puebla de Arenoso;203;104;99
12;Castellón/Castelló;095;Ribesalbes;1295;634;661
12;Castellón/Castelló;096;Rossell;1202;605;597
12;Castellón/Castelló;097;Sacañet;141;76;65
12;Castellón/Castelló;098;Salzadella (La);858;419;439
12;Castellón/Castelló;101;San Rafael del Río;500;256;244
12;Castellón/Castelló;902;Sant Joan de Moró;1657;840;817
12;Castellón/Castelló;099;Sant Jordi/San Jorge;564;272;292
12;Castellón/Castelló;100;Sant Mateu;1816;877;939
12;Castellón/Castelló;102;Santa Magdalena de Pulpis;724;370;354
12;Castellón/Castelló;103;Sarratella;111;62;49
12;Castellón/Castelló;104;Segorbe;7666;3737;3929
12;Castellón/Castelló;105;Sierra Engarcerán;1133;592;541
12;Castellón/Castelló;106;Soneja;1428;709;719
12;Castellón/Castelló;107;Sot de Ferrer;404;205;199
12;Castellón/Castelló;108;Sueras/Suera;565;286;279
12;Castellón/Castelló;109;Tales;782;379;403
12;Castellón/Castelló;110;Teresa;395;206;189
12;Castellón/Castelló;111;Tírig;599;290;309
12;Castellón/Castelló;112;Todolella;147;86;61
12;Castellón/Castelló;113;Toga;110;48;62
12;Castellón/Castelló;114;Torás;294;152;142
12;Castellón/Castelló;115;Toro (El);316;165;151
12;Castellón/Castelló;116;Torralba del Pinar;72;37;35
12;Castellón/Castelló;119;Torre d'En Besora (La);229;121;108
12;Castellón/Castelló;120;Torre Endoménech;274;136;138
12;Castellón/Castelló;117;Torreblanca;4653;2332;2321
12;Castellón/Castelló;118;Torrechiva;62;37;25
12;Castellón/Castelló;121;Traiguera;1637;837;800
12;Castellón/Castelló;122;Useras/Useres (Les);1109;561;548
12;Castellón/Castelló;124;Vall d'Alba;1891;952;939
12;Castellón/Castelló;125;Vall de Almonacid;278;136;142
12;Castellón/Castelló;126;Vall d'Uixó (La);29095;14550;14545
12;Castellón/Castelló;123;Vallat;39;17;22
12;Castellón/Castelló;127;Vallibona;104;54;50
12;Castellón/Castelló;128;Vilafamés;1425;749;676
12;Castellón/Castelló;132;Vilanova d'Alcolea;697;352;345
12;Castellón/Castelló;134;Vilar de Canes;188;95;93
12;Castellón/Castelló;129;Villafranca del Cid;2742;1316;1426
12;Castellón/Castelló;130;Villahermosa del Río;513;275;238
12;Castellón/Castelló;131;Villamalur;165;93;72
12;Castellón/Castelló;133;Villanueva de Viver;97;50;47
12;Castellón/Castelló;135;Villarreal/Vila-real;39736;19766;19970
12;Castellón/Castelló;136;Villavieja;3442;1703;1739
12;Castellón/Castelló;137;Villores;82;41;41
12;Castellón/Castelló;138;Vinaròs;20847;10192;10655
12;Castellón/Castelló;139;Vistabella del Maestrazgo;499;241;258
12;Castellón/Castelló;140;Viver;1239;626;613
12;Castellón/Castelló;141;Zorita del Maestrazgo;150;75;75
12;Castellón/Castelló;142;Zucaina;233;128;105
13;Ciudad Real;001;Abenójar;2000;1007;993
13;Ciudad Real;002;Agudo;2224;1124;1100
13;Ciudad Real;003;Alamillo;750;382;368
13;Ciudad Real;004;Albaladejo;1837;911;926
13;Ciudad Real;005;Alcázar de San Juan;26652;13063;13589
13;Ciudad Real;006;Alcoba;819;427;392
13;Ciudad Real;007;Alcolea de Calatrava;1619;814;805
13;Ciudad Real;008;Alcubillas;776;378;398
13;Ciudad Real;009;Aldea del Rey;2396;1153;1243
13;Ciudad Real;010;Alhambra;1422;718;704
13;Ciudad Real;011;Almadén;8257;3999;4258
13;Ciudad Real;012;Almadenejos;661;351;310
13;Ciudad Real;013;Almagro;8523;4146;4377
13;Ciudad Real;014;Almedina;855;418;437
13;Ciudad Real;015;Almodóvar del Campo;7757;3865;3892
13;Ciudad Real;016;Almuradiel;872;418;454
13;Ciudad Real;017;Anchuras;467;251;216
13;Ciudad Real;903;Arenales de San Gregorio;"";"";""
13;Ciudad Real;018;Arenas de San Juan;1088;550;538
13;Ciudad Real;019;Argamasilla de Alba;6605;3251;3354
13;Ciudad Real;020;Argamasilla de Calatrava;5507;2758;2749
13;Ciudad Real;021;Arroba de los Montes;689;364;325
13;Ciudad Real;022;Ballesteros de Calatrava;617;305;312
13;Ciudad Real;023;Bolaños de Calatrava;10457;5221;5236
13;Ciudad Real;024;Brazatortas;1375;682;693
13;Ciudad Real;025;Cabezarados;411;211;200
13;Ciudad Real;026;Cabezarrubias del Puerto;719;370;349
13;Ciudad Real;027;Calzada de Calatrava;5059;2442;2617
13;Ciudad Real;028;Campo de Criptana;14078;6890;7188
13;Ciudad Real;029;Cañada de Calatrava;82;48;34
13;Ciudad Real;030;Caracuel de Calatrava;197;104;93
13;Ciudad Real;031;Carrión de Calatrava;2547;1248;1299
13;Ciudad Real;032;Carrizosa;1790;901;889
13;Ciudad Real;033;Castellar de Santiago;2324;1125;1199
13;Ciudad Real;038;Chillón;2540;1239;1301
13;Ciudad Real;034;Ciudad Real;62072;29501;32571
13;Ciudad Real;035;Corral de Calatrava;1358;683;675
13;Ciudad Real;036;Cortijos (Los);1111;552;559
13;Ciudad Real;037;Cózar;1460;709;751
13;Ciudad Real;039;Daimiel;17285;8441;8844
13;Ciudad Real;040;Fernán Caballero;1058;501;557
13;Ciudad Real;041;Fontanarejo;424;223;201
13;Ciudad Real;042;Fuencaliente;1370;742;628
13;Ciudad Real;043;Fuenllana;364;159;205
13;Ciudad Real;044;Fuente el Fresno;3542;1723;1819
13;Ciudad Real;045;Granátula de Calatrava;1075;517;558
13;Ciudad Real;046;Guadalmez;1098;556;542
13;Ciudad Real;047;Herencia;7069;3531;3538
13;Ciudad Real;048;Hinojosas de Calatrava;903;438;465
13;Ciudad Real;049;Horcajo de los Montes;1100;553;547
13;Ciudad Real;050;Labores (Las);679;336;343
13;Ciudad Real;904;Llanos del Caudillo;"";"";""
13;Ciudad Real;051;Luciana;485;244;241
13;Ciudad Real;052;Malagón;8139;3997;4142
13;Ciudad Real;053;Manzanares;18325;8933;9392
13;Ciudad Real;054;Membrilla;6781;3375;3406
13;Ciudad Real;055;Mestanza;1073;534;539
13;Ciudad Real;056;Miguelturra;7731;3816;3915
13;Ciudad Real;057;Montiel;1784;885;899
13;Ciudad Real;058;Moral de Calatrava;5269;2546;2723
13;Ciudad Real;059;Navalpino;349;171;178
13;Ciudad Real;060;Navas de Estena;437;239;198
13;Ciudad Real;061;Pedro Muñoz;7233;3595;3638
13;Ciudad Real;062;Picón;611;322;289
13;Ciudad Real;063;Piedrabuena;5310;2671;2639
13;Ciudad Real;064;Poblete;717;362;355
13;Ciudad Real;065;Porzuna;4073;2020;2053
13;Ciudad Real;066;Pozuelo de Calatrava;2454;1185;1269
13;Ciudad Real;067;Pozuelos de Calatrava (Los);621;310;311
13;Ciudad Real;068;Puebla de Don Rodrigo;1366;711;655
13;Ciudad Real;069;Puebla del Príncipe;1109;558;551
13;Ciudad Real;070;Puerto Lápice;1032;510;522
13;Ciudad Real;071;Puertollano;52917;25817;27100
13;Ciudad Real;072;Retuerta del Bullaque;1123;575;548
13;Ciudad Real;901;Robledo (El);1146;600;546
13;Ciudad Real;902;Ruidera;614;328;286
13;Ciudad Real;073;Saceruela;815;422;393
13;Ciudad Real;074;San Carlos del Valle;1289;643;646
13;Ciudad Real;075;San Lorenzo de Calatrava;367;191;176
13;Ciudad Real;076;Santa Cruz de los Cáñamos;678;335;343
13;Ciudad Real;077;Santa Cruz de Mudela;4917;2372;2545
13;Ciudad Real;078;Socuéllamos;11580;5678;5902
13;Ciudad Real;080;Solana del Pino;699;347;352
13;Ciudad Real;079;Solana (La);14831;7423;7408
13;Ciudad Real;081;Terrinches;1061;511;550
13;Ciudad Real;082;Tomelloso;29116;14314;14802
13;Ciudad Real;083;Torralba de Calatrava;3034;1469;1565
13;Ciudad Real;084;Torre de Juan Abad;1703;847;856
13;Ciudad Real;085;Torrenueva;3256;1639;1617
13;Ciudad Real;086;Valdemanco del Esteras;345;176;169
13;Ciudad Real;087;Valdepeñas;26142;12657;13485
13;Ciudad Real;088;Valenzuela de Calatrava;848;410;438
13;Ciudad Real;089;Villahermosa;2904;1378;1526
13;Ciudad Real;090;Villamanrique;1880;945;935
13;Ciudad Real;091;Villamayor de Calatrava;775;377;398
13;Ciudad Real;092;Villanueva de la Fuente;2935;1466;1469
13;Ciudad Real;093;Villanueva de los Infantes;6140;2953;3187
13;Ciudad Real;094;Villanueva de San Carlos;564;283;281
13;Ciudad Real;095;Villar del Pozo;98;51;47
13;Ciudad Real;096;Villarrubia de los Ojos;9800;4890;4910
13;Ciudad Real;097;Villarta de San Juan;2994;1504;1490
13;Ciudad Real;098;Viso del Marqués;3289;1616;1673
14;Córdoba;001;Adamuz;4557;2272;2285
14;Córdoba;002;Aguilar de la Frontera;13366;6607;6759
14;Córdoba;003;Alcaracejos;1520;760;760
14;Córdoba;004;Almedinilla;2627;1314;1313
14;Córdoba;005;Almodóvar del Río;7297;3647;3650
14;Córdoba;006;Añora;1687;841;846
14;Córdoba;007;Baena;20572;10139;10433
14;Córdoba;008;Belalcázar;4117;1994;2123
14;Córdoba;009;Belmez;4395;2111;2284
14;Córdoba;010;Benamejí;4648;2311;2337
14;Córdoba;011;Blázquez (Los);751;380;371
14;Córdoba;012;Bujalance;8640;4236;4404
14;Córdoba;013;Cabra;20710;10064;10646
14;Córdoba;015;Carcabuey;2923;1451;1472
14;Córdoba;016;Cardeña;2093;1050;1043
14;Córdoba;017;Carlota (La);9836;4918;4918
14;Córdoba;018;Carpio (El);4636;2278;2358
14;Córdoba;019;Castro del Río;7968;3901;4067
14;Córdoba;014;Cañete de las Torres;3433;1695;1738
14;Córdoba;020;Conquista;564;283;281
14;Córdoba;021;Córdoba;315948;152610;163338
14;Córdoba;023;Dos Torres;2563;1257;1306
14;Córdoba;022;Doña Mencía;5172;2568;2604
14;Córdoba;024;Encinas Reales;2368;1162;1206
14;Córdoba;025;Espejo;5067;2509;2558
14;Córdoba;026;Espiel;2620;1306;1314
14;Córdoba;027;Fernán-Núñez;9629;4794;4835
14;Córdoba;029;Fuente Obejuna;6378;3238;3140
14;Córdoba;030;Fuente Palmera;9786;4970;4816
14;Córdoba;028;Fuente la Lancha;460;229;231
14;Córdoba;031;Fuente-Tójar;881;424;457
14;Córdoba;032;Granjuela (La);537;283;254
14;Córdoba;033;Guadalcázar;1173;612;561
14;Córdoba;034;Guijo (El);445;230;215
14;Córdoba;035;Hinojosa del Duque;8265;3964;4301
14;Córdoba;036;Hornachuelos;5152;2625;2527
14;Córdoba;037;Iznájar;5588;2776;2812
14;Córdoba;038;Lucena;34262;17030;17232
14;Córdoba;039;Luque;3404;1679;1725
14;Córdoba;040;Montalbán de Córdoba;4623;2319;2304
14;Córdoba;041;Montemayor;3765;1893;1872
14;Córdoba;042;Montilla;23311;11505;11806
14;Córdoba;043;Montoro;9828;4822;5006
14;Córdoba;044;Monturque;2002;1013;989
14;Córdoba;045;Moriles;3762;1866;1896
14;Córdoba;046;Nueva Carteya;5842;2920;2922
14;Córdoba;047;Obejo;1465;722;743
14;Córdoba;048;Palenciana;1691;859;832
14;Córdoba;049;Palma del Río;19121;9580;9541
14;Córdoba;050;Pedro Abad;3040;1512;1528
14;Córdoba;051;Pedroche;1930;943;987
14;Córdoba;052;Peñarroya-Pueblonuevo;14159;6757;7402
14;Córdoba;053;Posadas;7240;3607;3633
14;Córdoba;054;Pozoblanco;15679;7518;8161
14;Córdoba;055;Priego de Córdoba;22344;11008;11336
14;Córdoba;056;Puente Genil;27598;13580;14018
14;Córdoba;057;Rambla (La);7066;3507;3559
14;Córdoba;058;Rute;10220;5012;5208
14;Córdoba;059;San Sebastián de los Ballesteros;837;431;406
14;Córdoba;061;Santa Eufemia;1268;651;617
14;Córdoba;060;Santaella;5826;2922;2904
14;Córdoba;062;Torrecampo;1556;759;797
14;Córdoba;063;Valenzuela;1553;731;822
14;Córdoba;064;Valsequillo;524;256;268
14;Córdoba;065;Victoria (La);1752;864;888
14;Córdoba;066;Villa del Río;7152;3618;3534
14;Córdoba;067;Villafranca de Córdoba;3707;1912;1795
14;Córdoba;068;Villaharta;630;310;320
14;Córdoba;069;Villanueva de Córdoba;10374;5046;5328
14;Córdoba;070;Villanueva del Duque;1992;921;1071
14;Córdoba;071;Villanueva del Rey;1324;692;632
14;Córdoba;072;Villaralto;1700;807;893
14;Córdoba;073;Villaviciosa de Córdoba;4011;2058;1953
14;Córdoba;074;Viso (El);3447;1662;1785
14;Córdoba;075;Zuheros;956;469;487
15;Coruña (A);001;Abegondo;5427;2684;2743
15;Coruña (A);002;Ames;11247;5435;5812
15;Coruña (A);003;Aranga;2513;1255;1258
15;Coruña (A);004;Ares;4631;2289;2342
15;Coruña (A);005;Arteixo;18688;9391;9297
15;Coruña (A);006;Arzúa;7041;3478;3563
15;Coruña (A);007;Baña (A);5818;2820;2998
15;Coruña (A);008;Bergondo;5514;2695;2819
15;Coruña (A);009;Betanzos;12322;5836;6486
15;Coruña (A);010;Boimorto;2960;1515;1445
15;Coruña (A);011;Boiro;18245;8936;9309
15;Coruña (A);012;Boqueixón;4304;2118;2186
15;Coruña (A);013;Brión;6347;3030;3317
15;Coruña (A);014;Cabana de Bergantiños;6446;3191;3255
15;Coruña (A);015;Cabanas;3301;1604;1697
15;Coruña (A);016;Camariñas;7498;3735;3763
15;Coruña (A);017;Cambre;13205;6444;6761
15;Coruña (A);018;Capela (A);1708;846;862
15;Coruña (A);019;Carballo;28501;13935;14566
15;Coruña (A);901;Cariño;5589;2746;2843
15;Coruña (A);020;Carnota;6704;3239;3465
15;Coruña (A);021;Carral;5300;2622;2678
15;Coruña (A);022;Cedeira;7772;3804;3968
15;Coruña (A);023;Cee;7655;3722;3933
15;Coruña (A);024;Cerceda;7037;3444;3593
15;Coruña (A);025;Cerdido;1888;911;977
15;Coruña (A);026;Cesuras;2911;1440;1471
15;Coruña (A);027;Coirós;1594;779;815
15;Coruña (A);028;Corcubión;2084;1009;1075
15;Coruña (A);029;Coristanco;9228;4614;4614
15;Coruña (A);030;A Coruña;255087;119902;135185
15;Coruña (A);031;Culleredo;16647;8132;8515
15;Coruña (A);032;Curtis;4671;2273;2398
15;Coruña (A);033;Dodro;3493;1704;1789
15;Coruña (A);034;Dumbría;4918;2400;2518
15;Coruña (A);035;Fene;15337;7555;7782
15;Coruña (A);036;Ferrol;85692;40383;45309
15;Coruña (A);037;Fisterra;5577;2803;2774
15;Coruña (A);038;Frades;3273;1658;1615
15;Coruña (A);039;Irixoa;1863;911;952
15;Coruña (A);041;Laracha (A);10883;5386;5497
15;Coruña (A);040;Laxe;3562;1768;1794
15;Coruña (A);042;Lousame;4726;2301;2425
15;Coruña (A);043;Malpica de Bergantiños;7960;3920;4040
15;Coruña (A);045;Mazaricos;6911;3348;3563
15;Coruña (A);044;Mañón;2180;1058;1122
15;Coruña (A);046;Melide;8499;4203;4296
15;Coruña (A);047;Mesía;3657;1822;1835
15;Coruña (A);048;Miño;5054;2420;2634
15;Coruña (A);049;Moeche;1680;815;865
15;Coruña (A);050;Monfero;2934;1511;1423
15;Coruña (A);051;Mugardos;6544;3154;3390
15;Coruña (A);053;Muros;11585;5568;6017
15;Coruña (A);052;Muxía;6767;3322;3445
15;Coruña (A);054;Narón;31926;15599;16327
15;Coruña (A);055;Neda;6482;3130;3352
15;Coruña (A);056;Negreira;6866;3265;3601
15;Coruña (A);057;Noia;15226;7379;7847
15;Coruña (A);058;Oleiros;21167;10240;10927
15;Coruña (A);059;Ordes;11916;5801;6115
15;Coruña (A);060;Oroso;4104;2003;2101
15;Coruña (A);061;Ortigueira;9898;4771;5127
15;Coruña (A);062;Outes;9387;4468;4919
15;Coruña (A);063;Oza dos Ríos;3350;1625;1725
15;Coruña (A);064;Paderne;2852;1351;1501
15;Coruña (A);065;Padrón;10275;4978;5297
15;Coruña (A);066;Pino (O);5267;2639;2628
15;Coruña (A);067;Pobra do Caramiñal (A);10408;4984;5424
15;Coruña (A);068;Ponteceso;7915;3984;3931
15;Coruña (A);069;Pontedeume;8962;4292;4670
15;Coruña (A);070;Pontes de García Rodríguez (As);13286;6742;6544
15;Coruña (A);071;Porto do Son;10964;5351;5613
15;Coruña (A);072;Rianxo;13017;6447;6570
15;Coruña (A);073;Ribeira;26542;13048;13494
15;Coruña (A);074;Rois;5604;2709;2895
15;Coruña (A);075;Sada;9728;4721;5007
15;Coruña (A);076;San Sadurniño;3713;1833;1880
15;Coruña (A);077;Santa Comba;11621;5660;5961
15;Coruña (A);078;Santiago de Compostela;93398;44028;49370
15;Coruña (A);079;Santiso;2496;1298;1198
15;Coruña (A);080;Sobrado;2883;1492;1391
15;Coruña (A);081;Somozas (As);1605;805;800
15;Coruña (A);082;Teo;13237;6454;6783
15;Coruña (A);083;Toques;1941;1011;930
15;Coruña (A);084;Tordoia;5783;2794;2989
15;Coruña (A);085;Touro;5007;2442;2565
15;Coruña (A);086;Trazo;4263;2120;2143
15;Coruña (A);088;Val do Dubra;5471;2684;2787
15;Coruña (A);087;Valdoviño;7107;3517;3590
15;Coruña (A);089;Vedra;5158;2485;2673
15;Coruña (A);091;Vilarmaior;1436;715;721
15;Coruña (A);090;Vilasantar;1844;944;900
15;Coruña (A);092;Vimianzo;9621;4762;4859
15;Coruña (A);093;Zas;6700;3286;3414
16;Cuenca;001;Abia de la Obispalía;110;59;51
16;Cuenca;002;Acebrón (El);306;151;155
16;Cuenca;003;Alarcón;228;116;112
16;Cuenca;004;Albaladejo del Cuende;458;246;212
16;Cuenca;005;Albalate de las Nogueras;416;221;195
16;Cuenca;006;Albendea;211;105;106
16;Cuenca;007;Alberca de Záncara (La);1883;930;953
16;Cuenca;008;Alcalá de la Vega;178;91;87
16;Cuenca;009;Alcantud;152;80;72
16;Cuenca;011;Alcohujate;72;38;34
16;Cuenca;012;Alconchel de la Estrella;238;125;113
16;Cuenca;010;Alcázar del Rey;275;138;137
16;Cuenca;013;Algarra;43;23;20
16;Cuenca;014;Aliaguilla;927;485;442
16;Cuenca;015;Almarcha (La);673;333;340
16;Cuenca;016;Almendros;418;204;214
16;Cuenca;017;Almodóvar del Pinar;585;302;283
16;Cuenca;018;Almonacid del Marquesado;582;301;281
16;Cuenca;019;Altarejos;398;197;201
16;Cuenca;020;Arandilla del Arroyo;51;22;29
16;Cuenca;905;Arcas del Villar;411;205;206
16;Cuenca;022;Arcos de la Sierra;130;69;61
16;Cuenca;024;Arguisuelas;215;113;102
16;Cuenca;025;Arrancacepas;40;22;18
16;Cuenca;026;Atalaya del Cañavate;134;64;70
16;Cuenca;027;Barajas de Melo;740;366;374
16;Cuenca;029;Barchín del Hoyo;151;83;68
16;Cuenca;030;Bascuñana de San Pedro;39;23;16
16;Cuenca;031;Beamud;103;57;46
16;Cuenca;032;Belinchón;328;161;167
16;Cuenca;033;Belmonte;2613;1225;1388
16;Cuenca;034;Belmontejo;301;152;149
16;Cuenca;035;Beteta;438;221;217
16;Cuenca;036;Boniches;270;132;138
16;Cuenca;038;Buciegas;95;48;47
16;Cuenca;039;Buenache de Alarcón;661;337;324
16;Cuenca;040;Buenache de la Sierra;117;71;46
16;Cuenca;041;Buendía;497;255;242
16;Cuenca;042;Campillo de Altobuey;1741;861;880
16;Cuenca;043;Campillos-Paravientos;162;85;77
16;Cuenca;044;Campillos-Sierra;98;52;46
16;Cuenca;901;Campos del Paraíso;1276;597;679
16;Cuenca;045;Canalejas del Arroyo;379;199;180
16;Cuenca;055;Carboneras de Guadazaón;1059;564;495
16;Cuenca;056;Cardenete;742;386;356
16;Cuenca;057;Carrascosa;132;70;62
16;Cuenca;058;Carrascosa de Haro;169;85;84
16;Cuenca;060;Casas de Benítez;1128;556;572
16;Cuenca;061;Casas de Fernando Alonso;1441;709;732
16;Cuenca;062;Casas de Garcimolina;36;15;21
16;Cuenca;063;Casas de Guijarro;179;93;86
16;Cuenca;064;Casas de Haro;906;454;452
16;Cuenca;065;Casas de los Pinos;563;278;285
16;Cuenca;066;Casasimarro;3071;1552;1519
16;Cuenca;067;Castejón;254;128;126
16;Cuenca;068;Castillejo de Iniesta;198;111;87
16;Cuenca;070;Castillejo-Sierra;55;26;29
16;Cuenca;072;Castillo de Garcimuñoz;301;153;148
16;Cuenca;071;Castillo-Albaráñez;34;18;16
16;Cuenca;047;Cañada Juncosa;417;217;200
16;Cuenca;046;Cañada del Hoyo;409;210;199
16;Cuenca;048;Cañamares;618;330;288
16;Cuenca;049;Cañavate (El);300;148;152
16;Cuenca;050;Cañaveras;433;218;215
16;Cuenca;051;Cañaveruelas;255;130;125
16;Cuenca;052;Cañete;820;406;414
16;Cuenca;053;Cañizares;652;339;313
16;Cuenca;073;Cervera del Llano;342;175;167
16;Cuenca;023;Chillarón de Cuenca;310;159;151
16;Cuenca;081;Chumillas;54;33;21
16;Cuenca;074;Cierva (La);56;29;27
16;Cuenca;078;Cuenca;44960;21707;23253
16;Cuenca;079;Cueva del Hierro;53;33;20
16;Cuenca;082;Enguídanos;590;314;276
16;Cuenca;083;Fresneda de Altarejos;106;61;45
16;Cuenca;084;Fresneda de la Sierra;79;39;40
16;Cuenca;085;Frontera (La);250;125;125
16;Cuenca;086;Fuente de Pedro Naharro;1259;620;639
16;Cuenca;087;Fuentelespino de Haro;391;209;182
16;Cuenca;088;Fuentelespino de Moya;154;76;78
16;Cuenca;904;Fuentenava de Jábaga;250;131;119
16;Cuenca;089;Fuentes;546;285;261
16;Cuenca;091;Fuertescusa;134;67;67
16;Cuenca;092;Gabaldón;210;112;98
16;Cuenca;093;Garaballa;175;90;85
16;Cuenca;094;Gascueña;174;81;93
16;Cuenca;095;Graja de Campalbo;142;80;62
16;Cuenca;096;Graja de Iniesta;347;187;160
16;Cuenca;097;Henarejos;337;161;176
16;Cuenca;098;Herrumblar (El);791;412;379
16;Cuenca;099;Hinojosa (La);387;192;195
16;Cuenca;100;Hinojosos (Los);1216;606;610
16;Cuenca;101;Hito (El);257;126;131
16;Cuenca;102;Honrubia;1695;835;860
16;Cuenca;103;Hontanaya;548;263;285
16;Cuenca;104;Hontecillas;101;47;54
16;Cuenca;106;Horcajo de Santiago;3638;1802;1836
16;Cuenca;108;Huelves;87;42;45
16;Cuenca;110;Huerta de la Obispalía;172;98;74
16;Cuenca;111;Huerta del Marquesado;215;117;98
16;Cuenca;112;Huete;2446;1253;1193
16;Cuenca;107;Huélamo;153;83;70
16;Cuenca;109;Huérguina;94;50;44
16;Cuenca;113;Iniesta;3730;1853;1877
16;Cuenca;115;Laguna del Marquesado;75;39;36
16;Cuenca;116;Lagunaseca;103;50;53
16;Cuenca;117;Landete;1600;800;800
16;Cuenca;118;Ledaña;2008;991;1017
16;Cuenca;119;Leganiel;269;131;138
16;Cuenca;121;Majadas (Las);409;208;201
16;Cuenca;122;Mariana;313;158;155
16;Cuenca;123;Masegosa;135;69;66
16;Cuenca;124;Mesas (Las);2629;1350;1279
16;Cuenca;125;Minglanilla;2365;1193;1172
16;Cuenca;126;Mira;1176;593;583
16;Cuenca;128;Monreal del Llano;96;51;45
16;Cuenca;129;Montalbanejo;230;107;123
16;Cuenca;130;Montalbo;819;439;380
16;Cuenca;131;Monteagudo de las Salinas;126;69;57
16;Cuenca;132;Mota de Altarejos;74;44;30
16;Cuenca;133;Mota del Cuervo;5573;2763;2810
16;Cuenca;134;Motilla del Palancar;4874;2454;2420
16;Cuenca;135;Moya;327;172;155
16;Cuenca;137;Narboneta;106;59;47
16;Cuenca;139;Olivares de Júcar;647;327;320
16;Cuenca;140;Olmeda de la Cuesta;50;28;22
16;Cuenca;141;Olmeda del Rey;259;121;138
16;Cuenca;142;Olmedilla de Alarcón;249;130;119
16;Cuenca;143;Olmedilla de Eliz;36;18;18
16;Cuenca;145;Osa de la Vega;730;371;359
16;Cuenca;147;Pajaroncillo;105;54;51
16;Cuenca;146;Pajarón;157;81;76
16;Cuenca;148;Palomares del Campo;1059;514;545
16;Cuenca;149;Palomera;186;90;96
16;Cuenca;150;Paracuellos;191;93;98
16;Cuenca;151;Paredes;77;42;35
16;Cuenca;152;Parra de las Vegas (La);65;30;35
16;Cuenca;153;Pedernoso (El);1409;692;717
16;Cuenca;154;Pedroñeras (Las);6605;3351;3254
16;Cuenca;155;Peral (El);758;387;371
16;Cuenca;156;Peraleja (La);188;97;91
16;Cuenca;157;Pesquera (La);291;153;138
16;Cuenca;158;Picazo (El);740;362;378
16;Cuenca;159;Pinarejo;627;326;301
16;Cuenca;160;Pineda de Gigüela;184;96;88
16;Cuenca;161;Piqueras del Castillo;91;49;42
16;Cuenca;162;Portalrubio de Guadamejud;114;54;60
16;Cuenca;163;Portilla;107;57;50
16;Cuenca;165;Poyatos;133;75;58
16;Cuenca;166;Pozoamargo;347;160;187
16;Cuenca;908;Pozorrubielos de la Mancha;297;150;147
16;Cuenca;167;Pozorrubio;552;265;287
16;Cuenca;169;Pozuelo (El);107;55;52
16;Cuenca;170;Priego;1127;573;554
16;Cuenca;171;Provencio (El);2713;1353;1360
16;Cuenca;172;Puebla de Almenara;656;337;319
16;Cuenca;173;Puebla de Don Francisco;428;218;210
16;Cuenca;174;Puebla del Salvador;313;167;146
16;Cuenca;175;Quintanar del Rey;6054;3078;2976
16;Cuenca;176;Rada de Haro;77;37;40
16;Cuenca;177;Reíllo;156;75;81
16;Cuenca;181;Rozalén del Monte;151;72;79
16;Cuenca;185;Saceda-Trasierra;69;33;36
16;Cuenca;186;Saelices;776;391;385
16;Cuenca;187;Salinas del Manzano;143;77;66
16;Cuenca;188;Salmeroncillos;165;89;76
16;Cuenca;189;Salvacañete;365;202;163
16;Cuenca;190;San Clemente;6314;3092;3222
16;Cuenca;191;San Lorenzo de la Parrilla;1660;839;821
16;Cuenca;192;San Martín de Boniches;111;57;54
16;Cuenca;193;San Pedro Palmiches;115;64;51
16;Cuenca;194;Santa Cruz de Moya;435;222;213
16;Cuenca;196;Santa María de los Llanos;923;460;463
16;Cuenca;195;Santa María del Campo Rus;930;459;471
16;Cuenca;197;Santa María del Val;130;70;60
16;Cuenca;198;Sisante;1854;930;924
16;Cuenca;199;Solera de Gabaldón;42;25;17
16;Cuenca;909;Sotorribas;1019;506;513
16;Cuenca;202;Talayuelas;1248;645;603
16;Cuenca;203;Tarancón;11395;5624;5771
16;Cuenca;205;Tejadillos;200;96;104
16;Cuenca;206;Tinajas;431;233;198
16;Cuenca;209;Torralba;229;110;119
16;Cuenca;211;Torrejoncillo del Rey;818;386;432
16;Cuenca;212;Torrubia del Campo;375;170;205
16;Cuenca;213;Torrubia del Castillo;52;27;25
16;Cuenca;215;Tragacete;419;221;198
16;Cuenca;216;Tresjuncos;589;301;288
16;Cuenca;217;Tribaldos;149;71;78
16;Cuenca;204;Tébar;445;243;202
16;Cuenca;218;Uclés;292;138;154
16;Cuenca;219;Uña;164;81;83
16;Cuenca;906;Valdecolmenas (Los);153;81;72
16;Cuenca;224;Valdemeca;108;57;51
16;Cuenca;225;Valdemorillo de la Sierra;100;53;47
16;Cuenca;227;Valdemoro-Sierra;183;107;76
16;Cuenca;228;Valdeolivas;321;171;150
16;Cuenca;902;Valdetórtola;169;93;76
16;Cuenca;903;Valeras (Las);1469;729;740
16;Cuenca;231;Valhermoso de la Fuente;71;34;37
16;Cuenca;234;Valsalobre;60;30;30
16;Cuenca;236;Valverde de Júcar;1510;747;763
16;Cuenca;237;Valverdejo;156;79;77
16;Cuenca;238;Vara de Rey;787;385;402
16;Cuenca;239;Vega del Codorno;268;134;134
16;Cuenca;240;Vellisca;201;96;105
16;Cuenca;242;Villaconejos de Trabaque;565;285;280
16;Cuenca;243;Villaescusa de Haro;633;319;314
16;Cuenca;244;Villagarcía del Llano;1018;513;505
16;Cuenca;245;Villalba de la Sierra;579;290;289
16;Cuenca;246;Villalba del Rey;786;397;389
16;Cuenca;247;Villalgordo del Marquesado;174;85;89
16;Cuenca;248;Villalpardo;1146;575;571
16;Cuenca;249;Villamayor de Santiago;2954;1455;1499
16;Cuenca;250;Villanueva de Guadamejud;135;72;63
16;Cuenca;251;Villanueva de la Jara;2441;1233;1208
16;Cuenca;253;Villar de Cañas;490;243;247
16;Cuenca;254;Villar de Domingo García;280;143;137
16;Cuenca;263;Villar de Olalla;795;407;388
16;Cuenca;255;Villar de la Encina;258;129;129
16;Cuenca;258;Villar del Humo;518;266;252
16;Cuenca;259;Villar del Infantado;52;30;22
16;Cuenca;910;Villar y Velasco;155;83;72
16;Cuenca;264;Villarejo de Fuentes;887;424;463
16;Cuenca;265;Villarejo de la Peñuela;37;18;19
16;Cuenca;266;Villarejo-Periesteban;569;294;275
16;Cuenca;269;Villares del Saz;841;431;410
16;Cuenca;270;Villarrubio;263;124;139
16;Cuenca;271;Villarta;828;414;414
16;Cuenca;272;Villas de la Ventosa;450;250;200
16;Cuenca;273;Villaverde y Pasaconsol;440;220;220
16;Cuenca;275;Vindel;25;14;11
16;Cuenca;274;Víllora;273;126;147
16;Cuenca;276;Yémeda;38;16;22
16;Cuenca;277;Zafra de Záncara;259;132;127
16;Cuenca;278;Zafrilla;138;71;67
16;Cuenca;279;Zarza de Tajo;301;132;169
16;Cuenca;280;Zarzuela;327;161;166
17;Girona;001;Agullana;675;351;324
17;Girona;002;Aiguaviva;395;196;199
17;Girona;003;Albanyà;122;61;61
17;Girona;004;Albons;488;264;224
17;Girona;006;Alp;1005;510;495
17;Girona;007;Amer;2300;1140;1160
17;Girona;008;Anglès;5097;2579;2518
17;Girona;009;Arbúcies;4815;2417;2398
17;Girona;010;Argelaguer;371;189;182
17;Girona;011;Armentera (L');764;375;389
17;Girona;012;Avinyonet de Puigventós;454;222;232
17;Girona;015;Banyoles;14584;7193;7391
17;Girona;016;Bàscara;782;405;377
17;Girona;013;Begur;2986;1519;1467
17;Girona;018;Bellcaire d'Empordà;482;245;237
17;Girona;019;Besalú;2047;1002;1045
17;Girona;020;Bescanó;2918;1472;1446
17;Girona;021;Beuda;128;67;61
17;Girona;022;Bisbal d'Empordà (La);8006;3934;4072
17;Girona;234;Biure;227;112;115
17;Girona;023;Blanes;27246;13778;13468
17;Girona;029;Boadella d'Empordà;222;112;110
17;Girona;024;Bolvir;250;118;132
17;Girona;025;Bordils;1368;685;683
17;Girona;026;Borrassà;483;240;243
17;Girona;027;Breda;3352;1728;1624
17;Girona;028;Brunyola;381;188;193
17;Girona;031;Cabanelles;227;124;103
17;Girona;030;Cabanes;804;411;393
17;Girona;032;Cadaqués;1874;927;947
17;Girona;033;Caldes de Malavella;3381;1681;1700
17;Girona;034;Calonge;5988;3000;2988
17;Girona;035;Camós;645;326;319
17;Girona;036;Campdevànol;3336;1627;1709
17;Girona;037;Campelles;133;68;65
17;Girona;038;Campllong;295;156;139
17;Girona;039;Camprodon;2209;1080;1129
17;Girona;040;Canet d'Adri;491;251;240
17;Girona;041;Cantallops;266;132;134
17;Girona;042;Capmany;396;203;193
17;Girona;044;Cassà de la Selva;7411;3675;3736
17;Girona;046;Castellfollit de la Roca;998;484;514
17;Girona;047;Castelló d'Empúries;4447;2280;2167
17;Girona;048;Castell-Platja d'Aro;6004;3109;2895
17;Girona;189;Cellera de Ter (La);2101;1026;1075
17;Girona;049;Celrà;2594;1311;1283
17;Girona;050;Cervià de Ter;636;312;324
17;Girona;051;Cistella;212;106;106
17;Girona;054;Colera;456;235;221
17;Girona;055;Colomers;203;100;103
17;Girona;057;Corçà;1145;567;578
17;Girona;056;Cornellà del Terri;1818;908;910
17;Girona;058;Crespià;234;117;117
17;Girona;901;Cruïlles, Monells i Sant Sadurní de l'Heura;1088;542;546
17;Girona;060;Darnius;525;276;249
17;Girona;061;Das;140;78;62
17;Girona;062;Escala (L');5859;2970;2889
17;Girona;063;Espinelves;173;84;89
17;Girona;064;Espolla;393;199;194
17;Girona;065;Esponellà;383;191;192
17;Girona;005;Far d'Empordà (El);436;220;216
17;Girona;066;Figueres;35202;17239;17963
17;Girona;067;Flaçà;897;443;454
17;Girona;068;Foixà;305;150;155
17;Girona;069;Fontanals de Cerdanya;308;152;156
17;Girona;070;Fontanilles;126;72;54
17;Girona;071;Fontcoberta;990;516;474
17;Girona;902;Forallac;1622;803;819
17;Girona;073;Fornells de la Selva;1206;592;614
17;Girona;074;Fortià;497;248;249
17;Girona;075;Garrigàs;311;162;149
17;Girona;076;Garrigoles;151;82;69
17;Girona;077;Garriguella;699;360;339
17;Girona;078;Ger;301;158;143
17;Girona;079;Girona;72333;34875;37458
17;Girona;080;Gombrèn;247;120;127
17;Girona;081;Gualta;268;129;139
17;Girona;082;Guils de Cerdanya;311;161;150
17;Girona;083;Hostalric;2880;1430;1450
17;Girona;084;Isòvol;174;88;86
17;Girona;085;Jafre;369;183;186
17;Girona;086;Jonquera (La);2559;1287;1272
17;Girona;087;Juià;254;113;141
17;Girona;088;Lladó;484;242;242
17;Girona;089;Llagostera;5399;2734;2665
17;Girona;090;Llambilles;457;240;217
17;Girona;091;Llanars;415;213;202
17;Girona;092;Llançà;3703;1874;1829
17;Girona;093;Llers;845;447;398
17;Girona;094;Llívia;903;467;436
17;Girona;095;Lloret de Mar;16782;8498;8284
17;Girona;096;Llosses (Les);375;211;164
17;Girona;102;Maçanet de Cabrenys;679;342;337
17;Girona;103;Maçanet de la Selva;3338;1694;1644
17;Girona;097;Madremanya;183;80;103
17;Girona;098;Maià de Montcal;340;165;175
17;Girona;100;Masarac;259;131;128
17;Girona;101;Massanes;521;275;246
17;Girona;099;Meranges;71;40;31
17;Girona;105;Mieres;331;165;166
17;Girona;106;Mollet de Peralada;184;101;83
17;Girona;107;Molló;354;182;172
17;Girona;109;Montagut i Oix;805;413;392
17;Girona;110;Mont-ras;1473;766;707
17;Girona;111;Navata;658;321;337
17;Girona;112;Ogassa;264;153;111
17;Girona;114;Olot;27639;13306;14333
17;Girona;115;Ordis;312;163;149
17;Girona;116;Osor;494;249;245
17;Girona;117;Palafrugell;17773;9083;8690
17;Girona;118;Palamós;13913;6909;7004
17;Girona;119;Palau de Santa Eulàlia;92;50;42
17;Girona;121;Palau-sator;290;148;142
17;Girona;120;Palau-saverdera;771;378;393
17;Girona;122;Palmerola;"";"";""
17;Girona;123;Palol de Revardit;352;175;177
17;Girona;124;Pals;1787;927;860
17;Girona;125;Pardines;134;71;63
17;Girona;126;Parlavà;341;179;162
17;Girona;128;Pau;359;171;188
17;Girona;129;Pedret i Marzà;122;59;63
17;Girona;130;Pera (La);380;196;184
17;Girona;132;Peralada;1157;591;566
17;Girona;133;Planes d'Hostoles (Les);1794;885;909
17;Girona;134;Planoles;266;147;119
17;Girona;135;Pont de Molins;412;222;190
17;Girona;136;Pontós;199;117;82
17;Girona;137;Porqueres;3227;1618;1609
17;Girona;140;Port de la Selva (El);830;402;428
17;Girona;138;Portbou;1818;891;927
17;Girona;139;Preses (Les);1305;643;662
17;Girona;141;Puigcerdà;6586;3354;3232
17;Girona;142;Quart;2092;1063;1029
17;Girona;043;Queralbs;198;109;89
17;Girona;143;Rabós;138;59;79
17;Girona;144;Regencós;265;147;118
17;Girona;145;Ribes de Freser;2258;1095;1163
17;Girona;146;Riells i Viabrea;1193;622;571
17;Girona;147;Ripoll;11289;5504;5785
17;Girona;148;Riudarenes;1150;580;570
17;Girona;149;Riudaura;383;184;199
17;Girona;150;Riudellots de la Selva;1412;719;693
17;Girona;151;Riumors;201;95;106
17;Girona;152;Roses;11465;5878;5587
17;Girona;153;Rupià;212;108;104
17;Girona;154;Sales de Llierca;57;33;24
17;Girona;155;Salt;22274;11163;11111
17;Girona;157;Sant Andreu Salou;133;68;65
17;Girona;183;Sant Aniol de Finestres;256;134;122
17;Girona;158;Sant Climent Sescebes;424;224;200
17;Girona;159;Sant Feliu de Buixalleu;642;341;301
17;Girona;160;Sant Feliu de Guíxols;17071;8327;8744
17;Girona;161;Sant Feliu de Pallerols;1100;531;569
17;Girona;162;Sant Ferriol;200;109;91
17;Girona;163;Sant Gregori;2029;1059;970
17;Girona;164;Sant Hilari Sacalm;4942;2520;2422
17;Girona;165;Sant Jaume de Llierca;771;392;379
17;Girona;167;Sant Joan de les Abadesses;3880;1883;1997
17;Girona;168;Sant Joan de Mollet;312;151;161
17;Girona;185;Sant Joan les Fonts;2831;1404;1427
17;Girona;166;Sant Jordi Desvalls;603;307;296
17;Girona;169;Sant Julià de Ramis;1904;960;944
17;Girona;903;Sant Julià del Llor i Bonmatí;902;441;461
17;Girona;171;Sant Llorenç de la Muga;169;83;86
17;Girona;172;Sant Martí de Llémena;373;200;173
17;Girona;173;Sant Martí Vell;204;111;93
17;Girona;174;Sant Miquel de Campmajor;211;121;90
17;Girona;175;Sant Miquel de Fluvià;560;289;271
17;Girona;176;Sant Mori;148;69;79
17;Girona;177;Sant Pau de Segúries;643;316;327
17;Girona;178;Sant Pere Pescador;1406;764;642
17;Girona;180;Santa Coloma de Farners;8655;4423;4232
17;Girona;181;Santa Cristina d'Aro;2117;1127;990
17;Girona;182;Santa Llogaia d'Àlguema;326;174;152
17;Girona;184;Santa Pau;1450;739;711
17;Girona;186;Sarrià de Ter;3290;1614;1676
17;Girona;187;Saus;697;348;349
17;Girona;188;Selva de Mar (La);167;88;79
17;Girona;190;Serinyà;773;392;381
17;Girona;191;Serra de Daró;182;93;89
17;Girona;192;Setcases;157;83;74
17;Girona;193;Sils;2565;1308;1257
17;Girona;052;Siurana;152;70;82
17;Girona;194;Susqueda;86;45;41
17;Girona;195;Tallada d'Empordà (La);328;167;161
17;Girona;196;Terrades;182;84;98
17;Girona;197;Torrent;181;91;90
17;Girona;198;Torroella de Fluvià;299;165;134
17;Girona;199;Torroella de Montgrí;7578;3835;3743
17;Girona;200;Tortellà;671;339;332
17;Girona;201;Toses;143;87;56
17;Girona;202;Tossa de Mar;3764;1899;1865
17;Girona;204;Ullà;722;362;360
17;Girona;205;Ullastret;248;128;120
17;Girona;203;Ultramort;196;100;96
17;Girona;206;Urús;134;70;64
17;Girona;014;Vajol (La);85;45;40
17;Girona;208;Vall de Bianya (La);1070;531;539
17;Girona;207;Vall d'en Bas (La);2533;1289;1244
17;Girona;170;Vallfogona de Ripollès;260;134;126
17;Girona;209;Vall-llobrega;287;151;136
17;Girona;210;Ventalló;557;282;275
17;Girona;211;Verges;1105;516;589
17;Girona;212;Vidrà;175;91;84
17;Girona;213;Vidreres;3968;1981;1987
17;Girona;214;Vilabertran;801;400;401
17;Girona;215;Vilablareix;1121;554;567
17;Girona;217;Viladamat;398;211;187
17;Girona;216;Viladasens;190;100;90
17;Girona;218;Vilademuls;761;379;382
17;Girona;220;Viladrau;879;446;433
17;Girona;221;Vilafant;3085;1541;1544
17;Girona;223;Vilajuïga;677;337;340
17;Girona;224;Vilallonga de Ter;424;221;203
17;Girona;225;Vilamacolum;247;131;116
17;Girona;226;Vilamalla;717;363;354
17;Girona;227;Vilamaniscle;117;59;58
17;Girona;228;Vilanant;270;138;132
17;Girona;230;Vila-sacra;385;183;202
17;Girona;222;Vilaür;105;52;53
17;Girona;233;Vilobí d'Onyar;2124;1126;998
17;Girona;232;Vilopriu;177;90;87
18;Granada;001;Agrón;451;230;221
18;Granada;002;Alamedilla;1004;500;504
18;Granada;003;Albolote;11358;5730;5628
18;Granada;004;Albondón;1316;654;662
18;Granada;005;Albuñán;488;247;241
18;Granada;006;Albuñol;5578;2760;2818
18;Granada;007;Albuñuelas;1357;689;668
18;Granada;010;Aldeire;814;412;402
18;Granada;011;Alfacar;3992;2039;1953
18;Granada;012;Algarinejo;5194;2643;2551
18;Granada;013;Alhama de Granada;6142;3092;3050
18;Granada;014;Alhendín;3954;1995;1959
18;Granada;015;Alicún de Ortega;805;404;401
18;Granada;016;Almegíjar;443;226;217
18;Granada;017;Almuñécar;21102;10449;10653
18;Granada;904;Alpujarra de la Sierra;1299;659;640
18;Granada;018;Alquife;1079;526;553
18;Granada;020;Arenas del Rey;2118;1099;1019
18;Granada;021;Armilla;12116;6011;6105
18;Granada;022;Atarfe;10508;5203;5305
18;Granada;023;Baza;21640;10559;11081
18;Granada;024;Beas de Granada;943;488;455
18;Granada;025;Beas de Guadix;413;220;193
18;Granada;027;Benalúa;3444;1729;1715
18;Granada;028;Benalúa de las Villas;1407;702;705
18;Granada;029;Benamaurel;2564;1312;1252
18;Granada;030;Bérchules;866;448;418
18;Granada;032;Bubión;369;182;187
18;Granada;033;Busquístar;460;238;222
18;Granada;034;Cacín;891;458;433
18;Granada;035;Cádiar;1983;1006;977
18;Granada;036;Cájar;2432;1145;1287
18;Granada;114;Calahorra (La);1042;495;547
18;Granada;037;Calicasas;605;299;306
18;Granada;038;Campotéjar;1478;726;752
18;Granada;039;Caniles;5280;2573;2707
18;Granada;040;Cáñar;345;166;179
18;Granada;042;Capileira;581;286;295
18;Granada;043;Carataunas;219;117;102
18;Granada;044;Cástaras;339;176;163
18;Granada;045;Castilléjar;2205;1111;1094
18;Granada;046;Castril;3204;1663;1541
18;Granada;047;Cenes de la Vega;3169;1626;1543
18;Granada;059;Chauchina;3972;1964;2008
18;Granada;061;Chimeneas;1606;816;790
18;Granada;062;Churriana de la Vega;6013;3021;2992
18;Granada;048;Cijuela;1451;711;740
18;Granada;049;Cogollos de Guadix;797;422;375
18;Granada;050;Cogollos de la Vega;2072;1037;1035
18;Granada;051;Colomera;1870;954;916
18;Granada;053;Cortes de Baza;2950;1504;1446
18;Granada;054;Cortes y Graena;1025;538;487
18;Granada;912;Cuevas del Campo;2409;1176;1233
18;Granada;056;Cúllar;5518;2742;2776
18;Granada;057;Cúllar Vega;2041;1021;1020
18;Granada;063;Darro;1638;790;848
18;Granada;064;Dehesas de Guadix;681;342;339
18;Granada;066;Deifontes;2560;1286;1274
18;Granada;067;Diezma;1036;532;504
18;Granada;068;Dílar;1529;758;771
18;Granada;069;Dólar;704;352;352
18;Granada;070;Dúdar;273;135;138
18;Granada;071;Dúrcal;6155;3061;3094
18;Granada;072;Escúzar;970;500;470
18;Granada;074;Ferreira;419;197;222
18;Granada;076;Fonelas;1369;679;690
18;Granada;078;Freila;1240;627;613
18;Granada;079;Fuente Vaqueros;3960;1974;1986
18;Granada;905;Gabias (Las);6627;3302;3325
18;Granada;082;Galera;1613;808;805
18;Granada;083;Gobernador;404;199;205
18;Granada;084;Gójar;2716;1374;1342
18;Granada;085;Gor;1292;649;643
18;Granada;086;Gorafe;603;302;301
18;Granada;087;Granada;271180;127738;143442
18;Granada;088;Guadahortuna;2450;1248;1202
18;Granada;089;Guadix;20658;10209;10449
18;Granada;906;Guajares (Los);1491;764;727
18;Granada;093;Gualchos;3048;1542;1506
18;Granada;094;Güejar Sierra;2873;1449;1424
18;Granada;095;Güevéjar;1378;685;693
18;Granada;096;Huélago;712;368;344
18;Granada;097;Huéneja;1353;673;680
18;Granada;098;Huéscar;10196;5107;5089
18;Granada;099;Huétor de Santillán;1639;861;778
18;Granada;100;Huétor Tájar;7956;3954;4002
18;Granada;101;Huétor Vega;7320;3657;3663
18;Granada;102;Illora;11025;5531;5494
18;Granada;103;Itrabo;1080;537;543
18;Granada;105;Iznalloz;6880;3498;3382
18;Granada;107;Jayena;1553;797;756
18;Granada;108;Jerez del Marquesado;1255;634;621
18;Granada;109;Jete;742;359;383
18;Granada;111;Jun;1355;676;679
18;Granada;112;Juviles;224;112;112
18;Granada;115;Láchar;2385;1189;1196
18;Granada;116;Lanjarón;4052;2023;2029
18;Granada;117;Lanteira;706;353;353
18;Granada;119;Lecrín;2450;1189;1261
18;Granada;120;Lentegí;380;183;197
18;Granada;121;Lobras;219;111;108
18;Granada;122;Loja;21729;10795;10934
18;Granada;123;Lugros;448;241;207
18;Granada;124;Lújar;613;322;291
18;Granada;126;Malahá (La);1643;832;811
18;Granada;127;Maracena;13855;6896;6959
18;Granada;128;Marchal;485;238;247
18;Granada;132;Moclín;4887;2424;2463
18;Granada;133;Molvízar;2711;1340;1371
18;Granada;134;Monachil;4871;2507;2364
18;Granada;135;Montefrío;8180;4132;4048
18;Granada;136;Montejícar;3023;1544;1479
18;Granada;137;Montillana;1427;729;698
18;Granada;138;Moraleda de Zafayona;2677;1383;1294
18;Granada;909;Morelábor;1027;511;516
18;Granada;140;Motril;48984;24259;24725
18;Granada;141;Murtas;1075;549;526
18;Granada;903;Nevada;1503;751;752
18;Granada;143;Nigüelas;1211;619;592
18;Granada;144;Nívar;631;327;304
18;Granada;145;Ogíjares;6120;3075;3045
18;Granada;146;Orce;1488;759;729
18;Granada;147;Órgiva;5345;2686;2659
18;Granada;148;Otívar;1155;578;577
18;Granada;149;Otura;3238;1632;1606
18;Granada;150;Padul;6445;3250;3195
18;Granada;151;Pampaneira;356;187;169
18;Granada;152;Pedro Martínez;1553;787;766
18;Granada;153;Peligros;6969;3476;3493
18;Granada;154;Peza (La);1568;810;758
18;Granada;910;Pinar (El);1308;653;655
18;Granada;157;Pinos Genil;1133;588;545
18;Granada;158;Pinos Puente;13878;6946;6932
18;Granada;159;Píñar;1527;781;746
18;Granada;161;Polícar;261;137;124
18;Granada;162;Polopos;1216;641;575
18;Granada;163;Pórtugos;469;239;230
18;Granada;164;Puebla de Don Fadrique;2677;1335;1342
18;Granada;165;Pulianas;2898;1465;1433
18;Granada;167;Purullena;2634;1292;1342
18;Granada;168;Quéntar;1166;590;576
18;Granada;170;Rubite;442;232;210
18;Granada;171;Salar;2801;1381;1420
18;Granada;173;Salobreña;9983;4991;4992
18;Granada;174;Santa Cruz del Comercio;592;318;274
18;Granada;175;Santa Fe;12608;6182;6426
18;Granada;176;Soportújar;275;149;126
18;Granada;177;Sorvilán;945;469;476
18;Granada;901;Taha (La);981;496;485
18;Granada;178;Torre-Cardela;1300;661;639
18;Granada;179;Torvizcón;1126;567;559
18;Granada;180;Trevélez;820;446;374
18;Granada;181;Turón;428;239;189
18;Granada;182;Ugíjar;3012;1481;1531
18;Granada;907;Valle del Zalabí;2530;1253;1277
18;Granada;902;Valle (El);1494;742;752
18;Granada;183;Válor;1135;569;566
18;Granada;911;Vegas del Genil;2683;1359;1324
18;Granada;184;Vélez de Benaudalla;2556;1255;1301
18;Granada;185;Ventas de Huelma;697;348;349
18;Granada;908;Villamena;1032;494;538
18;Granada;187;Villanueva de las Torres;1069;559;510
18;Granada;188;Villanueva Mesía;1955;985;970
18;Granada;189;Víznar;816;424;392
18;Granada;192;Zafarraya;2233;1125;1108
18;Granada;913;Zagra;1264;628;636
18;Granada;193;Zubia (La);10233;5064;5169
18;Granada;194;Zújar;3062;1546;1516
19;Guadalajara;001;Abánades;118;67;51
19;Guadalajara;002;Ablanque;161;82;79
19;Guadalajara;003;Adobes;47;23;24
19;Guadalajara;004;Alaminos;103;51;52
19;Guadalajara;005;Alarilla;126;65;61
19;Guadalajara;006;Albalate de Zorita;1015;529;486
19;Guadalajara;007;Albares;541;277;264
19;Guadalajara;008;Albendiego;58;29;29
19;Guadalajara;009;Alcocer;342;168;174
19;Guadalajara;010;Alcolea de las Peñas;43;25;18
19;Guadalajara;011;Alcolea del Pinar;445;216;229
19;Guadalajara;013;Alcoroches;201;104;97
19;Guadalajara;015;Aldeanueva de Guadalajara;102;46;56
19;Guadalajara;016;Algar de Mesa;91;48;43
19;Guadalajara;017;Algora;122;70;52
19;Guadalajara;018;Alhóndiga;257;146;111
19;Guadalajara;019;Alique;37;9;28
19;Guadalajara;020;Almadrones;113;74;39
19;Guadalajara;021;Almoguera;788;405;383
19;Guadalajara;022;Almonacid de Zorita;952;466;486
19;Guadalajara;023;Alocén;139;71;68
19;Guadalajara;024;Alovera;1410;721;689
19;Guadalajara;027;Alustante;295;163;132
19;Guadalajara;031;Angón;38;22;16
19;Guadalajara;032;Anguita;347;171;176
19;Guadalajara;033;Anquela del Ducado;86;41;45
19;Guadalajara;034;Anquela del Pedregal;29;17;12
19;Guadalajara;036;Aranzueque;375;190;185
19;Guadalajara;037;Arbancón;217;121;96
19;Guadalajara;038;Arbeteta;49;26;23
19;Guadalajara;039;Argecilla;149;84;65
19;Guadalajara;040;Armallones;59;35;24
19;Guadalajara;041;Armuña de Tajuña;119;63;56
19;Guadalajara;042;Arroyo de las Fraguas;27;14;13
19;Guadalajara;043;Atanzón;110;64;46
19;Guadalajara;044;Atienza;501;258;243
19;Guadalajara;045;Auñón;277;143;134
19;Guadalajara;046;Azuqueca de Henares;13439;6812;6627
19;Guadalajara;047;Baides;88;46;42
19;Guadalajara;048;Baños de Tajo;33;22;11
19;Guadalajara;049;Bañuelos;34;18;16
19;Guadalajara;050;Barriopedro;35;15;20
19;Guadalajara;051;Berninches;136;78;58
19;Guadalajara;052;Bodera (La);58;35;23
19;Guadalajara;053;Brihuega;3100;1605;1495
19;Guadalajara;054;Budia;317;175;142
19;Guadalajara;055;Bujalaro;101;57;44
19;Guadalajara;057;Bustares;125;68;57
19;Guadalajara;058;Cabanillas del Campo;1306;689;617
19;Guadalajara;059;Campillo de Dueñas;163;87;76
19;Guadalajara;060;Campillo de Ranas;127;57;70
19;Guadalajara;061;Campisábalos;71;34;37
19;Guadalajara;064;Canredondo;134;68;66
19;Guadalajara;065;Cantalojas;168;95;73
19;Guadalajara;066;Cañizar;119;63;56
19;Guadalajara;067;Cardoso de la Sierra (El);124;76;48
19;Guadalajara;070;Casa de Uceda;117;59;58
19;Guadalajara;071;Casar (El);1705;884;821
19;Guadalajara;073;Casas de San Galindo;40;21;19
19;Guadalajara;074;Caspueñas;75;45;30
19;Guadalajara;075;Castejón de Henares;118;64;54
19;Guadalajara;076;Castellar de la Muela;60;31;29
19;Guadalajara;078;Castilforte;61;35;26
19;Guadalajara;079;Castilnuevo;12;4;8
19;Guadalajara;080;Cendejas de Enmedio;133;64;69
19;Guadalajara;081;Cendejas de la Torre;124;70;54
19;Guadalajara;082;Centenera;83;42;41
19;Guadalajara;103;Checa;443;227;216
19;Guadalajara;104;Chequilla;28;13;15
19;Guadalajara;106;Chillarón del Rey;140;78;62
19;Guadalajara;105;Chiloeches;1116;581;535
19;Guadalajara;086;Cifuentes;2647;1331;1316
19;Guadalajara;087;Cincovillas;38;19;19
19;Guadalajara;088;Ciruelas;70;37;33
19;Guadalajara;089;Ciruelos del Pinar;69;36;33
19;Guadalajara;090;Cobeta;146;72;74
19;Guadalajara;091;Cogollor;57;31;26
19;Guadalajara;092;Cogolludo;605;335;270
19;Guadalajara;095;Condemios de Abajo;32;18;14
19;Guadalajara;096;Condemios de Arriba;175;93;82
19;Guadalajara;097;Congostrina;53;26;27
19;Guadalajara;098;Copernal;32;18;14
19;Guadalajara;099;Corduente;513;276;237
19;Guadalajara;102;Cubillo de Uceda (El);151;72;79
19;Guadalajara;107;Driebes;360;199;161
19;Guadalajara;108;Durón;124;57;67
19;Guadalajara;109;Embid;72;39;33
19;Guadalajara;110;Escamilla;125;63;62
19;Guadalajara;111;Escariche;223;115;108
19;Guadalajara;112;Escopete;61;20;41
19;Guadalajara;113;Espinosa de Henares;527;254;273
19;Guadalajara;114;Esplegares;86;51;35
19;Guadalajara;115;Establés;59;29;30
19;Guadalajara;116;Estriégana;37;20;17
19;Guadalajara;117;Fontanar;837;433;404
19;Guadalajara;118;Fuembellida;19;10;9
19;Guadalajara;119;Fuencemillán;131;69;62
19;Guadalajara;120;Fuentelahiguera de Albatages;207;109;98
19;Guadalajara;121;Fuentelencina;222;120;102
19;Guadalajara;122;Fuentelsaz;161;77;84
19;Guadalajara;123;Fuentelviejo;87;45;42
19;Guadalajara;124;Fuentenovilla;217;127;90
19;Guadalajara;125;Gajanejos;111;62;49
19;Guadalajara;126;Galápagos;197;99;98
19;Guadalajara;127;Galve de Sorbe;184;89;95
19;Guadalajara;129;Gascueña de Bornova;39;21;18
19;Guadalajara;130;Guadalajara;67401;33253;34148
19;Guadalajara;132;Henche;42;26;16
19;Guadalajara;133;Heras de Ayuso;113;59;54
19;Guadalajara;134;Herrería;39;16;23
19;Guadalajara;135;Hiendelaencina;150;80;70
19;Guadalajara;136;Hijes;28;14;14
19;Guadalajara;138;Hita;266;143;123
19;Guadalajara;139;Hombrados;56;31;25
19;Guadalajara;142;Hontoba;148;71;77
19;Guadalajara;143;Horche;1192;611;581
19;Guadalajara;145;Hortezuela de Océn;97;49;48
19;Guadalajara;146;Huerce (La);34;19;15
19;Guadalajara;147;Huérmeces del Cerro;69;40;29
19;Guadalajara;148;Huertahernando;77;44;33
19;Guadalajara;150;Hueva;148;73;75
19;Guadalajara;151;Humanes;1201;631;570
19;Guadalajara;152;Illana;686;354;332
19;Guadalajara;153;Iniéstola;28;16;12
19;Guadalajara;154;Inviernas (Las);102;60;42
19;Guadalajara;155;Irueste;76;35;41
19;Guadalajara;156;Jadraque;1211;617;594
19;Guadalajara;157;Jirueque;60;33;27
19;Guadalajara;159;Ledanca;186;87;99
19;Guadalajara;160;Loranca de Tajuña;285;151;134
19;Guadalajara;161;Lupiana;272;148;124
19;Guadalajara;162;Luzaga;127;61;66
19;Guadalajara;163;Luzón;98;47;51
19;Guadalajara;165;Majaelrayo;58;27;31
19;Guadalajara;166;Málaga del Fresno;229;119;110
19;Guadalajara;167;Malaguilla;183;105;78
19;Guadalajara;168;Mandayona;474;226;248
19;Guadalajara;169;Mantiel;75;35;40
19;Guadalajara;170;Maranchón;236;132;104
19;Guadalajara;171;Marchamalo;"";"";""
19;Guadalajara;172;Masegoso de Tajuña;113;56;57
19;Guadalajara;173;Matarrubia;58;34;24
19;Guadalajara;174;Matillas;267;139;128
19;Guadalajara;175;Mazarete;89;45;44
19;Guadalajara;176;Mazuecos;413;207;206
19;Guadalajara;177;Medranda;149;74;75
19;Guadalajara;178;Megina;89;52;37
19;Guadalajara;179;Membrillera;103;52;51
19;Guadalajara;181;Miedes de Atienza;127;65;62
19;Guadalajara;182;Mierla (La);35;22;13
19;Guadalajara;184;Millana;114;56;58
19;Guadalajara;183;Milmarcos;114;59;55
19;Guadalajara;185;Miñosa (La);53;30;23
19;Guadalajara;186;Mirabueno;119;66;53
19;Guadalajara;187;Miralrío;104;56;48
19;Guadalajara;188;Mochales;143;70;73
19;Guadalajara;189;Mohernando;142;79;63
19;Guadalajara;190;Molina de Aragón;3577;1802;1775
19;Guadalajara;191;Monasterio;19;9;10
19;Guadalajara;192;Mondéjar;2151;1069;1082
19;Guadalajara;193;Montarrón;75;44;31
19;Guadalajara;194;Moratilla de los Meleros;121;70;51
19;Guadalajara;195;Morenilla;60;38;22
19;Guadalajara;196;Muduex;137;68;69
19;Guadalajara;197;Navas de Jadraque (Las);25;17;8
19;Guadalajara;198;Negredo;24;11;13
19;Guadalajara;199;Ocentejo;45;20;25
19;Guadalajara;200;Olivar (El);83;45;38
19;Guadalajara;201;Olmeda de Cobeta;87;34;53
19;Guadalajara;202;Olmeda de Jadraque (La);15;8;7
19;Guadalajara;203;Ordial (El);42;18;24
19;Guadalajara;204;Orea;330;177;153
19;Guadalajara;208;Pálmaces de Jadraque;71;36;35
19;Guadalajara;209;Pardos;63;32;31
19;Guadalajara;210;Paredes de Sigüenza;85;44;41
19;Guadalajara;211;Pareja;484;239;245
19;Guadalajara;212;Pastrana;1160;589;571
19;Guadalajara;213;Pedregal (El);114;61;53
19;Guadalajara;214;Peñalén;160;84;76
19;Guadalajara;215;Peñalver;280;163;117
19;Guadalajara;216;Peralejos de las Truchas;183;100;83
19;Guadalajara;217;Peralveche;110;59;51
19;Guadalajara;218;Pinilla de Jadraque;103;51;52
19;Guadalajara;219;Pinilla de Molina;25;15;10
19;Guadalajara;220;Pioz;224;118;106
19;Guadalajara;221;Piqueras;54;32;22
19;Guadalajara;222;Pobo de Dueñas (El);177;97;80
19;Guadalajara;223;Poveda de la Sierra;194;100;94
19;Guadalajara;224;Pozo de Almoguera;227;115;112
19;Guadalajara;225;Pozo de Guadalajara;355;193;162
19;Guadalajara;226;Prádena de Atienza;47;27;20
19;Guadalajara;227;Prados Redondos;95;54;41
19;Guadalajara;228;Puebla de Beleña;33;23;10
19;Guadalajara;229;Puebla de Valles;74;41;33
19;Guadalajara;230;Quer;109;56;53
19;Guadalajara;231;Rebollosa de Jadraque;39;22;17
19;Guadalajara;232;Recuenco (El);127;63;64
19;Guadalajara;233;Renera;69;32;37
19;Guadalajara;234;Retiendas;44;20;24
19;Guadalajara;235;Riba de Saelices;193;107;86
19;Guadalajara;237;Rillo de Gallo;70;39;31
19;Guadalajara;238;Riofrío del Llano;85;44;41
19;Guadalajara;239;Robledillo de Mohernando;179;97;82
19;Guadalajara;240;Robledo de Corpes;79;39;40
19;Guadalajara;241;Romanillos de Atienza;73;44;29
19;Guadalajara;242;Romanones;158;92;66
19;Guadalajara;243;Rueda de la Sierra;86;42;44
19;Guadalajara;244;Sacecorbo;155;82;73
19;Guadalajara;245;Sacedón;1609;818;791
19;Guadalajara;246;Saelices de la Sal;77;40;37
19;Guadalajara;247;Salmerón;294;154;140
19;Guadalajara;248;San Andrés del Congosto;81;42;39
19;Guadalajara;249;San Andrés del Rey;47;18;29
19;Guadalajara;250;Santiuste;26;12;14
19;Guadalajara;251;Saúca;63;30;33
19;Guadalajara;252;Sayatón;203;101;102
19;Guadalajara;254;Selas;68;32;36
19;Guadalajara;901;Semillas;32;15;17
19;Guadalajara;255;Setiles;209;113;96
19;Guadalajara;256;Sienes;105;61;44
19;Guadalajara;257;Sigüenza;4791;2376;2415
19;Guadalajara;258;Solanillos del Extremo;125;68;57
19;Guadalajara;259;Somolinos;43;19;24
19;Guadalajara;260;Sotillo (El);62;39;23
19;Guadalajara;261;Sotodosos;72;35;37
19;Guadalajara;262;Tamajón;190;93;97
19;Guadalajara;263;Taragudo;35;18;17
19;Guadalajara;264;Taravilla;72;39;33
19;Guadalajara;265;Tartanedo;225;109;116
19;Guadalajara;266;Tendilla;404;222;182
19;Guadalajara;267;Terzaga;48;27;21
19;Guadalajara;268;Tierzo;45;23;22
19;Guadalajara;269;Toba (La);129;68;61
19;Guadalajara;271;Tordellego;100;54;46
19;Guadalajara;270;Tordelrábano;18;9;9
19;Guadalajara;272;Tordesilos;168;90;78
19;Guadalajara;274;Torija;369;175;194
19;Guadalajara;279;Torre del Burgo;58;31;27
19;Guadalajara;276;Torrecilla del Ducado;"";"";""
19;Guadalajara;277;Torrecuadrada de Molina;25;15;10
19;Guadalajara;278;Torrecuadradilla;72;42;30
19;Guadalajara;280;Torrejón del Rey;690;375;315
19;Guadalajara;281;Torremocha de Jadraque;19;13;6
19;Guadalajara;282;Torremocha del Campo;383;214;169
19;Guadalajara;283;Torremocha del Pinar;76;38;38
19;Guadalajara;284;Torremochuela;10;5;5
19;Guadalajara;285;Torrubia;46;22;24
19;Guadalajara;286;Tórtola de Henares;396;202;194
19;Guadalajara;287;Tortuera;266;140;126
19;Guadalajara;288;Tortuero;37;22;15
19;Guadalajara;289;Traíd;72;35;37
19;Guadalajara;290;Trijueque;451;240;211
19;Guadalajara;291;Trillo;1531;775;756
19;Guadalajara;293;Uceda;573;280;293
19;Guadalajara;294;Ujados;44;24;20
19;Guadalajara;296;Utande;69;43;26
19;Guadalajara;297;Valdarachas;26;11;15
19;Guadalajara;298;Valdearenas;58;32;26
19;Guadalajara;299;Valdeavellano;104;52;52
19;Guadalajara;300;Valdeaveruelo;193;105;88
19;Guadalajara;301;Valdeconcha;43;20;23
19;Guadalajara;302;Valdegrudas;65;35;30
19;Guadalajara;303;Valdelcubo;73;44;29
19;Guadalajara;304;Valdenuño Fernández;136;71;65
19;Guadalajara;305;Valdepeñas de la Sierra;254;138;116
19;Guadalajara;306;Valderrebollo;39;19;20
19;Guadalajara;307;Valdesotos;48;18;30
19;Guadalajara;308;Valfermoso de Tajuña;67;37;30
19;Guadalajara;309;Valhermoso;46;25;21
19;Guadalajara;310;Valtablado del Río;20;11;9
19;Guadalajara;311;Valverde de los Arroyos;101;54;47
19;Guadalajara;314;Viana de Jadraque;67;35;32
19;Guadalajara;317;Villanueva de Alcorón;320;171;149
19;Guadalajara;318;Villanueva de Argecilla;50;28;22
19;Guadalajara;319;Villanueva de la Torre;125;65;60
19;Guadalajara;321;Villares de Jadraque;57;29;28
19;Guadalajara;322;Villaseca de Henares;69;37;32
19;Guadalajara;323;Villaseca de Uceda;66;34;32
19;Guadalajara;324;Villel de Mesa;266;128;138
19;Guadalajara;325;Viñuelas;125;69;56
19;Guadalajara;326;Yebes;63;37;26
19;Guadalajara;327;Yebra;586;293;293
19;Guadalajara;329;Yélamos de Abajo;103;49;54
19;Guadalajara;330;Yélamos de Arriba;135;71;64
19;Guadalajara;331;Yunquera de Henares;2021;1021;1000
19;Guadalajara;332;Yunta (La);189;90;99
19;Guadalajara;333;Zaorejas;211;115;96
19;Guadalajara;334;Zarzuela de Jadraque;31;18;13
19;Guadalajara;335;Zorita de los Canes;106;59;47
20;Guipúzcoa;001;Abaltzisketa;276;150;126
20;Guipúzcoa;002;Aduna;301;157;144
20;Guipúzcoa;016;Aia;1680;953;727
20;Guipúzcoa;003;Aizarnazabal;537;292;245
20;Guipúzcoa;004;Albiztur;304;159;145
20;Guipúzcoa;005;Alegia;1674;872;802
20;Guipúzcoa;006;Alkiza;269;155;114
20;Guipúzcoa;906;Altzaga;93;45;48
20;Guipúzcoa;007;Altzo;313;172;141
20;Guipúzcoa;008;Amezketa;1035;553;482
20;Guipúzcoa;009;Andoain;14984;7493;7491
20;Guipúzcoa;010;Anoeta;1786;904;882
20;Guipúzcoa;011;Antzuola;2005;1032;973
20;Guipúzcoa;012;Arama;153;77;76
20;Guipúzcoa;013;Aretxabaleta;6150;3140;3010
20;Guipúzcoa;055;Arrasate/Mondragón;25057;12572;12485
20;Guipúzcoa;014;Asteasu;1201;657;544
20;Guipúzcoa;903;Astigarraga;3202;1583;1619
20;Guipúzcoa;015;Ataun;1656;842;814
20;Guipúzcoa;017;Azkoitia;10469;5224;5245
20;Guipúzcoa;018;Azpeitia;13787;6963;6824
20;Guipúzcoa;904;Baliarrain;99;48;51
20;Guipúzcoa;019;Beasain;12417;6250;6167
20;Guipúzcoa;020;Beizama;172;96;76
20;Guipúzcoa;021;Belauntza;300;164;136
20;Guipúzcoa;022;Berastegi;948;522;426
20;Guipúzcoa;074;Bergara;15576;7776;7800
20;Guipúzcoa;023;Berrobi;586;320;266
20;Guipúzcoa;024;Bidegoyan;439;248;191
20;Guipúzcoa;029;Deba;5033;2570;2463
20;Guipúzcoa;069;Donostia/San Sebastián;177929;83527;94402
20;Guipúzcoa;030;Eibar;31489;15463;16026
20;Guipúzcoa;031;Elduain;240;128;112
20;Guipúzcoa;033;Elgeta;993;504;489
20;Guipúzcoa;032;Elgoibar;11359;5716;5643
20;Guipúzcoa;067;Errenteria;41418;20485;20933
20;Guipúzcoa;066;Errezil;666;373;293
20;Guipúzcoa;034;Eskoriatza;3880;2017;1863
20;Guipúzcoa;035;Ezkio-Itsaso;519;268;251
20;Guipúzcoa;038;Gabiria;448;244;204
20;Guipúzcoa;037;Gaintza;134;78;56
20;Guipúzcoa;907;Gaztelu;"";"";""
20;Guipúzcoa;039;Getaria;2393;1200;1193
20;Guipúzcoa;040;Hernani;18671;9276;9395
20;Guipúzcoa;041;Hernialde;289;150;139
20;Guipúzcoa;036;Hondarribia;13836;6901;6935
20;Guipúzcoa;042;Ibarra;4445;2312;2133
20;Guipúzcoa;043;Idiazabal;2048;1041;1007
20;Guipúzcoa;044;Ikaztegieta;382;199;183
20;Guipúzcoa;045;Irún;55360;27170;28190
20;Guipúzcoa;046;Irura;679;341;338
20;Guipúzcoa;047;Itsasondo;612;304;308
20;Guipúzcoa;048;Larraul;142;84;58
20;Guipúzcoa;902;Lasarte-Oria;18242;9142;9100
20;Guipúzcoa;049;Lazkao;4986;2556;2430
20;Guipúzcoa;050;Leaburu;540;300;240
20;Guipúzcoa;051;Legazpi;9639;4975;4664
20;Guipúzcoa;052;Legorreta;1465;734;731
20;Guipúzcoa;068;Leintz-Gatzaga;242;135;107
20;Guipúzcoa;053;Lezo;5535;2730;2805
20;Guipúzcoa;054;Lizartza;679;358;321
20;Guipúzcoa;901;Mendaro;1373;708;665
20;Guipúzcoa;057;Mutiloa;182;89;93
20;Guipúzcoa;056;Mutriku;4689;2338;2351
20;Guipúzcoa;063;Oiartzun;8731;4359;4372
20;Guipúzcoa;058;Olaberria;1078;556;522
20;Guipúzcoa;076;Ordizia;9335;4572;4763
20;Guipúzcoa;905;Orendain;163;96;67
20;Guipúzcoa;060;Orexa;78;41;37
20;Guipúzcoa;061;Orio;4276;2162;2114
20;Guipúzcoa;062;Ormaiztegi;1226;615;611
20;Guipúzcoa;059;Oñati;10588;5287;5301
20;Guipúzcoa;064;Pasaia;18337;8911;9426
20;Guipúzcoa;070;Segura;1295;650;645
20;Guipúzcoa;065;Soraluze/Placencia de las Armas;4675;2326;2349
20;Guipúzcoa;071;Tolosa;18168;8737;9431
20;Guipúzcoa;072;Urnieta;4762;2447;2315
20;Guipúzcoa;077;Urretxu;6162;3110;3052
20;Guipúzcoa;073;Usurbil;5342;2747;2595
20;Guipúzcoa;075;Villabona;5414;2750;2664
20;Guipúzcoa;078;Zaldibia;1545;809;736
20;Guipúzcoa;079;Zarautz;18752;9281;9471
20;Guipúzcoa;025;Zegama;1395;708;687
20;Guipúzcoa;026;Zerain;236;112;124
20;Guipúzcoa;027;Zestoa;3352;1747;1605
20;Guipúzcoa;028;Zizurkil;2708;1380;1328
20;Guipúzcoa;081;Zumaia;8255;4140;4115
20;Guipúzcoa;080;Zumarraga;10835;5448;5387
21;Huelva;001;Alájar;861;448;413
21;Huelva;002;Aljaraque;7565;3796;3769
21;Huelva;003;Almendro (El);867;456;411
21;Huelva;004;Almonaster la Real;2145;1045;1100
21;Huelva;005;Almonte;17107;8618;8489
21;Huelva;006;Alosno;4965;2401;2564
21;Huelva;007;Aracena;6746;3307;3439
21;Huelva;008;Aroche;3633;1771;1862
21;Huelva;009;Arroyomolinos de León;1227;622;605
21;Huelva;010;Ayamonte;15796;7751;8045
21;Huelva;011;Beas;4081;2022;2059
21;Huelva;012;Berrocal;419;212;207
21;Huelva;013;Bollullos Par del Condado;12824;6370;6454
21;Huelva;014;Bonares;5011;2528;2483
21;Huelva;015;Cabezas Rubias;967;496;471
21;Huelva;016;Cala;1530;778;752
21;Huelva;017;Calañas;5043;2481;2562
21;Huelva;018;Campillo (El);2621;1269;1352
21;Huelva;019;Campofrío;898;453;445
21;Huelva;020;Cañaveral de León;575;275;300
21;Huelva;021;Cartaya;11002;5451;5551
21;Huelva;022;Castaño del Robledo;213;106;107
21;Huelva;023;Cerro de Andévalo (El);2889;1413;1476
21;Huelva;030;Chucena;1962;1001;961
21;Huelva;024;Corteconcepción;689;349;340
21;Huelva;025;Cortegana;5302;2616;2686
21;Huelva;026;Cortelazor;320;158;162
21;Huelva;027;Cumbres de Enmedio;60;30;30
21;Huelva;028;Cumbres de San Bartolomé;615;312;303
21;Huelva;029;Cumbres Mayores;2271;1103;1168
21;Huelva;031;Encinasola;1970;979;991
21;Huelva;032;Escacena del Campo;2243;1106;1137
21;Huelva;033;Fuenteheridos;677;344;333
21;Huelva;034;Galaroza;1657;807;850
21;Huelva;035;Gibraleón;10150;5082;5068
21;Huelva;036;Granada de Río-Tinto (La);217;113;104
21;Huelva;037;Granado (El);691;367;324
21;Huelva;038;Higuera de la Sierra;1295;646;649
21;Huelva;039;Hinojales;469;233;236
21;Huelva;040;Hinojos;3429;1739;1690
21;Huelva;041;Huelva;145049;70427;74622
21;Huelva;042;Isla Cristina;17729;8809;8920
21;Huelva;043;Jabugo;2618;1300;1318
21;Huelva;044;Lepe;17185;8690;8495
21;Huelva;045;Linares de la Sierra;293;142;151
21;Huelva;046;Lucena del Puerto;2116;1081;1035
21;Huelva;047;Manzanilla;2590;1283;1307
21;Huelva;048;Marines (Los);360;179;181
21;Huelva;049;Minas de Riotinto;5393;2568;2825
21;Huelva;050;Moguer;12986;6623;6363
21;Huelva;051;Nava (La);340;173;167
21;Huelva;052;Nerva;7004;3409;3595
21;Huelva;053;Niebla;3858;1959;1899
21;Huelva;054;Palma del Condado (La);9635;4768;4867
21;Huelva;055;Palos de la Frontera;6945;3524;3421
21;Huelva;056;Paterna del Campo;3895;2001;1894
21;Huelva;057;Paymogo;1374;669;705
21;Huelva;058;Puebla de Guzmán;3265;1635;1630
21;Huelva;059;Puerto Moral;235;111;124
21;Huelva;060;Punta Umbría;10793;5470;5323
21;Huelva;061;Rociana del Condado;6282;3214;3068
21;Huelva;062;Rosal de la Frontera;1939;933;1006
21;Huelva;063;San Bartolomé de la Torre;2913;1463;1450
21;Huelva;064;San Juan del Puerto;5822;2936;2886
21;Huelva;066;San Silvestre de Guzmán;693;347;346
21;Huelva;065;Sanlúcar de Guadiana;399;198;201
21;Huelva;067;Santa Ana la Real;505;236;269
21;Huelva;068;Santa Bárbara de Casa;1415;704;711
21;Huelva;069;Santa Olalla del Cala;2343;1199;1144
21;Huelva;070;Trigueros;7128;3578;3550
21;Huelva;071;Valdelarco;287;138;149
21;Huelva;072;Valverde del Camino;12492;6035;6457
21;Huelva;073;Villablanca;2047;1062;985
21;Huelva;074;Villalba del Alcor;3713;1845;1868
21;Huelva;075;Villanueva de las Cruces;412;197;215
21;Huelva;076;Villanueva de los Castillejos;2691;1304;1387
21;Huelva;077;Villarrasa;2177;1111;1066
21;Huelva;078;Zalamea la Real;3767;1851;1916
21;Huelva;079;Zufre;1305;671;634
22;Huesca;001;Abiego;301;149;152
22;Huesca;002;Abizanda;132;72;60
22;Huesca;003;Adahuesca;174;89;85
22;Huesca;004;Agüero;166;85;81
22;Huesca;907;Aínsa-Sobrarbe;1467;788;679
22;Huesca;006;Aisa;354;193;161
22;Huesca;007;Albalate de Cinca;1156;599;557
22;Huesca;008;Albalatillo;269;134;135
22;Huesca;009;Albelda;1018;527;491
22;Huesca;011;Albero Alto;103;56;47
22;Huesca;012;Albero Bajo;110;62;48
22;Huesca;013;Alberuela de Tubo;425;222;203
22;Huesca;014;Alcalá de Gurrea;387;192;195
22;Huesca;015;Alcalá del Obispo;360;176;184
22;Huesca;016;Alcampell;1028;513;515
22;Huesca;017;Alcolea de Cinca;1235;628;607
22;Huesca;018;Alcubierre;503;258;245
22;Huesca;019;Alerre;158;82;76
22;Huesca;020;Alfántega;144;74;70
22;Huesca;021;Almudévar;2453;1283;1170
22;Huesca;022;Almunia de San Juan;752;376;376
22;Huesca;023;Almuniente;668;340;328
22;Huesca;024;Alquézar;287;144;143
22;Huesca;025;Altorricón;1491;768;723
22;Huesca;027;Angüés;465;253;212
22;Huesca;028;Ansó;501;246;255
22;Huesca;029;Antillón;172;86;86
22;Huesca;032;Aragüés del Puerto;122;73;49
22;Huesca;035;Arén;448;243;205
22;Huesca;036;Argavieso;115;66;49
22;Huesca;037;Arguis;62;35;27
22;Huesca;039;Ayerbe;1169;599;570
22;Huesca;040;Azanuy-Alins;212;102;110
22;Huesca;041;Azara;220;111;109
22;Huesca;042;Azlor;184;95;89
22;Huesca;043;Baélls;166;85;81
22;Huesca;044;Bailo;342;197;145
22;Huesca;045;Baldellou;164;84;80
22;Huesca;046;Ballobar;1128;574;554
22;Huesca;047;Banastás;139;70;69
22;Huesca;048;Barbastro;15392;7570;7822
22;Huesca;049;Barbués;125;64;61
22;Huesca;050;Barbuñales;113;57;56
22;Huesca;051;Bárcabo;122;66;56
22;Huesca;052;Belver de Cinca;1453;755;698
22;Huesca;053;Benabarre;1244;646;598
22;Huesca;054;Benasque;1212;625;587
22;Huesca;055;Berbegal;510;256;254
22;Huesca;057;Bielsa;445;228;217
22;Huesca;058;Bierge;199;119;80
22;Huesca;059;Biescas;1219;637;582
22;Huesca;060;Binaced;1626;828;798
22;Huesca;061;Binéfar;8020;4014;4006
22;Huesca;062;Bisaurri;233;137;96
22;Huesca;063;Biscarrués;266;142;124
22;Huesca;064;Blecua y Torres;190;100;90
22;Huesca;066;Boltaña;858;438;420
22;Huesca;067;Bonansa;73;36;37
22;Huesca;068;Borau;76;39;37
22;Huesca;069;Broto;513;256;257
22;Huesca;072;Caldearenas;262;143;119
22;Huesca;074;Campo;404;192;212
22;Huesca;075;Camporrélls;255;116;139
22;Huesca;076;Canal de Berdún;457;235;222
22;Huesca;077;Candasnos;603;306;297
22;Huesca;078;Canfranc;493;265;228
22;Huesca;079;Capdesaso;213;104;109
22;Huesca;080;Capella;426;217;209
22;Huesca;081;Casbas de Huesca;351;179;172
22;Huesca;083;Castejón de Monegros;759;375;384
22;Huesca;084;Castejón de Sos;484;253;231
22;Huesca;082;Castejón del Puente;445;216;229
22;Huesca;085;Castelflorite;161;84;77
22;Huesca;086;Castiello de Jaca;171;79;92
22;Huesca;087;Castigaleu;95;54;41
22;Huesca;088;Castillazuelo;252;123;129
22;Huesca;089;Castillonroy;430;211;219
22;Huesca;094;Chalamera;174;94;80
22;Huesca;095;Chía;123;70;53
22;Huesca;096;Chimillas;165;92;73
22;Huesca;090;Colungo;137;73;64
22;Huesca;099;Esplús;861;406;455
22;Huesca;102;Estada;187;94;93
22;Huesca;103;Estadilla;1003;510;493
22;Huesca;105;Estopiñán del Castillo;188;97;91
22;Huesca;106;Fago;44;28;16
22;Huesca;107;Fanlo;67;46;21
22;Huesca;109;Fiscal;255;136;119
22;Huesca;110;Fonz;1200;611;589
22;Huesca;111;Foradada del Toscar;281;135;146
22;Huesca;112;Fraga;11839;5983;5856
22;Huesca;113;Fueva (La);633;342;291
22;Huesca;114;Gistaín;197;113;84
22;Huesca;115;Grado (El);597;314;283
22;Huesca;116;Grañén;2135;1074;1061
22;Huesca;117;Graus;3324;1695;1629
22;Huesca;119;Gurrea de Gállego;1943;969;974
22;Huesca;122;Hoz de Jaca;83;35;48
22;Huesca;908;Hoz y Costean;274;141;133
22;Huesca;124;Huerto;300;157;143
22;Huesca;125;Huesca;45515;22101;23414
22;Huesca;126;Ibieca;114;61;53
22;Huesca;127;Igriés;148;83;65
22;Huesca;128;Ilche;306;155;151
22;Huesca;129;Isábena;276;148;128
22;Huesca;130;Jaca;11355;5595;5760
22;Huesca;131;Jasa;121;67;54
22;Huesca;133;Labuerda;166;87;79
22;Huesca;135;Laluenga;280;149;131
22;Huesca;136;Lalueza;1365;738;627
22;Huesca;137;Lanaja;1735;900;835
22;Huesca;139;Laperdiguera;114;60;54
22;Huesca;141;Lascellas-Ponzano;175;85;90
22;Huesca;142;Lascuarre;170;85;85
22;Huesca;143;Laspaúles;308;175;133
22;Huesca;144;Laspuña;301;165;136
22;Huesca;149;Loarre;405;217;188
22;Huesca;150;Loporzano;582;295;287
22;Huesca;151;Loscorrales;128;67;61
22;Huesca;905;Lupiñén-Ortilla;372;199;173
22;Huesca;155;Monesma y Cajigar;107;53;54
22;Huesca;156;Monflorite-Lascasas;185;105;80
22;Huesca;157;Montanuy;326;185;141
22;Huesca;158;Monzón;14766;7456;7310
22;Huesca;160;Naval;301;152;149
22;Huesca;162;Novales;187;89;98
22;Huesca;163;Nueno;222;120;102
22;Huesca;164;Olvena;58;27;31
22;Huesca;165;Ontiñena;734;370;364
22;Huesca;167;Osso de Cinca;747;393;354
22;Huesca;168;Palo;32;18;14
22;Huesca;170;Panticosa;639;333;306
22;Huesca;172;Peñalba;809;404;405
22;Huesca;173;Peñas de Riglos (Las);315;173;142
22;Huesca;174;Peralta de Alcofea;772;385;387
22;Huesca;175;Peralta de Calasanz;333;185;148
22;Huesca;176;Peraltilla;165;86;79
22;Huesca;177;Perarrúa;158;74;84
22;Huesca;178;Pertusa;155;77;78
22;Huesca;181;Piracés;104;63;41
22;Huesca;182;Plan;302;169;133
22;Huesca;184;Poleñino;259;131;128
22;Huesca;186;Pozán de Vero;268;130;138
22;Huesca;187;Puebla de Castro (La);302;159;143
22;Huesca;188;Puente de Montañana;144;74;70
22;Huesca;902;Puente la Reina de Jaca;286;142;144
22;Huesca;189;Puértolas;188;110;78
22;Huesca;190;Pueyo de Araguás (El);176;109;67
22;Huesca;193;Pueyo de Santa Cruz;388;202;186
22;Huesca;195;Quicena;139;69;70
22;Huesca;197;Robres;707;368;339
22;Huesca;199;Sabiñánigo;8990;4624;4366
22;Huesca;200;Sahún;312;165;147
22;Huesca;201;Salas Altas;417;212;205
22;Huesca;202;Salas Bajas;203;98;105
22;Huesca;203;Salillas;133;69;64
22;Huesca;204;Sallent de Gállego;958;490;468
22;Huesca;205;San Esteban de Litera;693;344;349
22;Huesca;207;San Juan de Plan;172;97;75
22;Huesca;903;San Miguel del Cinca;977;506;471
22;Huesca;206;Sangarrén;313;150;163
22;Huesca;208;Santa Cilia;206;110;96
22;Huesca;209;Santa Cruz de la Serós;166;96;70
22;Huesca;906;Santa María de Dulcis;224;108;116
22;Huesca;212;Santaliestra y San Quílez;100;50;50
22;Huesca;213;Sariñena;4155;2083;2072
22;Huesca;214;Secastilla;181;83;98
22;Huesca;215;Seira;208;104;104
22;Huesca;217;Sena;627;323;304
22;Huesca;218;Senés de Alcubierre;59;29;30
22;Huesca;220;Sesa;289;146;143
22;Huesca;221;Sesué;89;49;40
22;Huesca;222;Siétamo;355;199;156
22;Huesca;223;Sopeira;135;72;63
22;Huesca;904;Sotonera (La);1200;620;580
22;Huesca;225;Tamarite de Litera;3994;1965;2029
22;Huesca;226;Tardienta;1126;573;553
22;Huesca;227;Tella-Sin;300;154;146
22;Huesca;228;Tierz;189;100;89
22;Huesca;229;Tolva;242;133;109
22;Huesca;230;Torla;370;197;173
22;Huesca;232;Torralba de Aragón;146;70;76
22;Huesca;233;Torre la Ribera;113;64;49
22;Huesca;234;Torrente de Cinca;1163;582;581
22;Huesca;235;Torres de Alcanadre;145;86;59
22;Huesca;236;Torres de Barbués;410;214;196
22;Huesca;239;Tramaced;125;73;52
22;Huesca;242;Valfarta;110;57;53
22;Huesca;243;Valle de Bardají;56;29;27
22;Huesca;901;Valle de Hecho;1043;556;487
22;Huesca;244;Valle de Lierp;65;32;33
22;Huesca;245;Velilla de Cinca;514;256;258
22;Huesca;909;Vencillón;512;270;242
22;Huesca;246;Veracruz;119;67;52
22;Huesca;247;Viacamp y Litera;32;20;12
22;Huesca;248;Vicién;125;69;56
22;Huesca;249;Villanova;106;56;50
22;Huesca;250;Villanúa;332;173;159
22;Huesca;251;Villanueva de Sigena;492;253;239
22;Huesca;252;Yebra de Basa;166;101;65
22;Huesca;253;Yésero;67;32;35
22;Huesca;254;Zaidín;1755;891;864
23;Jaén;001;Albanchez de Mágina;1617;802;815
23;Jaén;002;Alcalá la Real;21441;10660;10781
23;Jaén;003;Alcaudete;11704;5824;5880
23;Jaén;004;Aldeaquemada;594;306;288
23;Jaén;005;Andújar;38385;19025;19360
23;Jaén;006;Arjona;5629;2822;2807
23;Jaén;007;Arjonilla;4048;2029;2019
23;Jaén;008;Arquillos;1833;938;895
23;Jaén;009;Baeza;15702;7706;7996
23;Jaén;010;Bailén;17645;8896;8749
23;Jaén;011;Baños de la Encina;2778;1408;1370
23;Jaén;012;Beas de Segura;8571;4304;4267
23;Jaén;902;Bedmar y Garcíez;3496;1735;1761
23;Jaén;014;Begíjar;3130;1575;1555
23;Jaén;015;Bélmez de la Moraleda;2046;1016;1030
23;Jaén;016;Benatae;613;309;304
23;Jaén;017;Cabra del Santo Cristo;2347;1191;1156
23;Jaén;018;Cambil;3497;1841;1656
23;Jaén;019;Campillo de Arenas;2323;1174;1149
23;Jaén;020;Canena;2085;1009;1076
23;Jaén;021;Carboneros;705;347;358
23;Jaén;901;Cárcheles;1612;788;824
23;Jaén;024;Carolina (La);15205;7485;7720
23;Jaén;025;Castellar;3751;1893;1858
23;Jaén;026;Castillo de Locubín;5774;2869;2905
23;Jaén;027;Cazalilla;860;435;425
23;Jaén;028;Cazorla;9146;4480;4666
23;Jaén;029;Chiclana de Segura;1643;834;809
23;Jaén;030;Chilluévar;1919;963;956
23;Jaén;031;Escañuela;1043;520;523
23;Jaén;032;Espelúy;801;392;409
23;Jaén;033;Frailes;1975;993;982
23;Jaén;034;Fuensanta de Martos;3459;1679;1780
23;Jaén;035;Fuerte del Rey;1167;582;585
23;Jaén;037;Génave;773;388;385
23;Jaén;038;Guardia de Jaén (La);1901;993;908
23;Jaén;039;Guarromán;2919;1417;1502
23;Jaén;041;Higuera de Calatrava;737;381;356
23;Jaén;042;Hinojares;589;292;297
23;Jaén;043;Hornos;798;396;402
23;Jaén;044;Huelma;6114;3072;3042
23;Jaén;045;Huesa;2852;1442;1410
23;Jaén;046;Ibros;3217;1612;1605
23;Jaén;047;Iruela (La);2163;1101;1062
23;Jaén;048;Iznatoraf;1269;615;654
23;Jaén;049;Jabalquinto;2717;1343;1374
23;Jaén;050;Jaén;112772;54577;58195
23;Jaén;051;Jamilena;3223;1638;1585
23;Jaén;052;Jimena;1675;814;861
23;Jaén;053;Jódar;12564;6259;6305
23;Jaén;040;Lahiguera;1962;962;1000
23;Jaén;054;Larva;573;294;279
23;Jaén;055;Linares;61642;30118;31524
23;Jaén;056;Lopera;4024;2005;2019
23;Jaén;057;Lupión;1138;528;610
23;Jaén;058;Mancha Real;8876;4419;4457
23;Jaén;059;Marmolejo;7720;3871;3849
23;Jaén;060;Martos;22206;10968;11238
23;Jaén;061;Mengíbar;8550;4298;4252
23;Jaén;062;Montizón;2045;1017;1028
23;Jaén;063;Navas de San Juan;5567;2784;2783
23;Jaén;064;Noalejo;2403;1213;1190
23;Jaén;065;Orcera;2457;1250;1207
23;Jaén;066;Peal de Becerro;5412;2698;2714
23;Jaén;067;Pegalajar;3143;1552;1591
23;Jaén;069;Porcuna;7143;3576;3567
23;Jaén;070;Pozo Alcón;6366;3212;3154
23;Jaén;071;Puente de Génave;2100;1066;1034
23;Jaén;072;Puerta de Segura (La);2860;1424;1436
23;Jaén;073;Quesada;6512;3173;3339
23;Jaén;074;Rus;3806;1905;1901
23;Jaén;075;Sabiote;4339;2115;2224
23;Jaén;076;Santa Elena;1094;576;518
23;Jaén;077;Santiago de Calatrava;991;499;492
23;Jaén;904;Santiago-Pontones;5010;2562;2448
23;Jaén;079;Santisteban del Puerto;5020;2566;2454
23;Jaén;080;Santo Tomé;2632;1321;1311
23;Jaén;081;Segura de la Sierra;2288;1157;1131
23;Jaén;082;Siles;2887;1466;1421
23;Jaén;084;Sorihuela del Guadalimar;1353;674;679
23;Jaén;086;Torre del Campo;11980;5901;6079
23;Jaén;085;Torreblascopedro;3042;1515;1527
23;Jaén;087;Torredonjimeno;13928;6835;7093
23;Jaén;088;Torreperogil;7909;3886;4023
23;Jaén;090;Torres;1957;989;968
23;Jaén;091;Torres de Albánchez;1126;559;567
23;Jaén;092;Úbeda;31783;15642;16141
23;Jaén;093;Valdepeñas de Jaén;4705;2350;2355
23;Jaén;094;Vilches;5153;2577;2576
23;Jaén;095;Villacarrillo;12058;5973;6085
23;Jaén;096;Villanueva de la Reina;3331;1656;1675
23;Jaén;097;Villanueva del Arzobispo;8854;4316;4538
23;Jaén;098;Villardompardo;1314;641;673
23;Jaén;099;Villares (Los);4669;2315;2354
23;Jaén;101;Villarrodrigo;672;323;349
23;Jaén;903;Villatorres;4159;2070;2089
24;León;001;Acebedo;398;202;196
24;León;002;Algadefe;408;205;203
24;León;003;Alija del Infantado;1081;546;535
24;León;004;Almanza;869;453;416
24;León;005;Antigua (La);744;392;352
24;León;006;Ardón;775;393;382
24;León;007;Arganza;1145;548;597
24;León;008;Astorga;12743;6095;6648
24;León;009;Balboa;582;305;277
24;León;010;Bañeza (La);10427;5103;5324
24;León;011;Barjas;667;354;313
24;León;012;Barrios de Luna (Los);400;194;206
24;León;014;Bembibre;11528;5752;5776
24;León;015;Benavides;3261;1676;1585
24;León;016;Benuza;833;428;405
24;León;017;Bercianos del Páramo;940;470;470
24;León;018;Bercianos del Real Camino;267;130;137
24;León;019;Berlanga del Bierzo;481;234;247
24;León;020;Boca de Huérgano;720;393;327
24;León;021;Boñar;2828;1386;1442
24;León;022;Borrenes;600;305;295
24;León;023;Brazuelo;392;193;199
24;León;024;Burgo Ranero (El);1125;595;530
24;León;025;Burón;540;281;259
24;León;026;Bustillo del Páramo;2138;1064;1074
24;León;027;Cabañas Raras;1398;725;673
24;León;028;Cabreros del Río;682;355;327
24;León;029;Cabrillanes;1298;632;666
24;León;030;Cacabelos;5040;2564;2476
24;León;031;Calzada del Coto;328;184;144
24;León;032;Campazas;208;99;109
24;León;033;Campo de Villavidel;404;212;192
24;León;034;Camponaraya;3175;1538;1637
24;León;036;Candín;561;307;254
24;León;037;Cármenes;484;235;249
24;León;038;Carracedelo;3475;1736;1739
24;León;039;Carrizo;2867;1445;1422
24;León;040;Carrocera;621;294;327
24;León;041;Carucedo;686;318;368
24;León;042;Castilfalé;127;68;59
24;León;043;Castrillo de Cabrera;294;140;154
24;León;044;Castrillo de la Valduerna;299;131;168
24;León;046;Castrocalbón;1459;743;716
24;León;047;Castrocontrigo;1402;696;706
24;León;049;Castropodame;1942;981;961
24;León;050;Castrotierra de Valmadrigal;176;90;86
24;León;051;Cea;847;444;403
24;León;052;Cebanico;298;159;139
24;León;053;Cebrones del Río;797;404;393
24;León;065;Chozas de Abajo;2251;1170;1081
24;León;054;Cimanes de la Vega;763;377;386
24;León;055;Cimanes del Tejar;1206;600;606
24;León;056;Cistierna;4916;2471;2445
24;León;057;Congosto;1932;950;982
24;León;058;Corbillos de los Oteros;371;182;189
24;León;059;Corullón;1505;747;758
24;León;060;Crémenes;1613;787;826
24;León;061;Cuadros;1726;821;905
24;León;062;Cubillas de los Oteros;250;121;129
24;León;063;Cubillas de Rueda;725;359;366
24;León;064;Cubillos del Sil;1581;814;767
24;León;066;Destriana;1093;531;562
24;León;067;Encinedo;1107;575;532
24;León;068;Ercina (La);877;421;456
24;León;069;Escobar de Campos;98;56;42
24;León;070;Fabero;6456;3244;3212
24;León;071;Folgoso de la Ribera;1571;782;789
24;León;072;Fresnedo;"";"";""
24;León;073;Fresno de la Vega;777;389;388
24;León;074;Fuentes de Carbajal;159;81;78
24;León;076;Garrafe de Torío;1137;570;567
24;León;077;Gordaliza del Pino;433;219;214
24;León;078;Gordoncillo;690;336;354
24;León;079;Gradefes;1597;773;824
24;León;080;Grajal de Campos;320;134;186
24;León;081;Gusendos de los Oteros;266;133;133
24;León;082;Hospital de Órbigo;1220;597;623
24;León;083;Igüeña;2367;1246;1121
24;León;084;Izagre;325;153;172
24;León;086;Joarilla de las Matas;516;271;245
24;León;087;Laguna Dalga;1056;527;529
24;León;088;Laguna de Negrillos;1711;866;845
24;León;089;León;147311;69682;77629
24;León;092;Llamas de la Ribera;1382;702;680
24;León;090;Lucillo;585;292;293
24;León;091;Luyego;1046;501;545
24;León;093;Magaz de Cepeda;652;307;345
24;León;094;Mansilla de las Mulas;1768;877;891
24;León;095;Mansilla Mayor;449;227;222
24;León;096;Maraña;199;100;99
24;León;097;Matadeón de los Oteros;385;189;196
24;León;098;Matallana de Torío;2005;992;1013
24;León;099;Matanza;391;191;200
24;León;100;Molinaseca;778;398;380
24;León;101;Murias de Paredes;838;393;445
24;León;102;Noceda del Bierzo;995;489;506
24;León;103;Oencia;546;289;257
24;León;104;Omañas (Las);513;256;257
24;León;105;Onzonilla;1458;719;739
24;León;106;Oseja de Sajambre;385;219;166
24;León;107;Pajares de los Oteros;456;234;222
24;León;108;Palacios de la Valduerna;640;313;327
24;León;109;Palacios del Sil;1670;840;830
24;León;110;Páramo del Sil;2220;1125;1095
24;León;111;Pedrosa del Rey;"";"";""
24;León;112;Peranzanes;391;203;188
24;León;113;Pobladura de Pelayo García;687;351;336
24;León;114;Pola de Gordón (La);5803;2824;2979
24;León;115;Ponferrada;61505;30088;31417
24;León;116;Posada de Valdeón;535;281;254
24;León;117;Pozuelo del Páramo;737;383;354
24;León;118;Prado de la Guzpeña;195;104;91
24;León;119;Priaranza del Bierzo;1076;552;524
24;León;120;Prioro;551;287;264
24;León;121;Puebla de Lillo;753;403;350
24;León;122;Puente de Domingo Flórez;2084;1094;990
24;León;123;Quintana del Castillo;1331;697;634
24;León;124;Quintana del Marco;649;329;320
24;León;125;Quintana y Congosto;971;504;467
24;León;127;Regueras de Arriba;458;238;220
24;León;129;Reyero;186;102;84
24;León;130;Riaño;573;312;261
24;León;131;Riego de la Vega;1237;601;636
24;León;132;Riello;1294;650;644
24;León;133;Rioseco de Tapia;651;347;304
24;León;134;Robla (La);5560;2810;2750
24;León;136;Roperuelos del Páramo;944;480;464
24;León;137;Sabero;2292;1140;1152
24;León;139;Sahagún;3352;1666;1686
24;León;141;San Adrián del Valle;227;103;124
24;León;142;San Andrés del Rabanedo;21500;10526;10974
24;León;144;San Cristóbal de la Polantera;1241;621;620
24;León;145;San Emiliano;1060;521;539
24;León;146;San Esteban de Nogales;541;252;289
24;León;148;San Justo de la Vega;2400;1200;1200
24;León;149;San Millán de los Caballeros;216;104;112
24;León;150;San Pedro Bercianos;415;203;212
24;León;143;Sancedo;689;342;347
24;León;151;Santa Colomba de Curueño;797;378;419
24;León;152;Santa Colomba de Somoza;512;257;255
24;León;153;Santa Cristina de Valmadrigal;444;219;225
24;León;154;Santa Elena de Jamuz;1553;788;765
24;León;155;Santa María de la Isla;806;422;384
24;León;158;Santa María de Ordás;542;270;272
24;León;156;Santa María del Monte de Cea;475;237;238
24;León;157;Santa María del Páramo;3214;1543;1671
24;León;159;Santa Marina del Rey;2760;1389;1371
24;León;160;Santas Martas;1169;603;566
24;León;161;Santiago Millas;420;211;209
24;León;162;Santovenia de la Valdoncina;1348;647;701
24;León;163;Sariegos;1780;888;892
24;León;164;Sena de Luna;613;298;315
24;León;165;Sobrado;611;305;306
24;León;166;Soto de la Vega;2164;1095;1069
24;León;167;Soto y Amío;1282;626;656
24;León;168;Toral de los Guzmanes;782;397;385
24;León;169;Toreno;5012;2609;2403
24;León;170;Torre del Bierzo;3627;1816;1811
24;León;171;Trabadelo;722;381;341
24;León;172;Truchas;1149;580;569
24;León;173;Turcia;1583;808;775
24;León;174;Urdiales del Páramo;867;433;434
24;León;185;Val de San Lorenzo;843;413;430
24;León;175;Valdefresno;1645;823;822
24;León;176;Valdefuentes del Páramo;523;268;255
24;León;177;Valdelugueros;470;241;229
24;León;178;Valdemora;134;67;67
24;León;179;Valdepiélago;471;228;243
24;León;180;Valdepolo;1779;916;863
24;León;181;Valderas;2359;1196;1163
24;León;182;Valderrey;735;358;377
24;León;183;Valderrueda;1527;755;772
24;León;184;Valdesamario;353;174;179
24;León;187;Valdevimbre;1348;690;658
24;León;188;Valencia de Don Juan;3863;1929;1934
24;León;191;Vallecillo;209;109;100
24;León;189;Valverde de la Virgen;3807;1873;1934
24;León;190;Valverde-Enrique;277;140;137
24;León;193;Vecilla (La);466;235;231
24;León;196;Vega de Espinareda;3260;1658;1602
24;León;197;Vega de Infanzones;879;435;444
24;León;198;Vega de Valcarce;1125;578;547
24;León;194;Vegacervera;400;211;189
24;León;199;Vegaquemada;644;307;337
24;León;201;Vegas del Condado;1605;805;800
24;León;202;Villablino;16127;8130;7997
24;León;203;Villabraz;189;97;92
24;León;205;Villadangos del Páramo;1036;504;532
24;León;206;Villadecanes;2485;1257;1228
24;León;207;Villademor de la Vega;534;275;259
24;León;209;Villafranca del Bierzo;4252;2129;2123
24;León;210;Villagatón;1030;526;504
24;León;211;Villamandos;522;252;270
24;León;901;Villamanín;1508;750;758
24;León;212;Villamañán;1631;819;812
24;León;213;Villamartín de Don Sancho;248;130;118
24;León;214;Villamejil;1091;554;537
24;León;215;Villamol;290;151;139
24;León;216;Villamontán de la Valduerna;1267;639;628
24;León;217;Villamoratiel de las Matas;229;127;102
24;León;218;Villanueva de las Manzanas;691;327;364
24;León;219;Villaobispo de Otero;802;406;396
24;León;902;Villaornate y Castro;605;316;289
24;León;221;Villaquejida;1133;585;548
24;León;222;Villaquilambre;6132;3037;3095
24;León;223;Villarejo de Órbigo;3675;1803;1872
24;León;224;Villares de Órbigo;1061;536;525
24;León;225;Villasabariego;1296;651;645
24;León;226;Villaselán;379;204;175
24;León;227;Villaturiel;1780;894;886
24;León;228;Villazala;1214;631;583
24;León;229;Villazanzo de Valderaduey;799;422;377
24;León;230;Zotes del Páramo;799;412;387
25;Lleida;001;Abella de la Conca;161;87;74
25;Lleida;002;Àger;589;321;268
25;Lleida;003;Agramunt;4883;2441;2442
25;Lleida;038;Aitona;2403;1265;1138
25;Lleida;004;Alamús (Els);655;337;318
25;Lleida;005;Alàs i Cerc;391;212;179
25;Lleida;006;Albagés (L');532;268;264
25;Lleida;007;Albatàrrec;1004;473;531
25;Lleida;008;Albesa;1472;737;735
25;Lleida;009;Albi (L');765;394;371
25;Lleida;010;Alcanó;276;136;140
25;Lleida;011;Alcarràs;4582;2271;2311
25;Lleida;012;Alcoletge;1584;804;780
25;Lleida;013;Alfarràs;3059;1500;1559
25;Lleida;014;Alfés;348;189;159
25;Lleida;015;Algerri;544;269;275
25;Lleida;016;Alguaire;2878;1448;1430
25;Lleida;017;Alins;299;152;147
25;Lleida;019;Almacelles;5561;2847;2714
25;Lleida;020;Almatret;522;275;247
25;Lleida;021;Almenar;3619;1839;1780
25;Lleida;022;Alòs de Balaguer;164;97;67
25;Lleida;023;Alpicat;2935;1487;1448
25;Lleida;024;Alt Àneu;380;209;171
25;Lleida;027;Anglesola;1259;608;651
25;Lleida;029;Arbeca;2332;1166;1166
25;Lleida;031;Arres;85;45;40
25;Lleida;032;Arsèguel;113;59;54
25;Lleida;033;Artesa de Lleida;1220;605;615
25;Lleida;034;Artesa de Segre;3136;1611;1525
25;Lleida;036;Aspa;256;126;130
25;Lleida;037;Avellanes i Santa Linya (Les);473;253;220
25;Lleida;039;Baix Pallars;362;204;158
25;Lleida;040;Balaguer;13348;6597;6751
25;Lleida;041;Barbens;799;412;387
25;Lleida;042;Baronia de Rialb (La);271;142;129
25;Lleida;044;Bassella;366;182;184
25;Lleida;045;Bausen;67;39;28
25;Lleida;046;Belianes;568;265;303
25;Lleida;170;Bellaguarda;370;190;180
25;Lleida;047;Bellcaire d'Urgell;1416;680;736
25;Lleida;048;Bell-lloc d'Urgell;2190;1089;1101
25;Lleida;049;Bellmunt d'Urgell;238;121;117
25;Lleida;050;Bellpuig;4005;1988;2017
25;Lleida;051;Bellver de Cerdanya;1591;825;766
25;Lleida;052;Bellvís;2212;1094;1118
25;Lleida;053;Benavent de Segrià;755;391;364
25;Lleida;055;Biosca;271;135;136
25;Lleida;057;Bòrdes (Es);206;105;101
25;Lleida;058;Borges Blanques (Les);5202;2577;2625
25;Lleida;059;Bossòst;806;392;414
25;Lleida;056;Bovera;431;217;214
25;Lleida;060;Cabanabona;106;49;57
25;Lleida;061;Cabó;138;73;65
25;Lleida;062;Camarasa;910;463;447
25;Lleida;063;Canejan;108;58;50
25;Lleida;904;Castell de Mur;151;77;74
25;Lleida;064;Castellar de la Ribera;150;72;78
25;Lleida;067;Castelldans;983;513;470
25;Lleida;068;Castellnou de Seana;731;350;381
25;Lleida;069;Castelló de Farfanya;616;309;307
25;Lleida;070;Castellserà;1151;566;585
25;Lleida;071;Cava;51;30;21
25;Lleida;072;Cervera;7353;3660;3693
25;Lleida;073;Cervià de les Garrigues;846;432;414
25;Lleida;074;Ciutadilla;223;112;111
25;Lleida;075;Clariana de Cardener;139;71;68
25;Lleida;076;Cogul (El);233;117;116
25;Lleida;077;Coll de Nargó;616;321;295
25;Lleida;163;Coma i la Pedra (La);245;145;100
25;Lleida;161;Conca de Dalt;470;245;225
25;Lleida;078;Corbins;1005;515;490
25;Lleida;079;Cubells;369;186;183
25;Lleida;081;Espluga Calba (L');438;233;205
25;Lleida;082;Espot;241;121;120
25;Lleida;088;Estamariu;134;68;66
25;Lleida;085;Estaràs;167;85;82
25;Lleida;086;Esterri d'Àneu;505;248;257
25;Lleida;087;Esterri de Cardós;72;39;33
25;Lleida;089;Farrera;95;50;45
25;Lleida;908;Fígols i Alinyà;345;189;156
25;Lleida;092;Floresta (La);195;98;97
25;Lleida;093;Fondarella;646;314;332
25;Lleida;094;Foradada;179;100;79
25;Lleida;096;Fuliola (La);1312;665;647
25;Lleida;097;Fulleda;133;70;63
25;Lleida;098;Gavet de la Conca;359;181;178
25;Lleida;912;Gimenells i el Pla de la Font;1204;637;567
25;Lleida;099;Golmés;1333;648;685
25;Lleida;100;Gósol;198;103;95
25;Lleida;101;Granadella (La);855;425;430
25;Lleida;102;Granja d'Escarp (La);1141;576;565
25;Lleida;103;Granyanella;144;72;72
25;Lleida;105;Granyena de les Garrigues;185;90;95
25;Lleida;104;Granyena de Segarra;172;88;84
25;Lleida;109;Guimerà;412;200;212
25;Lleida;903;Guingueta d'Àneu (La);273;138;135
25;Lleida;110;Guissona;2899;1495;1404
25;Lleida;111;Guixers;160;99;61
25;Lleida;115;Isona i Conca Dellà;1337;695;642
25;Lleida;112;Ivars de Noguera;327;165;162
25;Lleida;113;Ivars d'Urgell;1735;859;876
25;Lleida;114;Ivorra;147;80;67
25;Lleida;910;Josa i Tuixén;146;77;69
25;Lleida;118;Juncosa;581;304;277
25;Lleida;119;Juneda;3034;1546;1488
25;Lleida;121;Les;686;344;342
25;Lleida;122;Linyola;2379;1192;1187
25;Lleida;123;Lladorre;219;119;100
25;Lleida;124;Lladurs;261;144;117
25;Lleida;125;Llardecans;647;326;321
25;Lleida;126;Llavorsí;276;146;130
25;Lleida;120;Lleida;114234;55880;58354
25;Lleida;127;Lles de Cerdanya;301;165;136
25;Lleida;128;Llimiana;135;70;65
25;Lleida;129;Llobera;251;129;122
25;Lleida;133;Maials;1063;539;524
25;Lleida;130;Maldà;310;156;154
25;Lleida;131;Massalcoreig;658;318;340
25;Lleida;132;Massoteres;160;78;82
25;Lleida;134;Menàrguens;874;437;437
25;Lleida;135;Miralcamp;1242;602;640
25;Lleida;137;Mollerussa;9266;4601;4665
25;Lleida;136;Molsosa (La);133;68;65
25;Lleida;139;Montellà i Martinet;518;271;247
25;Lleida;140;Montferrer i Castellbò;678;365;313
25;Lleida;138;Montgai;837;425;412
25;Lleida;142;Montoliu de Lleida;456;221;235
25;Lleida;141;Montoliu de Segarra;211;112;99
25;Lleida;143;Montornès de Segarra;119;54;65
25;Lleida;145;Nalec;106;47;59
25;Lleida;025;Naut Aran;1279;685;594
25;Lleida;146;Navès;274;138;136
25;Lleida;148;Odèn;300;164;136
25;Lleida;149;Oliana;1953;1009;944
25;Lleida;150;Oliola;209;108;101
25;Lleida;151;Olius;507;247;260
25;Lleida;152;Oluges (Les);209;110;99
25;Lleida;153;Omellons (Els);265;137;128
25;Lleida;154;Omells de na Gaia (Els);152;81;71
25;Lleida;155;Organyà;1013;517;496
25;Lleida;156;Os de Balaguer;795;420;375
25;Lleida;157;Ossó de Sió;233;116;117
25;Lleida;158;Palau d'Anglesola (El);1627;818;809
25;Lleida;164;Penelles;552;300;252
25;Lleida;165;Peramola;390;203;187
25;Lleida;166;Pinell de Solsonès;253;131;122
25;Lleida;167;Pinós;340;185;155
25;Lleida;911;Plans de Sió (Els);661;332;329
25;Lleida;168;Poal (El);642;334;308
25;Lleida;169;Pobla de Cérvoles (La);220;120;100
25;Lleida;171;Pobla de Segur (La);3113;1515;1598
25;Lleida;030;Pont de Bar (El);161;87;74
25;Lleida;173;Pont de Suert (El);2287;1153;1134
25;Lleida;172;Ponts;2251;1124;1127
25;Lleida;174;Portella (La);611;318;293
25;Lleida;175;Prats i Sansor;172;93;79
25;Lleida;176;Preixana;467;240;227
25;Lleida;177;Preixens;523;254;269
25;Lleida;179;Prullans;222;115;107
25;Lleida;180;Puiggròs;260;130;130
25;Lleida;181;Puigverd d'Agramunt;239;126;113
25;Lleida;182;Puigverd de Lleida;994;490;504
25;Lleida;183;Rialp;534;281;253
25;Lleida;905;Ribera d'Ondara;508;256;252
25;Lleida;185;Ribera d'Urgellet;815;426;389
25;Lleida;186;Riner;261;134;127
25;Lleida;913;Riu de Cerdanya;"";"";""
25;Lleida;189;Rosselló;1678;825;853
25;Lleida;190;Salàs de Pallars;347;177;170
25;Lleida;191;Sanaüja;450;223;227
25;Lleida;196;Sant Esteve de la Sarga;104;64;40
25;Lleida;192;Sant Guim de Freixenet;1090;540;550
25;Lleida;197;Sant Guim de la Plana;189;99;90
25;Lleida;193;Sant Llorenç de Morunys;857;440;417
25;Lleida;902;Sant Martí de Riucorb;776;399;377
25;Lleida;194;Sant Ramon;587;294;293
25;Lleida;201;Sarroca de Bellera;141;80;61
25;Lleida;200;Sarroca de Lleida;491;259;232
25;Lleida;202;Senterada;112;66;46
25;Lleida;035;Sentiu de Sió (La);477;229;248
25;Lleida;204;Seròs;1860;982;878
25;Lleida;203;Seu d'Urgell (La);10263;5083;5180
25;Lleida;205;Sidamon;457;231;226
25;Lleida;206;Soleràs (El);430;215;215
25;Lleida;207;Solsona;6994;3530;3464
25;Lleida;208;Soriguera;302;161;141
25;Lleida;209;Sort;1607;811;796
25;Lleida;210;Soses;1512;773;739
25;Lleida;211;Sudanell;733;393;340
25;Lleida;212;Sunyer;310;151;159
25;Lleida;215;Talarn;330;167;163
25;Lleida;216;Talavera;309;158;151
25;Lleida;217;Tàrrega;11521;5592;5929
25;Lleida;218;Tarrés;100;53;47
25;Lleida;219;Tarroja de Segarra;189;93;96
25;Lleida;220;Térmens;1434;724;710
25;Lleida;221;Tírvia;116;63;53
25;Lleida;222;Tiurana;217;118;99
25;Lleida;223;Torà;1155;589;566
25;Lleida;224;Torms (Els);207;112;95
25;Lleida;225;Tornabous;841;423;418
25;Lleida;227;Torre de Cabdella (La);733;355;378
25;Lleida;226;Torrebesses;362;182;180
25;Lleida;228;Torrefarrera;1546;785;761
25;Lleida;907;Torrefeta i Florejacs;710;353;357
25;Lleida;230;Torregrossa;2218;1098;1120
25;Lleida;231;Torrelameu;592;319;273
25;Lleida;232;Torres de Segre;1839;942;897
25;Lleida;233;Torre-serona;300;150;150
25;Lleida;234;Tremp;5302;2592;2710
25;Lleida;043;Vall de Boí (La);749;416;333
25;Lleida;901;Vall de Cardós;342;175;167
25;Lleida;238;Vallbona de les Monges;285;137;148
25;Lleida;240;Vallfogona de Balaguer;1421;714;707
25;Lleida;906;Valls d'Aguilar (Les);247;127;120
25;Lleida;239;Valls de Valira (Les);811;426;385
25;Lleida;909;Vansa i Fórnols (La);171;89;82
25;Lleida;242;Verdú;949;462;487
25;Lleida;243;Vielha e Mijaran;3608;1824;1784
25;Lleida;244;Vilagrassa;421;209;212
25;Lleida;245;Vilaller;623;331;292
25;Lleida;247;Vilamòs;130;61;69
25;Lleida;248;Vilanova de Bellpuig;1174;563;611
25;Lleida;254;Vilanova de la Barca;962;485;477
25;Lleida;249;Vilanova de l'Aguda;292;152;140
25;Lleida;250;Vilanova de Meià;496;249;247
25;Lleida;251;Vilanova de Segrià;683;337;346
25;Lleida;252;Vila-sana;495;244;251
25;Lleida;253;Vilosell (El);219;98;121
25;Lleida;255;Vinaixa;702;345;357
26;Rioja (La);001;Ábalos;286;161;125
26;Rioja (La);002;Agoncillo;905;481;424
26;Rioja (La);003;Aguilar del Río Alhama;792;411;381
26;Rioja (La);004;Ajamil;75;49;26
26;Rioja (La);005;Albelda de Iregua;2208;1108;1100
26;Rioja (La);006;Alberite;1973;1001;972
26;Rioja (La);007;Alcanadre;868;444;424
26;Rioja (La);008;Aldeanueva de Ebro;2533;1287;1246
26;Rioja (La);009;Alesanco;555;281;274
26;Rioja (La);010;Alesón;159;77;82
26;Rioja (La);011;Alfaro;9355;4679;4676
26;Rioja (La);012;Almarza de Cameros;39;22;17
26;Rioja (La);013;Anguciana;313;163;150
26;Rioja (La);014;Anguiano;661;364;297
26;Rioja (La);015;Arenzana de Abajo;373;194;179
26;Rioja (La);016;Arenzana de Arriba;45;25;20
26;Rioja (La);017;Arnedillo;445;216;229
26;Rioja (La);018;Arnedo;12507;6222;6285
26;Rioja (La);019;Arrúbal;423;224;199
26;Rioja (La);020;Ausejo;735;385;350
26;Rioja (La);021;Autol;3383;1705;1678
26;Rioja (La);022;Azofra;386;202;184
26;Rioja (La);023;Badarán;807;426;381
26;Rioja (La);024;Bañares;478;242;236
26;Rioja (La);026;Baños de Río Tobía;1876;957;919
26;Rioja (La);025;Baños de Rioja;131;76;55
26;Rioja (La);027;Berceo;244;142;102
26;Rioja (La);028;Bergasa;203;109;94
26;Rioja (La);029;Bergasillas Bajera;32;17;15
26;Rioja (La);030;Bezares;30;19;11
26;Rioja (La);031;Bobadilla;191;97;94
26;Rioja (La);032;Brieva de Cameros;79;45;34
26;Rioja (La);033;Briñas;190;96;94
26;Rioja (La);034;Briones;903;483;420
26;Rioja (La);035;Cabezón de Cameros;37;23;14
26;Rioja (La);036;Calahorra;19218;9319;9899
26;Rioja (La);037;Camprovín;259;135;124
26;Rioja (La);038;Canales de la Sierra;108;54;54
26;Rioja (La);039;Canillas de Río Tuerto;77;36;41
26;Rioja (La);040;Cañas;126;59;67
26;Rioja (La);041;Cárdenas;261;131;130
26;Rioja (La);042;Casalarreina;936;469;467
26;Rioja (La);043;Castañares de Rioja;527;279;248
26;Rioja (La);044;Castroviejo;69;34;35
26;Rioja (La);045;Cellorigo;18;11;7
26;Rioja (La);046;Cenicero;2126;1071;1055
26;Rioja (La);047;Cervera del Río Alhama;3341;1671;1670
26;Rioja (La);048;Cidamón;84;49;35
26;Rioja (La);049;Cihuri;187;103;84
26;Rioja (La);050;Cirueña;134;79;55
26;Rioja (La);051;Clavijo;194;100;94
26;Rioja (La);052;Cordovín;244;123;121
26;Rioja (La);053;Corera;253;123;130
26;Rioja (La);054;Cornago;706;386;320
26;Rioja (La);055;Corporales;72;37;35
26;Rioja (La);056;Cuzcurrita de Río Tirón;487;258;229
26;Rioja (La);057;Daroca de Rioja;58;37;21
26;Rioja (La);058;Enciso;197;117;80
26;Rioja (La);059;Entrena;1117;591;526
26;Rioja (La);060;Estollo;165;90;75
26;Rioja (La);061;Ezcaray;1831;968;863
26;Rioja (La);062;Foncea;144;78;66
26;Rioja (La);063;Fonzaleche;192;108;84
26;Rioja (La);064;Fuenmayor;2102;1040;1062
26;Rioja (La);065;Galbárruli;64;37;27
26;Rioja (La);066;Galilea;284;149;135
26;Rioja (La);067;Gallinero de Cameros;27;18;9
26;Rioja (La);068;Gimileo;88;44;44
26;Rioja (La);069;Grañón;475;251;224
26;Rioja (La);070;Grávalos;300;158;142
26;Rioja (La);071;Haro;8966;4398;4568
26;Rioja (La);072;Herce;382;197;185
26;Rioja (La);073;Herramélluri;191;100;91
26;Rioja (La);074;Hervías;223;118;105
26;Rioja (La);075;Hormilla;495;256;239
26;Rioja (La);076;Hormilleja;194;98;96
26;Rioja (La);077;Hornillos de Cameros;27;14;13
26;Rioja (La);078;Hornos de Moncalvillo;109;56;53
26;Rioja (La);079;Huércanos;922;462;460
26;Rioja (La);080;Igea;936;501;435
26;Rioja (La);081;Jalón de Cameros;44;24;20
26;Rioja (La);082;Laguna de Cameros;179;101;78
26;Rioja (La);083;Lagunilla del Jubera;351;184;167
26;Rioja (La);084;Lardero;3234;1623;1611
26;Rioja (La);086;Ledesma de la Cogolla;19;12;7
26;Rioja (La);087;Leiva;352;173;179
26;Rioja (La);088;Leza de Río Leza;44;28;16
26;Rioja (La);089;Logroño;124823;60292;64531
26;Rioja (La);091;Lumbreras;190;110;80
26;Rioja (La);092;Manjarrés;145;80;65
26;Rioja (La);093;Mansilla de la Sierra;53;33;20
26;Rioja (La);094;Manzanares de Rioja;142;74;68
26;Rioja (La);095;Matute;187;92;95
26;Rioja (La);096;Medrano;239;127;112
26;Rioja (La);098;Munilla;143;66;77
26;Rioja (La);099;Murillo de Río Leza;1592;801;791
26;Rioja (La);100;Muro de Aguas;73;42;31
26;Rioja (La);101;Muro en Cameros;41;29;12
26;Rioja (La);102;Nájera;7150;3577;3573
26;Rioja (La);103;Nalda;873;458;415
26;Rioja (La);104;Navajún;20;14;6
26;Rioja (La);105;Navarrete;2026;1030;996
26;Rioja (La);106;Nestares;70;38;32
26;Rioja (La);107;Nieva de Cameros;123;65;58
26;Rioja (La);109;Ochánduri;115;58;57
26;Rioja (La);108;Ocón;347;193;154
26;Rioja (La);110;Ojacastro;244;140;104
26;Rioja (La);111;Ollauri;314;169;145
26;Rioja (La);112;Ortigosa de Cameros;354;176;178
26;Rioja (La);113;Pazuengos;52;32;20
26;Rioja (La);114;Pedroso;114;62;52
26;Rioja (La);115;Pinillos;32;18;14
26;Rioja (La);117;Pradejón;2855;1456;1399
26;Rioja (La);118;Pradillo;115;60;55
26;Rioja (La);119;Préjano;224;103;121
26;Rioja (La);120;Quel;1990;1043;947
26;Rioja (La);121;Rabanera;53;25;28
26;Rioja (La);122;Rasillo de Cameros (El);132;69;63
26;Rioja (La);123;Redal (El);236;117;119
26;Rioja (La);124;Ribafrecha;1073;578;495
26;Rioja (La);125;Rincón de Soto;3366;1682;1684
26;Rioja (La);126;Robres del Castillo;24;14;10
26;Rioja (La);127;Rodezno;365;185;180
26;Rioja (La);128;Sajazarra;163;83;80
26;Rioja (La);129;San Asensio;1395;725;670
26;Rioja (La);130;San Millán de la Cogolla;308;186;122
26;Rioja (La);131;San Millán de Yécora;76;46;30
26;Rioja (La);132;San Román de Cameros;194;103;91
26;Rioja (La);139;San Torcuato;136;74;62
26;Rioja (La);142;San Vicente de la Sonsierra;1150;592;558
26;Rioja (La);134;Santa Coloma;169;102;67
26;Rioja (La);135;Santa Engracia del Jubera;210;124;86
26;Rioja (La);136;Santa Eulalia Bajera;107;60;47
26;Rioja (La);138;Santo Domingo de la Calzada;5703;2872;2831
26;Rioja (La);140;Santurde de Rioja;326;165;161
26;Rioja (La);141;Santurdejo;253;137;116
26;Rioja (La);143;Sojuela;93;53;40
26;Rioja (La);144;Sorzano;276;148;128
26;Rioja (La);145;Sotés;284;151;133
26;Rioja (La);146;Soto en Cameros;154;83;71
26;Rioja (La);147;Terroba;35;20;15
26;Rioja (La);148;Tirgo;296;149;147
26;Rioja (La);149;Tobía;59;35;24
26;Rioja (La);150;Tormantos;227;119;108
26;Rioja (La);153;Torre en Cameros;17;12;5
26;Rioja (La);151;Torrecilla en Cameros;537;279;258
26;Rioja (La);152;Torrecilla sobre Alesanco;100;51;49
26;Rioja (La);154;Torremontalbo;15;8;7
26;Rioja (La);155;Treviana;319;171;148
26;Rioja (La);157;Tricio;384;188;196
26;Rioja (La);158;Tudelilla;503;251;252
26;Rioja (La);160;Uruñuela;729;383;346
26;Rioja (La);161;Valdemadera;16;10;6
26;Rioja (La);162;Valgañón;180;97;83
26;Rioja (La);163;Ventosa;146;76;70
26;Rioja (La);164;Ventrosa;105;46;59
26;Rioja (La);165;Viguera;427;236;191
26;Rioja (La);166;Villalba de Rioja;176;99;77
26;Rioja (La);167;Villalobar de Rioja;141;81;60
26;Rioja (La);168;Villamediana de Iregua;1869;962;907
26;Rioja (La);169;Villanueva de Cameros;132;68;64
26;Rioja (La);170;Villar de Arnedo (El);726;360;366
26;Rioja (La);171;Villar de Torre;356;183;173
26;Rioja (La);172;Villarejo;47;29;18
26;Rioja (La);173;Villarroya;10;4;6
26;Rioja (La);174;Villarta-Quintana;229;116;113
26;Rioja (La);175;Villavelayo;73;42;31
26;Rioja (La);176;Villaverde de Rioja;105;60;45
26;Rioja (La);177;Villoslada de Cameros;396;219;177
26;Rioja (La);178;Viniegra de Abajo;146;76;70
26;Rioja (La);179;Viniegra de Arriba;54;32;22
26;Rioja (La);180;Zarratón;294;152;142
26;Rioja (La);181;Zarzosa;18;13;5
26;Rioja (La);183;Zorraquín;45;27;18
27;Lugo;001;Abadín;4004;1908;2096
27;Lugo;002;Alfoz;2654;1295;1359
27;Lugo;003;Antas de Ulla;3239;1575;1664
27;Lugo;004;Baleira;2159;1128;1031
27;Lugo;901;Baralla;3776;1924;1852
27;Lugo;005;Barreiros;3780;1814;1966
27;Lugo;006;Becerreá;4056;2057;1999
27;Lugo;007;Begonte;4487;2221;2266
27;Lugo;008;Bóveda;2314;1114;1200
27;Lugo;902;Burela;"";"";""
27;Lugo;009;Carballedo;4197;2088;2109
27;Lugo;010;Castro de Rei;5885;2950;2935
27;Lugo;011;Castroverde;3839;1958;1881
27;Lugo;012;Cervantes;2610;1415;1195
27;Lugo;013;Cervo;13096;6510;6586
27;Lugo;016;Chantada;10382;5081;5301
27;Lugo;014;Corgo (O);4765;2418;2347
27;Lugo;015;Cospeito;6369;3145;3224
27;Lugo;017;Folgoso do Courel;1877;962;915
27;Lugo;018;Fonsagrada (A);6741;3547;3194
27;Lugo;019;Foz;9839;4761;5078
27;Lugo;020;Friol;5084;2553;2531
27;Lugo;022;Guitiriz;6941;3450;3491
27;Lugo;023;Guntín;3901;1904;1997
27;Lugo;024;Incio (O);2811;1392;1419
27;Lugo;026;Láncara;3578;1861;1717
27;Lugo;027;Lourenzá;3117;1513;1604
27;Lugo;028;Lugo;87305;41355;45950
27;Lugo;029;Meira;1870;931;939
27;Lugo;030;Mondoñedo;5695;2655;3040
27;Lugo;031;Monforte de Lemos;20521;9895;10626
27;Lugo;032;Monterroso;4562;2298;2264
27;Lugo;033;Muras;1366;690;676
27;Lugo;034;Navia de Suarna;2279;1222;1057
27;Lugo;035;Negueira de Muñiz;338;175;163
27;Lugo;037;Nogais (As);1885;987;898
27;Lugo;038;Ourol;1866;901;965
27;Lugo;039;Outeiro de Rei;4226;2113;2113
27;Lugo;040;Palas de Rei;4936;2448;2488
27;Lugo;041;Pantón;4178;2014;2164
27;Lugo;042;Paradela;3126;1544;1582
27;Lugo;043;Páramo (O);2060;1055;1005
27;Lugo;044;Pastoriza (A);4429;2220;2209
27;Lugo;045;Pedrafita do Cebreiro;2018;1080;938
27;Lugo;047;Pobra do Brollón (A);3179;1565;1614
27;Lugo;046;Pol;2409;1172;1237
27;Lugo;048;Pontenova (A);3707;1802;1905
27;Lugo;049;Portomarín;2207;1095;1112
27;Lugo;050;Quiroga;5132;2513;2619
27;Lugo;056;Rábade;1768;915;853
27;Lugo;051;Ribadeo;9086;4276;4810
27;Lugo;052;Ribas de Sil;1642;790;852
27;Lugo;053;Ribeira de Piquín;1055;521;534
27;Lugo;054;Riotorto;2155;1063;1092
27;Lugo;055;Samos;2400;1259;1141
27;Lugo;057;Sarria;12611;6243;6368
27;Lugo;058;Saviñao (O);5794;2834;2960
27;Lugo;059;Sober;3740;1778;1962
27;Lugo;060;Taboada;5069;2513;2556
27;Lugo;061;Trabada;1957;945;1012
27;Lugo;062;Triacastela;1052;536;516
27;Lugo;063;Valadouro (O);2762;1372;1390
27;Lugo;064;Vicedo (O);2685;1304;1381
27;Lugo;065;Vilalba;16329;7999;8330
27;Lugo;066;Viveiro;15479;7408;8071
27;Lugo;021;Xermade;3023;1500;1523
27;Lugo;025;Xove;3636;1815;1821
28;Madrid;001;Acebeda (La);54;27;27
28;Madrid;002;Ajalvir;1538;812;726
28;Madrid;003;Alameda del Valle;171;97;74
28;Madrid;004;Álamo (El);3448;1737;1711
28;Madrid;005;Alcalá de Henares;166250;83190;83060
28;Madrid;006;Alcobendas;83990;41758;42232
28;Madrid;007;Alcorcón;142165;70668;71497
28;Madrid;008;Aldea del Fresno;1238;638;600
28;Madrid;009;Algete;12063;6050;6013
28;Madrid;010;Alpedrete;4332;2182;2150
28;Madrid;011;Ambite;285;141;144
28;Madrid;012;Anchuelo;557;301;256
28;Madrid;013;Aranjuez;38906;18934;19972
28;Madrid;014;Arganda del Rey;28466;14199;14267
28;Madrid;015;Arroyomolinos;1783;908;875
28;Madrid;016;Atazar (El);92;55;37
28;Madrid;017;Batres;537;287;250
28;Madrid;018;Becerril de la Sierra;2385;1210;1175
28;Madrid;019;Belmonte de Tajo;1173;599;574
28;Madrid;021;Berrueco (El);302;168;134
28;Madrid;020;Berzosa del Lozoya;89;45;44
28;Madrid;022;Boadilla del Monte;18001;9116;8885
28;Madrid;023;Boalo (El);2075;1042;1033
28;Madrid;024;Braojos;140;76;64
28;Madrid;025;Brea de Tajo;486;255;231
28;Madrid;026;Brunete;2964;1493;1471
28;Madrid;027;Buitrago del Lozoya;1334;653;681
28;Madrid;028;Bustarviejo;1313;674;639
28;Madrid;029;Cabanillas de la Sierra;371;194;177
28;Madrid;030;Cabrera (La);1186;606;580
28;Madrid;031;Cadalso de los Vidrios;2154;1092;1062
28;Madrid;032;Camarma de Esteruelas;1868;941;927
28;Madrid;033;Campo Real;2281;1139;1142
28;Madrid;034;Canencia;444;231;213
28;Madrid;035;Carabaña;1120;575;545
28;Madrid;036;Casarrubuelos;590;310;280
28;Madrid;037;Cenicientos;1813;894;919
28;Madrid;038;Cercedilla;4572;2260;2312
28;Madrid;039;Cervera de Buitrago;92;50;42
28;Madrid;051;Chapinería;1057;553;504
28;Madrid;052;Chinchón;4118;2068;2050
28;Madrid;040;Ciempozuelos;11758;5995;5763
28;Madrid;041;Cobeña;1422;727;695
28;Madrid;046;Collado Mediano;3070;1591;1479
28;Madrid;047;Collado Villalba;33633;16891;16742
28;Madrid;043;Colmenar de Oreja;5364;2592;2772
28;Madrid;042;Colmenar del Arroyo;682;336;346
28;Madrid;045;Colmenar Viejo;27172;13540;13632
28;Madrid;044;Colmenarejo;2909;1521;1388
28;Madrid;048;Corpa;359;187;172
28;Madrid;049;Coslada;79240;39829;39411
28;Madrid;050;Cubas de la Sagra;1090;542;548
28;Madrid;053;Daganzo de Arriba;1950;990;960
28;Madrid;054;Escorial (El);8709;4415;4294
28;Madrid;055;Estremera;1102;578;524
28;Madrid;056;Fresnedillas de la Oliva;546;273;273
28;Madrid;057;Fresno de Torote;437;218;219
28;Madrid;058;Fuenlabrada;158212;80036;78176
28;Madrid;059;Fuente el Saz de Jarama;2973;1542;1431
28;Madrid;060;Fuentidueña de Tajo;1349;649;700
28;Madrid;061;Galapagar;13772;7081;6691
28;Madrid;062;Garganta de los Montes;321;159;162
28;Madrid;063;Gargantilla del Lozoya y Pinilla de Buitrago;212;123;89
28;Madrid;064;Gascones;110;53;57
28;Madrid;065;Getafe;144368;72066;72302
28;Madrid;066;Griñón;3357;1714;1643
28;Madrid;067;Guadalix de la Sierra;2152;1074;1078
28;Madrid;068;Guadarrama;7477;3721;3756
28;Madrid;069;Hiruela (La);54;32;22
28;Madrid;070;Horcajo de la Sierra;117;62;55
28;Madrid;071;Horcajuelo de la Sierra;83;40;43
28;Madrid;072;Hoyo de Manzanares;4273;2171;2102
28;Madrid;073;Humanes de Madrid;8803;4501;4302
28;Madrid;074;Leganés;178162;89289;88873
28;Madrid;075;Loeches;2446;1236;1210
28;Madrid;076;Lozoya;436;222;214
28;Madrid;901;Lozoyuela-Navas-Sieteiglesias;646;347;299
28;Madrid;078;Madarcos;30;15;15
28;Madrid;079;Madrid;3041101;1429923;1611178
28;Madrid;080;Majadahonda;37414;18296;19118
28;Madrid;082;Manzanares el Real;2751;1407;1344
28;Madrid;083;Meco;3917;2010;1907
28;Madrid;084;Mejorada del Campo;15072;7613;7459
28;Madrid;085;Miraflores de la Sierra;3143;1584;1559
28;Madrid;086;Molar (El);3293;1750;1543
28;Madrid;087;Molinos (Los);2767;1316;1451
28;Madrid;088;Montejo de la Sierra;268;131;137
28;Madrid;089;Moraleja de Enmedio;1777;881;896
28;Madrid;090;Moralzarzal;2901;1484;1417
28;Madrid;091;Morata de Tajuña;5264;2569;2695
28;Madrid;092;Móstoles;199141;99148;99993
28;Madrid;093;Navacerrada;1632;805;827
28;Madrid;094;Navalafuente;386;213;173
28;Madrid;095;Navalagamella;732;365;367
28;Madrid;096;Navalcarnero;11113;5696;5417
28;Madrid;097;Navarredonda y San Mamés;107;56;51
28;Madrid;099;Navas del Rey;1223;612;611
28;Madrid;100;Nuevo Baztán;1460;774;686
28;Madrid;101;Olmeda de las Fuentes;144;80;64
28;Madrid;102;Orusco de Tajuña;612;309;303
28;Madrid;104;Paracuellos de Jarama;5361;2802;2559
28;Madrid;106;Parla;72145;36273;35872
28;Madrid;107;Patones;348;175;173
28;Madrid;108;Pedrezuela;950;495;455
28;Madrid;109;Pelayos de la Presa;1113;539;574
28;Madrid;110;Perales de Tajuña;2056;997;1059
28;Madrid;111;Pezuela de las Torres;474;251;223
28;Madrid;112;Pinilla del Valle;169;92;77
28;Madrid;113;Pinto;24363;12147;12216
28;Madrid;114;Piñuécar-Gandullas;145;65;80
28;Madrid;115;Pozuelo de Alarcón;56149;27738;28411
28;Madrid;116;Pozuelo del Rey;236;120;116
28;Madrid;117;Prádena del Rincón;112;58;54
28;Madrid;118;Puebla de la Sierra;53;29;24
28;Madrid;902;Puentes Viejas;420;220;200
28;Madrid;119;Quijorna;745;393;352
28;Madrid;120;Rascafría;1401;733;668
28;Madrid;121;Redueña;142;68;74
28;Madrid;122;Ribatejada;295;147;148
28;Madrid;123;Rivas-Vaciamadrid;19535;9848;9687
28;Madrid;124;Robledillo de la Jara;68;35;33
28;Madrid;125;Robledo de Chavela;1985;976;1009
28;Madrid;126;Robregordo;93;47;46
28;Madrid;127;Rozas de Madrid (Las);44248;21823;22425
28;Madrid;128;Rozas de Puerto Real;334;177;157
28;Madrid;129;San Agustín del Guadalix;4224;2185;2039
28;Madrid;130;San Fernando de Henares;28314;14229;14085
28;Madrid;131;San Lorenzo de El Escorial;10276;4982;5294
28;Madrid;132;San Martín de la Vega;8089;4139;3950
28;Madrid;133;San Martín de Valdeiglesias;5713;2860;2853
28;Madrid;134;San Sebastián de los Reyes;56921;28582;28339
28;Madrid;135;Santa María de la Alameda;698;383;315
28;Madrid;136;Santorcaz;540;283;257
28;Madrid;137;Santos de la Humosa (Los);966;499;467
28;Madrid;138;Serna del Monte (La);93;48;45
28;Madrid;140;Serranillos del Valle;625;319;306
28;Madrid;141;Sevilla la Nueva;1922;995;927
28;Madrid;143;Somosierra;104;62;42
28;Madrid;144;Soto del Real;3245;1655;1590
28;Madrid;145;Talamanca de Jarama;1222;595;627
28;Madrid;146;Tielmes;2008;1024;984
28;Madrid;147;Titulcia;886;437;449
28;Madrid;148;Torrejón de Ardoz;87219;43846;43373
28;Madrid;149;Torrejón de la Calzada;2192;1106;1086
28;Madrid;150;Torrejón de Velasco;1574;814;760
28;Madrid;151;Torrelaguna;2624;1296;1328
28;Madrid;152;Torrelodones;9302;4617;4685
28;Madrid;153;Torremocha de Jarama;278;137;141
28;Madrid;154;Torres de la Alameda;3581;1797;1784
28;Madrid;903;Tres Cantos;22301;11078;11223
28;Madrid;155;Valdaracete;690;340;350
28;Madrid;156;Valdeavero;517;268;249
28;Madrid;157;Valdelaguna;538;287;251
28;Madrid;158;Valdemanco;501;264;237
28;Madrid;159;Valdemaqueda;525;255;270
28;Madrid;160;Valdemorillo;3696;1901;1795
28;Madrid;161;Valdemoro;20125;10133;9992
28;Madrid;162;Valdeolmos-Alalpardo;1397;739;658
28;Madrid;163;Valdepiélagos;329;165;164
28;Madrid;164;Valdetorres de Jarama;1376;707;669
28;Madrid;165;Valdilecha;1792;883;909
28;Madrid;166;Valverde de Alcalá;276;149;127
28;Madrid;167;Velilla de San Antonio;3342;1721;1621
28;Madrid;168;Vellón (El);958;488;470
28;Madrid;169;Venturada;426;216;210
28;Madrid;171;Villa del Prado;3543;1785;1758
28;Madrid;170;Villaconejos;2895;1479;1416
28;Madrid;172;Villalbilla;2681;1343;1338
28;Madrid;173;Villamanrique de Tajo;597;309;288
28;Madrid;174;Villamanta;1379;737;642
28;Madrid;175;Villamantilla;321;168;153
28;Madrid;176;Villanueva de la Cañada;6035;3033;3002
28;Madrid;178;Villanueva de Perales;401;223;178
28;Madrid;177;Villanueva del Pardillo;2417;1249;1168
28;Madrid;179;Villar del Olmo;730;374;356
28;Madrid;180;Villarejo de Salvanés;5195;2579;2616
28;Madrid;181;Villaviciosa de Odón;15954;7906;8048
28;Madrid;182;Villavieja del Lozoya;167;82;85
28;Madrid;183;Zarzalejo;922;476;446
29;Málaga;001;Alameda;4921;2468;2453
29;Málaga;002;Alcaucín;1427;711;716
29;Málaga;003;Alfarnate;1505;773;732
29;Málaga;004;Alfarnatejo;429;239;190
29;Málaga;005;Algarrobo;4761;2411;2350
29;Málaga;006;Algatocín;1014;520;494
29;Málaga;007;Alhaurín de la Torre;15423;7808;7615
29;Málaga;008;Alhaurín el Grande;18001;8881;9120
29;Málaga;009;Almáchar;2038;1048;990
29;Málaga;010;Almargen;2243;1141;1102
29;Málaga;011;Almogía;3951;2017;1934
29;Málaga;012;Álora;13248;6681;6567
29;Málaga;013;Alozaina;2551;1342;1209
29;Málaga;014;Alpandeire;317;168;149
29;Málaga;015;Antequera;39842;19513;20329
29;Málaga;016;Árchez;352;192;160
29;Málaga;017;Archidona;10340;5175;5165
29;Málaga;018;Ardales;3213;1623;1590
29;Málaga;019;Arenas;1267;676;591
29;Málaga;020;Arriate;3290;1627;1663
29;Málaga;021;Atajate;172;92;80
29;Málaga;022;Benadalid;272;147;125
29;Málaga;023;Benahavís;1628;816;812
29;Málaga;024;Benalauría;519;276;243
29;Málaga;025;Benalmádena;24706;12192;12514
29;Málaga;026;Benamargosa;1662;834;828
29;Málaga;027;Benamocarra;2816;1430;1386
29;Málaga;028;Benaoján;1666;823;843
29;Málaga;029;Benarrabá;672;339;333
29;Málaga;030;Borge (El);1071;559;512
29;Málaga;031;Burgo (El);2171;1112;1059
29;Málaga;032;Campillos;8046;4072;3974
29;Málaga;033;Canillas de Aceituno;2762;1400;1362
29;Málaga;034;Canillas de Albaida;656;338;318
29;Málaga;035;Cañete la Real;2343;1202;1141
29;Málaga;036;Carratraca;827;417;410
29;Málaga;037;Cartajima;346;182;164
29;Málaga;038;Cártama;11972;6027;5945
29;Málaga;039;Casabermeja;3185;1681;1504
29;Málaga;040;Casarabonela;2566;1329;1237
29;Málaga;041;Casares;3228;1678;1550
29;Málaga;042;Coín;18227;9220;9007
29;Málaga;043;Colmenar;3202;1567;1635
29;Málaga;044;Comares;1447;754;693
29;Málaga;045;Cómpeta;2482;1229;1253
29;Málaga;046;Cortes de la Frontera;3767;1889;1878
29;Málaga;047;Cuevas Bajas;1541;725;816
29;Málaga;049;Cuevas de San Marcos;4153;2067;2086
29;Málaga;048;Cuevas del Becerro;2025;1048;977
29;Málaga;050;Cútar;623;318;305
29;Málaga;051;Estepona;36221;18108;18113
29;Málaga;052;Faraján;320;166;154
29;Málaga;053;Frigiliana;2175;1063;1112
29;Málaga;054;Fuengirola;42605;20895;21710
29;Málaga;055;Fuente de Piedra;2041;1008;1033
29;Málaga;056;Gaucín;1760;920;840
29;Málaga;057;Genalguacil;675;356;319
29;Málaga;058;Guaro;1952;990;962
29;Málaga;059;Humilladero;2426;1225;1201
29;Málaga;060;Igualeja;1011;499;512
29;Málaga;061;Istán;1321;662;659
29;Málaga;062;Iznate;762;386;376
29;Málaga;063;Jimera de Líbar;453;227;226
29;Málaga;064;Jubrique;874;444;430
29;Málaga;065;Júzcar;252;144;108
29;Málaga;066;Macharaviaya;364;192;172
29;Málaga;067;Málaga;531443;256106;275337
29;Málaga;068;Manilva;5192;2657;2535
29;Málaga;069;Marbella;86013;42582;43431
29;Málaga;070;Mijas;34598;17061;17537
29;Málaga;071;Moclinejo;1098;558;540
29;Málaga;072;Mollina;3269;1606;1663
29;Málaga;073;Monda;1634;841;793
29;Málaga;074;Montejaque;1043;513;530
29;Málaga;075;Nerja;14816;7335;7481
29;Málaga;076;Ojén;1990;1031;959
29;Málaga;077;Parauta;301;155;146
29;Málaga;079;Periana;3485;1821;1664
29;Málaga;080;Pizarra;6572;3310;3262
29;Málaga;081;Pujerra;361;200;161
29;Málaga;082;Rincón de la Victoria;16116;8022;8094
29;Málaga;083;Riogordo;2665;1350;1315
29;Málaga;084;Ronda;34575;17035;17540
29;Málaga;085;Salares;234;121;113
29;Málaga;086;Sayalonga;1053;544;509
29;Málaga;087;Sedella;491;258;233
29;Málaga;088;Sierra de Yeguas;3205;1619;1586
29;Málaga;089;Teba;4451;2274;2177
29;Málaga;090;Tolox;2944;1503;1441
29;Málaga;901;Torremolinos;31798;15630;16168
29;Málaga;091;Torrox;10819;5478;5341
29;Málaga;092;Totalán;620;322;298
29;Málaga;093;Valle de Abdalajís;3090;1567;1523
29;Málaga;094;Vélez-Málaga;54327;27108;27219
29;Málaga;095;Villanueva de Algaidas;4296;2120;2176
29;Málaga;098;Villanueva de Tapia;1618;814;804
29;Málaga;096;Villanueva del Rosario;3264;1591;1673
29;Málaga;097;Villanueva del Trabuco;4613;2347;2266
29;Málaga;099;Viñuela;1173;590;583
29;Málaga;100;Yunquera;3206;1657;1549
30;Murcia;001;Abanilla;6323;3126;3197
30;Murcia;002;Abarán;12103;6002;6101
30;Murcia;003;Águilas;26007;13038;12969
30;Murcia;004;Albudeite;1410;701;709
30;Murcia;005;Alcantarilla;31854;15576;16278
30;Murcia;902;Alcázares (Los);4456;2181;2275
30;Murcia;006;Aledo;996;513;483
30;Murcia;007;Alguazas;7121;3541;3580
30;Murcia;008;Alhama de Murcia;14852;7360;7492
30;Murcia;009;Archena;14054;6978;7076
30;Murcia;010;Beniel;7680;3829;3851
30;Murcia;011;Blanca;5768;2816;2952
30;Murcia;012;Bullas;10405;5250;5155
30;Murcia;013;Calasparra;9007;4510;4497
30;Murcia;014;Campos del Río;2030;1007;1023
30;Murcia;015;Caravaca de la Cruz;21781;10816;10965
30;Murcia;016;Cartagena;179659;89121;90538
30;Murcia;017;Cehegín;14119;7050;7069
30;Murcia;018;Ceutí;6779;3395;3384
30;Murcia;019;Cieza;32165;15684;16481
30;Murcia;020;Fortuna;6295;3224;3071
30;Murcia;021;Fuente Álamo de Murcia;9080;4536;4544
30;Murcia;022;Jumilla;20834;10355;10479
30;Murcia;023;Librilla;3801;1860;1941
30;Murcia;024;Lorca;69355;34274;35081
30;Murcia;025;Lorquí;5520;2726;2794
30;Murcia;026;Mazarrón;15447;7754;7693
30;Murcia;027;Molina de Segura;41139;20302;20837
30;Murcia;028;Moratalla;8975;4550;4425
30;Murcia;029;Mula;13534;6735;6799
30;Murcia;030;Murcia;341531;166259;175272
30;Murcia;031;Ojós;628;316;312
30;Murcia;032;Pliego;3401;1733;1668
30;Murcia;033;Puerto Lumbreras;10411;5066;5345
30;Murcia;034;Ricote;1653;808;845
30;Murcia;035;San Javier;16816;8345;8471
30;Murcia;036;San Pedro del Pinatar;13597;6771;6826
30;Murcia;901;Santomera;9432;4697;4735
30;Murcia;037;Torre-Pacheco;18563;9448;9115
30;Murcia;038;Torres de Cotillas (Las);15002;7500;7502
30;Murcia;039;Totana;21246;10625;10621
30;Murcia;040;Ulea;1046;520;526
30;Murcia;041;Unión (La);14433;7159;7274
30;Murcia;042;Villanueva del Río Segura;1614;804;810
30;Murcia;043;Yecla;27729;13840;13889
31;Navarra;001;Abáigar;91;49;42
31;Navarra;002;Abárzuza;501;245;256
31;Navarra;003;Abaurregaina/Abaurrea Alta;206;119;87
31;Navarra;004;Abaurrepea/Abaurrea Baja;51;36;15
31;Navarra;005;Aberin;371;193;178
31;Navarra;006;Ablitas;2291;1177;1114
31;Navarra;007;Adiós;113;56;57
31;Navarra;008;Aguilar de Codés;119;64;55
31;Navarra;009;Aibar/Oibar;966;491;475
31;Navarra;011;Allín;825;430;395
31;Navarra;012;Allo;1114;545;569
31;Navarra;010;Altsasu/Alsasua;7110;3608;3502
31;Navarra;013;Améscoa Baja;849;442;407
31;Navarra;014;Ancín;294;151;143
31;Navarra;015;Andosilla;2518;1249;1269
31;Navarra;016;Ansoáin;5074;2551;2523
31;Navarra;017;Anue;462;266;196
31;Navarra;018;Añorbe;413;228;185
31;Navarra;019;Aoiz/Agoitz;1904;937;967
31;Navarra;020;Araitz;651;379;272
31;Navarra;025;Arakil;870;470;400
31;Navarra;021;Aranarache;104;52;52
31;Navarra;023;Aranguren;2074;1092;982
31;Navarra;024;Arano;183;97;86
31;Navarra;022;Arantza;730;404;326
31;Navarra;026;Aras;230;116;114
31;Navarra;027;Arbizu;901;474;427
31;Navarra;028;Arce/Artzi;286;159;127
31;Navarra;029;Arcos (Los);1394;706;688
31;Navarra;030;Arellano;218;120;98
31;Navarra;031;Areso;292;153;139
31;Navarra;032;Arguedas;2283;1134;1149
31;Navarra;033;Aria;75;47;28
31;Navarra;034;Aribe;77;38;39
31;Navarra;035;Armañanzas;108;53;55
31;Navarra;036;Arróniz;1232;664;568
31;Navarra;037;Arruazu;126;64;62
31;Navarra;038;Artajona;1685;882;803
31;Navarra;039;Artazu;100;51;49
31;Navarra;040;Atez;250;150;100
31;Navarra;058;Auritz/Burguete;300;135;165
31;Navarra;041;Ayegui;807;416;391
31;Navarra;042;Azagra;3467;1729;1738
31;Navarra;043;Azuelo;73;35;38
31;Navarra;044;Bakaiku;356;201;155
31;Navarra;901;Barañain;18946;9409;9537
31;Navarra;045;Barásoain;441;220;221
31;Navarra;046;Barbarin;116;53;63
31;Navarra;047;Bargota;405;207;198
31;Navarra;048;Barillas;213;99;114
31;Navarra;049;Basaburua;747;423;324
31;Navarra;050;Baztan;8053;4085;3968
31;Navarra;137;Beintza-Labaien;311;178;133
31;Navarra;051;Beire;343;165;178
31;Navarra;052;Belascoáin;90;47;43
31;Navarra;250;Bera/Vera de Bidasoa;3551;1827;1724
31;Navarra;053;Berbinzana;739;373;366
31;Navarra;905;Beriáin;2246;1131;1115
31;Navarra;902;Berrioplano;925;469;456
31;Navarra;903;Berriozar;5472;2805;2667
31;Navarra;054;Bertizarana;676;335;341
31;Navarra;055;Betelu;352;194;158
31;Navarra;253;Bidaurreta;98;59;39
31;Navarra;056;Biurrun-Olcoz;176;94;82
31;Navarra;057;Buñuel;2426;1179;1247
31;Navarra;059;Burgui/Burgi;255;143;112
31;Navarra;060;Burlada/Burlata;15690;7843;7847
31;Navarra;061;Busto (El);115;57;58
31;Navarra;062;Cabanillas;1446;738;708
31;Navarra;063;Cabredo;147;74;73
31;Navarra;064;Cadreita;1890;922;968
31;Navarra;065;Caparroso;2344;1130;1214
31;Navarra;066;Cárcar;1288;642;646
31;Navarra;067;Carcastillo;2633;1323;1310
31;Navarra;068;Cascante;3519;1718;1801
31;Navarra;069;Cáseda;1093;537;556
31;Navarra;070;Castejón;3235;1636;1599
31;Navarra;071;Castillonuevo;24;15;9
31;Navarra;072;Cintruénigo;5432;2714;2718
31;Navarra;074;Cirauqui;480;266;214
31;Navarra;075;Ciriza;60;25;35
31;Navarra;076;Cizur;1060;550;510
31;Navarra;077;Corella;6389;3220;3169
31;Navarra;078;Cortes;3224;1635;1589
31;Navarra;079;Desojo;166;91;75
31;Navarra;080;Dicastillo;755;404;351
31;Navarra;081;Donamaria;369;187;182
31;Navarra;221;Doneztebe/Santesteban;1237;615;622
31;Navarra;083;Echarri;65;34;31
31;Navarra;086;Egüés;2354;1175;1179
31;Navarra;087;Elgorriaga;191;94;97
31;Navarra;089;Enériz;195;98;97
31;Navarra;090;Eratsun;195;118;77
31;Navarra;091;Ergoiena;506;285;221
31;Navarra;092;Erro;797;437;360
31;Navarra;094;Eslava;211;105;106
31;Navarra;095;Esparza de Salazar;123;64;59
31;Navarra;096;Espronceda;201;119;82
31;Navarra;097;Estella/Lizarra;12861;6233;6628
31;Navarra;098;Esteribar;1446;781;665
31;Navarra;099;Etayo;100;53;47
31;Navarra;082;Etxalar;882;453;429
31;Navarra;084;Etxarri-Aranatz;2369;1214;1155
31;Navarra;085;Etxauri;411;210;201
31;Navarra;100;Eulate;406;207;199
31;Navarra;101;Ezcabarte;1019;543;476
31;Navarra;093;Ezcároz/Ezkaroze;361;195;166
31;Navarra;102;Ezkurra;265;162;103
31;Navarra;103;Ezprogui;69;34;35
31;Navarra;104;Falces;2710;1332;1378
31;Navarra;105;Fitero;2142;1072;1070
31;Navarra;106;Fontellas;554;283;271
31;Navarra;107;Funes;2122;1071;1051
31;Navarra;108;Fustiñana;2314;1177;1137
31;Navarra;109;Galar;1026;545;481
31;Navarra;110;Gallipienzo;191;108;83
31;Navarra;111;Gallués/Galoze;123;80;43
31;Navarra;112;Garaioa;144;77;67
31;Navarra;113;Garde;217;116;101
31;Navarra;114;Garínoain;298;156;142
31;Navarra;115;Garralda;241;124;117
31;Navarra;116;Genevilla;134;67;67
31;Navarra;117;Goizueta;1008;546;462
31;Navarra;118;Goñi;208;116;92
31;Navarra;119;Güesa/Gorza;84;45;39
31;Navarra;120;Guesálaz;497;276;221
31;Navarra;121;Guirguillano;91;49;42
31;Navarra;256;Hiriberri/Villanueva de Aezkoa;170;88;82
31;Navarra;122;Huarte/Uharte;2821;1418;1403
31;Navarra;124;Ibargoiti;212;128;84
31;Navarra;259;Igantzi;618;327;291
31;Navarra;125;Igúzquiza;356;177;179
31;Navarra;126;Imotz;426;229;197
31;Navarra;127;Irañeta;159;89;70
31;Navarra;904;Irurtzun;2054;1069;985
31;Navarra;128;Isaba/Izaba;576;290;286
31;Navarra;129;Ituren;483;243;240
31;Navarra;130;Iturmendi;356;185;171
31;Navarra;131;Iza;622;329;293
31;Navarra;132;Izagaondoa;208;122;86
31;Navarra;133;Izalzu/Itzaltzu;54;29;25
31;Navarra;134;Jaurrieta;302;156;146
31;Navarra;135;Javier;157;64;93
31;Navarra;136;Juslapeña;450;245;205
31;Navarra;138;Lakuntza;992;525;467
31;Navarra;139;Lana;224;124;100
31;Navarra;140;Lantz;127;80;47
31;Navarra;141;Lapoblación;191;104;87
31;Navarra;142;Larraga;1919;1008;911
31;Navarra;143;Larraona;183;92;91
31;Navarra;144;Larraun;1952;1046;906
31;Navarra;145;Lazagurría;245;129;116
31;Navarra;146;Leache;62;34;28
31;Navarra;147;Legarda;79;44;35
31;Navarra;148;Legaria;164;87;77
31;Navarra;149;Leitza;3140;1629;1511
31;Navarra;908;Lekunberri;"";"";""
31;Navarra;150;Leoz;220;128;92
31;Navarra;151;Lerga;102;52;50
31;Navarra;152;Lerín;2029;1005;1024
31;Navarra;153;Lesaka;2750;1449;1301
31;Navarra;154;Lezáun;281;159;122
31;Navarra;155;Liédena;331;157;174
31;Navarra;156;Lizoáin;250;137;113
31;Navarra;157;Lodosa;4664;2365;2299
31;Navarra;158;Lónguida/Longida;311;167;144
31;Navarra;159;Lumbier;1513;824;689
31;Navarra;160;Luquin;138;75;63
31;Navarra;248;Luzaide/Valcarlos;531;260;271
31;Navarra;161;Mañeru;361;182;179
31;Navarra;162;Marañón;87;44;43
31;Navarra;163;Marcilla;2393;1192;1201
31;Navarra;164;Mélida;884;449;435
31;Navarra;165;Mendavia;3597;1801;1796
31;Navarra;166;Mendaza;429;201;228
31;Navarra;167;Mendigorría;967;500;467
31;Navarra;168;Metauten;326;167;159
31;Navarra;169;Milagro;2604;1284;1320
31;Navarra;170;Mirafuentes;51;24;27
31;Navarra;171;Miranda de Arga;962;475;487
31;Navarra;172;Monreal;303;154;149
31;Navarra;173;Monteagudo;1171;580;591
31;Navarra;174;Morentin;136;67;69
31;Navarra;175;Mues;126;65;61
31;Navarra;176;Murchante;2945;1454;1491
31;Navarra;177;Murieta;326;193;133
31;Navarra;178;Murillo el Cuende;664;352;312
31;Navarra;179;Murillo el Fruto;829;422;407
31;Navarra;180;Muruzábal;195;104;91
31;Navarra;181;Navascués;255;154;101
31;Navarra;182;Nazar;54;31;23
31;Navarra;088;Noáin (Valle de Elorz)/Noain (Elortzibar);3849;1933;1916
31;Navarra;183;Obanos;749;365;384
31;Navarra;185;Ochagavía;690;364;326
31;Navarra;184;Oco;94;57;37
31;Navarra;186;Odieta;330;184;146
31;Navarra;187;Oitz;172;107;65
31;Navarra;188;Olaibar;176;96;80
31;Navarra;189;Olazti/Olazagutía;1728;900;828
31;Navarra;190;Olejua;65;34;31
31;Navarra;191;Olite;3103;1555;1548
31;Navarra;194;Ollo;360;208;152
31;Navarra;192;Olóriz;177;100;77
31;Navarra;193;Olza;1257;647;610
31;Navarra;195;Orbaitzeta;257;141;116
31;Navarra;196;Orbara;65;34;31
31;Navarra;906;Orcoyen;1213;689;524
31;Navarra;197;Orísoain;107;56;51
31;Navarra;198;Oronz;53;29;24
31;Navarra;199;Oroz-Betelu;240;133;107
31;Navarra;211;Orreaga/Roncesvalles;32;18;14
31;Navarra;200;Oteiza;935;481;454
31;Navarra;201;Pamplona/Iruña;182465;87624;94841
31;Navarra;202;Peralta;4649;2286;2363
31;Navarra;203;Petilla de Aragón;55;28;27
31;Navarra;204;Piedramillera;84;48;36
31;Navarra;205;Pitillas;647;330;317
31;Navarra;206;Puente la Reina/Gares;2200;1091;1109
31;Navarra;207;Pueyo;331;170;161
31;Navarra;208;Ribaforada;3142;1617;1525
31;Navarra;209;Romanzado;157;86;71
31;Navarra;210;Roncal/Erronkari;361;181;180
31;Navarra;212;Sada;282;154;128
31;Navarra;213;Saldías;165;90;75
31;Navarra;214;Salinas de Oro;104;60;44
31;Navarra;215;San Adrián;5255;2566;2689
31;Navarra;217;San Martín de Unx;519;278;241
31;Navarra;216;Sangüesa/Zangoza;4686;2409;2277
31;Navarra;219;Sansol;144;74;70
31;Navarra;220;Santacara;1098;558;540
31;Navarra;222;Sarriés/Sartze;99;55;44
31;Navarra;223;Sartaguda;1421;710;711
31;Navarra;224;Sesma;1433;702;731
31;Navarra;225;Sorlada;63;31;32
31;Navarra;226;Sunbilla;706;362;344
31;Navarra;227;Tafalla;10329;5075;5254
31;Navarra;228;Tiebas-Muruarte de Reta;606;325;281
31;Navarra;229;Tirapu;67;36;31
31;Navarra;230;Torralba del Río;162;87;75
31;Navarra;231;Torres del Río;205;101;104
31;Navarra;232;Tudela;27303;13370;13933
31;Navarra;233;Tulebras;116;45;71
31;Navarra;234;Ucar;115;62;53
31;Navarra;123;Uharte-Arakil;840;446;394
31;Navarra;235;Ujué;276;149;127
31;Navarra;236;Ultzama;1657;851;806
31;Navarra;237;Unciti;258;147;111
31;Navarra;238;Unzué;142;78;64
31;Navarra;239;Urdazubi/Urdax;445;220;225
31;Navarra;240;Urdiain;683;360;323
31;Navarra;241;Urraul Alto;152;87;65
31;Navarra;242;Urraul Bajo;276;128;148
31;Navarra;244;Urrotz;207;114;93
31;Navarra;243;Urroz;370;186;184
31;Navarra;245;Urzainqui;118;64;54
31;Navarra;246;Uterga;137;63;74
31;Navarra;247;Uztárroz/Uztarroze;316;154;162
31;Navarra;249;Valtierra;2500;1242;1258
31;Navarra;251;Viana;3497;1779;1718
31;Navarra;252;Vidángoz/Bidankoze;115;57;58
31;Navarra;254;Villafranca;2555;1230;1325
31;Navarra;255;Villamayor de Monjardín;118;66;52
31;Navarra;257;Villatuerta;794;395;399
31;Navarra;258;Villava/Atarrabia;8458;4279;4179
31;Navarra;260;Yerri;1552;828;724
31;Navarra;261;Yesa;300;172;128
31;Navarra;262;Zabalza;139;65;74
31;Navarra;073;Ziordia;399;188;211
31;Navarra;907;Zizur Mayor/Zizur Nagusia;6649;3337;3312
31;Navarra;263;Zubieta;334;198;136
31;Navarra;264;Zugarramurdi;262;138;124
31;Navarra;265;Zúñiga;127;66;61
32;Ourense;001;Allariz;5422;2582;2840
32;Ourense;002;Amoeiro;2366;1143;1223
32;Ourense;003;Arnoia (A);1093;519;574
32;Ourense;004;Avión;3556;1620;1936
32;Ourense;005;Baltar;1835;902;933
32;Ourense;006;Bande;2910;1388;1522
32;Ourense;007;Baños de Molgas;3120;1538;1582
32;Ourense;008;Barbadás;4334;2115;2219
32;Ourense;009;Barco de Valdeorras (O);11486;5710;5776
32;Ourense;010;Beade;895;445;450
32;Ourense;011;Beariz;1867;845;1022
32;Ourense;012;Blancos (Os);1292;654;638
32;Ourense;013;Boborás;3910;1778;2132
32;Ourense;014;Bola (A);1716;806;910
32;Ourense;015;Bolo (O);1830;915;915
32;Ourense;016;Calvos de Randín;1970;1001;969
32;Ourense;018;Carballeda de Avia;1892;899;993
32;Ourense;017;Carballeda de Valdeorras;2696;1373;1323
32;Ourense;019;Carballiño (O);11993;5647;6346
32;Ourense;020;Cartelle;4292;2080;2212
32;Ourense;022;Castrelo de Miño;3589;1757;1832
32;Ourense;021;Castrelo do Val;1465;720;745
32;Ourense;023;Castro Caldelas;2151;1101;1050
32;Ourense;024;Celanova;6215;2944;3271
32;Ourense;025;Cenlle;1976;916;1060
32;Ourense;029;Chandrexa de Queixa;1035;553;482
32;Ourense;026;Coles;3321;1620;1701
32;Ourense;027;Cortegada;1617;770;847
32;Ourense;028;Cualedro;2708;1380;1328
32;Ourense;030;Entrimo;1718;775;943
32;Ourense;031;Esgos;1492;712;780
32;Ourense;033;Gomesende;1378;644;734
32;Ourense;034;Gudiña (A);2020;1015;1005
32;Ourense;035;Irixo (O);2539;1167;1372
32;Ourense;038;Larouco;693;326;367
32;Ourense;039;Laza;2312;1148;1164
32;Ourense;040;Leiro;2201;1064;1137
32;Ourense;041;Lobeira;1467;716;751
32;Ourense;042;Lobios;3172;1517;1655
32;Ourense;043;Maceda;3476;1672;1804
32;Ourense;044;Manzaneda;1607;814;793
32;Ourense;045;Maside;3604;1672;1932
32;Ourense;046;Melón;1750;764;986
32;Ourense;047;Merca (A);2739;1308;1431
32;Ourense;048;Mezquita (A);1864;939;925
32;Ourense;049;Montederramo;1494;770;724
32;Ourense;050;Monterrei;3733;1877;1856
32;Ourense;051;Muíños;2357;1155;1202
32;Ourense;052;Nogueira de Ramuín;2839;1338;1501
32;Ourense;053;Oímbra;2115;1051;1064
32;Ourense;054;Ourense;108547;51321;57226
32;Ourense;055;Paderne de Allariz;1826;853;973
32;Ourense;056;Padrenda;2949;1413;1536
32;Ourense;057;Parada de Sil;1090;530;560
32;Ourense;058;Pereiro de Aguiar (O);4822;2335;2487
32;Ourense;059;Peroxa (A);2878;1361;1517
32;Ourense;060;Petín;1300;621;679
32;Ourense;061;Piñor;1786;901;885
32;Ourense;063;Pobra de Trives (A);3140;1543;1597
32;Ourense;064;Pontedeva;834;400;434
32;Ourense;062;Porqueira;1295;639;656
32;Ourense;065;Punxín;1057;493;564
32;Ourense;066;Quintela de Leirado;1071;491;580
32;Ourense;067;Rairiz de Veiga;2326;1152;1174
32;Ourense;068;Ramirás;2164;990;1174
32;Ourense;069;Ribadavia;6086;2913;3173
32;Ourense;071;Riós;2521;1264;1257
32;Ourense;072;Rúa (A);5164;2569;2595
32;Ourense;073;Rubiá;2142;1072;1070
32;Ourense;074;San Amaro;1701;827;874
32;Ourense;075;San Cibrao das Viñas;3515;1697;1818
32;Ourense;076;San Cristovo de Cea;3731;1824;1907
32;Ourense;070;San Xoán de Río;1241;599;642
32;Ourense;077;Sandiás;1949;917;1032
32;Ourense;078;Sarreaus;2659;1314;1345
32;Ourense;079;Taboadela;1902;931;971
32;Ourense;080;Teixeira (A);717;346;371
32;Ourense;081;Toén;2769;1383;1386
32;Ourense;082;Trasmiras;2298;1134;1164
32;Ourense;083;Veiga (A);1664;837;827
32;Ourense;084;Verea;1768;841;927
32;Ourense;085;Verín;11909;5768;6141
32;Ourense;086;Viana do Bolo;4630;2357;2273
32;Ourense;087;Vilamarín;2337;1143;1194
32;Ourense;088;Vilamartín de Valdeorras;2536;1257;1279
32;Ourense;089;Vilar de Barrio;2636;1319;1317
32;Ourense;090;Vilar de Santos;1437;719;718
32;Ourense;091;Vilardevós;3275;1656;1619
32;Ourense;092;Vilariño de Conso;929;511;418
32;Ourense;032;Xinzo de Limia;9566;4666;4900
32;Ourense;036;Xunqueira de Ambía;2313;1130;1183
32;Ourense;037;Xunqueira de Espadanedo;1230;582;648
33;Asturias;001;Allande;2766;1426;1340
33;Asturias;002;Aller;17256;8537;8719
33;Asturias;003;Amieva;1020;535;485
33;Asturias;004;Avilés;88570;42932;45638
33;Asturias;005;Belmonte de Miranda;2741;1408;1333
33;Asturias;006;Bimenes;2490;1181;1309
33;Asturias;007;Boal;2898;1441;1457
33;Asturias;008;Cabrales;2486;1269;1217
33;Asturias;009;Cabranes;1442;697;745
33;Asturias;010;Candamo;2830;1382;1448
33;Asturias;012;Cangas de Onís;6480;3185;3295
33;Asturias;011;Cangas del Narcea;18929;9680;9249
33;Asturias;013;Caravia;585;300;285
33;Asturias;014;Carreño;11150;5410;5740
33;Asturias;015;Caso;2072;1075;997
33;Asturias;016;Castrillón;22401;10880;11521
33;Asturias;017;Castropol;5048;2443;2605
33;Asturias;018;Coaña;3994;1919;2075
33;Asturias;019;Colunga;5079;2478;2601
33;Asturias;020;Corvera de Asturias;17358;8626;8732
33;Asturias;021;Cudillero;6557;3251;3306
33;Asturias;022;Degaña;1687;889;798
33;Asturias;023;Franco (El);4301;2100;2201
33;Asturias;024;Gijón;269644;128735;140909
33;Asturias;025;Gozón;11744;5694;6050
33;Asturias;026;Grado;12256;5920;6336
33;Asturias;027;Grandas de Salime;1470;757;713
33;Asturias;028;Ibias;2478;1331;1147
33;Asturias;029;Illano;750;380;370
33;Asturias;030;Illas;1291;666;625
33;Asturias;031;Langreo;52023;24931;27092
33;Asturias;032;Laviana;15496;7573;7923
33;Asturias;033;Lena;14631;7189;7442
33;Asturias;035;Llanera;10998;5411;5587
33;Asturias;036;Llanes;14651;7023;7628
33;Asturias;037;Mieres;53331;25795;27536
33;Asturias;038;Morcín;3084;1529;1555
33;Asturias;039;Muros de Nalón;2596;1224;1372
33;Asturias;040;Nava;5808;2848;2960
33;Asturias;041;Navia;9183;4408;4775
33;Asturias;042;Noreña;4235;2003;2232
33;Asturias;043;Onís;1063;532;531
33;Asturias;044;Oviedo;201712;94624;107088
33;Asturias;045;Parres;5781;2838;2943
33;Asturias;046;Peñamellera Alta;899;447;452
33;Asturias;047;Peñamellera Baja;1754;863;891
33;Asturias;048;Pesoz;326;160;166
33;Asturias;049;Piloña;9702;4700;5002
33;Asturias;050;Ponga;861;485;376
33;Asturias;051;Pravia;10054;4851;5203
33;Asturias;052;Proaza;1008;498;510
33;Asturias;053;Quirós;1803;944;859
33;Asturias;054;Regueras (Las);2401;1185;1216
33;Asturias;055;Ribadedeva;2049;989;1060
33;Asturias;056;Ribadesella;6481;3099;3382
33;Asturias;057;Ribera de Arriba;2229;1108;1121
33;Asturias;058;Riosa;2790;1454;1336
33;Asturias;059;Salas;7800;3854;3946
33;Asturias;061;San Martín de Oscos;609;325;284
33;Asturias;060;San Martín del Rey Aurelio;23519;11389;12130
33;Asturias;063;San Tirso de Abres;700;346;354
33;Asturias;062;Santa Eulalia de Oscos;651;336;315
33;Asturias;064;Santo Adriano;389;188;201
33;Asturias;065;Sariego;1524;761;763
33;Asturias;066;Siero;46232;22456;23776
33;Asturias;067;Sobrescobio;815;421;394
33;Asturias;068;Somiedo;1788;934;854
33;Asturias;069;Soto del Barco;4630;2220;2410
33;Asturias;070;Tapia de Casariego;4538;2170;2368
33;Asturias;071;Taramundi;1018;497;521
33;Asturias;072;Teverga;2528;1299;1229
33;Asturias;073;Tineo;14650;7417;7233
33;Asturias;034;Valdés;16767;8223;8544
33;Asturias;074;Vegadeo;5118;2438;2680
33;Asturias;075;Villanueva de Oscos;466;240;226
33;Asturias;076;Villaviciosa;14910;7344;7566
33;Asturias;077;Villayón;2196;1130;1066
33;Asturias;078;Yernes y Tameza;192;95;97
34;Palencia;001;Abarca de Campos;52;24;28
34;Palencia;003;Abia de las Torres;237;123;114
34;Palencia;004;Aguilar de Campoo;7860;3859;4001
34;Palencia;005;Alar del Rey;1536;721;815
34;Palencia;006;Alba de Cerrato;130;62;68
34;Palencia;009;Amayuelas de Arriba;55;32;23
34;Palencia;010;Ampudia;829;429;400
34;Palencia;011;Amusco;630;341;289
34;Palencia;012;Antigüedad;464;249;215
34;Palencia;015;Arconada;95;48;47
34;Palencia;017;Astudillo;1427;751;676
34;Palencia;018;Autilla del Pino;305;160;145
34;Palencia;019;Autillo de Campos;222;102;120
34;Palencia;020;Ayuela;103;59;44
34;Palencia;022;Baltanás;1647;851;796
34;Palencia;024;Baquerín de Campos;40;26;14
34;Palencia;025;Bárcena de Campos;65;28;37
34;Palencia;027;Barruelo de Santullán;2154;1019;1135
34;Palencia;028;Báscones de Ojeda;209;105;104
34;Palencia;029;Becerril de Campos;1236;601;635
34;Palencia;031;Belmonte de Campos;54;27;27
34;Palencia;032;Berzosilla;82;40;42
34;Palencia;033;Boada de Campos;27;13;14
34;Palencia;035;Boadilla de Rioseco;220;111;109
34;Palencia;034;Boadilla del Camino;226;119;107
34;Palencia;036;Brañosera;310;158;152
34;Palencia;037;Buenavista de Valdavia;472;232;240
34;Palencia;038;Bustillo de la Vega;398;211;187
34;Palencia;039;Bustillo del Páramo de Carrión;114;61;53
34;Palencia;041;Calahorra de Boedo;161;80;81
34;Palencia;042;Calzada de los Molinos;411;219;192
34;Palencia;045;Capillas;150;70;80
34;Palencia;046;Cardeñosa de Volpejera;54;24;30
34;Palencia;047;Carrión de los Condes;2539;1208;1331
34;Palencia;048;Castil de Vela;127;60;67
34;Palencia;049;Castrejón de la Peña;731;394;337
34;Palencia;050;Castrillo de Don Juan;380;211;169
34;Palencia;051;Castrillo de Onielo;206;107;99
34;Palencia;052;Castrillo de Villavega;332;165;167
34;Palencia;053;Castromocho;295;153;142
34;Palencia;055;Cervatos de la Cueza;424;217;207
34;Palencia;056;Cervera de Pisuerga;2872;1442;1430
34;Palencia;057;Cevico de la Torre;711;337;374
34;Palencia;058;Cevico Navero;322;168;154
34;Palencia;059;Cisneros;679;333;346
34;Palencia;060;Cobos de Cerrato;260;132;128
34;Palencia;061;Collazos de Boedo;181;98;83
34;Palencia;062;Congosto de Valdavia;307;167;140
34;Palencia;063;Cordovilla la Real;167;96;71
34;Palencia;066;Cubillas de Cerrato;123;62;61
34;Palencia;067;Dehesa de Montejo;358;206;152
34;Palencia;068;Dehesa de Romanos;66;35;31
34;Palencia;069;Dueñas;3104;1601;1503
34;Palencia;070;Espinosa de Cerrato;301;156;145
34;Palencia;071;Espinosa de Villagonzalo;317;155;162
34;Palencia;072;Frechilla;299;139;160
34;Palencia;073;Fresno del Río;219;116;103
34;Palencia;074;Frómista;1071;545;526
34;Palencia;076;Fuentes de Nava;885;430;455
34;Palencia;077;Fuentes de Valdepero;257;134;123
34;Palencia;079;Grijota;831;412;419
34;Palencia;080;Guardo;9321;4756;4565
34;Palencia;081;Guaza de Campos;100;50;50
34;Palencia;082;Hérmedes de Cerrato;170;78;92
34;Palencia;083;Herrera de Pisuerga;2848;1422;1426
34;Palencia;084;Herrera de Valdecañas;201;98;103
34;Palencia;086;Hontoria de Cerrato;132;66;66
34;Palencia;087;Hornillos de Cerrato;174;82;92
34;Palencia;088;Husillos;230;121;109
34;Palencia;089;Itero de la Vega;273;145;128
34;Palencia;091;Lagartos;192;103;89
34;Palencia;092;Lantadilla;622;300;322
34;Palencia;094;Ledigos;125;62;63
34;Palencia;903;Loma de Ucieza;381;200;181
34;Palencia;096;Lomas;70;34;36
34;Palencia;098;Magaz de Pisuerga;740;378;362
34;Palencia;099;Manquillos;90;49;41
34;Palencia;100;Mantinos;224;118;106
34;Palencia;101;Marcilla de Campos;81;35;46
34;Palencia;102;Mazariegos;293;157;136
34;Palencia;103;Mazuecos de Valdeginate;160;80;80
34;Palencia;104;Melgar de Yuso;464;249;215
34;Palencia;106;Meneses de Campos;177;97;80
34;Palencia;107;Micieces de Ojeda;132;67;65
34;Palencia;108;Monzón de Campos;894;463;431
34;Palencia;109;Moratinos;97;49;48
34;Palencia;110;Mudá;164;84;80
34;Palencia;112;Nogal de las Huertas;93;55;38
34;Palencia;113;Olea de Boedo;52;23;29
34;Palencia;114;Olmos de Ojeda;447;240;207
34;Palencia;116;Osornillo;112;58;54
34;Palencia;901;Osorno la Mayor;1894;987;907
34;Palencia;120;Palencia;79561;38248;41313
34;Palencia;121;Palenzuela;372;201;171
34;Palencia;122;Páramo de Boedo;134;66;68
34;Palencia;123;Paredes de Nava;2613;1296;1317
34;Palencia;124;Payo de Ojeda;106;56;50
34;Palencia;125;Pedraza de Campos;166;88;78
34;Palencia;126;Pedrosa de la Vega;419;228;191
34;Palencia;127;Perales;162;82;80
34;Palencia;904;Pernía (La);524;280;244
34;Palencia;129;Pino del Río;281;159;122
34;Palencia;130;Piña de Campos;350;189;161
34;Palencia;131;Población de Arroyo;101;57;44
34;Palencia;132;Población de Campos;244;132;112
34;Palencia;133;Población de Cerrato;140;75;65
34;Palencia;134;Polentinos;131;67;64
34;Palencia;135;Pomar de Valdivia;619;307;312
34;Palencia;136;Poza de la Vega;303;172;131
34;Palencia;137;Pozo de Urama;49;26;23
34;Palencia;139;Prádanos de Ojeda;258;130;128
34;Palencia;140;Puebla de Valdavia (La);190;96;94
34;Palencia;141;Quintana del Puente;312;154;158
34;Palencia;143;Quintanilla de Onsoña;294;164;130
34;Palencia;146;Reinoso de Cerrato;97;55;42
34;Palencia;147;Renedo de la Vega;307;170;137
34;Palencia;149;Requena de Campos;57;29;28
34;Palencia;151;Respenda de la Peña;325;172;153
34;Palencia;152;Revenga de Campos;215;103;112
34;Palencia;154;Revilla de Collazos;105;58;47
34;Palencia;155;Ribas de Campos;243;129;114
34;Palencia;156;Riberos de la Cueza;92;48;44
34;Palencia;157;Saldaña;3182;1647;1535
34;Palencia;158;Salinas de Pisuerga;295;159;136
34;Palencia;159;San Cebrián de Campos;538;298;240
34;Palencia;160;San Cebrián de Mudá;255;128;127
34;Palencia;161;San Cristóbal de Boedo;57;33;24
34;Palencia;163;San Mamés de Campos;138;62;76
34;Palencia;165;San Román de la Cuba;153;78;75
34;Palencia;167;Santa Cecilia del Alcor;185;99;86
34;Palencia;168;Santa Cruz de Boedo;89;46;43
34;Palencia;169;Santervás de la Vega;619;334;285
34;Palencia;170;Santibáñez de Ecla;112;47;65
34;Palencia;171;Santibáñez de la Peña;1804;904;900
34;Palencia;174;Santoyo;336;163;173
34;Palencia;175;Serna (La);152;88;64
34;Palencia;177;Soto de Cerrato;232;116;116
34;Palencia;176;Sotobañado y Priorato;205;107;98
34;Palencia;178;Tabanera de Cerrato;203;102;101
34;Palencia;179;Tabanera de Valdavia;60;27;33
34;Palencia;180;Támara de Campos;100;49;51
34;Palencia;181;Tariego de Cerrato;568;294;274
34;Palencia;182;Torquemada;1337;668;669
34;Palencia;184;Torremormojón;109;53;56
34;Palencia;185;Triollo;128;72;56
34;Palencia;186;Valbuena de Pisuerga;88;49;39
34;Palencia;189;Valdeolmillos;98;46;52
34;Palencia;190;Valderrábano;115;63;52
34;Palencia;192;Valde-Ucieza;149;82;67
34;Palencia;196;Valle de Cerrato;151;81;70
34;Palencia;902;Valle del Retortillo;275;135;140
34;Palencia;199;Velilla del Río Carrión;2064;1061;1003
34;Palencia;023;Venta de Baños;6993;3479;3514
34;Palencia;201;Vertavillo;273;149;124
34;Palencia;093;Vid de Ojeda (La);159;93;66
34;Palencia;202;Villabasta de Valdavia;49;22;27
34;Palencia;204;Villacidaler;92;47;45
34;Palencia;205;Villaconancio;95;48;47
34;Palencia;206;Villada;1418;695;723
34;Palencia;208;Villaeles de Valdavia;100;55;45
34;Palencia;210;Villahán;161;90;71
34;Palencia;211;Villaherreros;329;153;176
34;Palencia;213;Villalaco;90;39;51
34;Palencia;214;Villalba de Guardo;231;124;107
34;Palencia;215;Villalcázar de Sirga;251;118;133
34;Palencia;216;Villalcón;105;52;53
34;Palencia;217;Villalobón;271;140;131
34;Palencia;218;Villaluenga de la Vega;746;423;323
34;Palencia;220;Villamartín de Campos;175;94;81
34;Palencia;221;Villamediana;293;149;144
34;Palencia;222;Villameriel;185;95;90
34;Palencia;223;Villamoronta;355;188;167
34;Palencia;224;Villamuera de la Cueza;94;54;40
34;Palencia;225;Villamuriel de Cerrato;4165;2114;2051
34;Palencia;227;Villanueva del Rebollar;125;63;62
34;Palencia;228;Villanuño de Valdavia;144;79;65
34;Palencia;229;Villaprovedo;118;71;47
34;Palencia;230;Villarmentero de Campos;23;11;12
34;Palencia;231;Villarrabé;304;155;149
34;Palencia;232;Villarramiel;1209;605;604
34;Palencia;233;Villasarracino;348;174;174
34;Palencia;234;Villasila de Valdavia;125;65;60
34;Palencia;236;Villaturde;310;156;154
34;Palencia;237;Villaumbrales;945;499;446
34;Palencia;238;Villaviudas;489;238;251
34;Palencia;240;Villerías de Campos;138;75;63
34;Palencia;241;Villodre;51;27;24
34;Palencia;242;Villodrigo;151;76;75
34;Palencia;243;Villoldo;557;291;266
34;Palencia;245;Villota del Páramo;510;292;218
34;Palencia;246;Villovieco;148;81;67
35;Palmas (Las);001;Agaete;5461;2747;2714
35;Palmas (Las);002;Agüimes;17513;8903;8610
35;Palmas (Las);003;Antigua;2714;1451;1263
35;Palmas (Las);004;Arrecife;36783;18630;18153
35;Palmas (Las);005;Artenara;1142;587;555
35;Palmas (Las);006;Arucas;28521;14314;14207
35;Palmas (Las);007;Betancuria;594;311;283
35;Palmas (Las);008;Firgas;6152;3107;3045
35;Palmas (Las);009;Gáldar;22081;11129;10952
35;Palmas (Las);010;Haría;3164;1622;1542
35;Palmas (Las);011;Ingenio;22884;11663;11221
35;Palmas (Las);016;Las Palmas de Gran Canaria;371787;183060;188727
35;Palmas (Las);012;Mogán;10772;5635;5137
35;Palmas (Las);013;Moya;8388;4233;4155
35;Palmas (Las);014;Oliva (La);6294;3283;3011
35;Palmas (Las);015;Pájara;6055;3209;2846
35;Palmas (Las);017;Puerto del Rosario;18221;9783;8438
35;Palmas (Las);018;San Bartolomé;9156;4727;4429
35;Palmas (Las);019;San Bartolomé de Tirajana;34098;17792;16306
35;Palmas (Las);020;San Nicolás de Tolentino;8049;4033;4016
35;Palmas (Las);021;Santa Brígida;13873;6887;6986
35;Palmas (Las);022;Santa Lucía de Tirajana;36831;18768;18063
35;Palmas (Las);023;Santa María de Guía de Gran Canaria;12767;6445;6322
35;Palmas (Las);024;Teguise;9279;4818;4461
35;Palmas (Las);025;Tejeda;2441;1221;1220
35;Palmas (Las);026;Telde;84078;42191;41887
35;Palmas (Las);027;Teror;11276;5688;5588
35;Palmas (Las);028;Tías;9817;5168;4649
35;Palmas (Las);029;Tinajo;3615;1847;1768
35;Palmas (Las);030;Tuineje;7599;3981;3618
35;Palmas (Las);032;Valleseco;4457;2271;2186
35;Palmas (Las);031;Valsequillo de Gran Canaria;7136;3621;3515
35;Palmas (Las);033;Vega de San Mateo;6153;3139;3014
35;Palmas (Las);034;Yaiza;3296;1747;1549
36;Pontevedra;020;Agolada;5067;2486;2581
36;Pontevedra;001;Arbo;5016;2445;2571
36;Pontevedra;003;Baiona;10774;5268;5506
36;Pontevedra;002;Barro;3707;1773;1934
36;Pontevedra;004;Bueu;12892;6371;6521
36;Pontevedra;005;Caldas de Reis;9390;4544;4846
36;Pontevedra;006;Cambados;13122;6449;6673
36;Pontevedra;007;Campo Lameiro;2654;1271;1383
36;Pontevedra;008;Cangas;24096;11922;12174
36;Pontevedra;009;Cañiza (A);7937;3803;4134
36;Pontevedra;010;Catoira;3742;1849;1893
36;Pontevedra;011;Cerdedo;3728;1701;2027
36;Pontevedra;012;Cotobade;5429;2476;2953
36;Pontevedra;013;Covelo;4630;2105;2525
36;Pontevedra;014;Crecente;4033;1900;2133
36;Pontevedra;015;Cuntis;6013;2784;3229
36;Pontevedra;016;Dozón;2749;1367;1382
36;Pontevedra;017;Estrada (A);22977;10782;12195
36;Pontevedra;018;Forcarei;5862;2775;3087
36;Pontevedra;019;Fornelos de Montes;2474;1152;1322
36;Pontevedra;021;Gondomar;11164;5502;5662
36;Pontevedra;022;Grove (O);10978;5429;5549
36;Pontevedra;023;Guarda (A);10490;5075;5415
36;Pontevedra;901;Illa de Arousa (A);"";"";""
36;Pontevedra;024;Lalín;20839;10197;10642
36;Pontevedra;025;Lama (A);3494;1586;1908
36;Pontevedra;026;Marín;25463;12429;13034
36;Pontevedra;027;Meaño;5475;2641;2834
36;Pontevedra;028;Meis;5115;2420;2695
36;Pontevedra;029;Moaña;18307;8877;9430
36;Pontevedra;030;Mondariz;6669;3194;3475
36;Pontevedra;031;Mondariz-Balneario;650;306;344
36;Pontevedra;032;Moraña;4814;2310;2504
36;Pontevedra;033;Mos;13905;6765;7140
36;Pontevedra;034;Neves (As);5337;2526;2811
36;Pontevedra;035;Nigrán;14925;7314;7611
36;Pontevedra;036;Oia;3177;1596;1581
36;Pontevedra;037;Pazos de Borbén;3600;1678;1922
36;Pontevedra;041;Poio;13699;6662;7037
36;Pontevedra;043;Ponte Caldelas;7973;3784;4189
36;Pontevedra;042;Ponteareas;16399;7811;8588
36;Pontevedra;044;Pontecesures;2869;1411;1458
36;Pontevedra;038;Pontevedra;76461;36287;40174
36;Pontevedra;039;Porriño (O);16166;7830;8336
36;Pontevedra;040;Portas;3379;1581;1798
36;Pontevedra;045;Redondela;28924;14089;14835
36;Pontevedra;046;Ribadumia;4152;2003;2149
36;Pontevedra;047;Rodeiro;4880;2526;2354
36;Pontevedra;048;Rosal (O);5910;2880;3030
36;Pontevedra;049;Salceda de Caselas;5952;2928;3024
36;Pontevedra;050;Salvaterra de Miño;8998;4295;4703
36;Pontevedra;051;Sanxenxo;15629;7734;7895
36;Pontevedra;052;Silleda;10132;4875;5257
36;Pontevedra;053;Soutomaior;5112;2447;2665
36;Pontevedra;054;Tomiño;10543;5154;5389
36;Pontevedra;055;Tui;15850;7522;8328
36;Pontevedra;056;Valga;6467;3155;3312
36;Pontevedra;057;Vigo;288573;137805;150768
36;Pontevedra;059;Vila de Cruces;7612;3721;3891
36;Pontevedra;058;Vilaboa;5926;2904;3022
36;Pontevedra;060;Vilagarcía de Arousa;33680;16270;17410
36;Pontevedra;061;Vilanova de Arousa;15708;7729;7979
37;Salamanca;001;Abusejo;321;167;154
37;Salamanca;002;Agallas;239;124;115
37;Salamanca;003;Ahigal de los Aceiteros;239;117;122
37;Salamanca;004;Ahigal de Villarino;56;29;27
37;Salamanca;005;Alameda de Gardón (La);168;77;91
37;Salamanca;006;Alamedilla (La);245;118;127
37;Salamanca;007;Alaraz;725;379;346
37;Salamanca;008;Alba de Tormes;4501;2208;2293
37;Salamanca;009;Alba de Yeltes;323;159;164
37;Salamanca;010;Alberca (La);1125;575;550
37;Salamanca;011;Alberguería de Argañán (La);217;110;107
37;Salamanca;012;Alconada;251;126;125
37;Salamanca;015;Aldea del Obispo;444;227;217
37;Salamanca;013;Aldeacipreste;325;180;145
37;Salamanca;014;Aldeadávila de la Ribera;1694;859;835
37;Salamanca;016;Aldealengua;509;253;256
37;Salamanca;017;Aldeanueva de Figueroa;399;202;197
37;Salamanca;018;Aldeanueva de la Sierra;113;60;53
37;Salamanca;019;Aldearrodrigo;221;117;104
37;Salamanca;020;Aldearrubia;498;258;240
37;Salamanca;021;Aldeaseca de Alba;155;76;79
37;Salamanca;022;Aldeaseca de la Frontera;411;207;204
37;Salamanca;023;Aldeatejada;559;270;289
37;Salamanca;024;Aldeavieja de Tormes;145;69;76
37;Salamanca;025;Aldehuela de la Bóveda;400;204;196
37;Salamanca;026;Aldehuela de Yeltes;374;186;188
37;Salamanca;027;Almenara de Tormes;263;131;132
37;Salamanca;028;Almendra;247;122;125
37;Salamanca;029;Anaya de Alba;345;182;163
37;Salamanca;030;Añover de Tormes;127;64;63
37;Salamanca;031;Arabayona de Mógica;582;306;276
37;Salamanca;032;Arapiles;560;276;284
37;Salamanca;033;Arcediano;109;54;55
37;Salamanca;034;Arco (El);101;53;48
37;Salamanca;035;Armenteros;380;181;199
37;Salamanca;037;Atalaya (La);177;98;79
37;Salamanca;038;Babilafuente;1011;535;476
37;Salamanca;039;Bañobárez;530;279;251
37;Salamanca;040;Barbadillo;585;280;305
37;Salamanca;041;Barbalos;139;71;68
37;Salamanca;042;Barceo;90;47;43
37;Salamanca;044;Barruecopardo;655;324;331
37;Salamanca;045;Bastida (La);50;23;27
37;Salamanca;046;Béjar;17297;8256;9041
37;Salamanca;047;Beleña;137;63;74
37;Salamanca;049;Bermellar;246;116;130
37;Salamanca;050;Berrocal de Huebra;135;61;74
37;Salamanca;051;Berrocal de Salvatierra;171;88;83
37;Salamanca;052;Boada;487;244;243
37;Salamanca;054;Bodón (El);392;201;191
37;Salamanca;055;Bogajo;246;128;118
37;Salamanca;056;Bouza (La);73;37;36
37;Salamanca;057;Bóveda del Río Almar;353;179;174
37;Salamanca;058;Brincones;136;62;74
37;Salamanca;059;Buenamadre;200;103;97
37;Salamanca;060;Buenavista;110;59;51
37;Salamanca;061;Cabaco (El);297;151;146
37;Salamanca;063;Cabeza de Béjar (La);132;70;62
37;Salamanca;065;Cabeza del Caballo;555;284;271
37;Salamanca;062;Cabezabellosa de la Calzada;147;79;68
37;Salamanca;067;Cabrerizos;1111;562;549
37;Salamanca;068;Cabrillas;613;291;322
37;Salamanca;069;Calvarrasa de Abajo;1107;556;551
37;Salamanca;070;Calvarrasa de Arriba;636;331;305
37;Salamanca;071;Calzada de Béjar (La);115;61;54
37;Salamanca;072;Calzada de Don Diego;317;156;161
37;Salamanca;073;Calzada de Valdunciel;674;331;343
37;Salamanca;074;Campillo de Azaba;318;156;162
37;Salamanca;077;Campo de Peñaranda (El);452;234;218
37;Salamanca;078;Candelario;1196;602;594
37;Salamanca;079;Canillas de Abajo;141;77;64
37;Salamanca;080;Cantagallo;285;136;149
37;Salamanca;081;Cantalapiedra;1568;781;787
37;Salamanca;082;Cantalpino;1281;685;596
37;Salamanca;083;Cantaracillo;329;166;163
37;Salamanca;085;Carbajosa de la Sagrada;857;430;427
37;Salamanca;086;Carpio de Azaba;123;59;64
37;Salamanca;087;Carrascal de Barregas;277;139;138
37;Salamanca;088;Carrascal del Obispo;259;128;131
37;Salamanca;089;Casafranca;94;43;51
37;Salamanca;090;Casas del Conde (Las);110;52;58
37;Salamanca;091;Casillas de Flores;293;136;157
37;Salamanca;092;Castellanos de Moriscos;370;174;196
37;Salamanca;185;Castellanos de Villiquera;508;260;248
37;Salamanca;096;Castillejo de Martín Viejo;342;171;171
37;Salamanca;097;Castraz;81;47;34
37;Salamanca;098;Cepeda;582;276;306
37;Salamanca;099;Cereceda de la Sierra;120;63;57
37;Salamanca;100;Cerezal de Peñahorcada;158;80;78
37;Salamanca;101;Cerralbo;287;155;132
37;Salamanca;102;Cerro (El);614;310;304
37;Salamanca;103;Cespedosa de Tormes;743;396;347
37;Salamanca;114;Chagarcía Medianero;170;86;84
37;Salamanca;104;Cilleros de la Bastida;58;27;31
37;Salamanca;106;Cipérez;519;257;262
37;Salamanca;107;Ciudad Rodrigo;15540;7528;8012
37;Salamanca;108;Coca de Alba;199;96;103
37;Salamanca;109;Colmenar de Montemayor;313;166;147
37;Salamanca;110;Cordovilla;146;79;67
37;Salamanca;112;Cristóbal;253;139;114
37;Salamanca;113;Cubo de Don Sancho (El);650;345;305
37;Salamanca;115;Dios le Guarde;177;97;80
37;Salamanca;116;Doñinos de Ledesma;121;61;60
37;Salamanca;117;Doñinos de Salamanca;657;338;319
37;Salamanca;118;Ejeme;280;147;133
37;Salamanca;120;Encina de San Silvestre;128;65;63
37;Salamanca;119;Encina (La);254;136;118
37;Salamanca;121;Encinas de Abajo;758;388;370
37;Salamanca;122;Encinas de Arriba;304;150;154
37;Salamanca;123;Encinasola de los Comendadores;342;180;162
37;Salamanca;124;Endrinal;323;171;152
37;Salamanca;125;Escurial de la Sierra;337;165;172
37;Salamanca;126;Espadaña;63;34;29
37;Salamanca;127;Espeja;340;171;169
37;Salamanca;128;Espino de la Orbada;373;185;188
37;Salamanca;129;Florida de Liébana;251;140;111
37;Salamanca;130;Forfoleda;247;118;129
37;Salamanca;131;Frades de la Sierra;319;165;154
37;Salamanca;132;Fregeneda (La);640;299;341
37;Salamanca;133;Fresnedoso;146;68;78
37;Salamanca;134;Fresno Alhándiga;384;215;169
37;Salamanca;135;Fuente de San Esteban (La);1766;891;875
37;Salamanca;136;Fuenteguinaldo;1070;538;532
37;Salamanca;137;Fuenteliante;160;73;87
37;Salamanca;138;Fuenterroble de Salvatierra;278;144;134
37;Salamanca;139;Fuentes de Béjar;318;131;187
37;Salamanca;140;Fuentes de Oñoro;1433;712;721
37;Salamanca;141;Gajates;289;149;140
37;Salamanca;142;Galindo y Perahuy;198;105;93
37;Salamanca;143;Galinduste;614;309;305
37;Salamanca;144;Galisancho;774;410;364
37;Salamanca;145;Gallegos de Argañán;508;257;251
37;Salamanca;146;Gallegos de Solmirón;246;115;131
37;Salamanca;147;Garcibuey;329;186;143
37;Salamanca;148;Garcihernández;652;354;298
37;Salamanca;149;Garcirrey;114;57;57
37;Salamanca;150;Gejuelo del Barro;56;32;24
37;Salamanca;151;Golpejas;233;122;111
37;Salamanca;152;Gomecello;624;311;313
37;Salamanca;154;Guadramiro;258;145;113
37;Salamanca;155;Guijo de Ávila;118;67;51
37;Salamanca;156;Guijuelo;5062;2532;2530
37;Salamanca;157;Herguijuela de Ciudad Rodrigo;181;93;88
37;Salamanca;158;Herguijuela de la Sierra;396;195;201
37;Salamanca;159;Herguijuela del Campo;156;77;79
37;Salamanca;160;Hinojosa de Duero;940;453;487
37;Salamanca;161;Horcajo de Montemayor;203;102;101
37;Salamanca;162;Horcajo Medianero;446;225;221
37;Salamanca;163;Hoya (La);25;16;9
37;Salamanca;164;Huerta;285;148;137
37;Salamanca;165;Iruelos;81;36;45
37;Salamanca;166;Ituero de Azaba;339;174;165
37;Salamanca;167;Juzbado;205;106;99
37;Salamanca;168;Lagunilla;763;400;363
37;Salamanca;169;Larrodrigo;350;185;165
37;Salamanca;170;Ledesma;2010;988;1022
37;Salamanca;171;Ledrada;626;300;326
37;Salamanca;172;Linares de Riofrío;1193;612;581
37;Salamanca;173;Lumbrales;2403;1202;1201
37;Salamanca;175;Machacón;566;282;284
37;Salamanca;174;Macotera;1851;925;926
37;Salamanca;176;Madroñal;169;86;83
37;Salamanca;177;Maíllo (El);462;235;227
37;Salamanca;178;Malpartida;190;101;89
37;Salamanca;179;Mancera de Abajo;412;205;207
37;Salamanca;180;Manzano (El);115;61;54
37;Salamanca;181;Martiago;490;241;249
37;Salamanca;183;Martín de Yeltes;583;291;292
37;Salamanca;182;Martinamor;94;49;45
37;Salamanca;184;Masueco;512;255;257
37;Salamanca;186;Mata de Ledesma (La);168;78;90
37;Salamanca;187;Matilla de los Caños del Río;750;384;366
37;Salamanca;188;Maya (La);281;151;130
37;Salamanca;189;Membribe de la Sierra;114;59;55
37;Salamanca;190;Mieza;417;215;202
37;Salamanca;191;Milano (El);193;101;92
37;Salamanca;192;Miranda de Azán;154;79;75
37;Salamanca;193;Miranda del Castañar;633;339;294
37;Salamanca;194;Mogarraz;404;191;213
37;Salamanca;195;Molinillo;93;48;45
37;Salamanca;196;Monforte de la Sierra;140;74;66
37;Salamanca;197;Monleón;143;89;54
37;Salamanca;198;Monleras;303;150;153
37;Salamanca;199;Monsagro;281;158;123
37;Salamanca;200;Montejo;262;138;124
37;Salamanca;201;Montemayor del Río;379;191;188
37;Salamanca;202;Monterrubio de Armuña;249;129;120
37;Salamanca;203;Monterrubio de la Sierra;177;90;87
37;Salamanca;204;Morasverdes;516;266;250
37;Salamanca;205;Morille;221;112;109
37;Salamanca;206;Moríñigo;162;91;71
37;Salamanca;207;Moriscos;150;85;65
37;Salamanca;208;Moronta;163;80;83
37;Salamanca;209;Mozárbez;385;193;192
37;Salamanca;211;Narros de Matalayegua;357;188;169
37;Salamanca;213;Nava de Béjar;127;60;67
37;Salamanca;214;Nava de Francia;168;86;82
37;Salamanca;215;Nava de Sotrobal;237;127;110
37;Salamanca;212;Navacarros;103;50;53
37;Salamanca;216;Navales;419;239;180
37;Salamanca;217;Navalmoral de Béjar;86;38;48
37;Salamanca;218;Navamorales;206;114;92
37;Salamanca;219;Navarredonda de la Rinconada;302;150;152
37;Salamanca;221;Navasfrías;798;393;405
37;Salamanca;222;Negrilla de Palencia;120;61;59
37;Salamanca;223;Olmedo de Camaces;211;100;111
37;Salamanca;224;Orbada (La);310;150;160
37;Salamanca;225;Pajares de la Laguna;161;81;80
37;Salamanca;226;Palacios del Arzobispo;280;146;134
37;Salamanca;228;Palaciosrubios;600;313;287
37;Salamanca;229;Palencia de Negrilla;229;115;114
37;Salamanca;230;Parada de Arriba;249;127;122
37;Salamanca;231;Parada de Rubiales;385;192;193
37;Salamanca;232;Paradinas de San Juan;673;356;317
37;Salamanca;233;Pastores;79;41;38
37;Salamanca;234;Payo (El);579;273;306
37;Salamanca;235;Pedraza de Alba;309;168;141
37;Salamanca;236;Pedrosillo de Alba;310;158;152
37;Salamanca;237;Pedrosillo de los Aires;491;261;230
37;Salamanca;238;Pedrosillo el Ralo;147;76;71
37;Salamanca;239;Pedroso de la Armuña (El);351;174;177
37;Salamanca;240;Pelabravo;667;342;325
37;Salamanca;241;Pelarrodríguez;233;128;105
37;Salamanca;242;Pelayos;99;54;45
37;Salamanca;243;Peña (La);169;81;88
37;Salamanca;244;Peñacaballera;253;118;135
37;Salamanca;245;Peñaparda;527;248;279
37;Salamanca;246;Peñaranda de Bracamonte;6437;3146;3291
37;Salamanca;247;Peñarandilla;328;166;162
37;Salamanca;248;Peralejos de Abajo;239;112;127
37;Salamanca;249;Peralejos de Arriba;84;47;37
37;Salamanca;250;Pereña de la Ribera;576;294;282
37;Salamanca;251;Peromingo;170;79;91
37;Salamanca;252;Pinedas;241;120;121
37;Salamanca;253;Pino de Tormes (El);176;91;85
37;Salamanca;254;Pitiegua;282;137;145
37;Salamanca;255;Pizarral;100;46;54
37;Salamanca;256;Poveda de las Cintas;416;222;194
37;Salamanca;257;Pozos de Hinojo;106;55;51
37;Salamanca;258;Puebla de Azaba;323;166;157
37;Salamanca;259;Puebla de San Medel;74;37;37
37;Salamanca;260;Puebla de Yeltes;267;140;127
37;Salamanca;261;Puente del Congosto;385;190;195
37;Salamanca;262;Puertas;124;66;58
37;Salamanca;263;Puerto de Béjar;550;262;288
37;Salamanca;264;Puerto Seguro;126;63;63
37;Salamanca;265;Rágama;379;202;177
37;Salamanca;266;Redonda (La);114;53;61
37;Salamanca;267;Retortillo;277;129;148
37;Salamanca;268;Rinconada de la Sierra (La);193;92;101
37;Salamanca;269;Robleda;641;336;305
37;Salamanca;270;Robliza de Cojos;232;114;118
37;Salamanca;271;Rollán;638;325;313
37;Salamanca;272;Saelices el Chico;217;115;102
37;Salamanca;273;Sagrada (La);213;105;108
37;Salamanca;303;Sahugo (El);343;175;168
37;Salamanca;274;Salamanca;167382;79255;88127
37;Salamanca;275;Saldeana;212;110;102
37;Salamanca;276;Salmoral;395;200;195
37;Salamanca;277;Salvatierra de Tormes;74;37;37
37;Salamanca;278;San Cristóbal de la Cuesta;277;143;134
37;Salamanca;284;San Esteban de la Sierra;493;257;236
37;Salamanca;285;San Felices de los Gallegos;702;352;350
37;Salamanca;286;San Martín del Castañar;314;161;153
37;Salamanca;287;San Miguel de Valero;444;222;222
37;Salamanca;036;San Miguel del Robledo;111;55;56
37;Salamanca;288;San Morales;192;103;89
37;Salamanca;289;San Muñoz;420;206;214
37;Salamanca;291;San Pedro de Rozados;420;217;203
37;Salamanca;290;San Pedro del Valle;137;69;68
37;Salamanca;292;San Pelayo de Guareña;123;64;59
37;Salamanca;280;Sanchón de la Ribera;154;77;77
37;Salamanca;281;Sanchón de la Sagrada;64;34;30
37;Salamanca;282;Sanchotello;367;188;179
37;Salamanca;279;Sancti-Spíritus;1312;671;641
37;Salamanca;283;Sando;265;150;115
37;Salamanca;293;Santa María de Sando;227;122;105
37;Salamanca;294;Santa Marta de Tormes;8364;4139;4225
37;Salamanca;296;Santiago de la Puebla;664;347;317
37;Salamanca;297;Santibáñez de Béjar;743;369;374
37;Salamanca;298;Santibáñez de la Sierra;264;140;124
37;Salamanca;299;Santiz;321;168;153
37;Salamanca;300;Santos (Los);817;439;378
37;Salamanca;301;Sardón de los Frailes;114;63;51
37;Salamanca;302;Saucelle;520;256;264
37;Salamanca;304;Sepulcro-Hilario;333;167;166
37;Salamanca;305;Sequeros;275;130;145
37;Salamanca;306;Serradilla del Arroyo;493;258;235
37;Salamanca;307;Serradilla del Llano;373;188;185
37;Salamanca;309;Sierpe (La);61;32;29
37;Salamanca;310;Sieteiglesias de Tormes;177;93;84
37;Salamanca;311;Sobradillo;420;203;217
37;Salamanca;312;Sorihuela;452;223;229
37;Salamanca;313;Sotoserrano;789;405;384
37;Salamanca;314;Tabera de Abajo;133;69;64
37;Salamanca;315;Tala (La);171;89;82
37;Salamanca;316;Tamames;1131;573;558
37;Salamanca;317;Tarazona de Guareña;458;247;211
37;Salamanca;318;Tardáguila;285;151;134
37;Salamanca;319;Tejado (El);216;108;108
37;Salamanca;320;Tejeda y Segoyuela;154;79;75
37;Salamanca;321;Tenebrón;235;117;118
37;Salamanca;322;Terradillos;2397;1207;1190
37;Salamanca;323;Topas;774;397;377
37;Salamanca;324;Tordillos;666;334;332
37;Salamanca;325;Tornadizo (El);162;87;75
37;Salamanca;327;Torresmenudas;266;129;137
37;Salamanca;328;Trabanca;275;140;135
37;Salamanca;329;Tremedal de Tormes;61;31;30
37;Salamanca;330;Valdecarros;473;241;232
37;Salamanca;331;Valdefuentes de Sangusín;359;176;183
37;Salamanca;332;Valdehijaderos;128;73;55
37;Salamanca;333;Valdelacasa;357;190;167
37;Salamanca;334;Valdelageve;141;77;64
37;Salamanca;335;Valdelosa;502;240;262
37;Salamanca;336;Valdemierque;76;40;36
37;Salamanca;337;Valderrodrigo;209;104;105
37;Salamanca;338;Valdunciel;139;65;74
37;Salamanca;339;Valero;513;259;254
37;Salamanca;343;Vallejera de Riofrío;67;29;38
37;Salamanca;340;Valsalabroso;252;129;123
37;Salamanca;341;Valverde de Valdelacasa;86;41;45
37;Salamanca;342;Valverdón;282;150;132
37;Salamanca;344;Vecinos;336;169;167
37;Salamanca;345;Vega de Tirados;266;138;128
37;Salamanca;346;Veguillas (Las);338;159;179
37;Salamanca;347;Vellés (La);484;248;236
37;Salamanca;348;Ventosa del Río Almar;179;86;93
37;Salamanca;349;Vídola (La);229;117;112
37;Salamanca;351;Villaflores;529;265;264
37;Salamanca;352;Villagonzalo de Tormes;247;132;115
37;Salamanca;353;Villalba de los Llanos;219;123;96
37;Salamanca;354;Villamayor;1601;815;786
37;Salamanca;355;Villanueva del Conde;287;145;142
37;Salamanca;356;Villar de Argañán;130;66;64
37;Salamanca;357;Villar de Ciervo;458;245;213
37;Salamanca;358;Villar de Gallimazo;270;143;127
37;Salamanca;359;Villar de la Yegua;365;174;191
37;Salamanca;360;Villar de Peralonso;397;191;206
37;Salamanca;361;Villar de Samaniego;147;78;69
37;Salamanca;362;Villares de la Reina;1373;679;694
37;Salamanca;363;Villares de Yeltes;194;94;100
37;Salamanca;364;Villarino de los Aires;1229;601;628
37;Salamanca;365;Villarmayor;236;120;116
37;Salamanca;366;Villarmuerto;76;43;33
37;Salamanca;367;Villasbuenas;356;175;181
37;Salamanca;368;Villasdardo;35;19;16
37;Salamanca;369;Villaseco de los Gamitos;231;116;115
37;Salamanca;370;Villaseco de los Reyes;459;235;224
37;Salamanca;371;Villasrubias;454;245;209
37;Salamanca;372;Villaverde de Guareña;224;114;110
37;Salamanca;373;Villavieja de Yeltes;1180;589;591
37;Salamanca;374;Villoria;1417;701;716
37;Salamanca;375;Villoruela;1084;538;546
37;Salamanca;350;Vilvestre;675;328;347
37;Salamanca;376;Vitigudino;3216;1575;1641
37;Salamanca;377;Yecla de Yeltes;429;210;219
37;Salamanca;378;Zamarra;176;97;79
37;Salamanca;379;Zamayón;198;108;90
37;Salamanca;380;Zarapicos;79;42;37
37;Salamanca;381;Zarza de Pumareda (La);231;131;100
37;Salamanca;382;Zorita de la Frontera;332;176;156
38;Santa Cruz de Tenerife;001;Adeje;12562;6394;6168
38;Santa Cruz de Tenerife;002;Agulo;1176;595;581
38;Santa Cruz de Tenerife;003;Alajeró;1179;611;568
38;Santa Cruz de Tenerife;004;Arafo;4437;2153;2284
38;Santa Cruz de Tenerife;005;Arico;4830;2470;2360
38;Santa Cruz de Tenerife;006;Arona;27909;14083;13826
38;Santa Cruz de Tenerife;007;Barlovento;2685;1345;1340
38;Santa Cruz de Tenerife;008;Breña Alta;5581;2786;2795
38;Santa Cruz de Tenerife;009;Breña Baja;3514;1742;1772
38;Santa Cruz de Tenerife;010;Buenavista del Norte;5609;2843;2766
38;Santa Cruz de Tenerife;011;Candelaria;11720;5826;5894
38;Santa Cruz de Tenerife;012;Fasnia;2400;1205;1195
38;Santa Cruz de Tenerife;013;Frontera;4102;2093;2009
38;Santa Cruz de Tenerife;014;Fuencaliente de la Palma;1800;912;888
38;Santa Cruz de Tenerife;015;Garachico;6023;2961;3062
38;Santa Cruz de Tenerife;016;Garafía;2015;1018;997
38;Santa Cruz de Tenerife;017;Granadilla de Abona;18039;9160;8879
38;Santa Cruz de Tenerife;018;Guancha (La);5360;2687;2673
38;Santa Cruz de Tenerife;019;Guía de Isora;12841;6329;6512
38;Santa Cruz de Tenerife;020;Güímar;15355;7651;7704
38;Santa Cruz de Tenerife;021;Hermigua;2162;1121;1041
38;Santa Cruz de Tenerife;022;Icod de los Vinos;22145;10964;11181
38;Santa Cruz de Tenerife;024;Llanos de Aridane (Los);17497;8613;8884
38;Santa Cruz de Tenerife;025;Matanza de Acentejo (La);6310;3237;3073
38;Santa Cruz de Tenerife;026;Orotava (La);36042;17789;18253
38;Santa Cruz de Tenerife;027;Paso (El);7258;3596;3662
38;Santa Cruz de Tenerife;028;Puerto de la Cruz;27426;13419;14007
38;Santa Cruz de Tenerife;029;Puntagorda;1824;897;927
38;Santa Cruz de Tenerife;030;Puntallana;2298;1148;1150
38;Santa Cruz de Tenerife;031;Realejos (Los);32588;16169;16419
38;Santa Cruz de Tenerife;032;Rosario (El);10137;5165;4972
38;Santa Cruz de Tenerife;033;San Andrés y Sauces;5394;2717;2677
38;Santa Cruz de Tenerife;023;San Cristóbal de La Laguna;125183;61677;63506
38;Santa Cruz de Tenerife;034;San Juan de la Rambla;4708;2337;2371
38;Santa Cruz de Tenerife;035;San Miguel de Abona;5945;3034;2911
38;Santa Cruz de Tenerife;036;San Sebastián de la Gomera;6123;3108;3015
38;Santa Cruz de Tenerife;037;Santa Cruz de la Palma;17454;8452;9002
38;Santa Cruz de Tenerife;038;Santa Cruz de Tenerife;203929;98783;105146
38;Santa Cruz de Tenerife;039;Santa Úrsula;9263;4615;4648
38;Santa Cruz de Tenerife;040;Santiago del Teide;6565;3311;3254
38;Santa Cruz de Tenerife;041;Sauzal (El);6722;3362;3360
38;Santa Cruz de Tenerife;042;Silos (Los);5605;2763;2842
38;Santa Cruz de Tenerife;043;Tacoronte;18815;9424;9391
38;Santa Cruz de Tenerife;044;Tanque (El);3132;1569;1563
38;Santa Cruz de Tenerife;045;Tazacorte;6556;3287;3269
38;Santa Cruz de Tenerife;046;Tegueste;8433;4241;4192
38;Santa Cruz de Tenerife;047;Tijarafe;2635;1315;1320
38;Santa Cruz de Tenerife;049;Valle Gran Rey;3161;1604;1557
38;Santa Cruz de Tenerife;050;Vallehermoso;3011;1527;1484
38;Santa Cruz de Tenerife;048;Valverde;3744;1865;1879
38;Santa Cruz de Tenerife;051;Victoria de Acentejo (La);7639;3852;3787
38;Santa Cruz de Tenerife;052;Vilaflor;1599;815;784
38;Santa Cruz de Tenerife;053;Villa de Mazo;5213;2591;2622
39;Cantabria;001;Alfoz de Lloredo;2743;1408;1335
39;Cantabria;002;Ampuero;3444;1712;1732
39;Cantabria;003;Anievas;440;216;224
39;Cantabria;004;Arenas de Iguña;2264;1146;1118
39;Cantabria;005;Argoños;723;369;354
39;Cantabria;006;Arnuero;1895;957;938
39;Cantabria;007;Arredondo;707;379;328
39;Cantabria;008;Astillero (El);12865;6352;6513
39;Cantabria;009;Bárcena de Cicero;2304;1179;1125
39;Cantabria;010;Bárcena de Pie de Concha;956;449;507
39;Cantabria;011;Bareyo;1702;856;846
39;Cantabria;012;Cabezón de la Sal;7205;3535;3670
39;Cantabria;013;Cabezón de Liébana;808;431;377
39;Cantabria;014;Cabuérniga;1117;563;554
39;Cantabria;015;Camaleño;1190;614;576
39;Cantabria;016;Camargo;21674;10731;10943
39;Cantabria;027;Campoo de Enmedio;3999;2020;1979
39;Cantabria;017;Campoo de Yuso;830;410;420
39;Cantabria;018;Cartes;2519;1255;1264
39;Cantabria;019;Castañeda;1591;783;808
39;Cantabria;020;Castro-Urdiales;14411;7187;7224
39;Cantabria;021;Cieza;784;384;400
39;Cantabria;022;Cillorigo de Liébana;1139;610;529
39;Cantabria;023;Colindres;5878;2913;2965
39;Cantabria;024;Comillas;2517;1201;1316
39;Cantabria;025;Corrales de Buelna (Los);10061;5022;5039
39;Cantabria;026;Corvera de Toranzo;2209;1108;1101
39;Cantabria;028;Entrambasaguas;2552;1268;1284
39;Cantabria;029;Escalante;789;398;391
39;Cantabria;030;Guriezo;1760;904;856
39;Cantabria;031;Hazas de Cesto;1275;642;633
39;Cantabria;032;Hermandad de Campoo de Suso;1910;1016;894
39;Cantabria;033;Herrerías;800;437;363
39;Cantabria;034;Lamasón;472;258;214
39;Cantabria;035;Laredo;13932;6781;7151
39;Cantabria;036;Liendo;769;393;376
39;Cantabria;037;Liérganes;2325;1152;1173
39;Cantabria;038;Limpias;1203;598;605
39;Cantabria;039;Luena;1152;590;562
39;Cantabria;040;Marina de Cudeyo;4603;2293;2310
39;Cantabria;041;Mazcuerras;1849;966;883
39;Cantabria;042;Medio Cudeyo;5891;2904;2987
39;Cantabria;043;Meruelo;1002;512;490
39;Cantabria;044;Miengo;3214;1608;1606
39;Cantabria;045;Miera;654;323;331
39;Cantabria;046;Molledo;2105;1022;1083
39;Cantabria;047;Noja;1667;831;836
39;Cantabria;048;Penagos;1811;897;914
39;Cantabria;049;Peñarrubia;330;167;163
39;Cantabria;050;Pesaguero;462;252;210
39;Cantabria;051;Pesquera;104;49;55
39;Cantabria;052;Piélagos;9673;4772;4901
39;Cantabria;053;Polaciones;337;198;139
39;Cantabria;054;Polanco;3804;1857;1947
39;Cantabria;055;Potes;1490;744;746
39;Cantabria;056;Puente Viesgo;2470;1237;1233
39;Cantabria;057;Ramales de la Victoria;2436;1249;1187
39;Cantabria;058;Rasines;1045;528;517
39;Cantabria;059;Reinosa;12416;6026;6390
39;Cantabria;060;Reocín;6831;3397;3434
39;Cantabria;061;Ribamontán al Mar;3096;1585;1511
39;Cantabria;062;Ribamontán al Monte;2025;1051;974
39;Cantabria;063;Rionansa;1623;870;753
39;Cantabria;064;Riotuerto;1604;775;829
39;Cantabria;065;Rozas de Valdearroyo (Las);311;161;150
39;Cantabria;066;Ruente;947;487;460
39;Cantabria;067;Ruesga;1325;664;661
39;Cantabria;068;Ruiloba;740;374;366
39;Cantabria;069;San Felices de Buelna;2350;1151;1199
39;Cantabria;070;San Miguel de Aguayo;168;88;80
39;Cantabria;071;San Pedro del Romeral;795;413;382
39;Cantabria;072;San Roque de Riomiera;605;322;283
39;Cantabria;080;San Vicente de la Barquera;4572;2323;2249
39;Cantabria;073;Santa Cruz de Bezana;6029;3037;2992
39;Cantabria;074;Santa María de Cayón;6116;3057;3059
39;Cantabria;075;Santander;194822;92074;102748
39;Cantabria;076;Santillana del Mar;3998;1952;2046
39;Cantabria;077;Santiurde de Reinosa;373;202;171
39;Cantabria;078;Santiurde de Toranzo;1765;887;878
39;Cantabria;079;Santoña;11842;6114;5728
39;Cantabria;081;Saro;579;295;284
39;Cantabria;082;Selaya;2082;1059;1023
39;Cantabria;083;Soba;1818;948;870
39;Cantabria;084;Solórzano;1003;516;487
39;Cantabria;085;Suances;6119;3009;3110
39;Cantabria;086;Tojos (Los);418;226;192
39;Cantabria;087;Torrelavega;59759;29083;30676
39;Cantabria;088;Tresviso;74;42;32
39;Cantabria;089;Tudanca;282;164;118
39;Cantabria;090;Udías;835;425;410
39;Cantabria;095;Val de San Vicente;2553;1310;1243
39;Cantabria;091;Valdáliga;2739;1400;1339
39;Cantabria;092;Valdeolea;1718;877;841
39;Cantabria;093;Valdeprado del Río;376;189;187
39;Cantabria;094;Valderredible;1185;623;562
39;Cantabria;096;Vega de Liébana;1107;586;521
39;Cantabria;097;Vega de Pas;1150;578;572
39;Cantabria;098;Villacarriedo;2107;1058;1049
39;Cantabria;099;Villaescusa;2942;1430;1512
39;Cantabria;100;Villafufre;1172;598;574
39;Cantabria;101;Villaverde de Trucíos;411;216;195
39;Cantabria;102;Voto;2478;1294;1184
40;Segovia;001;Abades;903;453;450
40;Segovia;002;Adrada de Pirón;51;30;21
40;Segovia;003;Adrados;253;125;128
40;Segovia;004;Aguilafuente;805;390;415
40;Segovia;005;Alconada de Maderuelo;60;31;29
40;Segovia;012;Aldea Real;426;225;201
40;Segovia;006;Aldealcorvo;39;20;19
40;Segovia;007;Aldealengua de Pedraza;113;61;52
40;Segovia;008;Aldealengua de Santa María;83;47;36
40;Segovia;009;Aldeanueva de la Serrezuela;56;31;25
40;Segovia;010;Aldeanueva del Codonal;246;123;123
40;Segovia;013;Aldeasoña;160;72;88
40;Segovia;014;Aldehorno;98;52;46
40;Segovia;015;Aldehuela del Codonal;65;28;37
40;Segovia;016;Aldeonte;106;53;53
40;Segovia;017;Anaya;125;64;61
40;Segovia;018;Añe;125;69;56
40;Segovia;019;Arahuetes;54;27;27
40;Segovia;020;Arcones;292;156;136
40;Segovia;021;Arevalillo de Cega;42;22;20
40;Segovia;022;Armuña;315;163;152
40;Segovia;024;Ayllón;1265;638;627
40;Segovia;025;Barbolla;230;124;106
40;Segovia;026;Basardilla;105;53;52
40;Segovia;028;Bercial;161;76;85
40;Segovia;029;Bercimuel;77;34;43
40;Segovia;030;Bernardos;803;399;404
40;Segovia;031;Bernuy de Porreros;328;173;155
40;Segovia;032;Boceguillas;533;264;269
40;Segovia;033;Brieva;59;37;22
40;Segovia;034;Caballar;109;52;57
40;Segovia;035;Cabañas de Polendos;117;60;57
40;Segovia;036;Cabezuela;787;408;379
40;Segovia;037;Calabazas de Fuentidueña;95;45;50
40;Segovia;039;Campo de San Pedro;387;220;167
40;Segovia;040;Cantalejo;3492;1758;1734
40;Segovia;041;Cantimpalos;1359;693;666
40;Segovia;043;Carbonero el Mayor;2370;1196;1174
40;Segovia;044;Carrascal del Río;221;115;106
40;Segovia;045;Casla;165;86;79
40;Segovia;046;Castillejo de Mesleón;133;64;69
40;Segovia;047;Castro de Fuentidueña;99;56;43
40;Segovia;048;Castrojimeno;48;31;17
40;Segovia;049;Castroserna de Abajo;68;42;26
40;Segovia;051;Castroserracín;49;30;19
40;Segovia;052;Cedillo de la Torre;160;83;77
40;Segovia;053;Cerezo de Abajo;178;96;82
40;Segovia;054;Cerezo de Arriba;212;117;95
40;Segovia;065;Chañe;760;391;369
40;Segovia;055;Cilleruelo de San Mamés;64;31;33
40;Segovia;056;Cobos de Fuentidueña;82;36;46
40;Segovia;057;Coca;2039;1020;1019
40;Segovia;058;Codorniz;492;242;250
40;Segovia;059;Collado Hermoso;150;77;73
40;Segovia;060;Condado de Castilnovo;158;84;74
40;Segovia;061;Corral de Ayllón;126;66;60
40;Segovia;902;Cozuelos de Fuentidueña;242;123;119
40;Segovia;062;Cubillo;75;42;33
40;Segovia;063;Cuéllar;9195;4646;4549
40;Segovia;905;Cuevas de Provanco;253;137;116
40;Segovia;068;Domingo García;56;25;31
40;Segovia;069;Donhierro;122;71;51
40;Segovia;070;Duruelo;137;70;67
40;Segovia;071;Encinas;78;37;41
40;Segovia;072;Encinillas;83;44;39
40;Segovia;073;Escalona del Prado;609;312;297
40;Segovia;074;Escarabajosa de Cabezas;404;216;188
40;Segovia;075;Escobar de Polendos;241;121;120
40;Segovia;076;Espinar (El);5578;2826;2752
40;Segovia;077;Espirdo;225;125;100
40;Segovia;078;Fresneda de Cuéllar;270;143;127
40;Segovia;079;Fresno de Cantespino;237;128;109
40;Segovia;080;Fresno de la Fuente;88;47;41
40;Segovia;081;Frumales;254;131;123
40;Segovia;082;Fuente de Santa Cruz;213;112;101
40;Segovia;083;Fuente el Olmo de Fuentidueña;200;101;99
40;Segovia;084;Fuente el Olmo de Íscar;108;61;47
40;Segovia;086;Fuentepelayo;1009;509;500
40;Segovia;087;Fuentepiñel;200;99;101
40;Segovia;088;Fuenterrebollo;495;243;252
40;Segovia;089;Fuentesaúco de Fuentidueña;391;201;190
40;Segovia;091;Fuentesoto;169;88;81
40;Segovia;092;Fuentidueña;213;102;111
40;Segovia;093;Gallegos;109;57;52
40;Segovia;094;Garcillán;359;189;170
40;Segovia;095;Gomezserracín;672;345;327
40;Segovia;097;Grajera;81;42;39
40;Segovia;099;Honrubia de la Cuesta;103;50;53
40;Segovia;100;Hontalbilla;512;261;251
40;Segovia;101;Hontanares de Eresma;145;75;70
40;Segovia;103;Huertos (Los);164;84;80
40;Segovia;104;Ituero y Lama;60;34;26
40;Segovia;105;Juarros de Riomoros;80;44;36
40;Segovia;106;Juarros de Voltoya;296;160;136
40;Segovia;107;Labajos;170;94;76
40;Segovia;108;Laguna de Contreras;200;109;91
40;Segovia;109;Languilla;156;85;71
40;Segovia;110;Lastras de Cuéllar;590;307;283
40;Segovia;111;Lastras del Pozo;99;54;45
40;Segovia;112;Lastrilla (La);953;495;458
40;Segovia;113;Losa (La);341;181;160
40;Segovia;115;Maderuelo;169;88;81
40;Segovia;903;Marazoleja;176;96;80
40;Segovia;118;Marazuela;95;46;49
40;Segovia;119;Martín Miguel;202;99;103
40;Segovia;120;Martín Muñoz de la Dehesa;179;94;85
40;Segovia;121;Martín Muñoz de las Posadas;596;299;297
40;Segovia;122;Marugán;284;140;144
40;Segovia;124;Mata de Cuéllar;329;177;152
40;Segovia;123;Matabuena;223;114;109
40;Segovia;125;Matilla (La);131;71;60
40;Segovia;126;Melque de Cercos;149;67;82
40;Segovia;127;Membibre de la Hoz;96;50;46
40;Segovia;128;Migueláñez;193;98;95
40;Segovia;129;Montejo de Arévalo;327;175;152
40;Segovia;130;Montejo de la Vega de la Serrezuela;206;113;93
40;Segovia;131;Monterrubio;61;32;29
40;Segovia;132;Moral de Hornuez;124;63;61
40;Segovia;134;Mozoncillo;1040;534;506
40;Segovia;135;Muñopedro;432;217;215
40;Segovia;136;Muñoveros;236;124;112
40;Segovia;138;Nava de la Asunción;2660;1362;1298
40;Segovia;139;Navafría;416;221;195
40;Segovia;140;Navalilla;185;95;90
40;Segovia;141;Navalmanzano;1161;599;562
40;Segovia;142;Navares de Ayuso;79;43;36
40;Segovia;143;Navares de Enmedio;190;100;90
40;Segovia;144;Navares de las Cuevas;25;13;12
40;Segovia;145;Navas de Oro;1510;760;750
40;Segovia;904;Navas de Riofrío;249;106;143
40;Segovia;146;Navas de San Antonio;319;163;156
40;Segovia;148;Nieva;395;199;196
40;Segovia;149;Olombrada;885;461;424
40;Segovia;150;Orejana;119;64;55
40;Segovia;151;Ortigosa de Pestaño;92;47;45
40;Segovia;901;Ortigosa del Monte;316;154;162
40;Segovia;152;Otero de Herreros;830;416;414
40;Segovia;154;Pajarejos;47;22;25
40;Segovia;155;Palazuelos de Eresma;1923;960;963
40;Segovia;156;Pedraza;453;225;228
40;Segovia;157;Pelayos del Arroyo;46;25;21
40;Segovia;158;Perosillo;38;23;15
40;Segovia;159;Pinarejos;225;122;103
40;Segovia;160;Pinarnegrillo;209;111;98
40;Segovia;161;Pradales;67;39;28
40;Segovia;162;Prádena;575;306;269
40;Segovia;163;Puebla de Pedraza;94;47;47
40;Segovia;164;Rapariegos;317;170;147
40;Segovia;165;Rebollo;148;84;64
40;Segovia;166;Remondo;393;188;205
40;Segovia;168;Riaguas de San Bartolomé;76;40;36
40;Segovia;170;Riaza;1657;872;785
40;Segovia;171;Ribota;38;21;17
40;Segovia;172;Riofrío de Riaza;61;35;26
40;Segovia;173;Roda de Eresma;105;53;52
40;Segovia;174;Sacramenia;603;322;281
40;Segovia;176;Samboal;665;338;327
40;Segovia;177;San Cristóbal de Cuéllar;269;139;130
40;Segovia;178;San Cristóbal de la Vega;180;93;87
40;Segovia;906;San Cristóbal de Segovia;"";"";""
40;Segovia;181;San Ildefonso;5069;2466;2603
40;Segovia;182;San Martín y Mudrián;327;168;159
40;Segovia;183;San Miguel de Bernuy;215;112;103
40;Segovia;184;San Pedro de Gaíllos;339;175;164
40;Segovia;179;Sanchonuño;763;383;380
40;Segovia;180;Sangarcía;536;273;263
40;Segovia;185;Santa María la Real de Nieva;1642;817;825
40;Segovia;186;Santa Marta del Cerro;58;27;31
40;Segovia;188;Santiuste de Pedraza;121;67;54
40;Segovia;189;Santiuste de San Juan Bautista;847;425;422
40;Segovia;190;Santo Domingo de Pirón;50;24;26
40;Segovia;191;Santo Tomé del Puerto;367;185;182
40;Segovia;192;Sauquillo de Cabezas;263;137;126
40;Segovia;193;Sebúlcor;291;155;136
40;Segovia;194;Segovia;55372;26680;28692
40;Segovia;195;Sepúlveda;1388;712;676
40;Segovia;196;Sequera de Fresno;68;37;31
40;Segovia;198;Sotillo;59;26;33
40;Segovia;199;Sotosalbos;97;50;47
40;Segovia;200;Tabanera la Luenga;85;45;40
40;Segovia;201;Tolocirio;67;30;37
40;Segovia;206;Torre Val de San Pedro;230;121;109
40;Segovia;202;Torreadrada;163;82;81
40;Segovia;203;Torrecaballeros;351;177;174
40;Segovia;204;Torrecilla del Pinar;359;173;186
40;Segovia;205;Torreiglesias;404;215;189
40;Segovia;207;Trescasas;177;94;83
40;Segovia;208;Turégano;1148;567;581
40;Segovia;210;Urueñas;134;76;58
40;Segovia;211;Valdeprados;49;27;22
40;Segovia;212;Valdevacas de Montejo;40;23;17
40;Segovia;213;Valdevacas y Guijar;165;88;77
40;Segovia;218;Valle de Tabladillo;193;102;91
40;Segovia;219;Vallelado;886;445;441
40;Segovia;220;Valleruela de Pedraza;75;42;33
40;Segovia;221;Valleruela de Sepúlveda;77;39;38
40;Segovia;214;Valseca;331;166;165
40;Segovia;215;Valtiendas;214;115;99
40;Segovia;216;Valverde del Majano;510;261;249
40;Segovia;222;Veganzones;330;164;166
40;Segovia;223;Vegas de Matute;270;147;123
40;Segovia;224;Ventosilla y Tejadilla;23;13;10
40;Segovia;225;Villacastín;1568;810;758
40;Segovia;228;Villaverde de Íscar;779;401;378
40;Segovia;229;Villaverde de Montejo;89;43;46
40;Segovia;230;Villeguillo;150;83;67
40;Segovia;231;Yanguas de Eresma;215;101;114
40;Segovia;233;Zarzuela del Monte;551;276;275
40;Segovia;234;Zarzuela del Pinar;633;338;295
41;Sevilla;001;Aguadulce;1971;987;984
41;Sevilla;002;Alanís;2114;1063;1051
41;Sevilla;003;Albaida del Aljarafe;1771;898;873
41;Sevilla;004;Alcalá de Guadaira;54529;27047;27482
41;Sevilla;005;Alcalá del Río;9414;4801;4613
41;Sevilla;006;Alcolea del Río;3565;1786;1779
41;Sevilla;007;Algaba (La);12708;6400;6308
41;Sevilla;008;Algámitas;1469;756;713
41;Sevilla;009;Almadén de la Plata;1771;901;870
41;Sevilla;010;Almensilla;2045;1022;1023
41;Sevilla;011;Arahal;18249;9062;9187
41;Sevilla;012;Aznalcázar;3327;1651;1676
41;Sevilla;013;Aznalcóllar;5739;2927;2812
41;Sevilla;014;Badolatosa;3184;1637;1547
41;Sevilla;015;Benacazón;4934;2494;2440
41;Sevilla;016;Bollullos de la Mitación;6209;3123;3086
41;Sevilla;017;Bormujos;5593;2753;2840
41;Sevilla;018;Brenes;10620;5350;5270
41;Sevilla;019;Burguillos;3374;1691;1683
41;Sevilla;020;Cabezas de San Juan (Las);15894;8205;7689
41;Sevilla;021;Camas;25984;12631;13353
41;Sevilla;022;Campana (La);5470;2769;2701
41;Sevilla;023;Cantillana;8998;4514;4484
41;Sevilla;901;Cañada Rosal;2927;1471;1456
41;Sevilla;024;Carmona;24608;12400;12208
41;Sevilla;025;Carrión de los Céspedes;2363;1132;1231
41;Sevilla;026;Casariche;5166;2610;2556
41;Sevilla;027;Castilblanco de los Arroyos;4232;2135;2097
41;Sevilla;028;Castilleja de Guzmán;583;290;293
41;Sevilla;029;Castilleja de la Cuesta;15960;7830;8130
41;Sevilla;030;Castilleja del Campo;638;310;328
41;Sevilla;031;Castillo de las Guardas (El);1744;891;853
41;Sevilla;032;Cazalla de la Sierra;5235;2606;2629
41;Sevilla;033;Constantina;7522;3699;3823
41;Sevilla;034;Coria del Río;23333;11636;11697
41;Sevilla;035;Coripe;1709;877;832
41;Sevilla;036;Coronil (El);5175;2619;2556
41;Sevilla;037;Corrales (Los);4135;2120;2015
41;Sevilla;903;Cuervo de Sevilla (El);7509;3815;3694
41;Sevilla;038;Dos Hermanas;82814;40981;41833
41;Sevilla;039;Écija;37267;18369;18898
41;Sevilla;040;Espartinas;3563;1817;1746
41;Sevilla;041;Estepa;11325;5605;5720
41;Sevilla;042;Fuentes de Andalucía;7555;3746;3809
41;Sevilla;043;Garrobo (El);748;373;375
41;Sevilla;044;Gelves;4257;2069;2188
41;Sevilla;045;Gerena;5419;2733;2686
41;Sevilla;046;Gilena;3824;1933;1891
41;Sevilla;047;Gines;7703;3781;3922
41;Sevilla;048;Guadalcanal;3121;1544;1577
41;Sevilla;049;Guillena;8117;4090;4027
41;Sevilla;050;Herrera;5982;2964;3018
41;Sevilla;051;Huévar del Aljarafe;2217;1144;1073
41;Sevilla;052;Lantejuela (La);3539;1801;1738
41;Sevilla;053;Lebrija;23773;12115;11658
41;Sevilla;054;Lora de Estepa;741;377;364
41;Sevilla;055;Lora del Río;19570;9668;9902
41;Sevilla;056;Luisiana (La);4332;2217;2115
41;Sevilla;057;Madroño (El);393;200;193
41;Sevilla;058;Mairena del Alcor;15720;7865;7855
41;Sevilla;059;Mairena del Aljarafe;28551;14271;14280
41;Sevilla;060;Marchena;17823;8823;9000
41;Sevilla;061;Marinaleda;2617;1305;1312
41;Sevilla;062;Martín de la Jara;2838;1495;1343
41;Sevilla;063;Molares (Los);2780;1405;1375
41;Sevilla;064;Montellano;7046;3570;3476
41;Sevilla;065;Morón de la Frontera;29408;14719;14689
41;Sevilla;066;Navas de la Concepción (Las);2008;1002;1006
41;Sevilla;067;Olivares;7093;3611;3482
41;Sevilla;068;Osuna;17109;8475;8634
41;Sevilla;069;Palacios y Villafranca (Los);31210;15848;15362
41;Sevilla;070;Palomares del Río;2946;1523;1423
41;Sevilla;071;Paradas;7187;3452;3735
41;Sevilla;072;Pedrera;4898;2458;2440
41;Sevilla;073;Pedroso (El);2445;1216;1229
41;Sevilla;074;Peñaflor;4092;2054;2038
41;Sevilla;075;Pilas;11042;5444;5598
41;Sevilla;076;Pruna;3485;1791;1694
41;Sevilla;077;Puebla de Cazalla (La);11133;5609;5524
41;Sevilla;078;Puebla de los Infantes (La);3649;1837;1812
41;Sevilla;079;Puebla del Río (La);16976;8543;8433
41;Sevilla;080;Real de la Jara (El);1745;864;881
41;Sevilla;081;Rinconada (La);23849;11991;11858
41;Sevilla;082;Roda de Andalucía (La);4139;2047;2092
41;Sevilla;083;Ronquillo (El);1373;683;690
41;Sevilla;084;Rubio (El);3687;1851;1836
41;Sevilla;085;Salteras;2712;1361;1351
41;Sevilla;086;San Juan de Aznalfarache;23258;11318;11940
41;Sevilla;088;San Nicolás del Puerto;717;380;337
41;Sevilla;087;Sanlúcar la Mayor;10047;5017;5030
41;Sevilla;089;Santiponce;6557;3293;3264
41;Sevilla;090;Saucejo (El);4144;2080;2064
41;Sevilla;091;Sevilla;714148;342552;371596
41;Sevilla;092;Tocina;8977;4491;4486
41;Sevilla;093;Tomares;15007;7454;7553
41;Sevilla;094;Umbrete;3014;1509;1505
41;Sevilla;095;Utrera;45008;22517;22491
41;Sevilla;096;Valencina de la Concepción;5038;2555;2483
41;Sevilla;902;Villafranco del Guadalquivir;"";"";""
41;Sevilla;097;Villamanrique de la Condesa;3668;1822;1846
41;Sevilla;100;Villanueva de San Juan;1696;840;856
41;Sevilla;098;Villanueva del Ariscal;4172;2006;2166
41;Sevilla;099;Villanueva del Río y Minas;6201;2989;3212
41;Sevilla;101;Villaverde del Río;6765;3443;3322
41;Sevilla;102;Viso del Alcor (El);15600;7915;7685
42;Soria;001;Abejar;384;195;189
42;Soria;003;Adradas;120;61;59
42;Soria;004;Ágreda;3647;1809;1838
42;Soria;006;Alconaba;176;98;78
42;Soria;007;Alcubilla de Avellaneda;254;135;119
42;Soria;008;Alcubilla de las Peñas;109;52;57
42;Soria;009;Aldealafuente;169;83;86
42;Soria;010;Aldealices;38;18;20
42;Soria;011;Aldealpozo;32;15;17
42;Soria;012;Aldealseñor;53;29;24
42;Soria;013;Aldehuela de Periáñez;45;24;21
42;Soria;014;Aldehuelas (Las);155;82;73
42;Soria;015;Alentisque;57;29;28
42;Soria;016;Aliud;54;26;28
42;Soria;017;Almajano;205;100;105
42;Soria;018;Almaluez;363;180;183
42;Soria;019;Almarza;654;349;305
42;Soria;020;Almazán;6012;3010;3002
42;Soria;021;Almazul;207;105;102
42;Soria;022;Almenar de Soria;455;237;218
42;Soria;023;Alpanseque;124;62;62
42;Soria;024;Arancón;131;67;64
42;Soria;025;Arcos de Jalón;2132;1062;1070
42;Soria;026;Arenillas;61;34;27
42;Soria;027;Arévalo de la Sierra;140;71;69
42;Soria;028;Ausejo de la Sierra;61;31;30
42;Soria;029;Baraona;281;139;142
42;Soria;030;Barca;161;85;76
42;Soria;031;Barcones;57;33;24
42;Soria;032;Bayubas de Abajo;304;158;146
42;Soria;033;Bayubas de Arriba;98;50;48
42;Soria;034;Beratón;38;28;10
42;Soria;035;Berlanga de Duero;1297;659;638
42;Soria;036;Blacos;74;42;32
42;Soria;037;Bliecos;67;32;35
42;Soria;038;Borjabad;74;40;34
42;Soria;039;Borobia;420;207;213
42;Soria;041;Buberos;59;26;33
42;Soria;042;Buitrago;59;29;30
42;Soria;043;Burgo de Osma-Ciudad de Osma;5011;2451;2560
42;Soria;044;Cabrejas del Campo;96;53;43
42;Soria;045;Cabrejas del Pinar;513;277;236
42;Soria;046;Calatañazor;76;42;34
42;Soria;048;Caltojar;165;84;81
42;Soria;049;Candilichera;251;129;122
42;Soria;050;Cañamaque;57;31;26
42;Soria;051;Carabantes;42;21;21
42;Soria;052;Caracena;17;9;8
42;Soria;053;Carrascosa de Abajo;48;26;22
42;Soria;054;Carrascosa de la Sierra;17;7;10
42;Soria;055;Casarejos;292;146;146
42;Soria;056;Castilfrío de la Sierra;38;21;17
42;Soria;058;Castillejo de Robledo;240;126;114
42;Soria;057;Castilruiz;362;187;175
42;Soria;059;Centenera de Andaluz;33;14;19
42;Soria;060;Cerbón;57;31;26
42;Soria;061;Cidones;372;204;168
42;Soria;062;Cigudosa;94;53;41
42;Soria;063;Cihuela;119;63;56
42;Soria;064;Ciria;106;48;58
42;Soria;065;Cirujales del Río;45;26;19
42;Soria;068;Coscurita;165;93;72
42;Soria;069;Covaleda;2098;1076;1022
42;Soria;070;Cubilla;98;53;45
42;Soria;071;Cubo de la Solana;319;161;158
42;Soria;073;Cueva de Ágreda;134;67;67
42;Soria;075;Dévanos;169;89;80
42;Soria;076;Deza;439;221;218
42;Soria;078;Duruelo de la Sierra;1500;769;731
42;Soria;079;Escobosa de Almazán;50;28;22
42;Soria;080;Espeja de San Marcelino;292;158;134
42;Soria;081;Espejón;236;120;116
42;Soria;082;Estepa de San Juan;16;8;8
42;Soria;083;Frechilla de Almazán;56;29;27
42;Soria;084;Fresno de Caracena;62;32;30
42;Soria;085;Fuentearmegil;415;221;194
42;Soria;086;Fuentecambrón;78;45;33
42;Soria;087;Fuentecantos;51;25;26
42;Soria;088;Fuentelmonge;168;87;81
42;Soria;089;Fuentelsaz de Soria;70;38;32
42;Soria;090;Fuentepinilla;176;92;84
42;Soria;092;Fuentes de Magaña;123;59;64
42;Soria;093;Fuentestrún;76;45;31
42;Soria;094;Garray;346;177;169
42;Soria;095;Golmayo;569;300;269
42;Soria;096;Gómara;597;292;305
42;Soria;097;Gormaz;27;11;16
42;Soria;098;Herrera de Soria;42;24;18
42;Soria;100;Hinojosa del Campo;62;37;25
42;Soria;103;Langa de Duero;1006;527;479
42;Soria;105;Liceras;74;37;37
42;Soria;106;Losilla (La);22;14;8
42;Soria;107;Magaña;111;55;56
42;Soria;108;Maján;17;8;9
42;Soria;110;Matalebreras;147;70;77
42;Soria;111;Matamala de Almazán;457;234;223
42;Soria;113;Medinaceli;751;387;364
42;Soria;115;Miño de Medinaceli;153;73;80
42;Soria;116;Miño de San Esteban;116;63;53
42;Soria;117;Molinos de Duero;207;110;97
42;Soria;118;Momblona;53;30;23
42;Soria;119;Monteagudo de las Vicarías;334;168;166
42;Soria;120;Montejo de Tiermes;302;166;136
42;Soria;121;Montenegro de Cameros;126;68;58
42;Soria;123;Morón de Almazán;325;156;169
42;Soria;124;Muriel de la Fuente;89;48;41
42;Soria;125;Muriel Viejo;101;49;52
42;Soria;127;Nafría de Ucero;98;49;49
42;Soria;128;Narros;64;31;33
42;Soria;129;Navaleno;950;485;465
42;Soria;130;Nepas;95;54;41
42;Soria;131;Nolay;103;56;47
42;Soria;132;Noviercas;266;125;141
42;Soria;134;Ólvega;3239;1687;1552
42;Soria;135;Oncala;122;75;47
42;Soria;139;Pinilla del Campo;30;17;13
42;Soria;140;Portillo de Soria;25;15;10
42;Soria;141;Póveda de Soria (La);137;67;70
42;Soria;142;Pozalmuro;117;51;66
42;Soria;144;Quintana Redonda;660;345;315
42;Soria;145;Quintanas de Gormaz;211;105;106
42;Soria;148;Quiñonería;19;7;12
42;Soria;149;Rábanos (Los);444;251;193
42;Soria;151;Rebollar;49;28;21
42;Soria;152;Recuerda;159;83;76
42;Soria;153;Rello;49;22;27
42;Soria;154;Renieblas;141;76;65
42;Soria;155;Retortillo de Soria;297;153;144
42;Soria;156;Reznos;61;35;26
42;Soria;157;Riba de Escalote (La);40;21;19
42;Soria;158;Rioseco de Soria;168;86;82
42;Soria;159;Rollamienta;59;31;28
42;Soria;160;Royo (El);396;187;209
42;Soria;161;Salduero;213;114;99
42;Soria;162;San Esteban de Gormaz;3497;1805;1692
42;Soria;163;San Felices;93;58;35
42;Soria;164;San Leonardo de Yagüe;2102;1071;1031
42;Soria;165;San Pedro Manrique;514;260;254
42;Soria;166;Santa Cruz de Yanguas;68;43;25
42;Soria;167;Santa María de Huerta;511;255;256
42;Soria;168;Santa María de las Hoyas;231;120;111
42;Soria;171;Serón de Nágima;334;172;162
42;Soria;172;Soliedra;48;28;20
42;Soria;173;Soria;33317;15849;17468
42;Soria;174;Sotillo del Rincón;209;98;111
42;Soria;175;Suellacabras;49;25;24
42;Soria;176;Tajahuerce;49;23;26
42;Soria;177;Tajueco;148;78;70
42;Soria;178;Talveila;228;121;107
42;Soria;181;Tardelcuende;723;351;372
42;Soria;182;Taroda;90;45;45
42;Soria;183;Tejado;258;128;130
42;Soria;184;Torlengua;139;66;73
42;Soria;185;Torreblacos;53;25;28
42;Soria;187;Torrubia de Soria;112;59;53
42;Soria;188;Trévago;88;40;48
42;Soria;189;Ucero;124;61;63
42;Soria;190;Vadillo;175;91;84
42;Soria;191;Valdeavellano de Tera;238;129;109
42;Soria;192;Valdegeña;60;31;29
42;Soria;193;Valdelagua del Cerro;42;21;21
42;Soria;194;Valdemaluque;349;170;179
42;Soria;195;Valdenebro;175;96;79
42;Soria;196;Valdeprado;22;8;14
42;Soria;197;Valderrodilla;142;67;75
42;Soria;198;Valtajeros;32;17;15
42;Soria;200;Velamazán;163;92;71
42;Soria;201;Velilla de la Sierra;20;8;12
42;Soria;202;Velilla de los Ajos;53;29;24
42;Soria;204;Viana de Duero;89;47;42
42;Soria;205;Villaciervos;89;47;42
42;Soria;206;Villanueva de Gormaz;24;13;11
42;Soria;207;Villar del Ala;49;22;27
42;Soria;208;Villar del Campo;42;22;20
42;Soria;209;Villar del Río;208;116;92
42;Soria;211;Villares de Soria (Los);131;61;70
42;Soria;212;Villasayas;122;75;47
42;Soria;213;Villaseca de Arciel;53;29;24
42;Soria;215;Vinuesa;1134;603;531
42;Soria;216;Vizmanos;46;28;18
42;Soria;217;Vozmediano;65;36;29
42;Soria;218;Yanguas;79;43;36
42;Soria;219;Yelo;82;44;38
43;Tarragona;001;Aiguamúrcia;580;303;277
43;Tarragona;002;Albinyana;1061;548;513
43;Tarragona;003;Albiol (L');151;76;75
43;Tarragona;004;Alcanar;8033;4009;4024
43;Tarragona;005;Alcover;3425;1742;1683
43;Tarragona;904;Aldea (L');3618;1811;1807
43;Tarragona;006;Aldover;817;394;423
43;Tarragona;007;Aleixar (L');621;310;311
43;Tarragona;008;Alfara de Carles;382;206;176
43;Tarragona;009;Alforja;1151;571;580
43;Tarragona;010;Alió;336;165;171
43;Tarragona;011;Almoster;586;288;298
43;Tarragona;012;Altafulla;2254;1134;1120
43;Tarragona;013;Ametlla de Mar (L');4367;2184;2183
43;Tarragona;906;Ampolla (L');1662;808;854
43;Tarragona;014;Amposta;15564;7736;7828
43;Tarragona;016;Arboç (L');3536;1809;1727
43;Tarragona;015;Arbolí;142;72;70
43;Tarragona;017;Argentera (L');135;70;65
43;Tarragona;018;Arnes;535;275;260
43;Tarragona;019;Ascó;1800;919;881
43;Tarragona;020;Banyeres del Penedès;1515;786;729
43;Tarragona;021;Barberà de la Conca;430;218;212
43;Tarragona;022;Batea;2013;1022;991
43;Tarragona;023;Bellmunt del Priorat;299;146;153
43;Tarragona;024;Bellvei;1132;602;530
43;Tarragona;025;Benifallet;927;467;460
43;Tarragona;026;Benissanet;1005;487;518
43;Tarragona;027;Bisbal de Falset (La);252;125;127
43;Tarragona;028;Bisbal del Penedès (La);1535;793;742
43;Tarragona;029;Blancafort;399;195;204
43;Tarragona;030;Bonastre;293;147;146
43;Tarragona;031;Borges del Camp (Les);1454;723;731
43;Tarragona;032;Bot;893;450;443
43;Tarragona;033;Botarell;491;245;246
43;Tarragona;034;Bràfim;562;275;287
43;Tarragona;035;Cabacés;340;177;163
43;Tarragona;036;Cabra del Camp;469;253;216
43;Tarragona;037;Calafell;9004;4505;4499
43;Tarragona;903;Camarles;2855;1424;1431
43;Tarragona;038;Cambrils;16547;8292;8255
43;Tarragona;039;Capafonts;102;48;54
43;Tarragona;040;Capçanes;401;182;219
43;Tarragona;041;Caseres;342;169;173
43;Tarragona;042;Castellvell del Camp;969;485;484
43;Tarragona;043;Catllar (El);1560;801;759
43;Tarragona;045;Colldejou;194;103;91
43;Tarragona;046;Conesa;126;58;68
43;Tarragona;047;Constantí;5382;2786;2596
43;Tarragona;048;Corbera d'Ebre;1104;577;527
43;Tarragona;049;Cornudella de Montsant;837;425;412
43;Tarragona;050;Creixell;1292;673;619
43;Tarragona;051;Cunit;3669;1905;1764
43;Tarragona;901;Deltebre;10408;5235;5173
43;Tarragona;053;Duesaigües;219;131;88
43;Tarragona;054;Espluga de Francolí (L');3627;1777;1850
43;Tarragona;055;Falset;2557;1266;1291
43;Tarragona;056;Fatarella (La);1347;676;671
43;Tarragona;057;Febró (La);64;35;29
43;Tarragona;058;Figuera (La);130;64;66
43;Tarragona;059;Figuerola del Camp;208;104;104
43;Tarragona;060;Flix;4815;2418;2397
43;Tarragona;061;Forès;62;31;31
43;Tarragona;062;Freginals;360;171;189
43;Tarragona;063;Galera (La);749;364;385
43;Tarragona;064;Gandesa;2675;1332;1343
43;Tarragona;065;Garcia;560;277;283
43;Tarragona;066;Garidells (Els);182;92;90
43;Tarragona;067;Ginestar;878;454;424
43;Tarragona;068;Godall;762;380;382
43;Tarragona;069;Gratallops;228;108;120
43;Tarragona;070;Guiamets (Els);297;146;151
43;Tarragona;071;Horta de Sant Joan;1311;674;637
43;Tarragona;072;Lloar (El);133;68;65
43;Tarragona;073;Llorac;106;54;52
43;Tarragona;074;Llorenç del Penedès;1384;673;711
43;Tarragona;076;Marçà;598;292;306
43;Tarragona;075;Margalef;152;81;71
43;Tarragona;077;Mas de Barberans;751;375;376
43;Tarragona;078;Masdenverge;933;480;453
43;Tarragona;079;Masllorenç;388;195;193
43;Tarragona;080;Masó (La);257;125;132
43;Tarragona;081;Maspujols;401;208;193
43;Tarragona;082;Masroig (El);534;253;281
43;Tarragona;083;Milà (El);151;70;81
43;Tarragona;084;Miravet;832;425;407
43;Tarragona;085;Molar (El);305;154;151
43;Tarragona;086;Montblanc;5937;2941;2996
43;Tarragona;088;Montbrió del Camp;1416;691;725
43;Tarragona;089;Montferri;161;82;79
43;Tarragona;090;Montmell (El);280;141;139
43;Tarragona;091;Mont-ral;142;68;74
43;Tarragona;092;Mont-roig del Camp;5354;2763;2591
43;Tarragona;093;Móra d'Ebre;4653;2299;2354
43;Tarragona;094;Móra la Nova;2763;1371;1392
43;Tarragona;095;Morell (El);2314;1187;1127
43;Tarragona;096;Morera de Montsant (La);202;100;102
43;Tarragona;097;Nou de Gaià (La);381;183;198
43;Tarragona;098;Nulles;337;160;177
43;Tarragona;100;Pallaresos (Els);1094;585;509
43;Tarragona;099;Palma d'Ebre (La);438;208;230
43;Tarragona;101;Passanant;184;104;80
43;Tarragona;102;Paüls;698;361;337
43;Tarragona;103;Perafort;517;265;252
43;Tarragona;104;Perelló (El);2184;1114;1070
43;Tarragona;105;Piles (Les);150;82;68
43;Tarragona;106;Pinell de Brai (El);1159;592;567
43;Tarragona;107;Pira;321;151;170
43;Tarragona;108;Pla de Santa Maria (El);1652;840;812
43;Tarragona;109;Pobla de Mafumet (La);944;472;472
43;Tarragona;110;Pobla de Massaluca (La);457;233;224
43;Tarragona;111;Pobla de Montornès (La);1093;611;482
43;Tarragona;112;Poboleda;373;192;181
43;Tarragona;113;Pont d'Armentera (El);606;300;306
43;Tarragona;141;Pontils;119;59;60
43;Tarragona;114;Porrera;445;232;213
43;Tarragona;115;Pradell de la Teixeta;247;128;119
43;Tarragona;116;Prades;536;280;256
43;Tarragona;117;Prat de Comte;206;97;109
43;Tarragona;118;Pratdip;437;217;220
43;Tarragona;119;Puigpelat;468;232;236
43;Tarragona;120;Querol;204;111;93
43;Tarragona;121;Rasquera;866;439;427
43;Tarragona;122;Renau;61;33;28
43;Tarragona;123;Reus;90059;44247;45812
43;Tarragona;124;Riba (La);858;433;425
43;Tarragona;125;Riba-roja d'Ebre;1562;806;756
43;Tarragona;126;Riera de Gaià (La);936;454;482
43;Tarragona;127;Riudecanyes;590;299;291
43;Tarragona;128;Riudecols;957;485;472
43;Tarragona;129;Riudoms;4901;2465;2436
43;Tarragona;130;Rocafort de Queralt;256;135;121
43;Tarragona;131;Roda de Barà;2623;1394;1229
43;Tarragona;132;Rodonyà;382;192;190
43;Tarragona;133;Roquetes;5952;2959;2993
43;Tarragona;134;Rourell (El);266;146;120
43;Tarragona;135;Salomó;430;220;210
43;Tarragona;905;Salou;9631;4898;4733
43;Tarragona;136;Sant Carles de la Ràpita;10805;5386;5419
43;Tarragona;137;Sant Jaume dels Domenys;1277;656;621
43;Tarragona;902;Sant Jaume d'Enveja;3447;1742;1705
43;Tarragona;138;Santa Bàrbara;3395;1683;1712
43;Tarragona;139;Santa Coloma de Queralt;2556;1255;1301
43;Tarragona;140;Santa Oliva;1742;909;833
43;Tarragona;142;Sarral;1406;714;692
43;Tarragona;143;Savallà del Comtat;64;30;34
43;Tarragona;144;Secuita (La);1056;523;533
43;Tarragona;145;Selva del Camp (La);3624;1795;1829
43;Tarragona;146;Senan;26;16;10
43;Tarragona;044;Sénia (La);5057;2569;2488
43;Tarragona;147;Solivella;706;336;370
43;Tarragona;148;Tarragona;114630;56185;58445
43;Tarragona;149;Tivenys;1020;507;513
43;Tarragona;150;Tivissa;1768;883;885
43;Tarragona;151;Torre de Fontaubella (La);80;34;46
43;Tarragona;152;Torre de l'Espanyol (La);700;358;342
43;Tarragona;153;Torredembarra;8090;4040;4050
43;Tarragona;154;Torroja del Priorat;140;80;60
43;Tarragona;155;Tortosa;30430;14781;15649
43;Tarragona;156;Ulldecona;5196;2570;2626
43;Tarragona;157;Ulldemolins;522;260;262
43;Tarragona;158;Vallclara;112;55;57
43;Tarragona;159;Vallfogona de Riucorb;107;66;41
43;Tarragona;160;Vallmoll;1115;560;555
43;Tarragona;161;Valls;20263;9958;10305
43;Tarragona;162;Vandellòs i l'Hospitalet de l'Infant;4454;2249;2205
43;Tarragona;163;Vendrell (El);17089;8482;8607
43;Tarragona;164;Vespella de Gaià;120;70;50
43;Tarragona;165;Vilabella;841;416;425
43;Tarragona;175;Vilalba dels Arcs;784;414;370
43;Tarragona;166;Vilallonga del Camp;1213;610;603
43;Tarragona;168;Vilanova de Prades;156;79;77
43;Tarragona;167;Vilanova d'Escornalbou;437;217;220
43;Tarragona;169;Vilaplana;518;269;249
43;Tarragona;170;Vila-rodona;1026;535;491
43;Tarragona;171;Vila-seca;12380;6251;6129
43;Tarragona;172;Vilaverd;373;187;186
43;Tarragona;173;Vilella Alta (La);134;69;65
43;Tarragona;174;Vilella Baixa (La);160;85;75
43;Tarragona;176;Vimbodí;1106;576;530
43;Tarragona;177;Vinebre;451;212;239
43;Tarragona;178;Vinyols i els Arcs;923;507;416
43;Tarragona;052;Xerta;1243;607;636
44;Teruel;001;Ababuj;86;50;36
44;Teruel;002;Abejuela;75;44;31
44;Teruel;003;Aguatón;29;14;15
44;Teruel;004;Aguaviva;638;315;323
44;Teruel;005;Aguilar del Alfambra;89;42;47
44;Teruel;006;Alacón;509;263;246
44;Teruel;007;Alba;310;160;150
44;Teruel;008;Albalate del Arzobispo;2481;1222;1259
44;Teruel;009;Albarracín;1066;525;541
44;Teruel;010;Albentosa;277;134;143
44;Teruel;011;Alcaine;55;27;28
44;Teruel;012;Alcalá de la Selva;443;231;212
44;Teruel;013;Alcañiz;12802;6286;6516
44;Teruel;014;Alcorisa;3254;1640;1614
44;Teruel;016;Alfambra;733;365;368
44;Teruel;017;Aliaga;457;235;222
44;Teruel;021;Allepuz;160;86;74
44;Teruel;022;Alloza;890;427;463
44;Teruel;023;Allueva;15;8;7
44;Teruel;018;Almohaja;38;22;16
44;Teruel;019;Alobras;107;56;51
44;Teruel;020;Alpeñés;35;20;15
44;Teruel;024;Anadón;27;13;14
44;Teruel;025;Andorra;8574;4441;4133
44;Teruel;026;Arcos de las Salinas;192;99;93
44;Teruel;027;Arens de Lledó;261;120;141
44;Teruel;028;Argente;282;142;140
44;Teruel;029;Ariño;954;478;476
44;Teruel;031;Azaila;219;121;98
44;Teruel;032;Bádenas;28;12;16
44;Teruel;033;Báguena;582;292;290
44;Teruel;034;Bañón;212;110;102
44;Teruel;035;Barrachina;186;92;94
44;Teruel;036;Bea;44;26;18
44;Teruel;037;Beceite;688;358;330
44;Teruel;039;Bello;459;215;244
44;Teruel;038;Belmonte de San José;156;80;76
44;Teruel;040;Berge;248;132;116
44;Teruel;041;Bezas;77;40;37
44;Teruel;042;Blancas;232;117;115
44;Teruel;043;Blesa;163;94;69
44;Teruel;044;Bordón;141;76;65
44;Teruel;045;Bronchales;476;244;232
44;Teruel;046;Bueña;119;65;54
44;Teruel;047;Burbáguena;355;157;198
44;Teruel;048;Cabra de Mora;97;51;46
44;Teruel;049;Calaceite;1287;655;632
44;Teruel;050;Calamocha;4202;2095;2107
44;Teruel;051;Calanda;3540;1791;1749
44;Teruel;052;Calomarde;106;53;53
44;Teruel;053;Camañas;152;86;66
44;Teruel;054;Camarena de la Sierra;158;83;75
44;Teruel;055;Camarillas;141;75;66
44;Teruel;056;Caminreal;875;422;453
44;Teruel;059;Cantavieja;752;394;358
44;Teruel;060;Cañada de Benatanduz;75;46;29
44;Teruel;061;Cañada de Verich (La);109;60;49
44;Teruel;062;Cañada Vellida;67;42;25
44;Teruel;063;Cañizar del Olivar;142;71;71
44;Teruel;064;Cascante del Río;131;78;53
44;Teruel;065;Castejón de Tornos;114;55;59
44;Teruel;066;Castel de Cabra;210;108;102
44;Teruel;070;Castellar (El);96;50;46
44;Teruel;071;Castellote;853;416;437
44;Teruel;067;Castelnou;124;65;59
44;Teruel;068;Castelserás;895;468;427
44;Teruel;074;Cedrillas;556;292;264
44;Teruel;075;Celadas;490;257;233
44;Teruel;076;Cella;3135;1605;1530
44;Teruel;077;Cerollera (La);91;49;42
44;Teruel;080;Codoñera (La);366;191;175
44;Teruel;082;Corbalán;72;43;29
44;Teruel;084;Cortes de Aragón;137;67;70
44;Teruel;085;Cosa;121;65;56
44;Teruel;086;Cretas;689;349;340
44;Teruel;087;Crivillén;158;77;81
44;Teruel;088;Cuba (La);72;36;36
44;Teruel;089;Cubla;64;34;30
44;Teruel;090;Cucalón;93;47;46
44;Teruel;092;Cuervo (El);149;74;75
44;Teruel;093;Cuevas de Almudén;114;60;54
44;Teruel;094;Cuevas Labradas;204;106;98
44;Teruel;096;Ejulve;247;122;125
44;Teruel;097;Escorihuela;263;130;133
44;Teruel;099;Escucha;1162;629;533
44;Teruel;100;Estercuel;422;215;207
44;Teruel;101;Ferreruela de Huerva;94;49;45
44;Teruel;102;Fonfría;34;19;15
44;Teruel;103;Formiche Alto;201;107;94
44;Teruel;105;Fórnoles;125;55;70
44;Teruel;106;Fortanete;215;108;107
44;Teruel;107;Foz-Calanda;257;141;116
44;Teruel;108;Fresneda (La);473;247;226
44;Teruel;109;Frías de Albarracín;193;99;94
44;Teruel;110;Fuenferrada;51;27;24
44;Teruel;111;Fuentes Calientes;144;75;69
44;Teruel;112;Fuentes Claras;727;358;369
44;Teruel;113;Fuentes de Rubielos;77;39;38
44;Teruel;114;Fuentespalda;415;207;208
44;Teruel;115;Galve;160;84;76
44;Teruel;116;Gargallo;138;76;62
44;Teruel;117;Gea de Albarracín;500;255;245
44;Teruel;118;Ginebrosa (La);282;156;126
44;Teruel;119;Griegos;156;91;65
44;Teruel;120;Guadalaviar;295;150;145
44;Teruel;121;Gúdar;85;52;33
44;Teruel;122;Híjar;2063;1026;1037
44;Teruel;123;Hinojosa de Jarque;206;112;94
44;Teruel;124;Hoz de la Vieja (La);150;76;74
44;Teruel;125;Huesa del Común;152;79;73
44;Teruel;126;Iglesuela del Cid (La);507;264;243
44;Teruel;127;Jabaloyas;103;56;47
44;Teruel;128;Jarque de la Val;119;63;56
44;Teruel;129;Jatiel;73;33;40
44;Teruel;130;Jorcas;65;40;25
44;Teruel;131;Josa;41;22;19
44;Teruel;132;Lagueruela;84;46;38
44;Teruel;133;Lanzuela;38;23;15
44;Teruel;135;Libros;204;102;102
44;Teruel;136;Lidón;95;48;47
44;Teruel;137;Linares de Mora;335;187;148
44;Teruel;141;Lledó;218;109;109
44;Teruel;138;Loscos;243;131;112
44;Teruel;142;Maicas;22;9;13
44;Teruel;143;Manzanera;497;258;239
44;Teruel;144;Martín del Río;542;279;263
44;Teruel;145;Mas de las Matas;1505;755;750
44;Teruel;146;Mata de los Olmos (La);270;131;139
44;Teruel;147;Mazaleón;626;323;303
44;Teruel;148;Mezquita de Jarque;163;84;79
44;Teruel;149;Mirambel;155;83;72
44;Teruel;150;Miravete de la Sierra;52;30;22
44;Teruel;151;Molinos;382;193;189
44;Teruel;152;Monforte de Moyuela;96;53;43
44;Teruel;153;Monreal del Campo;2330;1161;1169
44;Teruel;154;Monroyo;393;199;194
44;Teruel;155;Montalbán;1706;854;852
44;Teruel;156;Monteagudo del Castillo;82;46;36
44;Teruel;157;Monterde de Albarracín;84;41;43
44;Teruel;158;Mora de Rubielos;1364;706;658
44;Teruel;159;Moscardón;61;32;29
44;Teruel;160;Mosqueruela;702;362;340
44;Teruel;161;Muniesa;794;406;388
44;Teruel;163;Noguera de Albarracín;171;86;85
44;Teruel;164;Nogueras;26;18;8
44;Teruel;165;Nogueruelas;246;127;119
44;Teruel;167;Obón;68;30;38
44;Teruel;168;Odón;295;142;153
44;Teruel;169;Ojos Negros;651;336;315
44;Teruel;171;Olba;228;114;114
44;Teruel;172;Oliete;542;271;271
44;Teruel;173;Olmos (Los);168;94;74
44;Teruel;174;Orihuela del Tremedal;625;312;313
44;Teruel;175;Orrios;222;114;108
44;Teruel;176;Palomar de Arroyos;297;159;138
44;Teruel;177;Pancrudo;240;124;116
44;Teruel;178;Parras de Castellote (Las);108;59;49
44;Teruel;179;Peñarroya de Tastavins;575;296;279
44;Teruel;180;Peracense;121;61;60
44;Teruel;181;Peralejos;104;53;51
44;Teruel;182;Perales del Alfambra;309;166;143
44;Teruel;183;Pitarque;119;56;63
44;Teruel;184;Plou;57;28;29
44;Teruel;185;Pobo (El);164;94;70
44;Teruel;187;Portellada (La);353;184;169
44;Teruel;189;Pozondón;98;50;48
44;Teruel;190;Pozuel del Campo;138;75;63
44;Teruel;191;Puebla de Híjar (La);1190;580;610
44;Teruel;192;Puebla de Valverde (La);478;252;226
44;Teruel;193;Puertomingalvo;135;68;67
44;Teruel;194;Ráfales;251;130;121
44;Teruel;195;Rillo;160;87;73
44;Teruel;196;Riodeva;266;130;136
44;Teruel;197;Ródenas;97;48;49
44;Teruel;198;Royuela;243;134;109
44;Teruel;199;Rubiales;64;35;29
44;Teruel;200;Rubielos de la Cérida;64;30;34
44;Teruel;201;Rubielos de Mora;636;322;314
44;Teruel;203;Salcedillo;12;5;7
44;Teruel;204;Saldón;49;30;19
44;Teruel;205;Samper de Calanda;1131;548;583
44;Teruel;206;San Agustín;156;82;74
44;Teruel;207;San Martín del Río;341;164;177
44;Teruel;208;Santa Cruz de Nogueras;33;20;13
44;Teruel;209;Santa Eulalia;1344;641;703
44;Teruel;210;Sarrión;1049;547;502
44;Teruel;211;Segura de los Baños;59;32;27
44;Teruel;212;Seno;53;28;25
44;Teruel;213;Singra;104;51;53
44;Teruel;215;Terriente;195;107;88
44;Teruel;216;Teruel;29971;14598;15373
44;Teruel;217;Toril y Masegoso;42;25;17
44;Teruel;218;Tormón;45;24;21
44;Teruel;219;Tornos;290;150;140
44;Teruel;220;Torralba de los Sisones;243;126;117
44;Teruel;223;Torre de Arcas;122;59;63
44;Teruel;224;Torre de las Arcas;45;25;20
44;Teruel;225;Torre del Compte;196;93;103
44;Teruel;227;Torre los Negros;102;51;51
44;Teruel;221;Torrecilla de Alcañiz;465;241;224
44;Teruel;222;Torrecilla del Rebollar;189;101;88
44;Teruel;226;Torrelacárcel;337;173;164
44;Teruel;228;Torremocha de Jiloca;195;93;102
44;Teruel;229;Torres de Albarracín;176;89;87
44;Teruel;230;Torrevelilla;224;108;116
44;Teruel;231;Torrijas;104;51;53
44;Teruel;232;Torrijo del Campo;639;317;322
44;Teruel;234;Tramacastiel;132;61;71
44;Teruel;235;Tramacastilla;142;70;72
44;Teruel;236;Tronchón;107;54;53
44;Teruel;237;Urrea de Gaén;685;332;353
44;Teruel;238;Utrillas;3610;1855;1755
44;Teruel;239;Valacloche;29;15;14
44;Teruel;240;Valbona;212;111;101
44;Teruel;241;Valdealgorfa;818;403;415
44;Teruel;243;Valdecuenca;40;24;16
44;Teruel;244;Valdelinares;129;68;61
44;Teruel;245;Valdeltormo;415;211;204
44;Teruel;246;Valderrobres;1918;969;949
44;Teruel;247;Valjunquera;487;245;242
44;Teruel;249;Vallecillo (El);34;19;15
44;Teruel;250;Veguillas de la Sierra;31;18;13
44;Teruel;251;Villafranca del Campo;417;217;200
44;Teruel;252;Villahermosa del Campo;82;44;38
44;Teruel;256;Villanueva del Rebollar de la Sierra;48;26;22
44;Teruel;257;Villar del Cobo;234;121;113
44;Teruel;258;Villar del Salz;132;70;62
44;Teruel;260;Villarluengo;237;124;113
44;Teruel;261;Villarquemado;1037;517;520
44;Teruel;262;Villarroya de los Pinares;211;107;104
44;Teruel;263;Villastar;363;194;169
44;Teruel;264;Villel;373;185;188
44;Teruel;265;Vinaceite;337;171;166
44;Teruel;266;Visiedo;255;123;132
44;Teruel;267;Vivel del Río Martín;121;65;56
44;Teruel;268;Zoma (La);43;21;22
45;Toledo;001;Ajofrín;2241;1147;1094
45;Toledo;002;Alameda de la Sagra;2822;1500;1322
45;Toledo;003;Albarreal de Tajo;594;303;291
45;Toledo;004;Alcabón;554;282;272
45;Toledo;005;Alcañizo;362;191;171
45;Toledo;006;Alcaudete de la Jara;1552;736;816
45;Toledo;007;Alcolea de Tajo;802;403;399
45;Toledo;008;Aldea en Cabo;193;100;93
45;Toledo;009;Aldeanueva de Barbarroya;884;442;442
45;Toledo;010;Aldeanueva de San Bartolomé;667;324;343
45;Toledo;011;Almendral de la Cañada;455;237;218
45;Toledo;012;Almonacid de Toledo;826;412;414
45;Toledo;013;Almorox;2260;1161;1099
45;Toledo;014;Añover de Tajo;4554;2325;2229
45;Toledo;015;Arcicóllar;557;272;285
45;Toledo;016;Argés;1936;975;961
45;Toledo;017;Azután;377;187;190
45;Toledo;018;Barcience;122;63;59
45;Toledo;019;Bargas;6317;3190;3127
45;Toledo;020;Belvís de la Jara;1847;906;941
45;Toledo;021;Borox;2079;1017;1062
45;Toledo;022;Buenaventura;587;299;288
45;Toledo;023;Burguillos de Toledo;711;353;358
45;Toledo;024;Burujón;1264;653;611
45;Toledo;025;Cabañas de la Sagra;1013;517;496
45;Toledo;026;Cabañas de Yepes;263;138;125
45;Toledo;027;Cabezamesada;580;296;284
45;Toledo;028;Calera y Chozas;3741;1913;1828
45;Toledo;029;Caleruela;343;172;171
45;Toledo;030;Calzada de Oropesa;719;354;365
45;Toledo;031;Camarena;2144;1098;1046
45;Toledo;032;Camarenilla;554;272;282
45;Toledo;033;Campillo de la Jara (El);616;326;290
45;Toledo;034;Camuñas;1798;897;901
45;Toledo;035;Cardiel de los Montes;139;73;66
45;Toledo;036;Carmena;800;407;393
45;Toledo;037;Carpio de Tajo (El);2411;1161;1250
45;Toledo;038;Carranque;1217;615;602
45;Toledo;039;Carriches;319;153;166
45;Toledo;040;Casar de Escalona (El);890;440;450
45;Toledo;041;Casarrubios del Monte;2104;1060;1044
45;Toledo;042;Casasbuenas;249;122;127
45;Toledo;043;Castillo de Bayuela;1052;533;519
45;Toledo;045;Cazalegas;1126;551;575
45;Toledo;046;Cebolla;2704;1351;1353
45;Toledo;047;Cedillo del Condado;1107;565;542
45;Toledo;048;Cerralbos (Los);506;253;253
45;Toledo;049;Cervera de los Montes;428;226;202
45;Toledo;056;Chozas de Canales;980;490;490
45;Toledo;057;Chueca;253;131;122
45;Toledo;050;Ciruelos;321;168;153
45;Toledo;051;Cobeja;1676;857;819
45;Toledo;052;Cobisa;431;218;213
45;Toledo;053;Consuegra;10084;4983;5101
45;Toledo;054;Corral de Almaguer;5979;2968;3011
45;Toledo;055;Cuerva;1241;624;617
45;Toledo;058;Domingo Pérez;527;250;277
45;Toledo;059;Dosbarrios;2060;1045;1015
45;Toledo;060;Erustes;217;114;103
45;Toledo;061;Escalona;1917;960;957
45;Toledo;062;Escalonilla;1499;728;771
45;Toledo;063;Espinoso del Rey;627;317;310
45;Toledo;064;Esquivias;3598;1820;1778
45;Toledo;065;Estrella (La);474;259;215
45;Toledo;066;Fuensalida;7195;3621;3574
45;Toledo;067;Gálvez;3176;1598;1578
45;Toledo;068;Garciotum;162;81;81
45;Toledo;069;Gerindote;1781;910;871
45;Toledo;070;Guadamur;1623;830;793
45;Toledo;071;Guardia (La);2490;1236;1254
45;Toledo;072;Herencias (Las);739;380;359
45;Toledo;073;Herreruela de Oropesa;442;221;221
45;Toledo;074;Hinojosa de San Vicente;518;281;237
45;Toledo;075;Hontanar;114;61;53
45;Toledo;076;Hormigos;419;214;205
45;Toledo;077;Huecas;399;202;197
45;Toledo;078;Huerta de Valdecarábanos;1731;853;878
45;Toledo;079;Iglesuela (La);485;245;240
45;Toledo;080;Illán de Vacas;5;4;1
45;Toledo;081;Illescas;8672;4372;4300
45;Toledo;082;Lagartera;1974;965;1009
45;Toledo;083;Layos;271;136;135
45;Toledo;084;Lillo;2940;1464;1476
45;Toledo;085;Lominchar;1059;556;503
45;Toledo;086;Lucillos;521;258;263
45;Toledo;087;Madridejos;10501;5172;5329
45;Toledo;088;Magán;950;475;475
45;Toledo;089;Malpica de Tajo;1802;921;881
45;Toledo;090;Manzaneque;463;231;232
45;Toledo;091;Maqueda;487;244;243
45;Toledo;092;Marjaliza;330;170;160
45;Toledo;093;Marrupe;138;65;73
45;Toledo;094;Mascaraque;519;244;275
45;Toledo;095;Mata (La);1020;507;513
45;Toledo;096;Mazarambroz;1203;595;608
45;Toledo;097;Mejorada;1113;577;536
45;Toledo;098;Menasalbas;3018;1565;1453
45;Toledo;099;Méntrida;1567;807;760
45;Toledo;100;Mesegar de Tajo;238;115;123
45;Toledo;101;Miguel Esteban;4760;2372;2388
45;Toledo;102;Mocejón;4105;2076;2029
45;Toledo;103;Mohedas de la Jara;700;358;342
45;Toledo;104;Montearagón;491;248;243
45;Toledo;105;Montesclaros;481;231;250
45;Toledo;106;Mora;9326;4562;4764
45;Toledo;107;Nambroca;2046;999;1047
45;Toledo;108;Nava de Ricomalillo (La);794;412;382
45;Toledo;109;Navahermosa;3760;1923;1837
45;Toledo;110;Navalcán;2541;1327;1214
45;Toledo;111;Navalmoralejo;90;45;45
45;Toledo;112;Navalmorales (Los);2751;1374;1377
45;Toledo;113;Navalucillos (Los);2978;1495;1483
45;Toledo;114;Navamorcuende;742;379;363
45;Toledo;115;Noblejas;2939;1472;1467
45;Toledo;116;Noez;974;495;479
45;Toledo;117;Nombela;909;467;442
45;Toledo;118;Novés;1564;786;778
45;Toledo;119;Numancia de la Sagra;1248;646;602
45;Toledo;120;Nuño Gómez;176;89;87
45;Toledo;121;Ocaña;6009;2946;3063
45;Toledo;122;Olías del Rey;3933;1998;1935
45;Toledo;123;Ontígola;869;462;407
45;Toledo;124;Orgaz;2703;1362;1341
45;Toledo;125;Oropesa;2950;1480;1470
45;Toledo;126;Otero;251;122;129
45;Toledo;127;Palomeque;428;213;215
45;Toledo;128;Pantoja;2120;1096;1024
45;Toledo;129;Paredes de Escalona;107;49;58
45;Toledo;130;Parrillas;488;243;245
45;Toledo;131;Pelahustán;387;201;186
45;Toledo;132;Pepino;714;368;346
45;Toledo;133;Polán;3166;1593;1573
45;Toledo;134;Portillo de Toledo;1940;982;958
45;Toledo;135;Puebla de Almoradiel (La);5426;2708;2718
45;Toledo;136;Puebla de Montalbán (La);6601;3292;3309
45;Toledo;137;Pueblanueva (La);1950;975;975
45;Toledo;138;Puente del Arzobispo (El);1604;763;841
45;Toledo;139;Puerto de San Vicente;297;142;155
45;Toledo;140;Pulgar;1192;611;581
45;Toledo;141;Quero;1428;713;715
45;Toledo;142;Quintanar de la Orden;9308;4641;4667
45;Toledo;143;Quismondo;1275;635;640
45;Toledo;144;Real de San Vicente (El);1032;519;513
45;Toledo;145;Recas;2403;1234;1169
45;Toledo;146;Retamoso;192;103;89
45;Toledo;147;Rielves;480;238;242
45;Toledo;148;Robledo del Mazo;573;289;284
45;Toledo;149;Romeral (El);972;472;500
45;Toledo;150;San Bartolomé de las Abiertas;473;241;232
45;Toledo;151;San Martín de Montalbán;768;379;389
45;Toledo;152;San Martín de Pusa;815;432;383
45;Toledo;153;San Pablo de los Montes;2069;1042;1027
45;Toledo;154;San Román de los Montes;608;320;288
45;Toledo;155;Santa Ana de Pusa;379;194;185
45;Toledo;156;Santa Cruz de la Zarza;4419;2213;2206
45;Toledo;157;Santa Cruz del Retamar;1550;789;761
45;Toledo;158;Santa Olalla;2309;1197;1112
45;Toledo;901;Santo Domingo-Caudilla;820;397;423
45;Toledo;159;Sartajada;113;68;45
45;Toledo;160;Segurilla;967;484;483
45;Toledo;161;Seseña;3098;1589;1509
45;Toledo;162;Sevilleja de la Jara;1164;605;559
45;Toledo;163;Sonseca;8952;4500;4452
45;Toledo;164;Sotillo de las Palomas;199;106;93
45;Toledo;165;Talavera de la Reina;75138;37132;38006
45;Toledo;166;Tembleque;2172;1083;1089
45;Toledo;167;Toboso (El);2185;1071;1114
45;Toledo;168;Toledo;64040;31000;33040
45;Toledo;169;Torralba de Oropesa;322;153;169
45;Toledo;171;Torre de Esteban Hambrán (La);1349;696;653
45;Toledo;170;Torrecilla de la Jara;328;176;152
45;Toledo;172;Torrico;977;488;489
45;Toledo;173;Torrijos;9726;4811;4915
45;Toledo;174;Totanés;374;191;183
45;Toledo;175;Turleque;1079;539;540
45;Toledo;176;Ugena;628;336;292
45;Toledo;177;Urda;3123;1553;1570
45;Toledo;179;Valdeverdeja;931;433;498
45;Toledo;180;Valmojado;2261;1154;1107
45;Toledo;181;Velada;2361;1212;1149
45;Toledo;182;Ventas con Peña Aguilera (Las);1442;733;709
45;Toledo;183;Ventas de Retamosa (Las);559;282;277
45;Toledo;184;Ventas de San Julián (Las);246;110;136
45;Toledo;186;Villa de Don Fadrique (La);4266;2084;2182
45;Toledo;185;Villacañas;9035;4481;4554
45;Toledo;187;Villafranca de los Caballeros;5469;2695;2774
45;Toledo;188;Villaluenga de la Sagra;2565;1298;1267
45;Toledo;189;Villamiel de Toledo;329;160;169
45;Toledo;190;Villaminaya;681;337;344
45;Toledo;191;Villamuelas;784;397;387
45;Toledo;192;Villanueva de Alcardete;3310;1667;1643
45;Toledo;193;Villanueva de Bogas;857;421;436
45;Toledo;194;Villarejo de Montalbán;101;49;52
45;Toledo;195;Villarrubia de Santiago;2955;1481;1474
45;Toledo;196;Villaseca de la Sagra;1616;819;797
45;Toledo;197;Villasequilla;2393;1251;1142
45;Toledo;198;Villatobas;2391;1195;1196
45;Toledo;199;Viso de San Juan (El);756;387;369
45;Toledo;200;Yébenes (Los);6598;3303;3295
45;Toledo;201;Yeles;1206;619;587
45;Toledo;202;Yepes;4403;2226;2177
45;Toledo;203;Yuncler;1875;972;903
45;Toledo;204;Yunclillos;598;301;297
45;Toledo;205;Yuncos;2961;1536;1425
46;Valencia/València;001;Ademuz;1253;631;622
46;Valencia/València;002;Ador;1091;547;544
46;Valencia/València;004;Agullent;2196;1060;1136
46;Valencia/València;042;Aielo de Malferit;3894;1927;1967
46;Valencia/València;043;Aielo de Rugat;204;107;97
46;Valencia/València;005;Alaquàs;24729;12330;12399
46;Valencia/València;006;Albaida;5886;2903;2983
46;Valencia/València;007;Albal;9789;4875;4914
46;Valencia/València;008;Albalat de la Ribera;3511;1702;1809
46;Valencia/València;009;Albalat dels Sorells;3548;1737;1811
46;Valencia/València;010;Albalat dels Tarongers;576;291;285
46;Valencia/València;011;Alberic;9484;4679;4805
46;Valencia/València;012;Alborache;914;463;451
46;Valencia/València;013;Alboraya;12574;6153;6421
46;Valencia/València;014;Albuixech;3081;1519;1562
46;Valencia/València;016;Alcàntera de Xúquer;1448;724;724
46;Valencia/València;015;Alcàsser;7387;3707;3680
46;Valencia/València;018;Alcublas;858;430;428
46;Valencia/València;020;Alcúdia de Crespins (L');4207;2100;2107
46;Valencia/València;019;Alcúdia (L');10648;5227;5421
46;Valencia/València;021;Aldaia;23525;11749;11776
46;Valencia/València;022;Alfafar;20360;10088;10272
46;Valencia/València;024;Alfara de Algimia;522;254;268
46;Valencia/València;025;Alfara del Patriarca;2842;1405;1437
46;Valencia/València;026;Alfarp;1363;667;696
46;Valencia/València;027;Alfarrasí;1230;607;623
46;Valencia/València;023;Alfauir;317;162;155
46;Valencia/València;028;Algar de Palancia;397;191;206
46;Valencia/València;029;Algemesí;25838;12758;13080
46;Valencia/València;030;Algimia de Alfara;876;433;443
46;Valencia/València;031;Alginet;12035;5972;6063
46;Valencia/València;032;Almàssera;5552;2693;2859
46;Valencia/València;033;Almiserà;220;111;109
46;Valencia/València;034;Almoines;1838;927;911
46;Valencia/València;035;Almussafes;6676;3344;3332
46;Valencia/València;036;Alpuente;1134;591;543
46;Valencia/València;037;Alquería de la Condesa/Alqueria de la Comtessa (l');1557;740;817
46;Valencia/València;017;Alzira;41082;20014;21068
46;Valencia/València;038;Andilla;253;138;115
46;Valencia/València;039;Anna;2690;1346;1344
46;Valencia/València;040;Antella;1610;805;805
46;Valencia/València;041;Aras de los Olmos;433;240;193
46;Valencia/València;003;Atzeneta d'Albaida;1277;648;629
46;Valencia/València;044;Ayora;5581;2896;2685
46;Valencia/València;046;Barx;1075;523;552
46;Valencia/València;045;Barxeta;1631;819;812
46;Valencia/València;047;Bèlgida;675;324;351
46;Valencia/València;048;Bellreguard;3761;1856;1905
46;Valencia/València;049;Bellús;408;203;205
46;Valencia/València;050;Benagéber;147;79;68
46;Valencia/València;051;Benaguasil;9291;4664;4627
46;Valencia/València;052;Benavites;667;323;344
46;Valencia/València;053;Beneixida;695;334;361
46;Valencia/València;054;Benetússer;14221;7035;7186
46;Valencia/València;055;Beniarjó;1138;544;594
46;Valencia/València;056;Beniatjar;262;131;131
46;Valencia/València;057;Benicolet;484;250;234
46;Valencia/València;060;Benifaió;12480;6152;6328
46;Valencia/València;059;Benifairó de la Valldigna;1646;818;828
46;Valencia/València;058;Benifairó de les Valls;2010;1000;1010
46;Valencia/València;061;Beniflá;148;68;80
46;Valencia/València;062;Benigánim;5436;2794;2642
46;Valencia/València;063;Benimodo;1766;912;854
46;Valencia/València;064;Benimuslem;568;273;295
46;Valencia/València;065;Beniparrell;1437;722;715
46;Valencia/València;066;Benirredrà;999;480;519
46;Valencia/València;067;Benisanó;1659;846;813
46;Valencia/València;068;Benissoda;312;174;138
46;Valencia/València;069;Benisuera;197;90;107
46;Valencia/València;070;Bétera;10905;5412;5493
46;Valencia/València;071;Bicorp;701;348;353
46;Valencia/València;072;Bocairent;4679;2302;2377
46;Valencia/València;073;Bolbaite;1421;715;706
46;Valencia/València;074;Bonrepòs i Mirambell;2440;1205;1235
46;Valencia/València;075;Bufali;218;111;107
46;Valencia/València;076;Bugarra;865;433;432
46;Valencia/València;077;Buñol;9262;4605;4657
46;Valencia/València;078;Burjassot;35202;17418;17784
46;Valencia/València;079;Calles;418;223;195
46;Valencia/València;080;Camporrobles;1471;741;730
46;Valencia/València;081;Canals;12610;6224;6386
46;Valencia/València;082;Canet d'En Berenguer;1690;829;861
46;Valencia/València;083;Carcaixent;20483;9981;10502
46;Valencia/València;084;Càrcer;2010;957;1053
46;Valencia/València;085;Carlet;14494;7127;7367
46;Valencia/València;086;Carrícola;76;33;43
46;Valencia/València;087;Casas Altas;148;76;72
46;Valencia/València;088;Casas Bajas;319;167;152
46;Valencia/València;089;Casinos;2416;1257;1159
46;Valencia/València;090;Castelló de Rugat;2103;1086;1017
46;Valencia/València;091;Castellonet de la Conquesta;113;57;56
46;Valencia/València;092;Castielfabib;645;340;305
46;Valencia/València;093;Catadau;2225;1091;1134
46;Valencia/València;094;Catarroja;21157;10378;10779
46;Valencia/València;095;Caudete de las Fuentes;891;449;442
46;Valencia/València;096;Cerdà;272;136;136
46;Valencia/València;107;Chella;2549;1255;1294
46;Valencia/València;106;Chelva;2184;1105;1079
46;Valencia/València;108;Chera;615;318;297
46;Valencia/València;109;Cheste;6827;3442;3385
46;Valencia/València;111;Chiva;8157;4080;4077
46;Valencia/València;112;Chulilla;718;353;365
46;Valencia/València;097;Cofrentes;947;473;474
46;Valencia/València;098;Corbera;3195;1547;1648
46;Valencia/València;099;Cortes de Pallás;729;384;345
46;Valencia/València;100;Cotes;403;186;217
46;Valencia/València;105;Cullera;20663;10221;10442
46;Valencia/València;113;Daimús;1293;652;641
46;Valencia/València;114;Domeño;509;266;243
46;Valencia/València;115;Dos Aguas;375;208;167
46;Valencia/València;116;Eliana (L');10387;5224;5163
46;Valencia/València;117;Emperador;163;80;83
46;Valencia/València;118;Enguera;5069;2494;2575
46;Valencia/València;119;Ènova (L');1164;584;580
46;Valencia/València;120;Estivella;1122;526;596
46;Valencia/València;121;Estubeny;137;63;74
46;Valencia/València;122;Faura;2840;1393;1447
46;Valencia/València;123;Favara;1713;833;880
46;Valencia/València;126;Foios;5475;2656;2819
46;Valencia/València;128;Font de la Figuera (La);2200;1092;1108
46;Valencia/València;127;Font d'En Carròs (La);3258;1614;1644
46;Valencia/València;124;Fontanars dels Alforins;965;503;462
46;Valencia/València;125;Fortaleny;999;501;498
46;Valencia/València;129;Fuenterrobles;731;376;355
46;Valencia/València;131;Gandia;57186;27988;29198
46;Valencia/València;130;Gavarda;1304;637;667
46;Valencia/València;132;Genovés;2274;1135;1139
46;Valencia/València;133;Gestalgar;677;318;359
46;Valencia/València;134;Gilet;1333;671;662
46;Valencia/València;135;Godella;10493;5111;5382
46;Valencia/València;136;Godelleta;2030;994;1036
46;Valencia/València;137;Granja de la Costera (La);364;176;188
46;Valencia/València;138;Guadasequies;401;199;202
46;Valencia/València;139;Guadassuar;5430;2715;2715
46;Valencia/València;140;Guardamar de la Safor;64;38;26
46;Valencia/València;141;Higueruelas;582;313;269
46;Valencia/València;142;Jalance;1180;618;562
46;Valencia/València;144;Jarafuel;1046;536;510
46;Valencia/València;154;Llanera de Ranes;1002;500;502
46;Valencia/València;155;Llaurí;1418;687;731
46;Valencia/València;147;Llíria;14732;7289;7443
46;Valencia/València;153;Llocnou de Sant Jeroni;570;286;284
46;Valencia/València;151;Llocnou d'En Fenollet;689;334;355
46;Valencia/València;156;Llombai;2227;1121;1106
46;Valencia/València;157;Llosa de Ranes (La);3644;1870;1774
46;Valencia/València;150;Llutxent;2392;1209;1183
46;Valencia/València;148;Loriguilla;1059;535;524
46;Valencia/València;149;Losa del Obispo;503;241;262
46;Valencia/València;152;Lugar Nuevo de la Corona;121;57;64
46;Valencia/València;158;Macastre;932;449;483
46;Valencia/València;159;Manises;25338;12366;12972
46;Valencia/València;160;Manuel;2472;1186;1286
46;Valencia/València;161;Marines;1253;645;608
46;Valencia/València;162;Masalavés;1495;770;725
46;Valencia/València;163;Massalfassar;1391;691;700
46;Valencia/València;164;Massamagrell;12505;6173;6332
46;Valencia/València;165;Massanassa;7833;3843;3990
46;Valencia/València;166;Meliana;9302;4531;4771
46;Valencia/València;167;Millares;743;376;367
46;Valencia/València;168;Miramar;992;485;507
46;Valencia/València;169;Mislata;40595;19912;20683
46;Valencia/València;170;Mogente/Moixent;4214;2149;2065
46;Valencia/València;171;Moncada;18407;9128;9279
46;Valencia/València;172;Monserrat;2771;1424;1347
46;Valencia/València;173;Montaverner;1679;847;832
46;Valencia/València;174;Montesa;1244;620;624
46;Valencia/València;175;Montichelvo;615;307;308
46;Valencia/València;176;Montroy;1486;769;717
46;Valencia/València;177;Museros;4190;2079;2111
46;Valencia/València;178;Náquera;1820;914;906
46;Valencia/València;179;Navarrés;2763;1373;1390
46;Valencia/València;180;Novelé/Novetlè;623;306;317
46;Valencia/València;181;Oliva;20810;10247;10563
46;Valencia/València;183;Olleria (L');6977;3564;3413
46;Valencia/València;182;Olocau;685;363;322
46;Valencia/València;184;Ontinyent;30848;15169;15679
46;Valencia/València;185;Otos;555;274;281
46;Valencia/València;186;Paiporta;16550;8166;8384
46;Valencia/València;187;Palma de Gandía;1516;756;760
46;Valencia/València;188;Palmera;457;226;231
46;Valencia/València;189;Palomar (El);513;246;267
46;Valencia/València;190;Paterna;45944;22713;23231
46;Valencia/València;191;Pedralba;2058;1039;1019
46;Valencia/València;192;Petrés;781;374;407
46;Valencia/València;193;Picanya;8230;4097;4133
46;Valencia/València;194;Picassent;15334;7722;7612
46;Valencia/València;195;Piles;2110;1019;1091
46;Valencia/València;196;Pinet;252;134;118
46;Valencia/València;199;Pobla de Farnals (La);5161;2580;2581
46;Valencia/València;202;Pobla de Vallbona (La);8614;4423;4191
46;Valencia/València;200;Pobla del Duc (La);2596;1279;1317
46;Valencia/València;203;Pobla Llarga (La);4463;2182;2281
46;Valencia/València;197;Polinyà de Xúquer;3127;1553;1574
46;Valencia/València;198;Potríes;967;467;500
46;Valencia/València;205;Puçol;13205;6530;6675
46;Valencia/València;201;Puebla de San Miguel;65;35;30
46;Valencia/València;204;Puig;6844;3383;3461
46;Valencia/València;101;Quart de les Valls;1075;513;562
46;Valencia/València;102;Quart de Poblet;27721;13735;13986
46;Valencia/València;103;Quartell;1361;663;698
46;Valencia/València;104;Quatretonda;2594;1322;1272
46;Valencia/València;206;Quesa;823;416;407
46;Valencia/València;207;Rafelbuñol/Rafelbunyol;5015;2489;2526
46;Valencia/València;208;Rafelcofer;1437;658;779
46;Valencia/València;209;Rafelguaraf;2455;1202;1253
46;Valencia/València;210;Ráfol de Salem;373;170;203
46;Valencia/València;211;Real de Gandía;1867;880;987
46;Valencia/València;212;Real de Montroi;1853;951;902
46;Valencia/València;213;Requena;18494;9302;9192
46;Valencia/València;214;Riba-roja de Túria;10877;5419;5458
46;Valencia/València;215;Riola;1642;828;814
46;Valencia/València;216;Rocafort;4619;2263;2356
46;Valencia/València;217;Rotglá y Corberá;1036;525;511
46;Valencia/València;218;Rótova;1342;686;656
46;Valencia/València;219;Rugat;194;99;95
46;Valencia/València;220;Sagunto/Sagunt;57630;28286;29344
46;Valencia/València;221;Salem;473;241;232
46;Valencia/València;222;San Juan de Énova;363;158;205
46;Valencia/València;223;Sedaví;8308;4075;4233
46;Valencia/València;224;Segart;190;87;103
46;Valencia/València;225;Sellent;483;249;234
46;Valencia/València;226;Sempere;40;19;21
46;Valencia/València;227;Senyera;838;396;442
46;Valencia/València;228;Serra;1634;827;807
46;Valencia/València;229;Siete Aguas;1075;540;535
46;Valencia/València;230;Silla;16712;8437;8275
46;Valencia/València;231;Simat de la Valldigna;3148;1595;1553
46;Valencia/València;232;Sinarcas;1300;669;631
46;Valencia/València;233;Sollana;4467;2185;2282
46;Valencia/València;234;Sot de Chera;319;165;154
46;Valencia/València;235;Sueca;24426;12000;12426
46;Valencia/València;236;Sumacàrcer;1400;708;692
46;Valencia/València;237;Tavernes Blanques;8481;4184;4297
46;Valencia/València;238;Tavernes de la Valldigna;16432;8177;8255
46;Valencia/València;239;Teresa de Cofrentes;758;383;375
46;Valencia/València;240;Terrateig;203;102;101
46;Valencia/València;241;Titaguas;609;320;289
46;Valencia/València;242;Torrebaja;485;249;236
46;Valencia/València;243;Torrella;213;106;107
46;Valencia/València;244;Torrent;60617;30053;30564
46;Valencia/València;245;Torres Torres;401;190;211
46;Valencia/València;246;Tous;1240;604;636
46;Valencia/València;247;Tuéjar;1375;723;652
46;Valencia/València;248;Turís;4375;2238;2137
46;Valencia/València;249;Utiel;12019;5981;6038
46;Valencia/València;250;Valencia;764293;364580;399713
46;Valencia/València;251;Vallada;3009;1528;1481
46;Valencia/València;252;Vallanca;243;115;128
46;Valencia/València;253;Vallés;101;55;46
46;Valencia/València;254;Venta del Moro;1659;856;803
46;Valencia/València;256;Vilamarxant;5154;2609;2545
46;Valencia/València;255;Villalonga;3583;1786;1797
46;Valencia/València;257;Villanueva de Castellón;7041;3464;3577
46;Valencia/València;258;Villar del Arzobispo;3445;1719;1726
46;Valencia/València;259;Villargordo del Cabriel;770;395;375
46;Valencia/València;260;Vinalesa;2269;1076;1193
46;Valencia/València;145;Xàtiva;25816;12546;13270
46;Valencia/València;143;Xeraco;4693;2354;2339
46;Valencia/València;146;Xeresa;1994;998;996
46;Valencia/València;110;Xirivella;26589;13188;13401
46;Valencia/València;261;Yátova;2026;1058;968
46;Valencia/València;262;Yesa (La);288;143;145
46;Valencia/València;263;Zarra;442;226;216
47;Valladolid;001;Adalia;95;49;46
47;Valladolid;002;Aguasal;28;15;13
47;Valladolid;003;Aguilar de Campos;416;215;201
47;Valladolid;004;Alaejos;1780;919;861
47;Valladolid;005;Alcazarén;790;420;370
47;Valladolid;006;Aldea de San Miguel;253;127;126
47;Valladolid;007;Aldeamayor de San Martín;1133;569;564
47;Valladolid;008;Almenara de Adaja;34;19;15
47;Valladolid;009;Amusquillo;196;104;92
47;Valladolid;010;Arroyo de la Encomienda;1664;848;816
47;Valladolid;011;Ataquines;939;483;456
47;Valladolid;012;Bahabón;247;119;128
47;Valladolid;013;Barcial de la Loma;181;90;91
47;Valladolid;014;Barruelo del Valle;81;43;38
47;Valladolid;015;Becilla de Valderaduey;484;245;239
47;Valladolid;016;Benafarces;103;48;55
47;Valladolid;017;Bercero;301;156;145
47;Valladolid;018;Berceruelo;36;19;17
47;Valladolid;019;Berrueces;113;68;45
47;Valladolid;020;Bobadilla del Campo;436;228;208
47;Valladolid;021;Bocigas;174;86;88
47;Valladolid;022;Bocos de Duero;93;40;53
47;Valladolid;023;Boecillo;1048;539;509
47;Valladolid;024;Bolaños de Campos;404;203;201
47;Valladolid;025;Brahojos de Medina;196;110;86
47;Valladolid;026;Bustillo de Chaves;110;54;56
47;Valladolid;027;Cabezón de Pisuerga;1561;783;778
47;Valladolid;028;Cabezón de Valderaduey;53;27;26
47;Valladolid;029;Cabreros del Monte;112;62;50
47;Valladolid;030;Campaspero;1672;867;805
47;Valladolid;031;Campillo (El);249;135;114
47;Valladolid;032;Camporredondo;239;132;107
47;Valladolid;033;Canalejas de Peñafiel;339;178;161
47;Valladolid;034;Canillas de Esgueva;161;86;75
47;Valladolid;035;Carpio;1284;689;595
47;Valladolid;036;Casasola de Arión;408;218;190
47;Valladolid;037;Castrejón de Trabancos;285;155;130
47;Valladolid;038;Castrillo de Duero;254;132;122
47;Valladolid;039;Castrillo-Tejeriego;301;160;141
47;Valladolid;040;Castrobol;100;46;54
47;Valladolid;041;Castrodeza;267;142;125
47;Valladolid;042;Castromembibre;98;49;49
47;Valladolid;043;Castromonte;509;269;240
47;Valladolid;044;Castronuevo de Esgueva;303;158;145
47;Valladolid;045;Castronuño;1180;614;566
47;Valladolid;046;Castroponce;214;105;109
47;Valladolid;047;Castroverde de Cerrato;307;169;138
47;Valladolid;048;Ceinos de Campos;277;147;130
47;Valladolid;049;Cervillego de la Cruz;171;88;83
47;Valladolid;050;Cigales;2137;1028;1109
47;Valladolid;051;Ciguñuela;380;202;178
47;Valladolid;052;Cistérniga;2149;1103;1046
47;Valladolid;053;Cogeces de Íscar;158;81;77
47;Valladolid;054;Cogeces del Monte;1019;542;477
47;Valladolid;055;Corcos;285;145;140
47;Valladolid;056;Corrales de Duero;166;91;75
47;Valladolid;057;Cubillas de Santa Marta;251;133;118
47;Valladolid;058;Cuenca de Campos;300;148;152
47;Valladolid;059;Curiel de Duero;158;87;71
47;Valladolid;060;Encinas de Esgueva;436;234;202
47;Valladolid;061;Esguevillas de Esgueva;439;226;213
47;Valladolid;062;Fombellida;322;172;150
47;Valladolid;063;Fompedraza;152;85;67
47;Valladolid;064;Fontihoyuelo;51;29;22
47;Valladolid;065;Fresno el Viejo;1351;677;674
47;Valladolid;066;Fuensaldaña;817;408;409
47;Valladolid;067;Fuente el Sol;327;167;160
47;Valladolid;068;Fuente-Olmedo;65;31;34
47;Valladolid;069;Gallegos de Hornija;161;82;79
47;Valladolid;070;Gatón de Campos;66;36;30
47;Valladolid;071;Geria;429;234;195
47;Valladolid;073;Herrín de Campos;234;116;118
47;Valladolid;074;Hornillos de Eresma;148;75;73
47;Valladolid;075;Íscar;6069;3059;3010
47;Valladolid;076;Laguna de Duero;12977;6592;6385
47;Valladolid;077;Langayo;509;272;237
47;Valladolid;079;Llano de Olmedo;110;54;56
47;Valladolid;078;Lomoviejo;279;138;141
47;Valladolid;080;Manzanillo;70;39;31
47;Valladolid;081;Marzales;90;43;47
47;Valladolid;082;Matapozuelos;966;490;476
47;Valladolid;083;Matilla de los Caños;94;52;42
47;Valladolid;084;Mayorga;1714;832;882
47;Valladolid;086;Medina de Rioseco;5045;2477;2568
47;Valladolid;085;Medina del Campo;20165;9944;10221
47;Valladolid;087;Megeces;488;245;243
47;Valladolid;088;Melgar de Abajo;207;105;102
47;Valladolid;089;Melgar de Arriba;326;163;163
47;Valladolid;090;Mojados;2344;1160;1184
47;Valladolid;091;Monasterio de Vega;92;46;46
47;Valladolid;092;Montealegre de Campos;173;96;77
47;Valladolid;093;Montemayor de Pililla;1097;574;523
47;Valladolid;094;Moral de la Reina;251;134;117
47;Valladolid;095;Moraleja de las Panaderas;28;16;12
47;Valladolid;096;Morales de Campos;223;118;105
47;Valladolid;097;Mota del Marqués;487;235;252
47;Valladolid;098;Mucientes;645;325;320
47;Valladolid;099;Mudarra (La);294;153;141
47;Valladolid;100;Muriel;270;138;132
47;Valladolid;101;Nava del Rey;2370;1149;1221
47;Valladolid;102;Nueva Villa de las Torres;429;233;196
47;Valladolid;103;Olivares de Duero;339;182;157
47;Valladolid;104;Olmedo;3645;1790;1855
47;Valladolid;105;Olmos de Esgueva;201;107;94
47;Valladolid;106;Olmos de Peñafiel;93;50;43
47;Valladolid;109;Palazuelo de Vedija;234;127;107
47;Valladolid;110;Parrilla (La);671;327;344
47;Valladolid;111;Pedraja de Portillo (La);1091;538;553
47;Valladolid;112;Pedrajas de San Esteban;3222;1648;1574
47;Valladolid;113;Pedrosa del Rey;259;129;130
47;Valladolid;114;Peñafiel;5209;2648;2561
47;Valladolid;115;Peñaflor de Hornija;495;257;238
47;Valladolid;116;Pesquera de Duero;552;291;261
47;Valladolid;117;Piña de Esgueva;420;219;201
47;Valladolid;118;Piñel de Abajo;251;134;117
47;Valladolid;119;Piñel de Arriba;168;86;82
47;Valladolid;121;Pollos;900;457;443
47;Valladolid;122;Portillo;2578;1310;1268
47;Valladolid;123;Pozal de Gallinas;501;260;241
47;Valladolid;124;Pozaldez;574;280;294
47;Valladolid;125;Pozuelo de la Orden;94;51;43
47;Valladolid;126;Puras;68;34;34
47;Valladolid;127;Quintanilla de Arriba;244;128;116
47;Valladolid;129;Quintanilla de Onésimo;1141;606;535
47;Valladolid;130;Quintanilla de Trigueros;101;51;50
47;Valladolid;128;Quintanilla del Molar;91;38;53
47;Valladolid;131;Rábano;275;141;134
47;Valladolid;132;Ramiro;88;45;43
47;Valladolid;133;Renedo de Esgueva;901;476;425
47;Valladolid;134;Roales de Campos;292;152;140
47;Valladolid;135;Robladillo;103;53;50
47;Valladolid;137;Roturas;28;15;13
47;Valladolid;138;Rubí de Bracamonte;358;192;166
47;Valladolid;139;Rueda;1604;820;784
47;Valladolid;140;Saelices de Mayorga;210;112;98
47;Valladolid;141;Salvador de Zapardiel;216;110;106
47;Valladolid;142;San Cebrián de Mazote;252;134;118
47;Valladolid;143;San Llorente;231;119;112
47;Valladolid;144;San Martín de Valvení;112;64;48
47;Valladolid;145;San Miguel del Arroyo;863;446;417
47;Valladolid;146;San Miguel del Pino;239;129;110
47;Valladolid;147;San Pablo de la Moraleja;197;105;92
47;Valladolid;148;San Pedro de Latarce;707;382;325
47;Valladolid;149;San Pelayo;48;22;26
47;Valladolid;150;San Román de Hornija;513;254;259
47;Valladolid;151;San Salvador;51;26;25
47;Valladolid;156;San Vicente del Palacio;279;140;139
47;Valladolid;152;Santa Eufemia del Arroyo;149;72;77
47;Valladolid;153;Santervás de Campos;190;102;88
47;Valladolid;154;Santibáñez de Valcorba;228;117;111
47;Valladolid;155;Santovenia de Pisuerga;1226;623;603
47;Valladolid;157;Sardón de Duero;642;322;320
47;Valladolid;158;Seca (La);1070;559;511
47;Valladolid;159;Serrada;1037;531;506
47;Valladolid;160;Siete Iglesias de Trabancos;694;348;346
47;Valladolid;161;Simancas;2393;1226;1167
47;Valladolid;162;Tamariz de Campos;117;64;53
47;Valladolid;163;Tiedra;451;217;234
47;Valladolid;164;Tordehumos;593;303;290
47;Valladolid;165;Tordesillas;7825;3936;3889
47;Valladolid;169;Torre de Esgueva;125;58;67
47;Valladolid;170;Torre de Peñafiel;55;28;27
47;Valladolid;166;Torrecilla de la Abadesa;410;220;190
47;Valladolid;167;Torrecilla de la Orden;414;202;212
47;Valladolid;168;Torrecilla de la Torre;47;27;20
47;Valladolid;171;Torrelobatón;640;315;325
47;Valladolid;172;Torrescárcela;187;94;93
47;Valladolid;173;Traspinedo;814;418;396
47;Valladolid;174;Trigueros del Valle;298;152;146
47;Valladolid;175;Tudela de Duero;5434;2772;2662
47;Valladolid;176;Unión de Campos (La);364;173;191
47;Valladolid;177;Urones de Castroponce;198;111;87
47;Valladolid;178;Urueña;219;108;111
47;Valladolid;179;Valbuena de Duero;530;275;255
47;Valladolid;180;Valdearcos de la Vega;165;81;84
47;Valladolid;181;Valdenebro de los Valles;267;140;127
47;Valladolid;182;Valdestillas;1435;732;703
47;Valladolid;183;Valdunquillo;274;129;145
47;Valladolid;186;Valladolid;336917;163189;173728
47;Valladolid;184;Valoria la Buena;689;363;326
47;Valladolid;185;Valverde de Campos;122;65;57
47;Valladolid;187;Vega de Ruiponce;179;83;96
47;Valladolid;188;Vega de Valdetronco;209;113;96
47;Valladolid;189;Velascálvaro;202;106;96
47;Valladolid;190;Velilla;156;85;71
47;Valladolid;191;Velliza;167;93;74
47;Valladolid;192;Ventosa de la Cuesta;163;83;80
47;Valladolid;193;Viana de Cega;1165;600;565
47;Valladolid;195;Villabáñez;465;241;224
47;Valladolid;196;Villabaruz de Campos;54;25;29
47;Valladolid;197;Villabrágima;1308;680;628
47;Valladolid;198;Villacarralón;137;70;67
47;Valladolid;199;Villacid de Campos;118;64;54
47;Valladolid;200;Villaco;161;94;67
47;Valladolid;203;Villafrades de Campos;145;63;82
47;Valladolid;204;Villafranca de Duero;407;202;205
47;Valladolid;205;Villafrechós;552;278;274
47;Valladolid;206;Villafuerte;182;83;99
47;Valladolid;207;Villagarcía de Campos;463;242;221
47;Valladolid;208;Villagómez la Nueva;108;48;60
47;Valladolid;209;Villalán de Campos;53;27;26
47;Valladolid;210;Villalar de los Comuneros;514;262;252
47;Valladolid;211;Villalba de la Loma;56;30;26
47;Valladolid;212;Villalba de los Alcores;614;316;298
47;Valladolid;213;Villalbarba;180;91;89
47;Valladolid;214;Villalón de Campos;2210;1077;1133
47;Valladolid;215;Villamuriel de Campos;93;44;49
47;Valladolid;216;Villán de Tordesillas;179;89;90
47;Valladolid;217;Villanubla;954;499;455
47;Valladolid;218;Villanueva de Duero;886;456;430
47;Valladolid;219;Villanueva de la Condesa;46;29;17
47;Valladolid;220;Villanueva de los Caballeros;320;156;164
47;Valladolid;221;Villanueva de los Infantes;171;89;82
47;Valladolid;222;Villanueva de San Mancio;102;52;50
47;Valladolid;223;Villardefrades;270;144;126
47;Valladolid;224;Villarmentero de Esgueva;131;68;63
47;Valladolid;225;Villasexmir;139;74;65
47;Valladolid;226;Villavaquerín;223;117;106
47;Valladolid;227;Villavellid;70;41;29
47;Valladolid;228;Villaverde de Medina;646;347;299
47;Valladolid;229;Villavicencio de los Caballeros;377;183;194
47;Valladolid;194;Viloria;423;233;190
47;Valladolid;230;Wamba;382;197;185
47;Valladolid;231;Zaratán;1226;622;604
47;Valladolid;232;Zarza (La);182;92;90
48;Vizcaya;001;Abadiño;7030;3564;3466
48;Vizcaya;002;Abanto y Ciérvana-Abanto Zierbena;9731;4866;4865
48;Vizcaya;911;Ajangiz;370;195;175
48;Vizcaya;912;Alonsotegi;3048;1502;1546
48;Vizcaya;003;Amorebieta-Etxano;16064;8065;7999
48;Vizcaya;004;Amoroto;386;207;179
48;Vizcaya;005;Arakaldo;106;58;48
48;Vizcaya;006;Arantzazu;280;133;147
48;Vizcaya;093;Areatza;1119;508;611
48;Vizcaya;009;Arrankudiaga;717;350;367
48;Vizcaya;914;Arratzu;399;201;198
48;Vizcaya;010;Arrieta;437;221;216
48;Vizcaya;011;Arrigorriaga;10402;5151;5251
48;Vizcaya;023;Artea;607;296;311
48;Vizcaya;008;Artzentales;655;359;296
48;Vizcaya;091;Atxondo;1535;766;769
48;Vizcaya;070;Aulesti;686;369;317
48;Vizcaya;012;Bakio;1299;658;641
48;Vizcaya;090;Balmaseda;7303;3533;3770
48;Vizcaya;013;Barakaldo;103594;50962;52632
48;Vizcaya;014;Barrika;907;445;462
48;Vizcaya;015;Basauri;50020;25020;25000
48;Vizcaya;092;Bedia;1028;508;520
48;Vizcaya;016;Berango;4378;2181;2197
48;Vizcaya;017;Bermeo;17820;8829;8991
48;Vizcaya;018;Berriatua;1013;533;480
48;Vizcaya;019;Berriz;4188;2119;2069
48;Vizcaya;020;Bilbao;371876;177558;194318
48;Vizcaya;021;Busturia;1724;863;861
48;Vizcaya;901;Derio;4750;2370;2380
48;Vizcaya;026;Dima;1059;549;510
48;Vizcaya;027;Durango;23044;11351;11693
48;Vizcaya;028;Ea;813;403;410
48;Vizcaya;031;Elantxobe;536;241;295
48;Vizcaya;032;Elorrio;7448;3743;3705
48;Vizcaya;902;Erandio;24646;12149;12497
48;Vizcaya;033;Ereño;283;137;146
48;Vizcaya;034;Ermua;17769;9135;8634
48;Vizcaya;079;Errigoiti;430;231;199
48;Vizcaya;029;Etxebarri, Anteiglesia de San Esteban-Etxebarri Doneztebeko Elizatea;6557;3316;3241
48;Vizcaya;030;Etxebarria;800;418;382
48;Vizcaya;906;Forua;928;475;453
48;Vizcaya;035;Fruiz;319;162;157
48;Vizcaya;036;Galdakao;29600;14774;14826
48;Vizcaya;037;Galdames;818;434;384
48;Vizcaya;038;Gamiz-Fika;948;497;451
48;Vizcaya;039;Garay;256;139;117
48;Vizcaya;040;Gatika;961;487;474
48;Vizcaya;041;Gautegiz Arteaga;763;374;389
48;Vizcaya;046;Gernika-Lumo;15757;7704;8053
48;Vizcaya;044;Getxo;83466;40246;43220
48;Vizcaya;047;Gizaburuaga;134;68;66
48;Vizcaya;042;Gordexola;1508;755;753
48;Vizcaya;043;Gorliz;3266;1608;1658
48;Vizcaya;045;Güeñes;5895;2922;2973
48;Vizcaya;048;Ibarrangelu;550;252;298
48;Vizcaya;094;Igorre;3935;1965;1970
48;Vizcaya;049;Ispaster;612;321;291
48;Vizcaya;910;Iurreta;4801;2368;2433
48;Vizcaya;050;Izurtza;282;145;137
48;Vizcaya;022;Karrantza Harana/Valle de Carranza;3147;1671;1476
48;Vizcaya;907;Kortezubi;393;209;184
48;Vizcaya;051;Lanestosa;302;153;149
48;Vizcaya;052;Larrabetzu;1496;745;751
48;Vizcaya;053;Laukiz;968;504;464
48;Vizcaya;054;Leioa;25644;12697;12947
48;Vizcaya;057;Lekeitio;7560;3712;3848
48;Vizcaya;055;Lemoa;2608;1324;1284
48;Vizcaya;056;Lemoiz;797;411;386
48;Vizcaya;081;Lezama;2037;1031;1006
48;Vizcaya;903;Loiu;1767;900;867
48;Vizcaya;058;Mallabia;1110;589;521
48;Vizcaya;059;Mañaria;510;273;237
48;Vizcaya;060;Markina-Xemein;4837;2393;2444
48;Vizcaya;061;Maruri-Jatabe;557;270;287
48;Vizcaya;062;Mendata;342;185;157
48;Vizcaya;063;Mendexa;337;174;163
48;Vizcaya;064;Meñaka;440;232;208
48;Vizcaya;066;Morga;342;172;170
48;Vizcaya;068;Mundaka;1761;814;947
48;Vizcaya;069;Mungia;12631;6224;6407
48;Vizcaya;007;Munitibar-Arbatzegi Gerrikaitz;429;233;196
48;Vizcaya;908;Murueta;192;94;98
48;Vizcaya;071;Muskiz;6477;3190;3287
48;Vizcaya;067;Muxika;1430;740;690
48;Vizcaya;909;Nabarniz;260;128;132
48;Vizcaya;073;Ondarroa;10632;5326;5306
48;Vizcaya;075;Orozko;1889;953;936
48;Vizcaya;083;Ortuella;8836;4358;4478
48;Vizcaya;072;Otxandio;1078;568;510
48;Vizcaya;077;Plentzia;2878;1393;1485
48;Vizcaya;078;Portugalete;56441;27762;28679
48;Vizcaya;082;Santurtzi;50458;24951;25507
48;Vizcaya;084;Sestao;35660;17425;18235
48;Vizcaya;904;Sondika;3435;1673;1762
48;Vizcaya;085;Sopelana;8870;4436;4434
48;Vizcaya;086;Sopuerta;2204;1126;1078
48;Vizcaya;076;Sukarrieta;317;152;165
48;Vizcaya;087;Trucios-Turtzioz;533;261;272
48;Vizcaya;088;Ubide;155;75;80
48;Vizcaya;065;Ugao-Miraballes;4170;2086;2084
48;Vizcaya;089;Urduliz;2649;1320;1329
48;Vizcaya;074;Urduña-Orduña;4007;2061;1946
48;Vizcaya;080;Valle de Trápaga-Trapagaran;13210;6518;6692
48;Vizcaya;095;Zaldibar;3051;1450;1601
48;Vizcaya;096;Zalla;7495;3697;3798
48;Vizcaya;905;Zamudio;3105;1550;1555
48;Vizcaya;097;Zaratamo;1599;794;805
48;Vizcaya;024;Zeanuri;1143;598;545
48;Vizcaya;025;Zeberio;927;479;448
48;Vizcaya;913;Zierbena;"";"";""
49;Zamora;002;Abezames;121;59;62
49;Zamora;003;Alcañices;1227;630;597
49;Zamora;004;Alcubilla de Nogales;245;120;125
49;Zamora;005;Alfaraz de Sayago;242;129;113
49;Zamora;006;Algodre;236;123;113
49;Zamora;007;Almaraz de Duero;484;239;245
49;Zamora;008;Almeida de Sayago;746;387;359
49;Zamora;009;Andavías;540;254;286
49;Zamora;010;Arcenillas;264;135;129
49;Zamora;011;Arcos de la Polvorosa;324;171;153
49;Zamora;012;Argañín;130;60;70
49;Zamora;013;Argujillo;413;221;192
49;Zamora;014;Arquillinos;198;98;100
49;Zamora;015;Arrabalde;468;227;241
49;Zamora;016;Aspariegos;425;196;229
49;Zamora;017;Asturianos;418;201;217
49;Zamora;018;Ayoó de Vidriales;555;270;285
49;Zamora;019;Barcial del Barco;332;182;150
49;Zamora;020;Belver de los Montes;562;297;265
49;Zamora;021;Benavente;15553;7555;7998
49;Zamora;022;Benegiles;466;254;212
49;Zamora;023;Bermillo de Sayago;1667;862;805
49;Zamora;024;Bóveda de Toro (La);1052;536;516
49;Zamora;025;Bretó;293;150;143
49;Zamora;026;Bretocino;334;181;153
49;Zamora;027;Brime de Sog;279;125;154
49;Zamora;028;Brime de Urz;187;103;84
49;Zamora;029;Burganes de Valverde;916;458;458
49;Zamora;030;Bustillo del Oro;198;98;100
49;Zamora;031;Cabañas de Sayago;238;121;117
49;Zamora;032;Calzadilla de Tera;618;296;322
49;Zamora;033;Camarzana de Tera;1133;560;573
49;Zamora;034;Cañizal;687;353;334
49;Zamora;035;Cañizo;378;187;191
49;Zamora;036;Carbajales de Alba;758;379;379
49;Zamora;037;Carbellino;285;149;136
49;Zamora;038;Casaseca de Campeán;176;94;82
49;Zamora;039;Casaseca de las Chanas;404;199;205
49;Zamora;040;Castrillo de la Guareña;193;95;98
49;Zamora;041;Castrogonzalo;568;293;275
49;Zamora;042;Castronuevo;402;203;199
49;Zamora;043;Castroverde de Campos;470;231;239
49;Zamora;044;Cazurra;102;55;47
49;Zamora;046;Cerecinos de Campos;486;253;233
49;Zamora;047;Cerecinos del Carrizal;177;94;83
49;Zamora;048;Cernadilla;186;86;100
49;Zamora;050;Cobreros;860;422;438
49;Zamora;052;Coomonte;369;192;177
49;Zamora;053;Coreses;1324;687;637
49;Zamora;054;Corrales;1323;648;675
49;Zamora;055;Cotanes del Monte;198;101;97
49;Zamora;056;Cubillos;438;224;214
49;Zamora;057;Cubo de Benavente;249;131;118
49;Zamora;058;Cubo de Tierra del Vino (El);492;252;240
49;Zamora;059;Cuelgamures;157;89;68
49;Zamora;061;Entrala;170;82;88
49;Zamora;062;Espadañedo;259;124;135
49;Zamora;063;Faramontanos de Tábara;580;289;291
49;Zamora;064;Fariza;783;396;387
49;Zamora;065;Fermoselle;1905;912;993
49;Zamora;066;Ferreras de Abajo;675;343;332
49;Zamora;067;Ferreras de Arriba;567;289;278
49;Zamora;068;Ferreruela;739;392;347
49;Zamora;069;Figueruela de Arriba;615;302;313
49;Zamora;071;Fonfría;1281;645;636
49;Zamora;075;Fresno de la Polvorosa;263;133;130
49;Zamora;076;Fresno de la Ribera;442;241;201
49;Zamora;077;Fresno de Sayago;317;162;155
49;Zamora;078;Friera de Valverde;323;164;159
49;Zamora;079;Fuente Encalada;178;94;84
49;Zamora;080;Fuentelapeña;1113;560;553
49;Zamora;082;Fuentes de Ropel;699;360;339
49;Zamora;081;Fuentesaúco;1978;966;1012
49;Zamora;083;Fuentesecas;101;49;52
49;Zamora;084;Fuentespreadas;439;235;204
49;Zamora;085;Galende;1442;716;726
49;Zamora;086;Gallegos del Pan;190;92;98
49;Zamora;087;Gallegos del Río;964;507;457
49;Zamora;088;Gamones;114;65;49
49;Zamora;090;Gema;321;159;162
49;Zamora;091;Granja de Moreruela;411;192;219
49;Zamora;092;Granucillo;293;148;145
49;Zamora;093;Guarrate;423;227;196
49;Zamora;094;Hermisende;510;256;254
49;Zamora;095;Hiniesta (La);441;217;224
49;Zamora;096;Jambrina;301;150;151
49;Zamora;097;Justel;245;130;115
49;Zamora;098;Losacino;392;203;189
49;Zamora;099;Losacio;190;105;85
49;Zamora;100;Lubián;428;212;216
49;Zamora;101;Luelmo;293;155;138
49;Zamora;102;Maderal (El);309;158;151
49;Zamora;103;Madridanos;600;309;291
49;Zamora;104;Mahide;620;325;295
49;Zamora;105;Maire de Castroponce;282;139;143
49;Zamora;107;Malva;281;130;151
49;Zamora;108;Manganeses de la Lampreana;891;455;436
49;Zamora;109;Manganeses de la Polvorosa;963;458;505
49;Zamora;110;Manzanal de Arriba;551;279;272
49;Zamora;112;Manzanal de los Infantes;243;115;128
49;Zamora;111;Manzanal del Barco;240;128;112
49;Zamora;113;Matilla de Arzón;327;176;151
49;Zamora;114;Matilla la Seca;91;47;44
49;Zamora;115;Mayalde;286;145;141
49;Zamora;116;Melgar de Tera;673;334;339
49;Zamora;117;Micereces de Tera;691;358;333
49;Zamora;118;Milles de la Polvorosa;298;147;151
49;Zamora;119;Molacillos;333;178;155
49;Zamora;120;Molezuelas de la Carballeda;167;85;82
49;Zamora;121;Mombuey;540;271;269
49;Zamora;122;Monfarracinos;570;305;265
49;Zamora;123;Montamarta;774;367;407
49;Zamora;124;Moral de Sayago;420;225;195
49;Zamora;126;Moraleja de Sayago;319;170;149
49;Zamora;125;Moraleja del Vino;1238;646;592
49;Zamora;128;Morales de Rey;830;407;423
49;Zamora;129;Morales de Toro;1149;572;577
49;Zamora;130;Morales de Valverde;356;176;180
49;Zamora;127;Morales del Vino;1293;664;629
49;Zamora;131;Moralina;409;220;189
49;Zamora;132;Moreruela de los Infanzones;524;276;248
49;Zamora;133;Moreruela de Tábara;638;332;306
49;Zamora;134;Muelas de los Caballeros;281;145;136
49;Zamora;135;Muelas del Pan;966;471;495
49;Zamora;136;Muga de Sayago;548;266;282
49;Zamora;137;Navianos de Valverde;292;162;130
49;Zamora;138;Olmillos de Castro;504;250;254
49;Zamora;139;Otero de Bodas;307;159;148
49;Zamora;141;Pajares de la Lampreana;569;284;285
49;Zamora;143;Palacios de Sanabria;337;162;175
49;Zamora;142;Palacios del Pan;288;137;151
49;Zamora;145;Pedralba de la Pradería;421;216;205
49;Zamora;146;Pego (El);501;257;244
49;Zamora;147;Peleagonzalo;500;253;247
49;Zamora;148;Peleas de Abajo;218;112;106
49;Zamora;149;Peñausende;635;321;314
49;Zamora;150;Peque;251;122;129
49;Zamora;151;Perdigón (El);913;464;449
49;Zamora;152;Pereruela;857;424;433
49;Zamora;153;Perilla de Castro;290;147;143
49;Zamora;154;Pías;285;148;137
49;Zamora;155;Piedrahita de Castro;172;108;64
49;Zamora;156;Pinilla de Toro;472;238;234
49;Zamora;157;Pino del Oro;268;146;122
49;Zamora;158;Piñero (El);330;188;142
49;Zamora;160;Pobladura de Valderaduey;91;42;49
49;Zamora;159;Pobladura del Valle;387;188;199
49;Zamora;162;Porto;411;204;207
49;Zamora;163;Pozoantiguo;416;210;206
49;Zamora;164;Pozuelo de Tábara;283;138;145
49;Zamora;165;Prado;128;62;66
49;Zamora;166;Puebla de Sanabria;1697;801;896
49;Zamora;167;Pueblica de Valverde;396;200;196
49;Zamora;170;Quintanilla de Urz;151;81;70
49;Zamora;168;Quintanilla del Monte;167;77;90
49;Zamora;169;Quintanilla del Olmo;71;33;38
49;Zamora;171;Quiruelas de Vidriales;1066;516;550
49;Zamora;172;Rabanales;970;497;473
49;Zamora;173;Rábano de Aliste;556;276;280
49;Zamora;174;Requejo;269;132;137
49;Zamora;175;Revellinos;394;198;196
49;Zamora;176;Riofrío de Aliste;1155;610;545
49;Zamora;177;Rionegro del Puente;446;219;227
49;Zamora;178;Roales;354;176;178
49;Zamora;179;Robleda-Cervantes;500;237;263
49;Zamora;180;Roelos de Sayago;176;90;86
49;Zamora;181;Rosinos de la Requejada;632;298;334
49;Zamora;183;Salce;171;92;79
49;Zamora;184;Samir de los Caños;273;145;128
49;Zamora;185;San Agustín del Pozo;222;123;99
49;Zamora;186;San Cebrián de Castro;460;216;244
49;Zamora;187;San Cristóbal de Entreviñas;1664;848;816
49;Zamora;188;San Esteban del Molar;223;125;98
49;Zamora;189;San Justo;396;189;207
49;Zamora;190;San Martín de Valderaduey;103;45;58
49;Zamora;191;San Miguel de la Ribera;460;230;230
49;Zamora;192;San Miguel del Valle;285;132;153
49;Zamora;193;San Pedro de Ceque;737;366;371
49;Zamora;194;San Pedro de la Nave-Almendra;554;277;277
49;Zamora;208;San Vicente de la Cabeza;734;379;355
49;Zamora;209;San Vitero;812;428;384
49;Zamora;197;Santa Clara de Avedillo;295;148;147
49;Zamora;199;Santa Colomba de las Monjas;368;190;178
49;Zamora;200;Santa Cristina de la Polvorosa;1322;668;654
49;Zamora;201;Santa Croya de Tera;556;276;280
49;Zamora;202;Santa Eufemia del Barco;347;188;159
49;Zamora;203;Santa María de la Vega;555;289;266
49;Zamora;204;Santa María de Valverde;127;67;60
49;Zamora;205;Santibáñez de Tera;662;337;325
49;Zamora;206;Santibáñez de Vidriales;1548;758;790
49;Zamora;207;Santovenia;507;253;254
49;Zamora;210;Sanzoles;775;398;377
49;Zamora;214;Tábara;991;501;490
49;Zamora;216;Tapioles;271;149;122
49;Zamora;219;Toro;9553;4638;4915
49;Zamora;220;Torre del Valle (La);213;113;100
49;Zamora;221;Torregamones;404;194;210
49;Zamora;222;Torres del Carrizal;573;294;279
49;Zamora;223;Trabazos;1093;549;544
49;Zamora;224;Trefacio;251;114;137
49;Zamora;225;Uña de Quintana;280;138;142
49;Zamora;226;Vadillo de la Guareña;377;190;187
49;Zamora;227;Valcabado;347;172;175
49;Zamora;228;Valdefinjas;105;58;47
49;Zamora;229;Valdescorriel;201;98;103
49;Zamora;230;Vallesa de la Guareña;208;113;95
49;Zamora;231;Vega de Tera;615;293;322
49;Zamora;232;Vega de Villalobos;192;93;99
49;Zamora;233;Vegalatrave;199;94;105
49;Zamora;234;Venialbo;596;309;287
49;Zamora;235;Vezdemarbán;759;363;396
49;Zamora;236;Vidayanes;136;66;70
49;Zamora;237;Videmala;254;126;128
49;Zamora;238;Villabrázaro;452;226;226
49;Zamora;239;Villabuena del Puente;1101;568;533
49;Zamora;240;Villadepera;309;150;159
49;Zamora;241;Villaescusa;454;231;223
49;Zamora;242;Villafáfila;701;342;359
49;Zamora;243;Villaferrueña;176;90;86
49;Zamora;244;Villageriz;72;38;34
49;Zamora;245;Villalazán;418;210;208
49;Zamora;246;Villalba de la Lampreana;371;192;179
49;Zamora;247;Villalcampo;788;374;414
49;Zamora;248;Villalobos;353;169;184
49;Zamora;249;Villalonso;166;76;90
49;Zamora;250;Villalpando;1840;894;946
49;Zamora;251;Villalube;375;187;188
49;Zamora;252;Villamayor de Campos;648;328;320
49;Zamora;255;Villamor de los Escuderos;630;319;311
49;Zamora;256;Villanázar;421;203;218
49;Zamora;257;Villanueva de Azoague;431;219;212
49;Zamora;258;Villanueva de Campeán;218;111;107
49;Zamora;259;Villanueva de las Peras;238;116;122
49;Zamora;260;Villanueva del Campo;1199;594;605
49;Zamora;263;Villar de Fallaves;127;67;60
49;Zamora;264;Villar del Buey;963;515;448
49;Zamora;261;Villaralbo;1580;792;788
49;Zamora;262;Villardeciervos;581;263;318
49;Zamora;265;Villardiegua de la Ribera;191;91;100
49;Zamora;266;Villárdiga;128;61;67
49;Zamora;267;Villardondiego;165;87;78
49;Zamora;268;Villarrín de Campos;661;335;326
49;Zamora;269;Villaseco del Pan;374;184;190
49;Zamora;270;Villavendimio;245;133;112
49;Zamora;272;Villaveza de Valverde;168;86;82
49;Zamora;271;Villaveza del Agua;321;162;159
49;Zamora;273;Viñas;342;178;164
49;Zamora;275;Zamora;65885;31337;34548
50;Zaragoza;001;Abanto;207;107;100
50;Zaragoza;002;Acered;302;157;145
50;Zaragoza;003;Agón;218;113;105
50;Zaragoza;004;Aguarón;756;372;384
50;Zaragoza;005;Aguilón;264;133;131
50;Zaragoza;006;Ainzón;1214;603;611
50;Zaragoza;007;Aladrén;69;37;32
50;Zaragoza;008;Alagón;5618;2777;2841
50;Zaragoza;009;Alarba;177;100;77
50;Zaragoza;010;Alberite de San Juan;112;58;54
50;Zaragoza;011;Albeta;139;67;72
50;Zaragoza;012;Alborge;127;62;65
50;Zaragoza;013;Alcalá de Ebro;331;162;169
50;Zaragoza;014;Alcalá de Moncayo;167;95;72
50;Zaragoza;015;Alconchel de Ariza;185;99;86
50;Zaragoza;016;Aldehuela de Liestos;79;41;38
50;Zaragoza;017;Alfajarín;1465;761;704
50;Zaragoza;018;Alfamén;1304;697;607
50;Zaragoza;019;Alforque;91;49;42
50;Zaragoza;020;Alhama de Aragón;1216;597;619
50;Zaragoza;021;Almochuel;49;28;21
50;Zaragoza;022;Almolda (La);727;357;370
50;Zaragoza;023;Almonacid de la Cuba;373;193;180
50;Zaragoza;024;Almonacid de la Sierra;842;433;409
50;Zaragoza;025;Almunia de Doña Godina (La);5206;2659;2547
50;Zaragoza;026;Alpartir;631;332;299
50;Zaragoza;027;Ambel;399;192;207
50;Zaragoza;028;Anento;102;53;49
50;Zaragoza;029;Aniñón;945;492;453
50;Zaragoza;030;Añón de Moncayo;324;185;139
50;Zaragoza;031;Aranda de Moncayo;267;146;121
50;Zaragoza;032;Arándiga;569;278;291
50;Zaragoza;033;Ardisa;78;40;38
50;Zaragoza;034;Ariza;1375;685;690
50;Zaragoza;035;Artieda;102;56;46
50;Zaragoza;036;Asín;101;49;52
50;Zaragoza;037;Atea;271;145;126
50;Zaragoza;038;Ateca;2104;1022;1082
50;Zaragoza;039;Azuara;792;416;376
50;Zaragoza;040;Badules;117;59;58
50;Zaragoza;041;Bagüés;27;16;11
50;Zaragoza;042;Balconchán;34;19;15
50;Zaragoza;043;Bárboles;339;176;163
50;Zaragoza;044;Bardallur;319;153;166
50;Zaragoza;045;Belchite;1687;850;837
50;Zaragoza;046;Belmonte de Gracián;333;182;151
50;Zaragoza;047;Berdejo;46;25;21
50;Zaragoza;048;Berrueco;38;21;17
50;Zaragoza;901;Biel;227;122;105
50;Zaragoza;050;Bijuesca;144;80;64
50;Zaragoza;051;Biota;1300;680;620
50;Zaragoza;052;Bisimbre;147;68;79
50;Zaragoza;053;Boquiñeni;1050;532;518
50;Zaragoza;054;Bordalba;109;60;49
50;Zaragoza;055;Borja;4131;2014;2117
50;Zaragoza;056;Botorrita;464;244;220
50;Zaragoza;057;Brea de Aragón;2027;1003;1024
50;Zaragoza;058;Bubierca;118;56;62
50;Zaragoza;059;Bujaraloz;1053;545;508
50;Zaragoza;060;Bulbuente;263;148;115
50;Zaragoza;061;Bureta;338;168;170
50;Zaragoza;062;Burgo de Ebro (El);1362;677;685
50;Zaragoza;063;Buste (El);123;61;62
50;Zaragoza;064;Cabañas de Ebro;554;284;270
50;Zaragoza;065;Cabolafuente;101;57;44
50;Zaragoza;066;Cadrete;1100;585;515
50;Zaragoza;067;Calatayud;17300;8303;8997
50;Zaragoza;068;Calatorao;2631;1349;1282
50;Zaragoza;069;Calcena;108;55;53
50;Zaragoza;070;Calmarza;117;61;56
50;Zaragoza;071;Campillo de Aragón;223;127;96
50;Zaragoza;072;Carenas;240;120;120
50;Zaragoza;073;Cariñena;2928;1463;1465
50;Zaragoza;074;Caspe;8206;4084;4122
50;Zaragoza;075;Castejón de Alarba;131;74;57
50;Zaragoza;076;Castejón de las Armas;165;84;81
50;Zaragoza;077;Castejón de Valdejasa;385;209;176
50;Zaragoza;078;Castiliscar;460;230;230
50;Zaragoza;079;Cervera de la Cañada;363;177;186
50;Zaragoza;080;Cerveruela;4;2;2
50;Zaragoza;081;Cetina;814;402;412
50;Zaragoza;092;Chiprana;445;226;219
50;Zaragoza;093;Chodes;146;72;74
50;Zaragoza;082;Cimballa;131;66;65
50;Zaragoza;083;Cinco Olivas;147;72;75
50;Zaragoza;084;Clarés de Ribota;107;56;51
50;Zaragoza;085;Codo;309;154;155
50;Zaragoza;086;Codos;313;181;132
50;Zaragoza;087;Contamina;68;35;33
50;Zaragoza;088;Cosuenda;439;219;220
50;Zaragoza;089;Cuarte de Huerva;1520;788;732
50;Zaragoza;090;Cubel;254;126;128
50;Zaragoza;091;Cuerlas (Las);105;53;52
50;Zaragoza;094;Daroca;2402;1194;1208
50;Zaragoza;095;Ejea de los Caballeros;15516;7889;7627
50;Zaragoza;096;Embid de Ariza;69;37;32
50;Zaragoza;098;Encinacorba;344;187;157
50;Zaragoza;099;Épila;3911;2002;1909
50;Zaragoza;100;Erla;517;244;273
50;Zaragoza;101;Escatrón;1395;681;714
50;Zaragoza;102;Fabara;1303;692;611
50;Zaragoza;104;Farlete;482;243;239
50;Zaragoza;105;Fayón;416;213;203
50;Zaragoza;106;Fayos (Los);217;120;97
50;Zaragoza;107;Figueruelas;941;468;473
50;Zaragoza;108;Fombuena;22;17;5
50;Zaragoza;109;Frago (El);118;69;49
50;Zaragoza;110;Frasno (El);615;322;293
50;Zaragoza;111;Fréscano;279;138;141
50;Zaragoza;113;Fuendejalón;977;486;491
50;Zaragoza;114;Fuendetodos;170;95;75
50;Zaragoza;115;Fuentes de Ebro;3885;1990;1895
50;Zaragoza;116;Fuentes de Jiloca;404;213;191
50;Zaragoza;117;Gallocanta;192;99;93
50;Zaragoza;118;Gallur;3028;1511;1517
50;Zaragoza;119;Gelsa;1325;671;654
50;Zaragoza;120;Godojos;83;43;40
50;Zaragoza;121;Gotor;394;206;188
50;Zaragoza;122;Grisel;66;33;33
50;Zaragoza;123;Grisén;477;238;239
50;Zaragoza;124;Herrera de los Navarros;671;348;323
50;Zaragoza;125;Ibdes;625;321;304
50;Zaragoza;126;Illueca;3216;1596;1620
50;Zaragoza;128;Isuerre;65;33;32
50;Zaragoza;129;Jaraba;333;168;165
50;Zaragoza;130;Jarque;591;309;282
50;Zaragoza;131;Jaulín;312;161;151
50;Zaragoza;132;Joyosa (La);359;180;179
50;Zaragoza;133;Lagata;146;80;66
50;Zaragoza;134;Langa del Castillo;203;93;110
50;Zaragoza;135;Layana;177;85;92
50;Zaragoza;136;Lécera;950;466;484
50;Zaragoza;138;Lechón;60;34;26
50;Zaragoza;137;Leciñena;1404;694;710
50;Zaragoza;139;Letux;495;257;238
50;Zaragoza;140;Litago;190;109;81
50;Zaragoza;141;Lituénigo;129;63;66
50;Zaragoza;142;Lobera de Onsella;60;36;24
50;Zaragoza;143;Longares;895;466;429
50;Zaragoza;144;Longás;35;24;11
50;Zaragoza;146;Lucena de Jalón;312;154;158
50;Zaragoza;147;Luceni;1075;533;542
50;Zaragoza;148;Luesia;456;239;217
50;Zaragoza;149;Luesma;28;16;12
50;Zaragoza;150;Lumpiaque;984;517;467
50;Zaragoza;151;Luna;963;499;464
50;Zaragoza;152;Maella;2146;1084;1062
50;Zaragoza;153;Magallón;1307;686;621
50;Zaragoza;154;Mainar;190;107;83
50;Zaragoza;155;Malanquilla;161;81;80
50;Zaragoza;156;Maleján;322;167;155
50;Zaragoza;160;Mallén;3006;1531;1475
50;Zaragoza;157;Malón;515;261;254
50;Zaragoza;159;Maluenda;1039;516;523
50;Zaragoza;161;Manchones;171;82;89
50;Zaragoza;162;Mara;243;126;117
50;Zaragoza;163;María de Huerva;841;398;443
50;Zaragoza;902;Marracos;"";"";""
50;Zaragoza;164;Mediana de Aragón;529;263;266
50;Zaragoza;165;Mequinenza;2693;1355;1338
50;Zaragoza;166;Mesones de Isuela;423;213;210
50;Zaragoza;167;Mezalocha;334;176;158
50;Zaragoza;168;Mianos;40;22;18
50;Zaragoza;169;Miedes de Aragón;556;283;273
50;Zaragoza;170;Monegrillo;560;301;259
50;Zaragoza;171;Moneva;118;60;58
50;Zaragoza;172;Monreal de Ariza;335;172;163
50;Zaragoza;173;Monterde;202;100;102
50;Zaragoza;174;Montón;159;77;82
50;Zaragoza;175;Morata de Jalón;1669;812;857
50;Zaragoza;176;Morata de Jiloca;361;198;163
50;Zaragoza;177;Morés;553;287;266
50;Zaragoza;178;Moros;582;299;283
50;Zaragoza;179;Moyuela;406;202;204
50;Zaragoza;180;Mozota;115;56;59
50;Zaragoza;181;Muel;1192;597;595
50;Zaragoza;182;Muela (La);1034;540;494
50;Zaragoza;183;Munébrega;507;265;242
50;Zaragoza;184;Murero;164;92;72
50;Zaragoza;185;Murillo de Gállego;151;79;72
50;Zaragoza;186;Navardún;86;44;42
50;Zaragoza;187;Nigüella;136;68;68
50;Zaragoza;188;Nombrevilla;35;18;17
50;Zaragoza;189;Nonaspe;1119;564;555
50;Zaragoza;190;Novallas;824;408;416
50;Zaragoza;191;Novillas;728;369;359
50;Zaragoza;192;Nuévalos;329;193;136
50;Zaragoza;193;Nuez de Ebro;563;293;270
50;Zaragoza;194;Olvés;179;99;80
50;Zaragoza;195;Orcajo;52;25;27
50;Zaragoza;196;Orera;168;85;83
50;Zaragoza;197;Orés;126;68;58
50;Zaragoza;198;Oseja;30;12;18
50;Zaragoza;199;Osera de Ebro;358;175;183
50;Zaragoza;200;Paniza;765;380;385
50;Zaragoza;201;Paracuellos de Jiloca;539;256;283
50;Zaragoza;202;Paracuellos de la Ribera;354;166;188
50;Zaragoza;203;Pastriz;801;393;408
50;Zaragoza;204;Pedrola;2555;1313;1242
50;Zaragoza;205;Pedrosas (Las);106;51;55
50;Zaragoza;206;Perdiguera;469;248;221
50;Zaragoza;207;Piedratajada;228;119;109
50;Zaragoza;208;Pina de Ebro;2220;1108;1112
50;Zaragoza;209;Pinseque;1401;700;701
50;Zaragoza;210;Pintanos (Los);87;49;38
50;Zaragoza;211;Plasencia de Jalón;389;205;184
50;Zaragoza;212;Pleitas;78;42;36
50;Zaragoza;213;Plenas;171;86;85
50;Zaragoza;214;Pomer;21;9;12
50;Zaragoza;215;Pozuel de Ariza;32;19;13
50;Zaragoza;216;Pozuelo de Aragón;382;209;173
50;Zaragoza;217;Pradilla de Ebro;689;362;327
50;Zaragoza;218;Puebla de Albortón;149;78;71
50;Zaragoza;219;Puebla de Alfindén (La);1520;783;737
50;Zaragoza;220;Puendeluna;66;37;29
50;Zaragoza;221;Purujosa;35;21;14
50;Zaragoza;222;Quinto;2200;1115;1085
50;Zaragoza;223;Remolinos;1268;645;623
50;Zaragoza;224;Retascón;81;43;38
50;Zaragoza;225;Ricla;2046;1053;993
50;Zaragoza;227;Romanos;154;88;66
50;Zaragoza;228;Rueda de Jalón;364;188;176
50;Zaragoza;229;Ruesca;83;42;41
50;Zaragoza;241;Sabiñán;1030;498;532
50;Zaragoza;230;Sádaba;1820;926;894
50;Zaragoza;231;Salillas de Jalón;381;197;184
50;Zaragoza;232;Salvatierra de Esca;318;169;149
50;Zaragoza;233;Samper del Salz;105;51;54
50;Zaragoza;234;San Martín de la Virgen de Moncayo;320;167;153
50;Zaragoza;235;San Mateo de Gállego;1911;981;930
50;Zaragoza;236;Santa Cruz de Grío;245;134;111
50;Zaragoza;237;Santa Cruz de Moncayo;106;55;51
50;Zaragoza;238;Santa Eulalia de Gállego;133;68;65
50;Zaragoza;239;Santed;88;39;49
50;Zaragoza;240;Sástago;1596;802;794
50;Zaragoza;242;Sediles;112;57;55
50;Zaragoza;243;Sestrica;547;279;268
50;Zaragoza;244;Sierra de Luna;312;161;151
50;Zaragoza;245;Sigüés;193;102;91
50;Zaragoza;246;Sisamón;98;60;38
50;Zaragoza;247;Sobradiel;585;277;308
50;Zaragoza;248;Sos del Rey Católico;902;455;447
50;Zaragoza;249;Tabuenca;525;281;244
50;Zaragoza;250;Talamantes;56;28;28
50;Zaragoza;251;Tarazona;10667;5163;5504
50;Zaragoza;252;Tauste;7042;3512;3530
50;Zaragoza;253;Terrer;749;361;388
50;Zaragoza;254;Tierga;287;151;136
50;Zaragoza;255;Tobed;309;149;160
50;Zaragoza;256;Torralba de los Frailes;116;56;60
50;Zaragoza;257;Torralba de Ribota;239;134;105
50;Zaragoza;258;Torralbilla;73;36;37
50;Zaragoza;259;Torrehermosa;130;69;61
50;Zaragoza;260;Torrelapaja;51;24;27
50;Zaragoza;261;Torrellas;356;178;178
50;Zaragoza;262;Torres de Berrellén;1419;708;711
50;Zaragoza;263;Torrijo de la Cañada;472;249;223
50;Zaragoza;264;Tosos;243;127;116
50;Zaragoza;265;Trasmoz;73;38;35
50;Zaragoza;266;Trasobares;272;146;126
50;Zaragoza;267;Uncastillo;939;452;487
50;Zaragoza;268;Undués de Lerda;49;22;27
50;Zaragoza;269;Urrea de Jalón;357;179;178
50;Zaragoza;270;Urriés;84;46;38
50;Zaragoza;271;Used;426;220;206
50;Zaragoza;272;Utebo;8640;4362;4278
50;Zaragoza;274;Val de San Martín;80;36;44
50;Zaragoza;273;Valdehorna;74;36;38
50;Zaragoza;275;Valmadrid;70;35;35
50;Zaragoza;276;Valpalmas;222;111;111
50;Zaragoza;277;Valtorres;114;54;60
50;Zaragoza;278;Velilla de Ebro;284;140;144
50;Zaragoza;279;Velilla de Jiloca;152;75;77
50;Zaragoza;280;Vera de Moncayo;484;247;237
50;Zaragoza;281;Vierlas;116;56;60
50;Zaragoza;283;Villadoz;88;47;41
50;Zaragoza;284;Villafeliche;257;124;133
50;Zaragoza;285;Villafranca de Ebro;684;326;358
50;Zaragoza;286;Villalba de Perejil;119;61;58
50;Zaragoza;287;Villalengua;485;256;229
50;Zaragoza;288;Villanueva de Gállego;2649;1333;1316
50;Zaragoza;290;Villanueva de Huerva;649;322;327
50;Zaragoza;289;Villanueva de Jiloca;126;63;63
50;Zaragoza;291;Villar de los Navarros;191;97;94
50;Zaragoza;292;Villarreal de Huerva;203;111;92
50;Zaragoza;293;Villarroya de la Sierra;782;396;386
50;Zaragoza;294;Villarroya del Campo;77;39;38
50;Zaragoza;282;Vilueña (La);110;50;60
50;Zaragoza;295;Vistabella;34;18;16
50;Zaragoza;296;Zaida (La);657;330;327
50;Zaragoza;297;Zaragoza;606620;293194;313426
50;Zaragoza;298;Zuera;5385;2746;2639
51;Ceuta;001;Ceuta;71926;35705;36221
52;Melilla;001;Melilla;63570;31971;31599
