01;Álava;001;Alegría-Dulantzi;1139;591;548
01;Álava;002;Amurrio;9890;4919;4971
01;Álava;049;Añana;195;102;93
01;Álava;003;Aramaio;1316;679;637
01;Álava;006;Armiñón;133;72;61
01;Álava;037;Arraia-Maeztu;706;367;339
01;Álava;008;Arrazua-Ubarrundia;702;370;332
01;Álava;004;Artziniega;1323;655;668
01;Álava;009;Asparrena;1555;776;779
01;Álava;010;Ayala/Aiara;2060;1031;1029
01;Álava;011;Baños de Ebro/Mañueta;330;176;154
01;Álava;013;Barrundia;563;317;246
01;Álava;014;Berantevilla;414;211;203
01;Álava;016;Bernedo;539;313;226
01;Álava;017;Campezo/Kanpezu;1145;606;539
01;Álava;021;Elburgo/Burgelu;204;113;91
01;Álava;022;Elciego;951;475;476
01;Álava;023;Elvillar/Bilar;349;187;162
01;Álava;056;Harana/Valle de Arana;374;204;170
01;Álava;901;Iruña Oka/Iruña de Oca;1612;840;772
01;Álava;027;Iruraiz-Gauna;426;229;197
01;Álava;019;Kripan;199;103;96
01;Álava;020;Kuartango;360;201;159
01;Álava;028;Labastida;1049;565;484
01;Álava;030;Lagrán;191;101;90
01;Álava;031;Laguardia;1461;750;711
01;Álava;032;Lanciego/Lantziego;649;343;306
01;Álava;902;Lantarón;838;444;394
01;Álava;033;Lapuebla de Labarca;842;422;420
01;Álava;058;Legutiano;1286;694;592
01;Álava;034;Leza;203;111;92
01;Álava;036;Llodio;20179;10136;10043
01;Álava;039;Moreda de Álava;286;155;131
01;Álava;041;Navaridas;217;118;99
01;Álava;042;Okondo;778;396;382
01;Álava;043;Oyón/Oion;2189;1101;1088
01;Álava;044;Peñacerrada-Urizaharra;241;135;106
01;Álava;046;Ribera Alta;526;305;221
01;Álava;047;Ribera Baja/Erribera Beitia;433;237;196
01;Álava;051;Salvatierra/Agurain;3817;1920;1897
01;Álava;052;Samaniego;293;146;147
01;Álava;053;San Millán/Donemiliaga;712;387;325
01;Álava;054;Urkabustaiz;861;460;401
01;Álava;055;Valdegovía;887;497;390
01;Álava;057;Villabuena de Álava/Eskuernaga;364;183;181
01;Álava;059;Vitoria-Gasteiz;215049;105987;109062
01;Álava;060;Yécora/Lekora;254;124;130
01;Álava;061;Zalduondo;131;71;60
01;Álava;062;Zambrana;341;183;158
01;Álava;018;Zigoitia;983;538;445
01;Álava;063;Zuia;1399;711;688
02;Albacete;001;Abengibre;1036;522;514
02;Albacete;002;Alatoz;716;374;342
02;Albacete;003;Albacete;143779;70384;73395
02;Albacete;004;Albatana;932;472;460
02;Albacete;005;Alborea;810;425;385
02;Albacete;006;Alcadozo;812;416;396
02;Albacete;007;Alcalá del Júcar;1614;813;801
02;Albacete;008;Alcaraz;1904;927;977
02;Albacete;009;Almansa;23473;11549;11924
02;Albacete;010;Alpera;2356;1207;1149
02;Albacete;011;Ayna;1088;560;528
02;Albacete;012;Balazote;2281;1150;1131
02;Albacete;014;Ballestero (El);634;314;320
02;Albacete;013;Balsa de Ves;284;151;133
02;Albacete;015;Barrax;2015;1015;1000
02;Albacete;016;Bienservida;912;462;450
02;Albacete;017;Bogarra;1521;801;720
02;Albacete;018;Bonete;1275;657;618
02;Albacete;019;Bonillo (El);3332;1698;1634
02;Albacete;020;Carcelén;743;381;362
02;Albacete;021;Casas de Juan Núñez;1363;697;666
02;Albacete;022;Casas de Lázaro;517;268;249
02;Albacete;023;Casas de Ves;955;488;467
02;Albacete;024;Casas-Ibáñez;4040;2045;1995
02;Albacete;025;Caudete;8665;4316;4349
02;Albacete;026;Cenizate;1083;566;517
02;Albacete;029;Chinchilla de Monte-Aragón;3289;1713;1576
02;Albacete;027;Corral-Rubio;492;256;236
02;Albacete;028;Cotillas;251;127;124
02;Albacete;030;Elche de la Sierra;3995;1998;1997
02;Albacete;032;Fuensanta;439;218;221
02;Albacete;033;Fuente-Álamo;2478;1259;1219
02;Albacete;034;Fuentealbilla;1873;950;923
02;Albacete;031;Férez;867;431;436
02;Albacete;035;Gineta (La);2141;1050;1091
02;Albacete;036;Golosalvo;136;68;68
02;Albacete;037;Hellín;26403;13062;13341
02;Albacete;038;Herrera (La);446;230;216
02;Albacete;039;Higueruela;1318;663;655
02;Albacete;040;Hoya-Gonzalo;761;382;379
02;Albacete;041;Jorquera;649;347;302
02;Albacete;042;Letur;1402;694;708
02;Albacete;043;Lezuza;1949;1018;931
02;Albacete;044;Liétor;1808;936;872
02;Albacete;045;Madrigueras;4520;2275;2245
02;Albacete;046;Mahora;1397;691;706
02;Albacete;047;Masegoso;239;132;107
02;Albacete;048;Minaya;1933;979;954
02;Albacete;049;Molinicos;1611;843;768
02;Albacete;050;Montalvos;148;70;78
02;Albacete;051;Montealegre del Castillo;2146;1081;1065
02;Albacete;052;Motilleja;548;269;279
02;Albacete;053;Munera;4089;2073;2016
02;Albacete;054;Navas de Jorquera;594;303;291
02;Albacete;055;Nerpio;1978;1034;944
02;Albacete;056;Ontur;2515;1251;1264
02;Albacete;057;Ossa de Montiel;2875;1435;1440
02;Albacete;058;Paterna del Madera;662;347;315
02;Albacete;060;Peñas de San Pedro;1288;676;612
02;Albacete;059;Peñascosa;466;249;217
02;Albacete;061;Pétrola;1001;503;498
02;Albacete;062;Povedilla;775;403;372
02;Albacete;064;Pozo-Lorente;549;259;290
02;Albacete;063;Pozohondo;1966;1014;952
02;Albacete;065;Pozuelo;720;366;354
02;Albacete;066;Recueja (La);378;191;187
02;Albacete;067;Riópar;1398;724;674
02;Albacete;068;Robledo;484;248;236
02;Albacete;069;Roda (La);13564;6804;6760
02;Albacete;070;Salobre;680;355;325
02;Albacete;071;San Pedro;1341;680;661
02;Albacete;072;Socovos;2153;1106;1047
02;Albacete;073;Tarazona de la Mancha;5922;2971;2951
02;Albacete;074;Tobarra;7410;3687;3723
02;Albacete;075;Valdeganga;2096;1053;1043
02;Albacete;076;Vianos;549;272;277
02;Albacete;077;Villa de Ves;76;38;38
02;Albacete;078;Villalgordo del Júcar;1318;648;670
02;Albacete;079;Villamalea;3397;1746;1651
02;Albacete;080;Villapalacios;968;489;479
02;Albacete;081;Villarrobledo;22215;10900;11315
02;Albacete;082;Villatoya;207;114;93
02;Albacete;083;Villavaliente;320;165;155
02;Albacete;084;Villaverde de Guadalimar;625;330;295
02;Albacete;085;Viveros;626;325;301
02;Albacete;086;Yeste;4743;2440;2303
03;Alicante/Alacant;001;Adsubia;522;257;265
03;Alicante/Alacant;002;Agost;4042;2029;2013
03;Alicante/Alacant;003;Agres;654;338;316
03;Alicante/Alacant;004;Aigües;546;269;277
03;Alicante/Alacant;005;Albatera;8467;4216;4251
03;Alicante/Alacant;006;Alcalalí;824;410;414
03;Alicante/Alacant;007;Alcocer de Planes;129;58;71
03;Alicante/Alacant;008;Alcoleja;290;138;152
03;Alicante/Alacant;009;Alcoy/Alcoi;63979;30777;33202
03;Alicante/Alacant;010;Alfafara;383;181;202
03;Alicante/Alacant;011;Alfàs del Pi (L');10760;5265;5495
03;Alicante/Alacant;012;Algorfa;1079;539;540
03;Alicante/Alacant;013;Algueña;1478;726;752
03;Alicante/Alacant;014;Alicante/Alacant;276526;133286;143240
03;Alicante/Alacant;015;Almoradí;13249;6593;6656
03;Alicante/Alacant;016;Almudaina;134;68;66
03;Alicante/Alacant;017;Alquería d'Asnar (L');422;210;212
03;Alicante/Alacant;018;Altea;13559;6696;6863
03;Alicante/Alacant;019;Aspe;16406;8195;8211
03;Alicante/Alacant;020;Balones;168;73;95
03;Alicante/Alacant;021;Banyeres de Mariola;7118;3522;3596
03;Alicante/Alacant;022;Benasau;208;102;106
03;Alicante/Alacant;023;Beneixama;1819;901;918
03;Alicante/Alacant;024;Benejúzar;4861;2432;2429
03;Alicante/Alacant;025;Benferri;1009;510;499
03;Alicante/Alacant;026;Beniarbeig;1191;593;598
03;Alicante/Alacant;027;Beniardá;231;112;119
03;Alicante/Alacant;028;Beniarrés;1462;733;729
03;Alicante/Alacant;030;Benidoleig;807;403;404
03;Alicante/Alacant;031;Benidorm;47715;23532;24183
03;Alicante/Alacant;032;Benifallim;152;78;74
03;Alicante/Alacant;033;Benifato;129;68;61
03;Alicante/Alacant;029;Benigembla;364;184;180
03;Alicante/Alacant;034;Benijófar;1576;768;808
03;Alicante/Alacant;035;Benilloba;949;484;465
03;Alicante/Alacant;036;Benillup;83;45;38
03;Alicante/Alacant;037;Benimantell;460;216;244
03;Alicante/Alacant;038;Benimarfull;407;186;221
03;Alicante/Alacant;039;Benimassot;108;57;51
03;Alicante/Alacant;040;Benimeli;324;162;162
03;Alicante/Alacant;041;Benissa;8097;4020;4077
03;Alicante/Alacant;042;Benitachell/Poble Nou de Benitatxell (el);1762;891;871
03;Alicante/Alacant;043;Biar;3606;1741;1865
03;Alicante/Alacant;044;Bigastro;4636;2383;2253
03;Alicante/Alacant;045;Bolulla;275;137;138
03;Alicante/Alacant;046;Busot;1264;631;633
03;Alicante/Alacant;048;Callosa d'En Sarrià;7695;3821;3874
03;Alicante/Alacant;049;Callosa de Segura;15907;7919;7988
03;Alicante/Alacant;047;Calpe/Calp;11698;5906;5792
03;Alicante/Alacant;050;Campello (El);14019;6968;7051
03;Alicante/Alacant;051;Campo de Mirra/Camp de Mirra (el);384;187;197
03;Alicante/Alacant;053;Castalla;7586;3752;3834
03;Alicante/Alacant;054;Castell de Castells;510;256;254
03;Alicante/Alacant;055;Catral;4667;2325;2342
03;Alicante/Alacant;052;Cañada;1099;526;573
03;Alicante/Alacant;056;Cocentaina;10654;5211;5443
03;Alicante/Alacant;057;Confrides;288;160;128
03;Alicante/Alacant;058;Cox;5976;3010;2966
03;Alicante/Alacant;059;Crevillent;23737;11941;11796
03;Alicante/Alacant;061;Daya Nueva;1163;590;573
03;Alicante/Alacant;062;Daya Vieja;202;101;101
03;Alicante/Alacant;064;Dolores;6150;3090;3060
03;Alicante/Alacant;063;Dénia;27680;13494;14186
03;Alicante/Alacant;065;Elche/Elx;192424;95356;97068
03;Alicante/Alacant;066;Elda;55569;27171;28398
03;Alicante/Alacant;067;Facheca;137;70;67
03;Alicante/Alacant;068;Famorca;66;31;35
03;Alicante/Alacant;069;Finestrat;1533;752;781
03;Alicante/Alacant;070;Formentera del Segura;1976;980;996
03;Alicante/Alacant;072;Gaianes;324;151;173
03;Alicante/Alacant;071;Gata de Gorgos;5059;2519;2540
03;Alicante/Alacant;073;Gorga;281;139;142
03;Alicante/Alacant;074;Granja de Rocamora;2005;1020;985
03;Alicante/Alacant;075;Guadalest;165;84;81
03;Alicante/Alacant;076;Guardamar del Segura;7691;3820;3871
03;Alicante/Alacant;077;Hondón de las Nieves;1500;737;763
03;Alicante/Alacant;078;Hondón de los Frailes;531;257;274
03;Alicante/Alacant;079;Ibi;21113;10507;10606
03;Alicante/Alacant;080;Jacarilla;1495;749;746
03;Alicante/Alacant;081;Jalón/Xaló;1962;974;988
03;Alicante/Alacant;083;Jijona/Xixona;7833;3691;4142
03;Alicante/Alacant;082;Jávea/Xàbia;17291;8606;8685
03;Alicante/Alacant;085;Llíber;498;242;256
03;Alicante/Alacant;084;Lorcha/Orxa (L');837;423;414
03;Alicante/Alacant;086;Millena;143;68;75
03;Alicante/Alacant;088;Monforte del Cid;5167;2676;2491
03;Alicante/Alacant;903;Montesinos (Los);2393;1229;1164
03;Alicante/Alacant;089;Monóvar/Monòver;12088;5895;6193
03;Alicante/Alacant;091;Murla;333;143;190
03;Alicante/Alacant;092;Muro de Alcoy;6892;3424;3468
03;Alicante/Alacant;090;Mutxamel;11711;5891;5820
03;Alicante/Alacant;093;Novelda;23081;11312;11769
03;Alicante/Alacant;094;Nucia (la);6675;3285;3390
03;Alicante/Alacant;095;Ondara;5151;2567;2584
03;Alicante/Alacant;096;Onil;6759;3375;3384
03;Alicante/Alacant;097;Orba;1622;775;847
03;Alicante/Alacant;099;Orihuela;51959;25690;26269
03;Alicante/Alacant;098;Orxeta;513;260;253
03;Alicante/Alacant;100;Parcent;761;368;393
03;Alicante/Alacant;101;Pedreguer;5724;2783;2941
03;Alicante/Alacant;102;Pego;9361;4639;4722
03;Alicante/Alacant;103;Penàguila;361;174;187
03;Alicante/Alacant;104;Petrer;26161;13024;13137
03;Alicante/Alacant;902;Pilar de la Horadada;8839;4519;4320
03;Alicante/Alacant;105;Pinoso;5943;2959;2984
03;Alicante/Alacant;106;Planes;825;418;407
03;Alicante/Alacant;901;Poblets (Els);1135;549;586
03;Alicante/Alacant;107;Polop;1910;943;967
03;Alicante/Alacant;060;Quatretondeta;191;97;94
03;Alicante/Alacant;109;Rafal;2934;1460;1474
03;Alicante/Alacant;111;Redován;5150;2634;2516
03;Alicante/Alacant;112;Relleu;806;407;399
03;Alicante/Alacant;113;Rojales;5840;2912;2928
03;Alicante/Alacant;114;Romana (La);1934;978;956
03;Alicante/Alacant;110;Ràfol d'Almúnia (El);369;181;188
03;Alicante/Alacant;115;Sagra;380;192;188
03;Alicante/Alacant;116;Salinas;1194;621;573
03;Alicante/Alacant;118;San Fulgencio;2553;1303;1250
03;Alicante/Alacant;904;San Isidro;1185;619;566
03;Alicante/Alacant;120;San Miguel de Salinas;3200;1638;1562
03;Alicante/Alacant;122;San Vicente del Raspeig/Sant Vicent del Raspeig;34235;17010;17225
03;Alicante/Alacant;117;Sanet y Negrals;553;250;303
03;Alicante/Alacant;119;Sant Joan d'Alacant;15997;7964;8033
03;Alicante/Alacant;121;Santa Pola;16847;8375;8472
03;Alicante/Alacant;123;Sax;8639;4325;4314
03;Alicante/Alacant;124;Sella;588;309;279
03;Alicante/Alacant;125;Senija;466;240;226
03;Alicante/Alacant;128;Teulada;5904;2899;3005
03;Alicante/Alacant;129;Tibi;1093;554;539
03;Alicante/Alacant;130;Tollos;42;24;18
03;Alicante/Alacant;131;Tormos;283;138;145
03;Alicante/Alacant;132;Torremanzanas/Torre de les Maçanes (la);764;365;399
03;Alicante/Alacant;133;Torrevieja;31842;15646;16196
03;Alicante/Alacant;127;Tárbena;702;356;346
03;Alicante/Alacant;134;Vall d'Alcalà (La);188;91;97
03;Alicante/Alacant;135;Vall de Ebo;360;182;178
03;Alicante/Alacant;136;Vall de Gallinera;717;372;345
03;Alicante/Alacant;137;Vall de Laguar (La);939;453;486
03;Alicante/Alacant;138;Verger (El);3643;1775;1868
03;Alicante/Alacant;139;Villajoyosa/Vila Joiosa (La);23430;11587;11843
03;Alicante/Alacant;140;Villena;31375;15483;15892
04;Almería;001;Abla;1597;775;822
04;Almería;002;Abrucena;1488;716;772
04;Almería;003;Adra;21147;10613;10534
04;Almería;004;Albánchez;675;338;337
04;Almería;005;Alboloduy;845;391;454
04;Almería;006;Albox;10120;5059;5061
04;Almería;007;Alcolea;842;422;420
04;Almería;008;Alcóntar;663;333;330
04;Almería;009;Alcudia de Monteagud;209;99;110
04;Almería;010;Alhabia;720;367;353
04;Almería;011;Alhama de Almería;3153;1572;1581
04;Almería;012;Alicún;254;121;133
04;Almería;013;Almería;169509;82202;87307
04;Almería;014;Almócita;171;91;80
04;Almería;015;Alsodux;126;57;69
04;Almería;016;Antas;2616;1281;1335
04;Almería;017;Arboleas;1520;774;746
04;Almería;018;Armuña de Almanzora;351;167;184
04;Almería;019;Bacares;296;166;130
04;Almería;020;Bayárcal;395;212;183
04;Almería;021;Bayarque;239;112;127
04;Almería;022;Bédar;522;283;239
04;Almería;023;Beires;135;64;71
04;Almería;024;Benahadux;2546;1246;1300
04;Almería;026;Benitagla;111;58;53
04;Almería;027;Benizalón;304;158;146
04;Almería;028;Bentarique;347;177;170
04;Almería;029;Berja;12878;6419;6459
04;Almería;030;Canjáyar;1767;891;876
04;Almería;031;Cantoria;3297;1671;1626
04;Almería;032;Carboneras;6169;3194;2975
04;Almería;033;Castro de Filabres;153;72;81
04;Almería;036;Chercos;295;147;148
04;Almería;037;Chirivel;2008;991;1017
04;Almería;034;Cóbdar;264;134;130
04;Almería;035;Cuevas del Almanzora;9371;4691;4680
04;Almería;038;Dalías;3631;1793;1838
04;Almería;039;Darrical;283;143;140
04;Almería;902;Ejido (El);45354;23049;22305
04;Almería;041;Enix;239;119;120
04;Almería;043;Felix;594;297;297
04;Almería;044;Fines;1714;884;830
04;Almería;045;Fiñana;2672;1313;1359
04;Almería;046;Fondón;947;480;467
04;Almería;047;Gádor;2599;1278;1321
04;Almería;048;Gallardos (Los);1686;846;840
04;Almería;049;Garrucha;4643;2382;2261
04;Almería;050;Gérgal;1097;527;570
04;Almería;051;Huécija;563;282;281
04;Almería;052;Huércal de Almería;4489;2253;2236
04;Almería;053;Huércal-Overa;13830;6842;6988
04;Almería;054;Illar;469;224;245
04;Almería;055;Instinción;587;281;306
04;Almería;056;Laroya;120;65;55
04;Almería;057;Láujar de Andarax;1873;934;939
04;Almería;058;Líjar;529;265;264
04;Almería;059;Lubrín;1922;923;999
04;Almería;060;Lucainena de las Torres;547;272;275
04;Almería;061;Lúcar;787;386;401
04;Almería;062;Macael;6069;3082;2987
04;Almería;063;María;1729;882;847
04;Almería;064;Mojácar;3853;1895;1958
04;Almería;903;Mojonera (La);6096;3188;2908
04;Almería;065;Nacimiento;488;246;242
04;Almería;066;Níjar;14414;7387;7027
04;Almería;067;Ohanes;846;424;422
04;Almería;068;Olula de Castro;231;114;117
04;Almería;069;Olula del Río;5803;2914;2889
04;Almería;070;Oria;2365;1195;1170
04;Almería;071;Padules;494;250;244
04;Almería;072;Partaloa;390;189;201
04;Almería;073;Paterna del Río;351;181;170
04;Almería;074;Pechina;2484;1227;1257
04;Almería;075;Pulpí;4957;2518;2439
04;Almería;076;Purchena;1728;842;886
04;Almería;077;Rágol;406;189;217
04;Almería;078;Rioja;1187;593;594
04;Almería;079;Roquetas de Mar;35164;17849;17315
04;Almería;080;Santa Cruz de Marchena;212;100;112
04;Almería;081;Santa Fe de Mondújar;419;205;214
04;Almería;082;Senés;369;191;178
04;Almería;083;Serón;2989;1500;1489
04;Almería;084;Sierro;552;286;266
04;Almería;085;Somontín;516;264;252
04;Almería;086;Sorbas;2766;1386;1380
04;Almería;087;Suflí;248;123;125
04;Almería;088;Tabernas;3107;1568;1539
04;Almería;089;Taberno;1045;518;527
04;Almería;090;Tahal;494;244;250
04;Almería;091;Terque;445;220;225
04;Almería;092;Tíjola;3712;1875;1837
04;Almería;901;Tres Villas (Las);798;411;387
04;Almería;093;Turre;2261;1118;1143
04;Almería;094;Turrillas;272;144;128
04;Almería;095;Uleila del Campo;1025;522;503
04;Almería;096;Urrácal;349;170;179
04;Almería;097;Velefique;341;180;161
04;Almería;098;Vélez-Blanco;2292;1160;1132
04;Almería;099;Vélez-Rubio;6584;3185;3399
04;Almería;100;Vera;6537;3263;3274
04;Almería;101;Viator;2987;1453;1534
04;Almería;102;Vícar;13338;6846;6492
04;Almería;103;Zurgena;2135;1057;1078
05;Ávila;001;Adanero;355;188;167
05;Ávila;002;Adrada (La);2034;1053;981
05;Ávila;005;Albornos;297;159;138
05;Ávila;007;Aldeanueva de Santa Cruz;206;110;96
05;Ávila;008;Aldeaseca;388;192;196
05;Ávila;010;Aldehuela (La);308;156;152
05;Ávila;012;Amavida;214;105;109
05;Ávila;013;Arenal (El);1096;537;559
05;Ávila;014;Arenas de San Pedro;6782;3367;3415
05;Ávila;015;Arevalillo;162;83;79
05;Ávila;016;Arévalo;7442;3601;3841
05;Ávila;017;Aveinte;154;82;72
05;Ávila;018;Avellaneda;51;22;29
05;Ávila;019;Ávila;50015;24248;25767
05;Ávila;021;Barco de Ávila (El);2650;1312;1338
05;Ávila;022;Barraco (El);2056;1031;1025
05;Ávila;023;Barromán;278;158;120
05;Ávila;024;Becedas;511;273;238
05;Ávila;025;Becedillas;185;99;86
05;Ávila;026;Bercial de Zapardiel;353;168;185
05;Ávila;027;Berlanas (Las);389;196;193
05;Ávila;029;Bernuy-Zapardiel;290;159;131
05;Ávila;030;Berrocalejo de Aragona;46;22;24
05;Ávila;033;Blascomillán;328;156;172
05;Ávila;034;Blasconuño de Matacabras;32;19;13
05;Ávila;035;Blascosancho;171;88;83
05;Ávila;036;Bohodón (El);211;105;106
05;Ávila;037;Bohoyo;521;264;257
05;Ávila;038;Bonilla de la Sierra;209;115;94
05;Ávila;039;Brabos;77;44;33
05;Ávila;040;Bularros;134;72;62
05;Ávila;041;Burgohondo;1353;692;661
05;Ávila;042;Cabezas de Alambre;275;144;131
05;Ávila;043;Cabezas del Pozo;202;101;101
05;Ávila;044;Cabezas del Villar;545;297;248
05;Ávila;045;Cabizuela;161;81;80
05;Ávila;046;Canales;88;43;45
05;Ávila;047;Candeleda;5359;2715;2644
05;Ávila;048;Cantiveros;201;102;99
05;Ávila;049;Cardeñosa;560;288;272
05;Ávila;051;Carrera (La);335;162;173
05;Ávila;052;Casas del Puerto de Villatoro;127;70;57
05;Ávila;053;Casasola;184;96;88
05;Ávila;054;Casavieja;1628;856;772
05;Ávila;055;Casillas;1000;522;478
05;Ávila;056;Castellanos de Zapardiel;162;90;72
05;Ávila;057;Cebreros;3652;1824;1828
05;Ávila;058;Cepeda la Mora;162;89;73
05;Ávila;067;Chamartín;122;66;56
05;Ávila;059;Cillán;163;83;80
05;Ávila;060;Cisla;219;105;114
05;Ávila;061;Colilla (La);208;106;102
05;Ávila;062;Collado de Contreras;286;153;133
05;Ávila;063;Collado del Mirón;111;60;51
05;Ávila;064;Constanzana;216;112;104
05;Ávila;065;Crespos;808;426;382
05;Ávila;066;Cuevas del Valle;673;360;313
05;Ávila;903;Diego del Carpio;375;203;172
05;Ávila;069;Donjimeno;151;77;74
05;Ávila;070;Donvidas;80;38;42
05;Ávila;072;Espinosa de los Caballeros;118;65;53
05;Ávila;073;Flores de Ávila;478;250;228
05;Ávila;074;Fontíveros;1135;575;560
05;Ávila;075;Fresnedilla;129;63;66
05;Ávila;076;Fresno (El);449;233;216
05;Ávila;077;Fuente el Saúz;368;182;186
05;Ávila;078;Fuentes de Año;250;130;120
05;Ávila;079;Gallegos de Altamiros;121;65;56
05;Ávila;080;Gallegos de Sobrinos;121;54;67
05;Ávila;081;Garganta del Villar;91;51;40
05;Ávila;082;Gavilanes;783;424;359
05;Ávila;083;Gemuño;256;122;134
05;Ávila;085;Gil García;80;37;43
05;Ávila;084;Gilbuena;171;97;74
05;Ávila;086;Gimialcón;142;77;65
05;Ávila;087;Gotarrendura;192;67;125
05;Ávila;088;Grandes y San Martín;61;31;30
05;Ávila;089;Guisando;729;376;353
05;Ávila;090;Gutierre-Muñoz;141;66;75
05;Ávila;092;Hernansancho;242;123;119
05;Ávila;093;Herradón de Pinares;508;265;243
05;Ávila;094;Herreros de Suso;254;127;127
05;Ávila;095;Higuera de las Dueñas;322;174;148
05;Ávila;096;Hija de Dios (La);145;82;63
05;Ávila;097;Horcajada (La);924;454;470
05;Ávila;099;Horcajo de las Torres;903;482;421
05;Ávila;100;Hornillo (El);527;264;263
05;Ávila;102;Hoyo de Pinares (El);2598;1321;1277
05;Ávila;101;Hoyocasero;450;238;212
05;Ávila;103;Hoyorredondo;145;74;71
05;Ávila;106;Hoyos de Miguel Muñoz;63;33;30
05;Ávila;104;Hoyos del Collado;53;35;18
05;Ávila;105;Hoyos del Espino;419;222;197
05;Ávila;107;Hurtumpascual;144;76;68
05;Ávila;108;Junciana;102;51;51
05;Ávila;109;Langa;621;320;301
05;Ávila;110;Lanzahíta;961;492;469
05;Ávila;113;Llanos de Tormes (Los);173;93;80
05;Ávila;112;Losar del Barco (El);170;93;77
05;Ávila;114;Madrigal de las Altas Torres;2103;1080;1023
05;Ávila;115;Maello;677;334;343
05;Ávila;116;Malpartida de Corneja;261;130;131
05;Ávila;117;Mamblas;318;168;150
05;Ávila;118;Mancera de Arriba;167;84;83
05;Ávila;119;Manjabálago;87;48;39
05;Ávila;120;Marlín;39;20;19
05;Ávila;121;Martiherrero;221;111;110
05;Ávila;122;Martínez;280;148;132
05;Ávila;123;Mediana de Voltoya;117;64;53
05;Ávila;124;Medinilla;268;142;126
05;Ávila;125;Mengamuñoz;74;33;41
05;Ávila;126;Mesegar de Corneja;138;68;70
05;Ávila;127;Mijares;1095;555;540
05;Ávila;128;Mingorría;561;282;279
05;Ávila;129;Mirón (El);304;172;132
05;Ávila;130;Mironcillo;137;78;59
05;Ávila;131;Mirueña de los Infanzones;251;123;128
05;Ávila;132;Mombeltrán;1259;672;587
05;Ávila;133;Monsalupe;107;52;55
05;Ávila;134;Moraleja de Matacabras;77;36;41
05;Ávila;135;Muñana;615;320;295
05;Ávila;136;Muñico;164;85;79
05;Ávila;138;Muñogalindo;461;256;205
05;Ávila;139;Muñogrande;123;62;61
05;Ávila;140;Muñomer del Peco;140;76;64
05;Ávila;141;Muñopepe;115;62;53
05;Ávila;142;Muñosancho;185;86;99
05;Ávila;143;Muñotello;145;77;68
05;Ávila;144;Narrillos del Álamo;179;94;85
05;Ávila;145;Narrillos del Rebollar;87;46;41
05;Ávila;149;Narros de Saldueña;232;122;110
05;Ávila;147;Narros del Castillo;287;156;131
05;Ávila;148;Narros del Puerto;49;28;21
05;Ávila;152;Nava de Arévalo;1072;554;518
05;Ávila;153;Nava del Barco;232;111;121
05;Ávila;151;Navacepedilla de Corneja;154;82;72
05;Ávila;154;Navadijos;82;46;36
05;Ávila;155;Navaescurial;115;65;50
05;Ávila;156;Navahondilla;136;69;67
05;Ávila;157;Navalacruz;344;169;175
05;Ávila;158;Navalmoral;651;334;317
05;Ávila;159;Navalonguilla;538;265;273
05;Ávila;160;Navalosa;597;319;278
05;Ávila;161;Navalperal de Pinares;951;460;491
05;Ávila;162;Navalperal de Tormes;165;86;79
05;Ávila;163;Navaluenga;2049;1026;1023
05;Ávila;164;Navaquesera;69;36;33
05;Ávila;165;Navarredonda de Gredos;521;269;252
05;Ávila;166;Navarredondilla;321;156;165
05;Ávila;167;Navarrevisca;413;215;198
05;Ávila;168;Navas del Marqués (Las);4287;2149;2138
05;Ávila;169;Navatalgordo;576;285;291
05;Ávila;170;Navatejares;111;53;58
05;Ávila;171;Neila de San Miguel;149;76;73
05;Ávila;172;Niharra;210;106;104
05;Ávila;173;Ojos-Albos;41;18;23
05;Ávila;174;Orbita;110;53;57
05;Ávila;175;Oso (El);257;138;119
05;Ávila;176;Padiernos;273;140;133
05;Ávila;177;Pajares de Adaja;204;105;99
05;Ávila;178;Palacios de Goda;554;273;281
05;Ávila;179;Papatrigo;360;189;171
05;Ávila;180;Parral (El);135;73;62
05;Ávila;181;Pascualcobo;48;27;21
05;Ávila;182;Pedro Bernardo;1524;783;741
05;Ávila;183;Pedro-Rodríguez;244;113;131
05;Ávila;184;Peguerinos;381;211;170
05;Ávila;185;Peñalba de Ávila;134;76;58
05;Ávila;186;Piedrahíta;2287;1114;1173
05;Ávila;187;Piedralaves;2162;1089;1073
05;Ávila;188;Poveda;97;54;43
05;Ávila;189;Poyales del Hoyo;822;416;406
05;Ávila;190;Pozanco;66;37;29
05;Ávila;191;Pradosegar;220;117;103
05;Ávila;192;Puerto Castilla;157;75;82
05;Ávila;193;Rasueros;414;217;197
05;Ávila;194;Riocabado;218;118;100
05;Ávila;195;Riofrío;358;196;162
05;Ávila;196;Rivilla de Barajas;108;59;49
05;Ávila;197;Salobral;135;65;70
05;Ávila;198;Salvadiós;133;69;64
05;Ávila;199;San Bartolomé de Béjar;99;47;52
05;Ávila;200;San Bartolomé de Corneja;138;72;66
05;Ávila;201;San Bartolomé de Pinares;815;437;378
05;Ávila;206;San Esteban de los Patos;48;27;21
05;Ávila;208;San Esteban de Zapardiel;83;39;44
05;Ávila;207;San Esteban del Valle;1002;513;489
05;Ávila;209;San García de Ingelmos;198;102;96
05;Ávila;901;San Juan de Gredos;466;233;233
05;Ávila;210;San Juan de la Encinilla;158;71;87
05;Ávila;211;San Juan de la Nava;723;375;348
05;Ávila;212;San Juan del Molinillo;379;206;173
05;Ávila;213;San Juan del Olmo;201;110;91
05;Ávila;214;San Lorenzo de Tormes;83;38;45
05;Ávila;215;San Martín de la Vega del Alberche;322;188;134
05;Ávila;216;San Martín del Pimpollar;352;190;162
05;Ávila;217;San Miguel de Corneja;138;68;70
05;Ávila;218;San Miguel de Serrezuela;243;125;118
05;Ávila;219;San Pascual;75;42;33
05;Ávila;220;San Pedro del Arroyo;497;256;241
05;Ávila;231;San Vicente de Arévalo;244;121;123
05;Ávila;204;Sanchidrián;776;386;390
05;Ávila;205;Sanchorreja;141;76;65
05;Ávila;222;Santa Cruz de Pinares;236;132;104
05;Ávila;221;Santa Cruz del Valle;667;341;326
05;Ávila;226;Santa María de los Caballeros;182;91;91
05;Ávila;224;Santa María del Arroyo;152;79;73
05;Ávila;225;Santa María del Berrocal;680;322;358
05;Ávila;902;Santa María del Cubillo;409;225;184
05;Ávila;227;Santa María del Tiétar;400;212;188
05;Ávila;228;Santiago del Collado;323;195;128
05;Ávila;904;Santiago del Tormes;372;187;185
05;Ávila;229;Santo Domingo de las Posadas;100;50;50
05;Ávila;230;Santo Tomé de Zabarcos;131;72;59
05;Ávila;232;Serrada (La);145;73;72
05;Ávila;233;Serranillos;515;263;252
05;Ávila;234;Sigeres;93;42;51
05;Ávila;235;Sinlabajos;271;141;130
05;Ávila;236;Solana de Ávila;258;136;122
05;Ávila;237;Solana de Rioalmar;337;177;160
05;Ávila;238;Solosancho;1151;610;541
05;Ávila;239;Sotalbo;281;141;140
05;Ávila;240;Sotillo de la Adrada;3534;1754;1780
05;Ávila;241;Tiemblo (El);3808;1922;1886
05;Ávila;242;Tiñosillos;764;413;351
05;Ávila;243;Tolbaños;164;82;82
05;Ávila;244;Tormellas;138;72;66
05;Ávila;245;Tornadizos de Ávila;352;173;179
05;Ávila;247;Torre (La);491;266;225
05;Ávila;246;Tórtoles;140;74;66
05;Ávila;249;Umbrías;179;90;89
05;Ávila;251;Vadillo de la Sierra;190;107;83
05;Ávila;252;Valdecasa;134;72;62
05;Ávila;253;Vega de Santa María;147;83;64
05;Ávila;254;Velayos;301;151;150
05;Ávila;256;Villaflor;182;94;88
05;Ávila;257;Villafranca de la Sierra;271;143;128
05;Ávila;905;Villanueva de Ávila;620;323;297
05;Ávila;258;Villanueva de Gómez;166;77;89
05;Ávila;259;Villanueva del Aceral;233;105;128
05;Ávila;260;Villanueva del Campillo;244;123;121
05;Ávila;261;Villar de Corneja;106;52;54
05;Ávila;262;Villarejo del Valle;493;260;233
05;Ávila;263;Villatoro;253;136;117
05;Ávila;264;Viñegra de Moraña;101;52;49
05;Ávila;265;Vita;126;76;50
05;Ávila;266;Zapardiel de la Cañada;215;106;109
05;Ávila;267;Zapardiel de la Ribera;157;81;76
06;Badajoz;001;Acedera;1037;556;481
06;Badajoz;002;Aceuchal;5137;2523;2614
06;Badajoz;003;Ahillones;1246;615;631
06;Badajoz;004;Alange;2064;1066;998
06;Badajoz;005;Albuera (La);1820;924;896
06;Badajoz;006;Alburquerque;5797;2946;2851
06;Badajoz;007;Alconchel;2309;1144;1165
06;Badajoz;008;Alconera;766;389;377
06;Badajoz;009;Aljucén;226;122;104
06;Badajoz;010;Almendral;1529;756;773
06;Badajoz;011;Almendralejo;26869;13148;13721
06;Badajoz;012;Arroyo de San Serván;4085;2081;2004
06;Badajoz;013;Atalaya;388;188;200
06;Badajoz;014;Azuaga;10064;4937;5127
06;Badajoz;015;Badajoz;132154;64041;68113
06;Badajoz;016;Barcarrota;4195;2112;2083
06;Badajoz;017;Baterno;414;208;206
06;Badajoz;018;Benquerencia de la Serena;1150;573;577
06;Badajoz;019;Berlanga;2769;1365;1404
06;Badajoz;020;Bienvenida;2475;1254;1221
06;Badajoz;021;Bodonal de la Sierra;1442;736;706
06;Badajoz;022;Burguillos del Cerro;3393;1667;1726
06;Badajoz;023;Cabeza del Buey;6374;3126;3248
06;Badajoz;024;Cabeza la Vaca;1660;832;828
06;Badajoz;025;Calamonte;5868;2936;2932
06;Badajoz;026;Calera de León;1187;593;594
06;Badajoz;027;Calzadilla de los Barros;825;413;412
06;Badajoz;028;Campanario;6036;2918;3118
06;Badajoz;029;Campillo de Llerena;1817;898;919
06;Badajoz;030;Capilla;235;109;126
06;Badajoz;031;Carmonita;728;376;352
06;Badajoz;032;Carrascalejo (El);29;14;15
06;Badajoz;033;Casas de Don Pedro;1914;944;970
06;Badajoz;034;Casas de Reina;319;139;180
06;Badajoz;035;Castilblanco;1456;729;727
06;Badajoz;036;Castuera;7522;3783;3739
06;Badajoz;042;Cheles;1387;691;696
06;Badajoz;037;Codosera (La);2639;1359;1280
06;Badajoz;038;Cordobilla de Lácara;1031;524;507
06;Badajoz;039;Coronada (La);2544;1259;1285
06;Badajoz;040;Corte de Peleas;1315;662;653
06;Badajoz;041;Cristina;568;303;265
06;Badajoz;043;Don Álvaro;655;327;328
06;Badajoz;044;Don Benito;31098;15409;15689
06;Badajoz;045;Entrín Bajo;708;355;353
06;Badajoz;046;Esparragalejo;1527;752;775
06;Badajoz;047;Esparragosa de la Serena;1172;582;590
06;Badajoz;048;Esparragosa de Lares;1266;623;643
06;Badajoz;049;Feria;1575;778;797
06;Badajoz;050;Fregenal de la Sierra;5544;2674;2870
06;Badajoz;051;Fuenlabrada de los Montes;2153;1066;1087
06;Badajoz;052;Fuente de Cantos;5211;2626;2585
06;Badajoz;053;Fuente del Arco;877;447;430
06;Badajoz;054;Fuente del Maestre;6912;3432;3480
06;Badajoz;055;Fuentes de León;2878;1389;1489
06;Badajoz;056;Garbayuela;615;326;289
06;Badajoz;057;Garlitos;851;438;413
06;Badajoz;058;Garrovilla (La);2702;1394;1308
06;Badajoz;059;Granja de Torrehermosa;2718;1370;1348
06;Badajoz;060;Guareña;7404;3763;3641
06;Badajoz;061;Haba (La);1538;775;763
06;Badajoz;062;Helechosa de los Montes;841;452;389
06;Badajoz;063;Herrera del Duque;4153;2131;2022
06;Badajoz;064;Higuera de la Serena;1298;656;642
06;Badajoz;065;Higuera de Llerena;528;256;272
06;Badajoz;066;Higuera de Vargas;3001;1502;1499
06;Badajoz;067;Higuera la Real;2798;1405;1393
06;Badajoz;068;Hinojosa del Valle;632;328;304
06;Badajoz;069;Hornachos;3930;1981;1949
06;Badajoz;070;Jerez de los Caballeros;10587;5291;5296
06;Badajoz;071;Lapa (La);357;179;178
06;Badajoz;073;Llera;1051;546;505
06;Badajoz;074;Llerena;5795;2808;2987
06;Badajoz;072;Lobón;2780;1424;1356
06;Badajoz;075;Magacela;852;436;416
06;Badajoz;076;Maguilla;1153;584;569
06;Badajoz;077;Malcocinado;593;308;285
06;Badajoz;078;Malpartida de la Serena;1035;526;509
06;Badajoz;079;Manchita;784;398;386
06;Badajoz;080;Medellín;2529;1278;1251
06;Badajoz;081;Medina de las Torres;1666;825;841
06;Badajoz;082;Mengabril;484;241;243
06;Badajoz;083;Mérida;52518;25711;26807
06;Badajoz;084;Mirandilla;1369;695;674
06;Badajoz;085;Monesterio;5132;2562;2570
06;Badajoz;086;Montemolín;1843;896;947
06;Badajoz;087;Monterrubio de la Serena;3259;1586;1673
06;Badajoz;088;Montijo;15340;7467;7873
06;Badajoz;089;Morera (La);786;397;389
06;Badajoz;090;Nava de Santiago (La);1150;589;561
06;Badajoz;091;Navalvillar de Pela;5171;2599;2572
06;Badajoz;092;Nogales;816;410;406
06;Badajoz;093;Oliva de la Frontera;6479;3237;3242
06;Badajoz;094;Oliva de Mérida;2157;1085;1072
06;Badajoz;095;Olivenza;10717;5300;5417
06;Badajoz;096;Orellana de la Sierra;451;227;224
06;Badajoz;097;Orellana la Vieja;3997;2001;1996
06;Badajoz;098;Palomas;706;371;335
06;Badajoz;099;Parra (La);1457;744;713
06;Badajoz;100;Peñalsordo;1734;828;906
06;Badajoz;101;Peraleda del Zaucejo;715;368;347
06;Badajoz;102;Puebla de Alcocer;1581;784;797
06;Badajoz;103;Puebla de la Calzada;5553;2769;2784
06;Badajoz;104;Puebla de la Reina;932;480;452
06;Badajoz;107;Puebla de Obando;2109;1041;1068
06;Badajoz;108;Puebla de Sancho Pérez;3045;1524;1521
06;Badajoz;105;Puebla del Maestre;1015;502;513
06;Badajoz;106;Puebla del Prior;629;322;307
06;Badajoz;109;Quintana de la Serena;5162;2587;2575
06;Badajoz;110;Reina;241;127;114
06;Badajoz;111;Rena;689;347;342
06;Badajoz;112;Retamal de Llerena;619;320;299
06;Badajoz;113;Ribera del Fresno;3524;1682;1842
06;Badajoz;114;Risco;249;127;122
06;Badajoz;115;Roca de la Sierra (La);1640;810;830
06;Badajoz;116;Salvaleón;2490;1272;1218
06;Badajoz;117;Salvatierra de los Barros;2051;1008;1043
06;Badajoz;119;San Pedro de Mérida;798;416;382
06;Badajoz;123;San Vicente de Alcántara;6077;3008;3069
06;Badajoz;118;Sancti-Spíritus;371;178;193
06;Badajoz;120;Santa Amalia;4402;2198;2204
06;Badajoz;121;Santa Marta;4145;2067;2078
06;Badajoz;122;Santos de Maimona (Los);7898;3964;3934
06;Badajoz;124;Segura de León;2375;1181;1194
06;Badajoz;125;Siruela;2547;1252;1295
06;Badajoz;126;Solana de los Barros;2840;1449;1391
06;Badajoz;127;Talarrubias;3799;1888;1911
06;Badajoz;128;Talavera la Real;5346;2714;2632
06;Badajoz;129;Táliga;749;375;374
06;Badajoz;130;Tamurejo;285;139;146
06;Badajoz;131;Torre de Miguel Sesmero;1330;647;683
06;Badajoz;132;Torremayor;1171;584;587
06;Badajoz;133;Torremejía;2003;1009;994
06;Badajoz;134;Trasierra;723;385;338
06;Badajoz;135;Trujillanos;1088;568;520
06;Badajoz;136;Usagre;2208;1113;1095
06;Badajoz;137;Valdecaballeros;1504;743;761
06;Badajoz;901;Valdelacalzada;2533;1294;1239
06;Badajoz;138;Valdetorres;1420;712;708
06;Badajoz;139;Valencia de las Torres;922;455;467
06;Badajoz;140;Valencia del Mombuey;922;449;473
06;Badajoz;141;Valencia del Ventoso;2500;1237;1263
06;Badajoz;146;Valle de la Serena;1777;862;915
06;Badajoz;147;Valle de Matamoros;557;270;287
06;Badajoz;148;Valle de Santa Ana;1304;662;642
06;Badajoz;142;Valverde de Burguillos;435;219;216
06;Badajoz;143;Valverde de Leganés;3729;1918;1811
06;Badajoz;144;Valverde de Llerena;914;447;467
06;Badajoz;145;Valverde de Mérida;1168;602;566
06;Badajoz;149;Villafranca de los Barros;12677;6254;6423
06;Badajoz;150;Villagarcía de la Torre;1073;547;526
06;Badajoz;151;Villagonzalo;1549;758;791
06;Badajoz;152;Villalba de los Barros;1783;894;889
06;Badajoz;153;Villanueva de la Serena;24145;11864;12281
06;Badajoz;154;Villanueva del Fresno;3595;1806;1789
06;Badajoz;156;Villar de Rena;1775;941;834
06;Badajoz;155;Villar del Rey;2384;1229;1155
06;Badajoz;157;Villarta de los Montes;795;391;404
06;Badajoz;158;Zafra;14930;7234;7696
06;Badajoz;159;Zahínos;3252;1641;1611
06;Badajoz;160;Zalamea de la Serena;5079;2528;2551
06;Badajoz;162;Zarza (La);3763;1887;1876
06;Badajoz;161;Zarza-Capilla;592;297;295
07;Balears (Illes);002;Alaior;7000;3524;3476
07;Balears (Illes);001;Alaró;4020;1922;2098
07;Balears (Illes);003;Alcúdia;9905;5044;4861
07;Balears (Illes);004;Algaida;3468;1744;1724
07;Balears (Illes);005;Andratx;7469;3726;3743
07;Balears (Illes);901;Ariany;844;404;440
07;Balears (Illes);006;Artà;5872;2918;2954
07;Balears (Illes);007;Banyalbufar;526;262;264
07;Balears (Illes);008;Binissalem;4867;2347;2520
07;Balears (Illes);009;Búger;912;451;461
07;Balears (Illes);010;Bunyola;4813;2431;2382
07;Balears (Illes);011;Calvià;29504;14878;14626
07;Balears (Illes);012;Campanet;2277;1114;1163
07;Balears (Illes);013;Campos;6741;3383;3358
07;Balears (Illes);014;Capdepera;7223;3615;3608
07;Balears (Illes);064;Castell (Es);5927;2945;2982
07;Balears (Illes);015;Ciutadella de Menorca;21234;10580;10654
07;Balears (Illes);016;Consell;2136;1045;1091
07;Balears (Illes);017;Costitx;802;393;409
07;Balears (Illes);018;Deyá;577;289;288
07;Balears (Illes);026;Eivissa;34610;17470;17140
07;Balears (Illes);019;Escorca;334;178;156
07;Balears (Illes);020;Esporles;3579;1783;1796
07;Balears (Illes);021;Estellencs;341;182;159
07;Balears (Illes);022;Felanitx;14318;7122;7196
07;Balears (Illes);023;Ferreries;3828;2008;1820
07;Balears (Illes);024;Formentera;5435;2765;2670
07;Balears (Illes);025;Fornalutx;593;304;289
07;Balears (Illes);027;Inca;21501;10514;10987
07;Balears (Illes);028;Lloret de Vistalegre;810;402;408
07;Balears (Illes);029;Lloseta;4524;2275;2249
07;Balears (Illes);030;Llubí;1913;935;978
07;Balears (Illes);031;Llucmajor;20237;10060;10177
07;Balears (Illes);032;Mahón;23278;11383;11895
07;Balears (Illes);033;Manacor;29159;14436;14723
07;Balears (Illes);034;Mancor de la Vall;880;423;457
07;Balears (Illes);035;Maria de la Salut;1801;874;927
07;Balears (Illes);036;Marratxí;15275;7711;7564
07;Balears (Illes);037;Mercadal (Es);2601;1304;1297
07;Balears (Illes);902;Migjorn Gran (Es);1074;554;520
07;Balears (Illes);038;Montuïri;2192;1066;1126
07;Balears (Illes);039;Muro;5883;2880;3003
07;Balears (Illes);040;Palma de Mallorca;323138;157418;165720
07;Balears (Illes);041;Petra;2642;1285;1357
07;Balears (Illes);044;Pobla (Sa);10394;5302;5092
07;Balears (Illes);042;Pollença;13127;6588;6539
07;Balears (Illes);043;Porreres;4284;2125;2159
07;Balears (Illes);045;Puigpunyent;1180;586;594
07;Balears (Illes);059;Salines (Ses);3224;1611;1613
07;Balears (Illes);046;Sant Antoni de Portmany;15029;7644;7385
07;Balears (Illes);049;Sant Joan;1684;826;858
07;Balears (Illes);050;Sant Joan de Labritja;3735;1858;1877
07;Balears (Illes);048;Sant Josep de sa Talaia;12044;6217;5827
07;Balears (Illes);051;Sant Llorenç des Cardassar;5112;2548;2564
07;Balears (Illes);052;Sant Lluís;3789;1904;1885
07;Balears (Illes);053;Santa Eugènia;1034;523;511
07;Balears (Illes);054;Santa Eulalia del Río;18955;9606;9349
07;Balears (Illes);055;Santa Margalida;6615;3302;3313
07;Balears (Illes);056;Santa María del Camí;4333;2127;2206
07;Balears (Illes);057;Santanyí;7714;3870;3844
07;Balears (Illes);058;Selva;2916;1431;1485
07;Balears (Illes);047;Sencelles;1798;891;907
07;Balears (Illes);060;Sineu;2623;1296;1327
07;Balears (Illes);061;Sóller;10541;5182;5359
07;Balears (Illes);062;Son Servera;8132;4084;4048
07;Balears (Illes);063;Valldemossa;1495;718;777
07;Balears (Illes);065;Vilafranca de Bonany;2163;1057;1106
08;Barcelona;001;Abrera;6629;3422;3207
08;Barcelona;002;Aguilar de Segarra;212;108;104
08;Barcelona;014;Aiguafreda;2086;1020;1066
08;Barcelona;003;Alella;7540;3750;3790
08;Barcelona;004;Alpens;257;139;118
08;Barcelona;005;Ametlla del Vallès (L');4447;2202;2245
08;Barcelona;006;Arenys de Mar;11906;5766;6140
08;Barcelona;007;Arenys de Munt;5441;2664;2777
08;Barcelona;008;Argençola;210;106;104
08;Barcelona;009;Argentona;8627;4278;4349
08;Barcelona;010;Artés;4318;2131;2187
08;Barcelona;011;Avià;1793;913;880
08;Barcelona;012;Avinyó;2022;1000;1022
08;Barcelona;013;Avinyonet del Penedès;1221;612;609
08;Barcelona;015;Badalona;217983;107715;110268
08;Barcelona;904;Badia del Vallès;17927;9083;8844
08;Barcelona;016;Bagà;2114;1037;1077
08;Barcelona;017;Balenyà;3314;1692;1622
08;Barcelona;018;Balsareny;3379;1656;1723
08;Barcelona;252;Barberà del Vallès;24623;12430;12193
08;Barcelona;019;Barcelona;1614571;761244;853327
08;Barcelona;020;Begues;2799;1416;1383
08;Barcelona;021;Bellprat;95;50;45
08;Barcelona;022;Berga;14512;7038;7474
08;Barcelona;023;Bigues i Riells;3676;1917;1759
08;Barcelona;024;Borredà;474;232;242
08;Barcelona;025;Bruc (El);877;463;414
08;Barcelona;026;Brull (El);218;107;111
08;Barcelona;027;Cabanyes (Les);425;233;192
08;Barcelona;029;Cabrera de Mar;3277;1660;1617
08;Barcelona;028;Cabrera d'Igualada;341;187;154
08;Barcelona;030;Cabrils;3699;1828;1871
08;Barcelona;031;Calaf;3151;1547;1604
08;Barcelona;034;Calders;622;330;292
08;Barcelona;033;Caldes de Montbui;12279;6058;6221
08;Barcelona;032;Caldes d'Estrac;1652;788;864
08;Barcelona;035;Calella;12069;5693;6376
08;Barcelona;037;Calldetenes;1594;824;770
08;Barcelona;038;Callús;1344;657;687
08;Barcelona;036;Calonge de Segarra;190;102;88
08;Barcelona;039;Campins;217;100;117
08;Barcelona;040;Canet de Mar;9300;4523;4777
08;Barcelona;041;Canovelles;13506;6822;6684
08;Barcelona;042;Cànoves i Samalús;1430;719;711
08;Barcelona;043;Canyelles;1140;598;542
08;Barcelona;044;Capellades;5025;2445;2580
08;Barcelona;045;Capolat;70;39;31
08;Barcelona;046;Cardedeu;10467;5224;5243
08;Barcelona;047;Cardona;6192;3021;3171
08;Barcelona;048;Carme;691;359;332
08;Barcelona;049;Casserres;1627;784;843
08;Barcelona;057;Castell de l'Areny;52;30;22
08;Barcelona;052;Castellar de n'Hug;162;82;80
08;Barcelona;050;Castellar del Riu;80;49;31
08;Barcelona;051;Castellar del Vallès;15442;7721;7721
08;Barcelona;053;Castellbell i el Vilar;2896;1440;1456
08;Barcelona;054;Castellbisbal;5864;3033;2831
08;Barcelona;055;Castellcir;274;155;119
08;Barcelona;056;Castelldefels;36647;18331;18316
08;Barcelona;058;Castellet i la Gornal;1193;595;598
08;Barcelona;060;Castellfollit de Riubregós;234;115;119
08;Barcelona;059;Castellfollit del Boix;341;168;173
08;Barcelona;061;Castellgalí;764;382;382
08;Barcelona;062;Castellnou de Bages;305;166;139
08;Barcelona;063;Castellolí;430;218;212
08;Barcelona;064;Castellterçol;1956;945;1011
08;Barcelona;065;Castellví de la Marca;1444;738;706
08;Barcelona;066;Castellví de Rosanes;841;436;405
08;Barcelona;067;Centelles;5791;2841;2950
08;Barcelona;268;Cercs;1611;784;827
08;Barcelona;266;Cerdanyola del Vallès;50235;25220;25015
08;Barcelona;068;Cervelló;6999;3530;3469
08;Barcelona;069;Collbató;1384;717;667
08;Barcelona;070;Collsuspina;238;123;115
08;Barcelona;071;Copons;265;134;131
08;Barcelona;072;Corbera de Llobregat;7002;3563;3439
08;Barcelona;073;Cornellà de Llobregat;83287;41073;42214
08;Barcelona;074;Cubelles;4456;2250;2206
08;Barcelona;075;Dosrius;2203;1138;1065
08;Barcelona;076;Esparreguera;14188;7133;7055
08;Barcelona;077;Esplugues de Llobregat;48244;23911;24333
08;Barcelona;078;Espunyola (L');275;140;135
08;Barcelona;079;Estany (L');390;187;203
08;Barcelona;134;Figaró-Montmany;701;371;330
08;Barcelona;080;Fígols;56;32;24
08;Barcelona;082;Fogars de la Selva;533;271;262
08;Barcelona;081;Fogars de Montclús;284;151;133
08;Barcelona;083;Folgueroles;1231;610;621
08;Barcelona;084;Fonollosa;769;382;387
08;Barcelona;085;Font-rubí;1188;617;571
08;Barcelona;086;Franqueses del Vallès (Les);10768;5429;5339
08;Barcelona;090;Gaià;164;87;77
08;Barcelona;087;Gallifa;139;74;65
08;Barcelona;088;Garriga (La);10287;4984;5303
08;Barcelona;089;Gavà;37953;18950;19003
08;Barcelona;091;Gelida;4192;2101;2091
08;Barcelona;092;Gironella;5142;2484;2658
08;Barcelona;093;Gisclareny;30;15;15
08;Barcelona;094;Granada (La);1288;633;655
08;Barcelona;095;Granera;57;35;22
08;Barcelona;096;Granollers;53225;26141;27084
08;Barcelona;097;Gualba;635;323;312
08;Barcelona;099;Guardiola de Berguedà;1020;505;515
08;Barcelona;100;Gurb;1786;915;871
08;Barcelona;101;Hospitalet de Llobregat (L');262501;129079;133422
08;Barcelona;162;Hostalets de Pierola (Els);1110;563;547
08;Barcelona;102;Igualada;32460;15691;16769
08;Barcelona;103;Jorba;558;268;290
08;Barcelona;104;Llacuna (La);837;422;415
08;Barcelona;105;Llagosta (La);11662;5840;5822
08;Barcelona;107;Lliçà d'Amunt;7273;3784;3489
08;Barcelona;108;Lliçà de Vall;4312;2203;2109
08;Barcelona;106;Llinars del Vallès;6207;3159;3048
08;Barcelona;109;Lluçà;273;148;125
08;Barcelona;110;Malgrat de Mar;12341;6132;6209
08;Barcelona;111;Malla;255;120;135
08;Barcelona;112;Manlleu;16938;8395;8543
08;Barcelona;113;Manresa;65724;31679;34045
08;Barcelona;242;Marganell;221;97;124
08;Barcelona;114;Martorell;17493;8784;8709
08;Barcelona;115;Martorelles;5041;2524;2517
08;Barcelona;116;Masies de Roda (Les);635;314;321
08;Barcelona;117;Masies de Voltregà (Les);2587;1281;1306
08;Barcelona;118;Masnou (El);20301;9871;10430
08;Barcelona;119;Masquefa;3213;1618;1595
08;Barcelona;120;Matadepera;5846;2944;2902
08;Barcelona;121;Mataró;102137;50197;51940
08;Barcelona;122;Mediona;1245;633;612
08;Barcelona;138;Moià;3591;1761;1830
08;Barcelona;123;Molins de Rei;19144;9430;9714
08;Barcelona;124;Mollet del Vallès;43502;21741;21761
08;Barcelona;128;Monistrol de Calders;601;295;306
08;Barcelona;127;Monistrol de Montserrat;2502;1253;1249
08;Barcelona;125;Montcada i Reixac;27531;13648;13883
08;Barcelona;130;Montclar;251;109;142
08;Barcelona;131;Montesquiu;846;406;440
08;Barcelona;126;Montgat;7809;3817;3992
08;Barcelona;132;Montmajor;483;252;231
08;Barcelona;133;Montmaneu;235;133;102
08;Barcelona;135;Montmeló;7719;3819;3900
08;Barcelona;136;Montornès del Vallès;11573;5786;5787
08;Barcelona;137;Montseny;300;156;144
08;Barcelona;129;Muntanyola;226;127;99
08;Barcelona;139;Mura;203;110;93
08;Barcelona;140;Navarcles;5255;2623;2632
08;Barcelona;141;Navàs;5699;2821;2878
08;Barcelona;142;Nou de Berguedà (La);149;80;69
08;Barcelona;143;Òdena;2634;1334;1300
08;Barcelona;145;Olèrdola;1880;968;912
08;Barcelona;146;Olesa de Bonesvalls;623;337;286
08;Barcelona;147;Olesa de Montserrat;15592;7817;7775
08;Barcelona;148;Olivella;767;405;362
08;Barcelona;149;Olost;1210;601;609
08;Barcelona;144;Olvan;961;455;506
08;Barcelona;150;Orís;218;118;100
08;Barcelona;151;Oristà;691;341;350
08;Barcelona;152;Orpí;150;79;71
08;Barcelona;153;Òrrius;368;195;173
08;Barcelona;154;Pacs del Penedès;540;285;255
08;Barcelona;155;Palafolls;3995;1986;2009
08;Barcelona;156;Palau-solità i Plegamans;9539;4893;4646
08;Barcelona;157;Pallejà;6994;3498;3496
08;Barcelona;905;Palma de Cervelló (La);"";"";""
08;Barcelona;158;Papiol (El);3478;1734;1744
08;Barcelona;159;Parets del Vallès;12292;6227;6065
08;Barcelona;160;Perafita;334;159;175
08;Barcelona;161;Piera;7058;3563;3495
08;Barcelona;163;Pineda de Mar;17814;8913;8901
08;Barcelona;164;Pla del Penedès (El);975;482;493
08;Barcelona;165;Pobla de Claramunt (La);1697;847;850
08;Barcelona;166;Pobla de Lillet (La);1690;831;859
08;Barcelona;167;Polinyà;3904;2007;1897
08;Barcelona;182;Pont de Vilomara i Rocafort (El);2424;1223;1201
08;Barcelona;168;Pontons;312;168;144
08;Barcelona;169;Prat de Llobregat (El);64987;32599;32388
08;Barcelona;171;Prats de Lluçanès;2737;1350;1387
08;Barcelona;170;Prats de Rei (Els);558;272;286
08;Barcelona;230;Premià de Dalt;7555;3797;3758
08;Barcelona;172;Premià de Mar;25300;12689;12611
08;Barcelona;174;Puigdàlber;306;138;168
08;Barcelona;175;Puig-reig;4732;2307;2425
08;Barcelona;176;Pujalt;181;92;89
08;Barcelona;177;Quar (La);55;29;26
08;Barcelona;178;Rajadell;319;168;151
08;Barcelona;179;Rellinars;317;155;162
08;Barcelona;180;Ripollet;28622;14316;14306
08;Barcelona;181;Roca del Vallès (La);6502;3264;3238
08;Barcelona;183;Roda de Ter;4952;2400;2552
08;Barcelona;184;Rubí;53100;26714;26386
08;Barcelona;185;Rubió;119;63;56
08;Barcelona;901;Rupit i Pruit;364;184;180
08;Barcelona;187;Sabadell;188386;91838;96548
08;Barcelona;188;Sagàs;189;102;87
08;Barcelona;190;Saldes;327;181;146
08;Barcelona;191;Sallent;7501;3642;3859
08;Barcelona;194;Sant Adrià de Besòs;34361;16990;17371
08;Barcelona;195;Sant Agustí de Lluçanès;108;53;55
08;Barcelona;196;Sant Andreu de la Barca;17254;8847;8407
08;Barcelona;197;Sant Andreu de Llavaneres;5723;2857;2866
08;Barcelona;198;Sant Antoni de Vilamajor;2585;1291;1294
08;Barcelona;199;Sant Bartomeu del Grau;1207;648;559
08;Barcelona;200;Sant Boi de Llobregat;79737;39838;39899
08;Barcelona;201;Sant Boi de Lluçanès;538;267;271
08;Barcelona;203;Sant Cebrià de Vallalta;1198;663;535
08;Barcelona;202;Sant Celoni;12896;6442;6454
08;Barcelona;204;Sant Climent de Llobregat;2443;1202;1241
08;Barcelona;205;Sant Cugat del Vallès;44956;22192;22764
08;Barcelona;206;Sant Cugat Sesgarrigues;743;401;342
08;Barcelona;207;Sant Esteve de Palautordera;1267;648;619
08;Barcelona;208;Sant Esteve Sesrovires;3422;1740;1682
08;Barcelona;210;Sant Feliu de Codines;3973;1935;2038
08;Barcelona;211;Sant Feliu de Llobregat;36736;18199;18537
08;Barcelona;212;Sant Feliu Sasserra;644;327;317
08;Barcelona;209;Sant Fost de Campsentelles;5612;2877;2735
08;Barcelona;213;Sant Fruitós de Bages;5026;2528;2498
08;Barcelona;215;Sant Hipòlit de Voltregà;2979;1469;1510
08;Barcelona;193;Sant Iscle de Vallalta;648;334;314
08;Barcelona;216;Sant Jaume de Frontanyà;26;14;12
08;Barcelona;218;Sant Joan de Vilatorrada;8409;4209;4200
08;Barcelona;217;Sant Joan Despí;27013;13454;13559
08;Barcelona;903;Sant Julià de Cerdanyola;222;114;108
08;Barcelona;220;Sant Julià de Vilatorta;2004;980;1024
08;Barcelona;221;Sant Just Desvern;13553;6516;7037
08;Barcelona;222;Sant Llorenç d'Hortons;1261;640;621
08;Barcelona;223;Sant Llorenç Savall;2024;980;1044
08;Barcelona;225;Sant Martí d'Albars;126;67;59
08;Barcelona;224;Sant Martí de Centelles;661;336;325
08;Barcelona;226;Sant Martí de Tous;943;470;473
08;Barcelona;227;Sant Martí Sarroca;2491;1257;1234
08;Barcelona;228;Sant Martí Sesgueioles;365;181;184
08;Barcelona;229;Sant Mateu de Bages;530;269;261
08;Barcelona;231;Sant Pere de Ribes;17391;8743;8648
08;Barcelona;232;Sant Pere de Riudebitlles;2147;1059;1088
08;Barcelona;233;Sant Pere de Torelló;2061;993;1068
08;Barcelona;234;Sant Pere de Vilamajor;1657;840;817
08;Barcelona;189;Sant Pere Sallavinera;179;92;87
08;Barcelona;235;Sant Pol de Mar;2715;1367;1348
08;Barcelona;236;Sant Quintí de Mediona;1627;811;816
08;Barcelona;237;Sant Quirze de Besora;2004;971;1033
08;Barcelona;238;Sant Quirze del Vallès;10262;5092;5170
08;Barcelona;239;Sant Quirze Safaja;259;132;127
08;Barcelona;240;Sant Sadurní d'Anoia;9458;4734;4724
08;Barcelona;241;Sant Sadurní d'Osormort;82;42;40
08;Barcelona;098;Sant Salvador de Guardiola;1612;819;793
08;Barcelona;262;Sant Vicenç de Castellet;7554;3622;3932
08;Barcelona;264;Sant Vicenç de Montalt;2091;1063;1028
08;Barcelona;265;Sant Vicenç de Torelló;1739;827;912
08;Barcelona;263;Sant Vicenç dels Horts;22545;11416;11129
08;Barcelona;243;Santa Cecilia de Voltregà;190;109;81
08;Barcelona;244;Santa Coloma de Cervelló;3242;1593;1649
08;Barcelona;245;Santa Coloma de Gramenet;129751;64819;64932
08;Barcelona;246;Santa Eugènia de Berga;2080;1056;1024
08;Barcelona;247;Santa Eulàlia de Riuprimer;850;439;411
08;Barcelona;248;Santa Eulàlia de Ronçana;3829;1939;1890
08;Barcelona;249;Santa Fe del Penedès;222;105;117
08;Barcelona;250;Santa Margarida de Montbui;9440;4727;4713
08;Barcelona;251;Santa Margarida i els Monjos;4232;2180;2052
08;Barcelona;253;Santa Maria de Besora;192;98;94
08;Barcelona;254;Santa Maria de Corcó;2061;1042;1019
08;Barcelona;256;Santa Maria de Martorelles;675;328;347
08;Barcelona;255;Santa Maria de Merlès;189;95;94
08;Barcelona;257;Santa Maria de Miralles;112;60;52
08;Barcelona;259;Santa Maria de Palautordera;5358;2729;2629
08;Barcelona;258;Santa Maria d'Oló;999;511;488
08;Barcelona;260;Santa Perpètua de Mogoda;17603;8946;8657
08;Barcelona;261;Santa Susanna;1365;680;685
08;Barcelona;192;Santpedor;4892;2398;2494
08;Barcelona;267;Sentmenat;5042;2531;2511
08;Barcelona;269;Seva;1923;973;950
08;Barcelona;270;Sitges;16107;7918;8189
08;Barcelona;271;Sobremunt;97;48;49
08;Barcelona;272;Sora;193;101;92
08;Barcelona;273;Subirats;2246;1125;1121
08;Barcelona;274;Súria;6395;3135;3260
08;Barcelona;276;Tagamanent;178;94;84
08;Barcelona;277;Talamanca;109;56;53
08;Barcelona;278;Taradell;4555;2255;2300
08;Barcelona;275;Tavèrnoles;239;111;128
08;Barcelona;280;Tavertet;126;64;62
08;Barcelona;281;Teià;4426;2244;2182
08;Barcelona;279;Terrassa;162327;79294;83033
08;Barcelona;282;Tiana;5168;2587;2581
08;Barcelona;283;Tona;5701;2828;2873
08;Barcelona;284;Tordera;8951;4477;4474
08;Barcelona;285;Torelló;11903;5833;6070
08;Barcelona;286;Torre de Claramunt (La);1958;1023;935
08;Barcelona;287;Torrelavit;1226;627;599
08;Barcelona;288;Torrelles de Foix;1602;858;744
08;Barcelona;289;Torrelles de Llobregat;3043;1552;1491
08;Barcelona;290;Ullastrell;966;496;470
08;Barcelona;291;Vacarisses;1577;818;759
08;Barcelona;292;Vallbona d'Anoia;1036;521;515
08;Barcelona;293;Vallcebre;293;159;134
08;Barcelona;294;Vallgorguina;974;491;483
08;Barcelona;295;Vallirana;7730;3889;3841
08;Barcelona;296;Vallromanes;926;476;450
08;Barcelona;297;Veciana;164;85;79
08;Barcelona;298;Vic;30206;14564;15642
08;Barcelona;299;Vilada;531;273;258
08;Barcelona;301;Viladecans;52510;26487;26023
08;Barcelona;300;Viladecavalls;4423;2198;2225
08;Barcelona;305;Vilafranca del Penedès;28240;13807;14433
08;Barcelona;306;Vilalba Sasserra;342;177;165
08;Barcelona;303;Vilanova de Sau;308;148;160
08;Barcelona;302;Vilanova del Camí;9947;5024;4923
08;Barcelona;902;Vilanova del Vallès;1810;921;889
08;Barcelona;307;Vilanova i la Geltrú;48955;24049;24906
08;Barcelona;214;Vilassar de Dalt;7224;3526;3698
08;Barcelona;219;Vilassar de Mar;14631;7191;7440
08;Barcelona;304;Vilobí del Penedès;817;422;395
08;Barcelona;308;Viver i Serrateix;204;110;94
09;Burgos;001;Abajas;50;24;26
09;Burgos;003;Adrada de Haza;317;167;150
09;Burgos;006;Aguas Cándidas;104;57;47
09;Burgos;007;Aguilar de Bureba;109;58;51
09;Burgos;009;Albillos;145;76;69
09;Burgos;010;Alcocero de Mola;65;39;26
09;Burgos;011;Alfoz de Bricia;143;69;74
09;Burgos;907;Alfoz de Quintanadueñas;532;280;252
09;Burgos;012;Alfoz de Santa Gadea;160;86;74
09;Burgos;013;Altable;68;41;27
09;Burgos;014;Altos (Los);287;162;125
09;Burgos;016;Ameyugo;64;32;32
09;Burgos;017;Anguix;180;91;89
09;Burgos;018;Aranda de Duero;30431;15161;15270
09;Burgos;019;Arandilla;222;132;90
09;Burgos;020;Arauzo de Miel;436;242;194
09;Burgos;021;Arauzo de Salce;83;48;35
09;Burgos;022;Arauzo de Torre;119;64;55
09;Burgos;023;Arcos;253;148;105
09;Burgos;024;Arenillas de Riopisuerga;241;126;115
09;Burgos;025;Arija;272;127;145
09;Burgos;026;Arlanzón;412;219;193
09;Burgos;027;Arraya de Oca;55;29;26
09;Burgos;029;Atapuerca;153;75;78
09;Burgos;030;Ausines (Los);130;73;57
09;Burgos;032;Avellanosa de Muñó;198;101;97
09;Burgos;033;Bahabón de Esgueva;164;96;68
09;Burgos;034;Balbases (Los);390;205;185
09;Burgos;035;Baños de Valdearados;542;295;247
09;Burgos;036;Bañuelos de Bureba;57;37;20
09;Burgos;037;Barbadillo de Herreros;155;82;73
09;Burgos;038;Barbadillo del Mercado;200;99;101
09;Burgos;039;Barbadillo del Pez;119;67;52
09;Burgos;041;Barrio de Muñó;34;20;14
09;Burgos;043;Barrios de Bureba (Los);317;171;146
09;Burgos;044;Barrios de Colina;85;48;37
09;Burgos;045;Basconcillos del Tozo;426;223;203
09;Burgos;046;Bascuñana;83;46;37
09;Burgos;047;Belbimbre;82;41;41
09;Burgos;048;Belorado;2186;1110;1076
09;Burgos;050;Berberana;106;53;53
09;Burgos;051;Berlangas de Roa;298;154;144
09;Burgos;052;Berzosa de Bureba;54;30;24
09;Burgos;054;Bozoó;109;58;51
09;Burgos;055;Brazacorta;99;54;45
09;Burgos;056;Briviesca;6067;3013;3054
09;Burgos;057;Bugedo;106;77;29
09;Burgos;058;Buniel;149;87;62
09;Burgos;059;Burgos;166732;80976;85756
09;Burgos;060;Busto de Bureba;293;156;137
09;Burgos;061;Cabañes de Esgueva;298;155;143
09;Burgos;062;Cabezón de la Sierra;89;42;47
09;Burgos;063;Cabia;225;118;107
09;Burgos;064;Caleruega;440;224;216
09;Burgos;065;Campillo de Aranda;191;106;85
09;Burgos;066;Campolara;104;59;45
09;Burgos;067;Canicosa de la Sierra;673;344;329
09;Burgos;068;Cantabrana;67;37;30
09;Burgos;070;Carazo;48;29;19
09;Burgos;071;Carcedo de Bureba;42;23;19
09;Burgos;072;Carcedo de Burgos;133;77;56
09;Burgos;073;Cardeñadijo;354;192;162
09;Burgos;074;Cardeñajimeno;337;191;146
09;Burgos;075;Cardeñuela Riopico;86;43;43
09;Burgos;076;Carrias;53;36;17
09;Burgos;077;Cascajares de Bureba;69;39;30
09;Burgos;078;Cascajares de la Sierra;17;10;7
09;Burgos;079;Castellanos de Castro;71;40;31
09;Burgos;083;Castil de Peones;49;26;23
09;Burgos;082;Castildelgado;90;45;45
09;Burgos;084;Castrillo de la Reina;324;193;131
09;Burgos;085;Castrillo de la Vega;618;326;292
09;Burgos;088;Castrillo de Riopisuerga;101;59;42
09;Burgos;086;Castrillo del Val;258;150;108
09;Burgos;090;Castrillo Matajudíos;84;42;42
09;Burgos;091;Castrojeriz;1138;574;564
09;Burgos;093;Cayuela;113;66;47
09;Burgos;094;Cebrecos;78;45;33
09;Burgos;095;Celada del Camino;100;44;56
09;Burgos;098;Cerezo de Río Tirón;827;438;389
09;Burgos;100;Cerratón de Juarros;67;37;30
09;Burgos;101;Ciadoncha;144;84;60
09;Burgos;102;Cillaperlata;86;47;39
09;Burgos;103;Cilleruelo de Abajo;381;204;177
09;Burgos;104;Cilleruelo de Arriba;91;47;44
09;Burgos;105;Ciruelos de Cervera;184;96;88
09;Burgos;108;Cogollos;222;127;95
09;Burgos;109;Condado de Treviño;887;481;406
09;Burgos;110;Contreras;111;65;46
09;Burgos;112;Coruña del Conde;170;89;81
09;Burgos;113;Covarrubias;652;337;315
09;Burgos;114;Cubillo del Campo;76;40;36
09;Burgos;115;Cubo de Bureba;143;68;75
09;Burgos;117;Cueva de Roa (La);143;81;62
09;Burgos;119;Cuevas de San Clemente;62;32;30
09;Burgos;120;Encío;67;37;30
09;Burgos;122;Espinosa de Cervera;119;71;48
09;Burgos;124;Espinosa de los Monteros;2426;1252;1174
09;Burgos;123;Espinosa del Camino;58;29;29
09;Burgos;125;Estépar;867;462;405
09;Burgos;127;Fontioso;102;55;47
09;Burgos;128;Frandovínez;92;47;45
09;Burgos;129;Fresneda de la Sierra Tirón;113;62;51
09;Burgos;130;Fresneña;138;73;65
09;Burgos;131;Fresnillo de las Dueñas;312;164;148
09;Burgos;132;Fresno de Río Tirón;267;152;115
09;Burgos;133;Fresno de Rodilla;32;18;14
09;Burgos;134;Frías;341;186;155
09;Burgos;135;Fuentebureba;112;53;59
09;Burgos;136;Fuentecén;319;173;146
09;Burgos;137;Fuentelcésped;232;118;114
09;Burgos;138;Fuentelisendo;135;70;65
09;Burgos;139;Fuentemolinos;134;72;62
09;Burgos;140;Fuentenebro;216;113;103
09;Burgos;141;Fuentespina;571;293;278
09;Burgos;143;Galbarros;31;21;10
09;Burgos;144;Gallega (La);96;56;40
09;Burgos;148;Grijalba;153;73;80
09;Burgos;149;Grisaleña;59;35;24
09;Burgos;151;Gumiel de Izán;684;360;324
09;Burgos;152;Gumiel de Mercado;460;251;209
09;Burgos;154;Hacinas;214;111;103
09;Burgos;155;Haza;47;23;24
09;Burgos;159;Hontanas;92;51;41
09;Burgos;160;Hontangas;162;89;73
09;Burgos;162;Hontoria de la Cantera;107;54;53
09;Burgos;164;Hontoria de Valdearados;245;142;103
09;Burgos;163;Hontoria del Pinar;993;532;461
09;Burgos;166;Hormazas (Las);163;79;84
09;Burgos;167;Hornillos del Camino;80;43;37
09;Burgos;168;Horra (La);505;261;244
09;Burgos;169;Hortigüela;117;68;49
09;Burgos;170;Hoyales de Roa;351;173;178
09;Burgos;172;Huérmeces;164;94;70
09;Burgos;173;Huerta de Arriba;204;104;100
09;Burgos;174;Huerta de Rey;1246;646;600
09;Burgos;175;Humada;273;156;117
09;Burgos;176;Hurones;61;38;23
09;Burgos;177;Ibeas de Juarros;875;473;402
09;Burgos;178;Ibrillos;114;65;49
09;Burgos;179;Iglesiarrubia;72;37;35
09;Burgos;180;Iglesias;206;106;100
09;Burgos;181;Isar;459;212;247
09;Burgos;182;Itero del Castillo;135;66;69
09;Burgos;183;Jaramillo de la Fuente;37;18;19
09;Burgos;184;Jaramillo Quemado;16;10;6
09;Burgos;189;Junta de Traslaloma;239;120;119
09;Burgos;190;Junta de Villalba de Losa;107;58;49
09;Burgos;191;Jurisdicción de Lara;82;48;34
09;Burgos;192;Jurisdicción de San Zadornil;91;48;43
09;Burgos;194;Lerma;2584;1312;1272
09;Burgos;195;Llano de Bureba;67;43;24
09;Burgos;196;Madrigal del Monte;192;99;93
09;Burgos;197;Madrigalejo del Monte;185;101;84
09;Burgos;198;Mahamud;181;91;90
09;Burgos;199;Mambrilla de Castrejón;178;94;84
09;Burgos;200;Mambrillas de Lara;81;40;41
09;Burgos;201;Mamolar;90;46;44
09;Burgos;202;Manciles;48;27;21
09;Burgos;206;Mazuela;91;47;44
09;Burgos;208;Mecerreyes;308;153;155
09;Burgos;209;Medina de Pomar;5756;2868;2888
09;Burgos;211;Melgar de Fernamental;2165;1105;1060
09;Burgos;213;Merindad de Cuesta-Urria;573;340;233
09;Burgos;214;Merindad de Montija;1048;560;488
09;Burgos;431;Villafranca Montes de Oca;218;113;105
09;Burgos;432;Villafruela;335;179;156
09;Burgos;433;Villagalijo;81;45;36
09;Burgos;434;Villagonzalo Pedernales;588;293;295
09;Burgos;437;Villahoz;456;224;232
09;Burgos;438;Villalba de Duero;552;311;241
09;Burgos;439;Villalbilla de Burgos;644;350;294
09;Burgos;440;Villalbilla de Gumiel;149;85;64
09;Burgos;441;Villaldemiro;111;47;64
09;Burgos;442;Villalmanzo;444;237;207
09;Burgos;443;Villamayor de los Montes;291;142;149
09;Burgos;444;Villamayor de Treviño;125;68;57
09;Burgos;445;Villambistia;85;49;36
09;Burgos;446;Villamedianilla;27;14;13
09;Burgos;447;Villamiel de la Sierra;36;23;13
09;Burgos;448;Villangómez;376;195;181
09;Burgos;449;Villanueva de Argaño;115;61;54
09;Burgos;450;Villanueva de Carazo;24;13;11
09;Burgos;451;Villanueva de Gumiel;334;176;158
09;Burgos;454;Villanueva de Teba;75;39;36
09;Burgos;455;Villaquirán de la Puebla;82;43;39
09;Burgos;456;Villaquirán de los Infantes;226;119;107
09;Burgos;903;Villarcayo de Merindad de Castilla la Vieja;4162;2081;2081
09;Burgos;458;Villariezo;161;87;74
09;Burgos;460;Villasandino;301;148;153
09;Burgos;463;Villasur de Herreros;344;184;160
09;Burgos;464;Villatuelda;82;45;37
09;Burgos;466;Villaverde del Monte;200;109;91
09;Burgos;467;Villaverde-Mogina;144;84;60
09;Burgos;471;Villayerno Morquillas;145;70;75
09;Burgos;472;Villazopeque;98;53;45
09;Burgos;473;Villegas;146;77;69
09;Burgos;476;Villoruebo;45;29;16
09;Burgos;424;Viloria de Rioja;80;43;37
09;Burgos;425;Vilviestre del Pinar;821;420;401
09;Burgos;478;Vizcaínos;46;24;22
09;Burgos;480;Zael;166;81;85
09;Burgos;482;Zarzosa de Río Pisuerga;81;42;39
09;Burgos;483;Zazuar;294;155;139
09;Burgos;485;Zuñeda;100;49;51
09;Burgos;906;Merindad de Río Ubierna;1235;640;595
09;Burgos;215;Merindad de Sotoscueva;691;362;329
09;Burgos;216;Merindad de Valdeporres;592;303;289
09;Burgos;217;Merindad de Valdivielso;613;315;298
09;Burgos;218;Milagros;464;242;222
09;Burgos;219;Miranda de Ebro;36761;18294;18467
09;Burgos;220;Miraveche;125;69;56
09;Burgos;221;Modúbar de la Emparedada;218;120;98
09;Burgos;223;Monasterio de la Sierra;36;20;16
09;Burgos;224;Monasterio de Rodilla;207;111;96
09;Burgos;225;Moncalvillo;145;82;63
09;Burgos;226;Monterrubio de la Demanda;96;54;42
09;Burgos;227;Montorio;165;80;85
09;Burgos;228;Moradillo de Roa;241;129;112
09;Burgos;229;Nava de Roa;311;162;149
09;Burgos;230;Navas de Bureba;49;26;23
09;Burgos;231;Nebreda;122;74;48
09;Burgos;232;Neila;241;120;121
09;Burgos;235;Olmedillo de Roa;266;134;132
09;Burgos;236;Olmillos de Muñó;53;28;25
09;Burgos;238;Oña;1840;912;928
09;Burgos;239;Oquillas;78;39;39
09;Burgos;241;Orbaneja Riopico;177;99;78
09;Burgos;242;Padilla de Abajo;114;63;51
09;Burgos;243;Padilla de Arriba;152;80;72
09;Burgos;244;Padrones de Bureba;89;46;43
09;Burgos;246;Palacios de la Sierra;989;504;485
09;Burgos;247;Palacios de Riopisuerga;41;21;20
09;Burgos;248;Palazuelos de la Sierra;68;35;33
09;Burgos;249;Palazuelos de Muñó;78;44;34
09;Burgos;250;Pampliega;458;232;226
09;Burgos;251;Pancorbo;562;297;265
09;Burgos;253;Pardilla;123;61;62
09;Burgos;255;Partido de la Sierra en Tobalina;78;44;34
09;Burgos;256;Pedrosa de Duero;632;338;294
09;Burgos;259;Pedrosa de Río Úrbel;314;179;135
09;Burgos;257;Pedrosa del Páramo;121;68;53
09;Burgos;258;Pedrosa del Príncipe;315;160;155
09;Burgos;261;Peñaranda de Duero;654;350;304
09;Burgos;262;Peral de Arlanza;261;138;123
09;Burgos;265;Piérnigas;43;29;14
09;Burgos;266;Pineda de la Sierra;134;72;62
09;Burgos;267;Pineda Trasmonte;205;104;101
09;Burgos;268;Pinilla de los Barruecos;133;70;63
09;Burgos;269;Pinilla de los Moros;54;35;19
09;Burgos;270;Pinilla Trasmonte;256;138;118
09;Burgos;272;Poza de la Sal;459;226;233
09;Burgos;273;Prádanos de Bureba;83;46;37
09;Burgos;274;Pradoluengo;1720;830;890
09;Burgos;275;Presencio;354;185;169
09;Burgos;276;Puebla de Arganzón (La);299;173;126
09;Burgos;277;Puentedura;143;78;65
09;Burgos;279;Quemada;261;144;117
09;Burgos;281;Quintana del Pidio;211;115;96
09;Burgos;280;Quintanabureba;49;31;18
09;Burgos;283;Quintanaélez;119;61;58
09;Burgos;287;Quintanaortuño;116;59;57
09;Burgos;288;Quintanapalla;127;68;59
09;Burgos;289;Quintanar de la Sierra;2413;1236;1177
09;Burgos;292;Quintanavides;81;35;46
09;Burgos;294;Quintanilla de la Mata;175;98;77
09;Burgos;901;Quintanilla del Agua y Tordueles;650;339;311
09;Burgos;295;Quintanilla del Coco;131;69;62
09;Burgos;298;Quintanilla San García;130;67;63
09;Burgos;301;Quintanilla Vivar;382;195;187
09;Burgos;297;Quintanillas (Las);358;192;166
09;Burgos;302;Rabanera del Pinar;168;90;78
09;Burgos;303;Rábanos;76;42;34
09;Burgos;304;Rabé de las Calzadas;174;91;83
09;Burgos;306;Rebolledo de la Torre;190;98;92
09;Burgos;307;Redecilla del Camino;154;91;63
09;Burgos;308;Redecilla del Campo;99;47;52
09;Burgos;309;Regumiel de la Sierra;551;279;272
09;Burgos;310;Reinoso;29;19;10
09;Burgos;311;Retuerta;80;43;37
09;Burgos;314;Revilla del Campo;133;67;66
09;Burgos;316;Revilla Vallejera;185;104;81
09;Burgos;312;Revilla y Ahedo (La);126;62;64
09;Burgos;315;Revillarruz;165;85;80
09;Burgos;317;Rezmondo;26;13;13
09;Burgos;318;Riocavado de la Sierra;77;44;33
09;Burgos;321;Roa;2378;1210;1168
09;Burgos;323;Rojas;112;60;52
09;Burgos;325;Royuela de Río Franco;379;207;172
09;Burgos;326;Rubena;152;77;75
09;Burgos;327;Rublacedo de Abajo;40;19;21
09;Burgos;328;Rucandio;137;68;69
09;Burgos;329;Salas de Bureba;182;100;82
09;Burgos;330;Salas de los Infantes;2089;1051;1038
09;Burgos;332;Saldaña de Burgos;115;63;52
09;Burgos;334;Salinillas de Bureba;70;39;31
09;Burgos;335;San Adrián de Juarros;37;16;21
09;Burgos;337;San Juan del Monte;191;99;92
09;Burgos;338;San Mamés de Burgos;168;89;79
09;Burgos;339;San Martín de Rubiales;325;176;149
09;Burgos;340;San Millán de Lara;92;54;38
09;Burgos;360;San Vicente del Valle;31;21;10
09;Burgos;343;Santa Cecilia;148;80;68
09;Burgos;345;Santa Cruz de la Salceda;191;101;90
09;Burgos;346;Santa Cruz del Valle Urbión;130;75;55
09;Burgos;347;Santa Gadea del Cid;230;120;110
09;Burgos;348;Santa Inés;215;115;100
09;Burgos;350;Santa María del Campo;760;391;369
09;Burgos;351;Santa María del Invierno;58;33;25
09;Burgos;352;Santa María del Mercadillo;205;115;90
09;Burgos;353;Santa María Rivarredonda;135;74;61
09;Burgos;354;Santa Olalla de Bureba;45;20;25
09;Burgos;355;Santibáñez de Esgueva;183;91;92
09;Burgos;356;Santibáñez del Val;71;39;32
09;Burgos;358;Santo Domingo de Silos;334;214;120
09;Burgos;361;Sargentes de la Lora;202;102;100
09;Burgos;362;Sarracín;155;83;72
09;Burgos;363;Sasamón;1516;810;706
09;Burgos;365;Sequera de Haza (La);73;41;32
09;Burgos;366;Solarana;130;69;61
09;Burgos;368;Sordillos;44;25;19
09;Burgos;369;Sotillo de la Ribera;630;351;279
09;Burgos;372;Sotragero;131;75;56
09;Burgos;373;Sotresgudo;826;436;390
09;Burgos;374;Susinos del Páramo;56;31;25
09;Burgos;375;Tamarón;50;27;23
09;Burgos;377;Tardajos;756;428;328
09;Burgos;378;Tejada;56;32;24
09;Burgos;380;Terradillos de Esgueva;141;71;70
09;Burgos;381;Tinieblas de la Sierra;38;19;19
09;Burgos;382;Tobar;55;27;28
09;Burgos;384;Tordómar;427;236;191
09;Burgos;386;Torrecilla del Monte;85;49;36
09;Burgos;387;Torregalindo;157;87;70
09;Burgos;388;Torrelara;27;13;14
09;Burgos;389;Torrepadre;180;101;79
09;Burgos;390;Torresandino;813;435;378
09;Burgos;391;Tórtoles de Esgueva;593;324;269
09;Burgos;392;Tosantos;82;38;44
09;Burgos;394;Trespaderne;1186;621;565
09;Burgos;395;Tubilla del Agua;182;109;73
09;Burgos;396;Tubilla del Lago;219;115;104
09;Burgos;398;Úrbel del Castillo;109;58;51
09;Burgos;400;Vadocondes;471;243;228
09;Burgos;403;Valdeande;168;99;69
09;Burgos;405;Valdezate;228;122;106
09;Burgos;406;Valdorros;155;88;67
09;Burgos;408;Vallarta de Bureba;81;46;35
09;Burgos;904;Valle de las Navas;677;367;310
09;Burgos;908;Valle de Losa;707;409;298
09;Burgos;409;Valle de Manzanedo;140;75;65
09;Burgos;410;Valle de Mena;4689;2381;2308
09;Burgos;411;Valle de Oca;220;106;114
09;Burgos;902;Valle de Santibáñez;692;356;336
09;Burgos;905;Valle de Sedano;567;307;260
09;Burgos;412;Valle de Tobalina;1107;596;511
09;Burgos;413;Valle de Valdebezana;886;485;401
09;Burgos;414;Valle de Valdelaguna;279;145;134
09;Burgos;415;Valle de Valdelucio;407;220;187
09;Burgos;416;Valle de Zamanzas;67;33;34
09;Burgos;417;Vallejera;58;31;27
09;Burgos;418;Valles de Palenzuela;111;57;54
09;Burgos;419;Valluércanes;135;78;57
09;Burgos;407;Valmala;34;16;18
09;Burgos;422;Vid de Bureba (La);67;32;35
09;Burgos;421;Vid y Barrios (La);383;223;160
09;Burgos;423;Vileña;51;32;19
09;Burgos;427;Villadiego;2283;1217;1066
09;Burgos;428;Villaescusa de Roa;184;99;85
09;Burgos;429;Villaescusa la Sombría;69;42;27
09;Burgos;430;Villaespasa;37;20;17
10;Cáceres;001;Abadía;302;168;134
10;Cáceres;002;Abertura;515;274;241
10;Cáceres;003;Acebo;875;456;419
10;Cáceres;004;Acehúche;1010;511;499
10;Cáceres;005;Aceituna;764;389;375
10;Cáceres;006;Ahigal;1751;912;839
10;Cáceres;007;Albalá del Caudillo;916;452;464
10;Cáceres;008;Alcántara;1977;995;982
10;Cáceres;009;Alcollarín;372;175;197
10;Cáceres;010;Alcuéscar;3344;1733;1611
10;Cáceres;012;Aldea del Cano;792;391;401
10;Cáceres;013;Aldea del Obispo (La);429;220;209
10;Cáceres;011;Aldeacentenera;1012;500;512
10;Cáceres;014;Aldeanueva de la Vera;2670;1338;1332
10;Cáceres;015;Aldeanueva del Camino;988;467;521
10;Cáceres;016;Aldehuela de Jerte;385;221;164
10;Cáceres;017;Alía;1617;814;803
10;Cáceres;018;Aliseda;2484;1244;1240
10;Cáceres;019;Almaraz;1478;756;722
10;Cáceres;020;Almoharín;2122;1045;1077
10;Cáceres;021;Arroyo de la Luz;6713;3340;3373
10;Cáceres;023;Arroyomolinos;1176;605;571
10;Cáceres;022;Arroyomolinos de la Vera;652;322;330
10;Cáceres;024;Baños de Montemayor;720;321;399
10;Cáceres;025;Barrado;583;293;290
10;Cáceres;026;Belvís de Monroy;584;301;283
10;Cáceres;027;Benquerencia;116;65;51
10;Cáceres;028;Berrocalejo;139;65;74
10;Cáceres;029;Berzocana;703;352;351
10;Cáceres;030;Bohonal de Ibor;608;308;300
10;Cáceres;031;Botija;195;87;108
10;Cáceres;032;Brozas;2510;1245;1265
10;Cáceres;033;Cabañas del Castillo;672;344;328
10;Cáceres;034;Cabezabellosa;601;294;307
10;Cáceres;035;Cabezuela del Valle;2423;1231;1192
10;Cáceres;036;Cabrero;479;249;230
10;Cáceres;037;Cáceres;81037;39049;41988
10;Cáceres;038;Cachorrilla;107;51;56
10;Cáceres;039;Cadalso;603;307;296
10;Cáceres;040;Calzadilla;623;310;313
10;Cáceres;041;Caminomorisco;1313;683;630
10;Cáceres;042;Campillo de Deleitosa;164;78;86
10;Cáceres;043;Campo Lugar;1284;640;644
10;Cáceres;044;Cañamero;2021;1021;1000
10;Cáceres;045;Cañaveral;1697;810;887
10;Cáceres;046;Carbajo;294;155;139
10;Cáceres;047;Carcaboso;1296;686;610
10;Cáceres;048;Carrascalejo;468;229;239
10;Cáceres;049;Casar de Cáceres;4506;2290;2216
10;Cáceres;050;Casar de Palomero;1435;727;708
10;Cáceres;051;Casares de las Hurdes;942;483;459
10;Cáceres;052;Casas de Don Antonio;266;130;136
10;Cáceres;053;Casas de Don Gómez;412;206;206
10;Cáceres;056;Casas de Millán;874;453;421
10;Cáceres;057;Casas de Miravete;167;90;77
10;Cáceres;054;Casas del Castañar;743;364;379
10;Cáceres;055;Casas del Monte;946;491;455
10;Cáceres;058;Casatejada;1455;727;728
10;Cáceres;059;Casillas de Coria;615;284;331
10;Cáceres;060;Castañar de Ibor;1398;702;696
10;Cáceres;061;Ceclavín;2392;1209;1183
10;Cáceres;062;Cedillo;593;304;289
10;Cáceres;063;Cerezo;269;127;142
10;Cáceres;064;Cilleros;2368;1195;1173
10;Cáceres;065;Collado;354;188;166
10;Cáceres;066;Conquista de la Sierra;201;99;102
10;Cáceres;067;Coria;12055;6012;6043
10;Cáceres;068;Cuacos de Yuste;966;506;460
10;Cáceres;069;Cumbre (La);1230;609;621
10;Cáceres;070;Deleitosa;1045;519;526
10;Cáceres;071;Descargamaría;281;140;141
10;Cáceres;072;Eljas;1358;690;668
10;Cáceres;073;Escurial;1013;503;510
10;Cáceres;075;Fresnedoso de Ibor;497;253;244
10;Cáceres;076;Galisteo;2065;1044;1021
10;Cáceres;077;Garciaz;1100;556;544
10;Cáceres;078;Garganta (La);640;335;305
10;Cáceres;079;Garganta la Olla;1228;647;581
10;Cáceres;080;Gargantilla;555;287;268
10;Cáceres;081;Gargüera;265;127;138
10;Cáceres;082;Garrovillas de Alconétar;2640;1268;1372
10;Cáceres;083;Garvín;127;69;58
10;Cáceres;084;Gata;2051;1023;1028
10;Cáceres;085;Gordo (El);329;171;158
10;Cáceres;086;Granja (La);475;254;221
10;Cáceres;087;Guadalupe;2469;1222;1247
10;Cáceres;088;Guijo de Coria;339;178;161
10;Cáceres;089;Guijo de Galisteo;1777;906;871
10;Cáceres;090;Guijo de Granadilla;805;383;422
10;Cáceres;091;Guijo de Santa Bárbara;547;266;281
10;Cáceres;092;Herguijuela;454;218;236
10;Cáceres;093;Hernán-Pérez;508;267;241
10;Cáceres;094;Herrera de Alcántara;375;191;184
10;Cáceres;095;Herreruela;525;265;260
10;Cáceres;096;Hervás;3933;1896;2037
10;Cáceres;097;Higuera;130;72;58
10;Cáceres;098;Hinojal;461;223;238
10;Cáceres;099;Holguera;859;437;422
10;Cáceres;100;Hoyos;998;488;510
10;Cáceres;101;Huélaga;207;102;105
10;Cáceres;102;Ibahernando;854;423;431
10;Cáceres;103;Jaraicejo;727;360;367
10;Cáceres;104;Jaraíz de la Vera;7742;3953;3789
10;Cáceres;105;Jarandilla de la Vera;3162;1572;1590
10;Cáceres;106;Jarilla;197;105;92
10;Cáceres;107;Jerte;1394;719;675
10;Cáceres;108;Ladrillar;429;231;198
10;Cáceres;109;Logrosán;2755;1358;1397
10;Cáceres;110;Losar de la Vera;3096;1553;1543
10;Cáceres;111;Madrigal de la Vera;1823;935;888
10;Cáceres;112;Madrigalejo;2420;1200;1220
10;Cáceres;113;Madroñera;3258;1631;1627
10;Cáceres;114;Majadas;1316;751;565
10;Cáceres;115;Malpartida de Cáceres;4236;2102;2134
10;Cáceres;116;Malpartida de Plasencia;4237;2074;2163
10;Cáceres;117;Marchagaz;422;202;220
10;Cáceres;118;Mata de Alcántara;396;198;198
10;Cáceres;119;Membrío;990;472;518
10;Cáceres;120;Mesas de Ibor;236;121;115
10;Cáceres;121;Miajadas;10014;5047;4967
10;Cáceres;122;Millanes;262;143;119
10;Cáceres;123;Mirabel;900;445;455
10;Cáceres;124;Mohedas de Granadilla;1231;629;602
10;Cáceres;125;Monroy;1342;657;685
10;Cáceres;126;Montánchez;2391;1176;1215
10;Cáceres;127;Montehermoso;5368;2702;2666
10;Cáceres;128;Moraleja;8341;4140;4201
10;Cáceres;129;Morcillo;602;292;310
10;Cáceres;130;Navaconcejo;2197;1119;1078
10;Cáceres;131;Navalmoral de la Mata;16325;8163;8162
10;Cáceres;132;Navalvillar de Ibor;601;308;293
10;Cáceres;133;Navas del Madroño;1709;857;852
10;Cáceres;134;Navezuelas;774;410;364
10;Cáceres;135;Nuñomoral;2091;1101;990
10;Cáceres;136;Oliva de Plasencia;375;180;195
10;Cáceres;137;Palomero;613;321;292
10;Cáceres;138;Pasarón de la Vera;724;370;354
10;Cáceres;139;Pedroso de Acim;176;86;90
10;Cáceres;140;Peraleda de la Mata;1489;752;737
10;Cáceres;141;Peraleda de San Román;444;217;227
10;Cáceres;142;Perales del Puerto;1061;527;534
10;Cáceres;143;Pescueza;253;124;129
10;Cáceres;144;Pesga (La);1357;705;652
10;Cáceres;145;Piedras Albas;261;120;141
10;Cáceres;146;Pinofranqueado;1827;968;859
10;Cáceres;147;Piornal;1616;793;823
10;Cáceres;148;Plasencia;37703;18497;19206
10;Cáceres;149;Plasenzuela;561;267;294
10;Cáceres;150;Portaje;457;226;231
10;Cáceres;151;Portezuelo;351;159;192
10;Cáceres;152;Pozuelo de Zarzón;676;338;338
10;Cáceres;153;Puerto de Santa Cruz;461;220;241
10;Cáceres;154;Rebollar;270;139;131
10;Cáceres;155;Riolobos;1788;948;840
10;Cáceres;156;Robledillo de Gata;205;104;101
10;Cáceres;157;Robledillo de la Vera;451;222;229
10;Cáceres;158;Robledillo de Trujillo;535;270;265
10;Cáceres;159;Robledollano;444;235;209
10;Cáceres;160;Romangordo;231;111;120
10;Cáceres;901;Rosalejo;2025;1231;794
10;Cáceres;161;Ruanes;109;55;54
10;Cáceres;162;Salorino;951;464;487
10;Cáceres;163;Salvatierra de Santiago;463;242;221
10;Cáceres;164;San Martín de Trevejo;963;483;480
10;Cáceres;165;Santa Ana;410;210;200
10;Cáceres;166;Santa Cruz de la Sierra;388;202;186
10;Cáceres;167;Santa Cruz de Paniagua;474;251;223
10;Cáceres;168;Santa Marta de Magasca;445;234;211
10;Cáceres;169;Santiago de Alcántara;882;435;447
10;Cáceres;170;Santiago del Campo;348;177;171
10;Cáceres;171;Santibáñez el Alto;523;262;261
10;Cáceres;172;Santibáñez el Bajo;1076;566;510
10;Cáceres;173;Saucedilla;645;324;321
10;Cáceres;174;Segura de Toro;215;116;99
10;Cáceres;175;Serradilla;2191;1100;1091
10;Cáceres;176;Serrejón;525;269;256
10;Cáceres;177;Sierra de Fuentes;1675;821;854
10;Cáceres;178;Talaván;1092;533;559
10;Cáceres;179;Talaveruela de la Vera;524;245;279
10;Cáceres;180;Talayuela;7616;4265;3351
10;Cáceres;181;Tejeda de Tiétar;1063;569;494
10;Cáceres;182;Toril;183;106;77
10;Cáceres;183;Tornavacas;1453;759;694
10;Cáceres;184;Torno (El);1085;568;517
10;Cáceres;187;Torre de Don Miguel;696;351;345
10;Cáceres;188;Torre de Santa María;807;391;416
10;Cáceres;185;Torrecilla de los Ángeles;712;362;350
10;Cáceres;186;Torrecillas de la Tiesa;1283;643;640
10;Cáceres;190;Torrejón el Rubio;832;425;407
10;Cáceres;189;Torrejoncillo;3727;1803;1924
10;Cáceres;191;Torremenga;623;320;303
10;Cáceres;192;Torremocha;1338;642;696
10;Cáceres;193;Torreorgaz;1533;782;751
10;Cáceres;194;Torrequemada;634;288;346
10;Cáceres;195;Trujillo;9347;4444;4903
10;Cáceres;196;Valdastillas;459;219;240
10;Cáceres;197;Valdecañas de Tajo;152;79;73
10;Cáceres;198;Valdefuentes;1697;835;862
10;Cáceres;199;Valdehúncar;170;76;94
10;Cáceres;200;Valdelacasa de Tajo;739;350;389
10;Cáceres;201;Valdemorales;275;134;141
10;Cáceres;202;Valdeobispo;870;440;430
10;Cáceres;203;Valencia de Alcántara;6429;3149;3280
10;Cáceres;204;Valverde de la Vera;687;348;339
10;Cáceres;205;Valverde del Fresno;2859;1432;1427
10;Cáceres;206;Viandar de la Vera;347;163;184
10;Cáceres;207;Villa del Campo;691;346;345
10;Cáceres;208;Villa del Rey;179;86;93
10;Cáceres;209;Villamesías;475;230;245
10;Cáceres;210;Villamiel;803;400;403
10;Cáceres;211;Villanueva de la Sierra;675;327;348
10;Cáceres;212;Villanueva de la Vera;2268;1146;1122
10;Cáceres;214;Villar de Plasencia;317;155;162
10;Cáceres;213;Villar del Pedroso;907;456;451
10;Cáceres;215;Villasbuenas de Gata;549;283;266
10;Cáceres;216;Zarza de Granadilla;1927;997;930
10;Cáceres;217;Zarza de Montánchez;718;364;354
10;Cáceres;218;Zarza la Mayor;1716;855;861
10;Cáceres;219;Zorita;2187;1068;1119
11;Cádiz;001;Alcalá de los Gazules;5727;2981;2746
11;Cádiz;002;Alcalá del Valle;5428;2762;2666
11;Cádiz;003;Algar;1895;1026;869
11;Cádiz;004;Algeciras;104216;51347;52869
11;Cádiz;005;Algodonales;5848;3019;2829
11;Cádiz;006;Arcos de la Frontera;28215;14165;14050
11;Cádiz;007;Barbate;22733;11408;11325
11;Cádiz;008;Barrios (Los);15218;7702;7516
11;Cádiz;901;Benalup-Casas Viejas;6127;3167;2960
11;Cádiz;009;Benaocaz;600;306;294
11;Cádiz;010;Bornos;8130;4063;4067
11;Cádiz;011;Bosque (El);1822;934;888
11;Cádiz;013;Castellar de la Frontera;2445;1245;1200
11;Cádiz;015;Chiclana de la Frontera;52242;26704;25538
11;Cádiz;016;Chipiona;15683;7963;7720
11;Cádiz;014;Conil de la Frontera;16717;8494;8223
11;Cádiz;012;Cádiz;154511;74727;79784
11;Cádiz;017;Espera;4218;2167;2051
11;Cádiz;018;Gastor (El);2117;1125;992
11;Cádiz;019;Grazalema;2348;1203;1145
11;Cádiz;020;Jerez de la Frontera;191394;94011;97383
11;Cádiz;021;Jimena de la Frontera;9072;4645;4427
11;Cádiz;022;Línea de la Concepción (La);62455;30501;31954
11;Cádiz;023;Medina-Sidonia;10930;5652;5278
11;Cádiz;024;Olvera;9148;4586;4562
11;Cádiz;025;Paterna de Rivera;5127;2640;2487
11;Cádiz;026;Prado del Rey;5689;2853;2836
11;Cádiz;028;Puerto Real;31807;16044;15763
11;Cádiz;029;Puerto Serrano;6710;3430;3280
11;Cádiz;027;Puerto de Santa María (El);70901;35513;35388
11;Cádiz;030;Rota;24791;12462;12329
11;Cádiz;031;San Fernando;88212;43634;44578
11;Cádiz;902;San José del Valle;"";"";""
11;Cádiz;033;San Roque;22258;11156;11102
11;Cádiz;032;Sanlúcar de Barrameda;60604;30359;30245
11;Cádiz;034;Setenil de las Bodegas;3316;1667;1649
11;Cádiz;035;Tarifa;15089;7641;7448
11;Cádiz;036;Torre Alháquime;1005;515;490
11;Cádiz;037;Trebujena;6996;3569;3427
11;Cádiz;038;Ubrique;18323;9132;9191
11;Cádiz;039;Vejer de la Frontera;12983;6614;6369
11;Cádiz;040;Villaluenga del Rosario;488;258;230
11;Cádiz;041;Villamartín;12489;6261;6228
11;Cádiz;042;Zahara;1595;811;784
12;Castellón/Castelló;002;Aín;134;67;67
12;Castellón/Castelló;003;Albocàsser;1424;687;737
12;Castellón/Castelló;004;Alcalà de Xivert;5030;2543;2487
12;Castellón/Castelló;005;Alcora (L');8448;4284;4164
12;Castellón/Castelló;006;Alcudia de Veo;180;85;95
12;Castellón/Castelló;007;Alfondeguilla;926;450;476
12;Castellón/Castelló;008;Algimia de Almonacid;315;174;141
12;Castellón/Castelló;009;Almazora/Almassora;16551;8144;8407
12;Castellón/Castelló;010;Almedíjar;295;143;152
12;Castellón/Castelló;011;Almenara;5087;2498;2589
12;Castellón/Castelló;901;Alquerías del Niño Perdido;3576;1732;1844
12;Castellón/Castelló;012;Altura;3101;1534;1567
12;Castellón/Castelló;013;Arañuel;130;58;72
12;Castellón/Castelló;014;Ares del Maestre;300;148;152
12;Castellón/Castelló;015;Argelita;109;54;55
12;Castellón/Castelló;016;Artana;1942;966;976
12;Castellón/Castelló;001;Atzeneta del Maestrat;1514;761;753
12;Castellón/Castelló;017;Ayódar;231;127;104
12;Castellón/Castelló;018;Azuébar;393;201;192
12;Castellón/Castelló;020;Barracas;181;101;80
12;Castellón/Castelló;022;Bejís;400;214;186
12;Castellón/Castelló;024;Benafer;143;79;64
12;Castellón/Castelló;025;Benafigos;250;134;116
12;Castellón/Castelló;026;Benasal;1436;700;736
12;Castellón/Castelló;027;Benicarló;19074;9443;9631
12;Castellón/Castelló;028;Benicasim/Benicàssim;9037;4589;4448
12;Castellón/Castelló;029;Benlloch;898;462;436
12;Castellón/Castelló;021;Betxí;5378;2729;2649
12;Castellón/Castelló;031;Borriol;2992;1511;1481
12;Castellón/Castelló;032;Burriana;26592;13047;13545
12;Castellón/Castelló;033;Cabanes;2473;1232;1241
12;Castellón/Castelló;034;Càlig;1767;857;910
12;Castellón/Castelló;036;Canet lo Roig;960;461;499
12;Castellón/Castelló;037;Castell de Cabres;21;11;10
12;Castellón/Castelló;038;Castellfort;252;133;119
12;Castellón/Castelló;039;Castellnovo;1056;521;535
12;Castellón/Castelló;040;Castellón de la Plana/Castelló de la Plana;139889;68341;71548
12;Castellón/Castelló;041;Castillo de Villamalefa;122;58;64
12;Castellón/Castelló;042;Catí;919;478;441
12;Castellón/Castelló;043;Caudiel;716;355;361
12;Castellón/Castelló;044;Cervera del Maestre;819;398;421
12;Castellón/Castelló;052;Chert/Xert;984;479;505
12;Castellón/Castelló;053;Chilches/Xilxes;2225;1129;1096
12;Castellón/Castelló;055;Chodos/Xodos;164;91;73
12;Castellón/Castelló;056;Chóvar;415;212;203
12;Castellón/Castelló;045;Cinctorres;596;280;316
12;Castellón/Castelló;046;Cirat;274;137;137
12;Castellón/Castelló;048;Cortes de Arenoso;437;236;201
12;Castellón/Castelló;049;Costur;474;236;238
12;Castellón/Castelló;050;Coves de Vinromà (les);1862;931;931
12;Castellón/Castelló;051;Culla;895;444;451
12;Castellón/Castelló;057;Eslida;813;387;426
12;Castellón/Castelló;058;Espadilla;82;35;47
12;Castellón/Castelló;059;Fanzara;321;154;167
12;Castellón/Castelló;060;Figueroles;576;281;295
12;Castellón/Castelló;061;Forcall;568;272;296
12;Castellón/Castelló;063;Fuente la Reina;31;15;16
12;Castellón/Castelló;064;Fuentes de Ayódar;92;47;45
12;Castellón/Castelló;065;Gaibiel;218;113;105
12;Castellón/Castelló;066;Gatova;494;240;254
12;Castellón/Castelló;067;Geldo;704;358;346
12;Castellón/Castelló;068;Herbés;127;64;63
12;Castellón/Castelló;069;Higueras;34;18;16
12;Castellón/Castelló;070;Jana (La);888;438;450
12;Castellón/Castelló;071;Jérica;1617;829;788
12;Castellón/Castelló;074;Llosa (La);934;463;471
12;Castellón/Castelló;072;Lucena del Cid;1618;797;821
12;Castellón/Castelló;073;Ludiente;248;122;126
12;Castellón/Castelló;075;Mata de Morella (La);223;105;118
12;Castellón/Castelló;076;Matet;142;75;67
12;Castellón/Castelló;077;Moncofa;3661;1848;1813
12;Castellón/Castelló;078;Montán;345;172;173
12;Castellón/Castelló;079;Montanejos;425;214;211
12;Castellón/Castelló;080;Morella;2842;1402;1440
12;Castellón/Castelló;081;Navajas;468;227;241
12;Castellón/Castelló;082;Nules;11704;5839;5865
12;Castellón/Castelló;083;Olocau del Rey;159;88;71
12;Castellón/Castelló;084;Onda;18767;9449;9318
12;Castellón/Castelló;085;Oropesa del Mar/Orpesa;2836;1477;1359
12;Castellón/Castelló;087;Palanques;21;13;8
12;Castellón/Castelló;088;Pavías;61;36;25
12;Castellón/Castelló;089;Peñíscola;4129;2078;2051
12;Castellón/Castelló;090;Pina de Montalgrao;187;101;86
12;Castellón/Castelló;093;Pobla de Benifassà (La);210;103;107
12;Castellón/Castelló;094;Pobla Tornesa (La);533;261;272
12;Castellón/Castelló;091;Portell de Morella;279;140;139
12;Castellón/Castelló;092;Puebla de Arenoso;189;96;93
12;Castellón/Castelló;095;Ribesalbes;1300;639;661
12;Castellón/Castelló;096;Rossell;1216;608;608
12;Castellón/Castelló;097;Sacañet;145;76;69
12;Castellón/Castelló;098;Salzadella (La);851;414;437
12;Castellón/Castelló;101;San Rafael del Río;509;258;251
12;Castellón/Castelló;902;Sant Joan de Moró;1671;850;821
12;Castellón/Castelló;099;Sant Jordi/San Jorge;571;277;294
12;Castellón/Castelló;100;Sant Mateu;1810;881;929
12;Castellón/Castelló;102;Santa Magdalena de Pulpis;730;372;358
12;Castellón/Castelló;103;Sarratella;105;60;45
12;Castellón/Castelló;104;Segorbe;7697;3759;3938
12;Castellón/Castelló;105;Sierra Engarcerán;1132;593;539
12;Castellón/Castelló;106;Soneja;1432;711;721
12;Castellón/Castelló;107;Sot de Ferrer;412;211;201
12;Castellón/Castelló;108;Sueras/Suera;557;281;276
12;Castellón/Castelló;109;Tales;784;381;403
12;Castellón/Castelló;110;Teresa;391;202;189
12;Castellón/Castelló;111;Tírig;594;289;305
12;Castellón/Castelló;112;Todolella;143;86;57
12;Castellón/Castelló;113;Toga;114;49;65
12;Castellón/Castelló;114;Torás;291;149;142
12;Castellón/Castelló;115;Toro (El);388;200;188
12;Castellón/Castelló;116;Torralba del Pinar;72;37;35
12;Castellón/Castelló;119;Torre d'En Besora (La);227;119;108
12;Castellón/Castelló;120;Torre Endoménech;275;138;137
12;Castellón/Castelló;117;Torreblanca;4604;2308;2296
12;Castellón/Castelló;118;Torrechiva;66;41;25
12;Castellón/Castelló;121;Traiguera;1617;828;789
12;Castellón/Castelló;122;Useras/Useres (Les);1095;558;537
12;Castellón/Castelló;124;Vall d'Alba;1894;956;938
12;Castellón/Castelló;125;Vall de Almonacid;281;138;143
12;Castellón/Castelló;126;Vall d'Uixó (La);29185;14590;14595
12;Castellón/Castelló;123;Vallat;38;16;22
12;Castellón/Castelló;127;Vallibona;111;58;53
12;Castellón/Castelló;128;Vilafamés;1418;750;668
12;Castellón/Castelló;132;Vilanova d'Alcolea;686;342;344
12;Castellón/Castelló;134;Vilar de Canes;187;93;94
12;Castellón/Castelló;129;Villafranca del Cid;2753;1331;1422
12;Castellón/Castelló;130;Villahermosa del Río;509;279;230
12;Castellón/Castelló;131;Villamalur;167;91;76
12;Castellón/Castelló;133;Villanueva de Viver;101;54;47
12;Castellón/Castelló;135;Villarreal/Vila-real;39930;19900;20030
12;Castellón/Castelló;136;Villavieja;3451;1710;1741
12;Castellón/Castelló;137;Villores;78;37;41
12;Castellón/Castelló;138;Vinaròs;21035;10311;10724
12;Castellón/Castelló;139;Vistabella del Maestrazgo;498;243;255
12;Castellón/Castelló;140;Viver;1241;632;609
12;Castellón/Castelló;141;Zorita del Maestrazgo;147;74;73
12;Castellón/Castelló;142;Zucaina;228;127;101
13;Ciudad Real;001;Abenójar;1987;1001;986
13;Ciudad Real;002;Agudo;2226;1131;1095
13;Ciudad Real;003;Alamillo;752;387;365
13;Ciudad Real;004;Albaladejo;1803;901;902
13;Ciudad Real;005;Alcázar de San Juan;26652;13058;13594
13;Ciudad Real;006;Alcoba;811;421;390
13;Ciudad Real;007;Alcolea de Calatrava;1624;816;808
13;Ciudad Real;008;Alcubillas;746;361;385
13;Ciudad Real;009;Aldea del Rey;2353;1130;1223
13;Ciudad Real;010;Alhambra;1428;727;701
13;Ciudad Real;011;Almadén;8268;4018;4250
13;Ciudad Real;012;Almadenejos;646;342;304
13;Ciudad Real;013;Almagro;8551;4156;4395
13;Ciudad Real;014;Almedina;829;405;424
13;Ciudad Real;015;Almodóvar del Campo;7778;3872;3906
13;Ciudad Real;016;Almuradiel;893;430;463
13;Ciudad Real;017;Anchuras;472;260;212
13;Ciudad Real;903;Arenales de San Gregorio;"";"";""
13;Ciudad Real;018;Arenas de San Juan;1101;551;550
13;Ciudad Real;019;Argamasilla de Alba;6667;3291;3376
13;Ciudad Real;020;Argamasilla de Calatrava;5535;2784;2751
13;Ciudad Real;021;Arroba de los Montes;696;363;333
13;Ciudad Real;022;Ballesteros de Calatrava;607;300;307
13;Ciudad Real;023;Bolaños de Calatrava;10537;5260;5277
13;Ciudad Real;024;Brazatortas;1352;676;676
13;Ciudad Real;025;Cabezarados;405;211;194
13;Ciudad Real;026;Cabezarrubias del Puerto;714;367;347
13;Ciudad Real;027;Calzada de Calatrava;5027;2437;2590
13;Ciudad Real;028;Campo de Criptana;14094;6897;7197
13;Ciudad Real;029;Cañada de Calatrava;101;56;45
13;Ciudad Real;030;Caracuel de Calatrava;199;105;94
13;Ciudad Real;031;Carrión de Calatrava;2558;1254;1304
13;Ciudad Real;032;Carrizosa;1791;897;894
13;Ciudad Real;033;Castellar de Santiago;2321;1128;1193
13;Ciudad Real;038;Chillón;2538;1243;1295
13;Ciudad Real;034;Ciudad Real;63008;29888;33120
13;Ciudad Real;035;Corral de Calatrava;1348;676;672
13;Ciudad Real;036;Cortijos (Los);1125;561;564
13;Ciudad Real;037;Cózar;1444;705;739
13;Ciudad Real;039;Daimiel;17371;8499;8872
13;Ciudad Real;040;Fernán Caballero;1063;507;556
13;Ciudad Real;041;Fontanarejo;420;216;204
13;Ciudad Real;042;Fuencaliente;1369;743;626
13;Ciudad Real;043;Fuenllana;353;156;197
13;Ciudad Real;044;Fuente el Fresno;3540;1730;1810
13;Ciudad Real;045;Granátula de Calatrava;1064;507;557
13;Ciudad Real;046;Guadalmez;1104;559;545
13;Ciudad Real;047;Herencia;7081;3516;3565
13;Ciudad Real;048;Hinojosas de Calatrava;895;435;460
13;Ciudad Real;049;Horcajo de los Montes;1099;553;546
13;Ciudad Real;050;Labores (Las);695;344;351
13;Ciudad Real;904;Llanos del Caudillo;"";"";""
13;Ciudad Real;051;Luciana;479;245;234
13;Ciudad Real;052;Malagón;8179;4014;4165
13;Ciudad Real;053;Manzanares;18325;8956;9369
13;Ciudad Real;054;Membrilla;6774;3368;3406
13;Ciudad Real;055;Mestanza;1060;526;534
13;Ciudad Real;056;Miguelturra;8251;4087;4164
13;Ciudad Real;057;Montiel;1775;878;897
13;Ciudad Real;058;Moral de Calatrava;5284;2562;2722
13;Ciudad Real;059;Navalpino;341;168;173
13;Ciudad Real;060;Navas de Estena;432;236;196
13;Ciudad Real;061;Pedro Muñoz;7249;3609;3640
13;Ciudad Real;062;Picón;632;329;303
13;Ciudad Real;063;Piedrabuena;5277;2659;2618
13;Ciudad Real;064;Poblete;751;375;376
13;Ciudad Real;065;Porzuna;4118;2039;2079
13;Ciudad Real;066;Pozuelo de Calatrava;2466;1206;1260
13;Ciudad Real;067;Pozuelos de Calatrava (Los);619;312;307
13;Ciudad Real;068;Puebla de Don Rodrigo;1370;717;653
13;Ciudad Real;069;Puebla del Príncipe;1110;561;549
13;Ciudad Real;070;Puerto Lápice;1053;521;532
13;Ciudad Real;071;Puertollano;53143;25915;27228
13;Ciudad Real;072;Retuerta del Bullaque;1119;581;538
13;Ciudad Real;901;Robledo (El);1122;591;531
13;Ciudad Real;902;Ruidera;610;327;283
13;Ciudad Real;073;Saceruela;791;415;376
13;Ciudad Real;074;San Carlos del Valle;1276;633;643
13;Ciudad Real;075;San Lorenzo de Calatrava;360;189;171
13;Ciudad Real;076;Santa Cruz de los Cáñamos;685;339;346
13;Ciudad Real;077;Santa Cruz de Mudela;4881;2356;2525
13;Ciudad Real;078;Socuéllamos;11583;5701;5882
13;Ciudad Real;080;Solana del Pino;695;347;348
13;Ciudad Real;079;Solana (La);14879;7453;7426
13;Ciudad Real;081;Terrinches;1061;508;553
13;Ciudad Real;082;Tomelloso;29322;14429;14893
13;Ciudad Real;083;Torralba de Calatrava;3046;1473;1573
13;Ciudad Real;084;Torre de Juan Abad;1707;849;858
13;Ciudad Real;085;Torrenueva;3280;1656;1624
13;Ciudad Real;086;Valdemanco del Esteras;340;173;167
13;Ciudad Real;087;Valdepeñas;26307;12714;13593
13;Ciudad Real;088;Valenzuela de Calatrava;844;414;430
13;Ciudad Real;089;Villahermosa;2875;1372;1503
13;Ciudad Real;090;Villamanrique;1859;935;924
13;Ciudad Real;091;Villamayor de Calatrava;776;381;395
13;Ciudad Real;092;Villanueva de la Fuente;2922;1469;1453
13;Ciudad Real;093;Villanueva de los Infantes;6128;2936;3192
13;Ciudad Real;094;Villanueva de San Carlos;543;274;269
13;Ciudad Real;095;Villar del Pozo;98;50;48
13;Ciudad Real;096;Villarrubia de los Ojos;9489;4728;4761
13;Ciudad Real;097;Villarta de San Juan;2993;1508;1485
13;Ciudad Real;098;Viso del Marqués;3253;1596;1657
14;Córdoba;001;Adamuz;4533;2271;2262
14;Córdoba;002;Aguilar de la Frontera;13393;6626;6767
14;Córdoba;003;Alcaracejos;1510;755;755
14;Córdoba;004;Almedinilla;2642;1313;1329
14;Córdoba;005;Almodóvar del Río;7354;3672;3682
14;Córdoba;006;Añora;1662;825;837
14;Córdoba;007;Baena;20582;10166;10416
14;Córdoba;008;Belalcázar;4082;1979;2103
14;Córdoba;009;Belmez;4347;2093;2254
14;Córdoba;010;Benamejí;4679;2329;2350
14;Córdoba;011;Blázquez (Los);762;386;376
14;Córdoba;012;Bujalance;8607;4214;4393
14;Córdoba;013;Cabra;20715;10093;10622
14;Córdoba;015;Carcabuey;2931;1453;1478
14;Córdoba;016;Cardeña;2096;1054;1042
14;Córdoba;017;Carlota (La);9979;5002;4977
14;Córdoba;018;Carpio (El);4599;2255;2344
14;Córdoba;019;Castro del Río;7965;3897;4068
14;Córdoba;014;Cañete de las Torres;3445;1701;1744
14;Córdoba;020;Conquista;554;276;278
14;Córdoba;021;Córdoba;318030;153612;164418
14;Córdoba;023;Dos Torres;2568;1260;1308
14;Córdoba;022;Doña Mencía;5171;2564;2607
14;Córdoba;024;Encinas Reales;2393;1173;1220
14;Córdoba;025;Espejo;4182;2065;2117
14;Córdoba;026;Espiel;2597;1290;1307
14;Córdoba;027;Fernán-Núñez;9674;4827;4847
14;Córdoba;029;Fuente Obejuna;6376;3232;3144
14;Córdoba;030;Fuente Palmera;9781;4945;4836
14;Córdoba;028;Fuente la Lancha;454;228;226
14;Córdoba;031;Fuente-Tójar;877;421;456
14;Córdoba;032;Granjuela (La);519;273;246
14;Córdoba;033;Guadalcázar;1179;619;560
14;Córdoba;034;Guijo (El);438;227;211
14;Córdoba;035;Hinojosa del Duque;8251;3970;4281
14;Córdoba;036;Hornachuelos;5152;2620;2532
14;Córdoba;037;Iznájar;5541;2758;2783
14;Córdoba;038;Lucena;34780;17273;17507
14;Córdoba;039;Luque;3446;1703;1743
14;Córdoba;040;Montalbán de Córdoba;4654;2338;2316
14;Córdoba;041;Montemayor;3782;1901;1881
14;Córdoba;042;Montilla;23464;11581;11883
14;Córdoba;043;Montoro;9775;4779;4996
14;Córdoba;044;Monturque;2023;1021;1002
14;Córdoba;045;Moriles;3794;1884;1910
14;Córdoba;046;Nueva Carteya;5869;2946;2923
14;Córdoba;047;Obejo;1489;739;750
14;Córdoba;048;Palenciana;1704;867;837
14;Córdoba;049;Palma del Río;19176;9574;9602
14;Córdoba;050;Pedro Abad;3020;1506;1514
14;Córdoba;051;Pedroche;1922;943;979
14;Córdoba;052;Peñarroya-Pueblonuevo;14165;6757;7408
14;Córdoba;053;Posadas;7255;3618;3637
14;Córdoba;054;Pozoblanco;15820;7618;8202
14;Córdoba;055;Priego de Córdoba;22563;11141;11422
14;Córdoba;056;Puente Genil;27845;13730;14115
14;Córdoba;057;Rambla (La);7141;3540;3601
14;Córdoba;058;Rute;10264;5030;5234
14;Córdoba;059;San Sebastián de los Ballesteros;839;426;413
14;Córdoba;061;Santa Eufemia;1260;645;615
14;Córdoba;060;Santaella;5862;2939;2923
14;Córdoba;062;Torrecampo;1526;744;782
14;Córdoba;063;Valenzuela;1548;725;823
14;Córdoba;064;Valsequillo;521;257;264
14;Córdoba;065;Victoria (La);1775;874;901
14;Córdoba;066;Villa del Río;7185;3632;3553
14;Córdoba;067;Villafranca de Córdoba;3742;1929;1813
14;Córdoba;068;Villaharta;639;317;322
14;Córdoba;069;Villanueva de Córdoba;10378;5050;5328
14;Córdoba;070;Villanueva del Duque;1983;918;1065
14;Córdoba;071;Villanueva del Rey;1321;686;635
14;Córdoba;072;Villaralto;1664;793;871
14;Córdoba;073;Villaviciosa de Córdoba;4024;2059;1965
14;Córdoba;074;Viso (El);3435;1655;1780
14;Córdoba;075;Zuheros;948;464;484
15;Coruña (A);001;Abegondo;5384;2660;2724
15;Coruña (A);002;Ames;12045;5840;6205
15;Coruña (A);003;Aranga;2498;1249;1249
15;Coruña (A);004;Ares;4663;2305;2358
15;Coruña (A);005;Arteixo;20074;10078;9996
15;Coruña (A);006;Arzúa;7011;3468;3543
15;Coruña (A);007;Baña (A);5770;2788;2982
15;Coruña (A);008;Bergondo;5600;2718;2882
15;Coruña (A);009;Betanzos;12393;5881;6512
15;Coruña (A);010;Boimorto;2906;1485;1421
15;Coruña (A);011;Boiro;18451;9056;9395
15;Coruña (A);012;Boqueixón;4344;2141;2203
15;Coruña (A);013;Brión;6372;3047;3325
15;Coruña (A);014;Cabana de Bergantiños;6461;3218;3243
15;Coruña (A);015;Cabanas;3339;1630;1709
15;Coruña (A);016;Camariñas;7427;3697;3730
15;Coruña (A);017;Cambre;13714;6704;7010
15;Coruña (A);018;Capela (A);1714;845;869
15;Coruña (A);019;Carballo;28683;14002;14681
15;Coruña (A);901;Cariño;5558;2728;2830
15;Coruña (A);020;Carnota;6604;3190;3414
15;Coruña (A);021;Carral;5291;2594;2697
15;Coruña (A);022;Cedeira;7809;3841;3968
15;Coruña (A);023;Cee;7672;3731;3941
15;Coruña (A);024;Cerceda;6979;3413;3566
15;Coruña (A);025;Cerdido;1857;900;957
15;Coruña (A);026;Cesuras;2903;1441;1462
15;Coruña (A);027;Coirós;1591;777;814
15;Coruña (A);028;Corcubión;2091;1022;1069
15;Coruña (A);029;Coristanco;9110;4539;4571
15;Coruña (A);030;A Coruña;254822;119766;135056
15;Coruña (A);031;Culleredo;17136;8405;8731
15;Coruña (A);032;Curtis;4682;2281;2401
15;Coruña (A);033;Dodro;3487;1691;1796
15;Coruña (A);034;Dumbría;4893;2376;2517
15;Coruña (A);035;Fene;15375;7584;7791
15;Coruña (A);036;Ferrol;85587;40315;45272
15;Coruña (A);037;Fisterra;5578;2813;2765
15;Coruña (A);038;Frades;3267;1662;1605
15;Coruña (A);039;Irixoa;1845;903;942
15;Coruña (A);041;Laracha (A);10830;5349;5481
15;Coruña (A);040;Laxe;3566;1772;1794
15;Coruña (A);042;Lousame;4697;2290;2407
15;Coruña (A);043;Malpica de Bergantiños;7901;3880;4021
15;Coruña (A);045;Mazaricos;6863;3339;3524
15;Coruña (A);044;Mañón;2150;1043;1107
15;Coruña (A);046;Melide;8550;4242;4308
15;Coruña (A);047;Mesía;3624;1815;1809
15;Coruña (A);048;Miño;5071;2425;2646
15;Coruña (A);049;Moeche;1658;803;855
15;Coruña (A);050;Monfero;2918;1501;1417
15;Coruña (A);051;Mugardos;6473;3127;3346
15;Coruña (A);053;Muros;11575;5553;6022
15;Coruña (A);052;Muxía;6800;3331;3469
15;Coruña (A);054;Narón;32054;15655;16399
15;Coruña (A);055;Neda;6423;3107;3316
15;Coruña (A);056;Negreira;6905;3296;3609
15;Coruña (A);057;Noia;15199;7350;7849
15;Coruña (A);058;Oleiros;22306;10803;11503
15;Coruña (A);059;Ordes;12030;5854;6176
15;Coruña (A);060;Oroso;4193;2053;2140
15;Coruña (A);061;Ortigueira;9799;4716;5083
15;Coruña (A);062;Outes;9391;4473;4918
15;Coruña (A);063;Oza dos Ríos;3315;1609;1706
15;Coruña (A);064;Paderne;2847;1358;1489
15;Coruña (A);065;Padrón;10295;4992;5303
15;Coruña (A);066;Pino (O);5229;2610;2619
15;Coruña (A);067;Pobra do Caramiñal (A);10424;4989;5435
15;Coruña (A);068;Ponteceso;7844;3933;3911
15;Coruña (A);069;Pontedeume;9006;4318;4688
15;Coruña (A);070;Pontes de García Rodríguez (As);13205;6683;6522
15;Coruña (A);071;Porto do Son;10896;5348;5548
15;Coruña (A);072;Rianxo;13021;6452;6569
15;Coruña (A);073;Ribeira;26828;13205;13623
15;Coruña (A);074;Rois;5583;2697;2886
15;Coruña (A);075;Sada;10017;4864;5153
15;Coruña (A);076;San Sadurniño;3695;1822;1873
15;Coruña (A);077;Santa Comba;11612;5668;5944
15;Coruña (A);078;Santiago de Compostela;94057;44373;49684
15;Coruña (A);079;Santiso;2476;1283;1193
15;Coruña (A);080;Sobrado;2830;1462;1368
15;Coruña (A);081;Somozas (As);1589;791;798
15;Coruña (A);082;Teo;13415;6570;6845
15;Coruña (A);083;Toques;1936;1007;929
15;Coruña (A);084;Tordoia;5722;2770;2952
15;Coruña (A);085;Touro;5004;2443;2561
15;Coruña (A);086;Trazo;4235;2100;2135
15;Coruña (A);088;Val do Dubra;5443;2661;2782
15;Coruña (A);087;Valdoviño;7089;3504;3585
15;Coruña (A);089;Vedra;5155;2480;2675
15;Coruña (A);091;Vilarmaior;1430;712;718
15;Coruña (A);090;Vilasantar;1817;932;885
15;Coruña (A);092;Vimianzo;9603;4742;4861
15;Coruña (A);093;Zas;6703;3282;3421
16;Cuenca;001;Abia de la Obispalía;107;57;50
16;Cuenca;002;Acebrón (El);301;150;151
16;Cuenca;003;Alarcón;230;119;111
16;Cuenca;004;Albaladejo del Cuende;432;230;202
16;Cuenca;005;Albalate de las Nogueras;413;220;193
16;Cuenca;006;Albendea;212;106;106
16;Cuenca;007;Alberca de Záncara (La);1862;922;940
16;Cuenca;008;Alcalá de la Vega;174;91;83
16;Cuenca;009;Alcantud;155;82;73
16;Cuenca;011;Alcohujate;70;37;33
16;Cuenca;012;Alconchel de la Estrella;236;125;111
16;Cuenca;010;Alcázar del Rey;268;133;135
16;Cuenca;013;Algarra;40;20;20
16;Cuenca;014;Aliaguilla;919;485;434
16;Cuenca;015;Almarcha (La);658;327;331
16;Cuenca;016;Almendros;419;205;214
16;Cuenca;017;Almodóvar del Pinar;582;298;284
16;Cuenca;018;Almonacid del Marquesado;578;302;276
16;Cuenca;019;Altarejos;403;200;203
16;Cuenca;020;Arandilla del Arroyo;52;22;30
16;Cuenca;905;Arcas del Villar;424;208;216
16;Cuenca;022;Arcos de la Sierra;128;67;61
16;Cuenca;024;Arguisuelas;217;114;103
16;Cuenca;025;Arrancacepas;39;21;18
16;Cuenca;026;Atalaya del Cañavate;131;64;67
16;Cuenca;027;Barajas de Melo;755;371;384
16;Cuenca;029;Barchín del Hoyo;154;86;68
16;Cuenca;030;Bascuñana de San Pedro;38;22;16
16;Cuenca;031;Beamud;107;58;49
16;Cuenca;032;Belinchón;330;162;168
16;Cuenca;033;Belmonte;2597;1223;1374
16;Cuenca;034;Belmontejo;298;151;147
16;Cuenca;035;Beteta;428;218;210
16;Cuenca;036;Boniches;267;130;137
16;Cuenca;038;Buciegas;89;45;44
16;Cuenca;039;Buenache de Alarcón;657;336;321
16;Cuenca;040;Buenache de la Sierra;126;72;54
16;Cuenca;041;Buendía;514;262;252
16;Cuenca;042;Campillo de Altobuey;1739;863;876
16;Cuenca;043;Campillos-Paravientos;162;85;77
16;Cuenca;044;Campillos-Sierra;105;55;50
16;Cuenca;901;Campos del Paraíso;1262;586;676
16;Cuenca;045;Canalejas del Arroyo;372;195;177
16;Cuenca;055;Carboneras de Guadazaón;1045;556;489
16;Cuenca;056;Cardenete;761;394;367
16;Cuenca;057;Carrascosa;125;69;56
16;Cuenca;058;Carrascosa de Haro;172;89;83
16;Cuenca;060;Casas de Benítez;1131;555;576
16;Cuenca;061;Casas de Fernando Alonso;1441;709;732
16;Cuenca;062;Casas de Garcimolina;29;14;15
16;Cuenca;063;Casas de Guijarro;172;88;84
16;Cuenca;064;Casas de Haro;901;453;448
16;Cuenca;065;Casas de los Pinos;548;266;282
16;Cuenca;066;Casasimarro;3060;1548;1512
16;Cuenca;067;Castejón;257;128;129
16;Cuenca;068;Castillejo de Iniesta;202;113;89
16;Cuenca;070;Castillejo-Sierra;57;26;31
16;Cuenca;072;Castillo de Garcimuñoz;297;151;146
16;Cuenca;071;Castillo-Albaráñez;34;18;16
16;Cuenca;047;Cañada Juncosa;402;208;194
16;Cuenca;046;Cañada del Hoyo;402;205;197
16;Cuenca;048;Cañamares;621;333;288
16;Cuenca;049;Cañavate (El);290;145;145
16;Cuenca;050;Cañaveras;449;230;219
16;Cuenca;051;Cañaveruelas;257;129;128
16;Cuenca;052;Cañete;823;414;409
16;Cuenca;053;Cañizares;646;338;308
16;Cuenca;073;Cervera del Llano;332;166;166
16;Cuenca;023;Chillarón de Cuenca;306;154;152
16;Cuenca;081;Chumillas;59;34;25
16;Cuenca;074;Cierva (La);55;27;28
16;Cuenca;078;Cuenca;45789;22081;23708
16;Cuenca;079;Cueva del Hierro;49;31;18
16;Cuenca;082;Enguídanos;573;300;273
16;Cuenca;083;Fresneda de Altarejos;107;60;47
16;Cuenca;084;Fresneda de la Sierra;78;38;40
16;Cuenca;085;Frontera (La);237;117;120
16;Cuenca;086;Fuente de Pedro Naharro;1257;619;638
16;Cuenca;087;Fuentelespino de Haro;386;209;177
16;Cuenca;088;Fuentelespino de Moya;153;77;76
16;Cuenca;904;Fuentenava de Jábaga;261;138;123
16;Cuenca;089;Fuentes;539;281;258
16;Cuenca;091;Fuertescusa;132;69;63
16;Cuenca;092;Gabaldón;199;109;90
16;Cuenca;093;Garaballa;171;89;82
16;Cuenca;094;Gascueña;172;80;92
16;Cuenca;095;Graja de Campalbo;143;80;63
16;Cuenca;096;Graja de Iniesta;358;192;166
16;Cuenca;097;Henarejos;323;153;170
16;Cuenca;098;Herrumblar (El);798;415;383
16;Cuenca;099;Hinojosa (La);382;187;195
16;Cuenca;100;Hinojosos (Los);1196;596;600
16;Cuenca;101;Hito (El);252;125;127
16;Cuenca;102;Honrubia;1692;833;859
16;Cuenca;103;Hontanaya;543;263;280
16;Cuenca;104;Hontecillas;103;49;54
16;Cuenca;106;Horcajo de Santiago;3626;1800;1826
16;Cuenca;108;Huelves;84;38;46
16;Cuenca;110;Huerta de la Obispalía;167;95;72
16;Cuenca;111;Huerta del Marquesado;218;118;100
16;Cuenca;112;Huete;2437;1251;1186
16;Cuenca;107;Huélamo;164;87;77
16;Cuenca;109;Huérguina;124;66;58
16;Cuenca;113;Iniesta;3787;1885;1902
16;Cuenca;115;Laguna del Marquesado;75;38;37
16;Cuenca;116;Lagunaseca;105;52;53
16;Cuenca;117;Landete;1587;796;791
16;Cuenca;118;Ledaña;1978;977;1001
16;Cuenca;119;Leganiel;273;133;140
16;Cuenca;121;Majadas (Las);412;205;207
16;Cuenca;122;Mariana;302;151;151
16;Cuenca;123;Masegosa;132;68;64
16;Cuenca;124;Mesas (Las);2622;1348;1274
16;Cuenca;125;Minglanilla;2378;1197;1181
16;Cuenca;126;Mira;1173;592;581
16;Cuenca;128;Monreal del Llano;97;51;46
16;Cuenca;129;Montalbanejo;235;109;126
16;Cuenca;130;Montalbo;816;433;383
16;Cuenca;131;Monteagudo de las Salinas;123;68;55
16;Cuenca;132;Mota de Altarejos;69;43;26
16;Cuenca;133;Mota del Cuervo;5563;2757;2806
16;Cuenca;134;Motilla del Palancar;4898;2472;2426
16;Cuenca;135;Moya;318;172;146
16;Cuenca;137;Narboneta;105;56;49
16;Cuenca;139;Olivares de Júcar;647;325;322
16;Cuenca;140;Olmeda de la Cuesta;49;28;21
16;Cuenca;141;Olmeda del Rey;253;116;137
16;Cuenca;142;Olmedilla de Alarcón;242;126;116
16;Cuenca;143;Olmedilla de Eliz;38;20;18
16;Cuenca;145;Osa de la Vega;721;367;354
16;Cuenca;147;Pajaroncillo;104;52;52
16;Cuenca;146;Pajarón;156;80;76
16;Cuenca;148;Palomares del Campo;1042;507;535
16;Cuenca;149;Palomera;196;93;103
16;Cuenca;150;Paracuellos;187;90;97
16;Cuenca;151;Paredes;82;43;39
16;Cuenca;152;Parra de las Vegas (La);59;27;32
16;Cuenca;153;Pedernoso (El);1401;694;707
16;Cuenca;154;Pedroñeras (Las);6549;3330;3219
16;Cuenca;155;Peral (El);743;379;364
16;Cuenca;156;Peraleja (La);184;94;90
16;Cuenca;157;Pesquera (La);293;153;140
16;Cuenca;158;Picazo (El);736;364;372
16;Cuenca;159;Pinarejo;624;324;300
16;Cuenca;160;Pineda de Gigüela;179;94;85
16;Cuenca;161;Piqueras del Castillo;89;47;42
16;Cuenca;162;Portalrubio de Guadamejud;112;52;60
16;Cuenca;163;Portilla;105;56;49
16;Cuenca;165;Poyatos;131;75;56
16;Cuenca;166;Pozoamargo;336;157;179
16;Cuenca;908;Pozorrubielos de la Mancha;287;145;142
16;Cuenca;167;Pozorrubio;564;268;296
16;Cuenca;169;Pozuelo (El);106;55;51
16;Cuenca;170;Priego;1135;572;563
16;Cuenca;171;Provencio (El);2673;1328;1345
16;Cuenca;172;Puebla de Almenara;650;334;316
16;Cuenca;173;Puebla de Don Francisco;423;213;210
16;Cuenca;174;Puebla del Salvador;310;166;144
16;Cuenca;175;Quintanar del Rey;6075;3095;2980
16;Cuenca;176;Rada de Haro;75;36;39
16;Cuenca;177;Reíllo;158;77;81
16;Cuenca;181;Rozalén del Monte;147;70;77
16;Cuenca;185;Saceda-Trasierra;78;38;40
16;Cuenca;186;Saelices;779;394;385
16;Cuenca;187;Salinas del Manzano;143;78;65
16;Cuenca;188;Salmeroncillos;176;93;83
16;Cuenca;189;Salvacañete;362;201;161
16;Cuenca;190;San Clemente;6374;3129;3245
16;Cuenca;191;San Lorenzo de la Parrilla;1634;820;814
16;Cuenca;192;San Martín de Boniches;112;58;54
16;Cuenca;193;San Pedro Palmiches;111;61;50
16;Cuenca;194;Santa Cruz de Moya;444;226;218
16;Cuenca;196;Santa María de los Llanos;918;462;456
16;Cuenca;195;Santa María del Campo Rus;906;454;452
16;Cuenca;197;Santa María del Val;128;69;59
16;Cuenca;198;Sisante;1850;927;923
16;Cuenca;199;Solera de Gabaldón;42;25;17
16;Cuenca;909;Sotorribas;1002;496;506
16;Cuenca;202;Talayuelas;1261;648;613
16;Cuenca;203;Tarancón;11339;5595;5744
16;Cuenca;205;Tejadillos;192;94;98
16;Cuenca;206;Tinajas;425;231;194
16;Cuenca;209;Torralba;223;107;116
16;Cuenca;211;Torrejoncillo del Rey;809;382;427
16;Cuenca;212;Torrubia del Campo;380;176;204
16;Cuenca;213;Torrubia del Castillo;52;27;25
16;Cuenca;215;Tragacete;419;218;201
16;Cuenca;216;Tresjuncos;585;300;285
16;Cuenca;217;Tribaldos;143;67;76
16;Cuenca;204;Tébar;437;239;198
16;Cuenca;218;Uclés;300;142;158
16;Cuenca;219;Uña;162;77;85
16;Cuenca;906;Valdecolmenas (Los);151;78;73
16;Cuenca;224;Valdemeca;110;54;56
16;Cuenca;225;Valdemorillo de la Sierra;100;52;48
16;Cuenca;227;Valdemoro-Sierra;182;105;77
16;Cuenca;228;Valdeolivas;340;182;158
16;Cuenca;902;Valdetórtola;164;92;72
16;Cuenca;903;Valeras (Las);1476;729;747
16;Cuenca;231;Valhermoso de la Fuente;70;34;36
16;Cuenca;234;Valsalobre;65;32;33
16;Cuenca;236;Valverde de Júcar;1499;741;758
16;Cuenca;237;Valverdejo;157;80;77
16;Cuenca;238;Vara de Rey;783;384;399
16;Cuenca;239;Vega del Codorno;257;128;129
16;Cuenca;240;Vellisca;195;93;102
16;Cuenca;242;Villaconejos de Trabaque;559;280;279
16;Cuenca;243;Villaescusa de Haro;650;325;325
16;Cuenca;244;Villagarcía del Llano;1024;507;517
16;Cuenca;245;Villalba de la Sierra;585;292;293
16;Cuenca;246;Villalba del Rey;769;390;379
16;Cuenca;247;Villalgordo del Marquesado;168;83;85
16;Cuenca;248;Villalpardo;1146;575;571
16;Cuenca;249;Villamayor de Santiago;2957;1455;1502
16;Cuenca;250;Villanueva de Guadamejud;133;69;64
16;Cuenca;251;Villanueva de la Jara;2452;1245;1207
16;Cuenca;253;Villar de Cañas;480;241;239
16;Cuenca;254;Villar de Domingo García;294;151;143
16;Cuenca;263;Villar de Olalla;815;418;397
16;Cuenca;255;Villar de la Encina;252;129;123
16;Cuenca;258;Villar del Humo;502;261;241
16;Cuenca;259;Villar del Infantado;50;30;20
16;Cuenca;910;Villar y Velasco;151;82;69
16;Cuenca;264;Villarejo de Fuentes;868;414;454
16;Cuenca;265;Villarejo de la Peñuela;35;18;17
16;Cuenca;266;Villarejo-Periesteban;570;293;277
16;Cuenca;269;Villares del Saz;834;425;409
16;Cuenca;270;Villarrubio;272;127;145
16;Cuenca;271;Villarta;818;411;407
16;Cuenca;272;Villas de la Ventosa;443;247;196
16;Cuenca;273;Villaverde y Pasaconsol;438;221;217
16;Cuenca;275;Vindel;30;17;13
16;Cuenca;274;Víllora;270;129;141
16;Cuenca;276;Yémeda;38;16;22
16;Cuenca;277;Zafra de Záncara;252;130;122
16;Cuenca;278;Zafrilla;139;69;70
16;Cuenca;279;Zarza de Tajo;297;130;167
16;Cuenca;280;Zarzuela;327;163;164
17;Girona;001;Agullana;668;346;322
17;Girona;002;Aiguaviva;413;207;206
17;Girona;003;Albanyà;118;61;57
17;Girona;004;Albons;515;276;239
17;Girona;006;Alp;1050;535;515
17;Girona;007;Amer;2293;1131;1162
17;Girona;008;Anglès;5132;2595;2537
17;Girona;009;Arbúcies;4848;2428;2420
17;Girona;010;Argelaguer;353;183;170
17;Girona;011;Armentera (L');766;376;390
17;Girona;012;Avinyonet de Puigventós;448;220;228
17;Girona;015;Banyoles;14751;7284;7467
17;Girona;016;Bàscara;780;400;380
17;Girona;013;Begur;2995;1524;1471
17;Girona;018;Bellcaire d'Empordà;490;251;239
17;Girona;019;Besalú;2050;1008;1042
17;Girona;020;Bescanó;2949;1494;1455
17;Girona;021;Beuda;127;69;58
17;Girona;022;Bisbal d'Empordà (La);7974;3928;4046
17;Girona;234;Biure;231;115;116
17;Girona;023;Blanes;27596;13970;13626
17;Girona;029;Boadella d'Empordà;221;111;110
17;Girona;024;Bolvir;244;116;128
17;Girona;025;Bordils;1350;684;666
17;Girona;026;Borrassà;483;240;243
17;Girona;027;Breda;3354;1731;1623
17;Girona;028;Brunyola;372;189;183
17;Girona;031;Cabanelles;231;127;104
17;Girona;030;Cabanes;798;406;392
17;Girona;032;Cadaqués;1909;940;969
17;Girona;033;Caldes de Malavella;3483;1743;1740
17;Girona;034;Calonge;6176;3094;3082
17;Girona;035;Camós;640;326;314
17;Girona;036;Campdevànol;3332;1625;1707
17;Girona;037;Campelles;131;66;65
17;Girona;038;Campllong;283;151;132
17;Girona;039;Camprodon;2209;1078;1131
17;Girona;040;Canet d'Adri;512;260;252
17;Girona;041;Cantallops;266;133;133
17;Girona;042;Capmany;387;200;187
17;Girona;044;Cassà de la Selva;7482;3708;3774
17;Girona;046;Castellfollit de la Roca;1029;499;530
17;Girona;047;Castelló d'Empúries;4652;2413;2239
17;Girona;048;Castell-Platja d'Aro;6338;3275;3063
17;Girona;189;Cellera de Ter (La);2090;1024;1066
17;Girona;049;Celrà;2633;1328;1305
17;Girona;050;Cervià de Ter;652;321;331
17;Girona;051;Cistella;216;109;107
17;Girona;054;Colera;447;237;210
17;Girona;055;Colomers;206;98;108
17;Girona;057;Corçà;1158;573;585
17;Girona;056;Cornellà del Terri;1851;928;923
17;Girona;058;Crespià;237;119;118
17;Girona;901;Cruïlles, Monells i Sant Sadurní de l'Heura;1121;555;566
17;Girona;060;Darnius;524;277;247
17;Girona;061;Das;138;79;59
17;Girona;062;Escala (L');6043;3073;2970
17;Girona;063;Espinelves;171;87;84
17;Girona;064;Espolla;400;203;197
17;Girona;065;Esponellà;379;190;189
17;Girona;005;Far d'Empordà (El);433;219;214
17;Girona;066;Figueres;35175;17173;18002
17;Girona;067;Flaçà;899;446;453
17;Girona;068;Foixà;310;156;154
17;Girona;069;Fontanals de Cerdanya;345;174;171
17;Girona;070;Fontanilles;124;70;54
17;Girona;071;Fontcoberta;1015;532;483
17;Girona;902;Forallac;1626;809;817
17;Girona;073;Fornells de la Selva;1227;596;631
17;Girona;074;Fortià;487;241;246
17;Girona;075;Garrigàs;309;162;147
17;Girona;076;Garrigoles;147;82;65
17;Girona;077;Garriguella;703;361;342
17;Girona;078;Ger;297;158;139
17;Girona;079;Girona;72879;35134;37745
17;Girona;080;Gombrèn;254;123;131
17;Girona;081;Gualta;264;130;134
17;Girona;082;Guils de Cerdanya;315;162;153
17;Girona;083;Hostalric;2886;1442;1444
17;Girona;084;Isòvol;172;87;85
17;Girona;085;Jafre;367;185;182
17;Girona;086;Jonquera (La);2573;1296;1277
17;Girona;087;Juià;263;119;144
17;Girona;088;Lladó;487;242;245
17;Girona;089;Llagostera;5398;2725;2673
17;Girona;090;Llambilles;455;231;224
17;Girona;091;Llanars;421;217;204
17;Girona;092;Llançà;3751;1899;1852
17;Girona;093;Llers;869;460;409
17;Girona;094;Llívia;933;479;454
17;Girona;095;Lloret de Mar;17277;8747;8530
17;Girona;096;Llosses (Les);368;204;164
17;Girona;102;Maçanet de Cabrenys;677;344;333
17;Girona;103;Maçanet de la Selva;3484;1758;1726
17;Girona;097;Madremanya;184;80;104
17;Girona;098;Maià de Montcal;333;165;168
17;Girona;100;Masarac;254;128;126
17;Girona;101;Massanes;537;278;259
17;Girona;099;Meranges;72;42;30
17;Girona;105;Mieres;323;163;160
17;Girona;106;Mollet de Peralada;175;96;79
17;Girona;107;Molló;353;183;170
17;Girona;109;Montagut i Oix;792;413;379
17;Girona;110;Mont-ras;1509;791;718
17;Girona;111;Navata;658;322;336
17;Girona;112;Ogassa;261;153;108
17;Girona;114;Olot;27890;13425;14465
17;Girona;115;Ordis;308;160;148
17;Girona;116;Osor;505;262;243
17;Girona;117;Palafrugell;17758;9071;8687
17;Girona;118;Palamós;14126;7001;7125
17;Girona;119;Palau de Santa Eulàlia;93;49;44
17;Girona;121;Palau-sator;296;151;145
17;Girona;120;Palau-saverdera;782;388;394
17;Girona;122;Palmerola;"";"";""
17;Girona;123;Palol de Revardit;358;182;176
17;Girona;124;Pals;1846;957;889
17;Girona;125;Pardines;136;71;65
17;Girona;126;Parlavà;338;178;160
17;Girona;128;Pau;377;181;196
17;Girona;129;Pedret i Marzà;119;59;60
17;Girona;130;Pera (La);374;196;178
17;Girona;132;Peralada;1148;590;558
17;Girona;133;Planes d'Hostoles (Les);1807;892;915
17;Girona;134;Planoles;275;152;123
17;Girona;135;Pont de Molins;416;224;192
17;Girona;136;Pontós;201;120;81
17;Girona;137;Porqueres;3258;1644;1614
17;Girona;140;Port de la Selva (El);861;422;439
17;Girona;138;Portbou;1791;887;904
17;Girona;139;Preses (Les);1331;657;674
17;Girona;141;Puigcerdà;6635;3378;3257
17;Girona;142;Quart;2093;1070;1023
17;Girona;043;Queralbs;203;112;91
17;Girona;143;Rabós;147;68;79
17;Girona;144;Regencós;270;152;118
17;Girona;145;Ribes de Freser;2248;1091;1157
17;Girona;146;Riells i Viabrea;1298;673;625
17;Girona;147;Ripoll;11247;5499;5748
17;Girona;148;Riudarenes;1190;601;589
17;Girona;149;Riudaura;380;183;197
17;Girona;150;Riudellots de la Selva;1450;736;714
17;Girona;151;Riumors;201;95;106
17;Girona;152;Roses;11717;5993;5724
17;Girona;153;Rupià;204;105;99
17;Girona;154;Sales de Llierca;59;35;24
17;Girona;155;Salt;22080;11049;11031
17;Girona;157;Sant Andreu Salou;132;68;64
17;Girona;183;Sant Aniol de Finestres;255;135;120
17;Girona;158;Sant Climent Sescebes;429;225;204
17;Girona;159;Sant Feliu de Buixalleu;649;351;298
17;Girona;160;Sant Feliu de Guíxols;17430;8504;8926
17;Girona;161;Sant Feliu de Pallerols;1119;543;576
17;Girona;162;Sant Ferriol;205;113;92
17;Girona;163;Sant Gregori;2120;1116;1004
17;Girona;164;Sant Hilari Sacalm;5012;2558;2454
17;Girona;165;Sant Jaume de Llierca;780;392;388
17;Girona;167;Sant Joan de les Abadesses;3875;1883;1992
17;Girona;168;Sant Joan de Mollet;312;151;161
17;Girona;185;Sant Joan les Fonts;2849;1425;1424
17;Girona;166;Sant Jordi Desvalls;605;304;301
17;Girona;169;Sant Julià de Ramis;1966;993;973
17;Girona;903;Sant Julià del Llor i Bonmatí;907;440;467
17;Girona;171;Sant Llorenç de la Muga;169;83;86
17;Girona;172;Sant Martí de Llémena;377;199;178
17;Girona;173;Sant Martí Vell;204;111;93
17;Girona;174;Sant Miquel de Campmajor;215;122;93
17;Girona;175;Sant Miquel de Fluvià;560;289;271
17;Girona;176;Sant Mori;131;62;69
17;Girona;177;Sant Pau de Segúries;634;311;323
17;Girona;178;Sant Pere Pescador;1413;785;628
17;Girona;180;Santa Coloma de Farners;8682;4431;4251
17;Girona;181;Santa Cristina d'Aro;2276;1204;1072
17;Girona;182;Santa Llogaia d'Àlguema;325;172;153
17;Girona;184;Santa Pau;1440;735;705
17;Girona;186;Sarrià de Ter;3256;1599;1657
17;Girona;187;Saus;686;345;341
17;Girona;188;Selva de Mar (La);167;88;79
17;Girona;190;Serinyà;768;388;380
17;Girona;191;Serra de Daró;186;96;90
17;Girona;192;Setcases;161;85;76
17;Girona;193;Sils;2636;1345;1291
17;Girona;052;Siurana;157;72;85
17;Girona;194;Susqueda;84;44;40
17;Girona;195;Tallada d'Empordà (La);335;170;165
17;Girona;196;Terrades;190;89;101
17;Girona;197;Torrent;186;95;91
17;Girona;198;Torroella de Fluvià;316;173;143
17;Girona;199;Torroella de Montgrí;7770;3938;3832
17;Girona;200;Tortellà;673;335;338
17;Girona;201;Toses;138;84;54
17;Girona;202;Tossa de Mar;3831;1927;1904
17;Girona;204;Ullà;737;369;368
17;Girona;205;Ullastret;253;129;124
17;Girona;203;Ultramort;200;104;96
17;Girona;206;Urús;148;79;69
17;Girona;014;Vajol (La);100;54;46
17;Girona;208;Vall de Bianya (La);1072;534;538
17;Girona;207;Vall d'en Bas (La);2523;1280;1243
17;Girona;170;Vallfogona de Ripollès;260;134;126
17;Girona;209;Vall-llobrega;291;148;143
17;Girona;210;Ventalló;566;294;272
17;Girona;211;Verges;1090;508;582
17;Girona;212;Vidrà;176;90;86
17;Girona;213;Vidreres;4055;2026;2029
17;Girona;214;Vilabertran;789;393;396
17;Girona;215;Vilablareix;1173;589;584
17;Girona;217;Viladamat;408;213;195
17;Girona;216;Viladasens;188;99;89
17;Girona;218;Vilademuls;773;385;388
17;Girona;220;Viladrau;890;449;441
17;Girona;221;Vilafant;3234;1601;1633
17;Girona;223;Vilajuïga;705;351;354
17;Girona;224;Vilallonga de Ter;431;225;206
17;Girona;225;Vilamacolum;255;133;122
17;Girona;226;Vilamalla;701;359;342
17;Girona;227;Vilamaniscle;122;61;61
17;Girona;228;Vilanant;264;135;129
17;Girona;230;Vila-sacra;373;177;196
17;Girona;222;Vilaür;118;57;61
17;Girona;233;Vilobí d'Onyar;2154;1143;1011
17;Girona;232;Vilopriu;183;94;89
18;Granada;001;Agrón;465;236;229
18;Granada;002;Alamedilla;976;491;485
18;Granada;003;Albolote;11620;5875;5745
18;Granada;004;Albondón;1311;650;661
18;Granada;005;Albuñán;507;252;255
18;Granada;006;Albuñol;5575;2757;2818
18;Granada;007;Albuñuelas;1358;692;666
18;Granada;010;Aldeire;808;410;398
18;Granada;011;Alfacar;4146;2103;2043
18;Granada;012;Algarinejo;5181;2644;2537
18;Granada;013;Alhama de Granada;6104;3070;3034
18;Granada;014;Alhendín;4073;2050;2023
18;Granada;015;Alicún de Ortega;796;404;392
18;Granada;016;Almegíjar;446;232;214
18;Granada;017;Almuñécar;21368;10559;10809
18;Granada;904;Alpujarra de la Sierra;1307;669;638
18;Granada;018;Alquife;1090;533;557
18;Granada;020;Arenas del Rey;2145;1111;1034
18;Granada;021;Armilla;12462;6189;6273
18;Granada;022;Atarfe;10620;5277;5343
18;Granada;023;Baza;21851;10669;11182
18;Granada;024;Beas de Granada;963;498;465
18;Granada;025;Beas de Guadix;428;229;199
18;Granada;027;Benalúa;3483;1750;1733
18;Granada;028;Benalúa de las Villas;1428;714;714
18;Granada;029;Benamaurel;2561;1305;1256
18;Granada;030;Bérchules;900;470;430
18;Granada;032;Bubión;375;187;188
18;Granada;033;Busquístar;458;239;219
18;Granada;034;Cacín;895;454;441
18;Granada;035;Cádiar;1982;1004;978
18;Granada;036;Cájar;2495;1172;1323
18;Granada;114;Calahorra (La);1042;493;549
18;Granada;037;Calicasas;614;304;310
18;Granada;038;Campotéjar;1491;735;756
18;Granada;039;Caniles;5288;2574;2714
18;Granada;040;Cáñar;345;166;179
18;Granada;042;Capileira;594;292;302
18;Granada;043;Carataunas;221;118;103
18;Granada;044;Cástaras;323;169;154
18;Granada;045;Castilléjar;2199;1107;1092
18;Granada;046;Castril;3221;1669;1552
18;Granada;047;Cenes de la Vega;3487;1801;1686
18;Granada;059;Chauchina;4047;2001;2046
18;Granada;061;Chimeneas;1608;816;792
18;Granada;062;Churriana de la Vega;6168;3116;3052
18;Granada;048;Cijuela;1465;722;743
18;Granada;049;Cogollos de Guadix;790;421;369
18;Granada;050;Cogollos de la Vega;2086;1050;1036
18;Granada;051;Colomera;1858;947;911
18;Granada;053;Cortes de Baza;2924;1491;1433
18;Granada;054;Cortes y Graena;1054;552;502
18;Granada;912;Cuevas del Campo;2394;1181;1213
18;Granada;056;Cúllar;5528;2737;2791
18;Granada;057;Cúllar Vega;2142;1077;1065
18;Granada;063;Darro;1644;797;847
18;Granada;064;Dehesas de Guadix;699;352;347
18;Granada;066;Deifontes;2615;1312;1303
18;Granada;067;Diezma;1043;538;505
18;Granada;068;Dílar;1533;754;779
18;Granada;069;Dólar;696;350;346
18;Granada;070;Dúdar;294;145;149
18;Granada;071;Dúrcal;6244;3101;3143
18;Granada;072;Escúzar;957;495;462
18;Granada;074;Ferreira;418;195;223
18;Granada;076;Fonelas;1345;672;673
18;Granada;078;Freila;1234;625;609
18;Granada;079;Fuente Vaqueros;3996;1981;2015
18;Granada;905;Gabias (Las);6884;3445;3439
18;Granada;082;Galera;1597;798;799
18;Granada;083;Gobernador;410;202;208
18;Granada;084;Gójar;2786;1412;1374
18;Granada;085;Gor;1304;660;644
18;Granada;086;Gorafe;587;285;302
18;Granada;087;Granada;272738;128398;144340
18;Granada;088;Guadahortuna;2457;1255;1202
18;Granada;089;Guadix;20488;10118;10370
18;Granada;906;Guajares (Los);1486;762;724
18;Granada;093;Gualchos;3105;1568;1537
18;Granada;094;Güejar Sierra;2920;1461;1459
18;Granada;095;Güevéjar;1418;697;721
18;Granada;096;Huélago;703;363;340
18;Granada;097;Huéneja;1338;661;677
18;Granada;098;Huéscar;10174;5093;5081
18;Granada;099;Huétor de Santillán;1676;874;802
18;Granada;100;Huétor Tájar;8099;4034;4065
18;Granada;101;Huétor Vega;7427;3709;3718
18;Granada;102;Illora;11086;5553;5533
18;Granada;103;Itrabo;1079;531;548
18;Granada;105;Iznalloz;6961;3514;3447
18;Granada;107;Jayena;1552;802;750
18;Granada;108;Jerez del Marquesado;1238;616;622
18;Granada;109;Jete;752;366;386
18;Granada;111;Jun;1419;714;705
18;Granada;112;Juviles;217;108;109
18;Granada;115;Láchar;2407;1199;1208
18;Granada;116;Lanjarón;4028;2004;2024
18;Granada;117;Lanteira;702;344;358
18;Granada;119;Lecrín;2452;1184;1268
18;Granada;120;Lentegí;381;183;198
18;Granada;121;Lobras;220;111;109
18;Granada;122;Loja;21888;10884;11004
18;Granada;123;Lugros;441;235;206
18;Granada;124;Lújar;614;318;296
18;Granada;126;Malahá (La);1656;834;822
18;Granada;127;Maracena;14047;6980;7067
18;Granada;128;Marchal;485;233;252
18;Granada;132;Moclín;4917;2435;2482
18;Granada;133;Molvízar;2827;1387;1440
18;Granada;134;Monachil;5080;2612;2468
18;Granada;135;Montefrío;8135;4105;4030
18;Granada;136;Montejícar;3034;1548;1486
18;Granada;137;Montillana;1437;736;701
18;Granada;138;Moraleda de Zafayona;2709;1390;1319
18;Granada;909;Morelábor;1032;510;522
18;Granada;140;Motril;49527;24510;25017
18;Granada;141;Murtas;1060;550;510
18;Granada;903;Nevada;1505;752;753
18;Granada;143;Nigüelas;1223;623;600
18;Granada;144;Nívar;657;341;316
18;Granada;145;Ogíjares;6491;3256;3235
18;Granada;146;Orce;1475;756;719
18;Granada;147;Órgiva;5333;2681;2652
18;Granada;148;Otívar;1180;593;587
18;Granada;149;Otura;3477;1761;1716
18;Granada;150;Padul;6645;3354;3291
18;Granada;151;Pampaneira;343;179;164
18;Granada;152;Pedro Martínez;1545;786;759
18;Granada;153;Peligros;7113;3539;3574
18;Granada;154;Peza (La);1573;806;767
18;Granada;910;Pinar (El);1323;660;663
18;Granada;157;Pinos Genil;1133;587;546
18;Granada;158;Pinos Puente;13973;6994;6979
18;Granada;159;Píñar;1536;791;745
18;Granada;161;Polícar;260;135;125
18;Granada;162;Polopos;1226;642;584
18;Granada;163;Pórtugos;472;244;228
18;Granada;164;Puebla de Don Fadrique;2687;1339;1348
18;Granada;165;Pulianas;3041;1542;1499
18;Granada;167;Purullena;2706;1326;1380
18;Granada;168;Quéntar;1171;590;581
18;Granada;170;Rubite;451;235;216
18;Granada;171;Salar;2800;1389;1411
18;Granada;173;Salobreña;10088;5038;5050
18;Granada;174;Santa Cruz del Comercio;581;311;270
18;Granada;175;Santa Fe;12724;6248;6476
18;Granada;176;Soportújar;278;144;134
18;Granada;177;Sorvilán;921;453;468
18;Granada;901;Taha (La);975;489;486
18;Granada;178;Torre-Cardela;1305;656;649
18;Granada;179;Torvizcón;1106;555;551
18;Granada;180;Trevélez;807;440;367
18;Granada;181;Turón;394;220;174
18;Granada;182;Ugíjar;3004;1481;1523
18;Granada;907;Valle del Zalabí;2551;1273;1278
18;Granada;902;Valle (El);1479;734;745
18;Granada;183;Válor;1118;560;558
18;Granada;911;Vegas del Genil;2716;1372;1344
18;Granada;184;Vélez de Benaudalla;2607;1280;1327
18;Granada;185;Ventas de Huelma;724;360;364
18;Granada;908;Villamena;1024;488;536
18;Granada;187;Villanueva de las Torres;1064;559;505
18;Granada;188;Villanueva Mesía;1969;985;984
18;Granada;189;Víznar;818;427;391
18;Granada;192;Zafarraya;2255;1145;1110
18;Granada;913;Zagra;1282;636;646
18;Granada;193;Zubia (La);10846;5355;5491
18;Granada;194;Zújar;3090;1568;1522
19;Guadalajara;001;Abánades;119;67;52
19;Guadalajara;002;Ablanque;152;78;74
19;Guadalajara;003;Adobes;46;23;23
19;Guadalajara;004;Alaminos;100;48;52
19;Guadalajara;005;Alarilla;120;61;59
19;Guadalajara;006;Albalate de Zorita;1044;544;500
19;Guadalajara;007;Albares;534;269;265
19;Guadalajara;008;Albendiego;54;26;28
19;Guadalajara;009;Alcocer;342;168;174
19;Guadalajara;010;Alcolea de las Peñas;43;25;18
19;Guadalajara;011;Alcolea del Pinar;471;233;238
19;Guadalajara;013;Alcoroches;203;106;97
19;Guadalajara;015;Aldeanueva de Guadalajara;100;44;56
19;Guadalajara;016;Algar de Mesa;96;50;46
19;Guadalajara;017;Algora;131;76;55
19;Guadalajara;018;Alhóndiga;264;150;114
19;Guadalajara;019;Alique;34;9;25
19;Guadalajara;020;Almadrones;110;71;39
19;Guadalajara;021;Almoguera;823;428;395
19;Guadalajara;022;Almonacid de Zorita;990;482;508
19;Guadalajara;023;Alocén;145;75;70
19;Guadalajara;024;Alovera;1407;716;691
19;Guadalajara;027;Alustante;295;163;132
19;Guadalajara;031;Angón;38;22;16
19;Guadalajara;032;Anguita;348;175;173
19;Guadalajara;033;Anquela del Ducado;93;44;49
19;Guadalajara;034;Anquela del Pedregal;27;16;11
19;Guadalajara;036;Aranzueque;379;194;185
19;Guadalajara;037;Arbancón;219;123;96
19;Guadalajara;038;Arbeteta;53;27;26
19;Guadalajara;039;Argecilla;145;81;64
19;Guadalajara;040;Armallones;55;33;22
19;Guadalajara;041;Armuña de Tajuña;120;64;56
19;Guadalajara;042;Arroyo de las Fraguas;27;14;13
19;Guadalajara;043;Atanzón;104;61;43
19;Guadalajara;044;Atienza;501;266;235
19;Guadalajara;045;Auñón;263;139;124
19;Guadalajara;046;Azuqueca de Henares;14376;7295;7081
19;Guadalajara;047;Baides;90;46;44
19;Guadalajara;048;Baños de Tajo;35;23;12
19;Guadalajara;049;Bañuelos;31;17;14
19;Guadalajara;050;Barriopedro;36;15;21
19;Guadalajara;051;Berninches;134;77;57
19;Guadalajara;052;Bodera (La);58;35;23
19;Guadalajara;053;Brihuega;3103;1609;1494
19;Guadalajara;054;Budia;315;175;140
19;Guadalajara;055;Bujalaro;97;55;42
19;Guadalajara;057;Bustares;121;64;57
19;Guadalajara;058;Cabanillas del Campo;1450;748;702
19;Guadalajara;059;Campillo de Dueñas;162;85;77
19;Guadalajara;060;Campillo de Ranas;134;62;72
19;Guadalajara;061;Campisábalos;74;35;39
19;Guadalajara;064;Canredondo;127;66;61
19;Guadalajara;065;Cantalojas;169;95;74
19;Guadalajara;066;Cañizar;116;59;57
19;Guadalajara;067;Cardoso de la Sierra (El);124;76;48
19;Guadalajara;070;Casa de Uceda;117;59;58
19;Guadalajara;071;Casar (El);1911;989;922
19;Guadalajara;073;Casas de San Galindo;39;21;18
19;Guadalajara;074;Caspueñas;81;48;33
19;Guadalajara;075;Castejón de Henares;117;64;53
19;Guadalajara;076;Castellar de la Muela;58;29;29
19;Guadalajara;078;Castilforte;59;33;26
19;Guadalajara;079;Castilnuevo;12;5;7
19;Guadalajara;080;Cendejas de Enmedio;135;65;70
19;Guadalajara;081;Cendejas de la Torre;114;64;50
19;Guadalajara;082;Centenera;82;43;39
19;Guadalajara;103;Checa;443;230;213
19;Guadalajara;104;Chequilla;25;11;14
19;Guadalajara;106;Chillarón del Rey;143;76;67
19;Guadalajara;105;Chiloeches;1135;597;538
19;Guadalajara;086;Cifuentes;2638;1335;1303
19;Guadalajara;087;Cincovillas;39;19;20
19;Guadalajara;088;Ciruelas;75;39;36
19;Guadalajara;089;Ciruelos del Pinar;67;34;33
19;Guadalajara;090;Cobeta;146;72;74
19;Guadalajara;091;Cogollor;58;32;26
19;Guadalajara;092;Cogolludo;609;338;271
19;Guadalajara;095;Condemios de Abajo;33;18;15
19;Guadalajara;096;Condemios de Arriba;176;92;84
19;Guadalajara;097;Congostrina;53;25;28
19;Guadalajara;098;Copernal;31;17;14
19;Guadalajara;099;Corduente;507;275;232
19;Guadalajara;102;Cubillo de Uceda (El);148;70;78
19;Guadalajara;107;Driebes;384;203;181
19;Guadalajara;108;Durón;123;59;64
19;Guadalajara;109;Embid;69;38;31
19;Guadalajara;110;Escamilla;121;60;61
19;Guadalajara;111;Escariche;219;115;104
19;Guadalajara;112;Escopete;67;24;43
19;Guadalajara;113;Espinosa de Henares;543;261;282
19;Guadalajara;114;Esplegares;85;50;35
19;Guadalajara;115;Establés;62;30;32
19;Guadalajara;116;Estriégana;38;21;17
19;Guadalajara;117;Fontanar;850;436;414
19;Guadalajara;118;Fuembellida;19;10;9
19;Guadalajara;119;Fuencemillán;129;68;61
19;Guadalajara;120;Fuentelahiguera de Albatages;206;106;100
19;Guadalajara;121;Fuentelencina;220;117;103
19;Guadalajara;122;Fuentelsaz;156;73;83
19;Guadalajara;123;Fuentelviejo;111;54;57
19;Guadalajara;124;Fuentenovilla;222;128;94
19;Guadalajara;125;Gajanejos;107;60;47
19;Guadalajara;126;Galápagos;213;109;104
19;Guadalajara;127;Galve de Sorbe;181;87;94
19;Guadalajara;129;Gascueña de Bornova;42;21;21
19;Guadalajara;130;Guadalajara;68044;33536;34508
19;Guadalajara;132;Henche;51;29;22
19;Guadalajara;133;Heras de Ayuso;114;59;55
19;Guadalajara;134;Herrería;38;16;22
19;Guadalajara;135;Hiendelaencina;138;72;66
19;Guadalajara;136;Hijes;28;14;14
19;Guadalajara;138;Hita;267;143;124
19;Guadalajara;139;Hombrados;55;30;25
19;Guadalajara;142;Hontoba;172;84;88
19;Guadalajara;143;Horche;1253;645;608
19;Guadalajara;145;Hortezuela de Océn;100;51;49
19;Guadalajara;146;Huerce (La);32;18;14
19;Guadalajara;147;Huérmeces del Cerro;75;43;32
19;Guadalajara;148;Huertahernando;75;41;34
19;Guadalajara;150;Hueva;138;68;70
19;Guadalajara;151;Humanes;1207;630;577
19;Guadalajara;152;Illana;751;388;363
19;Guadalajara;153;Iniéstola;24;13;11
19;Guadalajara;154;Inviernas (Las);98;59;39
19;Guadalajara;155;Irueste;77;36;41
19;Guadalajara;156;Jadraque;1207;619;588
19;Guadalajara;157;Jirueque;62;34;28
19;Guadalajara;159;Ledanca;174;83;91
19;Guadalajara;160;Loranca de Tajuña;291;152;139
19;Guadalajara;161;Lupiana;272;147;125
19;Guadalajara;162;Luzaga;128;62;66
19;Guadalajara;163;Luzón;93;46;47
19;Guadalajara;165;Majaelrayo;63;32;31
19;Guadalajara;166;Málaga del Fresno;225;116;109
19;Guadalajara;167;Malaguilla;181;104;77
19;Guadalajara;168;Mandayona;473;223;250
19;Guadalajara;169;Mantiel;97;46;51
19;Guadalajara;170;Maranchón;246;137;109
19;Guadalajara;171;Marchamalo;"";"";""
19;Guadalajara;172;Masegoso de Tajuña;114;57;57
19;Guadalajara;173;Matarrubia;60;35;25
19;Guadalajara;174;Matillas;255;134;121
19;Guadalajara;175;Mazarete;92;46;46
19;Guadalajara;176;Mazuecos;410;207;203
19;Guadalajara;177;Medranda;144;70;74
19;Guadalajara;178;Megina;96;54;42
19;Guadalajara;179;Membrillera;107;52;55
19;Guadalajara;181;Miedes de Atienza;119;61;58
19;Guadalajara;182;Mierla (La);38;22;16
19;Guadalajara;184;Millana;114;56;58
19;Guadalajara;183;Milmarcos;116;62;54
19;Guadalajara;185;Miñosa (La);49;28;21
19;Guadalajara;186;Mirabueno;124;68;56
19;Guadalajara;187;Miralrío;98;51;47
19;Guadalajara;188;Mochales;144;71;73
19;Guadalajara;189;Mohernando;141;78;63
19;Guadalajara;190;Molina de Aragón;3580;1799;1781
19;Guadalajara;191;Monasterio;19;9;10
19;Guadalajara;192;Mondéjar;2150;1070;1080
19;Guadalajara;193;Montarrón;75;44;31
19;Guadalajara;194;Moratilla de los Meleros;121;67;54
19;Guadalajara;195;Morenilla;58;37;21
19;Guadalajara;196;Muduex;133;67;66
19;Guadalajara;197;Navas de Jadraque (Las);25;17;8
19;Guadalajara;198;Negredo;23;11;12
19;Guadalajara;199;Ocentejo;45;19;26
19;Guadalajara;200;Olivar (El);98;53;45
19;Guadalajara;201;Olmeda de Cobeta;87;34;53
19;Guadalajara;202;Olmeda de Jadraque (La);14;8;6
19;Guadalajara;203;Ordial (El);46;21;25
19;Guadalajara;204;Orea;335;177;158
19;Guadalajara;208;Pálmaces de Jadraque;68;34;34
19;Guadalajara;209;Pardos;63;32;31
19;Guadalajara;210;Paredes de Sigüenza;84;43;41
19;Guadalajara;211;Pareja;491;245;246
19;Guadalajara;212;Pastrana;1158;589;569
19;Guadalajara;213;Pedregal (El);118;64;54
19;Guadalajara;214;Peñalén;159;83;76
19;Guadalajara;215;Peñalver;270;152;118
19;Guadalajara;216;Peralejos de las Truchas;185;96;89
19;Guadalajara;217;Peralveche;143;79;64
19;Guadalajara;218;Pinilla de Jadraque;98;48;50
19;Guadalajara;219;Pinilla de Molina;25;15;10
19;Guadalajara;220;Pioz;280;147;133
19;Guadalajara;221;Piqueras;54;32;22
19;Guadalajara;222;Pobo de Dueñas (El);189;104;85
19;Guadalajara;223;Poveda de la Sierra;198;102;96
19;Guadalajara;224;Pozo de Almoguera;221;109;112
19;Guadalajara;225;Pozo de Guadalajara;370;201;169
19;Guadalajara;226;Prádena de Atienza;45;26;19
19;Guadalajara;227;Prados Redondos;94;54;40
19;Guadalajara;228;Puebla de Beleña;38;27;11
19;Guadalajara;229;Puebla de Valles;74;42;32
19;Guadalajara;230;Quer;118;64;54
19;Guadalajara;231;Rebollosa de Jadraque;39;22;17
19;Guadalajara;232;Recuenco (El);129;64;65
19;Guadalajara;233;Renera;68;32;36
19;Guadalajara;234;Retiendas;46;21;25
19;Guadalajara;235;Riba de Saelices;199;111;88
19;Guadalajara;237;Rillo de Gallo;72;41;31
19;Guadalajara;238;Riofrío del Llano;84;44;40
19;Guadalajara;239;Robledillo de Mohernando;185;97;88
19;Guadalajara;240;Robledo de Corpes;80;39;41
19;Guadalajara;241;Romanillos de Atienza;71;44;27
19;Guadalajara;242;Romanones;153;89;64
19;Guadalajara;243;Rueda de la Sierra;79;40;39
19;Guadalajara;244;Sacecorbo;162;89;73
19;Guadalajara;245;Sacedón;1615;822;793
19;Guadalajara;246;Saelices de la Sal;77;39;38
19;Guadalajara;247;Salmerón;287;149;138
19;Guadalajara;248;San Andrés del Congosto;96;50;46
19;Guadalajara;249;San Andrés del Rey;47;18;29
19;Guadalajara;250;Santiuste;26;12;14
19;Guadalajara;251;Saúca;78;40;38
19;Guadalajara;252;Sayatón;206;105;101
19;Guadalajara;254;Selas;63;29;34
19;Guadalajara;901;Semillas;38;19;19
19;Guadalajara;255;Setiles;199;107;92
19;Guadalajara;256;Sienes;104;61;43
19;Guadalajara;257;Sigüenza;4801;2376;2425
19;Guadalajara;258;Solanillos del Extremo;133;70;63
19;Guadalajara;259;Somolinos;43;20;23
19;Guadalajara;260;Sotillo (El);58;36;22
19;Guadalajara;261;Sotodosos;70;34;36
19;Guadalajara;262;Tamajón;192;93;99
19;Guadalajara;263;Taragudo;35;18;17
19;Guadalajara;264;Taravilla;71;38;33
19;Guadalajara;265;Tartanedo;215;102;113
19;Guadalajara;266;Tendilla;398;218;180
19;Guadalajara;267;Terzaga;48;27;21
19;Guadalajara;268;Tierzo;41;19;22
19;Guadalajara;269;Toba (La);131;70;61
19;Guadalajara;271;Tordellego;96;52;44
19;Guadalajara;270;Tordelrábano;18;9;9
19;Guadalajara;272;Tordesilos;169;91;78
19;Guadalajara;274;Torija;360;168;192
19;Guadalajara;279;Torre del Burgo;56;29;27
19;Guadalajara;276;Torrecilla del Ducado;"";"";""
19;Guadalajara;277;Torrecuadrada de Molina;24;14;10
19;Guadalajara;278;Torrecuadradilla;75;44;31
19;Guadalajara;280;Torrejón del Rey;740;398;342
19;Guadalajara;281;Torremocha de Jadraque;17;11;6
19;Guadalajara;282;Torremocha del Campo;374;209;165
19;Guadalajara;283;Torremocha del Pinar;78;38;40
19;Guadalajara;284;Torremochuela;10;5;5
19;Guadalajara;285;Torrubia;46;23;23
19;Guadalajara;286;Tórtola de Henares;403;205;198
19;Guadalajara;287;Tortuera;255;132;123
19;Guadalajara;288;Tortuero;43;26;17
19;Guadalajara;289;Traíd;76;36;40
19;Guadalajara;290;Trijueque;493;264;229
19;Guadalajara;291;Trillo;1542;779;763
19;Guadalajara;293;Uceda;669;332;337
19;Guadalajara;294;Ujados;43;23;20
19;Guadalajara;296;Utande;67;43;24
19;Guadalajara;297;Valdarachas;30;13;17
19;Guadalajara;298;Valdearenas;60;34;26
19;Guadalajara;299;Valdeavellano;101;51;50
19;Guadalajara;300;Valdeaveruelo;220;123;97
19;Guadalajara;301;Valdeconcha;46;23;23
19;Guadalajara;302;Valdegrudas;63;33;30
19;Guadalajara;303;Valdelcubo;73;44;29
19;Guadalajara;304;Valdenuño Fernández;140;73;67
19;Guadalajara;305;Valdepeñas de la Sierra;251;139;112
19;Guadalajara;306;Valderrebollo;39;19;20
19;Guadalajara;307;Valdesotos;47;17;30
19;Guadalajara;308;Valfermoso de Tajuña;70;37;33
19;Guadalajara;309;Valhermoso;45;25;20
19;Guadalajara;310;Valtablado del Río;18;10;8
19;Guadalajara;311;Valverde de los Arroyos;96;53;43
19;Guadalajara;314;Viana de Jadraque;67;35;32
19;Guadalajara;317;Villanueva de Alcorón;308;168;140
19;Guadalajara;318;Villanueva de Argecilla;44;24;20
19;Guadalajara;319;Villanueva de la Torre;225;111;114
19;Guadalajara;321;Villares de Jadraque;62;32;30
19;Guadalajara;322;Villaseca de Henares;67;35;32
19;Guadalajara;323;Villaseca de Uceda;64;34;30
19;Guadalajara;324;Villel de Mesa;303;148;155
19;Guadalajara;325;Viñuelas;116;63;53
19;Guadalajara;326;Yebes;62;37;25
19;Guadalajara;327;Yebra;585;295;290
19;Guadalajara;329;Yélamos de Abajo;105;51;54
19;Guadalajara;330;Yélamos de Arriba;139;74;65
19;Guadalajara;331;Yunquera de Henares;2036;1025;1011
19;Guadalajara;332;Yunta (La);186;91;95
19;Guadalajara;333;Zaorejas;203;111;92
19;Guadalajara;334;Zarzuela de Jadraque;31;18;13
19;Guadalajara;335;Zorita de los Canes;102;57;45
20;Guipúzcoa;001;Abaltzisketa;273;150;123
20;Guipúzcoa;002;Aduna;303;159;144
20;Guipúzcoa;016;Aia;1668;942;726
20;Guipúzcoa;003;Aizarnazabal;537;293;244
20;Guipúzcoa;004;Albiztur;305;160;145
20;Guipúzcoa;005;Alegia;1659;862;797
20;Guipúzcoa;006;Alkiza;267;153;114
20;Guipúzcoa;906;Altzaga;92;45;47
20;Guipúzcoa;007;Altzo;318;174;144
20;Guipúzcoa;008;Amezketa;1020;544;476
20;Guipúzcoa;009;Andoain;14873;7442;7431
20;Guipúzcoa;010;Anoeta;1801;916;885
20;Guipúzcoa;011;Antzuola;1974;1020;954
20;Guipúzcoa;012;Arama;152;73;79
20;Guipúzcoa;013;Aretxabaleta;6106;3113;2993
20;Guipúzcoa;055;Arrasate/Mondragón;24784;12421;12363
20;Guipúzcoa;014;Asteasu;1183;645;538
20;Guipúzcoa;903;Astigarraga;3158;1566;1592
20;Guipúzcoa;015;Ataun;1635;835;800
20;Guipúzcoa;017;Azkoitia;10397;5193;5204
20;Guipúzcoa;018;Azpeitia;13879;7030;6849
20;Guipúzcoa;904;Baliarrain;97;46;51
20;Guipúzcoa;019;Beasain;12412;6251;6161
20;Guipúzcoa;020;Beizama;172;97;75
20;Guipúzcoa;021;Belauntza;297;161;136
20;Guipúzcoa;022;Berastegi;956;526;430
20;Guipúzcoa;074;Bergara;15541;7755;7786
20;Guipúzcoa;023;Berrobi;584;318;266
20;Guipúzcoa;024;Bidegoyan;432;246;186
20;Guipúzcoa;029;Deba;5047;2564;2483
20;Guipúzcoa;069;Donostia/San Sebastián;178470;83849;94621
20;Guipúzcoa;030;Eibar;31119;15238;15881
20;Guipúzcoa;031;Elduain;235;125;110
20;Guipúzcoa;033;Elgeta;984;501;483
20;Guipúzcoa;032;Elgoibar;11204;5628;5576
20;Guipúzcoa;067;Errenteria;41033;20281;20752
20;Guipúzcoa;066;Errezil;653;366;287
20;Guipúzcoa;034;Eskoriatza;3932;2038;1894
20;Guipúzcoa;035;Ezkio-Itsaso;524;270;254
20;Guipúzcoa;038;Gabiria;433;236;197
20;Guipúzcoa;037;Gaintza;134;80;54
20;Guipúzcoa;907;Gaztelu;143;85;58
20;Guipúzcoa;039;Getaria;2406;1208;1198
20;Guipúzcoa;040;Hernani;18709;9314;9395
20;Guipúzcoa;041;Hernialde;292;148;144
20;Guipúzcoa;036;Hondarribia;13965;6977;6988
20;Guipúzcoa;042;Ibarra;4408;2291;2117
20;Guipúzcoa;043;Idiazabal;2047;1040;1007
20;Guipúzcoa;044;Ikaztegieta;389;203;186
20;Guipúzcoa;045;Irún;55656;27348;28308
20;Guipúzcoa;046;Irura;700;350;350
20;Guipúzcoa;047;Itsasondo;624;309;315
20;Guipúzcoa;048;Larraul;135;83;52
20;Guipúzcoa;902;Lasarte-Oria;18186;9108;9078
20;Guipúzcoa;049;Lazkao;4978;2549;2429
20;Guipúzcoa;050;Leaburu;401;216;185
20;Guipúzcoa;051;Legazpi;9518;4900;4618
20;Guipúzcoa;052;Legorreta;1447;718;729
20;Guipúzcoa;068;Leintz-Gatzaga;242;139;103
20;Guipúzcoa;053;Lezo;5557;2756;2801
20;Guipúzcoa;054;Lizartza;663;349;314
20;Guipúzcoa;901;Mendaro;1357;701;656
20;Guipúzcoa;057;Mutiloa;179;89;90
20;Guipúzcoa;056;Mutriku;4740;2364;2376
20;Guipúzcoa;063;Oiartzun;8825;4423;4402
20;Guipúzcoa;058;Olaberria;1051;539;512
20;Guipúzcoa;076;Ordizia;9325;4566;4759
20;Guipúzcoa;905;Orendain;165;94;71
20;Guipúzcoa;060;Orexa;80;42;38
20;Guipúzcoa;061;Orio;4281;2163;2118
20;Guipúzcoa;062;Ormaiztegi;1212;609;603
20;Guipúzcoa;059;Oñati;10565;5277;5288
20;Guipúzcoa;064;Pasaia;18176;8832;9344
20;Guipúzcoa;070;Segura;1290;648;642
20;Guipúzcoa;065;Soraluze/Placencia de las Armas;4556;2263;2293
20;Guipúzcoa;071;Tolosa;18091;8698;9393
20;Guipúzcoa;072;Urnieta;4982;2575;2407
20;Guipúzcoa;077;Urretxu;6166;3106;3060
20;Guipúzcoa;073;Usurbil;5311;2732;2579
20;Guipúzcoa;075;Villabona;5369;2723;2646
20;Guipúzcoa;078;Zaldibia;1571;819;752
20;Guipúzcoa;079;Zarautz;19061;9417;9644
20;Guipúzcoa;025;Zegama;1400;714;686
20;Guipúzcoa;026;Zerain;229;109;120
20;Guipúzcoa;027;Zestoa;3315;1733;1582
20;Guipúzcoa;028;Zizurkil;2692;1379;1313
20;Guipúzcoa;081;Zumaia;8278;4150;4128
20;Guipúzcoa;080;Zumarraga;10737;5405;5332
21;Huelva;001;Alájar;844;438;406
21;Huelva;002;Aljaraque;8029;4043;3986
21;Huelva;003;Almendro (El);872;462;410
21;Huelva;004;Almonaster la Real;2147;1043;1104
21;Huelva;005;Almonte;17284;8713;8571
21;Huelva;006;Alosno;5002;2415;2587
21;Huelva;007;Aracena;6774;3315;3459
21;Huelva;008;Aroche;3667;1790;1877
21;Huelva;009;Arroyomolinos de León;1209;620;589
21;Huelva;010;Ayamonte;16059;7883;8176
21;Huelva;011;Beas;4106;2037;2069
21;Huelva;012;Berrocal;414;211;203
21;Huelva;013;Bollullos Par del Condado;12921;6395;6526
21;Huelva;014;Bonares;5042;2546;2496
21;Huelva;015;Cabezas Rubias;978;494;484
21;Huelva;016;Cala;1534;784;750
21;Huelva;017;Calañas;5017;2481;2536
21;Huelva;018;Campillo (El);2620;1269;1351
21;Huelva;019;Campofrío;880;446;434
21;Huelva;020;Cañaveral de León;572;272;300
21;Huelva;021;Cartaya;11151;5521;5630
21;Huelva;022;Castaño del Robledo;215;107;108
21;Huelva;023;Cerro de Andévalo (El);2885;1415;1470
21;Huelva;030;Chucena;1955;1001;954
21;Huelva;024;Corteconcepción;688;354;334
21;Huelva;025;Cortegana;5346;2642;2704
21;Huelva;026;Cortelazor;331;166;165
21;Huelva;027;Cumbres de Enmedio;56;30;26
21;Huelva;028;Cumbres de San Bartolomé;613;312;301
21;Huelva;029;Cumbres Mayores;2263;1109;1154
21;Huelva;031;Encinasola;1970;979;991
21;Huelva;032;Escacena del Campo;2265;1114;1151
21;Huelva;033;Fuenteheridos;701;355;346
21;Huelva;034;Galaroza;1632;800;832
21;Huelva;035;Gibraleón;10283;5151;5132
21;Huelva;036;Granada de Río-Tinto (La);230;121;109
21;Huelva;037;Granado (El);698;374;324
21;Huelva;038;Higuera de la Sierra;1261;637;624
21;Huelva;039;Hinojales;464;229;235
21;Huelva;040;Hinojos;3468;1760;1708
21;Huelva;041;Huelva;145712;70825;74887
21;Huelva;042;Isla Cristina;18109;9026;9083
21;Huelva;043;Jabugo;2620;1308;1312
21;Huelva;044;Lepe;17867;9052;8815
21;Huelva;045;Linares de la Sierra;307;149;158
21;Huelva;046;Lucena del Puerto;2122;1087;1035
21;Huelva;047;Manzanilla;2586;1280;1306
21;Huelva;048;Marines (Los);348;171;177
21;Huelva;049;Minas de Riotinto;5317;2542;2775
21;Huelva;050;Moguer;13173;6713;6460
21;Huelva;051;Nava (La);347;177;170
21;Huelva;052;Nerva;6957;3373;3584
21;Huelva;053;Niebla;3923;1995;1928
21;Huelva;054;Palma del Condado (La);9639;4772;4867
21;Huelva;055;Palos de la Frontera;6907;3516;3391
21;Huelva;056;Paterna del Campo;3901;2016;1885
21;Huelva;057;Paymogo;1365;665;700
21;Huelva;058;Puebla de Guzmán;3317;1657;1660
21;Huelva;059;Puerto Moral;237;116;121
21;Huelva;060;Punta Umbría;11170;5671;5499
21;Huelva;061;Rociana del Condado;6333;3233;3100
21;Huelva;062;Rosal de la Frontera;1929;938;991
21;Huelva;063;San Bartolomé de la Torre;2925;1476;1449
21;Huelva;064;San Juan del Puerto;5775;2911;2864
21;Huelva;066;San Silvestre de Guzmán;681;337;344
21;Huelva;065;Sanlúcar de Guadiana;405;200;205
21;Huelva;067;Santa Ana la Real;509;237;272
21;Huelva;068;Santa Bárbara de Casa;1416;708;708
21;Huelva;069;Santa Olalla del Cala;2337;1196;1141
21;Huelva;070;Trigueros;7165;3599;3566
21;Huelva;071;Valdelarco;278;136;142
21;Huelva;072;Valverde del Camino;12509;6037;6472
21;Huelva;073;Villablanca;2052;1059;993
21;Huelva;074;Villalba del Alcor;3677;1818;1859
21;Huelva;075;Villanueva de las Cruces;405;192;213
21;Huelva;076;Villanueva de los Castillejos;2675;1295;1380
21;Huelva;077;Villarrasa;2181;1116;1065
21;Huelva;078;Zalamea la Real;3766;1854;1912
21;Huelva;079;Zufre;1286;665;621
22;Huesca;001;Abiego;298;147;151
22;Huesca;002;Abizanda;128;69;59
22;Huesca;003;Adahuesca;172;86;86
22;Huesca;004;Agüero;169;90;79
22;Huesca;907;Aínsa-Sobrarbe;1526;807;719
22;Huesca;006;Aisa;370;201;169
22;Huesca;007;Albalate de Cinca;1143;597;546
22;Huesca;008;Albalatillo;271;137;134
22;Huesca;009;Albelda;1016;525;491
22;Huesca;011;Albero Alto;100;56;44
22;Huesca;012;Albero Bajo;109;61;48
22;Huesca;013;Alberuela de Tubo;431;226;205
22;Huesca;014;Alcalá de Gurrea;378;190;188
22;Huesca;015;Alcalá del Obispo;355;171;184
22;Huesca;016;Alcampell;1011;504;507
22;Huesca;017;Alcolea de Cinca;1228;620;608
22;Huesca;018;Alcubierre;493;258;235
22;Huesca;019;Alerre;161;84;77
22;Huesca;020;Alfántega;136;68;68
22;Huesca;021;Almudévar;2462;1278;1184
22;Huesca;022;Almunia de San Juan;745;373;372
22;Huesca;023;Almuniente;659;333;326
22;Huesca;024;Alquézar;302;155;147
22;Huesca;025;Altorricón;1468;759;709
22;Huesca;027;Angüés;458;249;209
22;Huesca;028;Ansó;502;251;251
22;Huesca;029;Antillón;172;86;86
22;Huesca;032;Aragüés del Puerto;128;78;50
22;Huesca;035;Arén;451;245;206
22;Huesca;036;Argavieso;120;67;53
22;Huesca;037;Arguis;63;36;27
22;Huesca;039;Ayerbe;1158;594;564
22;Huesca;040;Azanuy-Alins;215;103;112
22;Huesca;041;Azara;223;110;113
22;Huesca;042;Azlor;185;96;89
22;Huesca;043;Baélls;164;85;79
22;Huesca;044;Bailo;339;193;146
22;Huesca;045;Baldellou;168;88;80
22;Huesca;046;Ballobar;1118;573;545
22;Huesca;047;Banastás;166;84;82
22;Huesca;048;Barbastro;15380;7565;7815
22;Huesca;049;Barbués;121;62;59
22;Huesca;050;Barbuñales;116;57;59
22;Huesca;051;Bárcabo;127;66;61
22;Huesca;052;Belver de Cinca;1435;747;688
22;Huesca;053;Benabarre;1234;637;597
22;Huesca;054;Benasque;1252;642;610
22;Huesca;055;Berbegal;505;254;251
22;Huesca;057;Bielsa;464;240;224
22;Huesca;058;Bierge;221;131;90
22;Huesca;059;Biescas;1231;643;588
22;Huesca;060;Binaced;1631;825;806
22;Huesca;061;Binéfar;8035;4016;4019
22;Huesca;062;Bisaurri;234;136;98
22;Huesca;063;Biscarrués;263;140;123
22;Huesca;064;Blecua y Torres;195;101;94
22;Huesca;066;Boltaña;852;440;412
22;Huesca;067;Bonansa;76;39;37
22;Huesca;068;Borau;79;40;39
22;Huesca;069;Broto;510;257;253
22;Huesca;072;Caldearenas;259;143;116
22;Huesca;074;Campo;388;187;201
22;Huesca;075;Camporrélls;255;115;140
22;Huesca;076;Canal de Berdún;462;241;221
22;Huesca;077;Candasnos;597;305;292
22;Huesca;078;Canfranc;499;269;230
22;Huesca;079;Capdesaso;201;95;106
22;Huesca;080;Capella;411;211;200
22;Huesca;081;Casbas de Huesca;342;177;165
22;Huesca;083;Castejón de Monegros;760;377;383
22;Huesca;084;Castejón de Sos;486;257;229
22;Huesca;082;Castejón del Puente;457;227;230
22;Huesca;085;Castelflorite;160;84;76
22;Huesca;086;Castiello de Jaca;174;83;91
22;Huesca;087;Castigaleu;105;59;46
22;Huesca;088;Castillazuelo;251;121;130
22;Huesca;089;Castillonroy;440;217;223
22;Huesca;094;Chalamera;174;92;82
22;Huesca;095;Chía;127;71;56
22;Huesca;096;Chimillas;163;90;73
22;Huesca;090;Colungo;133;72;61
22;Huesca;099;Esplús;874;412;462
22;Huesca;102;Estada;194;97;97
22;Huesca;103;Estadilla;984;501;483
22;Huesca;105;Estopiñán del Castillo;192;96;96
22;Huesca;106;Fago;45;30;15
22;Huesca;107;Fanlo;96;59;37
22;Huesca;109;Fiscal;250;134;116
22;Huesca;110;Fonz;1196;609;587
22;Huesca;111;Foradada del Toscar;278;133;145
22;Huesca;112;Fraga;11967;6045;5922
22;Huesca;113;Fueva (La);628;337;291
22;Huesca;114;Gistaín;199;115;84
22;Huesca;115;Grado (El);597;313;284
22;Huesca;116;Grañén;2104;1066;1038
22;Huesca;117;Graus;3333;1700;1633
22;Huesca;119;Gurrea de Gállego;1944;973;971
22;Huesca;122;Hoz de Jaca;83;35;48
22;Huesca;908;Hoz y Costean;272;139;133
22;Huesca;124;Huerto;291;154;137
22;Huesca;125;Huesca;45607;22096;23511
22;Huesca;126;Ibieca;111;59;52
22;Huesca;127;Igriés;148;83;65
22;Huesca;128;Ilche;305;156;149
22;Huesca;129;Isábena;278;146;132
22;Huesca;130;Jaca;11438;5671;5767
22;Huesca;131;Jasa;118;66;52
22;Huesca;133;Labuerda;167;87;80
22;Huesca;135;Laluenga;279;149;130
22;Huesca;136;Lalueza;1346;733;613
22;Huesca;137;Lanaja;1729;892;837
22;Huesca;139;Laperdiguera;109;57;52
22;Huesca;141;Lascellas-Ponzano;166;82;84
22;Huesca;142;Lascuarre;170;88;82
22;Huesca;143;Laspaúles;302;171;131
22;Huesca;144;Laspuña;289;160;129
22;Huesca;149;Loarre;407;219;188
22;Huesca;150;Loporzano;573;292;281
22;Huesca;151;Loscorrales;132;71;61
22;Huesca;905;Lupiñén-Ortilla;359;194;165
22;Huesca;155;Monesma y Cajigar;109;55;54
22;Huesca;156;Monflorite-Lascasas;198;111;87
22;Huesca;157;Montanuy;331;188;143
22;Huesca;158;Monzón;14757;7470;7287
22;Huesca;160;Naval;301;152;149
22;Huesca;162;Novales;182;86;96
22;Huesca;163;Nueno;228;123;105
22;Huesca;164;Olvena;56;27;29
22;Huesca;165;Ontiñena;705;354;351
22;Huesca;167;Osso de Cinca;768;411;357
22;Huesca;168;Palo;32;18;14
22;Huesca;170;Panticosa;635;327;308
22;Huesca;172;Peñalba;810;404;406
22;Huesca;173;Peñas de Riglos (Las);303;170;133
22;Huesca;174;Peralta de Alcofea;760;375;385
22;Huesca;175;Peralta de Calasanz;327;182;145
22;Huesca;176;Peraltilla;164;86;78
22;Huesca;177;Perarrúa;156;73;83
22;Huesca;178;Pertusa;153;76;77
22;Huesca;181;Piracés;102;63;39
22;Huesca;182;Plan;310;174;136
22;Huesca;184;Poleñino;264;135;129
22;Huesca;186;Pozán de Vero;266;131;135
22;Huesca;187;Puebla de Castro (La);310;164;146
22;Huesca;188;Puente de Montañana;147;74;73
22;Huesca;902;Puente la Reina de Jaca;286;143;143
22;Huesca;189;Puértolas;198;121;77
22;Huesca;190;Pueyo de Araguás (El);176;109;67
22;Huesca;193;Pueyo de Santa Cruz;387;207;180
22;Huesca;195;Quicena;135;66;69
22;Huesca;197;Robres;706;366;340
22;Huesca;199;Sabiñánigo;8923;4581;4342
22;Huesca;200;Sahún;325;173;152
22;Huesca;201;Salas Altas;414;210;204
22;Huesca;202;Salas Bajas;203;97;106
22;Huesca;203;Salillas;127;65;62
22;Huesca;204;Sallent de Gállego;987;508;479
22;Huesca;205;San Esteban de Litera;693;351;342
22;Huesca;207;San Juan de Plan;171;96;75
22;Huesca;903;San Miguel del Cinca;964;496;468
22;Huesca;206;Sangarrén;310;152;158
22;Huesca;208;Santa Cilia;207;110;97
22;Huesca;209;Santa Cruz de la Serós;171;102;69
22;Huesca;906;Santa María de Dulcis;223;108;115
22;Huesca;212;Santaliestra y San Quílez;103;54;49
22;Huesca;213;Sariñena;4136;2078;2058
22;Huesca;214;Secastilla;180;81;99
22;Huesca;215;Seira;208;103;105
22;Huesca;217;Sena;628;327;301
22;Huesca;218;Senés de Alcubierre;61;30;31
22;Huesca;220;Sesa;287;146;141
22;Huesca;221;Sesué;103;57;46
22;Huesca;222;Siétamo;355;196;159
22;Huesca;223;Sopeira;134;71;63
22;Huesca;904;Sotonera (La);1201;624;577
22;Huesca;225;Tamarite de Litera;3961;1957;2004
22;Huesca;226;Tardienta;1140;585;555
22;Huesca;227;Tella-Sin;300;154;146
22;Huesca;228;Tierz;184;96;88
22;Huesca;229;Tolva;235;130;105
22;Huesca;230;Torla;371;199;172
22;Huesca;232;Torralba de Aragón;147;69;78
22;Huesca;233;Torre la Ribera;110;61;49
22;Huesca;234;Torrente de Cinca;1165;585;580
22;Huesca;235;Torres de Alcanadre;147;86;61
22;Huesca;236;Torres de Barbués;387;199;188
22;Huesca;239;Tramaced;122;70;52
22;Huesca;242;Valfarta;110;58;52
22;Huesca;243;Valle de Bardají;46;23;23
22;Huesca;901;Valle de Hecho;1045;556;489
22;Huesca;244;Valle de Lierp;63;30;33
22;Huesca;245;Velilla de Cinca;520;258;262
22;Huesca;909;Vencillón;509;267;242
22;Huesca;246;Veracruz;119;66;53
22;Huesca;247;Viacamp y Litera;32;20;12
22;Huesca;248;Vicién;127;69;58
22;Huesca;249;Villanova;106;56;50
22;Huesca;250;Villanúa;334;177;157
22;Huesca;251;Villanueva de Sigena;498;252;246
22;Huesca;252;Yebra de Basa;164;100;64
22;Huesca;253;Yésero;66;32;34
22;Huesca;254;Zaidín;1766;901;865
23;Jaén;001;Albanchez de Mágina;1616;804;812
23;Jaén;002;Alcalá la Real;21578;10747;10831
23;Jaén;003;Alcaudete;11747;5837;5910
23;Jaén;004;Aldeaquemada;603;307;296
23;Jaén;005;Andújar;38828;19202;19626
23;Jaén;006;Arjona;5691;2843;2848
23;Jaén;007;Arjonilla;4094;2059;2035
23;Jaén;008;Arquillos;1860;946;914
23;Jaén;009;Baeza;15900;7802;8098
23;Jaén;010;Bailén;17760;8961;8799
23;Jaén;011;Baños de la Encina;2769;1408;1361
23;Jaén;012;Beas de Segura;8572;4299;4273
23;Jaén;902;Bedmar y Garcíez;3494;1742;1752
23;Jaén;014;Begíjar;3174;1592;1582
23;Jaén;015;Bélmez de la Moraleda;2069;1027;1042
23;Jaén;016;Benatae;609;304;305
23;Jaén;017;Cabra del Santo Cristo;2388;1224;1164
23;Jaén;018;Cambil;3506;1855;1651
23;Jaén;019;Campillo de Arenas;2327;1164;1163
23;Jaén;020;Canena;2117;1027;1090
23;Jaén;021;Carboneros;699;344;355
23;Jaén;901;Cárcheles;1621;799;822
23;Jaén;024;Carolina (La);15263;7505;7758
23;Jaén;025;Castellar;3787;1914;1873
23;Jaén;026;Castillo de Locubín;5802;2894;2908
23;Jaén;027;Cazalilla;861;433;428
23;Jaén;028;Cazorla;9170;4509;4661
23;Jaén;029;Chiclana de Segura;1628;821;807
23;Jaén;030;Chilluévar;1906;951;955
23;Jaén;031;Escañuela;1034;512;522
23;Jaén;032;Espelúy;802;394;408
23;Jaén;033;Frailes;1967;989;978
23;Jaén;034;Fuensanta de Martos;3472;1683;1789
23;Jaén;035;Fuerte del Rey;1164;579;585
23;Jaén;037;Génave;772;391;381
23;Jaén;038;Guardia de Jaén (La);1951;1015;936
23;Jaén;039;Guarromán;2956;1443;1513
23;Jaén;041;Higuera de Calatrava;748;387;361
23;Jaén;042;Hinojares;580;286;294
23;Jaén;043;Hornos;782;382;400
23;Jaén;044;Huelma;6135;3082;3053
23;Jaén;045;Huesa;2849;1449;1400
23;Jaén;046;Ibros;3225;1616;1609
23;Jaén;047;Iruela (La);2169;1107;1062
23;Jaén;048;Iznatoraf;1269;614;655
23;Jaén;049;Jabalquinto;2745;1357;1388
23;Jaén;050;Jaén;113141;54774;58367
23;Jaén;051;Jamilena;3244;1652;1592
23;Jaén;052;Jimena;1675;814;861
23;Jaén;053;Jódar;12591;6277;6314
23;Jaén;040;Lahiguera;1964;957;1007
23;Jaén;054;Larva;573;294;279
23;Jaén;055;Linares;61712;30152;31560
23;Jaén;056;Lopera;4070;2026;2044
23;Jaén;057;Lupión;1111;517;594
23;Jaén;058;Mancha Real;8929;4451;4478
23;Jaén;059;Marmolejo;7699;3856;3843
23;Jaén;060;Martos;22424;11076;11348
23;Jaén;061;Mengíbar;8659;4364;4295
23;Jaén;062;Montizón;2070;1031;1039
23;Jaén;063;Navas de San Juan;5592;2792;2800
23;Jaén;064;Noalejo;2416;1213;1203
23;Jaén;065;Orcera;2434;1234;1200
23;Jaén;066;Peal de Becerro;5453;2728;2725
23;Jaén;067;Pegalajar;3152;1551;1601
23;Jaén;069;Porcuna;7114;3564;3550
23;Jaén;070;Pozo Alcón;6401;3240;3161
23;Jaén;071;Puente de Génave;2100;1063;1037
23;Jaén;072;Puerta de Segura (La);2850;1429;1421
23;Jaén;073;Quesada;6509;3176;3333
23;Jaén;074;Rus;3826;1916;1910
23;Jaén;075;Sabiote;4333;2106;2227
23;Jaén;076;Santa Elena;1096;580;516
23;Jaén;077;Santiago de Calatrava;1007;510;497
23;Jaén;904;Santiago-Pontones;5013;2566;2447
23;Jaén;079;Santisteban del Puerto;5040;2574;2466
23;Jaén;080;Santo Tomé;2652;1340;1312
23;Jaén;081;Segura de la Sierra;2328;1170;1158
23;Jaén;082;Siles;2858;1442;1416
23;Jaén;084;Sorihuela del Guadalimar;1365;676;689
23;Jaén;086;Torre del Campo;12332;6097;6235
23;Jaén;085;Torreblascopedro;3079;1534;1545
23;Jaén;087;Torredonjimeno;13938;6840;7098
23;Jaén;088;Torreperogil;7964;3914;4050
23;Jaén;090;Torres;1992;1001;991
23;Jaén;091;Torres de Albánchez;1128;560;568
23;Jaén;092;Úbeda;31819;15658;16161
23;Jaén;093;Valdepeñas de Jaén;4656;2321;2335
23;Jaén;094;Vilches;5197;2600;2597
23;Jaén;095;Villacarrillo;12032;5975;6057
23;Jaén;096;Villanueva de la Reina;3321;1649;1672
23;Jaén;097;Villanueva del Arzobispo;8896;4371;4525
23;Jaén;098;Villardompardo;1305;637;668
23;Jaén;099;Villares (Los);4773;2370;2403
23;Jaén;101;Villarrodrigo;670;326;344
23;Jaén;903;Villatorres;4205;2094;2111
24;León;001;Acebedo;400;205;195
24;León;002;Algadefe;405;205;200
24;León;003;Alija del Infantado;1093;551;542
24;León;004;Almanza;853;441;412
24;León;005;Antigua (La);719;379;340
24;León;006;Ardón;763;392;371
24;León;007;Arganza;1136;550;586
24;León;008;Astorga;12787;6095;6692
24;León;009;Balboa;573;302;271
24;León;010;Bañeza (La);10537;5163;5374
24;León;011;Barjas;646;345;301
24;León;012;Barrios de Luna (Los);388;190;198
24;León;014;Bembibre;11650;5783;5867
24;León;015;Benavides;3254;1669;1585
24;León;016;Benuza;837;431;406
24;León;017;Bercianos del Páramo;934;465;469
24;León;018;Bercianos del Real Camino;260;126;134
24;León;019;Berlanga del Bierzo;471;227;244
24;León;020;Boca de Huérgano;715;393;322
24;León;021;Boñar;2816;1389;1427
24;León;022;Borrenes;585;299;286
24;León;023;Brazuelo;389;188;201
24;León;024;Burgo Ranero (El);1095;579;516
24;León;025;Burón;535;274;261
24;León;026;Bustillo del Páramo;2112;1053;1059
24;León;027;Cabañas Raras;1395;724;671
24;León;028;Cabreros del Río;678;355;323
24;León;029;Cabrillanes;1302;630;672
24;León;030;Cacabelos;5075;2577;2498
24;León;031;Calzada del Coto;332;187;145
24;León;032;Campazas;205;99;106
24;León;033;Campo de Villavidel;389;204;185
24;León;034;Camponaraya;3200;1546;1654
24;León;036;Candín;546;299;247
24;León;037;Cármenes;494;245;249
24;León;038;Carracedelo;3505;1749;1756
24;León;039;Carrizo;2880;1451;1429
24;León;040;Carrocera;619;293;326
24;León;041;Carucedo;683;319;364
24;León;042;Castilfalé;117;64;53
24;León;043;Castrillo de Cabrera;288;135;153
24;León;044;Castrillo de la Valduerna;296;129;167
24;León;046;Castrocalbón;1465;739;726
24;León;047;Castrocontrigo;1392;694;698
24;León;049;Castropodame;1925;972;953
24;León;050;Castrotierra de Valmadrigal;173;90;83
24;León;051;Cea;849;445;404
24;León;052;Cebanico;301;160;141
24;León;053;Cebrones del Río;786;399;387
24;León;065;Chozas de Abajo;2247;1164;1083
24;León;054;Cimanes de la Vega;762;375;387
24;León;055;Cimanes del Tejar;1189;590;599
24;León;056;Cistierna;4847;2438;2409
24;León;057;Congosto;1906;936;970
24;León;058;Corbillos de los Oteros;353;174;179
24;León;059;Corullón;1486;738;748
24;León;060;Crémenes;1603;773;830
24;León;061;Cuadros;1740;830;910
24;León;062;Cubillas de los Oteros;243;119;124
24;León;063;Cubillas de Rueda;723;365;358
24;León;064;Cubillos del Sil;1578;817;761
24;León;066;Destriana;1065;517;548
24;León;067;Encinedo;1098;572;526
24;León;068;Ercina (La);872;422;450
24;León;069;Escobar de Campos;96;55;41
24;León;070;Fabero;6419;3217;3202
24;León;071;Folgoso de la Ribera;1539;764;775
24;León;072;Fresnedo;"";"";""
24;León;073;Fresno de la Vega;776;386;390
24;León;074;Fuentes de Carbajal;161;80;81
24;León;076;Garrafe de Torío;1175;588;587
24;León;077;Gordaliza del Pino;426;216;210
24;León;078;Gordoncillo;697;337;360
24;León;079;Gradefes;1562;766;796
24;León;080;Grajal de Campos;326;131;195
24;León;081;Gusendos de los Oteros;262;131;131
24;León;082;Hospital de Órbigo;1217;596;621
24;León;083;Igüeña;2294;1211;1083
24;León;084;Izagre;326;157;169
24;León;086;Joarilla de las Matas;505;263;242
24;León;087;Laguna Dalga;1058;524;534
24;León;088;Laguna de Negrillos;1699;862;837
24;León;089;León;147780;69772;78008
24;León;092;Llamas de la Ribera;1353;683;670
24;León;090;Lucillo;578;289;289
24;León;091;Luyego;1040;498;542
24;León;093;Magaz de Cepeda;637;300;337
24;León;094;Mansilla de las Mulas;1777;886;891
24;León;095;Mansilla Mayor;445;228;217
24;León;096;Maraña;197;99;98
24;León;097;Matadeón de los Oteros;366;185;181
24;León;098;Matallana de Torío;1958;968;990
24;León;099;Matanza;384;185;199
24;León;100;Molinaseca;785;404;381
24;León;101;Murias de Paredes;824;386;438
24;León;102;Noceda del Bierzo;1001;496;505
24;León;103;Oencia;567;302;265
24;León;104;Omañas (Las);509;253;256
24;León;105;Onzonilla;1466;723;743
24;León;106;Oseja de Sajambre;398;226;172
24;León;107;Pajares de los Oteros;450;232;218
24;León;108;Palacios de la Valduerna;634;312;322
24;León;109;Palacios del Sil;1674;838;836
24;León;110;Páramo del Sil;2202;1123;1079
24;León;111;Pedrosa del Rey;"";"";""
24;León;112;Peranzanes;389;202;187
24;León;113;Pobladura de Pelayo García;668;344;324
24;León;114;Pola de Gordón (La);5696;2769;2927
24;León;115;Ponferrada;61829;30242;31587
24;León;116;Posada de Valdeón;537;285;252
24;León;117;Pozuelo del Páramo;729;379;350
24;León;118;Prado de la Guzpeña;189;101;88
24;León;119;Priaranza del Bierzo;1067;549;518
24;León;120;Prioro;552;287;265
24;León;121;Puebla de Lillo;757;407;350
24;León;122;Puente de Domingo Flórez;2063;1091;972
24;León;123;Quintana del Castillo;1315;687;628
24;León;124;Quintana del Marco;639;323;316
24;León;125;Quintana y Congosto;961;497;464
24;León;127;Regueras de Arriba;459;237;222
24;León;129;Reyero;184;101;83
24;León;130;Riaño;588;318;270
24;León;131;Riego de la Vega;1240;603;637
24;León;132;Riello;1263;637;626
24;León;133;Rioseco de Tapia;627;331;296
24;León;134;Robla (La);5554;2802;2752
24;León;136;Roperuelos del Páramo;920;470;450
24;León;137;Sabero;2272;1137;1135
24;León;139;Sahagún;3349;1675;1674
24;León;141;San Adrián del Valle;224;101;123
24;León;142;San Andrés del Rabanedo;22134;10861;11273
24;León;144;San Cristóbal de la Polantera;1218;605;613
24;León;145;San Emiliano;1038;511;527
24;León;146;San Esteban de Nogales;540;251;289
24;León;148;San Justo de la Vega;2397;1206;1191
24;León;149;San Millán de los Caballeros;216;106;110
24;León;150;San Pedro Bercianos;425;204;221
24;León;143;Sancedo;691;343;348
24;León;151;Santa Colomba de Curueño;779;367;412
24;León;152;Santa Colomba de Somoza;506;256;250
24;León;153;Santa Cristina de Valmadrigal;441;218;223
24;León;154;Santa Elena de Jamuz;1573;795;778
24;León;155;Santa María de la Isla;799;417;382
24;León;158;Santa María de Ordás;519;264;255
24;León;156;Santa María del Monte de Cea;465;228;237
24;León;157;Santa María del Páramo;3219;1554;1665
24;León;159;Santa Marina del Rey;2752;1381;1371
24;León;160;Santas Martas;1158;598;560
24;León;161;Santiago Millas;423;213;210
24;León;162;Santovenia de la Valdoncina;1403;685;718
24;León;163;Sariegos;1863;933;930
24;León;164;Sena de Luna;594;294;300
24;León;165;Sobrado;616;310;306
24;León;166;Soto de la Vega;2144;1086;1058
24;León;167;Soto y Amío;1287;637;650
24;León;168;Toral de los Guzmanes;776;393;383
24;León;169;Toreno;4995;2611;2384
24;León;170;Torre del Bierzo;3632;1826;1806
24;León;171;Trabadelo;715;379;336
24;León;172;Truchas;1136;570;566
24;León;173;Turcia;1550;783;767
24;León;174;Urdiales del Páramo;850;427;423
24;León;185;Val de San Lorenzo;844;411;433
24;León;175;Valdefresno;1660;835;825
24;León;176;Valdefuentes del Páramo;523;268;255
24;León;177;Valdelugueros;473;247;226
24;León;178;Valdemora;131;66;65
24;León;179;Valdepiélago;475;235;240
24;León;180;Valdepolo;1783;925;858
24;León;181;Valderas;2367;1204;1163
24;León;182;Valderrey;730;357;373
24;León;183;Valderrueda;1522;747;775
24;León;184;Valdesamario;348;170;178
24;León;187;Valdevimbre;1342;678;664
24;León;188;Valencia de Don Juan;3852;1912;1940
24;León;191;Vallecillo;209;110;99
24;León;189;Valverde de la Virgen;3901;1928;1973
24;León;190;Valverde-Enrique;270;135;135
24;León;193;Vecilla (La);464;235;229
24;León;196;Vega de Espinareda;3222;1635;1587
24;León;197;Vega de Infanzones;909;448;461
24;León;198;Vega de Valcarce;1110;569;541
24;León;194;Vegacervera;416;215;201
24;León;199;Vegaquemada;645;304;341
24;León;201;Vegas del Condado;1602;808;794
24;León;202;Villablino;15978;8042;7936
24;León;203;Villabraz;187;97;90
24;León;205;Villadangos del Páramo;1034;508;526
24;León;206;Villadecanes;2497;1268;1229
24;León;207;Villademor de la Vega;530;275;255
24;León;209;Villafranca del Bierzo;4262;2140;2122
24;León;210;Villagatón;1010;519;491
24;León;211;Villamandos;515;250;265
24;León;901;Villamanín;1486;736;750
24;León;212;Villamañán;1628;825;803
24;León;213;Villamartín de Don Sancho;243;125;118
24;León;214;Villamejil;1082;543;539
24;León;215;Villamol;280;143;137
24;León;216;Villamontán de la Valduerna;1243;628;615
24;León;217;Villamoratiel de las Matas;222;126;96
24;León;218;Villanueva de las Manzanas;695;332;363
24;León;219;Villaobispo de Otero;800;404;396
24;León;902;Villaornate y Castro;602;313;289
24;León;221;Villaquejida;1124;583;541
24;León;222;Villaquilambre;6494;3247;3247
24;León;223;Villarejo de Órbigo;3696;1809;1887
24;León;224;Villares de Órbigo;1044;531;513
24;León;225;Villasabariego;1273;636;637
24;León;226;Villaselán;369;199;170
24;León;227;Villaturiel;1786;905;881
24;León;228;Villazala;1203;621;582
24;León;229;Villazanzo de Valderaduey;792;420;372
24;León;230;Zotes del Páramo;785;402;383
25;Lleida;001;Abella de la Conca;164;90;74
25;Lleida;002;Àger;590;315;275
25;Lleida;003;Agramunt;4893;2443;2450
25;Lleida;038;Aitona;2372;1251;1121
25;Lleida;004;Alamús (Els);670;344;326
25;Lleida;005;Alàs i Cerc;388;210;178
25;Lleida;006;Albagés (L');543;277;266
25;Lleida;007;Albatàrrec;1013;483;530
25;Lleida;008;Albesa;1481;738;743
25;Lleida;009;Albi (L');777;400;377
25;Lleida;010;Alcanó;271;134;137
25;Lleida;011;Alcarràs;4633;2296;2337
25;Lleida;012;Alcoletge;1610;813;797
25;Lleida;013;Alfarràs;3062;1501;1561
25;Lleida;014;Alfés;353;191;162
25;Lleida;015;Algerri;538;266;272
25;Lleida;016;Alguaire;2898;1456;1442
25;Lleida;017;Alins;303;157;146
25;Lleida;019;Almacelles;5496;2799;2697
25;Lleida;020;Almatret;521;276;245
25;Lleida;021;Almenar;3607;1834;1773
25;Lleida;022;Alòs de Balaguer;173;102;71
25;Lleida;023;Alpicat;3101;1561;1540
25;Lleida;024;Alt Àneu;387;216;171
25;Lleida;027;Anglesola;1230;595;635
25;Lleida;029;Arbeca;2319;1157;1162
25;Lleida;031;Arres;80;43;37
25;Lleida;032;Arsèguel;111;59;52
25;Lleida;033;Artesa de Lleida;1232;617;615
25;Lleida;034;Artesa de Segre;3125;1595;1530
25;Lleida;036;Aspa;258;128;130
25;Lleida;037;Avellanes i Santa Linya (Les);465;251;214
25;Lleida;039;Baix Pallars;373;208;165
25;Lleida;040;Balaguer;13373;6615;6758
25;Lleida;041;Barbens;794;409;385
25;Lleida;042;Baronia de Rialb (La);260;137;123
25;Lleida;044;Bassella;361;179;182
25;Lleida;045;Bausen;68;41;27
25;Lleida;046;Belianes;564;268;296
25;Lleida;170;Bellaguarda;375;190;185
25;Lleida;047;Bellcaire d'Urgell;1417;683;734
25;Lleida;048;Bell-lloc d'Urgell;2181;1085;1096
25;Lleida;049;Bellmunt d'Urgell;237;122;115
25;Lleida;050;Bellpuig;4010;1979;2031
25;Lleida;051;Bellver de Cerdanya;1610;845;765
25;Lleida;052;Bellvís;2210;1092;1118
25;Lleida;053;Benavent de Segrià;756;389;367
25;Lleida;055;Biosca;269;133;136
25;Lleida;057;Bòrdes (Es);217;113;104
25;Lleida;058;Borges Blanques (Les);5193;2576;2617
25;Lleida;059;Bossòst;823;399;424
25;Lleida;056;Bovera;429;216;213
25;Lleida;060;Cabanabona;103;48;55
25;Lleida;061;Cabó;137;74;63
25;Lleida;062;Camarasa;920;468;452
25;Lleida;063;Canejan;110;59;51
25;Lleida;904;Castell de Mur;155;81;74
25;Lleida;064;Castellar de la Ribera;149;70;79
25;Lleida;067;Castelldans;973;505;468
25;Lleida;068;Castellnou de Seana;714;343;371
25;Lleida;069;Castelló de Farfanya;608;302;306
25;Lleida;070;Castellserà;1158;571;587
25;Lleida;071;Cava;51;31;20
25;Lleida;072;Cervera;7418;3689;3729
25;Lleida;073;Cervià de les Garrigues;873;448;425
25;Lleida;074;Ciutadilla;222;114;108
25;Lleida;075;Clariana de Cardener;148;76;72
25;Lleida;076;Cogul (El);232;115;117
25;Lleida;077;Coll de Nargó;626;328;298
25;Lleida;163;Coma i la Pedra (La);246;146;100
25;Lleida;161;Conca de Dalt;466;240;226
25;Lleida;078;Corbins;1031;527;504
25;Lleida;079;Cubells;368;184;184
25;Lleida;081;Espluga Calba (L');435;230;205
25;Lleida;082;Espot;247;125;122
25;Lleida;088;Estamariu;134;70;64
25;Lleida;085;Estaràs;174;91;83
25;Lleida;086;Esterri d'Àneu;517;253;264
25;Lleida;087;Esterri de Cardós;75;39;36
25;Lleida;089;Farrera;92;49;43
25;Lleida;908;Fígols i Alinyà;338;183;155
25;Lleida;092;Floresta (La);195;98;97
25;Lleida;093;Fondarella;659;318;341
25;Lleida;094;Foradada;183;104;79
25;Lleida;096;Fuliola (La);1307;661;646
25;Lleida;097;Fulleda;131;70;61
25;Lleida;098;Gavet de la Conca;353;175;178
25;Lleida;912;Gimenells i el Pla de la Font;1191;635;556
25;Lleida;099;Golmés;1328;647;681
25;Lleida;100;Gósol;200;104;96
25;Lleida;101;Granadella (La);864;431;433
25;Lleida;102;Granja d'Escarp (La);1145;586;559
25;Lleida;103;Granyanella;140;71;69
25;Lleida;105;Granyena de les Garrigues;194;97;97
25;Lleida;104;Granyena de Segarra;179;90;89
25;Lleida;109;Guimerà;397;197;200
25;Lleida;903;Guingueta d'Àneu (La);281;144;137
25;Lleida;110;Guissona;2915;1507;1408
25;Lleida;111;Guixers;159;98;61
25;Lleida;115;Isona i Conca Dellà;1337;695;642
25;Lleida;112;Ivars de Noguera;323;165;158
25;Lleida;113;Ivars d'Urgell;1731;860;871
25;Lleida;114;Ivorra;140;76;64
25;Lleida;910;Josa i Tuixén;148;78;70
25;Lleida;118;Juncosa;584;306;278
25;Lleida;119;Juneda;3027;1536;1491
25;Lleida;121;Les;684;339;345
25;Lleida;122;Linyola;2384;1197;1187
25;Lleida;123;Lladorre;226;120;106
25;Lleida;124;Lladurs;253;141;112
25;Lleida;125;Llardecans;649;324;325
25;Lleida;126;Llavorsí;271;145;126
25;Lleida;120;Lleida;114367;55858;58509
25;Lleida;127;Lles de Cerdanya;293;160;133
25;Lleida;128;Llimiana;132;71;61
25;Lleida;129;Llobera;251;128;123
25;Lleida;133;Maials;1043;537;506
25;Lleida;130;Maldà;306;152;154
25;Lleida;131;Massalcoreig;657;318;339
25;Lleida;132;Massoteres;159;75;84
25;Lleida;134;Menàrguens;863;433;430
25;Lleida;135;Miralcamp;1254;608;646
25;Lleida;137;Mollerussa;9290;4618;4672
25;Lleida;136;Molsosa (La);135;68;67
25;Lleida;139;Montellà i Martinet;512;267;245
25;Lleida;140;Montferrer i Castellbò;702;376;326
25;Lleida;138;Montgai;839;431;408
25;Lleida;142;Montoliu de Lleida;465;223;242
25;Lleida;141;Montoliu de Segarra;210;115;95
25;Lleida;143;Montornès de Segarra;115;52;63
25;Lleida;145;Nalec;105;46;59
25;Lleida;025;Naut Aran;1330;721;609
25;Lleida;146;Navès;270;135;135
25;Lleida;148;Odèn;294;162;132
25;Lleida;149;Oliana;1923;993;930
25;Lleida;150;Oliola;200;107;93
25;Lleida;151;Olius;506;246;260
25;Lleida;152;Oluges (Les);210;110;100
25;Lleida;153;Omellons (Els);265;136;129
25;Lleida;154;Omells de na Gaia (Els);149;82;67
25;Lleida;155;Organyà;1022;523;499
25;Lleida;156;Os de Balaguer;786;412;374
25;Lleida;157;Ossó de Sió;230;113;117
25;Lleida;158;Palau d'Anglesola (El);1646;830;816
25;Lleida;164;Penelles;540;295;245
25;Lleida;165;Peramola;391;206;185
25;Lleida;166;Pinell de Solsonès;246;126;120
25;Lleida;167;Pinós;338;184;154
25;Lleida;911;Plans de Sió (Els);646;326;320
25;Lleida;168;Poal (El);639;335;304
25;Lleida;169;Pobla de Cérvoles (La);212;118;94
25;Lleida;171;Pobla de Segur (La);3076;1502;1574
25;Lleida;030;Pont de Bar (El);159;86;73
25;Lleida;173;Pont de Suert (El);2281;1155;1126
25;Lleida;172;Ponts;2317;1157;1160
25;Lleida;174;Portella (La);596;313;283
25;Lleida;175;Prats i Sansor;172;94;78
25;Lleida;176;Preixana;471;244;227
25;Lleida;177;Preixens;512;246;266
25;Lleida;179;Prullans;219;112;107
25;Lleida;180;Puiggròs;266;135;131
25;Lleida;181;Puigverd d'Agramunt;229;119;110
25;Lleida;182;Puigverd de Lleida;991;489;502
25;Lleida;183;Rialp;549;287;262
25;Lleida;905;Ribera d'Ondara;506;254;252
25;Lleida;185;Ribera d'Urgellet;790;414;376
25;Lleida;186;Riner;261;131;130
25;Lleida;913;Riu de Cerdanya;"";"";""
25;Lleida;189;Rosselló;1691;835;856
25;Lleida;190;Salàs de Pallars;363;185;178
25;Lleida;191;Sanaüja;460;232;228
25;Lleida;196;Sant Esteve de la Sarga;106;66;40
25;Lleida;192;Sant Guim de Freixenet;1080;533;547
25;Lleida;197;Sant Guim de la Plana;193;101;92
25;Lleida;193;Sant Llorenç de Morunys;871;445;426
25;Lleida;902;Sant Martí de Riucorb;764;389;375
25;Lleida;194;Sant Ramon;589;295;294
25;Lleida;201;Sarroca de Bellera;145;83;62
25;Lleida;200;Sarroca de Lleida;481;251;230
25;Lleida;202;Senterada;116;67;49
25;Lleida;035;Sentiu de Sió (La);486;234;252
25;Lleida;204;Seròs;1842;971;871
25;Lleida;203;Seu d'Urgell (La);10259;5073;5186
25;Lleida;205;Sidamon;459;236;223
25;Lleida;206;Soleràs (El);430;214;216
25;Lleida;207;Solsona;7091;3577;3514
25;Lleida;208;Soriguera;302;158;144
25;Lleida;209;Sort;1625;812;813
25;Lleida;210;Soses;1522;785;737
25;Lleida;211;Sudanell;728;389;339
25;Lleida;212;Sunyer;319;154;165
25;Lleida;215;Talarn;326;164;162
25;Lleida;216;Talavera;304;159;145
25;Lleida;217;Tàrrega;11656;5675;5981
25;Lleida;218;Tarrés;110;59;51
25;Lleida;219;Tarroja de Segarra;182;92;90
25;Lleida;220;Térmens;1436;728;708
25;Lleida;221;Tírvia;118;65;53
25;Lleida;222;Tiurana;188;103;85
25;Lleida;223;Torà;1142;586;556
25;Lleida;224;Torms (Els);206;113;93
25;Lleida;225;Tornabous;837;425;412
25;Lleida;227;Torre de Cabdella (La);732;356;376
25;Lleida;226;Torrebesses;351;175;176
25;Lleida;228;Torrefarrera;1553;799;754
25;Lleida;907;Torrefeta i Florejacs;709;358;351
25;Lleida;230;Torregrossa;2218;1104;1114
25;Lleida;231;Torrelameu;588;317;271
25;Lleida;232;Torres de Segre;1832;935;897
25;Lleida;233;Torre-serona;302;150;152
25;Lleida;234;Tremp;5332;2615;2717
25;Lleida;043;Vall de Boí (La);749;428;321
25;Lleida;901;Vall de Cardós;350;181;169
25;Lleida;238;Vallbona de les Monges;294;141;153
25;Lleida;240;Vallfogona de Balaguer;1424;717;707
25;Lleida;906;Valls d'Aguilar (Les);245;126;119
25;Lleida;239;Valls de Valira (Les);820;435;385
25;Lleida;909;Vansa i Fórnols (La);164;87;77
25;Lleida;242;Verdú;957;463;494
25;Lleida;243;Vielha e Mijaran;3704;1866;1838
25;Lleida;244;Vilagrassa;435;214;221
25;Lleida;245;Vilaller;630;336;294
25;Lleida;247;Vilamòs;132;59;73
25;Lleida;248;Vilanova de Bellpuig;1187;576;611
25;Lleida;254;Vilanova de la Barca;976;488;488
25;Lleida;249;Vilanova de l'Aguda;298;154;144
25;Lleida;250;Vilanova de Meià;497;252;245
25;Lleida;251;Vilanova de Segrià;682;335;347
25;Lleida;252;Vila-sana;498;247;251
25;Lleida;253;Vilosell (El);215;97;118
25;Lleida;255;Vinaixa;688;341;347
26;Rioja (La);001;Ábalos;294;166;128
26;Rioja (La);002;Agoncillo;933;487;446
26;Rioja (La);003;Aguilar del Río Alhama;779;407;372
26;Rioja (La);004;Ajamil;79;52;27
26;Rioja (La);005;Albelda de Iregua;2231;1129;1102
26;Rioja (La);006;Alberite;1975;1003;972
26;Rioja (La);007;Alcanadre;851;433;418
26;Rioja (La);008;Aldeanueva de Ebro;2525;1281;1244
26;Rioja (La);009;Alesanco;548;276;272
26;Rioja (La);010;Alesón;154;76;78
26;Rioja (La);011;Alfaro;9309;4665;4644
26;Rioja (La);012;Almarza de Cameros;40;23;17
26;Rioja (La);013;Anguciana;317;163;154
26;Rioja (La);014;Anguiano;661;365;296
26;Rioja (La);015;Arenzana de Abajo;359;187;172
26;Rioja (La);016;Arenzana de Arriba;42;24;18
26;Rioja (La);017;Arnedillo;446;216;230
26;Rioja (La);018;Arnedo;12573;6270;6303
26;Rioja (La);019;Arrúbal;426;226;200
26;Rioja (La);020;Ausejo;741;392;349
26;Rioja (La);021;Autol;3417;1722;1695
26;Rioja (La);022;Azofra;386;204;182
26;Rioja (La);023;Badarán;795;416;379
26;Rioja (La);024;Bañares;478;242;236
26;Rioja (La);026;Baños de Río Tobía;1875;961;914
26;Rioja (La);025;Baños de Rioja;132;77;55
26;Rioja (La);027;Berceo;240;141;99
26;Rioja (La);028;Bergasa;200;106;94
26;Rioja (La);029;Bergasillas Bajera;34;20;14
26;Rioja (La);030;Bezares;31;19;12
26;Rioja (La);031;Bobadilla;180;91;89
26;Rioja (La);032;Brieva de Cameros;89;52;37
26;Rioja (La);033;Briñas;193;96;97
26;Rioja (La);034;Briones;870;464;406
26;Rioja (La);035;Cabezón de Cameros;33;21;12
26;Rioja (La);036;Calahorra;19277;9344;9933
26;Rioja (La);037;Camprovín;258;137;121
26;Rioja (La);038;Canales de la Sierra;111;55;56
26;Rioja (La);039;Canillas de Río Tuerto;74;35;39
26;Rioja (La);040;Cañas;120;56;64
26;Rioja (La);041;Cárdenas;265;133;132
26;Rioja (La);042;Casalarreina;944;478;466
26;Rioja (La);043;Castañares de Rioja;532;280;252
26;Rioja (La);044;Castroviejo;68;34;34
26;Rioja (La);045;Cellorigo;17;10;7
26;Rioja (La);046;Cenicero;2137;1080;1057
26;Rioja (La);047;Cervera del Río Alhama;3280;1651;1629
26;Rioja (La);048;Cidamón;89;49;40
26;Rioja (La);049;Cihuri;170;92;78
26;Rioja (La);050;Cirueña;141;82;59
26;Rioja (La);051;Clavijo;191;99;92
26;Rioja (La);052;Cordovín;231;116;115
26;Rioja (La);053;Corera;258;127;131
26;Rioja (La);054;Cornago;678;373;305
26;Rioja (La);055;Corporales;72;37;35
26;Rioja (La);056;Cuzcurrita de Río Tirón;469;253;216
26;Rioja (La);057;Daroca de Rioja;57;36;21
26;Rioja (La);058;Enciso;214;126;88
26;Rioja (La);059;Entrena;1129;592;537
26;Rioja (La);060;Estollo;162;89;73
26;Rioja (La);061;Ezcaray;1843;975;868
26;Rioja (La);062;Foncea;140;78;62
26;Rioja (La);063;Fonzaleche;191;109;82
26;Rioja (La);064;Fuenmayor;2118;1053;1065
26;Rioja (La);065;Galbárruli;62;36;26
26;Rioja (La);066;Galilea;286;149;137
26;Rioja (La);067;Gallinero de Cameros;27;18;9
26;Rioja (La);068;Gimileo;92;46;46
26;Rioja (La);069;Grañón;468;245;223
26;Rioja (La);070;Grávalos;300;158;142
26;Rioja (La);071;Haro;9071;4446;4625
26;Rioja (La);072;Herce;392;200;192
26;Rioja (La);073;Herramélluri;187;99;88
26;Rioja (La);074;Hervías;219;114;105
26;Rioja (La);075;Hormilla;491;257;234
26;Rioja (La);076;Hormilleja;189;96;93
26;Rioja (La);077;Hornillos de Cameros;24;13;11
26;Rioja (La);078;Hornos de Moncalvillo;111;56;55
26;Rioja (La);079;Huércanos;915;465;450
26;Rioja (La);080;Igea;920;499;421
26;Rioja (La);081;Jalón de Cameros;38;22;16
26;Rioja (La);082;Laguna de Cameros;175;99;76
26;Rioja (La);083;Lagunilla del Jubera;377;199;178
26;Rioja (La);084;Lardero;3337;1673;1664
26;Rioja (La);086;Ledesma de la Cogolla;20;13;7
26;Rioja (La);087;Leiva;342;167;175
26;Rioja (La);088;Leza de Río Leza;42;25;17
26;Rioja (La);089;Logroño;125456;60568;64888
26;Rioja (La);091;Lumbreras;192;112;80
26;Rioja (La);092;Manjarrés;145;80;65
26;Rioja (La);093;Mansilla de la Sierra;54;34;20
26;Rioja (La);094;Manzanares de Rioja;141;74;67
26;Rioja (La);095;Matute;188;94;94
26;Rioja (La);096;Medrano;232;126;106
26;Rioja (La);098;Munilla;148;68;80
26;Rioja (La);099;Murillo de Río Leza;1608;807;801
26;Rioja (La);100;Muro de Aguas;70;40;30
26;Rioja (La);101;Muro en Cameros;40;27;13
26;Rioja (La);102;Nájera;7193;3586;3607
26;Rioja (La);103;Nalda;894;470;424
26;Rioja (La);104;Navajún;21;14;7
26;Rioja (La);105;Navarrete;2031;1033;998
26;Rioja (La);106;Nestares;77;40;37
26;Rioja (La);107;Nieva de Cameros;128;67;61
26;Rioja (La);109;Ochánduri;116;59;57
26;Rioja (La);108;Ocón;344;192;152
26;Rioja (La);110;Ojacastro;255;147;108
26;Rioja (La);111;Ollauri;311;166;145
26;Rioja (La);112;Ortigosa de Cameros;355;174;181
26;Rioja (La);113;Pazuengos;52;34;18
26;Rioja (La);114;Pedroso;111;60;51
26;Rioja (La);115;Pinillos;32;18;14
26;Rioja (La);117;Pradejón;2859;1461;1398
26;Rioja (La);118;Pradillo;115;60;55
26;Rioja (La);119;Préjano;226;105;121
26;Rioja (La);120;Quel;2010;1048;962
26;Rioja (La);121;Rabanera;104;52;52
26;Rioja (La);122;Rasillo de Cameros (El);139;72;67
26;Rioja (La);123;Redal (El);236;120;116
26;Rioja (La);124;Ribafrecha;1077;578;499
26;Rioja (La);125;Rincón de Soto;3386;1686;1700
26;Rioja (La);126;Robres del Castillo;24;14;10
26;Rioja (La);127;Rodezno;374;189;185
26;Rioja (La);128;Sajazarra;156;80;76
26;Rioja (La);129;San Asensio;1392;724;668
26;Rioja (La);130;San Millán de la Cogolla;312;186;126
26;Rioja (La);131;San Millán de Yécora;66;40;26
26;Rioja (La);132;San Román de Cameros;198;110;88
26;Rioja (La);139;San Torcuato;129;69;60
26;Rioja (La);142;San Vicente de la Sonsierra;1125;587;538
26;Rioja (La);134;Santa Coloma;165;102;63
26;Rioja (La);135;Santa Engracia del Jubera;205;121;84
26;Rioja (La);136;Santa Eulalia Bajera;114;64;50
26;Rioja (La);138;Santo Domingo de la Calzada;5722;2884;2838
26;Rioja (La);140;Santurde de Rioja;321;160;161
26;Rioja (La);141;Santurdejo;251;135;116
26;Rioja (La);143;Sojuela;92;53;39
26;Rioja (La);144;Sorzano;278;155;123
26;Rioja (La);145;Sotés;282;152;130
26;Rioja (La);146;Soto en Cameros;162;84;78
26;Rioja (La);147;Terroba;36;19;17
26;Rioja (La);148;Tirgo;306;153;153
26;Rioja (La);149;Tobía;56;34;22
26;Rioja (La);150;Tormantos;220;114;106
26;Rioja (La);153;Torre en Cameros;14;11;3
26;Rioja (La);151;Torrecilla en Cameros;565;301;264
26;Rioja (La);152;Torrecilla sobre Alesanco;101;52;49
26;Rioja (La);154;Torremontalbo;15;8;7
26;Rioja (La);155;Treviana;314;170;144
26;Rioja (La);157;Tricio;382;188;194
26;Rioja (La);158;Tudelilla;495;249;246
26;Rioja (La);160;Uruñuela;734;384;350
26;Rioja (La);161;Valdemadera;21;9;12
26;Rioja (La);162;Valgañón;179;96;83
26;Rioja (La);163;Ventosa;141;73;68
26;Rioja (La);164;Ventrosa;110;48;62
26;Rioja (La);165;Viguera;436;246;190
26;Rioja (La);166;Villalba de Rioja;176;99;77
26;Rioja (La);167;Villalobar de Rioja;144;84;60
26;Rioja (La);168;Villamediana de Iregua;1872;959;913
26;Rioja (La);169;Villanueva de Cameros;133;71;62
26;Rioja (La);170;Villar de Arnedo (El);715;352;363
26;Rioja (La);171;Villar de Torre;351;180;171
26;Rioja (La);172;Villarejo;46;28;18
26;Rioja (La);173;Villarroya;10;4;6
26;Rioja (La);174;Villarta-Quintana;230;115;115
26;Rioja (La);175;Villavelayo;84;49;35
26;Rioja (La);176;Villaverde de Rioja;105;60;45
26;Rioja (La);177;Villoslada de Cameros;391;220;171
26;Rioja (La);178;Viniegra de Abajo;148;77;71
26;Rioja (La);179;Viniegra de Arriba;56;33;23
26;Rioja (La);180;Zarratón;285;148;137
26;Rioja (La);181;Zarzosa;19;14;5
26;Rioja (La);183;Zorraquín;45;27;18
27;Lugo;001;Abadín;3950;1879;2071
27;Lugo;002;Alfoz;2637;1288;1349
27;Lugo;003;Antas de Ulla;3140;1527;1613
27;Lugo;004;Baleira;2130;1109;1021
27;Lugo;901;Baralla;3705;1877;1828
27;Lugo;005;Barreiros;3730;1782;1948
27;Lugo;006;Becerreá;4006;2017;1989
27;Lugo;007;Begonte;4456;2211;2245
27;Lugo;008;Bóveda;2295;1106;1189
27;Lugo;902;Burela;7834;3881;3953
27;Lugo;009;Carballedo;4197;2088;2109
27;Lugo;010;Castro de Rei;5915;2984;2931
27;Lugo;011;Castroverde;3802;1941;1861
27;Lugo;012;Cervantes;2584;1407;1177
27;Lugo;013;Cervo;5289;2644;2645
27;Lugo;016;Chantada;10327;5063;5264
27;Lugo;014;Corgo (O);4708;2387;2321
27;Lugo;015;Cospeito;6372;3139;3233
27;Lugo;017;Folgoso do Courel;1887;957;930
27;Lugo;018;Fonsagrada (A);6668;3507;3161
27;Lugo;019;Foz;9896;4795;5101
27;Lugo;020;Friol;5043;2530;2513
27;Lugo;022;Guitiriz;6884;3418;3466
27;Lugo;023;Guntín;3875;1895;1980
27;Lugo;024;Incio (O);2756;1364;1392
27;Lugo;026;Láncara;3554;1853;1701
27;Lugo;027;Lourenzá;3088;1506;1582
27;Lugo;028;Lugo;88253;41791;46462
27;Lugo;029;Meira;1887;938;949
27;Lugo;030;Mondoñedo;5602;2624;2978
27;Lugo;031;Monforte de Lemos;20561;9896;10665
27;Lugo;032;Monterroso;4529;2284;2245
27;Lugo;033;Muras;1319;661;658
27;Lugo;034;Navia de Suarna;2242;1206;1036
27;Lugo;035;Negueira de Muñiz;339;175;164
27;Lugo;037;Nogais (As);1838;968;870
27;Lugo;038;Ourol;1833;886;947
27;Lugo;039;Outeiro de Rei;4212;2106;2106
27;Lugo;040;Palas de Rei;4916;2431;2485
27;Lugo;041;Pantón;4141;1997;2144
27;Lugo;042;Paradela;3113;1538;1575
27;Lugo;043;Páramo (O);2050;1048;1002
27;Lugo;044;Pastoriza (A);4394;2195;2199
27;Lugo;045;Pedrafita do Cebreiro;1973;1045;928
27;Lugo;047;Pobra do Brollón (A);3139;1539;1600
27;Lugo;046;Pol;2390;1169;1221
27;Lugo;048;Pontenova (A);3671;1784;1887
27;Lugo;049;Portomarín;2204;1097;1107
27;Lugo;050;Quiroga;5072;2469;2603
27;Lugo;056;Rábade;1768;915;853
27;Lugo;051;Ribadeo;9100;4287;4813
27;Lugo;052;Ribas de Sil;1611;773;838
27;Lugo;053;Ribeira de Piquín;1043;514;529
27;Lugo;054;Riotorto;2129;1055;1074
27;Lugo;055;Samos;2375;1244;1131
27;Lugo;057;Sarria;12611;6243;6368
27;Lugo;058;Saviñao (O);5709;2788;2921
27;Lugo;059;Sober;3708;1762;1946
27;Lugo;060;Taboada;5069;2513;2556
27;Lugo;061;Trabada;1929;929;1000
27;Lugo;062;Triacastela;1031;528;503
27;Lugo;063;Valadouro (O);2740;1354;1386
27;Lugo;064;Vicedo (O);2672;1291;1381
27;Lugo;065;Vilalba;16358;8009;8349
27;Lugo;066;Viveiro;15493;7434;8059
27;Lugo;021;Xermade;3004;1491;1513
27;Lugo;025;Xove;3649;1823;1826
28;Madrid;001;Acebeda (La);53;28;25
28;Madrid;002;Ajalvir;1630;864;766
28;Madrid;003;Alameda del Valle;167;96;71
28;Madrid;004;Álamo (El);3816;1908;1908
28;Madrid;005;Alcalá de Henares;166925;83506;83419
28;Madrid;006;Alcobendas;85466;42515;42951
28;Madrid;007;Alcorcón;143532;71305;72227
28;Madrid;008;Aldea del Fresno;1286;675;611
28;Madrid;009;Algete;12711;6390;6321
28;Madrid;010;Alpedrete;4757;2383;2374
28;Madrid;011;Ambite;299;149;150
28;Madrid;012;Anchuelo;565;304;261
28;Madrid;013;Aranjuez;39417;19223;20194
28;Madrid;014;Arganda del Rey;29007;14455;14552
28;Madrid;015;Arroyomolinos;2203;1126;1077
28;Madrid;016;Atazar (El);101;58;43
28;Madrid;017;Batres;614;319;295
28;Madrid;018;Becerril de la Sierra;2548;1300;1248
28;Madrid;019;Belmonte de Tajo;1161;594;567
28;Madrid;021;Berrueco (El);335;183;152
28;Madrid;020;Berzosa del Lozoya;108;52;56
28;Madrid;022;Boadilla del Monte;18450;9384;9066
28;Madrid;023;Boalo (El);2287;1161;1126
28;Madrid;024;Braojos;141;75;66
28;Madrid;025;Brea de Tajo;495;259;236
28;Madrid;026;Brunete;3309;1658;1651
28;Madrid;027;Buitrago del Lozoya;1391;691;700
28;Madrid;028;Bustarviejo;1334;687;647
28;Madrid;029;Cabanillas de la Sierra;387;202;185
28;Madrid;030;Cabrera (La);1259;634;625
28;Madrid;031;Cadalso de los Vidrios;2192;1117;1075
28;Madrid;032;Camarma de Esteruelas;2039;1017;1022
28;Madrid;033;Campo Real;2357;1183;1174
28;Madrid;034;Canencia;446;231;215
28;Madrid;035;Carabaña;1125;576;549
28;Madrid;036;Casarrubuelos;592;315;277
28;Madrid;037;Cenicientos;1865;926;939
28;Madrid;038;Cercedilla;4746;2354;2392
28;Madrid;039;Cervera de Buitrago;102;58;44
28;Madrid;051;Chapinería;1086;570;516
28;Madrid;052;Chinchón;4186;2105;2081
28;Madrid;040;Ciempozuelos;12192;6244;5948
28;Madrid;041;Cobeña;1662;843;819
28;Madrid;046;Collado Mediano;3476;1802;1674
28;Madrid;047;Collado Villalba;36031;18149;17882
28;Madrid;043;Colmenar de Oreja;5439;2636;2803
28;Madrid;042;Colmenar del Arroyo;771;379;392
28;Madrid;045;Colmenar Viejo;28114;14038;14076
28;Madrid;044;Colmenarejo;3071;1591;1480
28;Madrid;048;Corpa;375;195;180
28;Madrid;049;Coslada;79084;39711;39373
28;Madrid;050;Cubas de la Sagra;1142;567;575
28;Madrid;053;Daganzo de Arriba;2090;1076;1014
28;Madrid;054;Escorial (El);9143;4628;4515
28;Madrid;055;Estremera;1092;571;521
28;Madrid;056;Fresnedillas de la Oliva;584;297;287
28;Madrid;057;Fresno de Torote;469;239;230
28;Madrid;058;Fuenlabrada;160573;81228;79345
28;Madrid;059;Fuente el Saz de Jarama;3053;1590;1463
28;Madrid;060;Fuentidueña de Tajo;1388;670;718
28;Madrid;061;Galapagar;15434;7933;7501
28;Madrid;062;Garganta de los Montes;322;158;164
28;Madrid;063;Gargantilla del Lozoya y Pinilla de Buitrago;217;127;90
28;Madrid;064;Gascones;108;53;55
28;Madrid;065;Getafe;144662;72233;72429
28;Madrid;066;Griñón;3550;1818;1732
28;Madrid;067;Guadalix de la Sierra;2327;1161;1166
28;Madrid;068;Guadarrama;7796;3872;3924
28;Madrid;069;Hiruela (La);58;34;24
28;Madrid;070;Horcajo de la Sierra;121;65;56
28;Madrid;071;Horcajuelo de la Sierra;86;42;44
28;Madrid;072;Hoyo de Manzanares;4484;2297;2187
28;Madrid;073;Humanes de Madrid;8910;4557;4353
28;Madrid;074;Leganés;178321;89356;88965
28;Madrid;075;Loeches;2486;1245;1241
28;Madrid;076;Lozoya;434;225;209
28;Madrid;901;Lozoyuela-Navas-Sieteiglesias;643;339;304
28;Madrid;078;Madarcos;30;14;16
28;Madrid;079;Madrid;3029734;1424249;1605485
28;Madrid;080;Majadahonda;38852;18953;19899
28;Madrid;082;Manzanares el Real;2941;1493;1448
28;Madrid;083;Meco;4133;2129;2004
28;Madrid;084;Mejorada del Campo;15302;7738;7564
28;Madrid;085;Miraflores de la Sierra;3253;1647;1606
28;Madrid;086;Molar (El);3470;1844;1626
28;Madrid;087;Molinos (Los);2842;1361;1481
28;Madrid;088;Montejo de la Sierra;276;135;141
28;Madrid;089;Moraleja de Enmedio;1904;941;963
28;Madrid;090;Moralzarzal;3221;1650;1571
28;Madrid;091;Morata de Tajuña;5331;2596;2735
28;Madrid;092;Móstoles;199411;99253;100158
28;Madrid;093;Navacerrada;1712;848;864
28;Madrid;094;Navalafuente;385;214;171
28;Madrid;095;Navalagamella;784;390;394
28;Madrid;096;Navalcarnero;11469;5869;5600
28;Madrid;097;Navarredonda y San Mamés;107;55;52
28;Madrid;099;Navas del Rey;1351;681;670
28;Madrid;100;Nuevo Baztán;1826;956;870
28;Madrid;101;Olmeda de las Fuentes;149;82;67
28;Madrid;102;Orusco de Tajuña;642;327;315
28;Madrid;104;Paracuellos de Jarama;5484;2869;2615
28;Madrid;106;Parla;72788;36595;36193
28;Madrid;107;Patones;352;177;175
28;Madrid;108;Pedrezuela;1045;545;500
28;Madrid;109;Pelayos de la Presa;1143;566;577
28;Madrid;110;Perales de Tajuña;2047;993;1054
28;Madrid;111;Pezuela de las Torres;523;274;249
28;Madrid;112;Pinilla del Valle;176;93;83
28;Madrid;113;Pinto;24881;12381;12500
28;Madrid;114;Piñuécar-Gandullas;152;69;83
28;Madrid;115;Pozuelo de Alarcón;57780;28520;29260
28;Madrid;116;Pozuelo del Rey;240;121;119
28;Madrid;117;Prádena del Rincón;115;61;54
28;Madrid;118;Puebla de la Sierra;68;38;30
28;Madrid;902;Puentes Viejas;426;223;203
28;Madrid;119;Quijorna;788;411;377
28;Madrid;120;Rascafría;1431;754;677
28;Madrid;121;Redueña;143;68;75
28;Madrid;122;Ribatejada;305;156;149
28;Madrid;123;Rivas-Vaciamadrid;20977;10592;10385
28;Madrid;124;Robledillo de la Jara;100;52;48
28;Madrid;125;Robledo de Chavela;2079;1028;1051
28;Madrid;126;Robregordo;96;47;49
28;Madrid;127;Rozas de Madrid (Las);45888;22680;23208
28;Madrid;128;Rozas de Puerto Real;336;175;161
28;Madrid;129;San Agustín del Guadalix;4669;2415;2254
28;Madrid;130;San Fernando de Henares;28906;14539;14367
28;Madrid;131;San Lorenzo de El Escorial;10545;5124;5421
28;Madrid;132;San Martín de la Vega;8644;4422;4222
28;Madrid;133;San Martín de Valdeiglesias;5835;2911;2924
28;Madrid;134;San Sebastián de los Reyes;57747;28953;28794
28;Madrid;135;Santa María de la Alameda;717;390;327
28;Madrid;136;Santorcaz;545;282;263
28;Madrid;137;Santos de la Humosa (Los);949;492;457
28;Madrid;138;Serna del Monte (La);105;56;49
28;Madrid;140;Serranillos del Valle;670;348;322
28;Madrid;141;Sevilla la Nueva;2167;1131;1036
28;Madrid;143;Somosierra;105;62;43
28;Madrid;144;Soto del Real;3562;1823;1739
28;Madrid;145;Talamanca de Jarama;1287;628;659
28;Madrid;146;Tielmes;2005;1026;979
28;Madrid;147;Titulcia;908;453;455
28;Madrid;148;Torrejón de Ardoz;88224;44324;43900
28;Madrid;149;Torrejón de la Calzada;2566;1293;1273
28;Madrid;150;Torrejón de Velasco;1604;825;779
28;Madrid;151;Torrelaguna;2696;1318;1378
28;Madrid;152;Torrelodones;10080;5006;5074
28;Madrid;153;Torremocha de Jarama;302;146;156
28;Madrid;154;Torres de la Alameda;3777;1888;1889
28;Madrid;903;Tres Cantos;24555;12193;12362
28;Madrid;155;Valdaracete;692;342;350
28;Madrid;156;Valdeavero;546;277;269
28;Madrid;157;Valdelaguna;541;288;253
28;Madrid;158;Valdemanco;503;266;237
28;Madrid;159;Valdemaqueda;547;268;279
28;Madrid;160;Valdemorillo;3989;2044;1945
28;Madrid;161;Valdemoro;21023;10604;10419
28;Madrid;162;Valdeolmos-Alalpardo;1523;811;712
28;Madrid;163;Valdepiélagos;326;166;160
28;Madrid;164;Valdetorres de Jarama;1445;751;694
28;Madrid;165;Valdilecha;1822;899;923
28;Madrid;166;Valverde de Alcalá;276;149;127
28;Madrid;167;Velilla de San Antonio;3758;1933;1825
28;Madrid;168;Vellón (El);990;506;484
28;Madrid;169;Venturada;477;242;235
28;Madrid;171;Villa del Prado;3702;1857;1845
28;Madrid;170;Villaconejos;2916;1486;1430
28;Madrid;172;Villalbilla;2998;1517;1481
28;Madrid;173;Villamanrique de Tajo;594;308;286
28;Madrid;174;Villamanta;1438;774;664
28;Madrid;175;Villamantilla;324;170;154
28;Madrid;176;Villanueva de la Cañada;6713;3363;3350
28;Madrid;178;Villanueva de Perales;421;235;186
28;Madrid;177;Villanueva del Pardillo;2598;1333;1265
28;Madrid;179;Villar del Olmo;802;410;392
28;Madrid;180;Villarejo de Salvanés;5263;2615;2648
28;Madrid;181;Villaviciosa de Odón;16427;8153;8274
28;Madrid;182;Villavieja del Lozoya;165;81;84
28;Madrid;183;Zarzalejo;984;510;474
29;Málaga;001;Alameda;4941;2479;2462
29;Málaga;002;Alcaucín;1454;727;727
29;Málaga;003;Alfarnate;1510;771;739
29;Málaga;004;Alfarnatejo;439;242;197
29;Málaga;005;Algarrobo;4801;2425;2376
29;Málaga;006;Algatocín;1011;531;480
29;Málaga;007;Alhaurín de la Torre;15423;7808;7615
29;Málaga;008;Alhaurín el Grande;18104;8952;9152
29;Málaga;009;Almáchar;2032;1037;995
29;Málaga;010;Almargen;2253;1142;1111
29;Málaga;011;Almogía;3905;1988;1917
29;Málaga;012;Álora;13262;6719;6543
29;Málaga;013;Alozaina;2532;1333;1199
29;Málaga;014;Alpandeire;331;171;160
29;Málaga;015;Antequera;40197;19715;20482
29;Málaga;016;Árchez;352;192;160
29;Málaga;017;Archidona;10377;5203;5174
29;Málaga;018;Ardales;3201;1623;1578
29;Málaga;019;Arenas;1274;676;598
29;Málaga;020;Arriate;3300;1633;1667
29;Málaga;021;Atajate;186;101;85
29;Málaga;022;Benadalid;274;147;127
29;Málaga;023;Benahavís;1731;875;856
29;Málaga;024;Benalauría;523;277;246
29;Málaga;025;Benalmádena;25756;12701;13055
29;Málaga;026;Benamargosa;1641;821;820
29;Málaga;027;Benamocarra;2803;1433;1370
29;Málaga;028;Benaoján;1686;834;852
29;Málaga;029;Benarrabá;659;333;326
29;Málaga;030;Borge (El);1055;552;503
29;Málaga;031;Burgo (El);2172;1111;1061
29;Málaga;032;Campillos;8277;4195;4082
29;Málaga;033;Canillas de Aceituno;2766;1398;1368
29;Málaga;034;Canillas de Albaida;661;343;318
29;Málaga;035;Cañete la Real;2344;1200;1144
29;Málaga;036;Carratraca;852;433;419
29;Málaga;037;Cartajima;341;177;164
29;Málaga;038;Cártama;12298;6213;6085
29;Málaga;039;Casabermeja;3186;1689;1497
29;Málaga;040;Casarabonela;2553;1321;1232
29;Málaga;041;Casares;3193;1660;1533
29;Málaga;042;Coín;18466;9324;9142
29;Málaga;043;Colmenar;3203;1572;1631
29;Málaga;044;Comares;1412;735;677
29;Málaga;045;Cómpeta;2515;1253;1262
29;Málaga;046;Cortes de la Frontera;3767;1891;1876
29;Málaga;047;Cuevas Bajas;1523;712;811
29;Málaga;049;Cuevas de San Marcos;4150;2072;2078
29;Málaga;048;Cuevas del Becerro;2030;1050;980
29;Málaga;050;Cútar;614;314;300
29;Málaga;051;Estepona;36766;18373;18393
29;Málaga;052;Faraján;319;165;154
29;Málaga;053;Frigiliana;2193;1074;1119
29;Málaga;054;Fuengirola;43613;21395;22218
29;Málaga;055;Fuente de Piedra;2055;1012;1043
29;Málaga;056;Gaucín;1758;912;846
29;Málaga;057;Genalguacil;682;360;322
29;Málaga;058;Guaro;2034;1035;999
29;Málaga;059;Humilladero;2424;1226;1198
29;Málaga;060;Igualeja;1002;496;506
29;Málaga;061;Istán;1324;662;662
29;Málaga;062;Iznate;767;392;375
29;Málaga;063;Jimera de Líbar;450;220;230
29;Málaga;064;Jubrique;873;440;433
29;Málaga;065;Júzcar;250;144;106
29;Málaga;066;Macharaviaya;374;197;177
29;Málaga;067;Málaga;532425;256336;276089
29;Málaga;068;Manilva;5339;2741;2598
29;Málaga;069;Marbella;87679;43406;44273
29;Málaga;070;Mijas;35990;17746;18244
29;Málaga;071;Moclinejo;1086;553;533
29;Málaga;072;Mollina;3288;1624;1664
29;Málaga;073;Monda;1645;847;798
29;Málaga;074;Montejaque;1044;514;530
29;Málaga;075;Nerja;15009;7454;7555
29;Málaga;076;Ojén;1982;1030;952
29;Málaga;077;Parauta;300;154;146
29;Málaga;079;Periana;3467;1806;1661
29;Málaga;080;Pizarra;6587;3322;3265
29;Málaga;081;Pujerra;362;200;162
29;Málaga;082;Rincón de la Victoria;17183;8541;8642
29;Málaga;083;Riogordo;2673;1357;1316
29;Málaga;084;Ronda;34834;17171;17663
29;Málaga;085;Salares;235;120;115
29;Málaga;086;Sayalonga;1072;553;519
29;Málaga;087;Sedella;508;263;245
29;Málaga;088;Sierra de Yeguas;3239;1636;1603
29;Málaga;089;Teba;4472;2288;2184
29;Málaga;090;Tolox;2962;1500;1462
29;Málaga;901;Torremolinos;33005;16279;16726
29;Málaga;091;Torrox;10936;5525;5411
29;Málaga;092;Totalán;615;317;298
29;Málaga;093;Valle de Abdalajís;3118;1571;1547
29;Málaga;094;Vélez-Málaga;55399;27645;27754
29;Málaga;095;Villanueva de Algaidas;4299;2112;2187
29;Málaga;098;Villanueva de Tapia;1652;831;821
29;Málaga;096;Villanueva del Rosario;3288;1610;1678
29;Málaga;097;Villanueva del Trabuco;4640;2359;2281
29;Málaga;099;Viñuela;1177;593;584
29;Málaga;100;Yunquera;3229;1672;1557
30;Murcia;001;Abanilla;6321;3144;3177
30;Murcia;002;Abarán;12132;6033;6099
30;Murcia;003;Águilas;26232;13145;13087
30;Murcia;004;Albudeite;1383;690;693
30;Murcia;005;Alcantarilla;32455;15903;16552
30;Murcia;902;Alcázares (Los);4779;2344;2435
30;Murcia;006;Aledo;1007;520;487
30;Murcia;007;Alguazas;7107;3527;3580
30;Murcia;008;Alhama de Murcia;15022;7453;7569
30;Murcia;009;Archena;14033;6963;7070
30;Murcia;010;Beniel;7861;3910;3951
30;Murcia;011;Blanca;5765;2822;2943
30;Murcia;012;Bullas;10521;5298;5223
30;Murcia;013;Calasparra;9024;4537;4487
30;Murcia;014;Campos del Río;2058;1018;1040
30;Murcia;015;Caravaca de la Cruz;21941;10893;11048
30;Murcia;016;Cartagena;180553;89471;91082
30;Murcia;017;Cehegín;14197;7095;7102
30;Murcia;018;Ceutí;6854;3437;3417
30;Murcia;019;Cieza;32210;15732;16478
30;Murcia;020;Fortuna;6413;3275;3138
30;Murcia;021;Fuente Álamo de Murcia;9146;4548;4598
30;Murcia;022;Jumilla;20887;10385;10502
30;Murcia;023;Librilla;3854;1884;1970
30;Murcia;024;Lorca;69651;34456;35195
30;Murcia;025;Lorquí;5533;2738;2795
30;Murcia;026;Mazarrón;15753;7936;7817
30;Murcia;027;Molina de Segura;41519;20498;21021
30;Murcia;028;Moratalla;9005;4560;4445
30;Murcia;029;Mula;13685;6803;6882
30;Murcia;030;Murcia;344904;167921;176983
30;Murcia;031;Ojós;634;320;314
30;Murcia;032;Pliego;3427;1751;1676
30;Murcia;033;Puerto Lumbreras;10511;5121;5390
30;Murcia;034;Ricote;1667;820;847
30;Murcia;035;San Javier;17282;8573;8709
30;Murcia;036;San Pedro del Pinatar;13916;6918;6998
30;Murcia;901;Santomera;9607;4777;4830
30;Murcia;037;Torre-Pacheco;19586;10234;9352
30;Murcia;038;Torres de Cotillas (Las);15137;7584;7553
30;Murcia;039;Totana;21386;10696;10690
30;Murcia;040;Ulea;1049;522;527
30;Murcia;041;Unión (La);14475;7182;7293
30;Murcia;042;Villanueva del Río Segura;1618;808;810
30;Murcia;043;Yecla;27877;13940;13937
31;Navarra;001;Abáigar;91;50;41
31;Navarra;002;Abárzuza;504;245;259
31;Navarra;003;Abaurregaina/Abaurrea Alta;198;113;85
31;Navarra;004;Abaurrepea/Abaurrea Baja;51;35;16
31;Navarra;005;Aberin;369;191;178
31;Navarra;006;Ablitas;2302;1184;1118
31;Navarra;007;Adiós;117;58;59
31;Navarra;008;Aguilar de Codés;116;62;54
31;Navarra;009;Aibar/Oibar;952;486;466
31;Navarra;011;Allín;838;438;400
31;Navarra;012;Allo;1104;547;557
31;Navarra;010;Altsasu/Alsasua;7101;3611;3490
31;Navarra;013;Améscoa Baja;859;449;410
31;Navarra;014;Ancín;293;151;142
31;Navarra;015;Andosilla;2560;1270;1290
31;Navarra;016;Ansoáin;5107;2578;2529
31;Navarra;017;Anue;459;263;196
31;Navarra;018;Añorbe;421;231;190
31;Navarra;019;Aoiz/Agoitz;1875;931;944
31;Navarra;020;Araitz;639;374;265
31;Navarra;025;Arakil;879;471;408
31;Navarra;021;Aranarache;104;52;52
31;Navarra;023;Aranguren;2376;1266;1110
31;Navarra;024;Arano;177;95;82
31;Navarra;022;Arantza;718;398;320
31;Navarra;026;Aras;230;117;113
31;Navarra;027;Arbizu;920;487;433
31;Navarra;028;Arce/Artzi;286;161;125
31;Navarra;029;Arcos (Los);1418;717;701
31;Navarra;030;Arellano;216;116;100
31;Navarra;031;Areso;291;153;138
31;Navarra;032;Arguedas;2255;1123;1132
31;Navarra;033;Aria;76;47;29
31;Navarra;034;Aribe;78;38;40
31;Navarra;035;Armañanzas;108;54;54
31;Navarra;036;Arróniz;1224;660;564
31;Navarra;037;Arruazu;125;63;62
31;Navarra;038;Artajona;1704;896;808
31;Navarra;039;Artazu;98;51;47
31;Navarra;040;Atez;247;150;97
31;Navarra;058;Auritz/Burguete;294;134;160
31;Navarra;041;Ayegui;843;440;403
31;Navarra;042;Azagra;3525;1761;1764
31;Navarra;043;Azuelo;71;34;37
31;Navarra;044;Bakaiku;360;203;157
31;Navarra;901;Barañain;19759;9804;9955
31;Navarra;045;Barásoain;442;219;223
31;Navarra;046;Barbarin;117;54;63
31;Navarra;047;Bargota;399;203;196
31;Navarra;048;Barillas;213;100;113
31;Navarra;049;Basaburua;736;415;321
31;Navarra;050;Baztan;8055;4107;3948
31;Navarra;137;Beintza-Labaien;305;174;131
31;Navarra;051;Beire;349;169;180
31;Navarra;052;Belascoáin;92;47;45
31;Navarra;250;Bera/Vera de Bidasoa;3557;1827;1730
31;Navarra;053;Berbinzana;732;374;358
31;Navarra;905;Beriáin;2260;1136;1124
31;Navarra;902;Berrioplano;961;476;485
31;Navarra;903;Berriozar;5507;2810;2697
31;Navarra;054;Bertizarana;661;325;336
31;Navarra;055;Betelu;351;196;155
31;Navarra;253;Bidaurreta;101;60;41
31;Navarra;056;Biurrun-Olcoz;172;90;82
31;Navarra;057;Buñuel;2419;1180;1239
31;Navarra;059;Burgui/Burgi;255;144;111
31;Navarra;060;Burlada/Burlata;15833;7903;7930
31;Navarra;061;Busto (El);110;55;55
31;Navarra;062;Cabanillas;1476;754;722
31;Navarra;063;Cabredo;144;74;70
31;Navarra;064;Cadreita;1883;920;963
31;Navarra;065;Caparroso;2290;1103;1187
31;Navarra;066;Cárcar;1281;633;648
31;Navarra;067;Carcastillo;2637;1321;1316
31;Navarra;068;Cascante;3574;1764;1810
31;Navarra;069;Cáseda;1098;545;553
31;Navarra;070;Castejón;3240;1637;1603
31;Navarra;071;Castillonuevo;26;16;10
31;Navarra;072;Cintruénigo;5457;2717;2740
31;Navarra;074;Cirauqui;468;262;206
31;Navarra;075;Ciriza;62;25;37
31;Navarra;076;Cizur;1095;565;530
31;Navarra;077;Corella;6470;3260;3210
31;Navarra;078;Cortes;3227;1632;1595
31;Navarra;079;Desojo;165;91;74
31;Navarra;080;Dicastillo;740;394;346
31;Navarra;081;Donamaria;383;189;194
31;Navarra;221;Doneztebe/Santesteban;1282;642;640
31;Navarra;083;Echarri;65;33;32
31;Navarra;086;Egüés;3507;1782;1725
31;Navarra;087;Elgorriaga;197;99;98
31;Navarra;089;Enériz;195;98;97
31;Navarra;090;Eratsun;198;120;78
31;Navarra;091;Ergoiena;507;287;220
31;Navarra;092;Erro;794;440;354
31;Navarra;094;Eslava;209;106;103
31;Navarra;095;Esparza de Salazar;129;68;61
31;Navarra;096;Espronceda;194;111;83
31;Navarra;097;Estella/Lizarra;12815;6210;6605
31;Navarra;098;Esteribar;1479;798;681
31;Navarra;099;Etayo;102;53;49
31;Navarra;082;Etxalar;873;454;419
31;Navarra;084;Etxarri-Aranatz;2375;1223;1152
31;Navarra;085;Etxauri;415;209;206
31;Navarra;100;Eulate;402;206;196
31;Navarra;101;Ezcabarte;1040;553;487
31;Navarra;093;Ezcároz/Ezkaroze;359;194;165
31;Navarra;102;Ezkurra;267;164;103
31;Navarra;103;Ezprogui;69;34;35
31;Navarra;104;Falces;2715;1333;1382
31;Navarra;105;Fitero;2120;1059;1061
31;Navarra;106;Fontellas;558;285;273
31;Navarra;107;Funes;2137;1088;1049
31;Navarra;108;Fustiñana;2318;1177;1141
31;Navarra;109;Galar;1056;560;496
31;Navarra;110;Gallipienzo;190;109;81
31;Navarra;111;Gallués/Galoze;121;78;43
31;Navarra;112;Garaioa;139;74;65
31;Navarra;113;Garde;220;120;100
31;Navarra;114;Garínoain;305;159;146
31;Navarra;115;Garralda;236;123;113
31;Navarra;116;Genevilla;132;68;64
31;Navarra;117;Goizueta;1018;551;467
31;Navarra;118;Goñi;213;115;98
31;Navarra;119;Güesa/Gorza;82;45;37
31;Navarra;120;Guesálaz;476;265;211
31;Navarra;121;Guirguillano;90;48;42
31;Navarra;256;Hiriberri/Villanueva de Aezkoa;168;86;82
31;Navarra;122;Huarte/Uharte;2826;1427;1399
31;Navarra;124;Ibargoiti;210;128;82
31;Navarra;259;Igantzi;616;330;286
31;Navarra;125;Igúzquiza;354;177;177
31;Navarra;126;Imotz;422;229;193
31;Navarra;127;Irañeta;155;85;70
31;Navarra;904;Irurtzun;2043;1062;981
31;Navarra;128;Isaba/Izaba;570;289;281
31;Navarra;129;Ituren;487;242;245
31;Navarra;130;Iturmendi;361;188;173
31;Navarra;131;Iza;634;336;298
31;Navarra;132;Izagaondoa;198;119;79
31;Navarra;133;Izalzu/Itzaltzu;48;26;22
31;Navarra;134;Jaurrieta;303;159;144
31;Navarra;135;Javier;159;66;93
31;Navarra;136;Juslapeña;470;254;216
31;Navarra;138;Lakuntza;993;525;468
31;Navarra;139;Lana;219;119;100
31;Navarra;140;Lantz;123;78;45
31;Navarra;141;Lapoblación;200;107;93
31;Navarra;142;Larraga;1952;1025;927
31;Navarra;143;Larraona;183;92;91
31;Navarra;144;Larraun;1985;1064;921
31;Navarra;145;Lazagurría;251;132;119
31;Navarra;146;Leache;64;35;29
31;Navarra;147;Legarda;80;46;34
31;Navarra;148;Legaria;162;87;75
31;Navarra;149;Leitza;3149;1638;1511
31;Navarra;908;Lekunberri;"";"";""
31;Navarra;150;Leoz;244;142;102
31;Navarra;151;Lerga;101;51;50
31;Navarra;152;Lerín;2014;996;1018
31;Navarra;153;Lesaka;2750;1444;1306
31;Navarra;154;Lezáun;284;158;126
31;Navarra;155;Liédena;333;158;175
31;Navarra;156;Lizoáin;245;135;110
31;Navarra;157;Lodosa;4656;2353;2303
31;Navarra;158;Lónguida/Longida;310;166;144
31;Navarra;159;Lumbier;1521;835;686
31;Navarra;160;Luquin;134;74;60
31;Navarra;248;Luzaide/Valcarlos;530;261;269
31;Navarra;161;Mañeru;359;180;179
31;Navarra;162;Marañón;87;44;43
31;Navarra;163;Marcilla;2394;1193;1201
31;Navarra;164;Mélida;882;449;433
31;Navarra;165;Mendavia;3608;1815;1793
31;Navarra;166;Mendaza;420;196;224
31;Navarra;167;Mendigorría;956;489;467
31;Navarra;168;Metauten;320;164;156
31;Navarra;169;Milagro;2574;1268;1306
31;Navarra;170;Mirafuentes;51;24;27
31;Navarra;171;Miranda de Arga;980;486;494
31;Navarra;172;Monreal;307;158;149
31;Navarra;173;Monteagudo;1171;580;591
31;Navarra;174;Morentin;132;66;66
31;Navarra;175;Mues;120;61;59
31;Navarra;176;Murchante;2979;1474;1505
31;Navarra;177;Murieta;299;171;128
31;Navarra;178;Murillo el Cuende;668;354;314
31;Navarra;179;Murillo el Fruto;816;416;400
31;Navarra;180;Muruzábal;199;105;94
31;Navarra;181;Navascués;244;147;97
31;Navarra;182;Nazar;55;32;23
31;Navarra;088;Noáin (Valle de Elorz)/Noain (Elortzibar);3891;1945;1946
31;Navarra;183;Obanos;769;366;403
31;Navarra;185;Ochagavía;687;362;325
31;Navarra;184;Oco;94;57;37
31;Navarra;186;Odieta;334;186;148
31;Navarra;187;Oitz;168;101;67
31;Navarra;188;Olaibar;180;99;81
31;Navarra;189;Olazti/Olazagutía;1698;888;810
31;Navarra;190;Olejua;63;32;31
31;Navarra;191;Olite;3101;1551;1550
31;Navarra;194;Ollo;376;209;167
31;Navarra;192;Olóriz;181;100;81
31;Navarra;193;Olza;1287;666;621
31;Navarra;195;Orbaitzeta;254;141;113
31;Navarra;196;Orbara;64;33;31
31;Navarra;906;Orcoyen;1217;694;523
31;Navarra;197;Orísoain;108;56;52
31;Navarra;198;Oronz;51;28;23
31;Navarra;199;Oroz-Betelu;240;133;107
31;Navarra;211;Orreaga/Roncesvalles;32;18;14
31;Navarra;200;Oteiza;938;489;449
31;Navarra;201;Pamplona/Iruña;181776;87192;94584
31;Navarra;202;Peralta;4684;2311;2373
31;Navarra;203;Petilla de Aragón;52;26;26
31;Navarra;204;Piedramillera;81;46;35
31;Navarra;205;Pitillas;646;331;315
31;Navarra;206;Puente la Reina/Gares;2232;1112;1120
31;Navarra;207;Pueyo;330;169;161
31;Navarra;208;Ribaforada;3151;1623;1528
31;Navarra;209;Romanzado;159;89;70
31;Navarra;210;Roncal/Erronkari;384;194;190
31;Navarra;212;Sada;275;150;125
31;Navarra;213;Saldías;165;90;75
31;Navarra;214;Salinas de Oro;107;63;44
31;Navarra;215;San Adrián;5261;2566;2695
31;Navarra;217;San Martín de Unx;512;275;237
31;Navarra;216;Sangüesa/Zangoza;4725;2431;2294
31;Navarra;219;Sansol;144;75;69
31;Navarra;220;Santacara;1091;553;538
31;Navarra;222;Sarriés/Sartze;97;55;42
31;Navarra;223;Sartaguda;1396;705;691
31;Navarra;224;Sesma;1425;704;721
31;Navarra;225;Sorlada;60;29;31
31;Navarra;226;Sunbilla;705;361;344
31;Navarra;227;Tafalla;10343;5084;5259
31;Navarra;228;Tiebas-Muruarte de Reta;617;328;289
31;Navarra;229;Tirapu;65;36;29
31;Navarra;230;Torralba del Río;161;86;75
31;Navarra;231;Torres del Río;200;98;102
31;Navarra;232;Tudela;27562;13484;14078
31;Navarra;233;Tulebras;116;46;70
31;Navarra;234;Ucar;115;62;53
31;Navarra;123;Uharte-Arakil;827;438;389
31;Navarra;235;Ujué;272;145;127
31;Navarra;236;Ultzama;1653;855;798
31;Navarra;237;Unciti;249;144;105
31;Navarra;238;Unzué;134;76;58
31;Navarra;239;Urdazubi/Urdax;454;228;226
31;Navarra;240;Urdiain;671;350;321
31;Navarra;241;Urraul Alto;158;92;66
31;Navarra;242;Urraul Bajo;278;131;147
31;Navarra;244;Urrotz;209;116;93
31;Navarra;243;Urroz;362;182;180
31;Navarra;245;Urzainqui;117;63;54
31;Navarra;246;Uterga;145;67;78
31;Navarra;247;Uztárroz/Uztarroze;307;152;155
31;Navarra;249;Valtierra;2503;1241;1262
31;Navarra;251;Viana;3496;1778;1718
31;Navarra;252;Vidángoz/Bidankoze;118;57;61
31;Navarra;254;Villafranca;2540;1220;1320
31;Navarra;255;Villamayor de Monjardín;118;65;53
31;Navarra;257;Villatuerta;798;400;398
31;Navarra;258;Villava/Atarrabia;8710;4387;4323
31;Navarra;260;Yerri;1560;830;730
31;Navarra;261;Yesa;301;174;127
31;Navarra;262;Zabalza;144;63;81
31;Navarra;073;Ziordia;403;190;213
31;Navarra;907;Zizur Mayor/Zizur Nagusia;7152;3609;3543
31;Navarra;263;Zubieta;336;196;140
31;Navarra;264;Zugarramurdi;258;137;121
31;Navarra;265;Zúñiga;141;75;66
32;Ourense;001;Allariz;5390;2561;2829
32;Ourense;002;Amoeiro;2355;1140;1215
32;Ourense;003;Arnoia (A);1114;531;583
32;Ourense;004;Avión;3536;1618;1918
32;Ourense;005;Baltar;1820;895;925
32;Ourense;006;Bande;2891;1369;1522
32;Ourense;007;Baños de Molgas;3060;1506;1554
32;Ourense;008;Barbadás;4562;2237;2325
32;Ourense;009;Barco de Valdeorras (O);11712;5838;5874
32;Ourense;010;Beade;894;444;450
32;Ourense;011;Beariz;1861;846;1015
32;Ourense;012;Blancos (Os);1291;654;637
32;Ourense;013;Boborás;3888;1775;2113
32;Ourense;014;Bola (A);1738;815;923
32;Ourense;015;Bolo (O);1802;898;904
32;Ourense;016;Calvos de Randín;1946;978;968
32;Ourense;018;Carballeda de Avia;1879;894;985
32;Ourense;017;Carballeda de Valdeorras;2662;1354;1308
32;Ourense;019;Carballiño (O);12002;5669;6333
32;Ourense;020;Cartelle;4257;2062;2195
32;Ourense;022;Castrelo de Miño;3535;1732;1803
32;Ourense;021;Castrelo do Val;1470;714;756
32;Ourense;023;Castro Caldelas;2110;1093;1017
32;Ourense;024;Celanova;6211;2938;3273
32;Ourense;025;Cenlle;1943;898;1045
32;Ourense;029;Chandrexa de Queixa;1006;542;464
32;Ourense;026;Coles;3323;1620;1703
32;Ourense;027;Cortegada;1610;769;841
32;Ourense;028;Cualedro;2745;1394;1351
32;Ourense;030;Entrimo;1708;765;943
32;Ourense;031;Esgos;1487;709;778
32;Ourense;033;Gomesende;1368;636;732
32;Ourense;034;Gudiña (A);2014;1018;996
32;Ourense;035;Irixo (O);2529;1163;1366
32;Ourense;038;Larouco;684;321;363
32;Ourense;039;Laza;2290;1140;1150
32;Ourense;040;Leiro;2192;1053;1139
32;Ourense;041;Lobeira;1458;710;748
32;Ourense;042;Lobios;3090;1483;1607
32;Ourense;043;Maceda;3470;1662;1808
32;Ourense;044;Manzaneda;1594;814;780
32;Ourense;045;Maside;3571;1661;1910
32;Ourense;046;Melón;1728;760;968
32;Ourense;047;Merca (A);2706;1295;1411
32;Ourense;048;Mezquita (A);1844;934;910
32;Ourense;049;Montederramo;1478;759;719
32;Ourense;050;Monterrei;3759;1884;1875
32;Ourense;051;Muíños;2381;1166;1215
32;Ourense;052;Nogueira de Ramuín;2847;1341;1506
32;Ourense;053;Oímbra;2140;1050;1090
32;Ourense;054;Ourense;110796;52336;58460
32;Ourense;055;Paderne de Allariz;1809;849;960
32;Ourense;056;Padrenda;2908;1392;1516
32;Ourense;057;Parada de Sil;1081;521;560
32;Ourense;058;Pereiro de Aguiar (O);5032;2442;2590
32;Ourense;059;Peroxa (A);2862;1359;1503
32;Ourense;060;Petín;1284;621;663
32;Ourense;061;Piñor;1771;900;871
32;Ourense;063;Pobra de Trives (A);3114;1533;1581
32;Ourense;064;Pontedeva;823;393;430
32;Ourense;062;Porqueira;1312;642;670
32;Ourense;065;Punxín;1053;500;553
32;Ourense;066;Quintela de Leirado;1069;487;582
32;Ourense;067;Rairiz de Veiga;2277;1126;1151
32;Ourense;068;Ramirás;2151;983;1168
32;Ourense;069;Ribadavia;6021;2884;3137
32;Ourense;071;Riós;2528;1268;1260
32;Ourense;072;Rúa (A);5127;2546;2581
32;Ourense;073;Rubiá;2116;1059;1057
32;Ourense;074;San Amaro;1694;823;871
32;Ourense;075;San Cibrao das Viñas;3514;1701;1813
32;Ourense;076;San Cristovo de Cea;3649;1787;1862
32;Ourense;070;San Xoán de Río;1209;583;626
32;Ourense;077;Sandiás;1946;915;1031
32;Ourense;078;Sarreaus;2605;1295;1310
32;Ourense;079;Taboadela;1903;951;952
32;Ourense;080;Teixeira (A);706;333;373
32;Ourense;081;Toén;2757;1374;1383
32;Ourense;082;Trasmiras;2266;1115;1151
32;Ourense;083;Veiga (A);1648;820;828
32;Ourense;084;Verea;1729;821;908
32;Ourense;085;Verín;12099;5894;6205
32;Ourense;086;Viana do Bolo;4549;2312;2237
32;Ourense;087;Vilamarín;2331;1136;1195
32;Ourense;088;Vilamartín de Valdeorras;2511;1235;1276
32;Ourense;089;Vilar de Barrio;2574;1299;1275
32;Ourense;090;Vilar de Santos;1397;704;693
32;Ourense;091;Vilardevós;3271;1656;1615
32;Ourense;092;Vilariño de Conso;932;512;420
32;Ourense;032;Xinzo de Limia;9604;4682;4922
32;Ourense;036;Xunqueira de Ambía;2316;1130;1186
32;Ourense;037;Xunqueira de Espadanedo;1226;583;643
33;Asturias;001;Allande;2749;1419;1330
33;Asturias;002;Aller;17107;8456;8651
33;Asturias;003;Amieva;1012;532;480
33;Asturias;004;Avilés;88450;42863;45587
33;Asturias;005;Belmonte de Miranda;2708;1394;1314
33;Asturias;006;Bimenes;2468;1168;1300
33;Asturias;007;Boal;2854;1419;1435
33;Asturias;008;Cabrales;2485;1273;1212
33;Asturias;009;Cabranes;1418;686;732
33;Asturias;010;Candamo;2812;1362;1450
33;Asturias;012;Cangas de Onís;6504;3184;3320
33;Asturias;011;Cangas del Narcea;18782;9579;9203
33;Asturias;013;Caravia;581;293;288
33;Asturias;014;Carreño;11083;5382;5701
33;Asturias;015;Caso;2062;1072;990
33;Asturias;016;Castrillón;22567;10972;11595
33;Asturias;017;Castropol;5013;2414;2599
33;Asturias;018;Coaña;3967;1903;2064
33;Asturias;019;Colunga;5002;2451;2551
33;Asturias;020;Corvera de Asturias;17245;8562;8683
33;Asturias;021;Cudillero;6504;3212;3292
33;Asturias;022;Degaña;1655;875;780
33;Asturias;023;Franco (El);4293;2097;2196
33;Asturias;024;Gijón;270867;129250;141617
33;Asturias;025;Gozón;11756;5708;6048
33;Asturias;026;Grado;12214;5882;6332
33;Asturias;027;Grandas de Salime;1458;747;711
33;Asturias;028;Ibias;2469;1320;1149
33;Asturias;029;Illano;735;373;362
33;Asturias;030;Illas;1286;666;620
33;Asturias;031;Langreo;51614;24707;26907
33;Asturias;032;Laviana;15433;7564;7869
33;Asturias;033;Lena;14672;7210;7462
33;Asturias;035;Llanera;11148;5487;5661
33;Asturias;036;Llanes;14716;7046;7670
33;Asturias;037;Mieres;53012;25633;27379
33;Asturias;038;Morcín;3078;1523;1555
33;Asturias;039;Muros de Nalón;2576;1213;1363
33;Asturias;040;Nava;5810;2859;2951
33;Asturias;041;Navia;9166;4386;4780
33;Asturias;042;Noreña;4235;2003;2232
33;Asturias;043;Onís;1054;528;526
33;Asturias;044;Oviedo;202421;94878;107543
33;Asturias;045;Parres;5787;2839;2948
33;Asturias;046;Peñamellera Alta;880;433;447
33;Asturias;047;Peñamellera Baja;1708;845;863
33;Asturias;048;Pesoz;315;155;160
33;Asturias;049;Piloña;9630;4657;4973
33;Asturias;050;Ponga;861;484;377
33;Asturias;051;Pravia;9989;4820;5169
33;Asturias;052;Proaza;1003;497;506
33;Asturias;053;Quirós;1771;933;838
33;Asturias;054;Regueras (Las);2378;1184;1194
33;Asturias;055;Ribadedeva;2001;967;1034
33;Asturias;056;Ribadesella;6472;3071;3401
33;Asturias;057;Ribera de Arriba;2210;1093;1117
33;Asturias;058;Riosa;2791;1448;1343
33;Asturias;059;Salas;7721;3804;3917
33;Asturias;061;San Martín de Oscos;600;322;278
33;Asturias;060;San Martín del Rey Aurelio;23336;11286;12050
33;Asturias;063;San Tirso de Abres;689;345;344
33;Asturias;062;Santa Eulalia de Oscos;647;331;316
33;Asturias;064;Santo Adriano;381;184;197
33;Asturias;065;Sariego;1510;754;756
33;Asturias;066;Siero;46667;22669;23998
33;Asturias;067;Sobrescobio;814;419;395
33;Asturias;068;Somiedo;1773;935;838
33;Asturias;069;Soto del Barco;4568;2186;2382
33;Asturias;070;Tapia de Casariego;4550;2184;2366
33;Asturias;071;Taramundi;1004;492;512
33;Asturias;072;Teverga;2475;1269;1206
33;Asturias;073;Tineo;14462;7322;7140
33;Asturias;034;Valdés;16620;8146;8474
33;Asturias;074;Vegadeo;5085;2430;2655
33;Asturias;075;Villanueva de Oscos;453;234;219
33;Asturias;076;Villaviciosa;14815;7292;7523
33;Asturias;077;Villayón;2167;1111;1056
33;Asturias;078;Yernes y Tameza;196;96;100
34;Palencia;001;Abarca de Campos;54;25;29
34;Palencia;003;Abia de las Torres;239;127;112
34;Palencia;004;Aguilar de Campoo;7925;3897;4028
34;Palencia;005;Alar del Rey;1503;707;796
34;Palencia;006;Alba de Cerrato;129;60;69
34;Palencia;009;Amayuelas de Arriba;49;29;20
34;Palencia;010;Ampudia;804;416;388
34;Palencia;011;Amusco;627;342;285
34;Palencia;012;Antigüedad;466;252;214
34;Palencia;015;Arconada;92;47;45
34;Palencia;017;Astudillo;1421;755;666
34;Palencia;018;Autilla del Pino;299;155;144
34;Palencia;019;Autillo de Campos;220;102;118
34;Palencia;020;Ayuela;100;57;43
34;Palencia;022;Baltanás;1630;839;791
34;Palencia;024;Baquerín de Campos;40;26;14
34;Palencia;025;Bárcena de Campos;67;28;39
34;Palencia;027;Barruelo de Santullán;2128;1006;1122
34;Palencia;028;Báscones de Ojeda;218;108;110
34;Palencia;029;Becerril de Campos;1212;587;625
34;Palencia;031;Belmonte de Campos;64;32;32
34;Palencia;032;Berzosilla;87;44;43
34;Palencia;033;Boada de Campos;28;14;14
34;Palencia;035;Boadilla de Rioseco;216;108;108
34;Palencia;034;Boadilla del Camino;221;114;107
34;Palencia;036;Brañosera;318;163;155
34;Palencia;037;Buenavista de Valdavia;466;228;238
34;Palencia;038;Bustillo de la Vega;398;212;186
34;Palencia;039;Bustillo del Páramo de Carrión;111;61;50
34;Palencia;041;Calahorra de Boedo;155;77;78
34;Palencia;042;Calzada de los Molinos;413;220;193
34;Palencia;045;Capillas;142;66;76
34;Palencia;046;Cardeñosa de Volpejera;64;29;35
34;Palencia;047;Carrión de los Condes;2522;1203;1319
34;Palencia;048;Castil de Vela;124;60;64
34;Palencia;049;Castrejón de la Peña;718;386;332
34;Palencia;050;Castrillo de Don Juan;382;212;170
34;Palencia;051;Castrillo de Onielo;202;105;97
34;Palencia;052;Castrillo de Villavega;336;165;171
34;Palencia;053;Castromocho;293;149;144
34;Palencia;055;Cervatos de la Cueza;425;219;206
34;Palencia;056;Cervera de Pisuerga;2891;1446;1445
34;Palencia;057;Cevico de la Torre;737;344;393
34;Palencia;058;Cevico Navero;327;170;157
34;Palencia;059;Cisneros;677;329;348
34;Palencia;060;Cobos de Cerrato;255;126;129
34;Palencia;061;Collazos de Boedo;176;97;79
34;Palencia;062;Congosto de Valdavia;304;164;140
34;Palencia;063;Cordovilla la Real;159;92;67
34;Palencia;066;Cubillas de Cerrato;118;59;59
34;Palencia;067;Dehesa de Montejo;350;201;149
34;Palencia;068;Dehesa de Romanos;62;33;29
34;Palencia;069;Dueñas;3096;1611;1485
34;Palencia;070;Espinosa de Cerrato;297;155;142
34;Palencia;071;Espinosa de Villagonzalo;311;151;160
34;Palencia;072;Frechilla;307;142;165
34;Palencia;073;Fresno del Río;221;118;103
34;Palencia;074;Frómista;1073;541;532
34;Palencia;076;Fuentes de Nava;885;428;457
34;Palencia;077;Fuentes de Valdepero;254;134;120
34;Palencia;079;Grijota;808;399;409
34;Palencia;080;Guardo;9242;4709;4533
34;Palencia;081;Guaza de Campos;97;48;49
34;Palencia;082;Hérmedes de Cerrato;168;78;90
34;Palencia;083;Herrera de Pisuerga;2827;1421;1406
34;Palencia;084;Herrera de Valdecañas;199;97;102
34;Palencia;086;Hontoria de Cerrato;129;65;64
34;Palencia;087;Hornillos de Cerrato;167;78;89
34;Palencia;088;Husillos;227;120;107
34;Palencia;089;Itero de la Vega;274;146;128
34;Palencia;091;Lagartos;193;103;90
34;Palencia;092;Lantadilla;623;301;322
34;Palencia;094;Ledigos;121;60;61
34;Palencia;903;Loma de Ucieza;377;194;183
34;Palencia;096;Lomas;69;32;37
34;Palencia;098;Magaz de Pisuerga;724;370;354
34;Palencia;099;Manquillos;87;47;40
34;Palencia;100;Mantinos;218;114;104
34;Palencia;101;Marcilla de Campos;86;39;47
34;Palencia;102;Mazariegos;295;157;138
34;Palencia;103;Mazuecos de Valdeginate;158;80;78
34;Palencia;104;Melgar de Yuso;461;249;212
34;Palencia;106;Meneses de Campos;180;99;81
34;Palencia;107;Micieces de Ojeda;133;67;66
34;Palencia;108;Monzón de Campos;881;460;421
34;Palencia;109;Moratinos;96;48;48
34;Palencia;110;Mudá;163;81;82
34;Palencia;112;Nogal de las Huertas;93;54;39
34;Palencia;113;Olea de Boedo;52;24;28
34;Palencia;114;Olmos de Ojeda;438;236;202
34;Palencia;116;Osornillo;114;59;55
34;Palencia;901;Osorno la Mayor;1875;974;901
34;Palencia;120;Palencia;79867;38355;41512
34;Palencia;121;Palenzuela;368;194;174
34;Palencia;122;Páramo de Boedo;134;67;67
34;Palencia;123;Paredes de Nava;2596;1288;1308
34;Palencia;124;Payo de Ojeda;106;56;50
34;Palencia;125;Pedraza de Campos;164;86;78
34;Palencia;126;Pedrosa de la Vega;419;229;190
34;Palencia;127;Perales;156;81;75
34;Palencia;904;Pernía (La);525;279;246
34;Palencia;129;Pino del Río;282;157;125
34;Palencia;130;Piña de Campos;346;185;161
34;Palencia;131;Población de Arroyo;101;57;44
34;Palencia;132;Población de Campos;237;127;110
34;Palencia;133;Población de Cerrato;133;72;61
34;Palencia;134;Polentinos;133;69;64
34;Palencia;135;Pomar de Valdivia;596;294;302
34;Palencia;136;Poza de la Vega;296;169;127
34;Palencia;137;Pozo de Urama;49;26;23
34;Palencia;139;Prádanos de Ojeda;262;131;131
34;Palencia;140;Puebla de Valdavia (La);188;95;93
34;Palencia;141;Quintana del Puente;308;156;152
34;Palencia;143;Quintanilla de Onsoña;288;164;124
34;Palencia;146;Reinoso de Cerrato;101;59;42
34;Palencia;147;Renedo de la Vega;298;167;131
34;Palencia;149;Requena de Campos;57;29;28
34;Palencia;151;Respenda de la Peña;341;186;155
34;Palencia;152;Revenga de Campos;207;99;108
34;Palencia;154;Revilla de Collazos;99;55;44
34;Palencia;155;Ribas de Campos;240;128;112
34;Palencia;156;Riberos de la Cueza;91;47;44
34;Palencia;157;Saldaña;3173;1631;1542
34;Palencia;158;Salinas de Pisuerga;308;167;141
34;Palencia;159;San Cebrián de Campos;532;296;236
34;Palencia;160;San Cebrián de Mudá;258;129;129
34;Palencia;161;San Cristóbal de Boedo;57;31;26
34;Palencia;163;San Mamés de Campos;135;59;76
34;Palencia;165;San Román de la Cuba;147;77;70
34;Palencia;167;Santa Cecilia del Alcor;184;99;85
34;Palencia;168;Santa Cruz de Boedo;86;45;41
34;Palencia;169;Santervás de la Vega;610;332;278
34;Palencia;170;Santibáñez de Ecla;118;50;68
34;Palencia;171;Santibáñez de la Peña;1776;893;883
34;Palencia;174;Santoyo;332;160;172
34;Palencia;175;Serna (La);151;87;64
34;Palencia;177;Soto de Cerrato;224;114;110
34;Palencia;176;Sotobañado y Priorato;202;106;96
34;Palencia;178;Tabanera de Cerrato;193;98;95
34;Palencia;179;Tabanera de Valdavia;60;26;34
34;Palencia;180;Támara de Campos;102;52;50
34;Palencia;181;Tariego de Cerrato;550;282;268
34;Palencia;182;Torquemada;1344;663;681
34;Palencia;184;Torremormojón;101;49;52
34;Palencia;185;Triollo;133;76;57
34;Palencia;186;Valbuena de Pisuerga;88;51;37
34;Palencia;189;Valdeolmillos;102;50;52
34;Palencia;190;Valderrábano;111;60;51
34;Palencia;192;Valde-Ucieza;145;82;63
34;Palencia;196;Valle de Cerrato;144;79;65
34;Palencia;902;Valle del Retortillo;277;138;139
34;Palencia;199;Velilla del Río Carrión;2054;1053;1001
34;Palencia;023;Venta de Baños;6952;3469;3483
34;Palencia;201;Vertavillo;272;147;125
34;Palencia;093;Vid de Ojeda (La);154;91;63
34;Palencia;202;Villabasta de Valdavia;46;22;24
34;Palencia;204;Villacidaler;91;46;45
34;Palencia;205;Villaconancio;99;49;50
34;Palencia;206;Villada;1402;685;717
34;Palencia;208;Villaeles de Valdavia;101;55;46
34;Palencia;210;Villahán;151;84;67
34;Palencia;211;Villaherreros;322;149;173
34;Palencia;213;Villalaco;87;38;49
34;Palencia;214;Villalba de Guardo;229;122;107
34;Palencia;215;Villalcázar de Sirga;245;117;128
34;Palencia;216;Villalcón;104;50;54
34;Palencia;217;Villalobón;274;148;126
34;Palencia;218;Villaluenga de la Vega;739;416;323
34;Palencia;220;Villamartín de Campos;179;96;83
34;Palencia;221;Villamediana;287;145;142
34;Palencia;222;Villameriel;178;90;88
34;Palencia;223;Villamoronta;352;185;167
34;Palencia;224;Villamuera de la Cueza;93;53;40
34;Palencia;225;Villamuriel de Cerrato;4336;2211;2125
34;Palencia;227;Villanueva del Rebollar;120;61;59
34;Palencia;228;Villanuño de Valdavia;144;80;64
34;Palencia;229;Villaprovedo;115;69;46
34;Palencia;230;Villarmentero de Campos;24;12;12
34;Palencia;231;Villarrabé;321;162;159
34;Palencia;232;Villarramiel;1222;611;611
34;Palencia;233;Villasarracino;344;171;173
34;Palencia;234;Villasila de Valdavia;122;64;58
34;Palencia;236;Villaturde;308;154;154
34;Palencia;237;Villaumbrales;945;498;447
34;Palencia;238;Villaviudas;489;236;253
34;Palencia;240;Villerías de Campos;139;76;63
34;Palencia;241;Villodre;48;27;21
34;Palencia;242;Villodrigo;143;73;70
34;Palencia;243;Villoldo;539;278;261
34;Palencia;245;Villota del Páramo;509;290;219
34;Palencia;246;Villovieco;142;77;65
35;Palmas (Las);001;Agaete;5505;2775;2730
35;Palmas (Las);002;Agüimes;18078;9198;8880
35;Palmas (Las);003;Antigua;2874;1538;1336
35;Palmas (Las);004;Arrecife;36992;18721;18271
35;Palmas (Las);005;Artenara;1142;587;555
35;Palmas (Las);006;Arucas;28521;14314;14207
35;Palmas (Las);007;Betancuria;594;311;283
35;Palmas (Las);008;Firgas;6307;3187;3120
35;Palmas (Las);009;Gáldar;22081;11129;10952
35;Palmas (Las);010;Haría;3227;1657;1570
35;Palmas (Las);011;Ingenio;23433;11934;11499
35;Palmas (Las);016;Las Palmas de Gran Canaria;373772;183978;189794
35;Palmas (Las);012;Mogán;10772;5635;5137
35;Palmas (Las);013;Moya;8440;4267;4173
35;Palmas (Las);014;Oliva (La);6789;3574;3215
35;Palmas (Las);015;Pájara;6055;3209;2846
35;Palmas (Las);017;Puerto del Rosario;18835;10146;8689
35;Palmas (Las);018;San Bartolomé;9156;4727;4429
35;Palmas (Las);019;San Bartolomé de Tirajana;35750;18694;17056
35;Palmas (Las);020;San Nicolás de Tolentino;8089;4061;4028
35;Palmas (Las);021;Santa Brígida;14982;7483;7499
35;Palmas (Las);022;Santa Lucía de Tirajana;38445;19651;18794
35;Palmas (Las);023;Santa María de Guía de Gran Canaria;12767;6445;6322
35;Palmas (Las);024;Teguise;9613;4991;4622
35;Palmas (Las);025;Tejeda;2473;1252;1221
35;Palmas (Las);026;Telde;84799;42582;42217
35;Palmas (Las);027;Teror;11544;5840;5704
35;Palmas (Las);028;Tías;10437;5488;4949
35;Palmas (Las);029;Tinajo;3692;1881;1811
35;Palmas (Las);030;Tuineje;7735;4053;3682
35;Palmas (Las);032;Valleseco;4477;2284;2193
35;Palmas (Las);031;Valsequillo de Gran Canaria;7315;3723;3592
35;Palmas (Las);033;Vega de San Mateo;6153;3139;3014
35;Palmas (Las);034;Yaiza;3296;1747;1549
36;Pontevedra;020;Agolada;5094;2502;2592
36;Pontevedra;001;Arbo;5020;2456;2564
36;Pontevedra;003;Baiona;10931;5356;5575
36;Pontevedra;002;Barro;3679;1763;1916
36;Pontevedra;004;Bueu;12918;6393;6525
36;Pontevedra;005;Caldas de Reis;9430;4563;4867
36;Pontevedra;006;Cambados;13190;6471;6719
36;Pontevedra;007;Campo Lameiro;2645;1266;1379
36;Pontevedra;008;Cangas;24362;12067;12295
36;Pontevedra;009;Cañiza (A);7959;3830;4129
36;Pontevedra;010;Catoira;3726;1831;1895
36;Pontevedra;011;Cerdedo;3701;1683;2018
36;Pontevedra;012;Cotobade;5378;2465;2913
36;Pontevedra;013;Covelo;4653;2124;2529
36;Pontevedra;014;Crecente;4060;1904;2156
36;Pontevedra;015;Cuntis;5936;2747;3189
36;Pontevedra;016;Dozón;2733;1355;1378
36;Pontevedra;017;Estrada (A);22995;10811;12184
36;Pontevedra;018;Forcarei;5823;2776;3047
36;Pontevedra;019;Fornelos de Montes;2482;1159;1323
36;Pontevedra;021;Gondomar;11284;5560;5724
36;Pontevedra;022;Grove (O);11007;5449;5558
36;Pontevedra;023;Guarda (A);10504;5097;5407
36;Pontevedra;901;Illa de Arousa (A);"";"";""
36;Pontevedra;024;Lalín;21157;10355;10802
36;Pontevedra;025;Lama (A);3517;1605;1912
36;Pontevedra;026;Marín;25689;12530;13159
36;Pontevedra;027;Meaño;5507;2643;2864
36;Pontevedra;028;Meis;5087;2403;2684
36;Pontevedra;029;Moaña;18307;8898;9409
36;Pontevedra;030;Mondariz;6659;3192;3467
36;Pontevedra;031;Mondariz-Balneario;667;314;353
36;Pontevedra;032;Moraña;4793;2300;2493
36;Pontevedra;033;Mos;13987;6806;7181
36;Pontevedra;034;Neves (As);5320;2515;2805
36;Pontevedra;035;Nigrán;15114;7416;7698
36;Pontevedra;036;Oia;3220;1621;1599
36;Pontevedra;037;Pazos de Borbén;3585;1673;1912
36;Pontevedra;041;Poio;13765;6690;7075
36;Pontevedra;043;Ponte Caldelas;7997;3805;4192
36;Pontevedra;042;Ponteareas;16567;7931;8636
36;Pontevedra;044;Pontecesures;2897;1422;1475
36;Pontevedra;038;Pontevedra;77282;36709;40573
36;Pontevedra;039;Porriño (O);16274;7873;8401
36;Pontevedra;040;Portas;3386;1586;1800
36;Pontevedra;045;Redondela;29222;14211;15011
36;Pontevedra;046;Ribadumia;4180;2025;2155
36;Pontevedra;047;Rodeiro;4854;2519;2335
36;Pontevedra;048;Rosal (O);5898;2877;3021
36;Pontevedra;049;Salceda de Caselas;6023;2963;3060
36;Pontevedra;050;Salvaterra de Miño;9025;4315;4710
36;Pontevedra;051;Sanxenxo;15836;7829;8007
36;Pontevedra;052;Silleda;10181;4921;5260
36;Pontevedra;053;Soutomaior;5122;2466;2656
36;Pontevedra;054;Tomiño;10573;5155;5418
36;Pontevedra;055;Tui;16144;7685;8459
36;Pontevedra;056;Valga;6504;3180;3324
36;Pontevedra;057;Vigo;290582;138736;151846
36;Pontevedra;059;Vila de Cruces;7628;3737;3891
36;Pontevedra;058;Vilaboa;5935;2895;3040
36;Pontevedra;060;Vilagarcía de Arousa;34022;16472;17550
36;Pontevedra;061;Vilanova de Arousa;15795;7777;8018
37;Salamanca;001;Abusejo;315;158;157
37;Salamanca;002;Agallas;230;118;112
37;Salamanca;003;Ahigal de los Aceiteros;231;115;116
37;Salamanca;004;Ahigal de Villarino;55;28;27
37;Salamanca;005;Alameda de Gardón (La);169;79;90
37;Salamanca;006;Alamedilla (La);248;120;128
37;Salamanca;007;Alaraz;709;373;336
37;Salamanca;008;Alba de Tormes;4571;2230;2341
37;Salamanca;009;Alba de Yeltes;306;150;156
37;Salamanca;010;Alberca (La);1137;583;554
37;Salamanca;011;Alberguería de Argañán (La);217;112;105
37;Salamanca;012;Alconada;254;126;128
37;Salamanca;015;Aldea del Obispo;461;238;223
37;Salamanca;013;Aldeacipreste;323;177;146
37;Salamanca;014;Aldeadávila de la Ribera;1725;879;846
37;Salamanca;016;Aldealengua;514;252;262
37;Salamanca;017;Aldeanueva de Figueroa;393;198;195
37;Salamanca;018;Aldeanueva de la Sierra;114;59;55
37;Salamanca;019;Aldearrodrigo;227;116;111
37;Salamanca;020;Aldearrubia;505;263;242
37;Salamanca;021;Aldeaseca de Alba;154;78;76
37;Salamanca;022;Aldeaseca de la Frontera;403;202;201
37;Salamanca;023;Aldeatejada;579;279;300
37;Salamanca;024;Aldeavieja de Tormes;139;65;74
37;Salamanca;025;Aldehuela de la Bóveda;400;204;196
37;Salamanca;026;Aldehuela de Yeltes;367;183;184
37;Salamanca;027;Almenara de Tormes;257;127;130
37;Salamanca;028;Almendra;250;124;126
37;Salamanca;029;Anaya de Alba;340;178;162
37;Salamanca;030;Añover de Tormes;123;63;60
37;Salamanca;031;Arabayona de Mógica;587;311;276
37;Salamanca;032;Arapiles;556;273;283
37;Salamanca;033;Arcediano;103;51;52
37;Salamanca;034;Arco (El);111;58;53
37;Salamanca;035;Armenteros;366;173;193
37;Salamanca;037;Atalaya (La);178;99;79
37;Salamanca;038;Babilafuente;1013;537;476
37;Salamanca;039;Bañobárez;522;273;249
37;Salamanca;040;Barbadillo;580;278;302
37;Salamanca;041;Barbalos;141;72;69
37;Salamanca;042;Barceo;82;42;40
37;Salamanca;044;Barruecopardo;646;321;325
37;Salamanca;045;Bastida (La);50;23;27
37;Salamanca;046;Béjar;17171;8185;8986
37;Salamanca;047;Beleña;138;64;74
37;Salamanca;049;Bermellar;236;109;127
37;Salamanca;050;Berrocal de Huebra;132;59;73
37;Salamanca;051;Berrocal de Salvatierra;173;88;85
37;Salamanca;052;Boada;480;238;242
37;Salamanca;054;Bodón (El);382;198;184
37;Salamanca;055;Bogajo;236;125;111
37;Salamanca;056;Bouza (La);75;39;36
37;Salamanca;057;Bóveda del Río Almar;346;177;169
37;Salamanca;058;Brincones;137;64;73
37;Salamanca;059;Buenamadre;189;99;90
37;Salamanca;060;Buenavista;100;54;46
37;Salamanca;061;Cabaco (El);288;145;143
37;Salamanca;063;Cabeza de Béjar (La);137;72;65
37;Salamanca;065;Cabeza del Caballo;550;285;265
37;Salamanca;062;Cabezabellosa de la Calzada;147;79;68
37;Salamanca;067;Cabrerizos;1249;621;628
37;Salamanca;068;Cabrillas;598;282;316
37;Salamanca;069;Calvarrasa de Abajo;1090;546;544
37;Salamanca;070;Calvarrasa de Arriba;646;339;307
37;Salamanca;071;Calzada de Béjar (La);108;58;50
37;Salamanca;072;Calzada de Don Diego;313;151;162
37;Salamanca;073;Calzada de Valdunciel;683;341;342
37;Salamanca;074;Campillo de Azaba;316;154;162
37;Salamanca;077;Campo de Peñaranda (El);448;232;216
37;Salamanca;078;Candelario;1175;585;590
37;Salamanca;079;Canillas de Abajo;141;76;65
37;Salamanca;080;Cantagallo;291;138;153
37;Salamanca;081;Cantalapiedra;1546;766;780
37;Salamanca;082;Cantalpino;1268;679;589
37;Salamanca;083;Cantaracillo;317;163;154
37;Salamanca;085;Carbajosa de la Sagrada;930;479;451
37;Salamanca;086;Carpio de Azaba;117;58;59
37;Salamanca;087;Carrascal de Barregas;281;141;140
37;Salamanca;088;Carrascal del Obispo;257;126;131
37;Salamanca;089;Casafranca;92;42;50
37;Salamanca;090;Casas del Conde (Las);107;49;58
37;Salamanca;091;Casillas de Flores;283;133;150
37;Salamanca;092;Castellanos de Moriscos;379;180;199
37;Salamanca;185;Castellanos de Villiquera;546;283;263
37;Salamanca;096;Castillejo de Martín Viejo;331;166;165
37;Salamanca;097;Castraz;81;49;32
37;Salamanca;098;Cepeda;576;273;303
37;Salamanca;099;Cereceda de la Sierra;118;62;56
37;Salamanca;100;Cerezal de Peñahorcada;154;77;77
37;Salamanca;101;Cerralbo;286;157;129
37;Salamanca;102;Cerro (El);605;308;297
37;Salamanca;103;Cespedosa de Tormes;718;385;333
37;Salamanca;114;Chagarcía Medianero;164;85;79
37;Salamanca;104;Cilleros de la Bastida;57;26;31
37;Salamanca;106;Cipérez;518;258;260
37;Salamanca;107;Ciudad Rodrigo;15664;7592;8072
37;Salamanca;108;Coca de Alba;201;96;105
37;Salamanca;109;Colmenar de Montemayor;316;169;147
37;Salamanca;110;Cordovilla;146;80;66
37;Salamanca;112;Cristóbal;242;133;109
37;Salamanca;113;Cubo de Don Sancho (El);663;356;307
37;Salamanca;115;Dios le Guarde;175;97;78
37;Salamanca;116;Doñinos de Ledesma;117;60;57
37;Salamanca;117;Doñinos de Salamanca;669;341;328
37;Salamanca;118;Ejeme;280;147;133
37;Salamanca;120;Encina de San Silvestre;130;66;64
37;Salamanca;119;Encina (La);255;138;117
37;Salamanca;121;Encinas de Abajo;742;382;360
37;Salamanca;122;Encinas de Arriba;303;149;154
37;Salamanca;123;Encinasola de los Comendadores;336;174;162
37;Salamanca;124;Endrinal;315;170;145
37;Salamanca;125;Escurial de la Sierra;339;168;171
37;Salamanca;126;Espadaña;62;33;29
37;Salamanca;127;Espeja;343;172;171
37;Salamanca;128;Espino de la Orbada;376;183;193
37;Salamanca;129;Florida de Liébana;261;143;118
37;Salamanca;130;Forfoleda;250;124;126
37;Salamanca;131;Frades de la Sierra;309;161;148
37;Salamanca;132;Fregeneda (La);636;298;338
37;Salamanca;133;Fresnedoso;141;65;76
37;Salamanca;134;Fresno Alhándiga;375;211;164
37;Salamanca;135;Fuente de San Esteban (La);1732;880;852
37;Salamanca;136;Fuenteguinaldo;1053;531;522
37;Salamanca;137;Fuenteliante;158;69;89
37;Salamanca;138;Fuenterroble de Salvatierra;283;144;139
37;Salamanca;139;Fuentes de Béjar;320;133;187
37;Salamanca;140;Fuentes de Oñoro;1404;698;706
37;Salamanca;141;Gajates;283;148;135
37;Salamanca;142;Galindo y Perahuy;262;135;127
37;Salamanca;143;Galinduste;622;310;312
37;Salamanca;144;Galisancho;593;317;276
37;Salamanca;145;Gallegos de Argañán;503;253;250
37;Salamanca;146;Gallegos de Solmirón;241;111;130
37;Salamanca;147;Garcibuey;321;181;140
37;Salamanca;148;Garcihernández;648;355;293
37;Salamanca;149;Garcirrey;114;57;57
37;Salamanca;150;Gejuelo del Barro;55;31;24
37;Salamanca;151;Golpejas;220;116;104
37;Salamanca;152;Gomecello;608;310;298
37;Salamanca;154;Guadramiro;254;140;114
37;Salamanca;155;Guijo de Ávila;120;67;53
37;Salamanca;156;Guijuelo;5112;2557;2555
37;Salamanca;157;Herguijuela de Ciudad Rodrigo;176;90;86
37;Salamanca;158;Herguijuela de la Sierra;394;194;200
37;Salamanca;159;Herguijuela del Campo;157;78;79
37;Salamanca;160;Hinojosa de Duero;925;447;478
37;Salamanca;161;Horcajo de Montemayor;203;102;101
37;Salamanca;162;Horcajo Medianero;441;221;220
37;Salamanca;163;Hoya (La);30;20;10
37;Salamanca;164;Huerta;281;147;134
37;Salamanca;165;Iruelos;77;33;44
37;Salamanca;166;Ituero de Azaba;338;174;164
37;Salamanca;167;Juzbado;198;102;96
37;Salamanca;168;Lagunilla;766;404;362
37;Salamanca;169;Larrodrigo;357;191;166
37;Salamanca;170;Ledesma;2021;997;1024
37;Salamanca;171;Ledrada;620;300;320
37;Salamanca;172;Linares de Riofrío;1179;604;575
37;Salamanca;173;Lumbrales;2370;1184;1186
37;Salamanca;175;Machacón;557;278;279
37;Salamanca;174;Macotera;1825;922;903
37;Salamanca;176;Madroñal;170;86;84
37;Salamanca;177;Maíllo (El);451;230;221
37;Salamanca;178;Malpartida;188;102;86
37;Salamanca;179;Mancera de Abajo;422;213;209
37;Salamanca;180;Manzano (El);116;62;54
37;Salamanca;181;Martiago;479;237;242
37;Salamanca;183;Martín de Yeltes;573;286;287
37;Salamanca;182;Martinamor;91;48;43
37;Salamanca;184;Masueco;503;253;250
37;Salamanca;186;Mata de Ledesma (La);165;77;88
37;Salamanca;187;Matilla de los Caños del Río;762;390;372
37;Salamanca;188;Maya (La);272;148;124
37;Salamanca;189;Membribe de la Sierra;166;78;88
37;Salamanca;190;Mieza;421;217;204
37;Salamanca;191;Milano (El);192;101;91
37;Salamanca;192;Miranda de Azán;177;86;91
37;Salamanca;193;Miranda del Castañar;643;339;304
37;Salamanca;194;Mogarraz;406;191;215
37;Salamanca;195;Molinillo;92;46;46
37;Salamanca;196;Monforte de la Sierra;146;78;68
37;Salamanca;197;Monleón;148;91;57
37;Salamanca;198;Monleras;306;152;154
37;Salamanca;199;Monsagro;275;155;120
37;Salamanca;200;Montejo;256;133;123
37;Salamanca;201;Montemayor del Río;379;190;189
37;Salamanca;202;Monterrubio de Armuña;286;149;137
37;Salamanca;203;Monterrubio de la Sierra;173;89;84
37;Salamanca;204;Morasverdes;506;260;246
37;Salamanca;205;Morille;204;107;97
37;Salamanca;206;Moríñigo;159;88;71
37;Salamanca;207;Moriscos;147;82;65
37;Salamanca;208;Moronta;159;79;80
37;Salamanca;209;Mozárbez;405;206;199
37;Salamanca;211;Narros de Matalayegua;350;184;166
37;Salamanca;213;Nava de Béjar;129;60;69
37;Salamanca;214;Nava de Francia;163;83;80
37;Salamanca;215;Nava de Sotrobal;234;125;109
37;Salamanca;212;Navacarros;103;52;51
37;Salamanca;216;Navales;413;237;176
37;Salamanca;217;Navalmoral de Béjar;86;38;48
37;Salamanca;218;Navamorales;203;112;91
37;Salamanca;219;Navarredonda de la Rinconada;289;139;150
37;Salamanca;221;Navasfrías;782;388;394
37;Salamanca;222;Negrilla de Palencia;116;57;59
37;Salamanca;223;Olmedo de Camaces;209;100;109
37;Salamanca;224;Orbada (La);303;148;155
37;Salamanca;225;Pajares de la Laguna;158;79;79
37;Salamanca;226;Palacios del Arzobispo;277;145;132
37;Salamanca;228;Palaciosrubios;600;316;284
37;Salamanca;229;Palencia de Negrilla;229;116;113
37;Salamanca;230;Parada de Arriba;247;129;118
37;Salamanca;231;Parada de Rubiales;377;191;186
37;Salamanca;232;Paradinas de San Juan;663;348;315
37;Salamanca;233;Pastores;77;39;38
37;Salamanca;234;Payo (El);562;262;300
37;Salamanca;235;Pedraza de Alba;311;167;144
37;Salamanca;236;Pedrosillo de Alba;303;153;150
37;Salamanca;237;Pedrosillo de los Aires;481;254;227
37;Salamanca;238;Pedrosillo el Ralo;142;71;71
37;Salamanca;239;Pedroso de la Armuña (El);341;167;174
37;Salamanca;240;Pelabravo;677;348;329
37;Salamanca;241;Pelarrodríguez;231;128;103
37;Salamanca;242;Pelayos;82;42;40
37;Salamanca;243;Peña (La);170;79;91
37;Salamanca;244;Peñacaballera;240;110;130
37;Salamanca;245;Peñaparda;532;254;278
37;Salamanca;246;Peñaranda de Bracamonte;6465;3168;3297
37;Salamanca;247;Peñarandilla;323;165;158
37;Salamanca;248;Peralejos de Abajo;235;112;123
37;Salamanca;249;Peralejos de Arriba;84;46;38
37;Salamanca;250;Pereña de la Ribera;587;299;288
37;Salamanca;251;Peromingo;174;82;92
37;Salamanca;252;Pinedas;241;121;120
37;Salamanca;253;Pino de Tormes (El);175;92;83
37;Salamanca;254;Pitiegua;278;134;144
37;Salamanca;255;Pizarral;101;48;53
37;Salamanca;256;Poveda de las Cintas;405;215;190
37;Salamanca;257;Pozos de Hinojo;107;58;49
37;Salamanca;258;Puebla de Azaba;332;171;161
37;Salamanca;259;Puebla de San Medel;76;39;37
37;Salamanca;260;Puebla de Yeltes;264;139;125
37;Salamanca;261;Puente del Congosto;381;186;195
37;Salamanca;262;Puertas;123;66;57
37;Salamanca;263;Puerto de Béjar;541;255;286
37;Salamanca;264;Puerto Seguro;117;59;58
37;Salamanca;265;Rágama;375;201;174
37;Salamanca;266;Redonda (La);112;51;61
37;Salamanca;267;Retortillo;271;126;145
37;Salamanca;268;Rinconada de la Sierra (La);187;92;95
37;Salamanca;269;Robleda;628;332;296
37;Salamanca;270;Robliza de Cojos;225;112;113
37;Salamanca;271;Rollán;630;322;308
37;Salamanca;272;Saelices el Chico;216;114;102
37;Salamanca;273;Sagrada (La);208;102;106
37;Salamanca;303;Sahugo (El);342;176;166
37;Salamanca;274;Salamanca;167316;79086;88230
37;Salamanca;275;Saldeana;205;106;99
37;Salamanca;276;Salmoral;395;201;194
37;Salamanca;277;Salvatierra de Tormes;76;38;38
37;Salamanca;278;San Cristóbal de la Cuesta;274;143;131
37;Salamanca;284;San Esteban de la Sierra;492;252;240
37;Salamanca;285;San Felices de los Gallegos;694;345;349
37;Salamanca;286;San Martín del Castañar;302;156;146
37;Salamanca;287;San Miguel de Valero;445;224;221
37;Salamanca;036;San Miguel del Robledo;106;53;53
37;Salamanca;288;San Morales;193;103;90
37;Salamanca;289;San Muñoz;417;204;213
37;Salamanca;291;San Pedro de Rozados;410;208;202
37;Salamanca;290;San Pedro del Valle;136;68;68
37;Salamanca;292;San Pelayo de Guareña;121;63;58
37;Salamanca;280;Sanchón de la Ribera;153;77;76
37;Salamanca;281;Sanchón de la Sagrada;63;34;29
37;Salamanca;282;Sanchotello;355;180;175
37;Salamanca;279;Sancti-Spíritus;1297;658;639
37;Salamanca;283;Sando;252;144;108
37;Salamanca;293;Santa María de Sando;226;122;104
37;Salamanca;294;Santa Marta de Tormes;8801;4379;4422
37;Salamanca;296;Santiago de la Puebla;660;347;313
37;Salamanca;297;Santibáñez de Béjar;746;372;374
37;Salamanca;298;Santibáñez de la Sierra;255;137;118
37;Salamanca;299;Santiz;317;168;149
37;Salamanca;300;Santos (Los);808;428;380
37;Salamanca;301;Sardón de los Frailes;117;65;52
37;Salamanca;302;Saucelle;506;251;255
37;Salamanca;304;Sepulcro-Hilario;329;167;162
37;Salamanca;305;Sequeros;285;131;154
37;Salamanca;306;Serradilla del Arroyo;490;257;233
37;Salamanca;307;Serradilla del Llano;361;181;180
37;Salamanca;309;Sierpe (La);60;32;28
37;Salamanca;310;Sieteiglesias de Tormes;171;91;80
37;Salamanca;311;Sobradillo;403;196;207
37;Salamanca;312;Sorihuela;447;218;229
37;Salamanca;313;Sotoserrano;769;393;376
37;Salamanca;314;Tabera de Abajo;130;64;66
37;Salamanca;315;Tala (La);166;85;81
37;Salamanca;316;Tamames;1117;564;553
37;Salamanca;317;Tarazona de Guareña;463;250;213
37;Salamanca;318;Tardáguila;280;148;132
37;Salamanca;319;Tejado (El);208;103;105
37;Salamanca;320;Tejeda y Segoyuela;145;78;67
37;Salamanca;321;Tenebrón;232;115;117
37;Salamanca;322;Terradillos;2594;1326;1268
37;Salamanca;323;Topas;785;404;381
37;Salamanca;324;Tordillos;654;329;325
37;Salamanca;325;Tornadizo (El);162;86;76
37;Salamanca;327;Torresmenudas;263;129;134
37;Salamanca;328;Trabanca;271;138;133
37;Salamanca;329;Tremedal de Tormes;61;31;30
37;Salamanca;330;Valdecarros;471;245;226
37;Salamanca;331;Valdefuentes de Sangusín;350;173;177
37;Salamanca;332;Valdehijaderos;129;75;54
37;Salamanca;333;Valdelacasa;352;188;164
37;Salamanca;334;Valdelageve;142;78;64
37;Salamanca;335;Valdelosa;505;243;262
37;Salamanca;336;Valdemierque;75;39;36
37;Salamanca;337;Valderrodrigo;212;104;108
37;Salamanca;338;Valdunciel;139;68;71
37;Salamanca;339;Valero;518;262;256
37;Salamanca;343;Vallejera de Riofrío;68;32;36
37;Salamanca;340;Valsalabroso;253;134;119
37;Salamanca;341;Valverde de Valdelacasa;85;41;44
37;Salamanca;342;Valverdón;283;150;133
37;Salamanca;344;Vecinos;346;173;173
37;Salamanca;345;Vega de Tirados;259;134;125
37;Salamanca;346;Veguillas (Las);335;158;177
37;Salamanca;347;Vellés (La);496;256;240
37;Salamanca;348;Ventosa del Río Almar;175;86;89
37;Salamanca;349;Vídola (La);216;112;104
37;Salamanca;351;Villaflores;520;262;258
37;Salamanca;352;Villagonzalo de Tormes;254;140;114
37;Salamanca;353;Villalba de los Llanos;225;127;98
37;Salamanca;354;Villamayor;1847;936;911
37;Salamanca;355;Villanueva del Conde;286;145;141
37;Salamanca;356;Villar de Argañán;130;65;65
37;Salamanca;357;Villar de Ciervo;450;238;212
37;Salamanca;358;Villar de Gallimazo;268;141;127
37;Salamanca;359;Villar de la Yegua;356;172;184
37;Salamanca;360;Villar de Peralonso;393;187;206
37;Salamanca;361;Villar de Samaniego;141;74;67
37;Salamanca;362;Villares de la Reina;1592;792;800
37;Salamanca;363;Villares de Yeltes;193;92;101
37;Salamanca;364;Villarino de los Aires;1214;593;621
37;Salamanca;365;Villarmayor;244;124;120
37;Salamanca;366;Villarmuerto;73;41;32
37;Salamanca;367;Villasbuenas;360;182;178
37;Salamanca;368;Villasdardo;33;17;16
37;Salamanca;369;Villaseco de los Gamitos;227;113;114
37;Salamanca;370;Villaseco de los Reyes;461;236;225
37;Salamanca;371;Villasrubias;447;243;204
37;Salamanca;372;Villaverde de Guareña;220;110;110
37;Salamanca;373;Villavieja de Yeltes;1176;593;583
37;Salamanca;374;Villoria;1420;696;724
37;Salamanca;375;Villoruela;1084;541;543
37;Salamanca;350;Vilvestre;688;337;351
37;Salamanca;376;Vitigudino;3213;1573;1640
37;Salamanca;377;Yecla de Yeltes;414;203;211
37;Salamanca;378;Zamarra;176;95;81
37;Salamanca;379;Zamayón;211;117;94
37;Salamanca;380;Zarapicos;79;41;38
37;Salamanca;381;Zarza de Pumareda (La);228;129;99
37;Salamanca;382;Zorita de la Frontera;332;176;156
38;Santa Cruz de Tenerife;001;Adeje;13272;6772;6500
38;Santa Cruz de Tenerife;002;Agulo;1183;592;591
38;Santa Cruz de Tenerife;003;Alajeró;1224;631;593
38;Santa Cruz de Tenerife;004;Arafo;4557;2216;2341
38;Santa Cruz de Tenerife;005;Arico;4963;2547;2416
38;Santa Cruz de Tenerife;006;Arona;29730;15006;14724
38;Santa Cruz de Tenerife;007;Barlovento;2694;1345;1349
38;Santa Cruz de Tenerife;008;Breña Alta;5567;2773;2794
38;Santa Cruz de Tenerife;009;Breña Baja;3537;1757;1780
38;Santa Cruz de Tenerife;010;Buenavista del Norte;5577;2837;2740
38;Santa Cruz de Tenerife;011;Candelaria;12105;6025;6080
38;Santa Cruz de Tenerife;012;Fasnia;2509;1260;1249
38;Santa Cruz de Tenerife;013;Frontera;4166;2126;2040
38;Santa Cruz de Tenerife;014;Fuencaliente de la Palma;1804;915;889
38;Santa Cruz de Tenerife;015;Garachico;6061;2982;3079
38;Santa Cruz de Tenerife;016;Garafía;2032;1020;1012
38;Santa Cruz de Tenerife;017;Granadilla de Abona;18507;9409;9098
38;Santa Cruz de Tenerife;018;Guancha (La);5384;2679;2705
38;Santa Cruz de Tenerife;019;Guía de Isora;13173;6506;6667
38;Santa Cruz de Tenerife;020;Güímar;15391;7654;7737
38;Santa Cruz de Tenerife;021;Hermigua;2140;1116;1024
38;Santa Cruz de Tenerife;022;Icod de los Vinos;22127;10954;11173
38;Santa Cruz de Tenerife;024;Llanos de Aridane (Los);17737;8733;9004
38;Santa Cruz de Tenerife;025;Matanza de Acentejo (La);6390;3284;3106
38;Santa Cruz de Tenerife;026;Orotava (La);36189;17891;18298
38;Santa Cruz de Tenerife;027;Paso (El);7293;3630;3663
38;Santa Cruz de Tenerife;028;Puerto de la Cruz;27829;13600;14229
38;Santa Cruz de Tenerife;029;Puntagorda;1825;904;921
38;Santa Cruz de Tenerife;030;Puntallana;2296;1151;1145
38;Santa Cruz de Tenerife;031;Realejos (Los);33197;16472;16725
38;Santa Cruz de Tenerife;032;Rosario (El);10668;5429;5239
38;Santa Cruz de Tenerife;033;San Andrés y Sauces;5399;2714;2685
38;Santa Cruz de Tenerife;023;San Cristóbal de La Laguna;127743;63009;64734
38;Santa Cruz de Tenerife;034;San Juan de la Rambla;4797;2381;2416
38;Santa Cruz de Tenerife;035;San Miguel de Abona;6203;3153;3050
38;Santa Cruz de Tenerife;036;San Sebastián de la Gomera;6259;3159;3100
38;Santa Cruz de Tenerife;037;Santa Cruz de la Palma;17460;8483;8977
38;Santa Cruz de Tenerife;038;Santa Cruz de Tenerife;204948;99231;105717
38;Santa Cruz de Tenerife;039;Santa Úrsula;9385;4688;4697
38;Santa Cruz de Tenerife;040;Santiago del Teide;6879;3481;3398
38;Santa Cruz de Tenerife;041;Sauzal (El);6788;3389;3399
38;Santa Cruz de Tenerife;042;Silos (Los);5675;2793;2882
38;Santa Cruz de Tenerife;043;Tacoronte;19066;9554;9512
38;Santa Cruz de Tenerife;044;Tanque (El);3132;1574;1558
38;Santa Cruz de Tenerife;045;Tazacorte;6617;3319;3298
38;Santa Cruz de Tenerife;046;Tegueste;8527;4273;4254
38;Santa Cruz de Tenerife;047;Tijarafe;2662;1330;1332
38;Santa Cruz de Tenerife;049;Valle Gran Rey;3172;1613;1559
38;Santa Cruz de Tenerife;050;Vallehermoso;3050;1547;1503
38;Santa Cruz de Tenerife;048;Valverde;3791;1891;1900
38;Santa Cruz de Tenerife;051;Victoria de Acentejo (La);7789;3915;3874
38;Santa Cruz de Tenerife;052;Vilaflor;1629;832;797
38;Santa Cruz de Tenerife;053;Villa de Mazo;5260;2613;2647
39;Cantabria;001;Alfoz de Lloredo;2682;1374;1308
39;Cantabria;002;Ampuero;3441;1708;1733
39;Cantabria;003;Anievas;431;212;219
39;Cantabria;004;Arenas de Iguña;2246;1131;1115
39;Cantabria;005;Argoños;736;372;364
39;Cantabria;006;Arnuero;1880;949;931
39;Cantabria;007;Arredondo;699;381;318
39;Cantabria;008;Astillero (El);13081;6465;6616
39;Cantabria;009;Bárcena de Cicero;2300;1188;1112
39;Cantabria;010;Bárcena de Pie de Concha;959;456;503
39;Cantabria;011;Bareyo;1724;864;860
39;Cantabria;012;Cabezón de la Sal;7263;3573;3690
39;Cantabria;013;Cabezón de Liébana;803;429;374
39;Cantabria;014;Cabuérniga;1114;563;551
39;Cantabria;015;Camaleño;1164;602;562
39;Cantabria;016;Camargo;22232;10995;11237
39;Cantabria;027;Campoo de Enmedio;4026;2024;2002
39;Cantabria;017;Campoo de Yuso;831;412;419
39;Cantabria;018;Cartes;2780;1392;1388
39;Cantabria;019;Castañeda;1569;776;793
39;Cantabria;020;Castro-Urdiales;14907;7467;7440
39;Cantabria;021;Cieza;753;368;385
39;Cantabria;022;Cillorigo de Liébana;1139;607;532
39;Cantabria;023;Colindres;6021;2976;3045
39;Cantabria;024;Comillas;2557;1233;1324
39;Cantabria;025;Corrales de Buelna (Los);10196;5099;5097
39;Cantabria;026;Corvera de Toranzo;2219;1117;1102
39;Cantabria;028;Entrambasaguas;2509;1244;1265
39;Cantabria;029;Escalante;807;409;398
39;Cantabria;030;Guriezo;1742;906;836
39;Cantabria;031;Hazas de Cesto;1291;651;640
39;Cantabria;032;Hermandad de Campoo de Suso;1916;1020;896
39;Cantabria;033;Herrerías;799;439;360
39;Cantabria;034;Lamasón;456;250;206
39;Cantabria;035;Laredo;13989;6814;7175
39;Cantabria;036;Liendo;762;388;374
39;Cantabria;037;Liérganes;2320;1156;1164
39;Cantabria;038;Limpias;1261;631;630
39;Cantabria;039;Luena;1116;572;544
39;Cantabria;040;Marina de Cudeyo;4608;2283;2325
39;Cantabria;041;Mazcuerras;1857;975;882
39;Cantabria;042;Medio Cudeyo;5937;2930;3007
39;Cantabria;043;Meruelo;1036;531;505
39;Cantabria;044;Miengo;3380;1698;1682
39;Cantabria;045;Miera;644;316;328
39;Cantabria;046;Molledo;2082;1022;1060
39;Cantabria;047;Noja;1680;838;842
39;Cantabria;048;Penagos;1794;887;907
39;Cantabria;049;Peñarrubia;316;162;154
39;Cantabria;050;Pesaguero;464;252;212
39;Cantabria;051;Pesquera;104;50;54
39;Cantabria;052;Piélagos;9868;4870;4998
39;Cantabria;053;Polaciones;334;198;136
39;Cantabria;054;Polanco;3784;1844;1940
39;Cantabria;055;Potes;1516;760;756
39;Cantabria;056;Puente Viesgo;2444;1224;1220
39;Cantabria;057;Ramales de la Victoria;2418;1239;1179
39;Cantabria;058;Rasines;1040;524;516
39;Cantabria;059;Reinosa;12350;6003;6347
39;Cantabria;060;Reocín;6879;3427;3452
39;Cantabria;061;Ribamontán al Mar;3185;1634;1551
39;Cantabria;062;Ribamontán al Monte;2002;1030;972
39;Cantabria;063;Rionansa;1598;861;737
39;Cantabria;064;Riotuerto;1607;767;840
39;Cantabria;065;Rozas de Valdearroyo (Las);305;161;144
39;Cantabria;066;Ruente;943;485;458
39;Cantabria;067;Ruesga;1312;658;654
39;Cantabria;068;Ruiloba;729;369;360
39;Cantabria;069;San Felices de Buelna;2331;1139;1192
39;Cantabria;070;San Miguel de Aguayo;168;88;80
39;Cantabria;071;San Pedro del Romeral;787;403;384
39;Cantabria;072;San Roque de Riomiera;617;329;288
39;Cantabria;080;San Vicente de la Barquera;4568;2320;2248
39;Cantabria;073;Santa Cruz de Bezana;6354;3212;3142
39;Cantabria;074;Santa María de Cayón;6159;3072;3087
39;Cantabria;075;Santander;194837;92062;102775
39;Cantabria;076;Santillana del Mar;4028;1968;2060
39;Cantabria;077;Santiurde de Reinosa;372;201;171
39;Cantabria;078;Santiurde de Toranzo;1738;876;862
39;Cantabria;079;Santoña;12452;6437;6015
39;Cantabria;081;Saro;588;301;287
39;Cantabria;082;Selaya;2069;1050;1019
39;Cantabria;083;Soba;1817;946;871
39;Cantabria;084;Solórzano;1002;514;488
39;Cantabria;085;Suances;6209;3059;3150
39;Cantabria;086;Tojos (Los);420;224;196
39;Cantabria;087;Torrelavega;59408;28886;30522
39;Cantabria;088;Tresviso;73;41;32
39;Cantabria;089;Tudanca;292;168;124
39;Cantabria;090;Udías;836;423;413
39;Cantabria;095;Val de San Vicente;2587;1331;1256
39;Cantabria;091;Valdáliga;2698;1382;1316
39;Cantabria;092;Valdeolea;1681;861;820
39;Cantabria;093;Valdeprado del Río;364;186;178
39;Cantabria;094;Valderredible;1185;603;582
39;Cantabria;096;Vega de Liébana;1101;584;517
39;Cantabria;097;Vega de Pas;1153;577;576
39;Cantabria;098;Villacarriedo;2098;1061;1037
39;Cantabria;099;Villaescusa;2957;1436;1521
39;Cantabria;100;Villafufre;1158;589;569
39;Cantabria;101;Villaverde de Trucíos;405;213;192
39;Cantabria;102;Voto;2436;1267;1169
40;Segovia;001;Abades;885;447;438
40;Segovia;002;Adrada de Pirón;50;29;21
40;Segovia;003;Adrados;259;129;130
40;Segovia;004;Aguilafuente;802;383;419
40;Segovia;005;Alconada de Maderuelo;61;31;30
40;Segovia;012;Aldea Real;419;223;196
40;Segovia;006;Aldealcorvo;39;20;19
40;Segovia;007;Aldealengua de Pedraza;111;59;52
40;Segovia;008;Aldealengua de Santa María;104;56;48
40;Segovia;009;Aldeanueva de la Serrezuela;57;33;24
40;Segovia;010;Aldeanueva del Codonal;239;118;121
40;Segovia;013;Aldeasoña;158;72;86
40;Segovia;014;Aldehorno;96;49;47
40;Segovia;015;Aldehuela del Codonal;64;27;37
40;Segovia;016;Aldeonte;101;50;51
40;Segovia;017;Anaya;121;61;60
40;Segovia;018;Añe;125;68;57
40;Segovia;019;Arahuetes;54;27;27
40;Segovia;020;Arcones;276;145;131
40;Segovia;021;Arevalillo de Cega;41;20;21
40;Segovia;022;Armuña;306;160;146
40;Segovia;024;Ayllón;1267;637;630
40;Segovia;025;Barbolla;233;127;106
40;Segovia;026;Basardilla;103;55;48
40;Segovia;028;Bercial;151;72;79
40;Segovia;029;Bercimuel;75;34;41
40;Segovia;030;Bernardos;809;407;402
40;Segovia;031;Bernuy de Porreros;337;177;160
40;Segovia;032;Boceguillas;556;284;272
40;Segovia;033;Brieva;66;40;26
40;Segovia;034;Caballar;109;52;57
40;Segovia;035;Cabañas de Polendos;119;60;59
40;Segovia;036;Cabezuela;790;405;385
40;Segovia;037;Calabazas de Fuentidueña;88;40;48
40;Segovia;039;Campo de San Pedro;400;221;179
40;Segovia;040;Cantalejo;3502;1762;1740
40;Segovia;041;Cantimpalos;1333;682;651
40;Segovia;043;Carbonero el Mayor;2373;1190;1183
40;Segovia;044;Carrascal del Río;223;116;107
40;Segovia;045;Casla;160;85;75
40;Segovia;046;Castillejo de Mesleón;144;72;72
40;Segovia;047;Castro de Fuentidueña;102;58;44
40;Segovia;048;Castrojimeno;48;31;17
40;Segovia;049;Castroserna de Abajo;61;36;25
40;Segovia;051;Castroserracín;44;26;18
40;Segovia;052;Cedillo de la Torre;147;77;70
40;Segovia;053;Cerezo de Abajo;176;96;80
40;Segovia;054;Cerezo de Arriba;214;120;94
40;Segovia;065;Chañe;742;382;360
40;Segovia;055;Cilleruelo de San Mamés;62;30;32
40;Segovia;056;Cobos de Fuentidueña;83;36;47
40;Segovia;057;Coca;2022;1009;1013
40;Segovia;058;Codorniz;506;244;262
40;Segovia;059;Collado Hermoso;155;78;77
40;Segovia;060;Condado de Castilnovo;158;84;74
40;Segovia;061;Corral de Ayllón;127;67;60
40;Segovia;902;Cozuelos de Fuentidueña;230;115;115
40;Segovia;062;Cubillo;71;39;32
40;Segovia;063;Cuéllar;9186;4642;4544
40;Segovia;905;Cuevas de Provanco;253;137;116
40;Segovia;068;Domingo García;54;25;29
40;Segovia;069;Donhierro;116;68;48
40;Segovia;070;Duruelo;137;69;68
40;Segovia;071;Encinas;75;36;39
40;Segovia;072;Encinillas;78;40;38
40;Segovia;073;Escalona del Prado;614;320;294
40;Segovia;074;Escarabajosa de Cabezas;411;221;190
40;Segovia;075;Escobar de Polendos;237;118;119
40;Segovia;076;Espinar (El);5691;2897;2794
40;Segovia;077;Espirdo;234;129;105
40;Segovia;078;Fresneda de Cuéllar;270;146;124
40;Segovia;079;Fresno de Cantespino;238;127;111
40;Segovia;080;Fresno de la Fuente;104;56;48
40;Segovia;081;Frumales;251;129;122
40;Segovia;082;Fuente de Santa Cruz;212;110;102
40;Segovia;083;Fuente el Olmo de Fuentidueña;193;94;99
40;Segovia;084;Fuente el Olmo de Íscar;109;60;49
40;Segovia;086;Fuentepelayo;1005;508;497
40;Segovia;087;Fuentepiñel;196;99;97
40;Segovia;088;Fuenterrebollo;482;238;244
40;Segovia;089;Fuentesaúco de Fuentidueña;388;199;189
40;Segovia;091;Fuentesoto;173;92;81
40;Segovia;092;Fuentidueña;210;100;110
40;Segovia;093;Gallegos;107;56;51
40;Segovia;094;Garcillán;361;191;170
40;Segovia;095;Gomezserracín;672;348;324
40;Segovia;097;Grajera;81;43;38
40;Segovia;099;Honrubia de la Cuesta;99;48;51
40;Segovia;100;Hontalbilla;506;257;249
40;Segovia;101;Hontanares de Eresma;145;74;71
40;Segovia;103;Huertos (Los);164;83;81
40;Segovia;104;Ituero y Lama;66;39;27
40;Segovia;105;Juarros de Riomoros;80;46;34
40;Segovia;106;Juarros de Voltoya;303;162;141
40;Segovia;107;Labajos;166;92;74
40;Segovia;108;Laguna de Contreras;191;105;86
40;Segovia;109;Languilla;153;84;69
40;Segovia;110;Lastras de Cuéllar;591;308;283
40;Segovia;111;Lastras del Pozo;98;54;44
40;Segovia;112;Lastrilla (La);1050;542;508
40;Segovia;113;Losa (La);367;196;171
40;Segovia;115;Maderuelo;165;86;79
40;Segovia;903;Marazoleja;176;96;80
40;Segovia;118;Marazuela;89;42;47
40;Segovia;119;Martín Miguel;198;98;100
40;Segovia;120;Martín Muñoz de la Dehesa;179;93;86
40;Segovia;121;Martín Muñoz de las Posadas;576;294;282
40;Segovia;122;Marugán;311;154;157
40;Segovia;124;Mata de Cuéllar;331;180;151
40;Segovia;123;Matabuena;221;113;108
40;Segovia;125;Matilla (La);129;69;60
40;Segovia;126;Melque de Cercos;147;67;80
40;Segovia;127;Membibre de la Hoz;103;49;54
40;Segovia;128;Migueláñez;177;90;87
40;Segovia;129;Montejo de Arévalo;328;174;154
40;Segovia;130;Montejo de la Vega de la Serrezuela;206;113;93
40;Segovia;131;Monterrubio;64;32;32
40;Segovia;132;Moral de Hornuez;124;63;61
40;Segovia;134;Mozoncillo;1049;543;506
40;Segovia;135;Muñopedro;431;216;215
40;Segovia;136;Muñoveros;227;121;106
40;Segovia;138;Nava de la Asunción;2633;1341;1292
40;Segovia;139;Navafría;415;225;190
40;Segovia;140;Navalilla;183;89;94
40;Segovia;141;Navalmanzano;1162;597;565
40;Segovia;142;Navares de Ayuso;77;41;36
40;Segovia;143;Navares de Enmedio;178;97;81
40;Segovia;144;Navares de las Cuevas;25;13;12
40;Segovia;145;Navas de Oro;1503;753;750
40;Segovia;904;Navas de Riofrío;247;119;128
40;Segovia;146;Navas de San Antonio;315;158;157
40;Segovia;148;Nieva;404;203;201
40;Segovia;149;Olombrada;871;450;421
40;Segovia;150;Orejana;118;64;54
40;Segovia;151;Ortigosa de Pestaño;88;44;44
40;Segovia;901;Ortigosa del Monte;318;153;165
40;Segovia;152;Otero de Herreros;830;415;415
40;Segovia;154;Pajarejos;46;22;24
40;Segovia;155;Palazuelos de Eresma;2193;1098;1095
40;Segovia;156;Pedraza;461;230;231
40;Segovia;157;Pelayos del Arroyo;48;26;22
40;Segovia;158;Perosillo;37;22;15
40;Segovia;159;Pinarejos;220;123;97
40;Segovia;160;Pinarnegrillo;206;108;98
40;Segovia;161;Pradales;63;35;28
40;Segovia;162;Prádena;575;310;265
40;Segovia;163;Puebla de Pedraza;98;49;49
40;Segovia;164;Rapariegos;311;164;147
40;Segovia;165;Rebollo;144;82;62
40;Segovia;166;Remondo;391;186;205
40;Segovia;168;Riaguas de San Bartolomé;92;46;46
40;Segovia;170;Riaza;1695;905;790
40;Segovia;171;Ribota;38;21;17
40;Segovia;172;Riofrío de Riaza;60;34;26
40;Segovia;173;Roda de Eresma;107;53;54
40;Segovia;174;Sacramenia;603;324;279
40;Segovia;176;Samboal;659;339;320
40;Segovia;177;San Cristóbal de Cuéllar;266;139;127
40;Segovia;178;San Cristóbal de la Vega;185;98;87
40;Segovia;906;San Cristóbal de Segovia;"";"";""
40;Segovia;181;San Ildefonso;5127;2500;2627
40;Segovia;182;San Martín y Mudrián;320;163;157
40;Segovia;183;San Miguel de Bernuy;208;109;99
40;Segovia;184;San Pedro de Gaíllos;339;175;164
40;Segovia;179;Sanchonuño;776;389;387
40;Segovia;180;Sangarcía;536;273;263
40;Segovia;185;Santa María la Real de Nieva;1602;799;803
40;Segovia;186;Santa Marta del Cerro;58;26;32
40;Segovia;188;Santiuste de Pedraza;126;69;57
40;Segovia;189;Santiuste de San Juan Bautista;841;423;418
40;Segovia;190;Santo Domingo de Pirón;58;26;32
40;Segovia;191;Santo Tomé del Puerto;358;179;179
40;Segovia;192;Sauquillo de Cabezas;258;136;122
40;Segovia;193;Sebúlcor;290;155;135
40;Segovia;194;Segovia;55551;26775;28776
40;Segovia;195;Sepúlveda;1388;713;675
40;Segovia;196;Sequera de Fresno;61;33;28
40;Segovia;198;Sotillo;59;27;32
40;Segovia;199;Sotosalbos;104;54;50
40;Segovia;200;Tabanera la Luenga;85;45;40
40;Segovia;201;Tolocirio;69;32;37
40;Segovia;206;Torre Val de San Pedro;225;118;107
40;Segovia;202;Torreadrada;153;76;77
40;Segovia;203;Torrecaballeros;375;187;188
40;Segovia;204;Torrecilla del Pinar;355;171;184
40;Segovia;205;Torreiglesias;410;218;192
40;Segovia;207;Trescasas;177;94;83
40;Segovia;208;Turégano;1151;568;583
40;Segovia;210;Urueñas;135;75;60
40;Segovia;211;Valdeprados;57;31;26
40;Segovia;212;Valdevacas de Montejo;40;23;17
40;Segovia;213;Valdevacas y Guijar;164;87;77
40;Segovia;218;Valle de Tabladillo;188;99;89
40;Segovia;219;Vallelado;877;441;436
40;Segovia;220;Valleruela de Pedraza;73;41;32
40;Segovia;221;Valleruela de Sepúlveda;78;38;40
40;Segovia;214;Valseca;332;165;167
40;Segovia;215;Valtiendas;212;114;98
40;Segovia;216;Valverde del Majano;488;249;239
40;Segovia;222;Veganzones;327;163;164
40;Segovia;223;Vegas de Matute;267;145;122
40;Segovia;224;Ventosilla y Tejadilla;23;14;9
40;Segovia;225;Villacastín;1571;816;755
40;Segovia;228;Villaverde de Íscar;774;396;378
40;Segovia;229;Villaverde de Montejo;89;43;46
40;Segovia;230;Villeguillo;147;80;67
40;Segovia;231;Yanguas de Eresma;211;101;110
40;Segovia;233;Zarzuela del Monte;546;275;271
40;Segovia;234;Zarzuela del Pinar;627;332;295
41;Sevilla;001;Aguadulce;1992;1011;981
41;Sevilla;002;Alanís;2112;1060;1052
41;Sevilla;003;Albaida del Aljarafe;1791;915;876
41;Sevilla;004;Alcalá de Guadaira;55430;27482;27948
41;Sevilla;005;Alcalá del Río;9462;4828;4634
41;Sevilla;006;Alcolea del Río;3541;1769;1772
41;Sevilla;007;Algaba (La);12701;6403;6298
41;Sevilla;008;Algámitas;1469;756;713
41;Sevilla;009;Almadén de la Plata;1771;901;870
41;Sevilla;010;Almensilla;2154;1079;1075
41;Sevilla;011;Arahal;18375;9147;9228
41;Sevilla;012;Aznalcázar;3372;1690;1682
41;Sevilla;013;Aznalcóllar;5778;2953;2825
41;Sevilla;014;Badolatosa;3221;1653;1568
41;Sevilla;015;Benacazón;4966;2520;2446
41;Sevilla;016;Bollullos de la Mitación;6209;3123;3086
41;Sevilla;017;Bormujos;5704;2802;2902
41;Sevilla;018;Brenes;10667;5375;5292
41;Sevilla;019;Burguillos;3433;1713;1720
41;Sevilla;020;Cabezas de San Juan (Las);15930;8203;7727
41;Sevilla;021;Camas;25939;12608;13331
41;Sevilla;022;Campana (La);5484;2774;2710
41;Sevilla;023;Cantillana;9049;4540;4509
41;Sevilla;901;Cañada Rosal;2930;1471;1459
41;Sevilla;024;Carmona;24831;12505;12326
41;Sevilla;025;Carrión de los Céspedes;2356;1148;1208
41;Sevilla;026;Casariche;5178;2611;2567
41;Sevilla;027;Castilblanco de los Arroyos;4305;2176;2129
41;Sevilla;028;Castilleja de Guzmán;643;319;324
41;Sevilla;029;Castilleja de la Cuesta;16195;7944;8251
41;Sevilla;030;Castilleja del Campo;638;310;328
41;Sevilla;031;Castillo de las Guardas (El);1744;891;853
41;Sevilla;032;Cazalla de la Sierra;5263;2625;2638
41;Sevilla;033;Constantina;7449;3663;3786
41;Sevilla;034;Coria del Río;23598;11794;11804
41;Sevilla;035;Coripe;1680;863;817
41;Sevilla;036;Coronil (El);5179;2627;2552
41;Sevilla;037;Corrales (Los);4148;2129;2019
41;Sevilla;903;Cuervo de Sevilla (El);7504;3825;3679
41;Sevilla;038;Dos Hermanas;84948;42067;42881
41;Sevilla;039;Écija;37448;18445;19003
41;Sevilla;040;Espartinas;3918;2009;1909
41;Sevilla;041;Estepa;11450;5669;5781
41;Sevilla;042;Fuentes de Andalucía;7514;3733;3781
41;Sevilla;043;Garrobo (El);775;388;387
41;Sevilla;044;Gelves;4340;2112;2228
41;Sevilla;045;Gerena;5488;2760;2728
41;Sevilla;046;Gilena;3819;1937;1882
41;Sevilla;047;Gines;8073;3942;4131
41;Sevilla;048;Guadalcanal;3124;1547;1577
41;Sevilla;049;Guillena;8214;4149;4065
41;Sevilla;050;Herrera;6019;2988;3031
41;Sevilla;051;Huévar del Aljarafe;2291;1181;1110
41;Sevilla;052;Lantejuela (La);3570;1814;1756
41;Sevilla;053;Lebrija;23949;12187;11762
41;Sevilla;054;Lora de Estepa;737;370;367
41;Sevilla;055;Lora del Río;19582;9683;9899
41;Sevilla;056;Luisiana (La);4343;2227;2116
41;Sevilla;057;Madroño (El);399;204;195
41;Sevilla;058;Mairena del Alcor;15890;7964;7926
41;Sevilla;059;Mairena del Aljarafe;29708;14874;14834
41;Sevilla;060;Marchena;17940;8889;9051
41;Sevilla;061;Marinaleda;2617;1300;1317
41;Sevilla;062;Martín de la Jara;2843;1493;1350
41;Sevilla;063;Molares (Los);2794;1408;1386
41;Sevilla;064;Montellano;7069;3572;3497
41;Sevilla;065;Morón de la Frontera;29408;14719;14689
41;Sevilla;066;Navas de la Concepción (Las);2014;1011;1003
41;Sevilla;067;Olivares;7135;3623;3512
41;Sevilla;068;Osuna;17184;8519;8665
41;Sevilla;069;Palacios y Villafranca (Los);31522;16001;15521
41;Sevilla;070;Palomares del Río;3096;1490;1606
41;Sevilla;071;Paradas;7231;3464;3767
41;Sevilla;072;Pedrera;4971;2482;2489
41;Sevilla;073;Pedroso (El);2428;1207;1221
41;Sevilla;074;Peñaflor;4074;2045;2029
41;Sevilla;075;Pilas;11051;5444;5607
41;Sevilla;076;Pruna;3460;1771;1689
41;Sevilla;077;Puebla de Cazalla (La);11057;5567;5490
41;Sevilla;078;Puebla de los Infantes (La);3660;1838;1822
41;Sevilla;079;Puebla del Río (La);10888;5453;5435
41;Sevilla;080;Real de la Jara (El);1769;869;900
41;Sevilla;081;Rinconada (La);24693;12427;12266
41;Sevilla;082;Roda de Andalucía (La);4166;2075;2091
41;Sevilla;083;Ronquillo (El);1406;703;703
41;Sevilla;084;Rubio (El);3699;1857;1842
41;Sevilla;085;Salteras;2823;1418;1405
41;Sevilla;086;San Juan de Aznalfarache;23004;11175;11829
41;Sevilla;088;San Nicolás del Puerto;715;378;337
41;Sevilla;087;Sanlúcar la Mayor;10047;5017;5030
41;Sevilla;089;Santiponce;6551;3287;3264
41;Sevilla;090;Saucejo (El);4170;2096;2074
41;Sevilla;091;Sevilla;719588;345151;374437
41;Sevilla;092;Tocina;8975;4490;4485
41;Sevilla;093;Tomares;15786;7869;7917
41;Sevilla;094;Umbrete;4710;2379;2331
41;Sevilla;095;Utrera;45464;22756;22708
41;Sevilla;096;Valencina de la Concepción;5286;2678;2608
41;Sevilla;902;Villafranco del Guadalquivir;6032;3019;3013
41;Sevilla;097;Villamanrique de la Condesa;3693;1835;1858
41;Sevilla;100;Villanueva de San Juan;1683;834;849
41;Sevilla;098;Villanueva del Ariscal;4172;2006;2166
41;Sevilla;099;Villanueva del Río y Minas;6259;3006;3253
41;Sevilla;101;Villaverde del Río;6838;3495;3343
41;Sevilla;102;Viso del Alcor (El);15685;7978;7707
42;Soria;001;Abejar;393;198;195
42;Soria;003;Adradas;118;60;58
42;Soria;004;Ágreda;3632;1809;1823
42;Soria;006;Alconaba;177;100;77
42;Soria;007;Alcubilla de Avellaneda;249;133;116
42;Soria;008;Alcubilla de las Peñas;114;54;60
42;Soria;009;Aldealafuente;166;79;87
42;Soria;010;Aldealices;38;18;20
42;Soria;011;Aldealpozo;32;15;17
42;Soria;012;Aldealseñor;53;30;23
42;Soria;013;Aldehuela de Periáñez;48;25;23
42;Soria;014;Aldehuelas (Las);150;81;69
42;Soria;015;Alentisque;62;28;34
42;Soria;016;Aliud;52;24;28
42;Soria;017;Almajano;196;96;100
42;Soria;018;Almaluez;364;182;182
42;Soria;019;Almarza;657;352;305
42;Soria;020;Almazán;6003;3014;2989
42;Soria;021;Almazul;205;104;101
42;Soria;022;Almenar de Soria;456;238;218
42;Soria;023;Alpanseque;123;62;61
42;Soria;024;Arancón;127;64;63
42;Soria;025;Arcos de Jalón;2123;1069;1054
42;Soria;026;Arenillas;71;40;31
42;Soria;027;Arévalo de la Sierra;137;69;68
42;Soria;028;Ausejo de la Sierra;60;31;29
42;Soria;029;Baraona;273;138;135
42;Soria;030;Barca;157;81;76
42;Soria;031;Barcones;57;32;25
42;Soria;032;Bayubas de Abajo;298;153;145
42;Soria;033;Bayubas de Arriba;103;54;49
42;Soria;034;Beratón;38;28;10
42;Soria;035;Berlanga de Duero;1284;652;632
42;Soria;036;Blacos;72;41;31
42;Soria;037;Bliecos;66;31;35
42;Soria;038;Borjabad;72;39;33
42;Soria;039;Borobia;411;200;211
42;Soria;041;Buberos;57;26;31
42;Soria;042;Buitrago;58;28;30
42;Soria;043;Burgo de Osma-Ciudad de Osma;5002;2459;2543
42;Soria;044;Cabrejas del Campo;99;54;45
42;Soria;045;Cabrejas del Pinar;506;275;231
42;Soria;046;Calatañazor;81;43;38
42;Soria;048;Caltojar;160;82;78
42;Soria;049;Candilichera;254;133;121
42;Soria;050;Cañamaque;56;31;25
42;Soria;051;Carabantes;41;21;20
42;Soria;052;Caracena;18;10;8
42;Soria;053;Carrascosa de Abajo;47;25;22
42;Soria;054;Carrascosa de la Sierra;18;8;10
42;Soria;055;Casarejos;294;149;145
42;Soria;056;Castilfrío de la Sierra;37;21;16
42;Soria;058;Castillejo de Robledo;234;123;111
42;Soria;057;Castilruiz;358;186;172
42;Soria;059;Centenera de Andaluz;33;13;20
42;Soria;060;Cerbón;56;30;26
42;Soria;061;Cidones;356;190;166
42;Soria;062;Cigudosa;93;52;41
42;Soria;063;Cihuela;119;63;56
42;Soria;064;Ciria;104;48;56
42;Soria;065;Cirujales del Río;48;27;21
42;Soria;068;Coscurita;164;93;71
42;Soria;069;Covaleda;2076;1068;1008
42;Soria;070;Cubilla;100;54;46
42;Soria;071;Cubo de la Solana;310;156;154
42;Soria;073;Cueva de Ágreda;129;65;64
42;Soria;075;Dévanos;162;87;75
42;Soria;076;Deza;424;214;210
42;Soria;078;Duruelo de la Sierra;1493;768;725
42;Soria;079;Escobosa de Almazán;49;28;21
42;Soria;080;Espeja de San Marcelino;288;157;131
42;Soria;081;Espejón;236;118;118
42;Soria;082;Estepa de San Juan;16;8;8
42;Soria;083;Frechilla de Almazán;55;28;27
42;Soria;084;Fresno de Caracena;62;32;30
42;Soria;085;Fuentearmegil;397;211;186
42;Soria;086;Fuentecambrón;79;45;34
42;Soria;087;Fuentecantos;53;25;28
42;Soria;088;Fuentelmonge;162;85;77
42;Soria;089;Fuentelsaz de Soria;70;38;32
42;Soria;090;Fuentepinilla;169;89;80
42;Soria;092;Fuentes de Magaña;123;58;65
42;Soria;093;Fuentestrún;72;44;28
42;Soria;094;Garray;360;183;177
42;Soria;095;Golmayo;656;354;302
42;Soria;096;Gómara;584;286;298
42;Soria;097;Gormaz;27;11;16
42;Soria;098;Herrera de Soria;44;25;19
42;Soria;100;Hinojosa del Campo;60;35;25
42;Soria;103;Langa de Duero;977;516;461
42;Soria;105;Liceras;72;35;37
42;Soria;106;Losilla (La);21;13;8
42;Soria;107;Magaña;114;58;56
42;Soria;108;Maján;18;9;9
42;Soria;110;Matalebreras;147;69;78
42;Soria;111;Matamala de Almazán;452;230;222
42;Soria;113;Medinaceli;752;390;362
42;Soria;115;Miño de Medinaceli;144;70;74
42;Soria;116;Miño de San Esteban;114;61;53
42;Soria;117;Molinos de Duero;204;108;96
42;Soria;118;Momblona;53;29;24
42;Soria;119;Monteagudo de las Vicarías;331;163;168
42;Soria;120;Montejo de Tiermes;301;168;133
42;Soria;121;Montenegro de Cameros;126;68;58
42;Soria;123;Morón de Almazán;315;151;164
42;Soria;124;Muriel de la Fuente;91;46;45
42;Soria;125;Muriel Viejo;111;53;58
42;Soria;127;Nafría de Ucero;97;49;48
42;Soria;128;Narros;64;30;34
42;Soria;129;Navaleno;941;476;465
42;Soria;130;Nepas;95;55;40
42;Soria;131;Nolay;103;57;46
42;Soria;132;Noviercas;262;123;139
42;Soria;134;Ólvega;3221;1679;1542
42;Soria;135;Oncala;116;71;45
42;Soria;139;Pinilla del Campo;28;16;12
42;Soria;140;Portillo de Soria;24;14;10
42;Soria;141;Póveda de Soria (La);127;61;66
42;Soria;142;Pozalmuro;111;50;61
42;Soria;144;Quintana Redonda;642;335;307
42;Soria;145;Quintanas de Gormaz;208;103;105
42;Soria;148;Quiñonería;18;6;12
42;Soria;149;Rábanos (Los);426;244;182
42;Soria;151;Rebollar;48;27;21
42;Soria;152;Recuerda;158;83;75
42;Soria;153;Rello;46;21;25
42;Soria;154;Renieblas;139;75;64
42;Soria;155;Retortillo de Soria;299;152;147
42;Soria;156;Reznos;61;35;26
42;Soria;157;Riba de Escalote (La);38;22;16
42;Soria;158;Rioseco de Soria;173;90;83
42;Soria;159;Rollamienta;58;31;27
42;Soria;160;Royo (El);394;184;210
42;Soria;161;Salduero;206;111;95
42;Soria;162;San Esteban de Gormaz;3494;1798;1696
42;Soria;163;San Felices;88;56;32
42;Soria;164;San Leonardo de Yagüe;2093;1069;1024
42;Soria;165;San Pedro Manrique;517;265;252
42;Soria;166;Santa Cruz de Yanguas;64;41;23
42;Soria;167;Santa María de Huerta;505;254;251
42;Soria;168;Santa María de las Hoyas;228;118;110
42;Soria;171;Serón de Nágima;335;173;162
42;Soria;172;Soliedra;48;28;20
42;Soria;173;Soria;33438;15920;17518
42;Soria;174;Sotillo del Rincón;220;105;115
42;Soria;175;Suellacabras;50;27;23
42;Soria;176;Tajahuerce;52;24;28
42;Soria;177;Tajueco;148;78;70
42;Soria;178;Talveila;228;119;109
42;Soria;181;Tardelcuende;729;356;373
42;Soria;182;Taroda;89;44;45
42;Soria;183;Tejado;261;127;134
42;Soria;184;Torlengua;133;63;70
42;Soria;185;Torreblacos;50;23;27
42;Soria;187;Torrubia de Soria;107;57;50
42;Soria;188;Trévago;86;39;47
42;Soria;189;Ucero;131;65;66
42;Soria;190;Vadillo;178;92;86
42;Soria;191;Valdeavellano de Tera;234;130;104
42;Soria;192;Valdegeña;58;30;28
42;Soria;193;Valdelagua del Cerro;41;20;21
42;Soria;194;Valdemaluque;343;167;176
42;Soria;195;Valdenebro;168;90;78
42;Soria;196;Valdeprado;20;8;12
42;Soria;197;Valderrodilla;140;66;74
42;Soria;198;Valtajeros;31;17;14
42;Soria;200;Velamazán;162;91;71
42;Soria;201;Velilla de la Sierra;22;9;13
42;Soria;202;Velilla de los Ajos;49;29;20
42;Soria;204;Viana de Duero;89;47;42
42;Soria;205;Villaciervos;103;54;49
42;Soria;206;Villanueva de Gormaz;24;13;11
42;Soria;207;Villar del Ala;51;23;28
42;Soria;208;Villar del Campo;43;23;20
42;Soria;209;Villar del Río;200;111;89
42;Soria;211;Villares de Soria (Los);131;61;70
42;Soria;212;Villasayas;120;74;46
42;Soria;213;Villaseca de Arciel;51;28;23
42;Soria;215;Vinuesa;1140;608;532
42;Soria;216;Vizmanos;44;27;17
42;Soria;217;Vozmediano;65;36;29
42;Soria;218;Yanguas;81;43;38
42;Soria;219;Yelo;82;44;38
43;Tarragona;001;Aiguamúrcia;596;316;280
43;Tarragona;002;Albinyana;1088;569;519
43;Tarragona;003;Albiol (L');163;83;80
43;Tarragona;004;Alcanar;8147;4070;4077
43;Tarragona;005;Alcover;3466;1770;1696
43;Tarragona;904;Aldea (L');3622;1810;1812
43;Tarragona;006;Aldover;813;390;423
43;Tarragona;007;Aleixar (L');625;313;312
43;Tarragona;008;Alfara de Carles;378;202;176
43;Tarragona;009;Alforja;1178;588;590
43;Tarragona;010;Alió;342;168;174
43;Tarragona;011;Almoster;637;310;327
43;Tarragona;012;Altafulla;2429;1214;1215
43;Tarragona;013;Ametlla de Mar (L');4422;2209;2213
43;Tarragona;906;Ampolla (L');1700;825;875
43;Tarragona;014;Amposta;15687;7815;7872
43;Tarragona;016;Arboç (L');3497;1799;1698
43;Tarragona;015;Arbolí;143;73;70
43;Tarragona;017;Argentera (L');138;72;66
43;Tarragona;018;Arnes;536;282;254
43;Tarragona;019;Ascó;1807;920;887
43;Tarragona;020;Banyeres del Penedès;1566;812;754
43;Tarragona;021;Barberà de la Conca;429;220;209
43;Tarragona;022;Batea;2006;1017;989
43;Tarragona;023;Bellmunt del Priorat;308;151;157
43;Tarragona;024;Bellvei;1186;640;546
43;Tarragona;025;Benifallet;927;467;460
43;Tarragona;026;Benissanet;1039;510;529
43;Tarragona;027;Bisbal de Falset (La);257;126;131
43;Tarragona;028;Bisbal del Penedès (La);1606;826;780
43;Tarragona;029;Blancafort;398;194;204
43;Tarragona;030;Bonastre;301;151;150
43;Tarragona;031;Borges del Camp (Les);1457;732;725
43;Tarragona;032;Bot;879;446;433
43;Tarragona;033;Botarell;501;249;252
43;Tarragona;034;Bràfim;561;271;290
43;Tarragona;035;Cabacés;340;178;162
43;Tarragona;036;Cabra del Camp;483;263;220
43;Tarragona;037;Calafell;9705;4865;4840
43;Tarragona;903;Camarles;2873;1433;1440
43;Tarragona;038;Cambrils;17127;8608;8519
43;Tarragona;039;Capafonts;102;49;53
43;Tarragona;040;Capçanes;404;183;221
43;Tarragona;041;Caseres;343;168;175
43;Tarragona;042;Castellvell del Camp;1047;528;519
43;Tarragona;043;Catllar (El);1687;870;817
43;Tarragona;045;Colldejou;189;101;88
43;Tarragona;046;Conesa;126;59;67
43;Tarragona;047;Constantí;5407;2810;2597
43;Tarragona;048;Corbera d'Ebre;1103;576;527
43;Tarragona;049;Cornudella de Montsant;855;433;422
43;Tarragona;050;Creixell;1345;701;644
43;Tarragona;051;Cunit;3977;2063;1914
43;Tarragona;901;Deltebre;10393;5213;5180
43;Tarragona;053;Duesaigües;211;125;86
43;Tarragona;054;Espluga de Francolí (L');3661;1800;1861
43;Tarragona;055;Falset;2517;1248;1269
43;Tarragona;056;Fatarella (La);1329;663;666
43;Tarragona;057;Febró (La);60;35;25
43;Tarragona;058;Figuera (La);125;63;62
43;Tarragona;059;Figuerola del Camp;204;103;101
43;Tarragona;060;Flix;4761;2394;2367
43;Tarragona;061;Forès;61;30;31
43;Tarragona;062;Freginals;355;168;187
43;Tarragona;063;Galera (La);760;378;382
43;Tarragona;064;Gandesa;2702;1343;1359
43;Tarragona;065;Garcia;550;269;281
43;Tarragona;066;Garidells (Els);190;94;96
43;Tarragona;067;Ginestar;849;436;413
43;Tarragona;068;Godall;767;382;385
43;Tarragona;069;Gratallops;231;110;121
43;Tarragona;070;Guiamets (Els);310;152;158
43;Tarragona;071;Horta de Sant Joan;1309;675;634
43;Tarragona;072;Lloar (El);131;68;63
43;Tarragona;073;Llorac;106;55;51
43;Tarragona;074;Llorenç del Penedès;1394;669;725
43;Tarragona;076;Marçà;604;290;314
43;Tarragona;075;Margalef;152;83;69
43;Tarragona;077;Mas de Barberans;747;379;368
43;Tarragona;078;Masdenverge;939;477;462
43;Tarragona;079;Masllorenç;382;189;193
43;Tarragona;080;Masó (La);251;125;126
43;Tarragona;081;Maspujols;406;213;193
43;Tarragona;082;Masroig (El);528;249;279
43;Tarragona;083;Milà (El);164;74;90
43;Tarragona;084;Miravet;807;415;392
43;Tarragona;085;Molar (El);310;156;154
43;Tarragona;086;Montblanc;5932;2959;2973
43;Tarragona;088;Montbrió del Camp;1426;697;729
43;Tarragona;089;Montferri;161;83;78
43;Tarragona;090;Montmell (El);397;212;185
43;Tarragona;091;Mont-ral;139;70;69
43;Tarragona;092;Mont-roig del Camp;5580;2889;2691
43;Tarragona;093;Móra d'Ebre;4735;2333;2402
43;Tarragona;094;Móra la Nova;2776;1385;1391
43;Tarragona;095;Morell (El);2389;1221;1168
43;Tarragona;096;Morera de Montsant (La);204;101;103
43;Tarragona;097;Nou de Gaià (La);383;184;199
43;Tarragona;098;Nulles;338;160;178
43;Tarragona;100;Pallaresos (Els);1460;771;689
43;Tarragona;099;Palma d'Ebre (La);429;204;225
43;Tarragona;101;Passanant;189;107;82
43;Tarragona;102;Paüls;683;350;333
43;Tarragona;103;Perafort;513;260;253
43;Tarragona;104;Perelló (El);2158;1097;1061
43;Tarragona;105;Piles (Les);149;83;66
43;Tarragona;106;Pinell de Brai (El);1142;594;548
43;Tarragona;107;Pira;342;163;179
43;Tarragona;108;Pla de Santa Maria (El);1655;846;809
43;Tarragona;109;Pobla de Mafumet (La);968;487;481
43;Tarragona;110;Pobla de Massaluca (La);452;227;225
43;Tarragona;111;Pobla de Montornès (La);1178;654;524
43;Tarragona;112;Poboleda;378;195;183
43;Tarragona;113;Pont d'Armentera (El);601;294;307
43;Tarragona;141;Pontils;126;64;62
43;Tarragona;114;Porrera;455;236;219
43;Tarragona;115;Pradell de la Teixeta;245;127;118
43;Tarragona;116;Prades;529;275;254
43;Tarragona;117;Prat de Comte;208;98;110
43;Tarragona;118;Pratdip;437;217;220
43;Tarragona;119;Puigpelat;469;232;237
43;Tarragona;120;Querol;238;129;109
43;Tarragona;121;Rasquera;857;435;422
43;Tarragona;122;Renau;63;35;28
43;Tarragona;123;Reus;90221;44351;45870
43;Tarragona;124;Riba (La);852;435;417
43;Tarragona;125;Riba-roja d'Ebre;1544;796;748
43;Tarragona;126;Riera de Gaià (La);910;445;465
43;Tarragona;127;Riudecanyes;590;297;293
43;Tarragona;128;Riudecols;980;500;480
43;Tarragona;129;Riudoms;4962;2497;2465
43;Tarragona;130;Rocafort de Queralt;261;135;126
43;Tarragona;131;Roda de Barà;2759;1477;1282
43;Tarragona;132;Rodonyà;398;197;201
43;Tarragona;133;Roquetes;6037;3028;3009
43;Tarragona;134;Rourell (El);279;156;123
43;Tarragona;135;Salomó;430;220;210
43;Tarragona;905;Salou;10359;5295;5064
43;Tarragona;136;Sant Carles de la Ràpita;10815;5373;5442
43;Tarragona;137;Sant Jaume dels Domenys;1342;691;651
43;Tarragona;902;Sant Jaume d'Enveja;3417;1720;1697
43;Tarragona;138;Santa Bàrbara;3387;1687;1700
43;Tarragona;139;Santa Coloma de Queralt;2549;1239;1310
43;Tarragona;140;Santa Oliva;1788;920;868
43;Tarragona;142;Sarral;1418;714;704
43;Tarragona;143;Savallà del Comtat;63;30;33
43;Tarragona;144;Secuita (La);1073;540;533
43;Tarragona;145;Selva del Camp (La);3702;1829;1873
43;Tarragona;146;Senan;30;19;11
43;Tarragona;044;Sénia (La);5096;2588;2508
43;Tarragona;147;Solivella;706;336;370
43;Tarragona;148;Tarragona;114931;56303;58628
43;Tarragona;149;Tivenys;1009;506;503
43;Tarragona;150;Tivissa;1766;882;884
43;Tarragona;151;Torre de Fontaubella (La);83;36;47
43;Tarragona;152;Torre de l'Espanyol (La);679;347;332
43;Tarragona;153;Torredembarra;8572;4275;4297
43;Tarragona;154;Torroja del Priorat;142;81;61
43;Tarragona;155;Tortosa;30560;14837;15723
43;Tarragona;156;Ulldecona;5208;2571;2637
43;Tarragona;157;Ulldemolins;506;254;252
43;Tarragona;158;Vallclara;109;53;56
43;Tarragona;159;Vallfogona de Riucorb;111;69;42
43;Tarragona;160;Vallmoll;1154;583;571
43;Tarragona;161;Valls;20315;9956;10359
43;Tarragona;162;Vandellòs i l'Hospitalet de l'Infant;4457;2255;2202
43;Tarragona;163;Vendrell (El);17890;8911;8979
43;Tarragona;164;Vespella de Gaià;148;86;62
43;Tarragona;165;Vilabella;856;420;436
43;Tarragona;175;Vilalba dels Arcs;792;418;374
43;Tarragona;166;Vilallonga del Camp;1225;617;608
43;Tarragona;168;Vilanova de Prades;153;78;75
43;Tarragona;167;Vilanova d'Escornalbou;441;217;224
43;Tarragona;169;Vilaplana;519;268;251
43;Tarragona;170;Vila-rodona;1010;530;480
43;Tarragona;171;Vila-seca;12610;6339;6271
43;Tarragona;172;Vilaverd;367;181;186
43;Tarragona;173;Vilella Alta (La);135;69;66
43;Tarragona;174;Vilella Baixa (La);168;89;79
43;Tarragona;176;Vimbodí;1113;576;537
43;Tarragona;177;Vinebre;442;210;232
43;Tarragona;178;Vinyols i els Arcs;957;519;438
43;Tarragona;052;Xerta;1237;609;628
44;Teruel;001;Ababuj;86;50;36
44;Teruel;002;Abejuela;118;72;46
44;Teruel;003;Aguatón;27;12;15
44;Teruel;004;Aguaviva;638;314;324
44;Teruel;005;Aguilar del Alfambra;87;41;46
44;Teruel;006;Alacón;509;263;246
44;Teruel;007;Alba;306;158;148
44;Teruel;008;Albalate del Arzobispo;2458;1208;1250
44;Teruel;009;Albarracín;1079;536;543
44;Teruel;010;Albentosa;262;127;135
44;Teruel;011;Alcaine;50;26;24
44;Teruel;012;Alcalá de la Selva;437;228;209
44;Teruel;013;Alcañiz;12853;6306;6547
44;Teruel;014;Alcorisa;3296;1663;1633
44;Teruel;016;Alfambra;733;367;366
44;Teruel;017;Aliaga;461;237;224
44;Teruel;021;Allepuz;153;83;70
44;Teruel;022;Alloza;894;429;465
44;Teruel;023;Allueva;19;9;10
44;Teruel;018;Almohaja;37;21;16
44;Teruel;019;Alobras;99;52;47
44;Teruel;020;Alpeñés;35;20;15
44;Teruel;024;Anadón;27;13;14
44;Teruel;025;Andorra;8503;4408;4095
44;Teruel;026;Arcos de las Salinas;194;100;94
44;Teruel;027;Arens de Lledó;258;120;138
44;Teruel;028;Argente;281;141;140
44;Teruel;029;Ariño;952;474;478
44;Teruel;031;Azaila;215;118;97
44;Teruel;032;Bádenas;27;11;16
44;Teruel;033;Báguena;569;286;283
44;Teruel;034;Bañón;205;107;98
44;Teruel;035;Barrachina;184;91;93
44;Teruel;036;Bea;30;19;11
44;Teruel;037;Beceite;684;349;335
44;Teruel;039;Bello;445;208;237
44;Teruel;038;Belmonte de San José;155;80;75
44;Teruel;040;Berge;255;133;122
44;Teruel;041;Bezas;76;40;36
44;Teruel;042;Blancas;234;118;116
44;Teruel;043;Blesa;167;99;68
44;Teruel;044;Bordón;137;76;61
44;Teruel;045;Bronchales;473;246;227
44;Teruel;046;Bueña;118;65;53
44;Teruel;047;Burbáguena;363;159;204
44;Teruel;048;Cabra de Mora;98;52;46
44;Teruel;049;Calaceite;1295;662;633
44;Teruel;050;Calamocha;4185;2090;2095
44;Teruel;051;Calanda;3564;1798;1766
44;Teruel;052;Calomarde;106;53;53
44;Teruel;053;Camañas;150;83;67
44;Teruel;054;Camarena de la Sierra;156;85;71
44;Teruel;055;Camarillas;138;74;64
44;Teruel;056;Caminreal;863;417;446
44;Teruel;059;Cantavieja;747;394;353
44;Teruel;060;Cañada de Benatanduz;71;43;28
44;Teruel;061;Cañada de Verich (La);110;60;50
44;Teruel;062;Cañada Vellida;65;41;24
44;Teruel;063;Cañizar del Olivar;136;70;66
44;Teruel;064;Cascante del Río;136;80;56
44;Teruel;065;Castejón de Tornos;115;56;59
44;Teruel;066;Castel de Cabra;205;107;98
44;Teruel;070;Castellar (El);95;49;46
44;Teruel;071;Castellote;846;416;430
44;Teruel;067;Castelnou;114;59;55
44;Teruel;068;Castelserás;904;475;429
44;Teruel;074;Cedrillas;557;290;267
44;Teruel;075;Celadas;490;258;232
44;Teruel;076;Cella;3101;1586;1515
44;Teruel;077;Cerollera (La);91;49;42
44;Teruel;080;Codoñera (La);370;189;181
44;Teruel;082;Corbalán;76;45;31
44;Teruel;084;Cortes de Aragón;149;72;77
44;Teruel;085;Cosa;115;61;54
44;Teruel;086;Cretas;685;344;341
44;Teruel;087;Crivillén;149;73;76
44;Teruel;088;Cuba (La);73;35;38
44;Teruel;089;Cubla;65;34;31
44;Teruel;090;Cucalón;90;47;43
44;Teruel;092;Cuervo (El);153;76;77
44;Teruel;093;Cuevas de Almudén;108;59;49
44;Teruel;094;Cuevas Labradas;190;99;91
44;Teruel;096;Ejulve;247;122;125
44;Teruel;097;Escorihuela;257;127;130
44;Teruel;099;Escucha;1160;631;529
44;Teruel;100;Estercuel;404;203;201
44;Teruel;101;Ferreruela de Huerva;95;49;46
44;Teruel;102;Fonfría;32;18;14
44;Teruel;103;Formiche Alto;212;112;100
44;Teruel;105;Fórnoles;121;53;68
44;Teruel;106;Fortanete;219;111;108
44;Teruel;107;Foz-Calanda;257;141;116
44;Teruel;108;Fresneda (La);480;252;228
44;Teruel;109;Frías de Albarracín;193;99;94
44;Teruel;110;Fuenferrada;51;26;25
44;Teruel;111;Fuentes Calientes;142;75;67
44;Teruel;112;Fuentes Claras;733;360;373
44;Teruel;113;Fuentes de Rubielos;77;39;38
44;Teruel;114;Fuentespalda;414;205;209
44;Teruel;115;Galve;159;83;76
44;Teruel;116;Gargallo;137;74;63
44;Teruel;117;Gea de Albarracín;506;260;246
44;Teruel;118;Ginebrosa (La);282;154;128
44;Teruel;119;Griegos;163;96;67
44;Teruel;120;Guadalaviar;293;149;144
44;Teruel;121;Gúdar;85;53;32
44;Teruel;122;Híjar;2027;1004;1023
44;Teruel;123;Hinojosa de Jarque;203;108;95
44;Teruel;124;Hoz de la Vieja (La);147;75;72
44;Teruel;125;Huesa del Común;150;79;71
44;Teruel;126;Iglesuela del Cid (La);509;261;248
44;Teruel;127;Jabaloyas;102;55;47
44;Teruel;128;Jarque de la Val;113;60;53
44;Teruel;129;Jatiel;80;38;42
44;Teruel;130;Jorcas;66;40;26
44;Teruel;131;Josa;37;21;16
44;Teruel;132;Lagueruela;78;42;36
44;Teruel;133;Lanzuela;37;22;15
44;Teruel;135;Libros;196;97;99
44;Teruel;136;Lidón;91;43;48
44;Teruel;137;Linares de Mora;326;185;141
44;Teruel;141;Lledó;216;110;106
44;Teruel;138;Loscos;247;133;114
44;Teruel;142;Maicas;25;12;13
44;Teruel;143;Manzanera;498;262;236
44;Teruel;144;Martín del Río;542;279;263
44;Teruel;145;Mas de las Matas;1498;747;751
44;Teruel;146;Mata de los Olmos (La);279;135;144
44;Teruel;147;Mazaleón;636;325;311
44;Teruel;148;Mezquita de Jarque;161;81;80
44;Teruel;149;Mirambel;154;82;72
44;Teruel;150;Miravete de la Sierra;52;30;22
44;Teruel;151;Molinos;391;194;197
44;Teruel;152;Monforte de Moyuela;90;50;40
44;Teruel;153;Monreal del Campo;2344;1170;1174
44;Teruel;154;Monroyo;402;207;195
44;Teruel;155;Montalbán;1690;845;845
44;Teruel;156;Monteagudo del Castillo;76;43;33
44;Teruel;157;Monterde de Albarracín;82;40;42
44;Teruel;158;Mora de Rubielos;1349;699;650
44;Teruel;159;Moscardón;62;33;29
44;Teruel;160;Mosqueruela;705;361;344
44;Teruel;161;Muniesa;798;408;390
44;Teruel;163;Noguera de Albarracín;175;90;85
44;Teruel;164;Nogueras;26;19;7
44;Teruel;165;Nogueruelas;236;118;118
44;Teruel;167;Obón;61;27;34
44;Teruel;168;Odón;288;140;148
44;Teruel;169;Ojos Negros;649;334;315
44;Teruel;171;Olba;227;114;113
44;Teruel;172;Oliete;540;273;267
44;Teruel;173;Olmos (Los);164;92;72
44;Teruel;174;Orihuela del Tremedal;622;309;313
44;Teruel;175;Orrios;216;114;102
44;Teruel;176;Palomar de Arroyos;279;151;128
44;Teruel;177;Pancrudo;227;121;106
44;Teruel;178;Parras de Castellote (Las);111;61;50
44;Teruel;179;Peñarroya de Tastavins;570;290;280
44;Teruel;180;Peracense;119;60;59
44;Teruel;181;Peralejos;105;53;52
44;Teruel;182;Perales del Alfambra;313;169;144
44;Teruel;183;Pitarque;117;55;62
44;Teruel;184;Plou;57;28;29
44;Teruel;185;Pobo (El);164;91;73
44;Teruel;187;Portellada (La);352;185;167
44;Teruel;189;Pozondón;95;48;47
44;Teruel;190;Pozuel del Campo;136;74;62
44;Teruel;191;Puebla de Híjar (La);1186;577;609
44;Teruel;192;Puebla de Valverde (La);478;249;229
44;Teruel;193;Puertomingalvo;133;67;66
44;Teruel;194;Ráfales;244;127;117
44;Teruel;195;Rillo;155;83;72
44;Teruel;196;Riodeva;262;125;137
44;Teruel;197;Ródenas;96;46;50
44;Teruel;198;Royuela;239;133;106
44;Teruel;199;Rubiales;67;37;30
44;Teruel;200;Rubielos de la Cérida;65;30;35
44;Teruel;201;Rubielos de Mora;649;321;328
44;Teruel;203;Salcedillo;9;4;5
44;Teruel;204;Saldón;51;32;19
44;Teruel;205;Samper de Calanda;1120;541;579
44;Teruel;206;San Agustín;164;83;81
44;Teruel;207;San Martín del Río;326;156;170
44;Teruel;208;Santa Cruz de Nogueras;32;19;13
44;Teruel;209;Santa Eulalia;1325;635;690
44;Teruel;210;Sarrión;1046;551;495
44;Teruel;211;Segura de los Baños;60;32;28
44;Teruel;212;Seno;53;28;25
44;Teruel;213;Singra;101;49;52
44;Teruel;215;Terriente;196;108;88
44;Teruel;216;Teruel;30304;14764;15540
44;Teruel;217;Toril y Masegoso;43;26;17
44;Teruel;218;Tormón;43;22;21
44;Teruel;219;Tornos;287;149;138
44;Teruel;220;Torralba de los Sisones;249;124;125
44;Teruel;223;Torre de Arcas;114;54;60
44;Teruel;224;Torre de las Arcas;43;24;19
44;Teruel;225;Torre del Compte;190;88;102
44;Teruel;227;Torre los Negros;101;52;49
44;Teruel;221;Torrecilla de Alcañiz;464;243;221
44;Teruel;222;Torrecilla del Rebollar;184;96;88
44;Teruel;226;Torrelacárcel;334;169;165
44;Teruel;228;Torremocha de Jiloca;195;93;102
44;Teruel;229;Torres de Albarracín;172;88;84
44;Teruel;230;Torrevelilla;225;108;117
44;Teruel;231;Torrijas;103;49;54
44;Teruel;232;Torrijo del Campo;627;317;310
44;Teruel;234;Tramacastiel;134;62;72
44;Teruel;235;Tramacastilla;145;72;73
44;Teruel;236;Tronchón;105;53;52
44;Teruel;237;Urrea de Gaén;668;323;345
44;Teruel;238;Utrillas;3548;1812;1736
44;Teruel;239;Valacloche;26;14;12
44;Teruel;240;Valbona;208;109;99
44;Teruel;241;Valdealgorfa;808;396;412
44;Teruel;243;Valdecuenca;35;20;15
44;Teruel;244;Valdelinares;131;69;62
44;Teruel;245;Valdeltormo;410;207;203
44;Teruel;246;Valderrobres;1939;987;952
44;Teruel;247;Valjunquera;480;244;236
44;Teruel;249;Vallecillo (El);37;23;14
44;Teruel;250;Veguillas de la Sierra;30;17;13
44;Teruel;251;Villafranca del Campo;426;220;206
44;Teruel;252;Villahermosa del Campo;80;43;37
44;Teruel;256;Villanueva del Rebollar de la Sierra;49;27;22
44;Teruel;257;Villar del Cobo;229;114;115
44;Teruel;258;Villar del Salz;134;69;65
44;Teruel;260;Villarluengo;231;121;110
44;Teruel;261;Villarquemado;1039;518;521
44;Teruel;262;Villarroya de los Pinares;212;107;105
44;Teruel;263;Villastar;357;191;166
44;Teruel;264;Villel;363;182;181
44;Teruel;265;Vinaceite;319;162;157
44;Teruel;266;Visiedo;252;122;130
44;Teruel;267;Vivel del Río Martín;111;59;52
44;Teruel;268;Zoma (La);37;19;18
45;Toledo;001;Ajofrín;2259;1151;1108
45;Toledo;002;Alameda de la Sagra;2816;1502;1314
45;Toledo;003;Albarreal de Tajo;604;305;299
45;Toledo;004;Alcabón;561;288;273
45;Toledo;005;Alcañizo;357;189;168
45;Toledo;006;Alcaudete de la Jara;1615;767;848
45;Toledo;007;Alcolea de Tajo;810;408;402
45;Toledo;008;Aldea en Cabo;192;100;92
45;Toledo;009;Aldeanueva de Barbarroya;887;443;444
45;Toledo;010;Aldeanueva de San Bartolomé;669;333;336
45;Toledo;011;Almendral de la Cañada;440;229;211
45;Toledo;012;Almonacid de Toledo;812;410;402
45;Toledo;013;Almorox;2279;1167;1112
45;Toledo;014;Añover de Tajo;4602;2359;2243
45;Toledo;015;Arcicóllar;567;283;284
45;Toledo;016;Argés;2013;1008;1005
45;Toledo;017;Azután;369;182;187
45;Toledo;018;Barcience;126;64;62
45;Toledo;019;Bargas;6416;3242;3174
45;Toledo;020;Belvís de la Jara;1824;890;934
45;Toledo;021;Borox;2080;1023;1057
45;Toledo;022;Buenaventura;588;300;288
45;Toledo;023;Burguillos de Toledo;722;359;363
45;Toledo;024;Burujón;1267;655;612
45;Toledo;025;Cabañas de la Sagra;1041;533;508
45;Toledo;026;Cabañas de Yepes;268;138;130
45;Toledo;027;Cabezamesada;567;291;276
45;Toledo;028;Calera y Chozas;3742;1908;1834
45;Toledo;029;Caleruela;340;173;167
45;Toledo;030;Calzada de Oropesa;686;338;348
45;Toledo;031;Camarena;2143;1096;1047
45;Toledo;032;Camarenilla;562;279;283
45;Toledo;033;Campillo de la Jara (El);604;321;283
45;Toledo;034;Camuñas;1810;903;907
45;Toledo;035;Cardiel de los Montes;136;72;64
45;Toledo;036;Carmena;802;409;393
45;Toledo;037;Carpio de Tajo (El);2406;1161;1245
45;Toledo;038;Carranque;1325;670;655
45;Toledo;039;Carriches;324;155;169
45;Toledo;040;Casar de Escalona (El);893;442;451
45;Toledo;041;Casarrubios del Monte;2284;1157;1127
45;Toledo;042;Casasbuenas;244;122;122
45;Toledo;043;Castillo de Bayuela;1046;522;524
45;Toledo;045;Cazalegas;1154;567;587
45;Toledo;046;Cebolla;2777;1382;1395
45;Toledo;047;Cedillo del Condado;1166;597;569
45;Toledo;048;Cerralbos (Los);503;251;252
45;Toledo;049;Cervera de los Montes;416;224;192
45;Toledo;056;Chozas de Canales;987;493;494
45;Toledo;057;Chueca;263;137;126
45;Toledo;050;Ciruelos;333;176;157
45;Toledo;051;Cobeja;1701;864;837
45;Toledo;052;Cobisa;517;277;240
45;Toledo;053;Consuegra;10135;5009;5126
45;Toledo;054;Corral de Almaguer;5946;2967;2979
45;Toledo;055;Cuerva;1239;617;622
45;Toledo;058;Domingo Pérez;517;240;277
45;Toledo;059;Dosbarrios;2049;1037;1012
45;Toledo;060;Erustes;210;108;102
45;Toledo;061;Escalona;1970;986;984
45;Toledo;062;Escalonilla;1484;722;762
45;Toledo;063;Espinoso del Rey;629;320;309
45;Toledo;064;Esquivias;3635;1833;1802
45;Toledo;065;Estrella (La);478;259;219
45;Toledo;066;Fuensalida;7272;3671;3601
45;Toledo;067;Gálvez;3195;1597;1598
45;Toledo;068;Garciotum;165;82;83
45;Toledo;069;Gerindote;1824;936;888
45;Toledo;070;Guadamur;1635;840;795
45;Toledo;071;Guardia (La);2492;1235;1257
45;Toledo;072;Herencias (Las);721;373;348
45;Toledo;073;Herreruela de Oropesa;450;220;230
45;Toledo;074;Hinojosa de San Vicente;525;284;241
45;Toledo;075;Hontanar;128;67;61
45;Toledo;076;Hormigos;424;217;207
45;Toledo;077;Huecas;408;207;201
45;Toledo;078;Huerta de Valdecarábanos;1729;860;869
45;Toledo;079;Iglesuela (La);481;242;239
45;Toledo;080;Illán de Vacas;5;4;1
45;Toledo;081;Illescas;8959;4516;4443
45;Toledo;082;Lagartera;1949;955;994
45;Toledo;083;Layos;274;135;139
45;Toledo;084;Lillo;2951;1468;1483
45;Toledo;085;Lominchar;1059;560;499
45;Toledo;086;Lucillos;535;266;269
45;Toledo;087;Madridejos;10541;5210;5331
45;Toledo;088;Magán;997;499;498
45;Toledo;089;Malpica de Tajo;1833;933;900
45;Toledo;090;Manzaneque;464;232;232
45;Toledo;091;Maqueda;502;255;247
45;Toledo;092;Marjaliza;333;171;162
45;Toledo;093;Marrupe;139;65;74
45;Toledo;094;Mascaraque;512;239;273
45;Toledo;095;Mata (La);1008;495;513
45;Toledo;096;Mazarambroz;1199;594;605
45;Toledo;097;Mejorada;1097;565;532
45;Toledo;098;Menasalbas;3017;1568;1449
45;Toledo;099;Méntrida;1655;848;807
45;Toledo;100;Mesegar de Tajo;242;117;125
45;Toledo;101;Miguel Esteban;4755;2374;2381
45;Toledo;102;Mocejón;4112;2087;2025
45;Toledo;103;Mohedas de la Jara;684;349;335
45;Toledo;104;Montearagón;490;254;236
45;Toledo;105;Montesclaros;476;223;253
45;Toledo;106;Mora;9333;4562;4771
45;Toledo;107;Nambroca;2114;1050;1064
45;Toledo;108;Nava de Ricomalillo (La);789;409;380
45;Toledo;109;Navahermosa;3805;1958;1847
45;Toledo;110;Navalcán;2522;1309;1213
45;Toledo;111;Navalmoralejo;91;44;47
45;Toledo;112;Navalmorales (Los);2733;1360;1373
45;Toledo;113;Navalucillos (Los);2934;1476;1458
45;Toledo;114;Navamorcuende;760;387;373
45;Toledo;115;Noblejas;2942;1485;1457
45;Toledo;116;Noez;952;483;469
45;Toledo;117;Nombela;916;474;442
45;Toledo;118;Novés;1561;788;773
45;Toledo;119;Numancia de la Sagra;1438;743;695
45;Toledo;120;Nuño Gómez;175;92;83
45;Toledo;121;Ocaña;5991;2949;3042
45;Toledo;122;Olías del Rey;4102;2088;2014
45;Toledo;123;Ontígola;875;459;416
45;Toledo;124;Orgaz;2683;1350;1333
45;Toledo;125;Oropesa;2945;1474;1471
45;Toledo;126;Otero;239;122;117
45;Toledo;127;Palomeque;442;220;222
45;Toledo;128;Pantoja;2185;1126;1059
45;Toledo;129;Paredes de Escalona;111;51;60
45;Toledo;130;Parrillas;486;244;242
45;Toledo;131;Pelahustán;376;198;178
45;Toledo;132;Pepino;739;382;357
45;Toledo;133;Polán;3188;1603;1585
45;Toledo;134;Portillo de Toledo;1919;974;945
45;Toledo;135;Puebla de Almoradiel (La);5412;2708;2704
45;Toledo;136;Puebla de Montalbán (La);6756;3369;3387
45;Toledo;137;Pueblanueva (La);1965;981;984
45;Toledo;138;Puente del Arzobispo (El);1598;763;835
45;Toledo;139;Puerto de San Vicente;291;139;152
45;Toledo;140;Pulgar;1204;617;587
45;Toledo;141;Quero;1403;704;699
45;Toledo;142;Quintanar de la Orden;9348;4638;4710
45;Toledo;143;Quismondo;1335;662;673
45;Toledo;144;Real de San Vicente (El);1037;524;513
45;Toledo;145;Recas;2447;1259;1188
45;Toledo;146;Retamoso;193;104;89
45;Toledo;147;Rielves;496;248;248
45;Toledo;148;Robledo del Mazo;580;298;282
45;Toledo;149;Romeral (El);955;469;486
45;Toledo;150;San Bartolomé de las Abiertas;476;245;231
45;Toledo;151;San Martín de Montalbán;758;371;387
45;Toledo;152;San Martín de Pusa;809;422;387
45;Toledo;153;San Pablo de los Montes;2094;1050;1044
45;Toledo;154;San Román de los Montes;651;334;317
45;Toledo;155;Santa Ana de Pusa;382;197;185
45;Toledo;156;Santa Cruz de la Zarza;4438;2223;2215
45;Toledo;157;Santa Cruz del Retamar;1550;784;766
45;Toledo;158;Santa Olalla;2322;1187;1135
45;Toledo;901;Santo Domingo-Caudilla;830;402;428
45;Toledo;159;Sartajada;115;70;45
45;Toledo;160;Segurilla;969;478;491
45;Toledo;161;Seseña;3251;1672;1579
45;Toledo;162;Sevilleja de la Jara;1145;599;546
45;Toledo;163;Sonseca;9049;4566;4483
45;Toledo;164;Sotillo de las Palomas;204;107;97
45;Toledo;165;Talavera de la Reina;75864;37467;38397
45;Toledo;166;Tembleque;2176;1082;1094
45;Toledo;167;Toboso (El);2162;1065;1097
45;Toledo;168;Toledo;65104;31421;33683
45;Toledo;169;Torralba de Oropesa;325;153;172
45;Toledo;171;Torre de Esteban Hambrán (La);1359;701;658
45;Toledo;170;Torrecilla de la Jara;317;168;149
45;Toledo;172;Torrico;975;487;488
45;Toledo;173;Torrijos;9737;4813;4924
45;Toledo;174;Totanés;371;193;178
45;Toledo;175;Turleque;1066;531;535
45;Toledo;176;Ugena;744;402;342
45;Toledo;177;Urda;3089;1533;1556
45;Toledo;179;Valdeverdeja;888;416;472
45;Toledo;180;Valmojado;2273;1163;1110
45;Toledo;181;Velada;2374;1219;1155
45;Toledo;182;Ventas con Peña Aguilera (Las);1449;732;717
45;Toledo;183;Ventas de Retamosa (Las);599;304;295
45;Toledo;184;Ventas de San Julián (Las);250;115;135
45;Toledo;186;Villa de Don Fadrique (La);4245;2070;2175
45;Toledo;185;Villacañas;9066;4499;4567
45;Toledo;187;Villafranca de los Caballeros;5425;2680;2745
45;Toledo;188;Villaluenga de la Sagra;2600;1310;1290
45;Toledo;189;Villamiel de Toledo;349;168;181
45;Toledo;190;Villaminaya;678;335;343
45;Toledo;191;Villamuelas;790;396;394
45;Toledo;192;Villanueva de Alcardete;3329;1667;1662
45;Toledo;193;Villanueva de Bogas;839;419;420
45;Toledo;194;Villarejo de Montalbán;104;49;55
45;Toledo;195;Villarrubia de Santiago;2958;1476;1482
45;Toledo;196;Villaseca de la Sagra;1586;805;781
45;Toledo;197;Villasequilla;2389;1248;1141
45;Toledo;198;Villatobas;2323;1159;1164
45;Toledo;199;Viso de San Juan (El);873;458;415
45;Toledo;200;Yébenes (Los);6586;3302;3284
45;Toledo;201;Yeles;1308;675;633
45;Toledo;202;Yepes;4437;2237;2200
45;Toledo;203;Yuncler;1885;980;905
45;Toledo;204;Yunclillos;612;312;300
45;Toledo;205;Yuncos;3077;1595;1482
46;Valencia/València;001;Ademuz;1266;631;635
46;Valencia/València;002;Ador;1094;552;542
46;Valencia/València;004;Agullent;2212;1077;1135
46;Valencia/València;042;Aielo de Malferit;3905;1933;1972
46;Valencia/València;043;Aielo de Rugat;202;107;95
46;Valencia/València;005;Alaquàs;24926;12439;12487
46;Valencia/València;006;Albaida;5870;2882;2988
46;Valencia/València;007;Albal;10069;5005;5064
46;Valencia/València;008;Albalat de la Ribera;3494;1692;1802
46;Valencia/València;009;Albalat dels Sorells;3569;1738;1831
46;Valencia/València;010;Albalat dels Tarongers;604;308;296
46;Valencia/València;011;Alberic;9559;4703;4856
46;Valencia/València;012;Alborache;902;451;451
46;Valencia/València;013;Alboraya;12942;6338;6604
46;Valencia/València;014;Albuixech;3048;1507;1541
46;Valencia/València;016;Alcàntera de Xúquer;1484;738;746
46;Valencia/València;015;Alcàsser;7372;3703;3669
46;Valencia/València;018;Alcublas;858;432;426
46;Valencia/València;020;Alcúdia de Crespins (L');4222;2107;2115
46;Valencia/València;019;Alcúdia (L');10638;5226;5412
46;Valencia/València;021;Aldaia;23811;11917;11894
46;Valencia/València;022;Alfafar;20247;10015;10232
46;Valencia/València;024;Alfara de Algimia;525;258;267
46;Valencia/València;025;Alfara del Patriarca;2780;1383;1397
46;Valencia/València;026;Alfarp;1359;663;696
46;Valencia/València;027;Alfarrasí;1237;603;634
46;Valencia/València;023;Alfauir;314;160;154
46;Valencia/València;028;Algar de Palancia;399;193;206
46;Valencia/València;029;Algemesí;25813;12747;13066
46;Valencia/València;030;Algimia de Alfara;882;439;443
46;Valencia/València;031;Alginet;12237;6095;6142
46;Valencia/València;032;Almàssera;5612;2720;2892
46;Valencia/València;033;Almiserà;237;122;115
46;Valencia/València;034;Almoines;1798;904;894
46;Valencia/València;035;Almussafes;6833;3421;3412
46;Valencia/València;036;Alpuente;1105;571;534
46;Valencia/València;037;Alquería de la Condesa/Alqueria de la Comtessa (l');1536;730;806
46;Valencia/València;017;Alzira;41060;20010;21050
46;Valencia/València;038;Andilla;254;140;114
46;Valencia/València;039;Anna;2683;1348;1335
46;Valencia/València;040;Antella;1603;796;807
46;Valencia/València;041;Aras de los Olmos;433;240;193
46;Valencia/València;003;Atzeneta d'Albaida;1268;637;631
46;Valencia/València;044;Ayora;5594;2882;2712
46;Valencia/València;046;Barx;1128;550;578
46;Valencia/València;045;Barxeta;1632;821;811
46;Valencia/València;047;Bèlgida;675;324;351
46;Valencia/València;048;Bellreguard;3755;1861;1894
46;Valencia/València;049;Bellús;409;205;204
46;Valencia/València;050;Benagéber;164;92;72
46;Valencia/València;051;Benaguasil;9386;4715;4671
46;Valencia/València;052;Benavites;668;324;344
46;Valencia/València;053;Beneixida;675;321;354
46;Valencia/València;054;Benetússer;14186;7021;7165
46;Valencia/València;055;Beniarjó;1165;555;610
46;Valencia/València;056;Beniatjar;266;133;133
46;Valencia/València;057;Benicolet;497;256;241
46;Valencia/València;060;Benifaió;12555;6180;6375
46;Valencia/València;059;Benifairó de la Valldigna;1645;822;823
46;Valencia/València;058;Benifairó de les Valls;1998;992;1006
46;Valencia/València;061;Beniflá;141;65;76
46;Valencia/València;062;Benigánim;5454;2803;2651
46;Valencia/València;063;Benimodo;1787;927;860
46;Valencia/València;064;Benimuslem;566;279;287
46;Valencia/València;065;Beniparrell;1463;735;728
46;Valencia/València;066;Benirredrà;975;464;511
46;Valencia/València;067;Benisanó;1680;865;815
46;Valencia/València;068;Benissoda;308;171;137
46;Valencia/València;069;Benisuera;196;90;106
46;Valencia/València;070;Bétera;11254;5593;5661
46;Valencia/València;071;Bicorp;702;348;354
46;Valencia/València;072;Bocairent;4683;2315;2368
46;Valencia/València;073;Bolbaite;1422;717;705
46;Valencia/València;074;Bonrepòs i Mirambell;2429;1199;1230
46;Valencia/València;075;Bufali;222;110;112
46;Valencia/València;076;Bugarra;867;437;430
46;Valencia/València;077;Buñol;9313;4640;4673
46;Valencia/València;078;Burjassot;35196;17412;17784
46;Valencia/València;079;Calles;435;232;203
46;Valencia/València;080;Camporrobles;1464;746;718
46;Valencia/València;081;Canals;12720;6278;6442
46;Valencia/València;082;Canet d'En Berenguer;1794;871;923
46;Valencia/València;083;Carcaixent;20491;9979;10512
46;Valencia/València;084;Càrcer;2005;959;1046
46;Valencia/València;085;Carlet;14534;7137;7397
46;Valencia/València;086;Carrícola;76;33;43
46;Valencia/València;087;Casas Altas;143;75;68
46;Valencia/València;088;Casas Bajas;320;171;149
46;Valencia/València;089;Casinos;2432;1269;1163
46;Valencia/València;090;Castelló de Rugat;2082;1070;1012
46;Valencia/València;091;Castellonet de la Conquesta;132;66;66
46;Valencia/València;092;Castielfabib;645;340;305
46;Valencia/València;093;Catadau;2268;1121;1147
46;Valencia/València;094;Catarroja;21462;10522;10940
46;Valencia/València;095;Caudete de las Fuentes;886;446;440
46;Valencia/València;096;Cerdà;286;139;147
46;Valencia/València;107;Chella;2533;1247;1286
46;Valencia/València;106;Chelva;2231;1137;1094
46;Valencia/València;108;Chera;611;315;296
46;Valencia/València;109;Cheste;6844;3456;3388
46;Valencia/València;111;Chiva;8337;4183;4154
46;Valencia/València;112;Chulilla;734;364;370
46;Valencia/València;097;Cofrentes;1018;508;510
46;Valencia/València;098;Corbera;3195;1547;1648
46;Valencia/València;099;Cortes de Pallás;834;437;397
46;Valencia/València;100;Cotes;402;183;219
46;Valencia/València;105;Cullera;20891;10330;10561
46;Valencia/València;113;Daimús;1346;672;674
46;Valencia/València;114;Domeño;525;274;251
46;Valencia/València;115;Dos Aguas;373;208;165
46;Valencia/València;116;Eliana (L');11229;5628;5601
46;Valencia/València;117;Emperador;165;81;84
46;Valencia/València;118;Enguera;5057;2484;2573
46;Valencia/València;119;Ènova (L');1148;580;568
46;Valencia/València;120;Estivella;1111;515;596
46;Valencia/València;121;Estubeny;140;63;77
46;Valencia/València;122;Faura;2845;1402;1443
46;Valencia/València;123;Favara;1720;830;890
46;Valencia/València;126;Foios;5418;2620;2798
46;Valencia/València;128;Font de la Figuera (La);2171;1084;1087
46;Valencia/València;127;Font d'En Carròs (La);3232;1591;1641
46;Valencia/València;124;Fontanars dels Alforins;975;505;470
46;Valencia/València;125;Fortaleny;1007;507;500
46;Valencia/València;129;Fuenterrobles;727;376;351
46;Valencia/València;131;Gandia;58070;28460;29610
46;Valencia/València;130;Gavarda;1313;639;674
46;Valencia/València;132;Genovés;2321;1156;1165
46;Valencia/València;133;Gestalgar;688;328;360
46;Valencia/València;134;Gilet;1363;682;681
46;Valencia/València;135;Godella;10641;5183;5458
46;Valencia/València;136;Godelleta;2070;1010;1060
46;Valencia/València;137;Granja de la Costera (La);365;175;190
46;Valencia/València;138;Guadasequies;424;215;209
46;Valencia/València;139;Guadassuar;5441;2708;2733
46;Valencia/València;140;Guardamar de la Safor;62;37;25
46;Valencia/València;141;Higueruelas;560;302;258
46;Valencia/València;142;Jalance;1185;614;571
46;Valencia/València;144;Jarafuel;1031;531;500
46;Valencia/València;154;Llanera de Ranes;1004;503;501
46;Valencia/València;155;Llaurí;1426;683;743
46;Valencia/València;147;Llíria;15042;7458;7584
46;Valencia/València;153;Llocnou de Sant Jeroni;572;282;290
46;Valencia/València;151;Llocnou d'En Fenollet;696;336;360
46;Valencia/València;156;Llombai;2282;1154;1128
46;Valencia/València;157;Llosa de Ranes (La);3654;1870;1784
46;Valencia/València;150;Llutxent;2418;1226;1192
46;Valencia/València;148;Loriguilla;1057;539;518
46;Valencia/València;149;Losa del Obispo;492;238;254
46;Valencia/València;152;Lugar Nuevo de la Corona;127;61;66
46;Valencia/València;158;Macastre;947;461;486
46;Valencia/València;159;Manises;25400;12388;13012
46;Valencia/València;160;Manuel;2471;1186;1285
46;Valencia/València;161;Marines;1273;657;616
46;Valencia/València;162;Masalavés;1492;764;728
46;Valencia/València;163;Massalfassar;1394;694;700
46;Valencia/València;164;Massamagrell;12518;6177;6341
46;Valencia/València;165;Massanassa;7784;3833;3951
46;Valencia/València;166;Meliana;9258;4511;4747
46;Valencia/València;167;Millares;724;363;361
46;Valencia/València;168;Miramar;1031;507;524
46;Valencia/València;169;Mislata;41015;20125;20890
46;Valencia/València;170;Mogente/Moixent;4270;2180;2090
46;Valencia/València;171;Moncada;18504;9179;9325
46;Valencia/València;172;Monserrat;2869;1485;1384
46;Valencia/València;173;Montaverner;1663;836;827
46;Valencia/València;174;Montesa;1241;619;622
46;Valencia/València;175;Montichelvo;612;308;304
46;Valencia/València;176;Montroy;1506;777;729
46;Valencia/València;177;Museros;4217;2094;2123
46;Valencia/València;178;Náquera;1969;998;971
46;Valencia/València;179;Navarrés;2780;1391;1389
46;Valencia/València;180;Novelé/Novetlè;642;314;328
46;Valencia/València;181;Oliva;20828;10255;10573
46;Valencia/València;183;Olleria (L');7007;3572;3435
46;Valencia/València;182;Olocau;725;390;335
46;Valencia/València;184;Ontinyent;31000;15237;15763
46;Valencia/València;185;Otos;547;269;278
46;Valencia/València;186;Paiporta;16780;8276;8504
46;Valencia/València;187;Palma de Gandía;1549;771;778
46;Valencia/València;188;Palmera;463;229;234
46;Valencia/València;189;Palomar (El);529;263;266
46;Valencia/València;190;Paterna;47284;23407;23877
46;Valencia/València;191;Pedralba;2098;1068;1030
46;Valencia/València;192;Petrés;782;374;408
46;Valencia/València;193;Picanya;8495;4255;4240
46;Valencia/València;194;Picassent;15437;7771;7666
46;Valencia/València;195;Piles;2077;1005;1072
46;Valencia/València;196;Pinet;259;137;122
46;Valencia/València;199;Pobla de Farnals (La);5313;2666;2647
46;Valencia/València;202;Pobla de Vallbona (La);9248;4740;4508
46;Valencia/València;200;Pobla del Duc (La);2580;1268;1312
46;Valencia/València;203;Pobla Llarga (La);4435;2164;2271
46;Valencia/València;197;Polinyà de Xúquer;3133;1548;1585
46;Valencia/València;198;Potríes;962;459;503
46;Valencia/València;205;Puçol;13483;6634;6849
46;Valencia/València;201;Puebla de San Miguel;62;33;29
46;Valencia/València;204;Puig;6973;3434;3539
46;Valencia/València;101;Quart de les Valls;1104;524;580
46;Valencia/València;102;Quart de Poblet;27707;13691;14016
46;Valencia/València;103;Quartell;1364;664;700
46;Valencia/València;104;Quatretonda;2574;1313;1261
46;Valencia/València;206;Quesa;836;426;410
46;Valencia/València;207;Rafelbuñol/Rafelbunyol;5081;2516;2565
46;Valencia/València;208;Rafelcofer;1415;654;761
46;Valencia/València;209;Rafelguaraf;2479;1217;1262
46;Valencia/València;210;Ráfol de Salem;373;170;203
46;Valencia/València;211;Real de Gandía;1873;886;987
46;Valencia/València;212;Real de Montroi;1853;947;906
46;Valencia/València;213;Requena;18683;9392;9291
46;Valencia/València;214;Riba-roja de Túria;11131;5563;5568
46;Valencia/València;215;Riola;1644;827;817
46;Valencia/València;216;Rocafort;4753;2338;2415
46;Valencia/València;217;Rotglá y Corberá;1029;520;509
46;Valencia/València;218;Rótova;1346;687;659
46;Valencia/València;219;Rugat;195;97;98
46;Valencia/València;220;Sagunto/Sagunt;57716;28319;29397
46;Valencia/València;221;Salem;474;243;231
46;Valencia/València;222;San Juan de Énova;370;160;210
46;Valencia/València;223;Sedaví;8322;4085;4237
46;Valencia/València;224;Segart;190;87;103
46;Valencia/València;225;Sellent;493;256;237
46;Valencia/València;226;Sempere;41;20;21
46;Valencia/València;227;Senyera;850;400;450
46;Valencia/València;228;Serra;1707;869;838
46;Valencia/València;229;Siete Aguas;1163;577;586
46;Valencia/València;230;Silla;16706;8507;8199
46;Valencia/València;231;Simat de la Valldigna;3160;1602;1558
46;Valencia/València;232;Sinarcas;1308;671;637
46;Valencia/València;233;Sollana;4501;2189;2312
46;Valencia/València;234;Sot de Chera;335;175;160
46;Valencia/València;235;Sueca;24844;12235;12609
46;Valencia/València;236;Sumacàrcer;1421;721;700
46;Valencia/València;237;Tavernes Blanques;8578;4221;4357
46;Valencia/València;238;Tavernes de la Valldigna;16422;8186;8236
46;Valencia/València;239;Teresa de Cofrentes;771;389;382
46;Valencia/València;240;Terrateig;204;105;99
46;Valencia/València;241;Titaguas;601;315;286
46;Valencia/València;242;Torrebaja;486;250;236
46;Valencia/València;243;Torrella;207;102;105
46;Valencia/València;244;Torrent;61323;30436;30887
46;Valencia/València;245;Torres Torres;402;192;210
46;Valencia/València;246;Tous;1211;588;623
46;Valencia/València;247;Tuéjar;1365;720;645
46;Valencia/València;248;Turís;4441;2275;2166
46;Valencia/València;249;Utiel;12014;5977;6037
46;Valencia/València;250;Valencia;763299;364161;399138
46;Valencia/València;251;Vallada;3016;1531;1485
46;Valencia/València;252;Vallanca;250;116;134
46;Valencia/València;253;Vallés;99;55;44
46;Valencia/València;254;Venta del Moro;1655;854;801
46;Valencia/València;256;Vilamarxant;5353;2705;2648
46;Valencia/València;255;Villalonga;3575;1786;1789
46;Valencia/València;257;Villanueva de Castellón;7076;3496;3580
46;Valencia/València;258;Villar del Arzobispo;3444;1713;1731
46;Valencia/València;259;Villargordo del Cabriel;745;383;362
46;Valencia/València;260;Vinalesa;2284;1078;1206
46;Valencia/València;145;Xàtiva;25992;12617;13375
46;Valencia/València;143;Xeraco;4731;2379;2352
46;Valencia/València;146;Xeresa;1958;986;972
46;Valencia/València;110;Xirivella;26784;13301;13483
46;Valencia/València;261;Yátova;2010;1055;955
46;Valencia/València;262;Yesa (La);280;138;142
46;Valencia/València;263;Zarra;457;237;220
47;Valladolid;001;Adalia;92;46;46
47;Valladolid;002;Aguasal;26;13;13
47;Valladolid;003;Aguilar de Campos;411;217;194
47;Valladolid;004;Alaejos;1788;929;859
47;Valladolid;005;Alcazarén;787;419;368
47;Valladolid;006;Aldea de San Miguel;247;121;126
47;Valladolid;007;Aldeamayor de San Martín;1240;619;621
47;Valladolid;008;Almenara de Adaja;34;19;15
47;Valladolid;009;Amusquillo;197;105;92
47;Valladolid;010;Arroyo de la Encomienda;1751;887;864
47;Valladolid;011;Ataquines;935;482;453
47;Valladolid;012;Bahabón;236;114;122
47;Valladolid;013;Barcial de la Loma;175;87;88
47;Valladolid;014;Barruelo del Valle;80;42;38
47;Valladolid;015;Becilla de Valderaduey;484;249;235
47;Valladolid;016;Benafarces;101;48;53
47;Valladolid;017;Bercero;300;155;145
47;Valladolid;018;Berceruelo;35;19;16
47;Valladolid;019;Berrueces;111;65;46
47;Valladolid;020;Bobadilla del Campo;441;231;210
47;Valladolid;021;Bocigas;171;85;86
47;Valladolid;022;Bocos de Duero;89;38;51
47;Valladolid;023;Boecillo;1120;578;542
47;Valladolid;024;Bolaños de Campos;396;198;198
47;Valladolid;025;Brahojos de Medina;185;104;81
47;Valladolid;026;Bustillo de Chaves;111;53;58
47;Valladolid;027;Cabezón de Pisuerga;1598;804;794
47;Valladolid;028;Cabezón de Valderaduey;59;32;27
47;Valladolid;029;Cabreros del Monte;112;61;51
47;Valladolid;030;Campaspero;1637;839;798
47;Valladolid;031;Campillo (El);252;139;113
47;Valladolid;032;Camporredondo;234;126;108
47;Valladolid;033;Canalejas de Peñafiel;335;171;164
47;Valladolid;034;Canillas de Esgueva;165;89;76
47;Valladolid;035;Carpio;1291;687;604
47;Valladolid;036;Casasola de Arión;402;217;185
47;Valladolid;037;Castrejón de Trabancos;281;154;127
47;Valladolid;038;Castrillo de Duero;247;126;121
47;Valladolid;039;Castrillo-Tejeriego;305;161;144
47;Valladolid;040;Castrobol;101;44;57
47;Valladolid;041;Castrodeza;258;138;120
47;Valladolid;042;Castromembibre;99;49;50
47;Valladolid;043;Castromonte;512;269;243
47;Valladolid;044;Castronuevo de Esgueva;316;164;152
47;Valladolid;045;Castronuño;1158;597;561
47;Valladolid;046;Castroponce;211;103;108
47;Valladolid;047;Castroverde de Cerrato;293;162;131
47;Valladolid;048;Ceinos de Campos;277;147;130
47;Valladolid;049;Cervillego de la Cruz;169;87;82
47;Valladolid;050;Cigales;2350;1129;1221
47;Valladolid;051;Ciguñuela;396;212;184
47;Valladolid;052;Cistérniga;2270;1167;1103
47;Valladolid;053;Cogeces de Íscar;156;80;76
47;Valladolid;054;Cogeces del Monte;1015;539;476
47;Valladolid;055;Corcos;277;141;136
47;Valladolid;056;Corrales de Duero;161;88;73
47;Valladolid;057;Cubillas de Santa Marta;266;142;124
47;Valladolid;058;Cuenca de Campos;297;148;149
47;Valladolid;059;Curiel de Duero;158;86;72
47;Valladolid;060;Encinas de Esgueva;427;228;199
47;Valladolid;061;Esguevillas de Esgueva;447;229;218
47;Valladolid;062;Fombellida;314;168;146
47;Valladolid;063;Fompedraza;153;86;67
47;Valladolid;064;Fontihoyuelo;48;28;20
47;Valladolid;065;Fresno el Viejo;1341;673;668
47;Valladolid;066;Fuensaldaña;833;416;417
47;Valladolid;067;Fuente el Sol;322;164;158
47;Valladolid;068;Fuente-Olmedo;67;33;34
47;Valladolid;069;Gallegos de Hornija;160;82;78
47;Valladolid;070;Gatón de Campos;55;31;24
47;Valladolid;071;Geria;445;238;207
47;Valladolid;073;Herrín de Campos;228;112;116
47;Valladolid;074;Hornillos de Eresma;149;77;72
47;Valladolid;075;Íscar;6100;3083;3017
47;Valladolid;076;Laguna de Duero;13458;6834;6624
47;Valladolid;077;Langayo;504;266;238
47;Valladolid;079;Llano de Olmedo;109;53;56
47;Valladolid;078;Lomoviejo;281;139;142
47;Valladolid;080;Manzanillo;69;37;32
47;Valladolid;081;Marzales;90;43;47
47;Valladolid;082;Matapozuelos;976;498;478
47;Valladolid;083;Matilla de los Caños;92;50;42
47;Valladolid;084;Mayorga;1692;825;867
47;Valladolid;086;Medina de Rioseco;5060;2492;2568
47;Valladolid;085;Medina del Campo;20139;9898;10241
47;Valladolid;087;Megeces;484;242;242
47;Valladolid;088;Melgar de Abajo;205;104;101
47;Valladolid;089;Melgar de Arriba;327;165;162
47;Valladolid;090;Mojados;2387;1188;1199
47;Valladolid;091;Monasterio de Vega;89;45;44
47;Valladolid;092;Montealegre de Campos;171;97;74
47;Valladolid;093;Montemayor de Pililla;1092;569;523
47;Valladolid;094;Moral de la Reina;253;135;118
47;Valladolid;095;Moraleja de las Panaderas;28;16;12
47;Valladolid;096;Morales de Campos;213;113;100
47;Valladolid;097;Mota del Marqués;481;228;253
47;Valladolid;098;Mucientes;649;325;324
47;Valladolid;099;Mudarra (La);286;150;136
47;Valladolid;100;Muriel;264;134;130
47;Valladolid;101;Nava del Rey;2367;1154;1213
47;Valladolid;102;Nueva Villa de las Torres;434;236;198
47;Valladolid;103;Olivares de Duero;339;183;156
47;Valladolid;104;Olmedo;3628;1788;1840
47;Valladolid;105;Olmos de Esgueva;207;113;94
47;Valladolid;106;Olmos de Peñafiel;93;49;44
47;Valladolid;109;Palazuelo de Vedija;220;121;99
47;Valladolid;110;Parrilla (La);682;327;355
47;Valladolid;111;Pedraja de Portillo (La);1120;559;561
47;Valladolid;112;Pedrajas de San Esteban;3230;1650;1580
47;Valladolid;113;Pedrosa del Rey;256;126;130
47;Valladolid;114;Peñafiel;5187;2645;2542
47;Valladolid;115;Peñaflor de Hornija;506;264;242
47;Valladolid;116;Pesquera de Duero;550;294;256
47;Valladolid;117;Piña de Esgueva;405;211;194
47;Valladolid;118;Piñel de Abajo;249;133;116
47;Valladolid;119;Piñel de Arriba;166;82;84
47;Valladolid;121;Pollos;874;448;426
47;Valladolid;122;Portillo;2603;1323;1280
47;Valladolid;123;Pozal de Gallinas;502;260;242
47;Valladolid;124;Pozaldez;564;272;292
47;Valladolid;125;Pozuelo de la Orden;88;47;41
47;Valladolid;126;Puras;66;33;33
47;Valladolid;127;Quintanilla de Arriba;249;130;119
47;Valladolid;129;Quintanilla de Onésimo;1211;633;578
47;Valladolid;130;Quintanilla de Trigueros;99;50;49
47;Valladolid;128;Quintanilla del Molar;92;39;53
47;Valladolid;131;Rábano;262;136;126
47;Valladolid;132;Ramiro;89;46;43
47;Valladolid;133;Renedo de Esgueva;924;486;438
47;Valladolid;134;Roales de Campos;286;149;137
47;Valladolid;135;Robladillo;101;51;50
47;Valladolid;137;Roturas;27;16;11
47;Valladolid;138;Rubí de Bracamonte;347;185;162
47;Valladolid;139;Rueda;1606;820;786
47;Valladolid;140;Saelices de Mayorga;207;110;97
47;Valladolid;141;Salvador de Zapardiel;213;110;103
47;Valladolid;142;San Cebrián de Mazote;249;132;117
47;Valladolid;143;San Llorente;227;118;109
47;Valladolid;144;San Martín de Valvení;109;64;45
47;Valladolid;145;San Miguel del Arroyo;865;451;414
47;Valladolid;146;San Miguel del Pino;246;134;112
47;Valladolid;147;San Pablo de la Moraleja;199;107;92
47;Valladolid;148;San Pedro de Latarce;697;382;315
47;Valladolid;149;San Pelayo;50;23;27
47;Valladolid;150;San Román de Hornija;497;247;250
47;Valladolid;151;San Salvador;52;26;26
47;Valladolid;156;San Vicente del Palacio;277;139;138
47;Valladolid;152;Santa Eufemia del Arroyo;146;68;78
47;Valladolid;153;Santervás de Campos;191;104;87
47;Valladolid;154;Santibáñez de Valcorba;226;116;110
47;Valladolid;155;Santovenia de Pisuerga;1319;660;659
47;Valladolid;157;Sardón de Duero;640;323;317
47;Valladolid;158;Seca (La);1076;561;515
47;Valladolid;159;Serrada;1044;536;508
47;Valladolid;160;Siete Iglesias de Trabancos;692;346;346
47;Valladolid;161;Simancas;2506;1276;1230
47;Valladolid;162;Tamariz de Campos;120;65;55
47;Valladolid;163;Tiedra;450;216;234
47;Valladolid;164;Tordehumos;587;296;291
47;Valladolid;165;Tordesillas;7948;4006;3942
47;Valladolid;169;Torre de Esgueva;124;58;66
47;Valladolid;170;Torre de Peñafiel;51;26;25
47;Valladolid;166;Torrecilla de la Abadesa;405;217;188
47;Valladolid;167;Torrecilla de la Orden;415;200;215
47;Valladolid;168;Torrecilla de la Torre;48;27;21
47;Valladolid;171;Torrelobatón;624;306;318
47;Valladolid;172;Torrescárcela;183;93;90
47;Valladolid;173;Traspinedo;828;425;403
47;Valladolid;174;Trigueros del Valle;299;152;147
47;Valladolid;175;Tudela de Duero;5579;2862;2717
47;Valladolid;176;Unión de Campos (La);357;169;188
47;Valladolid;177;Urones de Castroponce;193;109;84
47;Valladolid;178;Urueña;219;108;111
47;Valladolid;179;Valbuena de Duero;524;272;252
47;Valladolid;180;Valdearcos de la Vega;160;80;80
47;Valladolid;181;Valdenebro de los Valles;264;137;127
47;Valladolid;182;Valdestillas;1445;736;709
47;Valladolid;183;Valdunquillo;268;126;142
47;Valladolid;186;Valladolid;334820;162026;172794
47;Valladolid;184;Valoria la Buena;682;358;324
47;Valladolid;185;Valverde de Campos;121;65;56
47;Valladolid;187;Vega de Ruiponce;175;81;94
47;Valladolid;188;Vega de Valdetronco;209;111;98
47;Valladolid;189;Velascálvaro;199;103;96
47;Valladolid;190;Velilla;156;84;72
47;Valladolid;191;Velliza;165;94;71
47;Valladolid;192;Ventosa de la Cuesta;161;83;78
47;Valladolid;193;Viana de Cega;1230;636;594
47;Valladolid;195;Villabáñez;463;237;226
47;Valladolid;196;Villabaruz de Campos;58;28;30
47;Valladolid;197;Villabrágima;1302;677;625
47;Valladolid;198;Villacarralón;136;70;66
47;Valladolid;199;Villacid de Campos;108;60;48
47;Valladolid;200;Villaco;153;91;62
47;Valladolid;203;Villafrades de Campos;140;63;77
47;Valladolid;204;Villafranca de Duero;410;205;205
47;Valladolid;205;Villafrechós;548;277;271
47;Valladolid;206;Villafuerte;177;83;94
47;Valladolid;207;Villagarcía de Campos;455;237;218
47;Valladolid;208;Villagómez la Nueva;108;47;61
47;Valladolid;209;Villalán de Campos;54;27;27
47;Valladolid;210;Villalar de los Comuneros;507;255;252
47;Valladolid;211;Villalba de la Loma;53;29;24
47;Valladolid;212;Villalba de los Alcores;622;320;302
47;Valladolid;213;Villalbarba;178;87;91
47;Valladolid;214;Villalón de Campos;2235;1091;1144
47;Valladolid;215;Villamuriel de Campos;91;44;47
47;Valladolid;216;Villán de Tordesillas;180;89;91
47;Valladolid;217;Villanubla;943;498;445
47;Valladolid;218;Villanueva de Duero;893;458;435
47;Valladolid;219;Villanueva de la Condesa;47;30;17
47;Valladolid;220;Villanueva de los Caballeros;307;149;158
47;Valladolid;221;Villanueva de los Infantes;169;89;80
47;Valladolid;222;Villanueva de San Mancio;101;54;47
47;Valladolid;223;Villardefrades;278;148;130
47;Valladolid;224;Villarmentero de Esgueva;137;70;67
47;Valladolid;225;Villasexmir;138;74;64
47;Valladolid;226;Villavaquerín;228;122;106
47;Valladolid;227;Villavellid;71;41;30
47;Valladolid;228;Villaverde de Medina;627;337;290
47;Valladolid;229;Villavicencio de los Caballeros;367;178;189
47;Valladolid;194;Viloria;427;231;196
47;Valladolid;230;Wamba;385;197;188
47;Valladolid;231;Zaratán;1257;648;609
47;Valladolid;232;Zarza (La);175;89;86
48;Vizcaya;001;Abadiño;7049;3568;3481
48;Vizcaya;002;Abanto y Ciérvana-Abanto Zierbena;9779;4898;4881
48;Vizcaya;911;Ajangiz;377;196;181
48;Vizcaya;912;Alonsotegi;3044;1505;1539
48;Vizcaya;003;Amorebieta-Etxano;16113;8065;8048
48;Vizcaya;004;Amoroto;380;204;176
48;Vizcaya;005;Arakaldo;106;61;45
48;Vizcaya;006;Arantzazu;279;133;146
48;Vizcaya;093;Areatza;1119;508;611
48;Vizcaya;009;Arrankudiaga;733;357;376
48;Vizcaya;914;Arratzu;395;197;198
48;Vizcaya;010;Arrieta;429;218;211
48;Vizcaya;011;Arrigorriaga;10442;5158;5284
48;Vizcaya;023;Artea;613;299;314
48;Vizcaya;008;Artzentales;645;353;292
48;Vizcaya;091;Atxondo;1536;761;775
48;Vizcaya;070;Aulesti;686;367;319
48;Vizcaya;012;Bakio;1335;682;653
48;Vizcaya;090;Balmaseda;7272;3524;3748
48;Vizcaya;013;Barakaldo;102561;50388;52173
48;Vizcaya;014;Barrika;936;463;473
48;Vizcaya;015;Basauri;50024;24999;25025
48;Vizcaya;092;Bedia;1028;509;519
48;Vizcaya;016;Berango;4459;2229;2230
48;Vizcaya;017;Bermeo;17717;8772;8945
48;Vizcaya;018;Berriatua;1017;530;487
48;Vizcaya;019;Berriz;4160;2097;2063
48;Vizcaya;020;Bilbao;370997;177060;193937
48;Vizcaya;021;Busturia;1738;880;858
48;Vizcaya;901;Derio;4768;2368;2400
48;Vizcaya;026;Dima;1067;553;514
48;Vizcaya;027;Durango;23354;11488;11866
48;Vizcaya;028;Ea;831;413;418
48;Vizcaya;031;Elantxobe;518;232;286
48;Vizcaya;032;Elorrio;7416;3716;3700
48;Vizcaya;902;Erandio;24392;12027;12365
48;Vizcaya;033;Ereño;281;134;147
48;Vizcaya;034;Ermua;17824;9149;8675
48;Vizcaya;079;Errigoiti;437;234;203
48;Vizcaya;029;Etxebarri, Anteiglesia de San Esteban-Etxebarri Doneztebeko Elizatea;6505;3288;3217
48;Vizcaya;030;Etxebarria;797;413;384
48;Vizcaya;906;Forua;927;472;455
48;Vizcaya;035;Fruiz;325;167;158
48;Vizcaya;036;Galdakao;29691;14809;14882
48;Vizcaya;037;Galdames;818;429;389
48;Vizcaya;038;Gamiz-Fika;960;508;452
48;Vizcaya;039;Garay;255;139;116
48;Vizcaya;040;Gatika;975;492;483
48;Vizcaya;041;Gautegiz Arteaga;766;374;392
48;Vizcaya;046;Gernika-Lumo;15800;7727;8073
48;Vizcaya;044;Getxo;83936;40413;43523
48;Vizcaya;047;Gizaburuaga;136;69;67
48;Vizcaya;042;Gordexola;1495;747;748
48;Vizcaya;043;Gorliz;3414;1689;1725
48;Vizcaya;045;Güeñes;5925;2941;2984
48;Vizcaya;048;Ibarrangelu;545;253;292
48;Vizcaya;094;Igorre;3950;1970;1980
48;Vizcaya;049;Ispaster;622;327;295
48;Vizcaya;910;Iurreta;4731;2349;2382
48;Vizcaya;050;Izurtza;279;143;136
48;Vizcaya;022;Karrantza Harana/Valle de Carranza;3150;1672;1478
48;Vizcaya;907;Kortezubi;385;204;181
48;Vizcaya;051;Lanestosa;295;151;144
48;Vizcaya;052;Larrabetzu;1506;753;753
48;Vizcaya;053;Laukiz;969;498;471
48;Vizcaya;054;Leioa;25758;12754;13004
48;Vizcaya;057;Lekeitio;7517;3682;3835
48;Vizcaya;055;Lemoa;2587;1313;1274
48;Vizcaya;056;Lemoiz;795;415;380
48;Vizcaya;081;Lezama;2040;1030;1010
48;Vizcaya;903;Loiu;1762;898;864
48;Vizcaya;058;Mallabia;1111;594;517
48;Vizcaya;059;Mañaria;504;267;237
48;Vizcaya;060;Markina-Xemein;4782;2371;2411
48;Vizcaya;061;Maruri-Jatabe;569;275;294
48;Vizcaya;062;Mendata;341;187;154
48;Vizcaya;063;Mendexa;344;178;166
48;Vizcaya;064;Meñaka;436;229;207
48;Vizcaya;066;Morga;336;173;163
48;Vizcaya;068;Mundaka;1774;820;954
48;Vizcaya;069;Mungia;12816;6311;6505
48;Vizcaya;007;Munitibar-Arbatzegi Gerrikaitz;424;231;193
48;Vizcaya;908;Murueta;195;96;99
48;Vizcaya;071;Muskiz;6500;3200;3300
48;Vizcaya;067;Muxika;1416;733;683
48;Vizcaya;909;Nabarniz;259;127;132
48;Vizcaya;073;Ondarroa;10517;5264;5253
48;Vizcaya;075;Orozko;1873;947;926
48;Vizcaya;083;Ortuella;8732;4302;4430
48;Vizcaya;072;Otxandio;1061;552;509
48;Vizcaya;077;Plentzia;3191;1533;1658
48;Vizcaya;078;Portugalete;56109;27588;28521
48;Vizcaya;082;Santurtzi;50281;24825;25456
48;Vizcaya;084;Sestao;35464;17283;18181
48;Vizcaya;904;Sondika;3554;1731;1823
48;Vizcaya;085;Sopelana;9085;4539;4546
48;Vizcaya;086;Sopuerta;2260;1150;1110
48;Vizcaya;076;Sukarrieta;323;158;165
48;Vizcaya;087;Trucios-Turtzioz;538;265;273
48;Vizcaya;088;Ubide;148;71;77
48;Vizcaya;065;Ugao-Miraballes;4169;2099;2070
48;Vizcaya;089;Urduliz;2728;1339;1389
48;Vizcaya;074;Urduña-Orduña;4007;2057;1950
48;Vizcaya;080;Valle de Trápaga-Trapagaran;13143;6476;6667
48;Vizcaya;095;Zaldibar;3018;1444;1574
48;Vizcaya;096;Zalla;7516;3701;3815
48;Vizcaya;905;Zamudio;3111;1558;1553
48;Vizcaya;097;Zaratamo;1583;788;795
48;Vizcaya;024;Zeanuri;1126;595;531
48;Vizcaya;025;Zeberio;909;469;440
48;Vizcaya;913;Zierbena;"";"";""
49;Zamora;002;Abezames;120;57;63
49;Zamora;003;Alcañices;1217;614;603
49;Zamora;004;Alcubilla de Nogales;241;118;123
49;Zamora;005;Alfaraz de Sayago;235;126;109
49;Zamora;006;Algodre;231;120;111
49;Zamora;007;Almaraz de Duero;485;241;244
49;Zamora;008;Almeida de Sayago;735;383;352
49;Zamora;009;Andavías;534;250;284
49;Zamora;010;Arcenillas;267;134;133
49;Zamora;011;Arcos de la Polvorosa;322;170;152
49;Zamora;012;Argañín;125;57;68
49;Zamora;013;Argujillo;417;222;195
49;Zamora;014;Arquillinos;196;97;99
49;Zamora;015;Arrabalde;469;226;243
49;Zamora;016;Aspariegos;425;197;228
49;Zamora;017;Asturianos;409;198;211
49;Zamora;018;Ayoó de Vidriales;540;265;275
49;Zamora;019;Barcial del Barco;321;175;146
49;Zamora;020;Belver de los Montes;551;291;260
49;Zamora;021;Benavente;15916;7769;8147
49;Zamora;022;Benegiles;472;255;217
49;Zamora;023;Bermillo de Sayago;1610;833;777
49;Zamora;024;Bóveda de Toro (La);1038;526;512
49;Zamora;025;Bretó;293;151;142
49;Zamora;026;Bretocino;338;183;155
49;Zamora;027;Brime de Sog;276;126;150
49;Zamora;028;Brime de Urz;187;107;80
49;Zamora;029;Burganes de Valverde;911;457;454
49;Zamora;030;Bustillo del Oro;197;97;100
49;Zamora;031;Cabañas de Sayago;241;123;118
49;Zamora;032;Calzadilla de Tera;604;290;314
49;Zamora;033;Camarzana de Tera;1114;552;562
49;Zamora;034;Cañizal;682;354;328
49;Zamora;035;Cañizo;377;185;192
49;Zamora;036;Carbajales de Alba;750;376;374
49;Zamora;037;Carbellino;282;146;136
49;Zamora;038;Casaseca de Campeán;166;89;77
49;Zamora;039;Casaseca de las Chanas;406;200;206
49;Zamora;040;Castrillo de la Guareña;204;101;103
49;Zamora;041;Castrogonzalo;575;299;276
49;Zamora;042;Castronuevo;393;202;191
49;Zamora;043;Castroverde de Campos;456;224;232
49;Zamora;044;Cazurra;107;58;49
49;Zamora;046;Cerecinos de Campos;491;257;234
49;Zamora;047;Cerecinos del Carrizal;182;95;87
49;Zamora;048;Cernadilla;205;94;111
49;Zamora;050;Cobreros;856;421;435
49;Zamora;052;Coomonte;374;195;179
49;Zamora;053;Coreses;1305;675;630
49;Zamora;054;Corrales;1300;638;662
49;Zamora;055;Cotanes del Monte;197;102;95
49;Zamora;056;Cubillos;436;221;215
49;Zamora;057;Cubo de Benavente;247;129;118
49;Zamora;058;Cubo de Tierra del Vino (El);496;256;240
49;Zamora;059;Cuelgamures;159;90;69
49;Zamora;061;Entrala;179;87;92
49;Zamora;062;Espadañedo;252;120;132
49;Zamora;063;Faramontanos de Tábara;584;293;291
49;Zamora;064;Fariza;773;391;382
49;Zamora;065;Fermoselle;1868;888;980
49;Zamora;066;Ferreras de Abajo;665;340;325
49;Zamora;067;Ferreras de Arriba;573;292;281
49;Zamora;068;Ferreruela;730;386;344
49;Zamora;069;Figueruela de Arriba;603;298;305
49;Zamora;071;Fonfría;1259;630;629
49;Zamora;075;Fresno de la Polvorosa;266;135;131
49;Zamora;076;Fresno de la Ribera;444;244;200
49;Zamora;077;Fresno de Sayago;316;160;156
49;Zamora;078;Friera de Valverde;321;164;157
49;Zamora;079;Fuente Encalada;174;90;84
49;Zamora;080;Fuentelapeña;1106;552;554
49;Zamora;082;Fuentes de Ropel;684;356;328
49;Zamora;081;Fuentesaúco;1968;965;1003
49;Zamora;083;Fuentesecas;99;48;51
49;Zamora;084;Fuentespreadas;430;233;197
49;Zamora;085;Galende;1426;706;720
49;Zamora;086;Gallegos del Pan;186;94;92
49;Zamora;087;Gallegos del Río;944;494;450
49;Zamora;088;Gamones;113;64;49
49;Zamora;090;Gema;322;160;162
49;Zamora;091;Granja de Moreruela;415;195;220
49;Zamora;092;Granucillo;290;149;141
49;Zamora;093;Guarrate;413;223;190
49;Zamora;094;Hermisende;506;255;251
49;Zamora;095;Hiniesta (La);442;215;227
49;Zamora;096;Jambrina;307;154;153
49;Zamora;097;Justel;237;125;112
49;Zamora;098;Losacino;386;203;183
49;Zamora;099;Losacio;187;104;83
49;Zamora;100;Lubián;426;210;216
49;Zamora;101;Luelmo;289;155;134
49;Zamora;102;Maderal (El);303;155;148
49;Zamora;103;Madridanos;589;301;288
49;Zamora;104;Mahide;604;319;285
49;Zamora;105;Maire de Castroponce;275;140;135
49;Zamora;107;Malva;266;125;141
49;Zamora;108;Manganeses de la Lampreana;898;461;437
49;Zamora;109;Manganeses de la Polvorosa;951;458;493
49;Zamora;110;Manzanal de Arriba;542;277;265
49;Zamora;112;Manzanal de los Infantes;241;118;123
49;Zamora;111;Manzanal del Barco;240;128;112
49;Zamora;113;Matilla de Arzón;316;168;148
49;Zamora;114;Matilla la Seca;86;45;41
49;Zamora;115;Mayalde;277;142;135
49;Zamora;116;Melgar de Tera;662;327;335
49;Zamora;117;Micereces de Tera;689;355;334
49;Zamora;118;Milles de la Polvorosa;301;148;153
49;Zamora;119;Molacillos;329;176;153
49;Zamora;120;Molezuelas de la Carballeda;158;80;78
49;Zamora;121;Mombuey;530;270;260
49;Zamora;122;Monfarracinos;574;304;270
49;Zamora;123;Montamarta;778;375;403
49;Zamora;124;Moral de Sayago;418;222;196
49;Zamora;126;Moraleja de Sayago;324;168;156
49;Zamora;125;Moraleja del Vino;1243;645;598
49;Zamora;128;Morales de Rey;827;406;421
49;Zamora;129;Morales de Toro;1159;577;582
49;Zamora;130;Morales de Valverde;350;173;177
49;Zamora;127;Morales del Vino;1338;682;656
49;Zamora;131;Moralina;405;220;185
49;Zamora;132;Moreruela de los Infanzones;515;271;244
49;Zamora;133;Moreruela de Tábara;622;322;300
49;Zamora;134;Muelas de los Caballeros;274;141;133
49;Zamora;135;Muelas del Pan;970;479;491
49;Zamora;136;Muga de Sayago;545;263;282
49;Zamora;137;Navianos de Valverde;286;159;127
49;Zamora;138;Olmillos de Castro;493;247;246
49;Zamora;139;Otero de Bodas;305;158;147
49;Zamora;141;Pajares de la Lampreana;566;283;283
49;Zamora;143;Palacios de Sanabria;337;162;175
49;Zamora;142;Palacios del Pan;284;132;152
49;Zamora;145;Pedralba de la Pradería;416;209;207
49;Zamora;146;Pego (El);501;258;243
49;Zamora;147;Peleagonzalo;485;244;241
49;Zamora;148;Peleas de Abajo;226;117;109
49;Zamora;149;Peñausende;646;325;321
49;Zamora;150;Peque;255;125;130
49;Zamora;151;Perdigón (El);893;453;440
49;Zamora;152;Pereruela;855;427;428
49;Zamora;153;Perilla de Castro;290;147;143
49;Zamora;154;Pías;280;144;136
49;Zamora;155;Piedrahita de Castro;176;109;67
49;Zamora;156;Pinilla de Toro;458;234;224
49;Zamora;157;Pino del Oro;268;144;124
49;Zamora;158;Piñero (El);329;188;141
49;Zamora;160;Pobladura de Valderaduey;89;41;48
49;Zamora;159;Pobladura del Valle;378;182;196
49;Zamora;162;Porto;408;208;200
49;Zamora;163;Pozoantiguo;403;203;200
49;Zamora;164;Pozuelo de Tábara;282;136;146
49;Zamora;165;Prado;130;62;68
49;Zamora;166;Puebla de Sanabria;1721;808;913
49;Zamora;167;Pueblica de Valverde;396;200;196
49;Zamora;170;Quintanilla de Urz;147;78;69
49;Zamora;168;Quintanilla del Monte;167;76;91
49;Zamora;169;Quintanilla del Olmo;70;33;37
49;Zamora;171;Quiruelas de Vidriales;1051;508;543
49;Zamora;172;Rabanales;963;492;471
49;Zamora;173;Rábano de Aliste;548;270;278
49;Zamora;174;Requejo;261;126;135
49;Zamora;175;Revellinos;388;196;192
49;Zamora;176;Riofrío de Aliste;1135;594;541
49;Zamora;177;Rionegro del Puente;445;219;226
49;Zamora;178;Roales;368;185;183
49;Zamora;179;Robleda-Cervantes;520;245;275
49;Zamora;180;Roelos de Sayago;177;90;87
49;Zamora;181;Rosinos de la Requejada;618;292;326
49;Zamora;183;Salce;167;89;78
49;Zamora;184;Samir de los Caños;272;144;128
49;Zamora;185;San Agustín del Pozo;221;122;99
49;Zamora;186;San Cebrián de Castro;465;217;248
49;Zamora;187;San Cristóbal de Entreviñas;1660;843;817
49;Zamora;188;San Esteban del Molar;216;121;95
49;Zamora;189;San Justo;397;188;209
49;Zamora;190;San Martín de Valderaduey;100;43;57
49;Zamora;191;San Miguel de la Ribera;464;230;234
49;Zamora;192;San Miguel del Valle;275;128;147
49;Zamora;193;San Pedro de Ceque;741;365;376
49;Zamora;194;San Pedro de la Nave-Almendra;553;274;279
49;Zamora;208;San Vicente de la Cabeza;724;377;347
49;Zamora;209;San Vitero;813;426;387
49;Zamora;197;Santa Clara de Avedillo;284;138;146
49;Zamora;199;Santa Colomba de las Monjas;372;190;182
49;Zamora;200;Santa Cristina de la Polvorosa;1337;677;660
49;Zamora;201;Santa Croya de Tera;539;273;266
49;Zamora;202;Santa Eufemia del Barco;340;186;154
49;Zamora;203;Santa María de la Vega;551;287;264
49;Zamora;204;Santa María de Valverde;129;67;62
49;Zamora;205;Santibáñez de Tera;642;330;312
49;Zamora;206;Santibáñez de Vidriales;1535;752;783
49;Zamora;207;Santovenia;493;242;251
49;Zamora;210;Sanzoles;773;398;375
49;Zamora;214;Tábara;980;505;475
49;Zamora;216;Tapioles;271;151;120
49;Zamora;219;Toro;9678;4697;4981
49;Zamora;220;Torre del Valle (La);205;109;96
49;Zamora;221;Torregamones;393;188;205
49;Zamora;222;Torres del Carrizal;566;291;275
49;Zamora;223;Trabazos;1084;549;535
49;Zamora;224;Trefacio;262;122;140
49;Zamora;225;Uña de Quintana;274;136;138
49;Zamora;226;Vadillo de la Guareña;373;189;184
49;Zamora;227;Valcabado;357;178;179
49;Zamora;228;Valdefinjas;104;58;46
49;Zamora;229;Valdescorriel;201;98;103
49;Zamora;230;Vallesa de la Guareña;205;112;93
49;Zamora;231;Vega de Tera;607;288;319
49;Zamora;232;Vega de Villalobos;178;88;90
49;Zamora;233;Vegalatrave;198;92;106
49;Zamora;234;Venialbo;594;310;284
49;Zamora;235;Vezdemarbán;744;356;388
49;Zamora;236;Vidayanes;135;64;71
49;Zamora;237;Videmala;251;123;128
49;Zamora;238;Villabrázaro;452;228;224
49;Zamora;239;Villabuena del Puente;1085;561;524
49;Zamora;240;Villadepera;309;151;158
49;Zamora;241;Villaescusa;456;231;225
49;Zamora;242;Villafáfila;690;340;350
49;Zamora;243;Villaferrueña;178;91;87
49;Zamora;244;Villageriz;71;37;34
49;Zamora;245;Villalazán;419;208;211
49;Zamora;246;Villalba de la Lampreana;370;192;178
49;Zamora;247;Villalcampo;783;371;412
49;Zamora;248;Villalobos;346;167;179
49;Zamora;249;Villalonso;164;75;89
49;Zamora;250;Villalpando;1822;884;938
49;Zamora;251;Villalube;366;182;184
49;Zamora;252;Villamayor de Campos;648;324;324
49;Zamora;255;Villamor de los Escuderos;610;311;299
49;Zamora;256;Villanázar;412;197;215
49;Zamora;257;Villanueva de Azoague;412;212;200
49;Zamora;258;Villanueva de Campeán;216;110;106
49;Zamora;259;Villanueva de las Peras;231;114;117
49;Zamora;260;Villanueva del Campo;1181;581;600
49;Zamora;263;Villar de Fallaves;127;67;60
49;Zamora;264;Villar del Buey;965;516;449
49;Zamora;261;Villaralbo;1590;795;795
49;Zamora;262;Villardeciervos;579;264;315
49;Zamora;265;Villardiegua de la Ribera;189;91;98
49;Zamora;266;Villárdiga;127;60;67
49;Zamora;267;Villardondiego;162;88;74
49;Zamora;268;Villarrín de Campos;663;336;327
49;Zamora;269;Villaseco del Pan;368;180;188
49;Zamora;270;Villavendimio;244;132;112
49;Zamora;272;Villaveza de Valverde;164;84;80
49;Zamora;271;Villaveza del Agua;319;163;156
49;Zamora;273;Viñas;336;174;162
49;Zamora;275;Zamora;66017;31423;34594
50;Zaragoza;001;Abanto;202;103;99
50;Zaragoza;002;Acered;307;159;148
50;Zaragoza;003;Agón;211;109;102
50;Zaragoza;004;Aguarón;757;372;385
50;Zaragoza;005;Aguilón;262;132;130
50;Zaragoza;006;Ainzón;1223;611;612
50;Zaragoza;007;Aladrén;66;38;28
50;Zaragoza;008;Alagón;5651;2792;2859
50;Zaragoza;009;Alarba;173;96;77
50;Zaragoza;010;Alberite de San Juan;112;58;54
50;Zaragoza;011;Albeta;137;66;71
50;Zaragoza;012;Alborge;126;61;65
50;Zaragoza;013;Alcalá de Ebro;332;162;170
50;Zaragoza;014;Alcalá de Moncayo;162;91;71
50;Zaragoza;015;Alconchel de Ariza;188;99;89
50;Zaragoza;016;Aldehuela de Liestos;78;40;38
50;Zaragoza;017;Alfajarín;1459;760;699
50;Zaragoza;018;Alfamén;1323;703;620
50;Zaragoza;019;Alforque;88;46;42
50;Zaragoza;020;Alhama de Aragón;1223;592;631
50;Zaragoza;021;Almochuel;48;28;20
50;Zaragoza;022;Almolda (La);719;354;365
50;Zaragoza;023;Almonacid de la Cuba;373;192;181
50;Zaragoza;024;Almonacid de la Sierra;845;435;410
50;Zaragoza;025;Almunia de Doña Godina (La);5269;2695;2574
50;Zaragoza;026;Alpartir;628;328;300
50;Zaragoza;027;Ambel;394;189;205
50;Zaragoza;028;Anento;103;52;51
50;Zaragoza;029;Aniñón;944;496;448
50;Zaragoza;030;Añón de Moncayo;327;185;142
50;Zaragoza;031;Aranda de Moncayo;263;145;118
50;Zaragoza;032;Arándiga;558;278;280
50;Zaragoza;033;Ardisa;76;40;36
50;Zaragoza;034;Ariza;1361;676;685
50;Zaragoza;035;Artieda;100;56;44
50;Zaragoza;036;Asín;106;50;56
50;Zaragoza;037;Atea;271;148;123
50;Zaragoza;038;Ateca;2126;1035;1091
50;Zaragoza;039;Azuara;776;409;367
50;Zaragoza;040;Badules;119;59;60
50;Zaragoza;041;Bagüés;30;17;13
50;Zaragoza;042;Balconchán;34;19;15
50;Zaragoza;043;Bárboles;337;177;160
50;Zaragoza;044;Bardallur;310;150;160
50;Zaragoza;045;Belchite;1667;843;824
50;Zaragoza;046;Belmonte de Gracián;328;180;148
50;Zaragoza;047;Berdejo;44;23;21
50;Zaragoza;048;Berrueco;38;21;17
50;Zaragoza;901;Biel;225;119;106
50;Zaragoza;050;Bijuesca;145;82;63
50;Zaragoza;051;Biota;1286;667;619
50;Zaragoza;052;Bisimbre;148;68;80
50;Zaragoza;053;Boquiñeni;1041;528;513
50;Zaragoza;054;Bordalba;103;58;45
50;Zaragoza;055;Borja;4197;2042;2155
50;Zaragoza;056;Botorrita;461;248;213
50;Zaragoza;057;Brea de Aragón;2032;1001;1031
50;Zaragoza;058;Bubierca;114;54;60
50;Zaragoza;059;Bujaraloz;1073;561;512
50;Zaragoza;060;Bulbuente;270;146;124
50;Zaragoza;061;Bureta;338;166;172
50;Zaragoza;062;Burgo de Ebro (El);1385;691;694
50;Zaragoza;063;Buste (El);114;58;56
50;Zaragoza;064;Cabañas de Ebro;547;282;265
50;Zaragoza;065;Cabolafuente;98;56;42
50;Zaragoza;066;Cadrete;1188;628;560
50;Zaragoza;067;Calatayud;17256;8272;8984
50;Zaragoza;068;Calatorao;2637;1359;1278
50;Zaragoza;069;Calcena;103;52;51
50;Zaragoza;070;Calmarza;114;59;55
50;Zaragoza;071;Campillo de Aragón;217;126;91
50;Zaragoza;072;Carenas;254;123;131
50;Zaragoza;073;Cariñena;2918;1460;1458
50;Zaragoza;074;Caspe;8182;4065;4117
50;Zaragoza;075;Castejón de Alarba;128;73;55
50;Zaragoza;076;Castejón de las Armas;171;88;83
50;Zaragoza;077;Castejón de Valdejasa;379;206;173
50;Zaragoza;078;Castiliscar;449;223;226
50;Zaragoza;079;Cervera de la Cañada;365;177;188
50;Zaragoza;080;Cerveruela;4;2;2
50;Zaragoza;081;Cetina;798;393;405
50;Zaragoza;092;Chiprana;435;219;216
50;Zaragoza;093;Chodes;146;73;73
50;Zaragoza;082;Cimballa;141;70;71
50;Zaragoza;083;Cinco Olivas;138;66;72
50;Zaragoza;084;Clarés de Ribota;102;53;49
50;Zaragoza;085;Codo;301;150;151
50;Zaragoza;086;Codos;310;181;129
50;Zaragoza;087;Contamina;65;36;29
50;Zaragoza;088;Cosuenda;443;222;221
50;Zaragoza;089;Cuarte de Huerva;1613;834;779
50;Zaragoza;090;Cubel;254;124;130
50;Zaragoza;091;Cuerlas (Las);105;52;53
50;Zaragoza;094;Daroca;2399;1191;1208
50;Zaragoza;095;Ejea de los Caballeros;15624;7957;7667
50;Zaragoza;096;Embid de Ariza;70;37;33
50;Zaragoza;098;Encinacorba;340;182;158
50;Zaragoza;099;Épila;3978;2059;1919
50;Zaragoza;100;Erla;507;237;270
50;Zaragoza;101;Escatrón;1403;690;713
50;Zaragoza;102;Fabara;1290;685;605
50;Zaragoza;104;Farlete;475;241;234
50;Zaragoza;105;Fayón;413;212;201
50;Zaragoza;106;Fayos (Los);215;119;96
50;Zaragoza;107;Figueruelas;961;481;480
50;Zaragoza;108;Fombuena;23;19;4
50;Zaragoza;109;Frago (El);114;68;46
50;Zaragoza;110;Frasno (El);602;318;284
50;Zaragoza;111;Fréscano;284;140;144
50;Zaragoza;113;Fuendejalón;965;481;484
50;Zaragoza;114;Fuendetodos;175;97;78
50;Zaragoza;115;Fuentes de Ebro;3877;1990;1887
50;Zaragoza;116;Fuentes de Jiloca;398;208;190
50;Zaragoza;117;Gallocanta;196;100;96
50;Zaragoza;118;Gallur;3009;1508;1501
50;Zaragoza;119;Gelsa;1317;664;653
50;Zaragoza;120;Godojos;83;44;39
50;Zaragoza;121;Gotor;390;202;188
50;Zaragoza;122;Grisel;69;36;33
50;Zaragoza;123;Grisén;471;236;235
50;Zaragoza;124;Herrera de los Navarros;655;341;314
50;Zaragoza;125;Ibdes;618;314;304
50;Zaragoza;126;Illueca;3232;1603;1629
50;Zaragoza;128;Isuerre;64;34;30
50;Zaragoza;129;Jaraba;341;173;168
50;Zaragoza;130;Jarque;598;319;279
50;Zaragoza;131;Jaulín;308;159;149
50;Zaragoza;132;Joyosa (La);355;178;177
50;Zaragoza;133;Lagata;144;80;64
50;Zaragoza;134;Langa del Castillo;201;93;108
50;Zaragoza;135;Layana;174;84;90
50;Zaragoza;136;Lécera;933;455;478
50;Zaragoza;138;Lechón;59;34;25
50;Zaragoza;137;Leciñena;1403;693;710
50;Zaragoza;139;Letux;487;251;236
50;Zaragoza;140;Litago;189;108;81
50;Zaragoza;141;Lituénigo;128;63;65
50;Zaragoza;142;Lobera de Onsella;57;35;22
50;Zaragoza;143;Longares;904;474;430
50;Zaragoza;144;Longás;39;26;13
50;Zaragoza;146;Lucena de Jalón;309;153;156
50;Zaragoza;147;Luceni;1073;529;544
50;Zaragoza;148;Luesia;441;229;212
50;Zaragoza;149;Luesma;28;15;13
50;Zaragoza;150;Lumpiaque;983;520;463
50;Zaragoza;151;Luna;962;504;458
50;Zaragoza;152;Maella;2120;1063;1057
50;Zaragoza;153;Magallón;1283;677;606
50;Zaragoza;154;Mainar;194;110;84
50;Zaragoza;155;Malanquilla;144;73;71
50;Zaragoza;156;Maleján;321;166;155
50;Zaragoza;160;Mallén;3008;1532;1476
50;Zaragoza;157;Malón;501;251;250
50;Zaragoza;159;Maluenda;1037;510;527
50;Zaragoza;161;Manchones;162;79;83
50;Zaragoza;162;Mara;234;122;112
50;Zaragoza;163;María de Huerva;845;402;443
50;Zaragoza;902;Marracos;"";"";""
50;Zaragoza;164;Mediana de Aragón;521;264;257
50;Zaragoza;165;Mequinenza;2673;1344;1329
50;Zaragoza;166;Mesones de Isuela;415;206;209
50;Zaragoza;167;Mezalocha;330;177;153
50;Zaragoza;168;Mianos;38;21;17
50;Zaragoza;169;Miedes de Aragón;536;274;262
50;Zaragoza;170;Monegrillo;554;293;261
50;Zaragoza;171;Moneva;134;67;67
50;Zaragoza;172;Monreal de Ariza;331;171;160
50;Zaragoza;173;Monterde;271;140;131
50;Zaragoza;174;Montón;155;76;79
50;Zaragoza;175;Morata de Jalón;1682;816;866
50;Zaragoza;176;Morata de Jiloca;361;198;163
50;Zaragoza;177;Morés;567;292;275
50;Zaragoza;178;Moros;571;294;277
50;Zaragoza;179;Moyuela;397;196;201
50;Zaragoza;180;Mozota;116;57;59
50;Zaragoza;181;Muel;1187;597;590
50;Zaragoza;182;Muela (La);1053;549;504
50;Zaragoza;183;Munébrega;500;264;236
50;Zaragoza;184;Murero;160;90;70
50;Zaragoza;185;Murillo de Gállego;156;81;75
50;Zaragoza;186;Navardún;83;44;39
50;Zaragoza;187;Nigüella;133;67;66
50;Zaragoza;188;Nombrevilla;33;17;16
50;Zaragoza;189;Nonaspe;1119;562;557
50;Zaragoza;190;Novallas;817;404;413
50;Zaragoza;191;Novillas;726;363;363
50;Zaragoza;192;Nuévalos;318;189;129
50;Zaragoza;193;Nuez de Ebro;570;301;269
50;Zaragoza;194;Olvés;173;95;78
50;Zaragoza;195;Orcajo;56;27;29
50;Zaragoza;196;Orera;164;84;80
50;Zaragoza;197;Orés;125;69;56
50;Zaragoza;198;Oseja;29;12;17
50;Zaragoza;199;Osera de Ebro;357;176;181
50;Zaragoza;200;Paniza;756;370;386
50;Zaragoza;201;Paracuellos de Jiloca;532;248;284
50;Zaragoza;202;Paracuellos de la Ribera;344;162;182
50;Zaragoza;203;Pastriz;818;401;417
50;Zaragoza;204;Pedrola;2557;1311;1246
50;Zaragoza;205;Pedrosas (Las);106;50;56
50;Zaragoza;206;Perdiguera;463;242;221
50;Zaragoza;207;Piedratajada;218;113;105
50;Zaragoza;208;Pina de Ebro;2222;1113;1109
50;Zaragoza;209;Pinseque;1391;693;698
50;Zaragoza;210;Pintanos (Los);85;48;37
50;Zaragoza;211;Plasencia de Jalón;382;202;180
50;Zaragoza;212;Pleitas;76;41;35
50;Zaragoza;213;Plenas;176;90;86
50;Zaragoza;214;Pomer;20;9;11
50;Zaragoza;215;Pozuel de Ariza;34;20;14
50;Zaragoza;216;Pozuelo de Aragón;381;208;173
50;Zaragoza;217;Pradilla de Ebro;677;358;319
50;Zaragoza;218;Puebla de Albortón;150;80;70
50;Zaragoza;219;Puebla de Alfindén (La);1539;792;747
50;Zaragoza;220;Puendeluna;65;36;29
50;Zaragoza;221;Purujosa;37;23;14
50;Zaragoza;222;Quinto;2180;1105;1075
50;Zaragoza;223;Remolinos;1261;639;622
50;Zaragoza;224;Retascón;81;43;38
50;Zaragoza;225;Ricla;2047;1050;997
50;Zaragoza;227;Romanos;151;85;66
50;Zaragoza;228;Rueda de Jalón;361;185;176
50;Zaragoza;229;Ruesca;84;43;41
50;Zaragoza;241;Sabiñán;1013;493;520
50;Zaragoza;230;Sádaba;1789;907;882
50;Zaragoza;231;Salillas de Jalón;378;196;182
50;Zaragoza;232;Salvatierra de Esca;314;169;145
50;Zaragoza;233;Samper del Salz;108;52;56
50;Zaragoza;234;San Martín de la Virgen de Moncayo;315;164;151
50;Zaragoza;235;San Mateo de Gállego;1926;991;935
50;Zaragoza;236;Santa Cruz de Grío;254;139;115
50;Zaragoza;237;Santa Cruz de Moncayo;104;55;49
50;Zaragoza;238;Santa Eulalia de Gállego;143;65;78
50;Zaragoza;239;Santed;84;36;48
50;Zaragoza;240;Sástago;1584;796;788
50;Zaragoza;242;Sediles;107;54;53
50;Zaragoza;243;Sestrica;554;281;273
50;Zaragoza;244;Sierra de Luna;295;152;143
50;Zaragoza;245;Sigüés;200;107;93
50;Zaragoza;246;Sisamón;99;60;39
50;Zaragoza;247;Sobradiel;587;275;312
50;Zaragoza;248;Sos del Rey Católico;867;437;430
50;Zaragoza;249;Tabuenca;523;280;243
50;Zaragoza;250;Talamantes;62;31;31
50;Zaragoza;251;Tarazona;10658;5148;5510
50;Zaragoza;252;Tauste;7030;3507;3523
50;Zaragoza;253;Terrer;750;364;386
50;Zaragoza;254;Tierga;278;147;131
50;Zaragoza;255;Tobed;315;151;164
50;Zaragoza;256;Torralba de los Frailes;107;52;55
50;Zaragoza;257;Torralba de Ribota;235;132;103
50;Zaragoza;258;Torralbilla;75;37;38
50;Zaragoza;259;Torrehermosa;128;68;60
50;Zaragoza;260;Torrelapaja;51;25;26
50;Zaragoza;261;Torrellas;357;179;178
50;Zaragoza;262;Torres de Berrellén;1419;707;712
50;Zaragoza;263;Torrijo de la Cañada;453;237;216
50;Zaragoza;264;Tosos;240;125;115
50;Zaragoza;265;Trasmoz;74;39;35
50;Zaragoza;266;Trasobares;268;143;125
50;Zaragoza;267;Uncastillo;925;450;475
50;Zaragoza;268;Undués de Lerda;52;25;27
50;Zaragoza;269;Urrea de Jalón;369;183;186
50;Zaragoza;270;Urriés;83;45;38
50;Zaragoza;271;Used;416;216;200
50;Zaragoza;272;Utebo;8874;4475;4399
50;Zaragoza;274;Val de San Martín;79;35;44
50;Zaragoza;273;Valdehorna;72;34;38
50;Zaragoza;275;Valmadrid;69;35;34
50;Zaragoza;276;Valpalmas;219;111;108
50;Zaragoza;277;Valtorres;108;53;55
50;Zaragoza;278;Velilla de Ebro;290;146;144
50;Zaragoza;279;Velilla de Jiloca;145;72;73
50;Zaragoza;280;Vera de Moncayo;477;244;233
50;Zaragoza;281;Vierlas;119;57;62
50;Zaragoza;283;Villadoz;88;47;41
50;Zaragoza;284;Villafeliche;254;123;131
50;Zaragoza;285;Villafranca de Ebro;679;326;353
50;Zaragoza;286;Villalba de Perejil;132;67;65
50;Zaragoza;287;Villalengua;486;255;231
50;Zaragoza;288;Villanueva de Gállego;2694;1359;1335
50;Zaragoza;290;Villanueva de Huerva;640;315;325
50;Zaragoza;289;Villanueva de Jiloca;125;63;62
50;Zaragoza;291;Villar de los Navarros;191;97;94
50;Zaragoza;292;Villarreal de Huerva;187;104;83
50;Zaragoza;293;Villarroya de la Sierra;774;393;381
50;Zaragoza;294;Villarroya del Campo;77;39;38
50;Zaragoza;282;Vilueña (La);108;49;59
50;Zaragoza;295;Vistabella;33;18;15
50;Zaragoza;296;Zaida (La);648;323;325
50;Zaragoza;297;Zaragoza;607899;293634;314265
50;Zaragoza;298;Zuera;5422;2778;2644
51;Ceuta;001;Ceuta;73142;36486;36656
52;Melilla;001;Melilla;64727;32703;32024
